*********** # 1 **************
PokerStars Hand #203492936567:  Hold'em No Limit ($0.02/$0.05 USD) - 2019/09/07 10:52:22 ET
Table 'Scorpius' 6-max Seat #4 is the button
Seat 2: Reignerrr ($5 in chips)
Seat 4: PlayTheBlues4U ($6 in chips)
Seat 5: zepped88 ($3.48 in chips)
zepped88: posts small blind $0.02
Reignerrr: posts big blind $0.05
*** HOLE CARDS ***
Dealt to PlayTheBlues4U [Jc 8s]
PlayTheBlues4U: folds
zepped88: folds
Uncalled bet ($0.03) returned to Reignerrr
Reignerrr collected $0.04 from pot
Reignerrr: doesn't show hand
*** SUMMARY ***
Total pot $0.04 | Rake $0
Seat 2: Reignerrr (big blind) collected ($0.04)
Seat 4: PlayTheBlues4U (button) folded before Flop (didn't bet)
Seat 5: zepped88 (small blind) folded before Flop


*********** # 2 **************
PokerStars Hand #203492936520:  Hold'em No Limit ($0.02/$0.05 USD) - 2019/09/07 10:51:48 ET
Table 'Scorpius' 6-max Seat #2 is the button
Seat 2: Reignerrr ($5 in chips)
Seat 4: PlayTheBlues4U ($6.40 in chips)
Seat 5: zepped88 ($3.12 in chips)
PlayTheBlues4U: posts small blind $0.02
zepped88: posts big blind $0.05
*** HOLE CARDS ***
Dealt to PlayTheBlues4U [4s As]
Reignerrr: folds
PlayTheBlues4U: raises $0.05 to $0.10
zepped88: calls $0.05
*** FLOP *** [5h Th 7h]
PlayTheBlues4U: bets $0.10
zepped88: calls $0.10
*** TURN *** [5h Th 7h] [3h]
PlayTheBlues4U: bets $0.20
zepped88: calls $0.20
*** RIVER *** [5h Th 7h 3h] [Ah]
PlayTheBlues4U: checks
zepped88: checks
*** SHOW DOWN ***
PlayTheBlues4U: shows [4s As] (a flush, Ace high)
zepped88: shows [9h Ac] (a flush, Ace high - Nine higher)
zepped88 collected $0.76 from pot
*** SUMMARY ***
Total pot $0.80 | Rake $0.04
Board [5h Th 7h 3h Ah]
Seat 2: Reignerrr (button) folded before Flop (didn't bet)
Seat 4: PlayTheBlues4U (small blind) showed [4s As] and lost with a flush, Ace high
Seat 5: zepped88 (big blind) showed [9h Ac] and won ($0.76) with a flush, Ace high


*********** # 3 **************
PokerStars Hand #203492936494:  Hold'em No Limit ($0.02/$0.05 USD) - 2019/09/07 10:51:23 ET
Table 'Scorpius' 6-max Seat #5 is the button
Seat 2: Reignerrr ($5 in chips)
Seat 4: PlayTheBlues4U ($6.45 in chips)
Seat 5: zepped88 ($3.06 in chips)
Reignerrr: posts small blind $0.02
PlayTheBlues4U: posts big blind $0.05
*** HOLE CARDS ***
Dealt to PlayTheBlues4U [6d Jc]
zepped88: calls $0.05
Reignerrr: folds
PlayTheBlues4U: checks
*** FLOP *** [7c 3c 4h]
PlayTheBlues4U: checks
zepped88: bets $0.05
PlayTheBlues4U: folds
Uncalled bet ($0.05) returned to zepped88
zepped88 collected $0.11 from pot
zepped88: doesn't show hand
*** SUMMARY ***
Total pot $0.12 | Rake $0.01
Board [7c 3c 4h]
Seat 2: Reignerrr (small blind) folded before Flop
Seat 4: PlayTheBlues4U (big blind) folded on the Flop
Seat 5: zepped88 (button) collected ($0.11)


*********** # 4 **************
PokerStars Hand #203492936422:  Hold'em No Limit ($0.02/$0.05 USD) - 2019/09/07 10:50:26 ET
Table 'Scorpius' 6-max Seat #4 is the button
Seat 2: Reignerrr ($5 in chips)
Seat 4: PlayTheBlues4U ($6.03 in chips)
Seat 5: zepped88 ($3.08 in chips)
Seat 6: marimba 104 ($5.70 in chips)
zepped88: posts small blind $0.02
marimba 104: posts big blind $0.05
*** HOLE CARDS ***
Dealt to PlayTheBlues4U [3s Ad]
Reignerrr: folds
PlayTheBlues4U: calls $0.05
zepped88: folds
marimba 104: checks
*** FLOP *** [6h 3d Ah]
marimba 104: checks
PlayTheBlues4U: bets $0.10
marimba 104: calls $0.10
*** TURN *** [6h 3d Ah] [5d]
marimba 104: checks
PlayTheBlues4U: bets $0.30
marimba 104: calls $0.30
*** RIVER *** [6h 3d Ah 5d] [Jd]
marimba 104: checks
PlayTheBlues4U: bets $0.50
marimba 104: folds
Uncalled bet ($0.50) returned to PlayTheBlues4U
marimba 104 leaves the table
PlayTheBlues4U collected $0.87 from pot
PlayTheBlues4U: doesn't show hand
*** SUMMARY ***
Total pot $0.92 | Rake $0.05
Board [6h 3d Ah 5d Jd]
Seat 2: Reignerrr folded before Flop (didn't bet)
Seat 4: PlayTheBlues4U (button) collected ($0.87)
Seat 5: zepped88 (small blind) folded before Flop
Seat 6: marimba 104 (big blind) folded on the River


*********** # 5 **************
PokerStars Hand #203492936350:  Hold'em No Limit ($0.02/$0.05 USD) - 2019/09/07 10:49:21 ET
Table 'Scorpius' 6-max Seat #2 is the button
Seat 2: Reignerrr ($5 in chips)
Seat 3: oldhippieVii ($5.35 in chips)
Seat 4: PlayTheBlues4U ($6.08 in chips)
Seat 5: zepped88 ($3.08 in chips)
Seat 6: marimba 104 ($6.05 in chips)
oldhippieVii: posts small blind $0.02
PlayTheBlues4U: posts big blind $0.05
*** HOLE CARDS ***
Dealt to PlayTheBlues4U [8d 3c]
zepped88: folds
marimba 104: calls $0.05
Reignerrr: folds
oldhippieVii: calls $0.03
PlayTheBlues4U: checks
*** FLOP *** [Ah Td Qs]
oldhippieVii: checks
PlayTheBlues4U: checks
marimba 104: bets $0.15
oldhippieVii: calls $0.15
PlayTheBlues4U: folds
*** TURN *** [Ah Td Qs] [3s]
oldhippieVii: checks
marimba 104: bets $0.15
oldhippieVii: calls $0.15
*** RIVER *** [Ah Td Qs 3s] [Kc]
oldhippieVii: checks
marimba 104: checks
*** SHOW DOWN ***
oldhippieVii: shows [Th Ks] (two pair, Kings and Tens)
marimba 104: mucks hand
oldhippieVii collected $0.71 from pot
*** SUMMARY ***
Total pot $0.75 | Rake $0.04
Board [Ah Td Qs 3s Kc]
Seat 2: Reignerrr (button) folded before Flop (didn't bet)
Seat 3: oldhippieVii (small blind) showed [Th Ks] and won ($0.71) with two pair, Kings and Tens
Seat 4: PlayTheBlues4U (big blind) folded on the Flop
Seat 5: zepped88 folded before Flop (didn't bet)
Seat 6: marimba 104 mucked [As 5d]


*********** # 6 **************
PokerStars Hand #203492936340:  Hold'em No Limit ($0.02/$0.05 USD) - 2019/09/07 10:49:13 ET
Table 'Scorpius' 6-max Seat #6 is the button
Seat 2: Reignerrr ($5 in chips)
Seat 3: oldhippieVii ($5.33 in chips)
Seat 4: PlayTheBlues4U ($6.08 in chips)
Seat 5: zepped88 ($3.08 in chips)
Seat 6: marimba 104 ($6.05 in chips)
Reignerrr: posts small blind $0.02
oldhippieVii: posts big blind $0.05
*** HOLE CARDS ***
Dealt to PlayTheBlues4U [3h 9c]
PlayTheBlues4U: folds
zepped88: folds
marimba 104: folds
Reignerrr: folds
Uncalled bet ($0.03) returned to oldhippieVii
oldhippieVii collected $0.04 from pot
oldhippieVii: doesn't show hand
*** SUMMARY ***
Total pot $0.04 | Rake $0
Seat 2: Reignerrr (small blind) folded before Flop
Seat 3: oldhippieVii (big blind) collected ($0.04)
Seat 4: PlayTheBlues4U folded before Flop (didn't bet)
Seat 5: zepped88 folded before Flop (didn't bet)
Seat 6: marimba 104 (button) folded before Flop (didn't bet)


*********** # 7 **************
PokerStars Hand #203492936289:  Hold'em No Limit ($0.02/$0.05 USD) - 2019/09/07 10:48:38 ET
Table 'Scorpius' 6-max Seat #5 is the button
Seat 2: Reignerrr ($5 in chips)
Seat 3: oldhippieVii ($5.27 in chips)
Seat 4: PlayTheBlues4U ($6.08 in chips)
Seat 5: zepped88 ($3.08 in chips)
Seat 6: marimba 104 ($6.07 in chips)
marimba 104: posts small blind $0.02
Reignerrr: posts big blind $0.05
*** HOLE CARDS ***
Dealt to PlayTheBlues4U [Kd 5h]
oldhippieVii: calls $0.05
PlayTheBlues4U: folds
zepped88: folds
marimba 104: folds
Reignerrr: checks
*** FLOP *** [5c 3c 2d]
Reignerrr: checks
oldhippieVii: bets $0.11
Reignerrr: folds
Uncalled bet ($0.11) returned to oldhippieVii
oldhippieVii collected $0.11 from pot
oldhippieVii: doesn't show hand
*** SUMMARY ***
Total pot $0.12 | Rake $0.01
Board [5c 3c 2d]
Seat 2: Reignerrr (big blind) folded on the Flop
Seat 3: oldhippieVii collected ($0.11)
Seat 4: PlayTheBlues4U folded before Flop (didn't bet)
Seat 5: zepped88 (button) folded before Flop (didn't bet)
Seat 6: marimba 104 (small blind) folded before Flop


*********** # 8 **************
PokerStars Hand #203492936272:  Hold'em No Limit ($0.02/$0.05 USD) - 2019/09/07 10:48:22 ET
Table 'Scorpius' 6-max Seat #4 is the button
Seat 2: Reignerrr ($5 in chips)
Seat 3: oldhippieVii ($5.27 in chips)
Seat 4: PlayTheBlues4U ($6.01 in chips)
Seat 5: zepped88 ($3.10 in chips)
Seat 6: marimba 104 ($6.12 in chips)
zepped88: posts small blind $0.02
marimba 104: posts big blind $0.05
*** HOLE CARDS ***
Dealt to PlayTheBlues4U [Qd Th]
Reignerrr: folds
oldhippieVii: folds
PlayTheBlues4U: raises $0.10 to $0.15
zepped88: folds
marimba 104: folds
Uncalled bet ($0.10) returned to PlayTheBlues4U
PlayTheBlues4U collected $0.12 from pot
PlayTheBlues4U: doesn't show hand
*** SUMMARY ***
Total pot $0.12 | Rake $0
Seat 2: Reignerrr folded before Flop (didn't bet)
Seat 3: oldhippieVii folded before Flop (didn't bet)
Seat 4: PlayTheBlues4U (button) collected ($0.12)
Seat 5: zepped88 (small blind) folded before Flop
Seat 6: marimba 104 (big blind) folded before Flop


*********** # 9 **************
PokerStars Hand #203492936247:  Hold'em No Limit ($0.02/$0.05 USD) - 2019/09/07 10:48:04 ET
Table 'Scorpius' 6-max Seat #3 is the button
Seat 2: Reignerrr ($5 in chips)
Seat 3: oldhippieVii ($5.27 in chips)
Seat 4: PlayTheBlues4U ($6.03 in chips)
Seat 5: zepped88 ($3.15 in chips)
Seat 6: marimba 104 ($6.06 in chips)
PlayTheBlues4U: posts small blind $0.02
zepped88: posts big blind $0.05
*** HOLE CARDS ***
Dealt to PlayTheBlues4U [7c 5h]
marimba 104: calls $0.05
Reignerrr: folds
oldhippieVii: folds
PlayTheBlues4U: folds
zepped88: checks
*** FLOP *** [9d Jh 6s]
zepped88: checks
marimba 104: bets $0.15
zepped88: folds
Uncalled bet ($0.15) returned to marimba 104
marimba 104 collected $0.11 from pot
marimba 104: doesn't show hand
*** SUMMARY ***
Total pot $0.12 | Rake $0.01
Board [9d Jh 6s]
Seat 2: Reignerrr folded before Flop (didn't bet)
Seat 3: oldhippieVii (button) folded before Flop (didn't bet)
Seat 4: PlayTheBlues4U (small blind) folded before Flop
Seat 5: zepped88 (big blind) folded on the Flop
Seat 6: marimba 104 collected ($0.11)


*********** # 10 **************
PokerStars Hand #203492936226:  Hold'em No Limit ($0.02/$0.05 USD) - 2019/09/07 10:47:50 ET
Table 'Scorpius' 6-max Seat #2 is the button
Seat 1: R@ngers94 ($4.45 in chips)
Seat 2: Reignerrr ($5 in chips)
Seat 3: oldhippieVii ($5.29 in chips)
Seat 4: PlayTheBlues4U ($6.08 in chips)
Seat 5: zepped88 ($3.08 in chips)
Seat 6: marimba 104 ($6.06 in chips)
oldhippieVii: posts small blind $0.02
PlayTheBlues4U: posts big blind $0.05
*** HOLE CARDS ***
Dealt to PlayTheBlues4U [4c Qh]
zepped88: raises $0.05 to $0.10
marimba 104: folds
R@ngers94: folds
Reignerrr: folds
oldhippieVii: folds
PlayTheBlues4U: folds
Uncalled bet ($0.05) returned to zepped88
R@ngers94 leaves the table
zepped88 collected $0.12 from pot
zepped88: doesn't show hand
*** SUMMARY ***
Total pot $0.12 | Rake $0
Seat 1: R@ngers94 folded before Flop (didn't bet)
Seat 2: Reignerrr (button) folded before Flop (didn't bet)
Seat 3: oldhippieVii (small blind) folded before Flop
Seat 4: PlayTheBlues4U (big blind) folded before Flop
Seat 5: zepped88 collected ($0.12)
Seat 6: marimba 104 folded before Flop (didn't bet)


*********** # 11 **************
PokerStars Hand #203492936153:  Hold'em No Limit ($0.02/$0.05 USD) - 2019/09/07 10:47:01 ET
Table 'Scorpius' 6-max Seat #1 is the button
Seat 1: R@ngers94 ($4.50 in chips)
Seat 2: Reignerrr ($5 in chips)
Seat 3: oldhippieVii ($5.34 in chips)
Seat 4: PlayTheBlues4U ($6.08 in chips)
Seat 5: zepped88 ($3.13 in chips)
Seat 6: marimba 104 ($5.90 in chips)
Reignerrr: posts small blind $0.02
oldhippieVii: posts big blind $0.05
*** HOLE CARDS ***
Dealt to PlayTheBlues4U [7s 2h]
PlayTheBlues4U: folds
zepped88: calls $0.05
marimba 104: calls $0.05
R@ngers94: calls $0.05
Reignerrr: folds
oldhippieVii: checks
*** FLOP *** [Kc Tc 9d]
oldhippieVii: checks
zepped88: checks
marimba 104: checks
R@ngers94: checks
*** TURN *** [Kc Tc 9d] [4s]
oldhippieVii: checks
zepped88: checks
marimba 104: bets $0.10
R@ngers94: folds
oldhippieVii: folds
zepped88: folds
Uncalled bet ($0.10) returned to marimba 104
marimba 104 collected $0.21 from pot
marimba 104: doesn't show hand
*** SUMMARY ***
Total pot $0.22 | Rake $0.01
Board [Kc Tc 9d 4s]
Seat 1: R@ngers94 (button) folded on the Turn
Seat 2: Reignerrr (small blind) folded before Flop
Seat 3: oldhippieVii (big blind) folded on the Turn
Seat 4: PlayTheBlues4U folded before Flop (didn't bet)
Seat 5: zepped88 folded on the Turn
Seat 6: marimba 104 collected ($0.21)


*********** # 12 **************
PokerStars Hand #203492936030:  Hold'em No Limit ($0.02/$0.05 USD) - 2019/09/07 10:45:24 ET
Table 'Scorpius' 6-max Seat #6 is the button
Seat 1: R@ngers94 ($4.55 in chips)
Seat 2: Reignerrr ($5 in chips)
Seat 3: oldhippieVii ($6.14 in chips)
Seat 4: PlayTheBlues4U ($6.08 in chips)
Seat 5: zepped88 ($3.18 in chips)
Seat 6: marimba 104 ($4.80 in chips)
R@ngers94: posts small blind $0.02
Reignerrr: posts big blind $0.05
*** HOLE CARDS ***
Dealt to PlayTheBlues4U [9s Td]
oldhippieVii: calls $0.05
PlayTheBlues4U has timed out
PlayTheBlues4U: folds
zepped88: calls $0.05
marimba 104: calls $0.05
R@ngers94: calls $0.03
Reignerrr: raises $0.25 to $0.30
oldhippieVii: calls $0.25
zepped88: folds
marimba 104: calls $0.25
R@ngers94: folds
*** FLOP *** [Qs Kh 3h]
Reignerrr: checks
oldhippieVii: checks
marimba 104: bets $0.25
Reignerrr: folds
oldhippieVii: calls $0.25
*** TURN *** [Qs Kh 3h] [Jd]
oldhippieVii: checks
marimba 104: bets $0.25
oldhippieVii: calls $0.25
*** RIVER *** [Qs Kh 3h Jd] [Kd]
oldhippieVii: checks
marimba 104: checks
*** SHOW DOWN ***
oldhippieVii: shows [As 2s] (a pair of Kings)
marimba 104: shows [9c Qc] (two pair, Kings and Queens)
marimba 104 collected $1.90 from pot
*** SUMMARY ***
Total pot $2 | Rake $0.10
Board [Qs Kh 3h Jd Kd]
Seat 1: R@ngers94 (small blind) folded before Flop
Seat 2: Reignerrr (big blind) folded on the Flop
Seat 3: oldhippieVii showed [As 2s] and lost with a pair of Kings
Seat 4: PlayTheBlues4U folded before Flop (didn't bet)
Seat 5: zepped88 folded before Flop
Seat 6: marimba 104 (button) showed [9c Qc] and won ($1.90) with two pair, Kings and Queens


*********** # 13 **************
PokerStars Hand #203492936010:  Hold'em No Limit ($0.02/$0.05 USD) - 2019/09/07 10:45:09 ET
Table 'Scorpius' 6-max Seat #5 is the button
Seat 1: R@ngers94 ($4.60 in chips)
Seat 2: Reignerrr ($5 in chips)
Seat 3: oldhippieVii ($6.07 in chips)
Seat 4: PlayTheBlues4U ($6.08 in chips)
Seat 5: zepped88 ($3.18 in chips)
Seat 6: marimba 104 ($4.82 in chips)
marimba 104: posts small blind $0.02
R@ngers94: posts big blind $0.05
*** HOLE CARDS ***
Dealt to PlayTheBlues4U [Ac 2s]
Reignerrr: folds
oldhippieVii: raises $0.10 to $0.15
PlayTheBlues4U: folds
zepped88: folds
marimba 104: folds
R@ngers94: folds
Uncalled bet ($0.10) returned to oldhippieVii
oldhippieVii collected $0.12 from pot
oldhippieVii: doesn't show hand
*** SUMMARY ***
Total pot $0.12 | Rake $0
Seat 1: R@ngers94 (big blind) folded before Flop
Seat 2: Reignerrr folded before Flop (didn't bet)
Seat 3: oldhippieVii collected ($0.12)
Seat 4: PlayTheBlues4U folded before Flop (didn't bet)
Seat 5: zepped88 (button) folded before Flop (didn't bet)
Seat 6: marimba 104 (small blind) folded before Flop


*********** # 14 **************
PokerStars Hand #203492935932:  Hold'em No Limit ($0.02/$0.05 USD) - 2019/09/07 10:44:15 ET
Table 'Scorpius' 6-max Seat #4 is the button
Seat 1: R@ngers94 ($4.31 in chips)
Seat 2: Reignerrr ($5 in chips)
Seat 3: oldhippieVii ($6.32 in chips)
Seat 4: PlayTheBlues4U ($6.08 in chips)
Seat 5: zepped88 ($3.20 in chips)
Seat 6: marimba 104 ($4.87 in chips)
zepped88: posts small blind $0.02
marimba 104: posts big blind $0.05
*** HOLE CARDS ***
Dealt to PlayTheBlues4U [5d 4d]
R@ngers94: raises $0.05 to $0.10
Reignerrr: folds
oldhippieVii: calls $0.10
PlayTheBlues4U: folds
zepped88: folds
marimba 104: folds
*** FLOP *** [6c 7c Td]
R@ngers94: bets $0.15
oldhippieVii: calls $0.15
*** TURN *** [6c 7c Td] [Jd]
R@ngers94: checks
oldhippieVii: checks
*** RIVER *** [6c 7c Td Jd] [Ks]
R@ngers94: bets $0.55
oldhippieVii: folds
Uncalled bet ($0.55) returned to R@ngers94
R@ngers94 collected $0.54 from pot
R@ngers94: doesn't show hand
*** SUMMARY ***
Total pot $0.57 | Rake $0.03
Board [6c 7c Td Jd Ks]
Seat 1: R@ngers94 collected ($0.54)
Seat 2: Reignerrr folded before Flop (didn't bet)
Seat 3: oldhippieVii folded on the River
Seat 4: PlayTheBlues4U (button) folded before Flop (didn't bet)
Seat 5: zepped88 (small blind) folded before Flop
Seat 6: marimba 104 (big blind) folded before Flop


*********** # 15 **************
PokerStars Hand #203492935871:  Hold'em No Limit ($0.02/$0.05 USD) - 2019/09/07 10:43:23 ET
Table 'Scorpius' 6-max Seat #3 is the button
Seat 1: R@ngers94 ($4.36 in chips)
Seat 2: Reignerrr ($5 in chips)
Seat 3: oldhippieVii ($6.47 in chips)
Seat 4: PlayTheBlues4U ($6.10 in chips)
Seat 5: zepped88 ($3 in chips)
Seat 6: marimba 104 ($4.87 in chips)
PlayTheBlues4U: posts small blind $0.02
zepped88: posts big blind $0.05
*** HOLE CARDS ***
Dealt to PlayTheBlues4U [8d 5h]
marimba 104: folds
R@ngers94: calls $0.05
Reignerrr: folds
oldhippieVii: calls $0.05
PlayTheBlues4U: folds
zepped88: raises $0.10 to $0.15
R@ngers94: folds
oldhippieVii: calls $0.10
*** FLOP *** [4s 3c Jd]
zepped88: checks
oldhippieVii: checks
*** TURN *** [4s 3c Jd] [9h]
zepped88: checks
oldhippieVii: checks
*** RIVER *** [4s 3c Jd 9h] [9d]
zepped88: checks
oldhippieVii: checks
*** SHOW DOWN ***
zepped88: shows [As Qh] (a pair of Nines)
oldhippieVii: mucks hand
zepped88 collected $0.35 from pot
*** SUMMARY ***
Total pot $0.37 | Rake $0.02
Board [4s 3c Jd 9h 9d]
Seat 1: R@ngers94 folded before Flop
Seat 2: Reignerrr folded before Flop (didn't bet)
Seat 3: oldhippieVii (button) mucked [Ac 6c]
Seat 4: PlayTheBlues4U (small blind) folded before Flop
Seat 5: zepped88 (big blind) showed [As Qh] and won ($0.35) with a pair of Nines
Seat 6: marimba 104 folded before Flop (didn't bet)


*********** # 16 **************
PokerStars Hand #203492935812:  Hold'em No Limit ($0.02/$0.05 USD) - 2019/09/07 10:42:31 ET
Table 'Scorpius' 6-max Seat #2 is the button
Seat 1: R@ngers94 ($4.41 in chips)
Seat 2: Reignerrr ($5 in chips)
Seat 3: oldhippieVii ($6.52 in chips)
Seat 4: PlayTheBlues4U ($6.01 in chips)
Seat 6: marimba 104 ($4.87 in chips)
oldhippieVii: posts small blind $0.02
PlayTheBlues4U: posts big blind $0.05
*** HOLE CARDS ***
Dealt to PlayTheBlues4U [7h Js]
marimba 104: folds
R@ngers94: calls $0.05
Reignerrr: folds
oldhippieVii: calls $0.03
PlayTheBlues4U: checks
*** FLOP *** [8c Ah Jd]
oldhippieVii: checks
PlayTheBlues4U: checks
R@ngers94: checks
*** TURN *** [8c Ah Jd] [2s]
oldhippieVii: checks
PlayTheBlues4U: bets $0.15
R@ngers94: folds
zepped88 joins the table at seat #5
oldhippieVii: folds
Uncalled bet ($0.15) returned to PlayTheBlues4U
PlayTheBlues4U collected $0.14 from pot
PlayTheBlues4U: doesn't show hand
*** SUMMARY ***
Total pot $0.15 | Rake $0.01
Board [8c Ah Jd 2s]
Seat 1: R@ngers94 folded on the Turn
Seat 2: Reignerrr (button) folded before Flop (didn't bet)
Seat 3: oldhippieVii (small blind) folded on the Turn
Seat 4: PlayTheBlues4U (big blind) collected ($0.14)
Seat 6: marimba 104 folded before Flop (didn't bet)


*********** # 17 **************
PokerStars Hand #203492935784:  Hold'em No Limit ($0.02/$0.05 USD) - 2019/09/07 10:42:01 ET
Table 'Scorpius' 6-max Seat #1 is the button
Seat 1: R@ngers94 ($4.58 in chips)
Seat 2: Reignerrr ($5 in chips)
Seat 3: oldhippieVii ($6.57 in chips)
Seat 4: PlayTheBlues4U ($5.79 in chips)
Seat 6: marimba 104 ($4.87 in chips)
Reignerrr: posts small blind $0.02
oldhippieVii: posts big blind $0.05
*** HOLE CARDS ***
Dealt to PlayTheBlues4U [Ac Kh]
PlayTheBlues4U: raises $0.12 to $0.17
marimba 104: folds
R@ngers94: calls $0.17
Reignerrr: folds
oldhippieVii: folds
*** FLOP *** [Qd 3d Kd]
PlayTheBlues4U: bets $0.30
R@ngers94: folds
Uncalled bet ($0.30) returned to PlayTheBlues4U
PlayTheBlues4U collected $0.39 from pot
PlayTheBlues4U: doesn't show hand
*** SUMMARY ***
Total pot $0.41 | Rake $0.02
Board [Qd 3d Kd]
Seat 1: R@ngers94 (button) folded on the Flop
Seat 2: Reignerrr (small blind) folded before Flop
Seat 3: oldhippieVii (big blind) folded before Flop
Seat 4: PlayTheBlues4U collected ($0.39)
Seat 6: marimba 104 folded before Flop (didn't bet)


*********** # 18 **************
PokerStars Hand #203492935741:  Hold'em No Limit ($0.02/$0.05 USD) - 2019/09/07 10:41:27 ET
Table 'Scorpius' 6-max Seat #6 is the button
Seat 1: R@ngers94 ($4.68 in chips)
Seat 2: Reignerrr ($5 in chips)
Seat 4: PlayTheBlues4U ($5.79 in chips)
Seat 6: marimba 104 ($4.69 in chips)
R@ngers94: posts small blind $0.02
Reignerrr: posts big blind $0.05
oldhippieVii: sits out
*** HOLE CARDS ***
Dealt to PlayTheBlues4U [4s Ad]
PlayTheBlues4U: folds
marimba 104: calls $0.05
R@ngers94: raises $0.05 to $0.10
Reignerrr: calls $0.05
marimba 104: calls $0.05
*** FLOP *** [9s 9h 9d]
R@ngers94: checks
Reignerrr: checks
marimba 104: checks
*** TURN *** [9s 9h 9d] [6d]
R@ngers94: checks
Reignerrr: checks
marimba 104: checks
*** RIVER *** [9s 9h 9d 6d] [8s]
R@ngers94: checks
Reignerrr: checks
marimba 104: bets $0.15
R@ngers94: folds
Reignerrr: folds
Uncalled bet ($0.15) returned to marimba 104
marimba 104 collected $0.28 from pot
marimba 104: doesn't show hand
*** SUMMARY ***
Total pot $0.30 | Rake $0.02
Board [9s 9h 9d 6d 8s]
Seat 1: R@ngers94 (small blind) folded on the River
Seat 2: Reignerrr (big blind) folded on the River
Seat 4: PlayTheBlues4U folded before Flop (didn't bet)
Seat 6: marimba 104 (button) collected ($0.28)


*********** # 19 **************
PokerStars Hand #203492935724:  Hold'em No Limit ($0.02/$0.05 USD) - 2019/09/07 10:41:09 ET
Table 'Scorpius' 6-max Seat #5 is the button
Seat 1: R@ngers94 ($4.73 in chips)
Seat 2: Reignerrr ($5 in chips)
Seat 4: PlayTheBlues4U ($5.72 in chips)
Seat 5: joemli3 ($2.76 in chips)
Seat 6: marimba 104 ($4.71 in chips)
marimba 104: posts small blind $0.02
R@ngers94: posts big blind $0.05
oldhippieVii: sits out
*** HOLE CARDS ***
Dealt to PlayTheBlues4U [Ac Qc]
Reignerrr: folds
PlayTheBlues4U: raises $0.15 to $0.20
joemli3: folds
joemli3 leaves the table
marimba 104: folds
R@ngers94: folds
Uncalled bet ($0.15) returned to PlayTheBlues4U
PlayTheBlues4U collected $0.12 from pot
PlayTheBlues4U: doesn't show hand
*** SUMMARY ***
Total pot $0.12 | Rake $0
Seat 1: R@ngers94 (big blind) folded before Flop
Seat 2: Reignerrr folded before Flop (didn't bet)
Seat 4: PlayTheBlues4U collected ($0.12)
Seat 5: joemli3 (button) folded before Flop (didn't bet)
Seat 6: marimba 104 (small blind) folded before Flop


*********** # 20 **************
PokerStars Hand #203492935673:  Hold'em No Limit ($0.02/$0.05 USD) - 2019/09/07 10:40:25 ET
Table 'Scorpius' 6-max Seat #4 is the button
Seat 1: R@ngers94 ($4.73 in chips)
Seat 2: Reignerrr ($5 in chips)
Seat 4: PlayTheBlues4U ($5.82 in chips)
Seat 5: joemli3 ($2.78 in chips)
Seat 6: marimba 104 ($4.60 in chips)
joemli3: posts small blind $0.02
marimba 104: posts big blind $0.05
oldhippieVii: sits out
*** HOLE CARDS ***
Dealt to PlayTheBlues4U [9d Tc]
R@ngers94: folds
Reignerrr: folds
PlayTheBlues4U: calls $0.05
joemli3: folds
marimba 104: checks
*** FLOP *** [6h Ad Jc]
marimba 104: checks
PlayTheBlues4U: bets $0.05
marimba 104: calls $0.05
*** TURN *** [6h Ad Jc] [Jd]
marimba 104: checks
PlayTheBlues4U: checks
*** RIVER *** [6h Ad Jc Jd] [3c]
marimba 104: bets $0.10
PlayTheBlues4U: folds
Uncalled bet ($0.10) returned to marimba 104
marimba 104 collected $0.21 from pot
marimba 104: doesn't show hand
*** SUMMARY ***
Total pot $0.22 | Rake $0.01
Board [6h Ad Jc Jd 3c]
Seat 1: R@ngers94 folded before Flop (didn't bet)
Seat 2: Reignerrr folded before Flop (didn't bet)
Seat 4: PlayTheBlues4U (button) folded on the River
Seat 5: joemli3 (small blind) folded before Flop
Seat 6: marimba 104 (big blind) collected ($0.21)


*********** # 21 **************
PokerStars Hand #203492935632:  Hold'em No Limit ($0.02/$0.05 USD) - 2019/09/07 10:39:47 ET
Table 'Scorpius' 6-max Seat #2 is the button
Seat 1: R@ngers94 ($5.03 in chips)
Seat 2: Reignerrr ($5 in chips)
Seat 4: PlayTheBlues4U ($5.84 in chips)
Seat 5: joemli3 ($2.83 in chips)
Seat 6: marimba 104 ($4.26 in chips)
PlayTheBlues4U: posts small blind $0.02
joemli3: posts big blind $0.05
*** HOLE CARDS ***
Dealt to PlayTheBlues4U [6s 4h]
AJalexanderAJ leaves the table
marimba 104: calls $0.05
oldhippieVii joins the table at seat #3
R@ngers94: raises $0.05 to $0.10
Reignerrr: folds
PlayTheBlues4U: folds
joemli3: folds
marimba 104: calls $0.05
*** FLOP *** [3s Ac 2h]
marimba 104: checks
R@ngers94: checks
*** TURN *** [3s Ac 2h] [Ts]
marimba 104: bets $0.10
R@ngers94: calls $0.10
*** RIVER *** [3s Ac 2h Ts] [5s]
marimba 104: bets $0.10
R@ngers94: calls $0.10
*** SHOW DOWN ***
marimba 104: shows [As Td] (two pair, Aces and Tens)
R@ngers94: mucks hand
marimba 104 collected $0.64 from pot
*** SUMMARY ***
Total pot $0.67 | Rake $0.03
Board [3s Ac 2h Ts 5s]
Seat 1: R@ngers94 mucked [Tc Kh]
Seat 2: Reignerrr (button) folded before Flop (didn't bet)
Seat 4: PlayTheBlues4U (small blind) folded before Flop
Seat 5: joemli3 (big blind) folded before Flop
Seat 6: marimba 104 showed [As Td] and won ($0.64) with two pair, Aces and Tens


*********** # 22 **************
PokerStars Hand #203492935593:  Hold'em No Limit ($0.02/$0.05 USD) - 2019/09/07 10:39:11 ET
Table 'Scorpius' 6-max Seat #1 is the button
Seat 1: R@ngers94 ($4.97 in chips)
Seat 2: Reignerrr ($5 in chips)
Seat 3: AJalexanderAJ ($8.54 in chips)
Seat 4: PlayTheBlues4U ($5.84 in chips)
Seat 5: joemli3 ($2.83 in chips)
Seat 6: marimba 104 ($4.26 in chips)
Reignerrr: posts small blind $0.02
AJalexanderAJ: posts big blind $0.05
*** HOLE CARDS ***
Dealt to PlayTheBlues4U [7s Tc]
PlayTheBlues4U: folds
joemli3: folds
marimba 104: folds
R@ngers94: calls $0.05
Reignerrr: folds
AJalexanderAJ: checks
*** FLOP *** [9s Jh 4c]
AJalexanderAJ: checks
R@ngers94: bets $0.05
AJalexanderAJ: folds
Uncalled bet ($0.05) returned to R@ngers94
R@ngers94 collected $0.11 from pot
R@ngers94: doesn't show hand
*** SUMMARY ***
Total pot $0.12 | Rake $0.01
Board [9s Jh 4c]
Seat 1: R@ngers94 (button) collected ($0.11)
Seat 2: Reignerrr (small blind) folded before Flop
Seat 3: AJalexanderAJ (big blind) folded on the Flop
Seat 4: PlayTheBlues4U folded before Flop (didn't bet)
Seat 5: joemli3 folded before Flop (didn't bet)
Seat 6: marimba 104 folded before Flop (didn't bet)


*********** # 23 **************
PokerStars Hand #203492935532:  Hold'em No Limit ($0.02/$0.05 USD) - 2019/09/07 10:38:18 ET
Table 'Scorpius' 6-max Seat #6 is the button
Seat 1: R@ngers94 ($5.02 in chips)
Seat 2: Reignerrr ($5 in chips)
Seat 3: AJalexanderAJ ($8.40 in chips)
Seat 4: PlayTheBlues4U ($5.84 in chips)
Seat 5: joemli3 ($2.88 in chips)
Seat 6: marimba 104 ($4.26 in chips)
R@ngers94: posts small blind $0.02
Reignerrr: posts big blind $0.05
*** HOLE CARDS ***
Dealt to PlayTheBlues4U [8d 6c]
AJalexanderAJ: calls $0.05
PlayTheBlues4U: folds
joemli3: calls $0.05
marimba 104: folds
R@ngers94: calls $0.03
Reignerrr: checks
*** FLOP *** [3h 2d 6s]
R@ngers94: checks
Reignerrr: checks
AJalexanderAJ: checks
joemli3: checks
*** TURN *** [3h 2d 6s] [Ad]
R@ngers94: checks
Reignerrr: checks
AJalexanderAJ: checks
joemli3: checks
*** RIVER *** [3h 2d 6s Ad] [5d]
R@ngers94: checks
Reignerrr: checks
AJalexanderAJ: checks
joemli3: checks
*** SHOW DOWN ***
R@ngers94: shows [5c 9c] (a pair of Fives)
Reignerrr: mucks hand
AJalexanderAJ: shows [5s Jh] (a pair of Fives - Ace+Jack kicker)
joemli3: mucks hand
AJalexanderAJ collected $0.19 from pot
*** SUMMARY ***
Total pot $0.20 | Rake $0.01
Board [3h 2d 6s Ad 5d]
Seat 1: R@ngers94 (small blind) showed [5c 9c] and lost with a pair of Fives
Seat 2: Reignerrr (big blind) mucked [7d Th]
Seat 3: AJalexanderAJ showed [5s Jh] and won ($0.19) with a pair of Fives
Seat 4: PlayTheBlues4U folded before Flop (didn't bet)
Seat 5: joemli3 mucked [9h Jc]
Seat 6: marimba 104 (button) folded before Flop (didn't bet)


*********** # 24 **************
PokerStars Hand #203492935466:  Hold'em No Limit ($0.02/$0.05 USD) - 2019/09/07 10:37:24 ET
Table 'Scorpius' 6-max Seat #5 is the button
Seat 1: R@ngers94 ($5.07 in chips)
Seat 2: Reignerrr ($5 in chips)
Seat 3: AJalexanderAJ ($8.60 in chips)
Seat 4: PlayTheBlues4U ($5.40 in chips)
Seat 5: joemli3 ($3.08 in chips)
Seat 6: marimba 104 ($4.28 in chips)
marimba 104: posts small blind $0.02
R@ngers94: posts big blind $0.05
*** HOLE CARDS ***
Dealt to PlayTheBlues4U [8s 9s]
Reignerrr: folds
AJalexanderAJ: calls $0.05
PlayTheBlues4U: raises $0.15 to $0.20
joemli3: calls $0.20
marimba 104: folds
R@ngers94: folds
AJalexanderAJ: calls $0.15
*** FLOP *** [Qd 3s 3h]
AJalexanderAJ: checks
PlayTheBlues4U: bets $0.35
joemli3: folds
AJalexanderAJ: folds
Uncalled bet ($0.35) returned to PlayTheBlues4U
PlayTheBlues4U collected $0.64 from pot
PlayTheBlues4U: doesn't show hand
*** SUMMARY ***
Total pot $0.67 | Rake $0.03
Board [Qd 3s 3h]
Seat 1: R@ngers94 (big blind) folded before Flop
Seat 2: Reignerrr folded before Flop (didn't bet)
Seat 3: AJalexanderAJ folded on the Flop
Seat 4: PlayTheBlues4U collected ($0.64)
Seat 5: joemli3 (button) folded on the Flop
Seat 6: marimba 104 (small blind) folded before Flop


*********** # 25 **************
PokerStars Hand #203492935406:  Hold'em No Limit ($0.02/$0.05 USD) - 2019/09/07 10:36:38 ET
Table 'Scorpius' 6-max Seat #4 is the button
Seat 1: R@ngers94 ($5.07 in chips)
Seat 2: Reignerrr ($5 in chips)
Seat 3: AJalexanderAJ ($9.85 in chips)
Seat 4: PlayTheBlues4U ($5.40 in chips)
Seat 5: joemli3 ($3.18 in chips)
Seat 6: marimba 104 ($3.06 in chips)
joemli3: posts small blind $0.02
marimba 104: posts big blind $0.05
*** HOLE CARDS ***
Dealt to PlayTheBlues4U [7c Kd]
R@ngers94: folds
Reignerrr: folds
AJalexanderAJ: calls $0.05
PlayTheBlues4U: folds
joemli3: calls $0.03
marimba 104: raises $0.05 to $0.10
AJalexanderAJ: calls $0.05
joemli3: calls $0.05
*** FLOP *** [7h Tc Ad]
joemli3: checks
marimba 104: checks
AJalexanderAJ: bets $0.40
joemli3: folds
marimba 104: calls $0.40
*** TURN *** [7h Tc Ad] [6h]
marimba 104: checks
AJalexanderAJ: bets $0.75
marimba 104: calls $0.75
*** RIVER *** [7h Tc Ad 6h] [3h]
marimba 104: checks
AJalexanderAJ: checks
*** SHOW DOWN ***
marimba 104: shows [5s As] (a pair of Aces)
AJalexanderAJ: mucks hand
marimba 104 collected $2.47 from pot
*** SUMMARY ***
Total pot $2.60 | Rake $0.13
Board [7h Tc Ad 6h 3h]
Seat 1: R@ngers94 folded before Flop (didn't bet)
Seat 2: Reignerrr folded before Flop (didn't bet)
Seat 3: AJalexanderAJ mucked [6s Jh]
Seat 4: PlayTheBlues4U (button) folded before Flop (didn't bet)
Seat 5: joemli3 (small blind) folded on the Flop
Seat 6: marimba 104 (big blind) showed [5s As] and won ($2.47) with a pair of Aces


*********** # 26 **************
PokerStars Hand #203492935355:  Hold'em No Limit ($0.02/$0.05 USD) - 2019/09/07 10:35:54 ET
Table 'Scorpius' 6-max Seat #3 is the button
Seat 1: R@ngers94 ($5.12 in chips)
Seat 2: Reignerrr ($5 in chips)
Seat 3: AJalexanderAJ ($9.74 in chips)
Seat 4: PlayTheBlues4U ($5.42 in chips)
Seat 5: joemli3 ($3.23 in chips)
Seat 6: marimba 104 ($3.06 in chips)
PlayTheBlues4U: posts small blind $0.02
joemli3: posts big blind $0.05
*** HOLE CARDS ***
Dealt to PlayTheBlues4U [Kh 4c]
marimba 104: folds
R@ngers94: calls $0.05
Reignerrr: folds
AJalexanderAJ: calls $0.05
PlayTheBlues4U: folds
joemli3: checks
*** FLOP *** [Qd 7s Kd]
joemli3: checks
R@ngers94: checks
AJalexanderAJ: checks
*** TURN *** [Qd 7s Kd] [8d]
joemli3: checks
R@ngers94: checks
AJalexanderAJ: bets $0.25
joemli3: folds
R@ngers94: folds
Uncalled bet ($0.25) returned to AJalexanderAJ
AJalexanderAJ collected $0.16 from pot
AJalexanderAJ: doesn't show hand
*** SUMMARY ***
Total pot $0.17 | Rake $0.01
Board [Qd 7s Kd 8d]
Seat 1: R@ngers94 folded on the Turn
Seat 2: Reignerrr folded before Flop (didn't bet)
Seat 3: AJalexanderAJ (button) collected ($0.16)
Seat 4: PlayTheBlues4U (small blind) folded before Flop
Seat 5: joemli3 (big blind) folded on the Turn
Seat 6: marimba 104 folded before Flop (didn't bet)


*********** # 27 **************
PokerStars Hand #203492935294:  Hold'em No Limit ($0.02/$0.05 USD) - 2019/09/07 10:35:02 ET
Table 'Scorpius' 6-max Seat #2 is the button
Seat 1: R@ngers94 ($5.12 in chips)
Seat 2: Reignerrr ($5 in chips)
Seat 3: AJalexanderAJ ($9.69 in chips)
Seat 4: PlayTheBlues4U ($5.47 in chips)
Seat 5: joemli3 ($3.23 in chips)
Seat 6: marimba 104 ($3.06 in chips)
AJalexanderAJ: posts small blind $0.02
PlayTheBlues4U: posts big blind $0.05
*** HOLE CARDS ***
Dealt to PlayTheBlues4U [4d Qc]
joemli3: folds
marimba 104: folds
R@ngers94: folds
Reignerrr: folds
AJalexanderAJ: calls $0.03
PlayTheBlues4U: checks
*** FLOP *** [Kc 2d Kh]
AJalexanderAJ: checks
PlayTheBlues4U: checks
*** TURN *** [Kc 2d Kh] [7h]
AJalexanderAJ: bets $0.10
PlayTheBlues4U: folds
Uncalled bet ($0.10) returned to AJalexanderAJ
AJalexanderAJ collected $0.10 from pot
AJalexanderAJ: doesn't show hand
*** SUMMARY ***
Total pot $0.10 | Rake $0
Board [Kc 2d Kh 7h]
Seat 1: R@ngers94 folded before Flop (didn't bet)
Seat 2: Reignerrr (button) folded before Flop (didn't bet)
Seat 3: AJalexanderAJ (small blind) collected ($0.10)
Seat 4: PlayTheBlues4U (big blind) folded on the Turn
Seat 5: joemli3 folded before Flop (didn't bet)
Seat 6: marimba 104 folded before Flop (didn't bet)


*********** # 28 **************
PokerStars Hand #203492935244:  Hold'em No Limit ($0.02/$0.05 USD) - 2019/09/07 10:34:22 ET
Table 'Scorpius' 6-max Seat #1 is the button
Seat 1: R@ngers94 ($5.12 in chips)
Seat 2: Reignerrr ($5 in chips)
Seat 3: AJalexanderAJ ($11.38 in chips)
Seat 4: PlayTheBlues4U ($5.47 in chips)
Seat 5: joemli3 ($1.69 in chips)
Seat 6: marimba 104 ($3.06 in chips)
Reignerrr: posts small blind $0.02
AJalexanderAJ: posts big blind $0.05
*** HOLE CARDS ***
Dealt to PlayTheBlues4U [2h 4d]
PlayTheBlues4U: folds
joemli3: raises $0.20 to $0.25
marimba 104: folds
R@ngers94: folds
Reignerrr: folds
AJalexanderAJ: raises $0.75 to $1
joemli3: raises $0.69 to $1.69 and is all-in
AJalexanderAJ: calls $0.69
*** FLOP *** [Js 2c 8c]
*** TURN *** [Js 2c 8c] [4c]
*** RIVER *** [Js 2c 8c 4c] [5d]
*** SHOW DOWN ***
AJalexanderAJ: shows [Tc Th] (a pair of Tens)
joemli3: shows [As Ah] (a pair of Aces)
joemli3 collected $3.23 from pot
*** SUMMARY ***
Total pot $3.40 | Rake $0.17
Board [Js 2c 8c 4c 5d]
Seat 1: R@ngers94 (button) folded before Flop (didn't bet)
Seat 2: Reignerrr (small blind) folded before Flop
Seat 3: AJalexanderAJ (big blind) showed [Tc Th] and lost with a pair of Tens
Seat 4: PlayTheBlues4U folded before Flop (didn't bet)
Seat 5: joemli3 showed [As Ah] and won ($3.23) with a pair of Aces
Seat 6: marimba 104 folded before Flop (didn't bet)


*********** # 29 **************
PokerStars Hand #203492935196:  Hold'em No Limit ($0.02/$0.05 USD) - 2019/09/07 10:33:38 ET
Table 'Scorpius' 6-max Seat #6 is the button
Seat 1: R@ngers94 ($5.17 in chips)
Seat 2: Reignerrr ($5 in chips)
Seat 3: AJalexanderAJ ($11.06 in chips)
Seat 4: PlayTheBlues4U ($5.47 in chips)
Seat 5: joemli3 ($1.94 in chips)
Seat 6: marimba 104 ($3.06 in chips)
R@ngers94: posts small blind $0.02
Reignerrr: posts big blind $0.05
*** HOLE CARDS ***
Dealt to PlayTheBlues4U [7h 4d]
AJalexanderAJ: calls $0.05
PlayTheBlues4U: folds
joemli3: calls $0.05
marimba 104: folds
R@ngers94: calls $0.03
Reignerrr: checks
*** FLOP *** [3h Ac 8d]
R@ngers94: checks
Reignerrr: checks
AJalexanderAJ: bets $0.20
joemli3: calls $0.20
R@ngers94: folds
Reignerrr: folds
*** TURN *** [3h Ac 8d] [Td]
AJalexanderAJ: bets $0.55
joemli3: folds
Uncalled bet ($0.55) returned to AJalexanderAJ
AJalexanderAJ collected $0.57 from pot
AJalexanderAJ: doesn't show hand
*** SUMMARY ***
Total pot $0.60 | Rake $0.03
Board [3h Ac 8d Td]
Seat 1: R@ngers94 (small blind) folded on the Flop
Seat 2: Reignerrr (big blind) folded on the Flop
Seat 3: AJalexanderAJ collected ($0.57)
Seat 4: PlayTheBlues4U folded before Flop (didn't bet)
Seat 5: joemli3 folded on the Turn
Seat 6: marimba 104 (button) folded before Flop (didn't bet)


*********** # 30 **************
PokerStars Hand #203492935154:  Hold'em No Limit ($0.02/$0.05 USD) - 2019/09/07 10:32:49 ET
Table 'Scorpius' 6-max Seat #5 is the button
Seat 1: R@ngers94 ($5.22 in chips)
Seat 2: Reignerrr ($5 in chips)
Seat 3: AJalexanderAJ ($10.74 in chips)
Seat 4: PlayTheBlues4U ($5.47 in chips)
Seat 5: joemli3 ($2.19 in chips)
Seat 6: marimba 104 ($3.11 in chips)
marimba 104: posts small blind $0.02
R@ngers94: posts big blind $0.05
*** HOLE CARDS ***
Dealt to PlayTheBlues4U [Qd 7c]
Reignerrr: folds
AJalexanderAJ: calls $0.05
PlayTheBlues4U: folds
joemli3: calls $0.05
marimba 104: calls $0.03
R@ngers94: checks
*** FLOP *** [9d 4h 2s]
marimba 104: checks
R@ngers94: checks
AJalexanderAJ: checks
joemli3: checks
*** TURN *** [9d 4h 2s] [2h]
marimba 104: checks
R@ngers94: checks
AJalexanderAJ: bets $0.20
joemli3: calls $0.20
marimba 104: folds
R@ngers94: folds
*** RIVER *** [9d 4h 2s 2h] [Kd]
AJalexanderAJ: checks
joemli3: checks
*** SHOW DOWN ***
AJalexanderAJ: shows [Tc 2d] (three of a kind, Deuces)
joemli3: mucks hand
AJalexanderAJ collected $0.57 from pot
*** SUMMARY ***
Total pot $0.60 | Rake $0.03
Board [9d 4h 2s 2h Kd]
Seat 1: R@ngers94 (big blind) folded on the Turn
Seat 2: Reignerrr folded before Flop (didn't bet)
Seat 3: AJalexanderAJ showed [Tc 2d] and won ($0.57) with three of a kind, Deuces
Seat 4: PlayTheBlues4U folded before Flop (didn't bet)
Seat 5: joemli3 (button) mucked [3h 5h]
Seat 6: marimba 104 (small blind) folded on the Turn


*********** # 31 **************
PokerStars Hand #203492935114:  Hold'em No Limit ($0.02/$0.05 USD) - 2019/09/07 10:32:08 ET
Table 'Scorpius' 6-max Seat #4 is the button
Seat 2: Reignerrr ($5 in chips)
Seat 3: AJalexanderAJ ($10.74 in chips)
Seat 4: PlayTheBlues4U ($4.93 in chips)
Seat 5: joemli3 ($2.74 in chips)
Seat 6: marimba 104 ($3.16 in chips)
joemli3: posts small blind $0.02
marimba 104: posts big blind $0.05
*** HOLE CARDS ***
Dealt to PlayTheBlues4U [5h 6s]
Reignerrr: folds
AJalexanderAJ: folds
PlayTheBlues4U: raises $0.10 to $0.15
joemli3: raises $0.25 to $0.40
marimba 104: folds
PlayTheBlues4U: calls $0.25
*** FLOP *** [7c Tc 6c]
joemli3: bets $0.15
PlayTheBlues4U: raises $0.45 to $0.60
joemli3: folds
Uncalled bet ($0.45) returned to PlayTheBlues4U
PlayTheBlues4U collected $1.09 from pot
PlayTheBlues4U: doesn't show hand
*** SUMMARY ***
Total pot $1.15 | Rake $0.06
Board [7c Tc 6c]
Seat 2: Reignerrr folded before Flop (didn't bet)
Seat 3: AJalexanderAJ folded before Flop (didn't bet)
Seat 4: PlayTheBlues4U (button) collected ($1.09)
Seat 5: joemli3 (small blind) folded on the Flop
Seat 6: marimba 104 (big blind) folded before Flop


*********** # 32 **************
PokerStars Hand #203490219978:  Hold'em No Limit ($0.02/$0.05 USD) - 2019/09/07 10:31:35 ET
Table 'Scorpius' 6-max Seat #3 is the button
Seat 1: R@ngers94 ($5.37 in chips)
Seat 2: Reignerrr ($5 in chips)
Seat 3: AJalexanderAJ ($10.30 in chips)
Seat 4: PlayTheBlues4U ($4.95 in chips)
Seat 5: joemli3 ($2.89 in chips)
Seat 6: marimba 104 ($3.16 in chips)
PlayTheBlues4U: posts small blind $0.02
joemli3: posts big blind $0.05
*** HOLE CARDS ***
Dealt to PlayTheBlues4U [2c 4d]
marimba 104: folds
R@ngers94: calls $0.05
Reignerrr: raises $0.10 to $0.15
AJalexanderAJ: calls $0.15
PlayTheBlues4U: folds
joemli3: calls $0.10
R@ngers94: calls $0.10
*** FLOP *** [Jc 2s 6d]
joemli3: checks
R@ngers94: checks
Reignerrr: checks
AJalexanderAJ: bets $0.60
joemli3: folds
R@ngers94: folds
Reignerrr: folds
Uncalled bet ($0.60) returned to AJalexanderAJ
AJalexanderAJ collected $0.59 from pot
AJalexanderAJ: doesn't show hand
*** SUMMARY ***
Total pot $0.62 | Rake $0.03
Board [Jc 2s 6d]
Seat 1: R@ngers94 folded on the Flop
Seat 2: Reignerrr folded on the Flop
Seat 3: AJalexanderAJ (button) collected ($0.59)
Seat 4: PlayTheBlues4U (small blind) folded before Flop
Seat 5: joemli3 (big blind) folded on the Flop
Seat 6: marimba 104 folded before Flop (didn't bet)


*********** # 33 **************
PokerStars Hand #203490219965:  Hold'em No Limit ($0.02/$0.05 USD) - 2019/09/07 10:31:16 ET
Table 'Scorpius' 6-max Seat #2 is the button
Seat 1: R@ngers94 ($5.30 in chips)
Seat 2: Reignerrr ($5 in chips)
Seat 3: AJalexanderAJ ($10.32 in chips)
Seat 4: PlayTheBlues4U ($5 in chips)
Seat 5: joemli3 ($2.89 in chips)
Seat 6: marimba 104 ($3.16 in chips)
AJalexanderAJ: posts small blind $0.02
PlayTheBlues4U: posts big blind $0.05
*** HOLE CARDS ***
Dealt to PlayTheBlues4U [8d 3d]
joemli3: folds
marimba 104: folds
R@ngers94: raises $0.10 to $0.15
Reignerrr: folds
AJalexanderAJ: folds
PlayTheBlues4U: folds
Uncalled bet ($0.10) returned to R@ngers94
R@ngers94 collected $0.12 from pot
R@ngers94: doesn't show hand
*** SUMMARY ***
Total pot $0.12 | Rake $0
Seat 1: R@ngers94 collected ($0.12)
Seat 2: Reignerrr (button) folded before Flop (didn't bet)
Seat 3: AJalexanderAJ (small blind) folded before Flop
Seat 4: PlayTheBlues4U (big blind) folded before Flop
Seat 5: joemli3 folded before Flop (didn't bet)
Seat 6: marimba 104 folded before Flop (didn't bet)


*********** # 34 **************
PokerStars Hand #203471893479:  Hold'em No Limit ($0.01/$0.02 USD) - 2019/09/06 21:48:00 ET
Table 'Pegasus' 6-max Seat #1 is the button
Seat 1: michelina44 ($0.42 in chips)
Seat 2: WillDuane ($2.03 in chips)
Seat 3: jjbenzky ($3.59 in chips)
Seat 4: PlayTheBlues4U ($4.41 in chips)
Seat 5: tsov252525 ($2.67 in chips)
Seat 6: TheWalrus435 ($2.57 in chips)
WillDuane: posts small blind $0.01
jjbenzky: posts big blind $0.02
*** HOLE CARDS ***
Dealt to PlayTheBlues4U [Kc 3h]
PlayTheBlues4U: folds
tsov252525: folds
TheWalrus435: calls $0.02
PlayTheBlues4U leaves the table
michelina44: folds
WillDuane: calls $0.01
jjbenzky: checks
*** FLOP *** [3d Td 2d]
WillDuane: checks
jjbenzky: checks
FaceIt00 joins the table at seat #4
TheWalrus435: checks
*** TURN *** [3d Td 2d] [4s]
WillDuane: checks
jjbenzky: checks
TheWalrus435: checks
*** RIVER *** [3d Td 2d 4s] [7d]
WillDuane: bets $0.02
jjbenzky: calls $0.02
TheWalrus435: folds
*** SHOW DOWN ***
WillDuane: shows [Qd 8d] (a flush, Queen high)
jjbenzky: mucks hand
WillDuane collected $0.10 from pot
*** SUMMARY ***
Total pot $0.10 | Rake $0
Board [3d Td 2d 4s 7d]
Seat 1: michelina44 (button) folded before Flop (didn't bet)
Seat 2: WillDuane (small blind) showed [Qd 8d] and won ($0.10) with a flush, Queen high
Seat 3: jjbenzky (big blind) mucked [7h Jh]
Seat 4: PlayTheBlues4U folded before Flop (didn't bet)
Seat 5: tsov252525 folded before Flop (didn't bet)
Seat 6: TheWalrus435 folded on the River


*********** # 35 **************
PokerStars Hand #203471893252:  Hold'em No Limit ($0.01/$0.02 USD) - 2019/09/06 21:46:45 ET
Table 'Pegasus' 6-max Seat #6 is the button
Seat 1: michelina44 ($0.43 in chips)
Seat 2: WillDuane ($2.07 in chips)
Seat 3: jjbenzky ($3.69 in chips)
Seat 4: PlayTheBlues4U ($4.41 in chips)
Seat 5: tsov252525 ($2.53 in chips)
Seat 6: TheWalrus435 ($2.57 in chips)
michelina44: posts small blind $0.01
WillDuane: posts big blind $0.02
*** HOLE CARDS ***
Dealt to PlayTheBlues4U [Qh 3c]
jjbenzky: raises $0.02 to $0.04
PlayTheBlues4U: folds
tsov252525: calls $0.04
TheWalrus435: folds
michelina44: folds
WillDuane: calls $0.02
*** FLOP *** [6d 6c 4c]
WillDuane: checks
jjbenzky: checks
tsov252525: bets $0.06
WillDuane: folds
jjbenzky: calls $0.06
*** TURN *** [6d 6c 4c] [3s]
jjbenzky: checks
tsov252525: bets $0.24
jjbenzky: folds
Uncalled bet ($0.24) returned to tsov252525
tsov252525 collected $0.24 from pot
tsov252525: doesn't show hand
*** SUMMARY ***
Total pot $0.25 | Rake $0.01
Board [6d 6c 4c 3s]
Seat 1: michelina44 (small blind) folded before Flop
Seat 2: WillDuane (big blind) folded on the Flop
Seat 3: jjbenzky folded on the Turn
Seat 4: PlayTheBlues4U folded before Flop (didn't bet)
Seat 5: tsov252525 collected ($0.24)
Seat 6: TheWalrus435 (button) folded before Flop (didn't bet)


*********** # 36 **************
PokerStars Hand #203471893149:  Hold'em No Limit ($0.01/$0.02 USD) - 2019/09/06 21:46:07 ET
Table 'Pegasus' 6-max Seat #5 is the button
Seat 1: michelina44 ($0.45 in chips)
Seat 2: WillDuane ($2.07 in chips)
Seat 3: jjbenzky ($3.81 in chips)
Seat 4: PlayTheBlues4U ($4.41 in chips)
Seat 5: tsov252525 ($2.53 in chips)
Seat 6: TheWalrus435 ($2.44 in chips)
TheWalrus435: posts small blind $0.01
michelina44: posts big blind $0.02
*** HOLE CARDS ***
Dealt to PlayTheBlues4U [3s 4c]
WillDuane: folds
jjbenzky: calls $0.02
PlayTheBlues4U: folds
tsov252525: folds
TheWalrus435: calls $0.01
michelina44: checks
*** FLOP *** [4d 2d 5h]
TheWalrus435: checks
michelina44: checks
jjbenzky: checks
*** TURN *** [4d 2d 5h] [7d]
TheWalrus435: bets $0.10
michelina44: folds
jjbenzky: calls $0.10
*** RIVER *** [4d 2d 5h 7d] [9h]
TheWalrus435: bets $0.25
jjbenzky: folds
Uncalled bet ($0.25) returned to TheWalrus435
TheWalrus435 collected $0.25 from pot
*** SUMMARY ***
Total pot $0.26 | Rake $0.01
Board [4d 2d 5h 7d 9h]
Seat 1: michelina44 (big blind) folded on the Turn
Seat 2: WillDuane folded before Flop (didn't bet)
Seat 3: jjbenzky folded on the River
Seat 4: PlayTheBlues4U folded before Flop (didn't bet)
Seat 5: tsov252525 (button) folded before Flop (didn't bet)
Seat 6: TheWalrus435 (small blind) collected ($0.25)


*********** # 37 **************
PokerStars Hand #203470999941:  Hold'em No Limit ($0.01/$0.02 USD) - 2019/09/06 21:44:53 ET
Table 'Pegasus' 6-max Seat #4 is the button
Seat 1: michelina44 ($0.45 in chips)
Seat 2: WillDuane ($2.17 in chips)
Seat 3: jjbenzky ($3.81 in chips)
Seat 4: PlayTheBlues4U ($4.47 in chips)
Seat 5: tsov252525 ($2.36 in chips)
Seat 6: TheWalrus435 ($2.46 in chips)
tsov252525: posts small blind $0.01
TheWalrus435: posts big blind $0.02
*** HOLE CARDS ***
Dealt to PlayTheBlues4U [Qc Ks]
michelina44: folds
WillDuane: raises $0.04 to $0.06
jjbenzky: folds
PlayTheBlues4U: calls $0.06
tsov252525: calls $0.05
TheWalrus435: folds
*** FLOP *** [8c Ad 4c]
tsov252525: checks
WillDuane: bets $0.02
PlayTheBlues4U: folds
tsov252525: calls $0.02
*** TURN *** [8c Ad 4c] [9h]
tsov252525: checks
WillDuane: bets $0.02
tsov252525: raises $0.14 to $0.16
WillDuane: folds
Uncalled bet ($0.14) returned to tsov252525
tsov252525 collected $0.27 from pot
tsov252525: doesn't show hand
*** SUMMARY ***
Total pot $0.28 | Rake $0.01
Board [8c Ad 4c 9h]
Seat 1: michelina44 folded before Flop (didn't bet)
Seat 2: WillDuane folded on the Turn
Seat 3: jjbenzky folded before Flop (didn't bet)
Seat 4: PlayTheBlues4U (button) folded on the Flop
Seat 5: tsov252525 (small blind) collected ($0.27)
Seat 6: TheWalrus435 (big blind) folded before Flop


*********** # 38 **************
PokerStars Hand #203470999721:  Hold'em No Limit ($0.01/$0.02 USD) - 2019/09/06 21:43:39 ET
Table 'Pegasus' 6-max Seat #3 is the button
Seat 1: michelina44 ($0.45 in chips)
Seat 2: WillDuane ($2.19 in chips)
Seat 3: jjbenzky ($3.39 in chips)
Seat 4: PlayTheBlues4U ($4.87 in chips)
Seat 5: tsov252525 ($2.38 in chips)
Seat 6: TheWalrus435 ($2.48 in chips)
PlayTheBlues4U: posts small blind $0.01
tsov252525: posts big blind $0.02
*** HOLE CARDS ***
Dealt to PlayTheBlues4U [2s Ac]
TheWalrus435: calls $0.02
michelina44: folds
WillDuane: calls $0.02
jjbenzky: calls $0.02
PlayTheBlues4U: calls $0.01
tsov252525: checks
*** FLOP *** [2c 3c Qd]
PlayTheBlues4U: checks
tsov252525: checks
TheWalrus435: checks
WillDuane: checks
jjbenzky: checks
*** TURN *** [2c 3c Qd] [2d]
PlayTheBlues4U: bets $0.10
tsov252525: folds
TheWalrus435: folds
WillDuane: folds
jjbenzky: calls $0.10
*** RIVER *** [2c 3c Qd 2d] [3h]
PlayTheBlues4U: bets $0.28
jjbenzky: calls $0.28
*** SHOW DOWN ***
PlayTheBlues4U: shows [2s Ac] (a full house, Deuces full of Threes)
jjbenzky: shows [9d 3d] (a full house, Threes full of Deuces)
jjbenzky collected $0.82 from pot
*** SUMMARY ***
Total pot $0.86 | Rake $0.04
Board [2c 3c Qd 2d 3h]
Seat 1: michelina44 folded before Flop (didn't bet)
Seat 2: WillDuane folded on the Turn
Seat 3: jjbenzky (button) showed [9d 3d] and won ($0.82) with a full house, Threes full of Deuces
Seat 4: PlayTheBlues4U (small blind) showed [2s Ac] and lost with a full house, Deuces full of Threes
Seat 5: tsov252525 (big blind) folded on the Turn
Seat 6: TheWalrus435 folded on the Turn


*********** # 39 **************
PokerStars Hand #203470999467:  Hold'em No Limit ($0.02/$0.05 USD) - 2019/09/06 21:42:09 ET
Table 'Icarus' 6-max Seat #3 is the button
Seat 1: bobca1944 ($2.61 in chips)
Seat 2: PlayTheBlues4U ($4.93 in chips)
Seat 3: FishyFlopp ($7.25 in chips)
Seat 6: DemolishIT ($10.08 in chips)
copierking35 will be allowed to play after the button
andreybhr will be allowed to play after the button
DemolishIT: posts small blind $0.02
bobca1944: posts big blind $0.05
*** HOLE CARDS ***
Dealt to PlayTheBlues4U [Js Qh]
PlayTheBlues4U: calls $0.05
FishyFlopp: folds
DemolishIT: calls $0.03
bobca1944: raises $0.15 to $0.20
PlayTheBlues4U: folds
DemolishIT: folds
Uncalled bet ($0.15) returned to bobca1944
bobca1944 collected $0.15 from pot
bobca1944: doesn't show hand
*** SUMMARY ***
Total pot $0.15 | Rake $0
Seat 1: bobca1944 (big blind) collected ($0.15)
Seat 2: PlayTheBlues4U folded before Flop
Seat 3: FishyFlopp (button) folded before Flop (didn't bet)
Seat 6: DemolishIT (small blind) folded before Flop


*********** # 40 **************
PokerStars Hand #203470999440:  Hold'em No Limit ($0.01/$0.02 USD) - 2019/09/06 21:41:59 ET
Table 'Pegasus' 6-max Seat #2 is the button
Seat 1: michelina44 ($0.45 in chips)
Seat 2: WillDuane ($1.91 in chips)
Seat 3: jjbenzky ($3.49 in chips)
Seat 4: PlayTheBlues4U ($4.97 in chips)
Seat 5: tsov252525 ($2.48 in chips)
Seat 6: TheWalrus435 ($2.48 in chips)
jjbenzky: posts small blind $0.01
PlayTheBlues4U: posts big blind $0.02
*** HOLE CARDS ***
Dealt to PlayTheBlues4U [Ts Ah]
tsov252525: raises $0.04 to $0.06
TheWalrus435: folds
michelina44: folds
WillDuane: calls $0.06
jjbenzky: calls $0.05
PlayTheBlues4U: calls $0.04
*** FLOP *** [2c 4s 5s]
jjbenzky: checks
PlayTheBlues4U: checks
tsov252525: checks
WillDuane: bets $0.02
jjbenzky: calls $0.02
PlayTheBlues4U: calls $0.02
tsov252525: calls $0.02
*** TURN *** [2c 4s 5s] [9c]
jjbenzky: checks
PlayTheBlues4U: checks
tsov252525: checks
WillDuane: bets $0.02
jjbenzky: calls $0.02
PlayTheBlues4U: calls $0.02
tsov252525: calls $0.02
*** RIVER *** [2c 4s 5s 9c] [Kh]
jjbenzky: checks
PlayTheBlues4U: checks
tsov252525: checks
WillDuane: bets $0.18
jjbenzky: folds
PlayTheBlues4U: folds
tsov252525: folds
Uncalled bet ($0.18) returned to WillDuane
WillDuane collected $0.38 from pot
WillDuane: doesn't show hand
*** SUMMARY ***
Total pot $0.40 | Rake $0.02
Board [2c 4s 5s 9c Kh]
Seat 1: michelina44 folded before Flop (didn't bet)
Seat 2: WillDuane (button) collected ($0.38)
Seat 3: jjbenzky (small blind) folded on the River
Seat 4: PlayTheBlues4U (big blind) folded on the River
Seat 5: tsov252525 folded on the River
Seat 6: TheWalrus435 folded before Flop (didn't bet)


*********** # 41 **************
PokerStars Hand #203470999405:  Hold'em No Limit ($0.02/$0.05 USD) - 2019/09/06 21:41:49 ET
Table 'Icarus' 6-max Seat #2 is the button
Seat 1: bobca1944 ($2.61 in chips)
Seat 2: PlayTheBlues4U ($4.93 in chips)
Seat 3: FishyFlopp ($7.20 in chips)
Seat 6: DemolishIT ($10.13 in chips)
FishyFlopp: posts small blind $0.02
DemolishIT: posts big blind $0.05
*** HOLE CARDS ***
Dealt to PlayTheBlues4U [3h Qc]
bobca1944: folds
PlayTheBlues4U: folds
copierking35 joins the table at seat #4
FishyFlopp: raises $0.17 to $0.22
andreybhr joins the table at seat #5
DemolishIT: folds
Uncalled bet ($0.17) returned to FishyFlopp
FishyFlopp collected $0.10 from pot
FishyFlopp: doesn't show hand
*** SUMMARY ***
Total pot $0.10 | Rake $0
Seat 1: bobca1944 folded before Flop (didn't bet)
Seat 2: PlayTheBlues4U (button) folded before Flop (didn't bet)
Seat 3: FishyFlopp (small blind) collected ($0.10)
Seat 6: DemolishIT (big blind) folded before Flop


*********** # 42 **************
PokerStars Hand #203470999283:  Hold'em No Limit ($0.02/$0.05 USD) - 2019/09/06 21:41:06 ET
Table 'Icarus' 6-max Seat #1 is the button
Seat 1: bobca1944 ($2.83 in chips)
Seat 2: PlayTheBlues4U ($4.95 in chips)
Seat 3: FishyFlopp ($6.77 in chips)
Seat 6: DemolishIT ($10.35 in chips)
PlayTheBlues4U: posts small blind $0.02
FishyFlopp: posts big blind $0.05
*** HOLE CARDS ***
Dealt to PlayTheBlues4U [Kc 2c]
DemolishIT: calls $0.05
bobca1944: calls $0.05
PlayTheBlues4U: folds
FishyFlopp: raises $0.17 to $0.22
DemolishIT: calls $0.17
bobca1944: calls $0.17
*** FLOP *** [Jc Ts 3h]
FishyFlopp: bets $0.52
DemolishIT: folds
bobca1944: folds
Uncalled bet ($0.52) returned to FishyFlopp
FishyFlopp collected $0.65 from pot
FishyFlopp: doesn't show hand
*** SUMMARY ***
Total pot $0.68 | Rake $0.03
Board [Jc Ts 3h]
Seat 1: bobca1944 (button) folded on the Flop
Seat 2: PlayTheBlues4U (small blind) folded before Flop
Seat 3: FishyFlopp (big blind) collected ($0.65)
Seat 6: DemolishIT folded on the Flop


*********** # 43 **************
PokerStars Hand #203470999246:  Hold'em No Limit ($0.02/$0.05 USD) - 2019/09/06 21:40:56 ET
Table 'Icarus' 6-max Seat #6 is the button
Seat 1: bobca1944 ($2.85 in chips)
Seat 2: PlayTheBlues4U ($4.93 in chips)
Seat 3: FishyFlopp ($6.77 in chips)
Seat 6: DemolishIT ($10.35 in chips)
bobca1944: posts small blind $0.02
PlayTheBlues4U: posts big blind $0.05
*** HOLE CARDS ***
Dealt to PlayTheBlues4U [9h 4h]
FishyFlopp: folds
DemolishIT: folds
bobca1944: folds
Uncalled bet ($0.03) returned to PlayTheBlues4U
rand60 leaves the table
PlayTheBlues4U collected $0.04 from pot
PlayTheBlues4U: doesn't show hand
*** SUMMARY ***
Total pot $0.04 | Rake $0
Seat 1: bobca1944 (small blind) folded before Flop
Seat 2: PlayTheBlues4U (big blind) collected ($0.04)
Seat 3: FishyFlopp folded before Flop (didn't bet)
Seat 6: DemolishIT (button) folded before Flop (didn't bet)


*********** # 44 **************
PokerStars Hand #203470999242:  Hold'em No Limit ($0.01/$0.02 USD) - 2019/09/06 21:40:56 ET
Table 'Pegasus' 6-max Seat #1 is the button
Seat 1: michelina44 ($0.45 in chips)
Seat 2: WillDuane ($1.92 in chips)
Seat 3: jjbenzky ($3.64 in chips)
Seat 4: PlayTheBlues4U ($4.97 in chips)
Seat 5: tsov252525 ($2.28 in chips)
Seat 6: TheWalrus435 ($2.54 in chips)
WillDuane: posts small blind $0.01
jjbenzky: posts big blind $0.02
*** HOLE CARDS ***
Dealt to PlayTheBlues4U [Td Qc]
PlayTheBlues4U: folds
tsov252525: raises $0.04 to $0.06
TheWalrus435: calls $0.06
michelina44: folds
WillDuane: folds
jjbenzky: calls $0.04
*** FLOP *** [4h Th 4c]
jjbenzky: checks
tsov252525: bets $0.09
TheWalrus435: folds
jjbenzky: calls $0.09
*** TURN *** [4h Th 4c] [9c]
jjbenzky: checks
tsov252525: checks
*** RIVER *** [4h Th 4c 9c] [3h]
jjbenzky: checks
tsov252525: bets $0.18
jjbenzky: folds
Uncalled bet ($0.18) returned to tsov252525
tsov252525 collected $0.35 from pot
tsov252525: doesn't show hand
*** SUMMARY ***
Total pot $0.37 | Rake $0.02
Board [4h Th 4c 9c 3h]
Seat 1: michelina44 (button) folded before Flop (didn't bet)
Seat 2: WillDuane (small blind) folded before Flop
Seat 3: jjbenzky (big blind) folded on the River
Seat 4: PlayTheBlues4U folded before Flop (didn't bet)
Seat 5: tsov252525 collected ($0.35)
Seat 6: TheWalrus435 folded on the Flop


*********** # 45 **************
PokerStars Hand #203470999182:  Hold'em No Limit ($0.01/$0.02 USD) - 2019/09/06 21:40:32 ET
Table 'Pegasus' 6-max Seat #6 is the button
Seat 1: michelina44 ($0.46 in chips)
Seat 2: WillDuane ($1.94 in chips)
Seat 3: jjbenzky ($3.66 in chips)
Seat 4: PlayTheBlues4U ($4.92 in chips)
Seat 5: tsov252525 ($2.28 in chips)
Seat 6: TheWalrus435 ($2.54 in chips)
michelina44: posts small blind $0.01
WillDuane: posts big blind $0.02
*** HOLE CARDS ***
Dealt to PlayTheBlues4U [9h 9c]
jjbenzky: calls $0.02
PlayTheBlues4U: raises $0.12 to $0.14
tsov252525: folds
TheWalrus435: folds
michelina44: folds
WillDuane: folds
jjbenzky: folds
Uncalled bet ($0.12) returned to PlayTheBlues4U
PlayTheBlues4U collected $0.07 from pot
PlayTheBlues4U: doesn't show hand
*** SUMMARY ***
Total pot $0.07 | Rake $0
Seat 1: michelina44 (small blind) folded before Flop
Seat 2: WillDuane (big blind) folded before Flop
Seat 3: jjbenzky folded before Flop
Seat 4: PlayTheBlues4U collected ($0.07)
Seat 5: tsov252525 folded before Flop (didn't bet)
Seat 6: TheWalrus435 (button) folded before Flop (didn't bet)


*********** # 46 **************
PokerStars Hand #203470999056:  Hold'em No Limit ($0.01/$0.02 USD) - 2019/09/06 21:39:53 ET
Table 'Pegasus' 6-max Seat #5 is the button
Seat 1: michelina44 ($0.48 in chips)
Seat 2: WillDuane ($1.94 in chips)
Seat 3: jjbenzky ($3.74 in chips)
Seat 4: PlayTheBlues4U ($4.82 in chips)
Seat 5: tsov252525 ($2.28 in chips)
Seat 6: TheWalrus435 ($2.55 in chips)
TheWalrus435: posts small blind $0.01
michelina44: posts big blind $0.02
*** HOLE CARDS ***
Dealt to PlayTheBlues4U [Jd Ah]
WillDuane: folds
jjbenzky: calls $0.02
PlayTheBlues4U: raises $0.06 to $0.08
tsov252525: folds
TheWalrus435: folds
michelina44: folds
jjbenzky: calls $0.06
*** FLOP *** [Th 7h 4d]
jjbenzky: checks
PlayTheBlues4U: bets $0.08
jjbenzky: folds
Uncalled bet ($0.08) returned to PlayTheBlues4U
PlayTheBlues4U collected $0.18 from pot
PlayTheBlues4U: doesn't show hand
*** SUMMARY ***
Total pot $0.19 | Rake $0.01
Board [Th 7h 4d]
Seat 1: michelina44 (big blind) folded before Flop
Seat 2: WillDuane folded before Flop (didn't bet)
Seat 3: jjbenzky folded on the Flop
Seat 4: PlayTheBlues4U collected ($0.18)
Seat 5: tsov252525 (button) folded before Flop (didn't bet)
Seat 6: TheWalrus435 (small blind) folded before Flop


*********** # 47 **************
PokerStars Hand #203470999030:  Hold'em No Limit ($0.02/$0.05 USD) - 2019/09/06 21:39:45 ET
Table 'Icarus' 6-max Seat #3 is the button
Seat 1: bobca1944 ($2.85 in chips)
Seat 2: PlayTheBlues4U ($4.93 in chips)
Seat 3: FishyFlopp ($6.96 in chips)
Seat 4: rand60 ($4.89 in chips)
Seat 6: DemolishIT ($10.54 in chips)
rand60: posts small blind $0.02
DemolishIT: posts big blind $0.05
*** HOLE CARDS ***
Dealt to PlayTheBlues4U [7h Tc]
bobca1944: folds
PlayTheBlues4U: folds
FishyFlopp: calls $0.05
rand60: calls $0.03
DemolishIT: checks
*** FLOP *** [6c 4h 5h]
rand60: checks
DemolishIT: checks
FishyFlopp: bets $0.14
rand60: calls $0.14
DemolishIT: calls $0.14
*** TURN *** [6c 4h 5h] [5d]
rand60: checks
DemolishIT: checks
FishyFlopp: checks
*** RIVER *** [6c 4h 5h 5d] [Th]
rand60: bets $0.54
DemolishIT: folds
FishyFlopp: folds
Uncalled bet ($0.54) returned to rand60
rand60 collected $0.54 from pot
rand60: doesn't show hand
*** SUMMARY ***
Total pot $0.57 | Rake $0.03
Board [6c 4h 5h 5d Th]
Seat 1: bobca1944 folded before Flop (didn't bet)
Seat 2: PlayTheBlues4U folded before Flop (didn't bet)
Seat 3: FishyFlopp (button) folded on the River
Seat 4: rand60 (small blind) collected ($0.54)
Seat 6: DemolishIT (big blind) folded on the River


*********** # 48 **************
PokerStars Hand #203470998913:  Hold'em No Limit ($0.02/$0.05 USD) - 2019/09/06 21:39:04 ET
Table 'Icarus' 6-max Seat #2 is the button
Seat 1: bobca1944 ($2.59 in chips)
Seat 2: PlayTheBlues4U ($4.93 in chips)
Seat 3: FishyFlopp ($6.98 in chips)
Seat 4: rand60 ($4.94 in chips)
Seat 5: DeccaDan ($12.15 in chips)
Seat 6: DemolishIT ($10.76 in chips)
FishyFlopp: posts small blind $0.02
rand60: posts big blind $0.05
*** HOLE CARDS ***
Dealt to PlayTheBlues4U [5c Th]
DeccaDan: folds
DemolishIT: calls $0.05
DeccaDan leaves the table
bobca1944: raises $0.17 to $0.22
PlayTheBlues4U: folds
FishyFlopp: folds
rand60: folds
DemolishIT: calls $0.17
*** FLOP *** [3d 8c 8s]
DemolishIT: checks
bobca1944: bets $0.24
DemolishIT: folds
Uncalled bet ($0.24) returned to bobca1944
bobca1944 collected $0.48 from pot
bobca1944: doesn't show hand
*** SUMMARY ***
Total pot $0.51 | Rake $0.03
Board [3d 8c 8s]
Seat 1: bobca1944 collected ($0.48)
Seat 2: PlayTheBlues4U (button) folded before Flop (didn't bet)
Seat 3: FishyFlopp (small blind) folded before Flop
Seat 4: rand60 (big blind) folded before Flop
Seat 5: DeccaDan folded before Flop (didn't bet)
Seat 6: DemolishIT folded on the Flop


*********** # 49 **************
PokerStars Hand #203470998829:  Hold'em No Limit ($0.01/$0.02 USD) - 2019/09/06 21:38:34 ET
Table 'Pegasus' 6-max Seat #4 is the button
Seat 1: michelina44 ($0.52 in chips)
Seat 2: WillDuane ($1.94 in chips)
Seat 3: jjbenzky ($3.66 in chips)
Seat 4: PlayTheBlues4U ($4.82 in chips)
Seat 5: tsov252525 ($2.29 in chips)
Seat 6: TheWalrus435 ($2.59 in chips)
tsov252525: posts small blind $0.01
TheWalrus435: posts big blind $0.02
*** HOLE CARDS ***
Dealt to PlayTheBlues4U [9s Qd]
michelina44: raises $0.02 to $0.04
WillDuane: folds
jjbenzky: calls $0.04
PlayTheBlues4U: folds
tsov252525: folds
TheWalrus435: calls $0.02
*** FLOP *** [2d 6d 8d]
TheWalrus435: checks
michelina44: checks
jjbenzky: checks
*** TURN *** [2d 6d 8d] [Tc]
TheWalrus435: checks
michelina44: checks
jjbenzky: checks
*** RIVER *** [2d 6d 8d Tc] [Jd]
TheWalrus435: checks
michelina44: checks
jjbenzky: bets $0.12
TheWalrus435: folds
michelina44: folds
Uncalled bet ($0.12) returned to jjbenzky
jjbenzky collected $0.12 from pot
jjbenzky: doesn't show hand
*** SUMMARY ***
Total pot $0.13 | Rake $0.01
Board [2d 6d 8d Tc Jd]
Seat 1: michelina44 folded on the River
Seat 2: WillDuane folded before Flop (didn't bet)
Seat 3: jjbenzky collected ($0.12)
Seat 4: PlayTheBlues4U (button) folded before Flop (didn't bet)
Seat 5: tsov252525 (small blind) folded before Flop
Seat 6: TheWalrus435 (big blind) folded on the River


*********** # 50 **************
PokerStars Hand #203470998714:  Hold'em No Limit ($0.02/$0.05 USD) - 2019/09/06 21:37:58 ET
Table 'Icarus' 6-max Seat #1 is the button
Seat 1: bobca1944 ($2.59 in chips)
Seat 2: PlayTheBlues4U ($4.95 in chips)
Seat 3: FishyFlopp ($7.08 in chips)
Seat 4: rand60 ($4.83 in chips)
Seat 5: DeccaDan ($12.15 in chips)
Seat 6: DemolishIT ($10.76 in chips)
PlayTheBlues4U: posts small blind $0.02
FishyFlopp: posts big blind $0.05
*** HOLE CARDS ***
Dealt to PlayTheBlues4U [2s Qd]
rand60: raises $0.05 to $0.10
DeccaDan: folds
DemolishIT: folds
bobca1944: folds
PlayTheBlues4U: folds
FishyFlopp: calls $0.05
*** FLOP *** [Kd 7s 3h]
FishyFlopp: checks
rand60: checks
*** TURN *** [Kd 7s 3h] [3c]
FishyFlopp: checks
rand60: checks
*** RIVER *** [Kd 7s 3h 3c] [Jd]
FishyFlopp: checks
rand60: bets $0.21
FishyFlopp: folds
Uncalled bet ($0.21) returned to rand60
rand60 collected $0.21 from pot
rand60: doesn't show hand
*** SUMMARY ***
Total pot $0.22 | Rake $0.01
Board [Kd 7s 3h 3c Jd]
Seat 1: bobca1944 (button) folded before Flop (didn't bet)
Seat 2: PlayTheBlues4U (small blind) folded before Flop
Seat 3: FishyFlopp (big blind) folded on the River
Seat 4: rand60 collected ($0.21)
Seat 5: DeccaDan folded before Flop (didn't bet)
Seat 6: DemolishIT folded before Flop (didn't bet)


*********** # 51 **************
PokerStars Hand #203470998702:  Hold'em No Limit ($0.01/$0.02 USD) - 2019/09/06 21:37:53 ET
Table 'Pegasus' 6-max Seat #3 is the button
Seat 1: michelina44 ($0.52 in chips)
Seat 2: WillDuane ($1.94 in chips)
Seat 3: jjbenzky ($3.68 in chips)
Seat 4: PlayTheBlues4U ($4.78 in chips)
Seat 5: tsov252525 ($2.31 in chips)
Seat 6: TheWalrus435 ($2.59 in chips)
PlayTheBlues4U: posts small blind $0.01
tsov252525: posts big blind $0.02
*** HOLE CARDS ***
Dealt to PlayTheBlues4U [Ad Kh]
TheWalrus435: folds
michelina44: folds
WillDuane: folds
jjbenzky: calls $0.02
PlayTheBlues4U: calls $0.01
tsov252525: checks
*** FLOP *** [9c 3h Ks]
PlayTheBlues4U: bets $0.08
tsov252525: folds
jjbenzky: folds
Uncalled bet ($0.08) returned to PlayTheBlues4U
PlayTheBlues4U collected $0.06 from pot
PlayTheBlues4U: doesn't show hand
*** SUMMARY ***
Total pot $0.06 | Rake $0
Board [9c 3h Ks]
Seat 1: michelina44 folded before Flop (didn't bet)
Seat 2: WillDuane folded before Flop (didn't bet)
Seat 3: jjbenzky (button) folded on the Flop
Seat 4: PlayTheBlues4U (small blind) collected ($0.06)
Seat 5: tsov252525 (big blind) folded on the Flop
Seat 6: TheWalrus435 folded before Flop (didn't bet)


*********** # 52 **************
PokerStars Hand #203470998557:  Hold'em No Limit ($0.02/$0.05 USD) - 2019/09/06 21:37:07 ET
Table 'Icarus' 6-max Seat #6 is the button
Seat 1: bobca1944 ($2.64 in chips)
Seat 2: PlayTheBlues4U ($5 in chips)
Seat 3: FishyFlopp ($7.08 in chips)
Seat 4: rand60 ($4.83 in chips)
Seat 5: DeccaDan ($12.15 in chips)
Seat 6: DemolishIT ($10.67 in chips)
bobca1944: posts small blind $0.02
PlayTheBlues4U: posts big blind $0.05
*** HOLE CARDS ***
Dealt to PlayTheBlues4U [3d Ks]
FishyFlopp: folds
rand60: folds
DeccaDan: folds
DemolishIT: calls $0.05
bobca1944: calls $0.03
PlayTheBlues4U: checks
*** FLOP *** [Kd As 8c]
bobca1944: checks
PlayTheBlues4U: checks
DemolishIT: bets $0.14
bobca1944: folds
PlayTheBlues4U: folds
Uncalled bet ($0.14) returned to DemolishIT
DemolishIT collected $0.14 from pot
*** SUMMARY ***
Total pot $0.15 | Rake $0.01
Board [Kd As 8c]
Seat 1: bobca1944 (small blind) folded on the Flop
Seat 2: PlayTheBlues4U (big blind) folded on the Flop
Seat 3: FishyFlopp folded before Flop (didn't bet)
Seat 4: rand60 folded before Flop (didn't bet)
Seat 5: DeccaDan folded before Flop (didn't bet)
Seat 6: DemolishIT (button) collected ($0.14)


*********** # 53 **************
PokerStars Hand #203470998469:  Hold'em No Limit ($0.02/$0.05 USD) - 2019/09/06 21:36:35 ET
Table 'Icarus' 6-max Seat #5 is the button
Seat 1: bobca1944 ($2.89 in chips)
Seat 2: PlayTheBlues4U ($5 in chips)
Seat 3: FishyFlopp ($7.08 in chips)
Seat 4: rand60 ($4.83 in chips)
Seat 5: DeccaDan ($12.15 in chips)
Seat 6: DemolishIT ($10.44 in chips)
DemolishIT: posts small blind $0.02
bobca1944: posts big blind $0.05
*** HOLE CARDS ***
Dealt to PlayTheBlues4U [4s 3s]
PlayTheBlues4U: folds
FishyFlopp: folds
rand60: folds
DeccaDan: folds
DemolishIT: raises $0.20 to $0.25
bobca1944: calls $0.20
*** FLOP *** [Ts 8c 2s]
DemolishIT: bets $0.48
bobca1944: folds
Uncalled bet ($0.48) returned to DemolishIT
DemolishIT collected $0.48 from pot
*** SUMMARY ***
Total pot $0.50 | Rake $0.02
Board [Ts 8c 2s]
Seat 1: bobca1944 (big blind) folded on the Flop
Seat 2: PlayTheBlues4U folded before Flop (didn't bet)
Seat 3: FishyFlopp folded before Flop (didn't bet)
Seat 4: rand60 folded before Flop (didn't bet)
Seat 5: DeccaDan (button) folded before Flop (didn't bet)
Seat 6: DemolishIT (small blind) collected ($0.48)


*********** # 54 **************
PokerStars Hand #203470998443:  Hold'em No Limit ($0.01/$0.02 USD) - 2019/09/06 21:36:27 ET
Table 'Pegasus' 6-max Seat #2 is the button
Seat 1: michelina44 ($0.52 in chips)
Seat 2: WillDuane ($1.96 in chips)
Seat 3: jjbenzky ($4 in chips)
Seat 4: PlayTheBlues4U ($4.45 in chips)
Seat 5: tsov252525 ($2.31 in chips)
Seat 6: TheWalrus435 ($2.61 in chips)
jjbenzky: posts small blind $0.01
PlayTheBlues4U: posts big blind $0.02
*** HOLE CARDS ***
Dealt to PlayTheBlues4U [2d Qd]
tsov252525: folds
TheWalrus435: calls $0.02
michelina44: folds
WillDuane: calls $0.02
jjbenzky: calls $0.01
PlayTheBlues4U: checks
*** FLOP *** [5d Jd 3d]
jjbenzky: checks
PlayTheBlues4U: bets $0.08
TheWalrus435: folds
WillDuane: folds
jjbenzky: calls $0.08
*** TURN *** [5d Jd 3d] [Ac]
jjbenzky: checks
PlayTheBlues4U: bets $0.22
jjbenzky: calls $0.22
*** RIVER *** [5d Jd 3d Ac] [Jh]
jjbenzky: checks
PlayTheBlues4U: bets $0.66
jjbenzky: folds
Uncalled bet ($0.66) returned to PlayTheBlues4U
PlayTheBlues4U collected $0.65 from pot
PlayTheBlues4U: doesn't show hand
*** SUMMARY ***
Total pot $0.68 | Rake $0.03
Board [5d Jd 3d Ac Jh]
Seat 1: michelina44 folded before Flop (didn't bet)
Seat 2: WillDuane (button) folded on the Flop
Seat 3: jjbenzky (small blind) folded on the River
Seat 4: PlayTheBlues4U (big blind) collected ($0.65)
Seat 5: tsov252525 folded before Flop (didn't bet)
Seat 6: TheWalrus435 folded on the Flop


*********** # 55 **************
PokerStars Hand #203470998337:  Hold'em No Limit ($0.02/$0.05 USD) - 2019/09/06 21:35:55 ET
Table 'Icarus' 6-max Seat #4 is the button
Seat 1: bobca1944 ($2.89 in chips)
Seat 2: PlayTheBlues4U ($5 in chips)
Seat 3: FishyFlopp ($7.13 in chips)
Seat 4: rand60 ($4.83 in chips)
Seat 5: DeccaDan ($12.20 in chips)
Seat 6: DemolishIT ($10.34 in chips)
DeccaDan: posts small blind $0.02
DemolishIT: posts big blind $0.05
*** HOLE CARDS ***
Dealt to PlayTheBlues4U [2d 9s]
bobca1944: folds
PlayTheBlues4U: folds
FishyFlopp: calls $0.05
rand60: folds
DeccaDan: calls $0.03
DemolishIT: raises $0.25 to $0.30
FishyFlopp: folds
DeccaDan: folds
Uncalled bet ($0.25) returned to DemolishIT
DemolishIT collected $0.15 from pot
*** SUMMARY ***
Total pot $0.15 | Rake $0
Seat 1: bobca1944 folded before Flop (didn't bet)
Seat 2: PlayTheBlues4U folded before Flop (didn't bet)
Seat 3: FishyFlopp folded before Flop
Seat 4: rand60 (button) folded before Flop (didn't bet)
Seat 5: DeccaDan (small blind) folded before Flop
Seat 6: DemolishIT (big blind) collected ($0.15)


*********** # 56 **************
PokerStars Hand #203470998292:  Hold'em No Limit ($0.01/$0.02 USD) - 2019/09/06 21:35:45 ET
Table 'Pegasus' 6-max Seat #1 is the button
Seat 1: michelina44 ($0.52 in chips)
Seat 2: WillDuane ($1.98 in chips)
Seat 3: jjbenzky ($3.98 in chips)
Seat 4: PlayTheBlues4U ($4.45 in chips)
Seat 5: tsov252525 ($2.31 in chips)
Seat 6: TheWalrus435 ($2.61 in chips)
WillDuane: posts small blind $0.01
jjbenzky: posts big blind $0.02
*** HOLE CARDS ***
Dealt to PlayTheBlues4U [Qd 8d]
PlayTheBlues4U: folds
tsov252525: folds
TheWalrus435: folds
michelina44: folds
WillDuane: calls $0.01
jjbenzky: checks
*** FLOP *** [Kh 4c 2c]
WillDuane: checks
jjbenzky: bets $0.04
WillDuane: folds
Uncalled bet ($0.04) returned to jjbenzky
jjbenzky collected $0.04 from pot
jjbenzky: doesn't show hand
*** SUMMARY ***
Total pot $0.04 | Rake $0
Board [Kh 4c 2c]
Seat 1: michelina44 (button) folded before Flop (didn't bet)
Seat 2: WillDuane (small blind) folded on the Flop
Seat 3: jjbenzky (big blind) collected ($0.04)
Seat 4: PlayTheBlues4U folded before Flop (didn't bet)
Seat 5: tsov252525 folded before Flop (didn't bet)
Seat 6: TheWalrus435 folded before Flop (didn't bet)


*********** # 57 **************
PokerStars Hand #203470998202:  Hold'em No Limit ($0.02/$0.05 USD) - 2019/09/06 21:35:17 ET
Table 'Icarus' 6-max Seat #3 is the button
Seat 1: bobca1944 ($3.54 in chips)
Seat 2: PlayTheBlues4U ($5 in chips)
Seat 3: FishyFlopp ($5.86 in chips)
Seat 4: rand60 ($4.85 in chips)
Seat 5: DeccaDan ($12.25 in chips)
Seat 6: DemolishIT ($10.99 in chips)
rand60: posts small blind $0.02
DeccaDan: posts big blind $0.05
*** HOLE CARDS ***
Dealt to PlayTheBlues4U [7d Qh]
DemolishIT: raises $0.20 to $0.25
bobca1944: calls $0.25
PlayTheBlues4U: folds
FishyFlopp: raises $0.40 to $0.65
rand60: folds
DeccaDan: folds
DemolishIT: calls $0.40
bobca1944: calls $0.40
*** FLOP *** [Qd 4d 7s]
DemolishIT: checks
bobca1944: checks
FishyFlopp: bets $1.92
DemolishIT: folds
bobca1944: folds
Uncalled bet ($1.92) returned to FishyFlopp
FishyFlopp collected $1.92 from pot
FishyFlopp: doesn't show hand
*** SUMMARY ***
Total pot $2.02 | Rake $0.10
Board [Qd 4d 7s]
Seat 1: bobca1944 folded on the Flop
Seat 2: PlayTheBlues4U folded before Flop (didn't bet)
Seat 3: FishyFlopp (button) collected ($1.92)
Seat 4: rand60 (small blind) folded before Flop
Seat 5: DeccaDan (big blind) folded before Flop
Seat 6: DemolishIT folded on the Flop


*********** # 58 **************
PokerStars Hand #203470998146:  Hold'em No Limit ($0.02/$0.05 USD) - 2019/09/06 21:34:59 ET
Table 'Icarus' 6-max Seat #2 is the button
Seat 1: bobca1944 ($3.54 in chips)
Seat 2: PlayTheBlues4U ($5 in chips)
Seat 3: FishyFlopp ($5.88 in chips)
Seat 4: rand60 ($4.90 in chips)
Seat 5: DeccaDan ($12.25 in chips)
Seat 6: DemolishIT ($10.92 in chips)
FishyFlopp: posts small blind $0.02
rand60: posts big blind $0.05
*** HOLE CARDS ***
Dealt to PlayTheBlues4U [6s 2d]
DeccaDan: folds
DemolishIT: raises $0.20 to $0.25
bobca1944: folds
PlayTheBlues4U: folds
FishyFlopp: folds
rand60: folds
Uncalled bet ($0.20) returned to DemolishIT
DemolishIT collected $0.12 from pot
*** SUMMARY ***
Total pot $0.12 | Rake $0
Seat 1: bobca1944 folded before Flop (didn't bet)
Seat 2: PlayTheBlues4U (button) folded before Flop (didn't bet)
Seat 3: FishyFlopp (small blind) folded before Flop
Seat 4: rand60 (big blind) folded before Flop
Seat 5: DeccaDan folded before Flop (didn't bet)
Seat 6: DemolishIT collected ($0.12)


*********** # 59 **************
PokerStars Hand #203470998057:  Hold'em No Limit ($0.01/$0.02 USD) - 2019/09/06 21:34:29 ET
Table 'Pegasus' 6-max Seat #6 is the button
Seat 1: michelina44 ($0.53 in chips)
Seat 2: WillDuane ($2 in chips)
Seat 3: jjbenzky ($2.07 in chips)
Seat 4: PlayTheBlues4U ($4.45 in chips)
Seat 5: tsov252525 ($4.38 in chips)
Seat 6: TheWalrus435 ($2.61 in chips)
michelina44: posts small blind $0.01
WillDuane: posts big blind $0.02
*** HOLE CARDS ***
Dealt to PlayTheBlues4U [2s Kc]
jjbenzky: calls $0.02
PlayTheBlues4U: folds
tsov252525: raises $0.07 to $0.09
TheWalrus435: folds
michelina44: folds
WillDuane: folds
jjbenzky: calls $0.07
*** FLOP *** [3h 5s 5c]
jjbenzky: checks
tsov252525: bets $0.10
jjbenzky: calls $0.10
*** TURN *** [3h 5s 5c] [As]
jjbenzky: checks
tsov252525: checks
*** RIVER *** [3h 5s 5c As] [5h]
jjbenzky: bets $0.27
tsov252525: raises $0.93 to $1.20
jjbenzky: raises $0.68 to $1.88 and is all-in
tsov252525: calls $0.68
*** SHOW DOWN ***
jjbenzky: shows [5d 6d] (four of a kind, Fives)
tsov252525: shows [Ah Ac] (a full house, Aces full of Fives)
jjbenzky collected $3.98 from pot
*** SUMMARY ***
Total pot $4.17 | Rake $0.19
Board [3h 5s 5c As 5h]
Seat 1: michelina44 (small blind) folded before Flop
Seat 2: WillDuane (big blind) folded before Flop
Seat 3: jjbenzky showed [5d 6d] and won ($3.98) with four of a kind, Fives
Seat 4: PlayTheBlues4U folded before Flop (didn't bet)
Seat 5: tsov252525 showed [Ah Ac] and lost with a full house, Aces full of Fives
Seat 6: TheWalrus435 (button) folded before Flop (didn't bet)


*********** # 60 **************
PokerStars Hand #203470998004:  Hold'em No Limit ($0.01/$0.02 USD) - 2019/09/06 21:34:10 ET
Table 'Pegasus' 6-max Seat #5 is the button
Seat 1: michelina44 ($0.55 in chips)
Seat 3: jjbenzky ($2.04 in chips)
Seat 4: PlayTheBlues4U ($4.45 in chips)
Seat 5: tsov252525 ($4.38 in chips)
Seat 6: TheWalrus435 ($2.62 in chips)
TheWalrus435: posts small blind $0.01
michelina44: posts big blind $0.02
WillDuane: sits out
*** HOLE CARDS ***
Dealt to PlayTheBlues4U [3h 6d]
jjbenzky: raises $0.03 to $0.05
PlayTheBlues4U: folds
tsov252525: folds
TheWalrus435: folds
michelina44: folds
Uncalled bet ($0.03) returned to jjbenzky
jjbenzky collected $0.05 from pot
jjbenzky: doesn't show hand
*** SUMMARY ***
Total pot $0.05 | Rake $0
Seat 1: michelina44 (big blind) folded before Flop
Seat 3: jjbenzky collected ($0.05)
Seat 4: PlayTheBlues4U folded before Flop (didn't bet)
Seat 5: tsov252525 (button) folded before Flop (didn't bet)
Seat 6: TheWalrus435 (small blind) folded before Flop


*********** # 61 **************
PokerStars Hand #203470997944:  Hold'em No Limit ($0.02/$0.05 USD) - 2019/09/06 21:33:53 ET
Table 'Icarus' 6-max Seat #1 is the button
Seat 1: bobca1944 ($3.54 in chips)
Seat 2: PlayTheBlues4U ($5.02 in chips)
Seat 3: FishyFlopp ($5.59 in chips)
Seat 5: DeccaDan ($12.55 in chips)
Seat 6: DemolishIT ($10.92 in chips)
PlayTheBlues4U: posts small blind $0.02
FishyFlopp: posts big blind $0.05
rand60: sits out
*** HOLE CARDS ***
Dealt to PlayTheBlues4U [3s Td]
DeccaDan: calls $0.05
DemolishIT: folds
bobca1944: folds
PlayTheBlues4U: folds
FishyFlopp: raises $0.05 to $0.10
DeccaDan: calls $0.05
*** FLOP *** [8d 6s 2s]
FishyFlopp: bets $0.10
DeccaDan: calls $0.10
*** TURN *** [8d 6s 2s] [Ah]
FishyFlopp: checks
DeccaDan: bets $0.10
FishyFlopp: calls $0.10
*** RIVER *** [8d 6s 2s Ah] [5s]
FishyFlopp: bets $0.59
DeccaDan: folds
Uncalled bet ($0.59) returned to FishyFlopp
FishyFlopp collected $0.59 from pot
FishyFlopp: doesn't show hand
*** SUMMARY ***
Total pot $0.62 | Rake $0.03
Board [8d 6s 2s Ah 5s]
Seat 1: bobca1944 (button) folded before Flop (didn't bet)
Seat 2: PlayTheBlues4U (small blind) folded before Flop
Seat 3: FishyFlopp (big blind) collected ($0.59)
Seat 5: DeccaDan folded on the River
Seat 6: DemolishIT folded before Flop (didn't bet)


*********** # 62 **************
PokerStars Hand #203470997850:  Hold'em No Limit ($0.02/$0.05 USD) - 2019/09/06 21:33:23 ET
Table 'Icarus' 6-max Seat #6 is the button
Seat 1: bobca1944 ($3.56 in chips)
Seat 2: PlayTheBlues4U ($5.07 in chips)
Seat 3: FishyFlopp ($5.59 in chips)
Seat 5: DeccaDan ($12.55 in chips)
Seat 6: DemolishIT ($10.85 in chips)
bobca1944: posts small blind $0.02
PlayTheBlues4U: posts big blind $0.05
rand60: sits out
*** HOLE CARDS ***
Dealt to PlayTheBlues4U [6c 4s]
FishyFlopp: folds
DeccaDan: folds
DemolishIT: raises $0.20 to $0.25
bobca1944: folds
PlayTheBlues4U: folds
Uncalled bet ($0.20) returned to DemolishIT
DemolishIT collected $0.12 from pot
*** SUMMARY ***
Total pot $0.12 | Rake $0
Seat 1: bobca1944 (small blind) folded before Flop
Seat 2: PlayTheBlues4U (big blind) folded before Flop
Seat 3: FishyFlopp folded before Flop (didn't bet)
Seat 5: DeccaDan folded before Flop (didn't bet)
Seat 6: DemolishIT (button) collected ($0.12)


*********** # 63 **************
PokerStars Hand #203470997834:  Hold'em No Limit ($0.01/$0.02 USD) - 2019/09/06 21:33:18 ET
Table 'Pegasus' 6-max Seat #4 is the button
Seat 1: michelina44 ($0.57 in chips)
Seat 3: jjbenzky ($1.99 in chips)
Seat 4: PlayTheBlues4U ($4.45 in chips)
Seat 5: tsov252525 ($4.39 in chips)
Seat 6: TheWalrus435 ($2.64 in chips)
tsov252525: posts small blind $0.01
TheWalrus435: posts big blind $0.02
WillDuane: sits out
*** HOLE CARDS ***
Dealt to PlayTheBlues4U [Jd 4d]
michelina44: calls $0.02
jjbenzky: calls $0.02
PlayTheBlues4U: folds
tsov252525: folds
TheWalrus435: checks
*** FLOP *** [9d 7h 4s]
TheWalrus435: checks
michelina44: checks
jjbenzky: checks
*** TURN *** [9d 7h 4s] [Qc]
TheWalrus435: checks
michelina44: checks
jjbenzky: checks
*** RIVER *** [9d 7h 4s Qc] [5d]
TheWalrus435: checks
michelina44: checks
jjbenzky: bets $0.02
TheWalrus435: folds
michelina44: folds
Uncalled bet ($0.02) returned to jjbenzky
jjbenzky collected $0.07 from pot
*** SUMMARY ***
Total pot $0.07 | Rake $0
Board [9d 7h 4s Qc 5d]
Seat 1: michelina44 folded on the River
Seat 3: jjbenzky collected ($0.07)
Seat 4: PlayTheBlues4U (button) folded before Flop (didn't bet)
Seat 5: tsov252525 (small blind) folded before Flop
Seat 6: TheWalrus435 (big blind) folded on the River


*********** # 64 **************
PokerStars Hand #203470997751:  Hold'em No Limit ($0.01/$0.02 USD) - 2019/09/06 21:32:51 ET
Table 'Pegasus' 6-max Seat #3 is the button
Seat 1: michelina44 ($0.57 in chips)
Seat 3: jjbenzky ($1.93 in chips)
Seat 4: PlayTheBlues4U ($4.49 in chips)
Seat 5: tsov252525 ($4.41 in chips)
Seat 6: TheWalrus435 ($2.64 in chips)
PlayTheBlues4U: posts small blind $0.01
tsov252525: posts big blind $0.02
WillDuane: sits out
*** HOLE CARDS ***
Dealt to PlayTheBlues4U [4c 6c]
TheWalrus435: folds
michelina44: folds
jjbenzky: raises $0.02 to $0.04
PlayTheBlues4U: calls $0.03
tsov252525: folds
*** FLOP *** [7s 8s Ks]
PlayTheBlues4U: checks
jjbenzky: bets $0.05
PlayTheBlues4U: folds
Uncalled bet ($0.05) returned to jjbenzky
jjbenzky collected $0.10 from pot
jjbenzky: doesn't show hand
*** SUMMARY ***
Total pot $0.10 | Rake $0
Board [7s 8s Ks]
Seat 1: michelina44 folded before Flop (didn't bet)
Seat 3: jjbenzky (button) collected ($0.10)
Seat 4: PlayTheBlues4U (small blind) folded on the Flop
Seat 5: tsov252525 (big blind) folded before Flop
Seat 6: TheWalrus435 folded before Flop (didn't bet)


*********** # 65 **************
PokerStars Hand #203470997689:  Hold'em No Limit ($0.02/$0.05 USD) - 2019/09/06 21:32:35 ET
Table 'Icarus' 6-max Seat #5 is the button
Seat 1: bobca1944 ($3.61 in chips)
Seat 2: PlayTheBlues4U ($5.07 in chips)
Seat 3: FishyFlopp ($5.59 in chips)
Seat 5: DeccaDan ($12.60 in chips)
Seat 6: DemolishIT ($10.76 in chips)
DemolishIT: posts small blind $0.02
bobca1944: posts big blind $0.05
rand60: sits out
*** HOLE CARDS ***
Dealt to PlayTheBlues4U [7s 5c]
PlayTheBlues4U: folds
FishyFlopp: folds
DeccaDan: calls $0.05
DemolishIT: calls $0.03
bobca1944: checks
*** FLOP *** [8h 3d 2h]
DemolishIT: checks
bobca1944: checks
DeccaDan: checks
*** TURN *** [8h 3d 2h] [7d]
DemolishIT: checks
bobca1944: checks
DeccaDan: checks
*** RIVER *** [8h 3d 2h 7d] [2c]
DemolishIT: checks
bobca1944: checks
DeccaDan: checks
*** SHOW DOWN ***
DemolishIT: shows [6s Qs] (a pair of Deuces)
bobca1944: mucks hand
DeccaDan: mucks hand
DemolishIT collected $0.14 from pot
*** SUMMARY ***
Total pot $0.15 | Rake $0.01
Board [8h 3d 2h 7d 2c]
Seat 1: bobca1944 (big blind) mucked [Js 9h]
Seat 2: PlayTheBlues4U folded before Flop (didn't bet)
Seat 3: FishyFlopp folded before Flop (didn't bet)
Seat 5: DeccaDan (button) mucked [5s Ts]
Seat 6: DemolishIT (small blind) showed [6s Qs] and won ($0.14) with a pair of Deuces


*********** # 66 **************
PokerStars Hand #203470997643:  Hold'em No Limit ($0.01/$0.02 USD) - 2019/09/06 21:32:21 ET
Table 'Pegasus' 6-max Seat #1 is the button
Seat 1: michelina44 ($0.57 in chips)
Seat 3: jjbenzky ($1.91 in chips)
Seat 4: PlayTheBlues4U ($4.51 in chips)
Seat 5: tsov252525 ($4.41 in chips)
Seat 6: TheWalrus435 ($2.64 in chips)
jjbenzky: posts small blind $0.01
PlayTheBlues4U: posts big blind $0.02
*** HOLE CARDS ***
Dealt to PlayTheBlues4U [2s 4h]
tsov252525: folds
TheWalrus435: folds
michelina44: folds
jjbenzky: calls $0.01
PlayTheBlues4U: checks
*** FLOP *** [9c Tc Qc]
jjbenzky: bets $0.04
PlayTheBlues4U: folds
Uncalled bet ($0.04) returned to jjbenzky
jjbenzky collected $0.04 from pot
*** SUMMARY ***
Total pot $0.04 | Rake $0
Board [9c Tc Qc]
Seat 1: michelina44 (button) folded before Flop (didn't bet)
Seat 3: jjbenzky (small blind) collected ($0.04)
Seat 4: PlayTheBlues4U (big blind) folded on the Flop
Seat 5: tsov252525 folded before Flop (didn't bet)
Seat 6: TheWalrus435 folded before Flop (didn't bet)


*********** # 67 **************
PokerStars Hand #203470997529:  Hold'em No Limit ($0.01/$0.02 USD) - 2019/09/06 21:31:44 ET
Table 'Pegasus' 6-max Seat #6 is the button
Seat 1: michelina44 ($0.53 in chips)
Seat 3: jjbenzky ($1.95 in chips)
Seat 4: PlayTheBlues4U ($4.51 in chips)
Seat 5: tsov252525 ($4.41 in chips)
Seat 6: TheWalrus435 ($2.64 in chips)
michelina44: posts small blind $0.01
jjbenzky: posts big blind $0.02
*** HOLE CARDS ***
Dealt to PlayTheBlues4U [6h Qd]
PlayTheBlues4U: folds
tsov252525: folds
TheWalrus435: folds
michelina44: raises $0.02 to $0.04
jjbenzky: calls $0.02
*** FLOP *** [3c 3d Qc]
michelina44: checks
jjbenzky: checks
*** TURN *** [3c 3d Qc] [4h]
michelina44: checks
jjbenzky: checks
*** RIVER *** [3c 3d Qc 4h] [3s]
michelina44: checks
jjbenzky: checks
*** SHOW DOWN ***
michelina44: shows [Kd Ad] (three of a kind, Threes)
jjbenzky: mucks hand
michelina44 collected $0.08 from pot
*** SUMMARY ***
Total pot $0.08 | Rake $0
Board [3c 3d Qc 4h 3s]
Seat 1: michelina44 (small blind) showed [Kd Ad] and won ($0.08) with three of a kind, Threes
Seat 3: jjbenzky (big blind) mucked [7h 2c]
Seat 4: PlayTheBlues4U folded before Flop (didn't bet)
Seat 5: tsov252525 folded before Flop (didn't bet)
Seat 6: TheWalrus435 (button) folded before Flop (didn't bet)


*********** # 68 **************
PokerStars Hand #203470997528:  Hold'em No Limit ($0.02/$0.05 USD) - 2019/09/06 21:31:43 ET
Table 'Icarus' 6-max Seat #3 is the button
Seat 1: bobca1944 ($3.61 in chips)
Seat 2: PlayTheBlues4U ($5.44 in chips)
Seat 3: FishyFlopp ($5.19 in chips)
Seat 5: DeccaDan ($12.62 in chips)
Seat 6: DemolishIT ($10.81 in chips)
rand60 will be allowed to play after the button
DeccaDan: posts small blind $0.02
DemolishIT: posts big blind $0.05
*** HOLE CARDS ***
Dealt to PlayTheBlues4U [9h 9c]
bobca1944: folds
PlayTheBlues4U: raises $0.12 to $0.17
FishyFlopp: calls $0.17
DeccaDan: folds
DemolishIT: folds
*** FLOP *** [Jh 4h Td]
PlayTheBlues4U: bets $0.20
FishyFlopp: calls $0.20
*** TURN *** [Jh 4h Td] [3c]
PlayTheBlues4U: checks
FishyFlopp: bets $0.25
PlayTheBlues4U: folds
Uncalled bet ($0.25) returned to FishyFlopp
FishyFlopp collected $0.77 from pot
FishyFlopp: doesn't show hand
*** SUMMARY ***
Total pot $0.81 | Rake $0.04
Board [Jh 4h Td 3c]
Seat 1: bobca1944 folded before Flop (didn't bet)
Seat 2: PlayTheBlues4U folded on the Turn
Seat 3: FishyFlopp (button) collected ($0.77)
Seat 5: DeccaDan (small blind) folded before Flop
Seat 6: DemolishIT (big blind) folded before Flop


*********** # 69 **************
PokerStars Hand #203470997465:  Hold'em No Limit ($0.01/$0.02 USD) - 2019/09/06 21:31:25 ET
Table 'Pegasus' 6-max Seat #5 is the button
Seat 1: michelina44 ($0.55 in chips)
Seat 3: jjbenzky ($1.95 in chips)
Seat 4: PlayTheBlues4U ($4.51 in chips)
Seat 5: tsov252525 ($4.38 in chips)
Seat 6: TheWalrus435 ($2.65 in chips)
TheWalrus435: posts small blind $0.01
michelina44: posts big blind $0.02
*** HOLE CARDS ***
Dealt to PlayTheBlues4U [Qc 4c]
jjbenzky: folds
PlayTheBlues4U: folds
tsov252525: raises $0.04 to $0.06
TheWalrus435: folds
michelina44: folds
Uncalled bet ($0.04) returned to tsov252525
tsov252525 collected $0.05 from pot
tsov252525: doesn't show hand
*** SUMMARY ***
Total pot $0.05 | Rake $0
Seat 1: michelina44 (big blind) folded before Flop
Seat 3: jjbenzky folded before Flop (didn't bet)
Seat 4: PlayTheBlues4U folded before Flop (didn't bet)
Seat 5: tsov252525 (button) collected ($0.05)
Seat 6: TheWalrus435 (small blind) folded before Flop


*********** # 70 **************
PokerStars Hand #203470997349:  Hold'em No Limit ($0.02/$0.05 USD) - 2019/09/06 21:30:48 ET
Table 'Icarus' 6-max Seat #2 is the button
Seat 1: bobca1944 ($3.61 in chips)
Seat 2: PlayTheBlues4U ($5.49 in chips)
Seat 3: FishyFlopp ($5.24 in chips)
Seat 5: DeccaDan ($12.48 in chips)
Seat 6: DemolishIT ($10.86 in chips)
FishyFlopp: posts small blind $0.02
DeccaDan: posts big blind $0.05
*** HOLE CARDS ***
Dealt to PlayTheBlues4U [5s 5c]
DemolishIT: calls $0.05
bobca1944: folds
PlayTheBlues4U: calls $0.05
FishyFlopp: calls $0.03
DeccaDan: checks
*** FLOP *** [8h Qh 2d]
FishyFlopp: checks
rand60 joins the table at seat #4
DeccaDan: checks
DemolishIT: checks
PlayTheBlues4U: checks
*** TURN *** [8h Qh 2d] [3c]
FishyFlopp: checks
DeccaDan: bets $0.20
DemolishIT: folds
PlayTheBlues4U: folds
FishyFlopp: folds
Uncalled bet ($0.20) returned to DeccaDan
DeccaDan collected $0.19 from pot
DeccaDan: doesn't show hand
*** SUMMARY ***
Total pot $0.20 | Rake $0.01
Board [8h Qh 2d 3c]
Seat 1: bobca1944 folded before Flop (didn't bet)
Seat 2: PlayTheBlues4U (button) folded on the Turn
Seat 3: FishyFlopp (small blind) folded on the Turn
Seat 5: DeccaDan (big blind) collected ($0.19)
Seat 6: DemolishIT folded on the Turn


*********** # 71 **************
PokerStars Hand #203470997225:  Hold'em No Limit ($0.02/$0.05 USD) - 2019/09/06 21:30:05 ET
Table 'Icarus' 6-max Seat #1 is the button
Seat 1: bobca1944 ($3.61 in chips)
Seat 2: PlayTheBlues4U ($4.86 in chips)
Seat 3: FishyFlopp ($5.94 in chips)
Seat 5: DeccaDan ($12.48 in chips)
Seat 6: DemolishIT ($10.86 in chips)
PlayTheBlues4U: posts small blind $0.02
FishyFlopp: posts big blind $0.05
*** HOLE CARDS ***
Dealt to PlayTheBlues4U [Qc Jd]
DeccaDan: folds
DemolishIT: folds
bobca1944: folds
PlayTheBlues4U: calls $0.03
FishyFlopp: raises $0.10 to $0.15
PlayTheBlues4U: calls $0.10
*** FLOP *** [Qd 4c 5c]
PlayTheBlues4U: checks
FishyFlopp: checks
*** TURN *** [Qd 4c 5c] [3d]
PlayTheBlues4U: bets $0.20
FishyFlopp: calls $0.20
*** RIVER *** [Qd 4c 5c 3d] [5s]
PlayTheBlues4U: bets $0.35
FishyFlopp: calls $0.35
*** SHOW DOWN ***
PlayTheBlues4U: shows [Qc Jd] (two pair, Queens and Fives)
FishyFlopp: mucks hand
PlayTheBlues4U collected $1.33 from pot
*** SUMMARY ***
Total pot $1.40 | Rake $0.07
Board [Qd 4c 5c 3d 5s]
Seat 1: bobca1944 (button) folded before Flop (didn't bet)
Seat 2: PlayTheBlues4U (small blind) showed [Qc Jd] and won ($1.33) with two pair, Queens and Fives
Seat 3: FishyFlopp (big blind) mucked [Ad Js]
Seat 5: DeccaDan folded before Flop (didn't bet)
Seat 6: DemolishIT folded before Flop (didn't bet)


*********** # 72 **************
PokerStars Hand #203470997133:  Hold'em No Limit ($0.01/$0.02 USD) - 2019/09/06 21:29:37 ET
Table 'Pegasus' 6-max Seat #4 is the button
Seat 1: michelina44 ($0.55 in chips)
Seat 2: WillDuane ($1.95 in chips)
Seat 3: jjbenzky ($1.99 in chips)
Seat 4: PlayTheBlues4U ($4.51 in chips)
Seat 5: tsov252525 ($2.55 in chips)
Seat 6: TheWalrus435 ($2.67 in chips)
tsov252525: posts small blind $0.01
TheWalrus435: posts big blind $0.02
*** HOLE CARDS ***
Dealt to PlayTheBlues4U [Qc 2d]
michelina44: folds
WillDuane: raises $0.02 to $0.04
jjbenzky: calls $0.04
PlayTheBlues4U: folds
tsov252525: calls $0.03
TheWalrus435: folds
*** FLOP *** [Qd 7s Th]
tsov252525: checks
WillDuane: bets $0.06
jjbenzky: folds
tsov252525: raises $0.06 to $0.12
WillDuane: calls $0.06
*** TURN *** [Qd 7s Th] [2c]
tsov252525: bets $0.22
WillDuane: calls $0.22
*** RIVER *** [Qd 7s Th 2c] [3s]
tsov252525: bets $2.17 and is all-in
WillDuane: calls $1.57 and is all-in
Uncalled bet ($0.60) returned to tsov252525
*** SHOW DOWN ***
tsov252525: shows [Tc Ts] (three of a kind, Tens)
WillDuane: shows [Qh Kc] (a pair of Queens)
tsov252525 collected $3.78 from pot
*** SUMMARY ***
Total pot $3.96 | Rake $0.18
Board [Qd 7s Th 2c 3s]
Seat 1: michelina44 folded before Flop (didn't bet)
Seat 2: WillDuane showed [Qh Kc] and lost with a pair of Queens
Seat 3: jjbenzky folded on the Flop
Seat 4: PlayTheBlues4U (button) folded before Flop (didn't bet)
Seat 5: tsov252525 (small blind) showed [Tc Ts] and won ($3.78) with three of a kind, Tens
Seat 6: TheWalrus435 (big blind) folded before Flop


*********** # 73 **************
PokerStars Hand #203470997016:  Hold'em No Limit ($0.02/$0.05 USD) - 2019/09/06 21:28:58 ET
Table 'Icarus' 6-max Seat #6 is the button
Seat 1: bobca1944 ($3.63 in chips)
Seat 2: PlayTheBlues4U ($4.91 in chips)
Seat 3: FishyFlopp ($6.48 in chips)
Seat 4: jjbenzky ($3.54 in chips)
Seat 5: DeccaDan ($11.93 in chips)
Seat 6: DemolishIT ($10.86 in chips)
bobca1944: posts small blind $0.02
PlayTheBlues4U: posts big blind $0.05
*** HOLE CARDS ***
Dealt to PlayTheBlues4U [Kh 3d]
FishyFlopp: raises $0.17 to $0.22
jjbenzky: folds
jjbenzky leaves the table
DeccaDan: calls $0.22
DemolishIT: folds
bobca1944: folds
PlayTheBlues4U: folds
*** FLOP *** [Jc 4c 7d]
FishyFlopp: checks
DeccaDan: checks
*** TURN *** [Jc 4c 7d] [6h]
FishyFlopp: bets $0.32
DeccaDan: calls $0.32
*** RIVER *** [Jc 4c 7d 6h] [9h]
FishyFlopp: checks
DeccaDan: bets $0.65
FishyFlopp: folds
Uncalled bet ($0.65) returned to DeccaDan
DeccaDan collected $1.09 from pot
DeccaDan: doesn't show hand
*** SUMMARY ***
Total pot $1.15 | Rake $0.06
Board [Jc 4c 7d 6h 9h]
Seat 1: bobca1944 (small blind) folded before Flop
Seat 2: PlayTheBlues4U (big blind) folded before Flop
Seat 3: FishyFlopp folded on the River
Seat 4: jjbenzky folded before Flop (didn't bet)
Seat 5: DeccaDan collected ($1.09)
Seat 6: DemolishIT (button) folded before Flop (didn't bet)


*********** # 74 **************
PokerStars Hand #203470996913:  Hold'em No Limit ($0.01/$0.02 USD) - 2019/09/06 21:28:27 ET
Table 'Pegasus' 6-max Seat #3 is the button
Seat 1: michelina44 ($0.55 in chips)
Seat 2: WillDuane ($1.97 in chips)
Seat 3: jjbenzky ($1.91 in chips)
Seat 4: PlayTheBlues4U ($4.53 in chips)
Seat 5: tsov252525 ($2.57 in chips)
Seat 6: TheWalrus435 ($2.69 in chips)
PlayTheBlues4U: posts small blind $0.01
tsov252525: posts big blind $0.02
*** HOLE CARDS ***
Dealt to PlayTheBlues4U [9c 6d]
TheWalrus435: calls $0.02
michelina44: folds
WillDuane: calls $0.02
jjbenzky: calls $0.02
PlayTheBlues4U: calls $0.01
tsov252525: checks
*** FLOP *** [7c Ah Jd]
PlayTheBlues4U: checks
tsov252525: checks
TheWalrus435: checks
WillDuane: checks
jjbenzky: bets $0.07
PlayTheBlues4U: folds
tsov252525: folds
TheWalrus435: folds
WillDuane: folds
Uncalled bet ($0.07) returned to jjbenzky
jjbenzky collected $0.10 from pot
jjbenzky: doesn't show hand
*** SUMMARY ***
Total pot $0.10 | Rake $0
Board [7c Ah Jd]
Seat 1: michelina44 folded before Flop (didn't bet)
Seat 2: WillDuane folded on the Flop
Seat 3: jjbenzky (button) collected ($0.10)
Seat 4: PlayTheBlues4U (small blind) folded on the Flop
Seat 5: tsov252525 (big blind) folded on the Flop
Seat 6: TheWalrus435 folded on the Flop


*********** # 75 **************
PokerStars Hand #203470996903:  Hold'em No Limit ($0.02/$0.05 USD) - 2019/09/06 21:28:23 ET
Table 'Icarus' 6-max Seat #5 is the button
Seat 1: bobca1944 ($3.68 in chips)
Seat 2: PlayTheBlues4U ($4.91 in chips)
Seat 3: FishyFlopp ($6.48 in chips)
Seat 4: jjbenzky ($3.31 in chips)
Seat 5: DeccaDan ($11.93 in chips)
Seat 6: DemolishIT ($11.06 in chips)
DemolishIT: posts small blind $0.02
bobca1944: posts big blind $0.05
*** HOLE CARDS ***
Dealt to PlayTheBlues4U [9d 8c]
PlayTheBlues4U: folds
FishyFlopp: folds
jjbenzky: calls $0.05
DeccaDan: folds
DemolishIT: raises $0.15 to $0.20
bobca1944: folds
jjbenzky: calls $0.15
*** FLOP *** [4d 5d 6c]
DemolishIT: checks
jjbenzky: checks
*** TURN *** [4d 5d 6c] [7s]
DemolishIT: checks
jjbenzky: checks
*** RIVER *** [4d 5d 6c 7s] [3h]
DemolishIT: checks
jjbenzky: bets $0.05
DemolishIT: folds
Uncalled bet ($0.05) returned to jjbenzky
jjbenzky collected $0.43 from pot
*** SUMMARY ***
Total pot $0.45 | Rake $0.02
Board [4d 5d 6c 7s 3h]
Seat 1: bobca1944 (big blind) folded before Flop
Seat 2: PlayTheBlues4U folded before Flop (didn't bet)
Seat 3: FishyFlopp folded before Flop (didn't bet)
Seat 4: jjbenzky collected ($0.43)
Seat 5: DeccaDan (button) folded before Flop (didn't bet)
Seat 6: DemolishIT (small blind) folded on the River


*********** # 76 **************
PokerStars Hand #203470996792:  Hold'em No Limit ($0.01/$0.02 USD) - 2019/09/06 21:27:48 ET
Table 'Pegasus' 6-max Seat #2 is the button
Seat 1: michelina44 ($0.58 in chips)
Seat 2: WillDuane ($1.97 in chips)
Seat 3: jjbenzky ($1.84 in chips)
Seat 4: PlayTheBlues4U ($4.55 in chips)
Seat 5: tsov252525 ($2.57 in chips)
Seat 6: TheWalrus435 ($2.71 in chips)
jjbenzky: posts small blind $0.01
PlayTheBlues4U: posts big blind $0.02
michelina44: posts small & big blinds $0.03
*** HOLE CARDS ***
Dealt to PlayTheBlues4U [5c 3d]
tsov252525: folds
TheWalrus435: calls $0.02
michelina44: checks
WillDuane: folds
jjbenzky: calls $0.01
PlayTheBlues4U: checks
*** FLOP *** [3s Jd 4c]
jjbenzky: bets $0.06
PlayTheBlues4U: folds
TheWalrus435: folds
michelina44: folds
Uncalled bet ($0.06) returned to jjbenzky
jjbenzky collected $0.09 from pot
*** SUMMARY ***
Total pot $0.09 | Rake $0
Board [3s Jd 4c]
Seat 1: michelina44 folded on the Flop (didn't bet)
Seat 2: WillDuane (button) folded before Flop (didn't bet)
Seat 3: jjbenzky (small blind) collected ($0.09)
Seat 4: PlayTheBlues4U (big blind) folded on the Flop
Seat 5: tsov252525 folded before Flop (didn't bet)
Seat 6: TheWalrus435 folded on the Flop


*********** # 77 **************
PokerStars Hand #203470996717:  Hold'em No Limit ($0.02/$0.05 USD) - 2019/09/06 21:27:22 ET
Table 'Icarus' 6-max Seat #4 is the button
Seat 1: bobca1944 ($3.68 in chips)
Seat 2: PlayTheBlues4U ($5.36 in chips)
Seat 3: FishyFlopp ($6.48 in chips)
Seat 4: jjbenzky ($2.62 in chips)
Seat 5: DeccaDan ($12.08 in chips)
Seat 6: DemolishIT ($11.21 in chips)
DeccaDan: posts small blind $0.02
DemolishIT: posts big blind $0.05
*** HOLE CARDS ***
Dealt to PlayTheBlues4U [7c 5c]
bobca1944: folds
PlayTheBlues4U: raises $0.10 to $0.15
FishyFlopp: folds
jjbenzky: calls $0.15
DeccaDan: calls $0.13
DemolishIT: calls $0.10
*** FLOP *** [5d Jh Jd]
DeccaDan: checks
DemolishIT: checks
PlayTheBlues4U: bets $0.30
jjbenzky: calls $0.30
DeccaDan: folds
DemolishIT: folds
*** TURN *** [5d Jh Jd] [9c]
PlayTheBlues4U: checks
jjbenzky: bets $0.80
PlayTheBlues4U: folds
Uncalled bet ($0.80) returned to jjbenzky
jjbenzky collected $1.14 from pot
jjbenzky: doesn't show hand
*** SUMMARY ***
Total pot $1.20 | Rake $0.06
Board [5d Jh Jd 9c]
Seat 1: bobca1944 folded before Flop (didn't bet)
Seat 2: PlayTheBlues4U folded on the Turn
Seat 3: FishyFlopp folded before Flop (didn't bet)
Seat 4: jjbenzky (button) collected ($1.14)
Seat 5: DeccaDan (small blind) folded on the Flop
Seat 6: DemolishIT (big blind) folded on the Flop


*********** # 78 **************
PokerStars Hand #203470996626:  Hold'em No Limit ($0.01/$0.02 USD) - 2019/09/06 21:26:55 ET
Table 'Pegasus' 6-max Seat #6 is the button
Seat 2: WillDuane ($1.99 in chips)
Seat 3: jjbenzky ($1.82 in chips)
Seat 4: PlayTheBlues4U ($4.55 in chips)
Seat 5: tsov252525 ($2.57 in chips)
Seat 6: TheWalrus435 ($2.71 in chips)
WillDuane: posts small blind $0.01
jjbenzky: posts big blind $0.02
*** HOLE CARDS ***
Dealt to PlayTheBlues4U [Td Ks]
PlayTheBlues4U: folds
tsov252525: folds
TheWalrus435: folds
WillDuane: calls $0.01
jjbenzky: checks
*** FLOP *** [8h Ac 3d]
WillDuane: checks
jjbenzky: bets $0.03
WillDuane: folds
Uncalled bet ($0.03) returned to jjbenzky
jjbenzky collected $0.04 from pot
*** SUMMARY ***
Total pot $0.04 | Rake $0
Board [8h Ac 3d]
Seat 2: WillDuane (small blind) folded on the Flop
Seat 3: jjbenzky (big blind) collected ($0.04)
Seat 4: PlayTheBlues4U folded before Flop (didn't bet)
Seat 5: tsov252525 folded before Flop (didn't bet)
Seat 6: TheWalrus435 (button) folded before Flop (didn't bet)


*********** # 79 **************
PokerStars Hand #203470996536:  Hold'em No Limit ($0.01/$0.02 USD) - 2019/09/06 21:26:30 ET
Table 'Pegasus' 6-max Seat #5 is the button
Seat 2: WillDuane ($2.01 in chips)
Seat 3: jjbenzky ($1.75 in chips)
Seat 4: PlayTheBlues4U ($4.59 in chips)
Seat 5: tsov252525 ($2.57 in chips)
Seat 6: TheWalrus435 ($2.72 in chips)
TheWalrus435: posts small blind $0.01
WillDuane: posts big blind $0.02
*** HOLE CARDS ***
Dealt to PlayTheBlues4U [Ad 5d]
jjbenzky: raises $0.02 to $0.04
PlayTheBlues4U: calls $0.04
tsov252525: folds
TheWalrus435: folds
WillDuane: folds
*** FLOP *** [9c Qd 9h]
jjbenzky: bets $0.11
PlayTheBlues4U: folds
Uncalled bet ($0.11) returned to jjbenzky
jjbenzky collected $0.11 from pot
*** SUMMARY ***
Total pot $0.11 | Rake $0
Board [9c Qd 9h]
Seat 2: WillDuane (big blind) folded before Flop
Seat 3: jjbenzky collected ($0.11)
Seat 4: PlayTheBlues4U folded on the Flop
Seat 5: tsov252525 (button) folded before Flop (didn't bet)
Seat 6: TheWalrus435 (small blind) folded before Flop


*********** # 80 **************
PokerStars Hand #203470996516:  Hold'em No Limit ($0.02/$0.05 USD) - 2019/09/06 21:26:24 ET
Table 'Icarus' 6-max Seat #3 is the button
Seat 1: bobca1944 ($3.68 in chips)
Seat 2: PlayTheBlues4U ($5.36 in chips)
Seat 3: FishyFlopp ($5.92 in chips)
Seat 4: jjbenzky ($3.19 in chips)
Seat 5: DeccaDan ($12.13 in chips)
Seat 6: DemolishIT ($11.21 in chips)
jjbenzky: posts small blind $0.02
DeccaDan: posts big blind $0.05
*** HOLE CARDS ***
Dealt to PlayTheBlues4U [3s Qc]
DemolishIT: folds
bobca1944: folds
PlayTheBlues4U: folds
FishyFlopp: raises $0.17 to $0.22
jjbenzky: calls $0.20
DeccaDan: folds
*** FLOP *** [8d 9d 3h]
jjbenzky: checks
FishyFlopp: bets $0.35
jjbenzky: calls $0.35
*** TURN *** [8d 9d 3h] [Ks]
jjbenzky: checks
FishyFlopp: bets $0.72
jjbenzky: folds
Uncalled bet ($0.72) returned to FishyFlopp
FishyFlopp collected $1.13 from pot
FishyFlopp: doesn't show hand
*** SUMMARY ***
Total pot $1.19 | Rake $0.06
Board [8d 9d 3h Ks]
Seat 1: bobca1944 folded before Flop (didn't bet)
Seat 2: PlayTheBlues4U folded before Flop (didn't bet)
Seat 3: FishyFlopp (button) collected ($1.13)
Seat 4: jjbenzky (small blind) folded on the Turn
Seat 5: DeccaDan (big blind) folded before Flop
Seat 6: DemolishIT folded before Flop (didn't bet)


*********** # 81 **************
PokerStars Hand #203470996361:  Hold'em No Limit ($0.02/$0.05 USD) - 2019/09/06 21:25:34 ET
Table 'Icarus' 6-max Seat #2 is the button
Seat 1: bobca1944 ($3.26 in chips)
Seat 2: PlayTheBlues4U ($5.36 in chips)
Seat 3: FishyFlopp ($6.12 in chips)
Seat 4: jjbenzky ($3.24 in chips)
Seat 5: DeccaDan ($12.13 in chips)
Seat 6: DemolishIT ($11.41 in chips)
FishyFlopp: posts small blind $0.02
jjbenzky: posts big blind $0.05
*** HOLE CARDS ***
Dealt to PlayTheBlues4U [Qd 5s]
DeccaDan: folds
DemolishIT: calls $0.05
bobca1944: calls $0.05
PlayTheBlues4U: folds
FishyFlopp: raises $0.15 to $0.20
jjbenzky: folds
DemolishIT: calls $0.15
bobca1944: calls $0.15
*** FLOP *** [7h 4s Ac]
FishyFlopp: checks
DemolishIT: checks
bobca1944: checks
*** TURN *** [7h 4s Ac] [6d]
FishyFlopp: checks
DemolishIT: checks
bobca1944: bets $0.62
FishyFlopp: folds
DemolishIT: folds
Uncalled bet ($0.62) returned to bobca1944
bobca1944 collected $0.62 from pot
bobca1944: doesn't show hand
*** SUMMARY ***
Total pot $0.65 | Rake $0.03
Board [7h 4s Ac 6d]
Seat 1: bobca1944 collected ($0.62)
Seat 2: PlayTheBlues4U (button) folded before Flop (didn't bet)
Seat 3: FishyFlopp (small blind) folded on the Turn
Seat 4: jjbenzky (big blind) folded before Flop
Seat 5: DeccaDan folded before Flop (didn't bet)
Seat 6: DemolishIT folded on the Turn


*********** # 82 **************
PokerStars Hand #203470996330:  Hold'em No Limit ($0.01/$0.02 USD) - 2019/09/06 21:25:25 ET
Table 'Pegasus' 6-max Seat #4 is the button
Seat 2: WillDuane ($2.01 in chips)
Seat 3: jjbenzky ($2 in chips)
Seat 4: PlayTheBlues4U ($4.59 in chips)
Seat 5: tsov252525 ($2.59 in chips)
Seat 6: TheWalrus435 ($2.47 in chips)
tsov252525: posts small blind $0.01
TheWalrus435: posts big blind $0.02
jjbenzky: posts big blind $0.02
*** HOLE CARDS ***
Dealt to PlayTheBlues4U [Tc 7d]
WillDuane: folds
jjbenzky: checks
PlayTheBlues4U: folds
tsov252525: calls $0.01
TheWalrus435: checks
*** FLOP *** [As 2c Ah]
tsov252525: checks
TheWalrus435: checks
jjbenzky: bets $0.06
tsov252525: folds
TheWalrus435: calls $0.06
*** TURN *** [As 2c Ah] [9h]
TheWalrus435: checks
jjbenzky: checks
*** RIVER *** [As 2c Ah 9h] [3h]
TheWalrus435: bets $0.17
jjbenzky: calls $0.17
*** SHOW DOWN ***
TheWalrus435: shows [Ad Qd] (three of a kind, Aces)
jjbenzky: mucks hand
TheWalrus435 collected $0.50 from pot
*** SUMMARY ***
Total pot $0.52 | Rake $0.02
Board [As 2c Ah 9h 3h]
Seat 2: WillDuane folded before Flop (didn't bet)
Seat 3: jjbenzky mucked [2s Td]
Seat 4: PlayTheBlues4U (button) folded before Flop (didn't bet)
Seat 5: tsov252525 (small blind) folded on the Flop
Seat 6: TheWalrus435 (big blind) showed [Ad Qd] and won ($0.50) with three of a kind, Aces


*********** # 83 **************
PokerStars Hand #203470996194:  Hold'em No Limit ($0.02/$0.05 USD) - 2019/09/06 21:24:45 ET
Table 'Icarus' 6-max Seat #1 is the button
Seat 1: bobca1944 ($3.26 in chips)
Seat 2: PlayTheBlues4U ($5.38 in chips)
Seat 3: FishyFlopp ($6.17 in chips)
Seat 4: jjbenzky ($3.24 in chips)
Seat 5: DeccaDan ($11.88 in chips)
Seat 6: DemolishIT ($11.61 in chips)
PlayTheBlues4U: posts small blind $0.02
FishyFlopp: posts big blind $0.05
*** HOLE CARDS ***
Dealt to PlayTheBlues4U [9d 8c]
jjbenzky: folds
DeccaDan: calls $0.05
DemolishIT: raises $0.15 to $0.20
bobca1944: folds
PlayTheBlues4U: folds
FishyFlopp: folds
DeccaDan: calls $0.15
*** FLOP *** [4d 4s Kc]
DeccaDan: checks
DemolishIT: checks
*** TURN *** [4d 4s Kc] [3c]
DeccaDan: checks
DemolishIT: checks
*** RIVER *** [4d 4s Kc 3c] [Kh]
DeccaDan: checks
DemolishIT: checks
*** SHOW DOWN ***
DeccaDan: shows [Js Qd] (two pair, Kings and Fours)
DemolishIT: mucks hand
DeccaDan collected $0.45 from pot
*** SUMMARY ***
Total pot $0.47 | Rake $0.02
Board [4d 4s Kc 3c Kh]
Seat 1: bobca1944 (button) folded before Flop (didn't bet)
Seat 2: PlayTheBlues4U (small blind) folded before Flop
Seat 3: FishyFlopp (big blind) folded before Flop
Seat 4: jjbenzky folded before Flop (didn't bet)
Seat 5: DeccaDan showed [Js Qd] and won ($0.45) with two pair, Kings and Fours
Seat 6: DemolishIT mucked [9c Td]


*********** # 84 **************
PokerStars Hand #203470996078:  Hold'em No Limit ($0.01/$0.02 USD) - 2019/09/06 21:24:09 ET
Table 'Pegasus' 6-max Seat #2 is the button
Seat 2: WillDuane ($2.01 in chips)
Seat 4: PlayTheBlues4U ($4.55 in chips)
Seat 5: tsov252525 ($2.61 in chips)
Seat 6: TheWalrus435 ($2.49 in chips)
PlayTheBlues4U: posts small blind $0.01
tsov252525: posts big blind $0.02
*** HOLE CARDS ***
Dealt to PlayTheBlues4U [9s 4h]
TheWalrus435: calls $0.02
michelina44 is disconnected
WillDuane: folds
PlayTheBlues4U: calls $0.01
tsov252525: checks
*** FLOP *** [5c 4d Kd]
PlayTheBlues4U: checks
jjbenzky joins the table at seat #3
tsov252525: checks
TheWalrus435: checks
*** TURN *** [5c 4d Kd] [3h]
PlayTheBlues4U: checks
tsov252525: checks
TheWalrus435: checks
*** RIVER *** [5c 4d Kd 3h] [Ks]
PlayTheBlues4U: checks
tsov252525: checks
TheWalrus435: checks
*** SHOW DOWN ***
PlayTheBlues4U: shows [9s 4h] (two pair, Kings and Fours)
tsov252525: mucks hand
TheWalrus435: mucks hand
PlayTheBlues4U collected $0.06 from pot
*** SUMMARY ***
Total pot $0.06 | Rake $0
Board [5c 4d Kd 3h Ks]
Seat 2: WillDuane (button) folded before Flop (didn't bet)
Seat 4: PlayTheBlues4U (small blind) showed [9s 4h] and won ($0.06) with two pair, Kings and Fours
Seat 5: tsov252525 (big blind) mucked [Tc 9d]
Seat 6: TheWalrus435 mucked [2s 7d]


*********** # 85 **************
PokerStars Hand #203470996069:  Hold'em No Limit ($0.02/$0.05 USD) - 2019/09/06 21:24:05 ET
Table 'Icarus' 6-max Seat #6 is the button
Seat 1: bobca1944 ($3.31 in chips)
Seat 2: PlayTheBlues4U ($5.23 in chips)
Seat 3: FishyFlopp ($6.22 in chips)
Seat 4: jjbenzky ($3.29 in chips)
Seat 5: DeccaDan ($11.88 in chips)
Seat 6: DemolishIT ($11.61 in chips)
bobca1944: posts small blind $0.02
PlayTheBlues4U: posts big blind $0.05
*** HOLE CARDS ***
Dealt to PlayTheBlues4U [As Qs]
FishyFlopp: calls $0.05
jjbenzky: calls $0.05
DeccaDan: folds
DemolishIT: folds
bobca1944: calls $0.03
PlayTheBlues4U: raises $0.30 to $0.35
FishyFlopp: folds
jjbenzky: folds
bobca1944: folds
Uncalled bet ($0.30) returned to PlayTheBlues4U
PlayTheBlues4U collected $0.20 from pot
PlayTheBlues4U: doesn't show hand
*** SUMMARY ***
Total pot $0.20 | Rake $0
Seat 1: bobca1944 (small blind) folded before Flop
Seat 2: PlayTheBlues4U (big blind) collected ($0.20)
Seat 3: FishyFlopp folded before Flop
Seat 4: jjbenzky folded before Flop
Seat 5: DeccaDan folded before Flop (didn't bet)
Seat 6: DemolishIT (button) folded before Flop (didn't bet)


*********** # 86 **************
PokerStars Hand #203470995940:  Hold'em No Limit ($0.02/$0.05 USD) - 2019/09/06 21:23:23 ET
Table 'Icarus' 6-max Seat #5 is the button
Seat 1: bobca1944 ($3.36 in chips)
Seat 2: PlayTheBlues4U ($5.23 in chips)
Seat 3: FishyFlopp ($4.93 in chips)
Seat 4: jjbenzky ($3.54 in chips)
Seat 5: DeccaDan ($12.98 in chips)
Seat 6: DemolishIT ($11.63 in chips)
DemolishIT: posts small blind $0.02
bobca1944: posts big blind $0.05
*** HOLE CARDS ***
Dealt to PlayTheBlues4U [6d 7s]
PlayTheBlues4U: folds
FishyFlopp: calls $0.05
jjbenzky: calls $0.05
DeccaDan: raises $0.20 to $0.25
DemolishIT: folds
bobca1944: folds
FishyFlopp: calls $0.20
jjbenzky: calls $0.20
*** FLOP *** [2h 4s Jh]
FishyFlopp: checks
jjbenzky: checks
DeccaDan: bets $0.30
FishyFlopp: calls $0.30
jjbenzky: folds
*** TURN *** [2h 4s Jh] [3d]
FishyFlopp: checks
DeccaDan: checks
*** RIVER *** [2h 4s Jh 3d] [Ah]
FishyFlopp: bets $0.55
DeccaDan: calls $0.55
*** SHOW DOWN ***
FishyFlopp: shows [8s 5s] (a straight, Ace to Five)
DeccaDan: mucks hand
FishyFlopp collected $2.39 from pot
*** SUMMARY ***
Total pot $2.52 | Rake $0.13
Board [2h 4s Jh 3d Ah]
Seat 1: bobca1944 (big blind) folded before Flop
Seat 2: PlayTheBlues4U folded before Flop (didn't bet)
Seat 3: FishyFlopp showed [8s 5s] and won ($2.39) with a straight, Ace to Five
Seat 4: jjbenzky folded on the Flop
Seat 5: DeccaDan (button) mucked [Ac Kc]
Seat 6: DemolishIT (small blind) folded before Flop


*********** # 87 **************
PokerStars Hand #203470995912:  Hold'em No Limit ($0.01/$0.02 USD) - 2019/09/06 21:23:16 ET
Table 'Pegasus' 6-max Seat #6 is the button
Seat 1: michelina44 ($0.59 in chips)
Seat 2: WillDuane ($2 in chips)
Seat 3: robcandy ($0.97 in chips)
Seat 4: PlayTheBlues4U ($4.55 in chips)
Seat 5: tsov252525 ($2.61 in chips)
Seat 6: TheWalrus435 ($2.49 in chips)
michelina44: posts small blind $0.01
WillDuane: posts big blind $0.02
*** HOLE CARDS ***
Dealt to PlayTheBlues4U [Ts 2c]
robcandy: folds
PlayTheBlues4U: folds
tsov252525: folds
TheWalrus435: folds
robcandy leaves the table
michelina44 has timed out
michelina44: folds
Uncalled bet ($0.01) returned to WillDuane
WillDuane collected $0.02 from pot
WillDuane: doesn't show hand
*** SUMMARY ***
Total pot $0.02 | Rake $0
Seat 1: michelina44 (small blind) folded before Flop
Seat 2: WillDuane (big blind) collected ($0.02)
Seat 3: robcandy folded before Flop (didn't bet)
Seat 4: PlayTheBlues4U folded before Flop (didn't bet)
Seat 5: tsov252525 folded before Flop (didn't bet)
Seat 6: TheWalrus435 (button) folded before Flop (didn't bet)


*********** # 88 **************
PokerStars Hand #203470995820:  Hold'em No Limit ($0.01/$0.02 USD) - 2019/09/06 21:22:41 ET
Table 'Pegasus' 6-max Seat #5 is the button
Seat 1: michelina44 ($0.61 in chips)
Seat 3: robcandy ($0.97 in chips)
Seat 4: PlayTheBlues4U ($4.55 in chips)
Seat 5: tsov252525 ($2.58 in chips)
Seat 6: TheWalrus435 ($2.50 in chips)
TheWalrus435: posts small blind $0.01
michelina44: posts big blind $0.02
WillDuane: sits out
*** HOLE CARDS ***
Dealt to PlayTheBlues4U [3c 2c]
robcandy: folds
PlayTheBlues4U: folds
tsov252525: raises $0.04 to $0.06
TheWalrus435: folds
michelina44: folds
Uncalled bet ($0.04) returned to tsov252525
tsov252525 collected $0.05 from pot
tsov252525: doesn't show hand
*** SUMMARY ***
Total pot $0.05 | Rake $0
Seat 1: michelina44 (big blind) folded before Flop
Seat 3: robcandy folded before Flop (didn't bet)
Seat 4: PlayTheBlues4U folded before Flop (didn't bet)
Seat 5: tsov252525 (button) collected ($0.05)
Seat 6: TheWalrus435 (small blind) folded before Flop


*********** # 89 **************
PokerStars Hand #203470995768:  Hold'em No Limit ($0.02/$0.05 USD) - 2019/09/06 21:22:27 ET
Table 'Icarus' 6-max Seat #4 is the button
Seat 1: bobca1944 ($3.93 in chips)
Seat 2: PlayTheBlues4U ($5.23 in chips)
Seat 3: FishyFlopp ($5 in chips)
Seat 4: jjbenzky ($3.59 in chips)
Seat 5: DeccaDan ($12.31 in chips)
Seat 6: DemolishIT ($11.68 in chips)
DeccaDan: posts small blind $0.02
DemolishIT: posts big blind $0.05
FishyFlopp: posts small & big blinds $0.07
*** HOLE CARDS ***
Dealt to PlayTheBlues4U [Jd 4s]
bobca1944: calls $0.05
PlayTheBlues4U: folds
FishyFlopp: checks
jjbenzky: calls $0.05
DeccaDan: raises $0.27 to $0.32
DemolishIT: folds
bobca1944: calls $0.27
FishyFlopp: folds
jjbenzky: folds
*** FLOP *** [8h 2c Kd]
DeccaDan: checks
bobca1944: checks
*** TURN *** [8h 2c Kd] [2d]
DeccaDan: bets $0.25
bobca1944: calls $0.25
*** RIVER *** [8h 2c Kd 2d] [Kc]
DeccaDan: checks
bobca1944: checks
*** SHOW DOWN ***
DeccaDan: shows [Jh Jc] (two pair, Kings and Jacks)
bobca1944: mucks hand
DeccaDan collected $1.24 from pot
*** SUMMARY ***
Total pot $1.31 | Rake $0.07
Board [8h 2c Kd 2d Kc]
Seat 1: bobca1944 mucked [6h 6c]
Seat 2: PlayTheBlues4U folded before Flop (didn't bet)
Seat 3: FishyFlopp folded before Flop (didn't bet)
Seat 4: jjbenzky (button) folded before Flop
Seat 5: DeccaDan (small blind) showed [Jh Jc] and won ($1.24) with two pair, Kings and Jacks
Seat 6: DemolishIT (big blind) folded before Flop


*********** # 90 **************
PokerStars Hand #203470995719:  Hold'em No Limit ($0.01/$0.02 USD) - 2019/09/06 21:22:11 ET
Table 'Pegasus' 6-max Seat #4 is the button
Seat 1: michelina44 ($0.63 in chips)
Seat 3: robcandy ($0.97 in chips)
Seat 4: PlayTheBlues4U ($4.50 in chips)
Seat 5: tsov252525 ($2.59 in chips)
Seat 6: TheWalrus435 ($2.52 in chips)
tsov252525: posts small blind $0.01
TheWalrus435: posts big blind $0.02
WillDuane: sits out
*** HOLE CARDS ***
Dealt to PlayTheBlues4U [9c 9s]
michelina44: calls $0.02
robcandy: folds
PlayTheBlues4U: raises $0.04 to $0.06
tsov252525: folds
TheWalrus435: folds
michelina44: folds
Uncalled bet ($0.04) returned to PlayTheBlues4U
PlayTheBlues4U collected $0.07 from pot
PlayTheBlues4U: doesn't show hand
*** SUMMARY ***
Total pot $0.07 | Rake $0
Seat 1: michelina44 folded before Flop
Seat 3: robcandy folded before Flop (didn't bet)
Seat 4: PlayTheBlues4U (button) collected ($0.07)
Seat 5: tsov252525 (small blind) folded before Flop
Seat 6: TheWalrus435 (big blind) folded before Flop


*********** # 91 **************
PokerStars Hand #203470995716:  Hold'em No Limit ($0.02/$0.05 USD) - 2019/09/06 21:22:10 ET
Table 'Icarus' 6-max Seat #2 is the button
Seat 1: bobca1944 ($3.93 in chips)
Seat 2: PlayTheBlues4U ($5.23 in chips)
Seat 4: jjbenzky ($3.61 in chips)
Seat 5: DeccaDan ($12.36 in chips)
Seat 6: DemolishIT ($11.61 in chips)
FishyFlopp will be allowed to play after the button
jjbenzky: posts small blind $0.02
DeccaDan: posts big blind $0.05
*** HOLE CARDS ***
Dealt to PlayTheBlues4U [4h Kd]
DemolishIT: raises $0.20 to $0.25
bobca1944: folds
PlayTheBlues4U: folds
jjbenzky: folds
DeccaDan: folds
Uncalled bet ($0.20) returned to DemolishIT
DemolishIT collected $0.12 from pot
*** SUMMARY ***
Total pot $0.12 | Rake $0
Seat 1: bobca1944 folded before Flop (didn't bet)
Seat 2: PlayTheBlues4U (button) folded before Flop (didn't bet)
Seat 4: jjbenzky (small blind) folded before Flop
Seat 5: DeccaDan (big blind) folded before Flop
Seat 6: DemolishIT collected ($0.12)


*********** # 92 **************
PokerStars Hand #203470995576:  Hold'em No Limit ($0.01/$0.02 USD) - 2019/09/06 21:21:31 ET
Table 'Pegasus' 6-max Seat #3 is the button
Seat 1: michelina44 ($0.57 in chips)
Seat 3: robcandy ($0.97 in chips)
Seat 4: PlayTheBlues4U ($4.54 in chips)
Seat 5: tsov252525 ($2.61 in chips)
Seat 6: TheWalrus435 ($2.52 in chips)
PlayTheBlues4U: posts small blind $0.01
tsov252525: posts big blind $0.02
michelina44: posts small blind $0.01
WillDuane: sits out
*** HOLE CARDS ***
Dealt to PlayTheBlues4U [Td 8d]
TheWalrus435: folds
michelina44: raises $0.02 to $0.04
robcandy: folds
PlayTheBlues4U: calls $0.03
tsov252525: folds
*** FLOP *** [5s 4s Ac]
PlayTheBlues4U: checks
michelina44: checks
*** TURN *** [5s 4s Ac] [Ad]
PlayTheBlues4U: checks
michelina44: bets $0.10
PlayTheBlues4U: folds
Uncalled bet ($0.10) returned to michelina44
michelina44 collected $0.11 from pot
michelina44: doesn't show hand
*** SUMMARY ***
Total pot $0.11 | Rake $0
Board [5s 4s Ac Ad]
Seat 1: michelina44 collected ($0.11)
Seat 3: robcandy (button) folded before Flop (didn't bet)
Seat 4: PlayTheBlues4U (small blind) folded on the Turn
Seat 5: tsov252525 (big blind) folded before Flop
Seat 6: TheWalrus435 folded before Flop (didn't bet)


*********** # 93 **************
PokerStars Hand #203470995541:  Hold'em No Limit ($0.02/$0.05 USD) - 2019/09/06 21:21:22 ET
Table 'Icarus' 6-max Seat #1 is the button
Seat 1: bobca1944 ($3.93 in chips)
Seat 2: PlayTheBlues4U ($5.25 in chips)
Seat 4: jjbenzky ($4.24 in chips)
Seat 5: DeccaDan ($11.73 in chips)
Seat 6: DemolishIT ($11.66 in chips)
PlayTheBlues4U: posts small blind $0.02
jjbenzky: posts big blind $0.05
*** HOLE CARDS ***
Dealt to PlayTheBlues4U [4d 8s]
DeccaDan: calls $0.05
DemolishIT: calls $0.05
bobca1944: folds
PlayTheBlues4U: folds
jjbenzky: checks
*** FLOP *** [Jh Qc Jd]
jjbenzky: checks
DeccaDan: bets $0.10
DemolishIT: folds
jjbenzky: calls $0.10
*** TURN *** [Jh Qc Jd] [Th]
jjbenzky: checks
DeccaDan: bets $0.10
jjbenzky: calls $0.10
*** RIVER *** [Jh Qc Jd Th] [5h]
jjbenzky: bets $0.38
DeccaDan: calls $0.38
*** SHOW DOWN ***
jjbenzky: shows [9c Ac] (a pair of Jacks)
DeccaDan: shows [Ks Qs] (two pair, Queens and Jacks)
DeccaDan collected $1.26 from pot
*** SUMMARY ***
Total pot $1.33 | Rake $0.07
Board [Jh Qc Jd Th 5h]
Seat 1: bobca1944 (button) folded before Flop (didn't bet)
Seat 2: PlayTheBlues4U (small blind) folded before Flop
Seat 4: jjbenzky (big blind) showed [9c Ac] and lost with a pair of Jacks
Seat 5: DeccaDan showed [Ks Qs] and won ($1.26) with two pair, Queens and Jacks
Seat 6: DemolishIT folded on the Flop


*********** # 94 **************
PokerStars Hand #203470995484:  Hold'em No Limit ($0.02/$0.05 USD) - 2019/09/06 21:21:07 ET
Table 'Icarus' 6-max Seat #6 is the button
Seat 1: bobca1944 ($3.95 in chips)
Seat 2: PlayTheBlues4U ($5.30 in chips)
Seat 4: jjbenzky ($4.17 in chips)
Seat 5: DeccaDan ($11.73 in chips)
Seat 6: DemolishIT ($11.66 in chips)
bobca1944: posts small blind $0.02
PlayTheBlues4U: posts big blind $0.05
*** HOLE CARDS ***
Dealt to PlayTheBlues4U [3d Qs]
jjbenzky: raises $0.09 to $0.14
DeccaDan: folds
DemolishIT: folds
bobca1944: folds
PlayTheBlues4U: folds
Uncalled bet ($0.09) returned to jjbenzky
jjbenzky collected $0.12 from pot
jjbenzky: doesn't show hand
*** SUMMARY ***
Total pot $0.12 | Rake $0
Seat 1: bobca1944 (small blind) folded before Flop
Seat 2: PlayTheBlues4U (big blind) folded before Flop
Seat 4: jjbenzky collected ($0.12)
Seat 5: DeccaDan folded before Flop (didn't bet)
Seat 6: DemolishIT (button) folded before Flop (didn't bet)


*********** # 95 **************
PokerStars Hand #203470995414:  Hold'em No Limit ($0.01/$0.02 USD) - 2019/09/06 21:20:46 ET
Table 'Pegasus' 6-max Seat #6 is the button
Seat 3: robcandy ($1.03 in chips)
Seat 4: PlayTheBlues4U ($4.49 in chips)
Seat 5: tsov252525 ($2.61 in chips)
Seat 6: TheWalrus435 ($2.52 in chips)
robcandy: posts small blind $0.01
PlayTheBlues4U: posts big blind $0.02
*** HOLE CARDS ***
Dealt to PlayTheBlues4U [Td Qc]
tsov252525: folds
TheWalrus435: folds
robcandy: calls $0.01
WillDuane joins the table at seat #2
PlayTheBlues4U: raises $0.04 to $0.06
robcandy: calls $0.04
*** FLOP *** [Qd 4h 3s]
robcandy: checks
PlayTheBlues4U: bets $0.10
robcandy: folds
Uncalled bet ($0.10) returned to PlayTheBlues4U
PlayTheBlues4U collected $0.11 from pot
PlayTheBlues4U: doesn't show hand
*** SUMMARY ***
Total pot $0.12 | Rake $0.01
Board [Qd 4h 3s]
Seat 3: robcandy (small blind) folded on the Flop
Seat 4: PlayTheBlues4U (big blind) collected ($0.11)
Seat 5: tsov252525 folded before Flop (didn't bet)
Seat 6: TheWalrus435 (button) folded before Flop (didn't bet)


*********** # 96 **************
PokerStars Hand #203470995298:  Hold'em No Limit ($0.02/$0.05 USD) - 2019/09/06 21:20:10 ET
Table 'Icarus' 6-max Seat #5 is the button
Seat 1: bobca1944 ($4 in chips)
Seat 2: PlayTheBlues4U ($5.30 in chips)
Seat 3: FishyFlopp ($3.53 in chips)
Seat 4: jjbenzky ($4.17 in chips)
Seat 5: DeccaDan ($11.73 in chips)
Seat 6: DemolishIT ($8.44 in chips)
DemolishIT: posts small blind $0.02
bobca1944: posts big blind $0.05
*** HOLE CARDS ***
Dealt to PlayTheBlues4U [6c Jh]
PlayTheBlues4U: folds
FishyFlopp: raises $0.25 to $0.30
jjbenzky: folds
DeccaDan: folds
DemolishIT: calls $0.28
bobca1944: folds
*** FLOP *** [7s 4c 4d]
DemolishIT: checks
FishyFlopp: bets $0.45
DemolishIT: calls $0.45
*** TURN *** [7s 4c 4d] [5s]
DemolishIT: checks
FishyFlopp: bets $0.55
DemolishIT: raises $7.14 to $7.69 and is all-in
FishyFlopp: calls $2.23 and is all-in
Uncalled bet ($4.91) returned to DemolishIT
*** RIVER *** [7s 4c 4d 5s] [Kd]
*** SHOW DOWN ***
DemolishIT: shows [Jc Js] (two pair, Jacks and Fours)
FishyFlopp: shows [Th Tc] (two pair, Tens and Fours)
DemolishIT collected $6.75 from pot
*** SUMMARY ***
Total pot $7.11 | Rake $0.36
Board [7s 4c 4d 5s Kd]
Seat 1: bobca1944 (big blind) folded before Flop
Seat 2: PlayTheBlues4U folded before Flop (didn't bet)
Seat 3: FishyFlopp showed [Th Tc] and lost with two pair, Tens and Fours
Seat 4: jjbenzky folded before Flop (didn't bet)
Seat 5: DeccaDan (button) folded before Flop (didn't bet)
Seat 6: DemolishIT (small blind) showed [Jc Js] and won ($6.75) with two pair, Jacks and Fours


*********** # 97 **************
PokerStars Hand #203470995275:  Hold'em No Limit ($0.01/$0.02 USD) - 2019/09/06 21:20:03 ET
Table 'Pegasus' 6-max Seat #5 is the button
Seat 1: michelina44 ($0.59 in chips)
Seat 3: robcandy ($1.03 in chips)
Seat 4: PlayTheBlues4U ($4.49 in chips)
Seat 5: tsov252525 ($2.58 in chips)
Seat 6: TheWalrus435 ($2.53 in chips)
TheWalrus435: posts small blind $0.01
michelina44: posts big blind $0.02
*** HOLE CARDS ***
Dealt to PlayTheBlues4U [Kh 5s]
robcandy: folds
PlayTheBlues4U: folds
tsov252525: raises $0.04 to $0.06
TheWalrus435: folds
michelina44 has timed out
michelina44: folds
Uncalled bet ($0.04) returned to tsov252525
tsov252525 collected $0.05 from pot
tsov252525: doesn't show hand
*** SUMMARY ***
Total pot $0.05 | Rake $0
Seat 1: michelina44 (big blind) folded before Flop
Seat 3: robcandy folded before Flop (didn't bet)
Seat 4: PlayTheBlues4U folded before Flop (didn't bet)
Seat 5: tsov252525 (button) collected ($0.05)
Seat 6: TheWalrus435 (small blind) folded before Flop


*********** # 98 **************
PokerStars Hand #203470995135:  Hold'em No Limit ($0.02/$0.05 USD) - 2019/09/06 21:19:23 ET
Table 'Icarus' 6-max Seat #4 is the button
Seat 2: PlayTheBlues4U ($5.30 in chips)
Seat 3: FishyFlopp ($2.61 in chips)
Seat 4: jjbenzky ($4.42 in chips)
Seat 5: DeccaDan ($11.78 in chips)
Seat 6: DemolishIT ($9.14 in chips)
DeccaDan: posts small blind $0.02
DemolishIT: posts big blind $0.05
bobca1944: sits out
*** HOLE CARDS ***
Dealt to PlayTheBlues4U [3d 7c]
PlayTheBlues4U: folds
FishyFlopp: calls $0.05
jjbenzky: calls $0.05
FishyFlopp said, "timely"
DeccaDan: calls $0.03
DemolishIT: raises $0.20 to $0.25
FishyFlopp: calls $0.20
jjbenzky: calls $0.20
DeccaDan: folds
*** FLOP *** [9s 8h Jc]
DemolishIT: checks
FishyFlopp: checks
jjbenzky: checks
*** TURN *** [9s 8h Jc] [6h]
DemolishIT: checks
FishyFlopp: bets $0.45
jjbenzky: folds
DemolishIT: calls $0.45
*** RIVER *** [9s 8h Jc 6h] [9c]
DemolishIT: checks
FishyFlopp: bets $0.70
DemolishIT: folds
Uncalled bet ($0.70) returned to FishyFlopp
FishyFlopp collected $1.62 from pot
FishyFlopp: doesn't show hand
*** SUMMARY ***
Total pot $1.70 | Rake $0.08
Board [9s 8h Jc 6h 9c]
Seat 2: PlayTheBlues4U folded before Flop (didn't bet)
Seat 3: FishyFlopp collected ($1.62)
Seat 4: jjbenzky (button) folded on the Turn
Seat 5: DeccaDan (small blind) folded before Flop
Seat 6: DemolishIT (big blind) folded on the River


*********** # 99 **************
PokerStars Hand #203470994983:  Hold'em No Limit ($0.01/$0.02 USD) - 2019/09/06 21:18:40 ET
Table 'Pegasus' 6-max Seat #4 is the button
Seat 1: michelina44 ($0.59 in chips)
Seat 3: robcandy ($1.63 in chips)
Seat 4: PlayTheBlues4U ($3.92 in chips)
Seat 5: tsov252525 ($2.59 in chips)
Seat 6: TheWalrus435 ($2.55 in chips)
tsov252525: posts small blind $0.01
TheWalrus435: posts big blind $0.02
*** HOLE CARDS ***
Dealt to PlayTheBlues4U [Js Qs]
michelina44: folds
robcandy: calls $0.02
PlayTheBlues4U: raises $0.04 to $0.06
tsov252525: folds
TheWalrus435: folds
robcandy: calls $0.04
*** FLOP *** [9s Kc Td]
robcandy: checks
PlayTheBlues4U: bets $0.14
robcandy: calls $0.14
*** TURN *** [9s Kc Td] [Ts]
robcandy: checks
PlayTheBlues4U: bets $0.40
robcandy: calls $0.40
*** RIVER *** [9s Kc Td Ts] [4h]
robcandy: checks
PlayTheBlues4U: bets $1.16
robcandy: folds
Uncalled bet ($1.16) returned to PlayTheBlues4U
PlayTheBlues4U collected $1.17 from pot
PlayTheBlues4U: doesn't show hand
*** SUMMARY ***
Total pot $1.23 | Rake $0.06
Board [9s Kc Td Ts 4h]
Seat 1: michelina44 folded before Flop (didn't bet)
Seat 3: robcandy folded on the River
Seat 4: PlayTheBlues4U (button) collected ($1.17)
Seat 5: tsov252525 (small blind) folded before Flop
Seat 6: TheWalrus435 (big blind) folded before Flop


*********** # 100 **************
PokerStars Hand #203470994910:  Hold'em No Limit ($0.02/$0.05 USD) - 2019/09/06 21:18:21 ET
Table 'Icarus' 6-max Seat #3 is the button
Seat 2: PlayTheBlues4U ($9.71 in chips)
Seat 3: FishyFlopp ($2.61 in chips)
Seat 4: jjbenzky ($5.17 in chips)
Seat 5: DeccaDan ($11.83 in chips)
Seat 6: DemolishIT ($4.41 in chips)
jjbenzky: posts small blind $0.02
DeccaDan: posts big blind $0.05
bobca1944: sits out
*** HOLE CARDS ***
Dealt to PlayTheBlues4U [Qd Qc]
DemolishIT: raises $0.20 to $0.25
PlayTheBlues4U: raises $0.50 to $0.75
FishyFlopp: folds
jjbenzky: calls $0.73
DeccaDan: folds
DemolishIT: raises $3.66 to $4.41 and is all-in
PlayTheBlues4U: calls $3.66
jjbenzky: folds
*** FLOP *** [4d Td 5c]
*** TURN *** [4d Td 5c] [7s]
*** RIVER *** [4d Td 5c 7s] [Kc]
*** SHOW DOWN ***
DemolishIT: shows [Ks Kd] (three of a kind, Kings)
PlayTheBlues4U: shows [Qd Qc] (a pair of Queens)
DemolishIT collected $9.14 from pot
*** SUMMARY ***
Total pot $9.62 | Rake $0.48
Board [4d Td 5c 7s Kc]
Seat 2: PlayTheBlues4U showed [Qd Qc] and lost with a pair of Queens
Seat 3: FishyFlopp (button) folded before Flop (didn't bet)
Seat 4: jjbenzky (small blind) folded before Flop
Seat 5: DeccaDan (big blind) folded before Flop
Seat 6: DemolishIT showed [Ks Kd] and won ($9.14) with three of a kind, Kings


*********** # 101 **************
PokerStars Hand #203470994812:  Hold'em No Limit ($0.01/$0.02 USD) - 2019/09/06 21:17:52 ET
Table 'Pegasus' 6-max Seat #3 is the button
Seat 1: michelina44 ($0.59 in chips)
Seat 3: robcandy ($1.49 in chips)
Seat 4: PlayTheBlues4U ($3.93 in chips)
Seat 5: tsov252525 ($2.73 in chips)
Seat 6: TheWalrus435 ($2.55 in chips)
PlayTheBlues4U: posts small blind $0.01
tsov252525: posts big blind $0.02
*** HOLE CARDS ***
Dealt to PlayTheBlues4U [Jh 3d]
TheWalrus435: folds
michelina44: folds
robcandy: calls $0.02
PlayTheBlues4U: folds
tsov252525: checks
*** FLOP *** [6d Tc 9h]
tsov252525: bets $0.05
robcandy: calls $0.05
*** TURN *** [6d Tc 9h] [Ks]
tsov252525: bets $0.07
robcandy: raises $0.07 to $0.14
tsov252525: folds
Uncalled bet ($0.07) returned to robcandy
robcandy collected $0.28 from pot
*** SUMMARY ***
Total pot $0.29 | Rake $0.01
Board [6d Tc 9h Ks]
Seat 1: michelina44 folded before Flop (didn't bet)
Seat 3: robcandy (button) collected ($0.28)
Seat 4: PlayTheBlues4U (small blind) folded before Flop
Seat 5: tsov252525 (big blind) folded on the Turn
Seat 6: TheWalrus435 folded before Flop (didn't bet)


*********** # 102 **************
PokerStars Hand #203470994735:  Hold'em No Limit ($0.01/$0.02 USD) - 2019/09/06 21:17:27 ET
Table 'Pegasus' 6-max Seat #1 is the button
Seat 1: michelina44 ($0.61 in chips)
Seat 3: robcandy ($1.51 in chips)
Seat 4: PlayTheBlues4U ($3.89 in chips)
Seat 5: tsov252525 ($2.73 in chips)
Seat 6: TheWalrus435 ($2.55 in chips)
robcandy: posts small blind $0.01
PlayTheBlues4U: posts big blind $0.02
*** HOLE CARDS ***
Dealt to PlayTheBlues4U [Tc Ks]
tsov252525: folds
TheWalrus435: folds
michelina44: calls $0.02
robcandy: calls $0.01
PlayTheBlues4U: checks
*** FLOP *** [6c Kh 6d]
robcandy: checks
PlayTheBlues4U: bets $0.06
michelina44: folds
robcandy: folds
Uncalled bet ($0.06) returned to PlayTheBlues4U
PlayTheBlues4U collected $0.06 from pot
PlayTheBlues4U: doesn't show hand
*** SUMMARY ***
Total pot $0.06 | Rake $0
Board [6c Kh 6d]
Seat 1: michelina44 (button) folded on the Flop
Seat 3: robcandy (small blind) folded on the Flop
Seat 4: PlayTheBlues4U (big blind) collected ($0.06)
Seat 5: tsov252525 folded before Flop (didn't bet)
Seat 6: TheWalrus435 folded before Flop (didn't bet)


*********** # 103 **************
PokerStars Hand #203470994714:  Hold'em No Limit ($0.02/$0.05 USD) - 2019/09/06 21:17:20 ET
Table 'Icarus' 6-max Seat #2 is the button
Seat 2: PlayTheBlues4U ($9.71 in chips)
Seat 3: FishyFlopp ($2.66 in chips)
Seat 4: jjbenzky ($5.37 in chips)
Seat 5: DeccaDan ($11.51 in chips)
Seat 6: DemolishIT ($4.51 in chips)
FishyFlopp: posts small blind $0.02
jjbenzky: posts big blind $0.05
bobca1944: sits out
*** HOLE CARDS ***
Dealt to PlayTheBlues4U [4c 2s]
DeccaDan: calls $0.05
DemolishIT: calls $0.05
PlayTheBlues4U: folds
FishyFlopp: calls $0.03
jjbenzky: checks
*** FLOP *** [6c Jc Ac]
FishyFlopp: checks
jjbenzky: bets $0.05
DeccaDan: calls $0.05
DemolishIT: calls $0.05
FishyFlopp: folds
*** TURN *** [6c Jc Ac] [Qs]
jjbenzky: checks
DeccaDan: bets $0.10
DemolishIT: folds
jjbenzky: calls $0.10
*** RIVER *** [6c Jc Ac Qs] [Js]
jjbenzky: checks
DeccaDan: bets $0.10
jjbenzky: folds
Uncalled bet ($0.10) returned to DeccaDan
DeccaDan collected $0.52 from pot
DeccaDan: doesn't show hand
*** SUMMARY ***
Total pot $0.55 | Rake $0.03
Board [6c Jc Ac Qs Js]
Seat 2: PlayTheBlues4U (button) folded before Flop (didn't bet)
Seat 3: FishyFlopp (small blind) folded on the Flop
Seat 4: jjbenzky (big blind) folded on the River
Seat 5: DeccaDan collected ($0.52)
Seat 6: DemolishIT folded on the Turn


*********** # 104 **************
PokerStars Hand #203470994653:  Hold'em No Limit ($0.01/$0.02 USD) - 2019/09/06 21:17:01 ET
Table 'Pegasus' 6-max Seat #6 is the button
Seat 1: michelina44 ($0.63 in chips)
Seat 3: robcandy ($1.53 in chips)
Seat 4: PlayTheBlues4U ($3.89 in chips)
Seat 5: tsov252525 ($2.73 in chips)
Seat 6: TheWalrus435 ($2.51 in chips)
michelina44: posts small blind $0.01
robcandy: posts big blind $0.02
*** HOLE CARDS ***
Dealt to PlayTheBlues4U [3h 4s]
PlayTheBlues4U: folds
tsov252525: folds
TheWalrus435: calls $0.02
michelina44: calls $0.01
robcandy: checks
*** FLOP *** [5h 5d Jc]
michelina44: checks
robcandy: checks
TheWalrus435: bets $0.06
michelina44: folds
robcandy: folds
Uncalled bet ($0.06) returned to TheWalrus435
TheWalrus435 collected $0.06 from pot
*** SUMMARY ***
Total pot $0.06 | Rake $0
Board [5h 5d Jc]
Seat 1: michelina44 (small blind) folded on the Flop
Seat 3: robcandy (big blind) folded on the Flop
Seat 4: PlayTheBlues4U folded before Flop (didn't bet)
Seat 5: tsov252525 folded before Flop (didn't bet)
Seat 6: TheWalrus435 (button) collected ($0.06)


*********** # 105 **************
PokerStars Hand #203470994607:  Hold'em No Limit ($0.01/$0.02 USD) - 2019/09/06 21:16:45 ET
Table 'Pegasus' 6-max Seat #5 is the button
Seat 1: michelina44 ($0.65 in chips)
Seat 3: robcandy ($1.53 in chips)
Seat 4: PlayTheBlues4U ($3.89 in chips)
Seat 5: tsov252525 ($2.70 in chips)
Seat 6: TheWalrus435 ($2.52 in chips)
TheWalrus435: posts small blind $0.01
michelina44: posts big blind $0.02
*** HOLE CARDS ***
Dealt to PlayTheBlues4U [Jd 3s]
robcandy: folds
PlayTheBlues4U: folds
tsov252525: raises $0.06 to $0.08
TheWalrus435: folds
michelina44: folds
Uncalled bet ($0.06) returned to tsov252525
tsov252525 collected $0.05 from pot
tsov252525: doesn't show hand
*** SUMMARY ***
Total pot $0.05 | Rake $0
Seat 1: michelina44 (big blind) folded before Flop
Seat 3: robcandy folded before Flop (didn't bet)
Seat 4: PlayTheBlues4U folded before Flop (didn't bet)
Seat 5: tsov252525 (button) collected ($0.05)
Seat 6: TheWalrus435 (small blind) folded before Flop


*********** # 106 **************
PokerStars Hand #203470994600:  Hold'em No Limit ($0.02/$0.05 USD) - 2019/09/06 21:16:42 ET
Table 'Icarus' 6-max Seat #6 is the button
Seat 2: PlayTheBlues4U ($9.73 in chips)
Seat 3: FishyFlopp ($2.71 in chips)
Seat 4: jjbenzky ($5.72 in chips)
Seat 5: DeccaDan ($11.51 in chips)
Seat 6: DemolishIT ($4.13 in chips)
bobca1944 will be allowed to play after the button
PlayTheBlues4U: posts small blind $0.02
FishyFlopp: posts big blind $0.05
*** HOLE CARDS ***
Dealt to PlayTheBlues4U [Ad 4s]
jjbenzky: raises $0.05 to $0.10
DeccaDan: folds
DemolishIT: raises $0.25 to $0.35
PlayTheBlues4U: folds
FishyFlopp: folds
jjbenzky: calls $0.25
*** FLOP *** [2c 5s 2h]
jjbenzky: checks
DemolishIT: bets $0.95
jjbenzky: folds
Uncalled bet ($0.95) returned to DemolishIT
DemolishIT collected $0.73 from pot
DemolishIT: doesn't show hand
*** SUMMARY ***
Total pot $0.77 | Rake $0.04
Board [2c 5s 2h]
Seat 2: PlayTheBlues4U (small blind) folded before Flop
Seat 3: FishyFlopp (big blind) folded before Flop
Seat 4: jjbenzky folded on the Flop
Seat 5: DeccaDan folded before Flop (didn't bet)
Seat 6: DemolishIT (button) collected ($0.73)


*********** # 107 **************
PokerStars Hand #203470994404:  Hold'em No Limit ($0.01/$0.02 USD) - 2019/09/06 21:15:46 ET
Table 'Pegasus' 6-max Seat #4 is the button
Seat 1: michelina44 ($0.65 in chips)
Seat 3: robcandy ($1.36 in chips)
Seat 4: PlayTheBlues4U ($3.89 in chips)
Seat 5: tsov252525 ($2.87 in chips)
Seat 6: TheWalrus435 ($2.54 in chips)
tsov252525: posts small blind $0.01
TheWalrus435: posts big blind $0.02
*** HOLE CARDS ***
Dealt to PlayTheBlues4U [3c Qc]
michelina44: folds
robcandy: calls $0.02
PlayTheBlues4U: folds
tsov252525: raises $0.06 to $0.08
TheWalrus435: folds
robcandy: calls $0.06
*** FLOP *** [5d 8s 3d]
tsov252525: checks
robcandy: checks
*** TURN *** [5d 8s 3d] [7h]
tsov252525: checks
robcandy: checks
*** RIVER *** [5d 8s 3d 7h] [Ad]
tsov252525: bets $0.09
robcandy: calls $0.09
*** SHOW DOWN ***
tsov252525: shows [Ah Tc] (a pair of Aces)
robcandy: shows [Jd Ac] (a pair of Aces - Jack kicker)
robcandy collected $0.34 from pot
*** SUMMARY ***
Total pot $0.36 | Rake $0.02
Board [5d 8s 3d 7h Ad]
Seat 1: michelina44 folded before Flop (didn't bet)
Seat 3: robcandy showed [Jd Ac] and won ($0.34) with a pair of Aces
Seat 4: PlayTheBlues4U (button) folded before Flop (didn't bet)
Seat 5: tsov252525 (small blind) showed [Ah Tc] and lost with a pair of Aces
Seat 6: TheWalrus435 (big blind) folded before Flop


*********** # 108 **************
PokerStars Hand #203470994374:  Hold'em No Limit ($0.02/$0.05 USD) - 2019/09/06 21:15:38 ET
Table 'Icarus' 6-max Seat #5 is the button
Seat 2: PlayTheBlues4U ($9.78 in chips)
Seat 3: FishyFlopp ($2.71 in chips)
Seat 4: jjbenzky ($6.92 in chips)
Seat 5: DeccaDan ($11.51 in chips)
Seat 6: DemolishIT ($3 in chips)
DemolishIT: posts small blind $0.02
Yockit: is sitting out
PlayTheBlues4U: posts big blind $0.05
*** HOLE CARDS ***
Dealt to PlayTheBlues4U [Tc 3s]
FishyFlopp: folds
jjbenzky: calls $0.05
Yockit leaves the table
DeccaDan: folds
bobca1944 joins the table at seat #1
DemolishIT: calls $0.03
PlayTheBlues4U: checks
*** FLOP *** [4h 4c 9h]
DemolishIT: checks
PlayTheBlues4U: checks
jjbenzky: bets $0.14
DemolishIT: calls $0.14
PlayTheBlues4U: folds
*** TURN *** [4h 4c 9h] [8d]
DemolishIT: checks
jjbenzky: bets $0.20
DemolishIT: raises $0.81 to $1.01
jjbenzky: calls $0.81
*** RIVER *** [4h 4c 9h 8d] [7d]
DemolishIT: bets $1.80 and is all-in
jjbenzky: folds
Uncalled bet ($1.80) returned to DemolishIT
DemolishIT collected $2.33 from pot
DemolishIT: doesn't show hand
*** SUMMARY ***
Total pot $2.45 | Rake $0.12
Board [4h 4c 9h 8d 7d]
Seat 2: PlayTheBlues4U (big blind) folded on the Flop
Seat 3: FishyFlopp folded before Flop (didn't bet)
Seat 4: jjbenzky folded on the River
Seat 5: DeccaDan (button) folded before Flop (didn't bet)
Seat 6: DemolishIT (small blind) collected ($2.33)


*********** # 109 **************
PokerStars Hand #203470994240:  Hold'em No Limit ($0.01/$0.02 USD) - 2019/09/06 21:14:55 ET
Table 'Pegasus' 6-max Seat #3 is the button
Seat 1: michelina44 ($0.65 in chips)
Seat 3: robcandy ($1.38 in chips)
Seat 4: PlayTheBlues4U ($3.91 in chips)
Seat 5: tsov252525 ($2.81 in chips)
Seat 6: TheWalrus435 ($2.56 in chips)
PlayTheBlues4U: posts small blind $0.01
tsov252525: posts big blind $0.02
*** HOLE CARDS ***
Dealt to PlayTheBlues4U [7c 5s]
TheWalrus435: calls $0.02
michelina44: folds
robcandy: calls $0.02
PlayTheBlues4U: calls $0.01
tsov252525: checks
*** FLOP *** [3h Qc 2h]
PlayTheBlues4U: checks
tsov252525: checks
TheWalrus435: checks
robcandy: checks
*** TURN *** [3h Qc 2h] [Jd]
PlayTheBlues4U: checks
tsov252525: checks
TheWalrus435: checks
robcandy: checks
*** RIVER *** [3h Qc 2h Jd] [Tc]
PlayTheBlues4U: checks
tsov252525: checks
TheWalrus435: checks
robcandy: checks
*** SHOW DOWN ***
PlayTheBlues4U: shows [7c 5s] (high card Queen)
tsov252525: shows [Td 8h] (a pair of Tens)
TheWalrus435: mucks hand
robcandy: mucks hand
tsov252525 collected $0.08 from pot
*** SUMMARY ***
Total pot $0.08 | Rake $0
Board [3h Qc 2h Jd Tc]
Seat 1: michelina44 folded before Flop (didn't bet)
Seat 3: robcandy (button) mucked [7h As]
Seat 4: PlayTheBlues4U (small blind) showed [7c 5s] and lost with high card Queen
Seat 5: tsov252525 (big blind) showed [Td 8h] and won ($0.08) with a pair of Tens
Seat 6: TheWalrus435 mucked [Ac 4c]


*********** # 110 **************
PokerStars Hand #203470994169:  Hold'em No Limit ($0.01/$0.02 USD) - 2019/09/06 21:14:33 ET
Table 'Pegasus' 6-max Seat #1 is the button
Seat 1: michelina44 ($0.65 in chips)
Seat 3: robcandy ($1.36 in chips)
Seat 4: PlayTheBlues4U ($3.93 in chips)
Seat 5: tsov252525 ($2.81 in chips)
Seat 6: TheWalrus435 ($2.56 in chips)
robcandy: posts small blind $0.01
PlayTheBlues4U: posts big blind $0.02
*** HOLE CARDS ***
Dealt to PlayTheBlues4U [8s 3s]
tsov252525: folds
TheWalrus435: folds
michelina44: folds
robcandy: calls $0.01
PlayTheBlues4U: checks
*** FLOP *** [6s Ah 9h]
robcandy: bets $0.02
PlayTheBlues4U: folds
Uncalled bet ($0.02) returned to robcandy
robcandy collected $0.04 from pot
*** SUMMARY ***
Total pot $0.04 | Rake $0
Board [6s Ah 9h]
Seat 1: michelina44 (button) folded before Flop (didn't bet)
Seat 3: robcandy (small blind) collected ($0.04)
Seat 4: PlayTheBlues4U (big blind) folded on the Flop
Seat 5: tsov252525 folded before Flop (didn't bet)
Seat 6: TheWalrus435 folded before Flop (didn't bet)


*********** # 111 **************
PokerStars Hand #203470994159:  Hold'em No Limit ($0.02/$0.05 USD) - 2019/09/06 21:14:28 ET
Table 'Icarus' 6-max Seat #4 is the button
Seat 1: Yockit ($7.85 in chips)
Seat 2: PlayTheBlues4U ($9.78 in chips)
Seat 3: FishyFlopp ($2.71 in chips)
Seat 4: jjbenzky ($6.97 in chips)
Seat 5: DeccaDan ($11.56 in chips)
Seat 6: DemolishIT ($5.05 in chips)
DeccaDan: posts small blind $0.02
DemolishIT: posts big blind $0.05
*** HOLE CARDS ***
Dealt to PlayTheBlues4U [Js 6h]
Yockit: calls $0.05
PlayTheBlues4U: folds
FishyFlopp: folds
jjbenzky: calls $0.05
DeccaDan: calls $0.03
DemolishIT: raises $0.35 to $0.40
Yockit: calls $0.35
jjbenzky: folds
DeccaDan: folds
*** FLOP *** [Kc Ad Ks]
DemolishIT: checks
Yockit: bets $0.65
DemolishIT: raises $1 to $1.65
Yockit: calls $1
*** TURN *** [Kc Ad Ks] [8c]
DemolishIT: checks
Yockit: bets $1.10
DemolishIT: folds
Uncalled bet ($1.10) returned to Yockit
Yockit collected $3.99 from pot
Yockit: doesn't show hand
*** SUMMARY ***
Total pot $4.20 | Rake $0.21
Board [Kc Ad Ks 8c]
Seat 1: Yockit collected ($3.99)
Seat 2: PlayTheBlues4U folded before Flop (didn't bet)
Seat 3: FishyFlopp folded before Flop (didn't bet)
Seat 4: jjbenzky (button) folded before Flop
Seat 5: DeccaDan (small blind) folded before Flop
Seat 6: DemolishIT (big blind) folded on the Turn


*********** # 112 **************
PokerStars Hand #203470994142:  Hold'em No Limit ($0.01/$0.02 USD) - 2019/09/06 21:14:24 ET
Table 'Pegasus' 6-max Seat #6 is the button
Seat 1: michelina44 ($0.66 in chips)
Seat 3: robcandy ($1.35 in chips)
Seat 4: PlayTheBlues4U ($3.93 in chips)
Seat 5: tsov252525 ($2.81 in chips)
Seat 6: TheWalrus435 ($2.56 in chips)
michelina44: posts small blind $0.01
robcandy: posts big blind $0.02
*** HOLE CARDS ***
Dealt to PlayTheBlues4U [8s 9d]
PlayTheBlues4U: folds
tsov252525: folds
TheWalrus435: folds
michelina44: folds
Uncalled bet ($0.01) returned to robcandy
robcandy collected $0.02 from pot
*** SUMMARY ***
Total pot $0.02 | Rake $0
Seat 1: michelina44 (small blind) folded before Flop
Seat 3: robcandy (big blind) collected ($0.02)
Seat 4: PlayTheBlues4U folded before Flop (didn't bet)
Seat 5: tsov252525 folded before Flop (didn't bet)
Seat 6: TheWalrus435 (button) folded before Flop (didn't bet)


*********** # 113 **************
PokerStars Hand #203470994099:  Hold'em No Limit ($0.01/$0.02 USD) - 2019/09/06 21:14:11 ET
Table 'Pegasus' 6-max Seat #5 is the button
Seat 1: michelina44 ($0.65 in chips)
Seat 3: robcandy ($1.35 in chips)
Seat 4: PlayTheBlues4U ($3.93 in chips)
Seat 5: tsov252525 ($2.81 in chips)
Seat 6: TheWalrus435 ($2.57 in chips)
TheWalrus435: posts small blind $0.01
michelina44: posts big blind $0.02
*** HOLE CARDS ***
Dealt to PlayTheBlues4U [9d 2c]
robcandy: folds
PlayTheBlues4U: folds
tsov252525: folds
TheWalrus435: folds
Uncalled bet ($0.01) returned to michelina44
michelina44 collected $0.02 from pot
michelina44: doesn't show hand
*** SUMMARY ***
Total pot $0.02 | Rake $0
Seat 1: michelina44 (big blind) collected ($0.02)
Seat 3: robcandy folded before Flop (didn't bet)
Seat 4: PlayTheBlues4U folded before Flop (didn't bet)
Seat 5: tsov252525 (button) folded before Flop (didn't bet)
Seat 6: TheWalrus435 (small blind) folded before Flop


*********** # 114 **************
PokerStars Hand #203470994073:  Hold'em No Limit ($0.02/$0.05 USD) - 2019/09/06 21:14:03 ET
Table 'Icarus' 6-max Seat #3 is the button
Seat 1: Yockit ($8.10 in chips)
Seat 2: PlayTheBlues4U ($9.78 in chips)
Seat 3: FishyFlopp ($2.71 in chips)
Seat 4: jjbenzky ($6.99 in chips)
Seat 5: DeccaDan ($11.61 in chips)
Seat 6: DemolishIT ($4.76 in chips)
jjbenzky: posts small blind $0.02
DeccaDan: posts big blind $0.05
*** HOLE CARDS ***
Dealt to PlayTheBlues4U [6d 3s]
DemolishIT: raises $0.20 to $0.25
Yockit: calls $0.25
PlayTheBlues4U: folds
FishyFlopp: folds
jjbenzky: folds
DeccaDan: folds
*** FLOP *** [7s 8s Ac]
DemolishIT: bets $0.54
Yockit: folds
Uncalled bet ($0.54) returned to DemolishIT
DemolishIT collected $0.54 from pot
DemolishIT: doesn't show hand
*** SUMMARY ***
Total pot $0.57 | Rake $0.03
Board [7s 8s Ac]
Seat 1: Yockit folded on the Flop
Seat 2: PlayTheBlues4U folded before Flop (didn't bet)
Seat 3: FishyFlopp (button) folded before Flop (didn't bet)
Seat 4: jjbenzky (small blind) folded before Flop
Seat 5: DeccaDan (big blind) folded before Flop
Seat 6: DemolishIT collected ($0.54)


*********** # 115 **************
PokerStars Hand #203470993945:  Hold'em No Limit ($0.02/$0.05 USD) - 2019/09/06 21:13:25 ET
Table 'Icarus' 6-max Seat #2 is the button
Seat 1: Yockit ($8.10 in chips)
Seat 2: PlayTheBlues4U ($9.78 in chips)
Seat 3: FishyFlopp ($2.73 in chips)
Seat 4: jjbenzky ($6.70 in chips)
Seat 5: DeccaDan ($11.61 in chips)
Seat 6: DemolishIT ($5.06 in chips)
FishyFlopp: posts small blind $0.02
jjbenzky: posts big blind $0.05
*** HOLE CARDS ***
Dealt to PlayTheBlues4U [8s 6s]
DeccaDan: folds
DemolishIT: raises $0.25 to $0.30
Yockit: folds
PlayTheBlues4U: folds
FishyFlopp: folds
jjbenzky: calls $0.25
*** FLOP *** [9d Js 5h]
jjbenzky: checks
DemolishIT: checks
*** TURN *** [9d Js 5h] [8h]
jjbenzky: checks
DemolishIT: checks
*** RIVER *** [9d Js 5h 8h] [Td]
jjbenzky: bets $0.28
DemolishIT: folds
Uncalled bet ($0.28) returned to jjbenzky
jjbenzky collected $0.59 from pot
jjbenzky: doesn't show hand
*** SUMMARY ***
Total pot $0.62 | Rake $0.03
Board [9d Js 5h 8h Td]
Seat 1: Yockit folded before Flop (didn't bet)
Seat 2: PlayTheBlues4U (button) folded before Flop (didn't bet)
Seat 3: FishyFlopp (small blind) folded before Flop
Seat 4: jjbenzky (big blind) collected ($0.59)
Seat 5: DeccaDan folded before Flop (didn't bet)
Seat 6: DemolishIT folded on the River


*********** # 116 **************
PokerStars Hand #203470993933:  Hold'em No Limit ($0.01/$0.02 USD) - 2019/09/06 21:13:20 ET
Table 'Pegasus' 6-max Seat #4 is the button
Seat 1: michelina44 ($0.65 in chips)
Seat 3: robcandy ($1.30 in chips)
Seat 4: PlayTheBlues4U ($3.95 in chips)
Seat 5: tsov252525 ($2.82 in chips)
Seat 6: TheWalrus435 ($2.59 in chips)
tsov252525: posts small blind $0.01
TheWalrus435: posts big blind $0.02
*** HOLE CARDS ***
Dealt to PlayTheBlues4U [9c 4c]
michelina44: folds
robcandy: calls $0.02
doc112ocean leaves the table
PlayTheBlues4U: calls $0.02
tsov252525: folds
TheWalrus435: checks
*** FLOP *** [Ah 5h Ac]
TheWalrus435: checks
robcandy: checks
PlayTheBlues4U: checks
*** TURN *** [Ah 5h Ac] [8h]
TheWalrus435: checks
robcandy: checks
PlayTheBlues4U: checks
*** RIVER *** [Ah 5h Ac 8h] [3c]
TheWalrus435: checks
robcandy: checks
PlayTheBlues4U: checks
*** SHOW DOWN ***
TheWalrus435: shows [Th 7d] (a pair of Aces)
robcandy: shows [Ks 9h] (a pair of Aces - King kicker)
PlayTheBlues4U: mucks hand
robcandy collected $0.07 from pot
*** SUMMARY ***
Total pot $0.07 | Rake $0
Board [Ah 5h Ac 8h 3c]
Seat 1: michelina44 folded before Flop (didn't bet)
Seat 3: robcandy showed [Ks 9h] and won ($0.07) with a pair of Aces
Seat 4: PlayTheBlues4U (button) mucked [9c 4c]
Seat 5: tsov252525 (small blind) folded before Flop
Seat 6: TheWalrus435 (big blind) showed [Th 7d] and lost with a pair of Aces


*********** # 117 **************
PokerStars Hand #203470993796:  Hold'em No Limit ($0.02/$0.05 USD) - 2019/09/06 21:12:35 ET
Table 'Icarus' 6-max Seat #1 is the button
Seat 1: Yockit ($8.10 in chips)
Seat 2: PlayTheBlues4U ($9.80 in chips)
Seat 3: FishyFlopp ($3.48 in chips)
Seat 4: jjbenzky ($6.01 in chips)
Seat 5: DeccaDan ($11.61 in chips)
Seat 6: DemolishIT ($5.06 in chips)
PlayTheBlues4U: posts small blind $0.02
FishyFlopp: posts big blind $0.05
*** HOLE CARDS ***
Dealt to PlayTheBlues4U [7c 6s]
jjbenzky: calls $0.05
DeccaDan: folds
DemolishIT: folds
Yockit: folds
PlayTheBlues4U: folds
FishyFlopp: raises $0.10 to $0.15
jjbenzky: calls $0.10
*** FLOP *** [8h 6c 3d]
FishyFlopp: bets $0.30
jjbenzky: calls $0.30
*** TURN *** [8h 6c 3d] [7h]
FishyFlopp: bets $0.30
jjbenzky: calls $0.30
*** RIVER *** [8h 6c 3d 7h] [3c]
FishyFlopp: checks
jjbenzky: checks
*** SHOW DOWN ***
FishyFlopp: shows [Tc Ah] (a pair of Threes)
jjbenzky: shows [9h 7s] (two pair, Sevens and Threes)
jjbenzky collected $1.44 from pot
*** SUMMARY ***
Total pot $1.52 | Rake $0.08
Board [8h 6c 3d 7h 3c]
Seat 1: Yockit (button) folded before Flop (didn't bet)
Seat 2: PlayTheBlues4U (small blind) folded before Flop
Seat 3: FishyFlopp (big blind) showed [Tc Ah] and lost with a pair of Threes
Seat 4: jjbenzky showed [9h 7s] and won ($1.44) with two pair, Sevens and Threes
Seat 5: DeccaDan folded before Flop (didn't bet)
Seat 6: DemolishIT folded before Flop (didn't bet)


*********** # 118 **************
PokerStars Hand #203470993750:  Hold'em No Limit ($0.01/$0.02 USD) - 2019/09/06 21:12:21 ET
Table 'Pegasus' 6-max Seat #3 is the button
Seat 1: michelina44 ($0.65 in chips)
Seat 2: doc112ocean ($0.21 in chips)
Seat 3: robcandy ($1.51 in chips)
Seat 4: PlayTheBlues4U ($3.52 in chips)
Seat 5: tsov252525 ($2.84 in chips)
Seat 6: TheWalrus435 ($2.61 in chips)
PlayTheBlues4U: posts small blind $0.01
tsov252525: posts big blind $0.02
*** HOLE CARDS ***
Dealt to PlayTheBlues4U [Kd Ad]
TheWalrus435: calls $0.02
michelina44: folds
doc112ocean: raises $0.19 to $0.21 and is all-in
robcandy: calls $0.21
PlayTheBlues4U: raises $1.09 to $1.30
tsov252525: folds
TheWalrus435: folds
robcandy: folds
Uncalled bet ($1.09) returned to PlayTheBlues4U
*** FLOP *** [Js Jc 3d]
*** TURN *** [Js Jc 3d] [Ks]
*** RIVER *** [Js Jc 3d Ks] [Td]
*** SHOW DOWN ***
PlayTheBlues4U: shows [Kd Ad] (two pair, Kings and Jacks)
doc112ocean: shows [Qh Tc] (two pair, Jacks and Tens)
PlayTheBlues4U collected $0.64 from pot
*** SUMMARY ***
Total pot $0.67 | Rake $0.03
Board [Js Jc 3d Ks Td]
Seat 1: michelina44 folded before Flop (didn't bet)
Seat 2: doc112ocean showed [Qh Tc] and lost with two pair, Jacks and Tens
Seat 3: robcandy (button) folded before Flop
Seat 4: PlayTheBlues4U (small blind) showed [Kd Ad] and won ($0.64) with two pair, Kings and Jacks
Seat 5: tsov252525 (big blind) folded before Flop
Seat 6: TheWalrus435 folded before Flop


*********** # 119 **************
PokerStars Hand #203470993644:  Hold'em No Limit ($0.02/$0.05 USD) - 2019/09/06 21:11:46 ET
Table 'Icarus' 6-max Seat #6 is the button
Seat 1: Yockit ($8.12 in chips)
Seat 2: PlayTheBlues4U ($9.85 in chips)
Seat 3: FishyFlopp ($3.48 in chips)
Seat 4: jjbenzky ($5.48 in chips)
Seat 5: DeccaDan ($12.13 in chips)
Seat 6: DemolishIT ($5.06 in chips)
Yockit: posts small blind $0.02
PlayTheBlues4U: posts big blind $0.05
*** HOLE CARDS ***
Dealt to PlayTheBlues4U [Qc 8d]
FishyFlopp: folds
jjbenzky: calls $0.05
DeccaDan: calls $0.05
DemolishIT: folds
Yockit: folds
PlayTheBlues4U: checks
*** FLOP *** [3h 5d 5s]
PlayTheBlues4U: checks
jjbenzky: checks
DeccaDan: bets $0.05
PlayTheBlues4U: folds
jjbenzky: calls $0.05
*** TURN *** [3h 5d 5s] [9h]
jjbenzky: checks
DeccaDan: bets $0.10
jjbenzky: calls $0.10
*** RIVER *** [3h 5d 5s 9h] [9s]
jjbenzky: bets $0.32
DeccaDan: calls $0.32
*** SHOW DOWN ***
jjbenzky: shows [8s 9c] (a full house, Nines full of Fives)
DeccaDan: mucks hand
jjbenzky collected $1.05 from pot
*** SUMMARY ***
Total pot $1.11 | Rake $0.06
Board [3h 5d 5s 9h 9s]
Seat 1: Yockit (small blind) folded before Flop
Seat 2: PlayTheBlues4U (big blind) folded on the Flop
Seat 3: FishyFlopp folded before Flop (didn't bet)
Seat 4: jjbenzky showed [8s 9c] and won ($1.05) with a full house, Nines full of Fives
Seat 5: DeccaDan mucked [Jh Jc]
Seat 6: DemolishIT (button) folded before Flop (didn't bet)


*********** # 120 **************
PokerStars Hand #203470993614:  Hold'em No Limit ($0.01/$0.02 USD) - 2019/09/06 21:11:35 ET
Table 'Pegasus' 6-max Seat #2 is the button
Seat 1: michelina44 ($0.76 in chips)
Seat 2: doc112ocean ($0.23 in chips)
Seat 3: robcandy ($1.52 in chips)
Seat 4: PlayTheBlues4U ($3.37 in chips)
Seat 5: tsov252525 ($2.84 in chips)
Seat 6: TheWalrus435 ($2.63 in chips)
robcandy: posts small blind $0.01
PlayTheBlues4U: posts big blind $0.02
michelina44: posts small & big blinds $0.03
*** HOLE CARDS ***
Dealt to PlayTheBlues4U [Kc Th]
tsov252525: folds
TheWalrus435: calls $0.02
michelina44: checks
doc112ocean: calls $0.02
robcandy: folds
PlayTheBlues4U: checks
*** FLOP *** [5h Ks 6h]
PlayTheBlues4U: bets $0.08
TheWalrus435: folds
michelina44: calls $0.08
doc112ocean: folds
*** TURN *** [5h Ks 6h] [Tc]
PlayTheBlues4U: bets $0.22
michelina44: folds
Uncalled bet ($0.22) returned to PlayTheBlues4U
PlayTheBlues4U collected $0.25 from pot
PlayTheBlues4U: doesn't show hand
*** SUMMARY ***
Total pot $0.26 | Rake $0.01
Board [5h Ks 6h Tc]
Seat 1: michelina44 folded on the Turn
Seat 2: doc112ocean (button) folded on the Flop
Seat 3: robcandy (small blind) folded before Flop
Seat 4: PlayTheBlues4U (big blind) collected ($0.25)
Seat 5: tsov252525 folded before Flop (didn't bet)
Seat 6: TheWalrus435 folded on the Flop


*********** # 121 **************
PokerStars Hand #203470993517:  Hold'em No Limit ($0.02/$0.05 USD) - 2019/09/06 21:11:02 ET
Table 'Icarus' 6-max Seat #5 is the button
Seat 1: Yockit ($8.17 in chips)
Seat 2: PlayTheBlues4U ($9.90 in chips)
Seat 3: FishyFlopp ($3.48 in chips)
Seat 4: jjbenzky ($5.37 in chips)
Seat 5: DeccaDan ($12.13 in chips)
Seat 6: DemolishIT ($5.08 in chips)
DemolishIT: posts small blind $0.02
Yockit: posts big blind $0.05
*** HOLE CARDS ***
Dealt to PlayTheBlues4U [8h Kh]
PlayTheBlues4U: calls $0.05
FishyFlopp: folds
jjbenzky: calls $0.05
DeccaDan: folds
DemolishIT: folds
Yockit: checks
*** FLOP *** [Ts Ah Jd]
Yockit: checks
PlayTheBlues4U: checks
jjbenzky: bets $0.16
Yockit: folds
PlayTheBlues4U: folds
Uncalled bet ($0.16) returned to jjbenzky
jjbenzky collected $0.16 from pot
jjbenzky: doesn't show hand
*** SUMMARY ***
Total pot $0.17 | Rake $0.01
Board [Ts Ah Jd]
Seat 1: Yockit (big blind) folded on the Flop
Seat 2: PlayTheBlues4U folded on the Flop
Seat 3: FishyFlopp folded before Flop (didn't bet)
Seat 4: jjbenzky collected ($0.16)
Seat 5: DeccaDan (button) folded before Flop (didn't bet)
Seat 6: DemolishIT (small blind) folded before Flop


*********** # 122 **************
PokerStars Hand #203470993422:  Hold'em No Limit ($0.01/$0.02 USD) - 2019/09/06 21:10:34 ET
Table 'Pegasus' 6-max Seat #6 is the button
Seat 2: doc112ocean ($0.71 in chips)
Seat 3: robcandy ($1.54 in chips)
Seat 4: PlayTheBlues4U ($3.49 in chips)
Seat 5: tsov252525 ($2.84 in chips)
Seat 6: TheWalrus435 ($2.06 in chips)
michelina44 will be allowed to play after the button
doc112ocean: posts small blind $0.01
robcandy: posts big blind $0.02
*** HOLE CARDS ***
Dealt to PlayTheBlues4U [Ks Jh]
PlayTheBlues4U: calls $0.02
tsov252525: folds
TheWalrus435: calls $0.02
doc112ocean: calls $0.01
robcandy: checks
*** FLOP *** [4c Jd Ad]
doc112ocean: checks
robcandy: checks
PlayTheBlues4U: checks
TheWalrus435: checks
*** TURN *** [4c Jd Ad] [2s]
doc112ocean: bets $0.10
robcandy: folds
PlayTheBlues4U: calls $0.10
TheWalrus435: calls $0.10
*** RIVER *** [4c Jd Ad 2s] [6h]
doc112ocean: checks
PlayTheBlues4U: checks
TheWalrus435: bets $0.36
doc112ocean: calls $0.36
PlayTheBlues4U: folds
*** SHOW DOWN ***
TheWalrus435: shows [5d 3d] (a straight, Deuce to Six)
doc112ocean: mucks hand
TheWalrus435 collected $1.05 from pot
*** SUMMARY ***
Total pot $1.10 | Rake $0.05
Board [4c Jd Ad 2s 6h]
Seat 2: doc112ocean (small blind) mucked [Ac Qd]
Seat 3: robcandy (big blind) folded on the Turn
Seat 4: PlayTheBlues4U folded on the River
Seat 5: tsov252525 folded before Flop (didn't bet)
Seat 6: TheWalrus435 (button) showed [5d 3d] and won ($1.05) with a straight, Deuce to Six


*********** # 123 **************
PokerStars Hand #203470993272:  Hold'em No Limit ($0.02/$0.05 USD) - 2019/09/06 21:09:47 ET
Table 'Icarus' 6-max Seat #4 is the button
Seat 1: Yockit ($7.85 in chips)
Seat 2: PlayTheBlues4U ($9.90 in chips)
Seat 3: FishyFlopp ($3.68 in chips)
Seat 4: jjbenzky ($5.42 in chips)
Seat 5: DeccaDan ($12.18 in chips)
Seat 6: DemolishIT ($5.13 in chips)
DeccaDan: posts small blind $0.02
DemolishIT: posts big blind $0.05
*** HOLE CARDS ***
Dealt to PlayTheBlues4U [8h Tc]
Yockit: calls $0.05
PlayTheBlues4U: folds
FishyFlopp: calls $0.05
jjbenzky: calls $0.05
DeccaDan: calls $0.03
DemolishIT: checks
*** FLOP *** [5h 8c Th]
DeccaDan: checks
DemolishIT: checks
Yockit: bets $0.15
FishyFlopp: calls $0.15
jjbenzky: folds
DeccaDan: folds
DemolishIT: folds
*** TURN *** [5h 8c Th] [Ks]
Yockit: checks
FishyFlopp: checks
*** RIVER *** [5h 8c Th Ks] [7h]
Yockit: bets $0.55
FishyFlopp: folds
Uncalled bet ($0.55) returned to Yockit
Yockit collected $0.52 from pot
*** SUMMARY ***
Total pot $0.55 | Rake $0.03
Board [5h 8c Th Ks 7h]
Seat 1: Yockit collected ($0.52)
Seat 2: PlayTheBlues4U folded before Flop (didn't bet)
Seat 3: FishyFlopp folded on the River
Seat 4: jjbenzky (button) folded on the Flop
Seat 5: DeccaDan (small blind) folded on the Flop
Seat 6: DemolishIT (big blind) folded on the Flop


*********** # 124 **************
PokerStars Hand #203470993260:  Hold'em No Limit ($0.01/$0.02 USD) - 2019/09/06 21:09:43 ET
Table 'Pegasus' 6-max Seat #5 is the button
Seat 2: doc112ocean ($0.87 in chips)
Seat 3: robcandy ($1.70 in chips)
Seat 4: PlayTheBlues4U ($3.49 in chips)
Seat 5: tsov252525 ($2.84 in chips)
Seat 6: TheWalrus435 ($1.76 in chips)
TheWalrus435: posts small blind $0.01
doc112ocean: posts big blind $0.02
*** HOLE CARDS ***
Dealt to PlayTheBlues4U [5h 2s]
robcandy: calls $0.02
PlayTheBlues4U: folds
tsov252525: folds
TheWalrus435: calls $0.01
doc112ocean: checks
*** FLOP *** [Ks 3h 4c]
TheWalrus435: checks
doc112ocean: checks
robcandy: bets $0.02
TheWalrus435: calls $0.02
doc112ocean: calls $0.02
*** TURN *** [Ks 3h 4c] [Th]
TheWalrus435: checks
doc112ocean: checks
robcandy: checks
*** RIVER *** [Ks 3h 4c Th] [Ac]
TheWalrus435: bets $0.12
doc112ocean: calls $0.12
robcandy: calls $0.12
*** SHOW DOWN ***
TheWalrus435: shows [4s 4h] (three of a kind, Fours)
doc112ocean: mucks hand
robcandy: mucks hand
TheWalrus435 collected $0.46 from pot
*** SUMMARY ***
Total pot $0.48 | Rake $0.02
Board [Ks 3h 4c Th Ac]
Seat 2: doc112ocean (big blind) mucked [Ah Qc]
Seat 3: robcandy mucked [3c Ad]
Seat 4: PlayTheBlues4U folded before Flop (didn't bet)
Seat 5: tsov252525 (button) folded before Flop (didn't bet)
Seat 6: TheWalrus435 (small blind) showed [4s 4h] and won ($0.46) with three of a kind, Fours


*********** # 125 **************
PokerStars Hand #203470993166:  Hold'em No Limit ($0.01/$0.02 USD) - 2019/09/06 21:09:10 ET
Table 'Pegasus' 6-max Seat #4 is the button
Seat 2: doc112ocean ($0.84 in chips)
Seat 3: robcandy ($1.70 in chips)
Seat 4: PlayTheBlues4U ($3.49 in chips)
Seat 5: tsov252525 ($2.85 in chips)
Seat 6: TheWalrus435 ($1.78 in chips)
tsov252525: posts small blind $0.01
TheWalrus435: posts big blind $0.02
*** HOLE CARDS ***
Dealt to PlayTheBlues4U [7s 5c]
doc112ocean: calls $0.02
robcandy: folds
PlayTheBlues4U: folds
tsov252525: folds
TheWalrus435: checks
*** FLOP *** [Kc 2c 3h]
TheWalrus435: checks
doc112ocean: bets $0.08
TheWalrus435: folds
Uncalled bet ($0.08) returned to doc112ocean
doc112ocean collected $0.05 from pot
*** SUMMARY ***
Total pot $0.05 | Rake $0
Board [Kc 2c 3h]
Seat 2: doc112ocean collected ($0.05)
Seat 3: robcandy folded before Flop (didn't bet)
Seat 4: PlayTheBlues4U (button) folded before Flop (didn't bet)
Seat 5: tsov252525 (small blind) folded before Flop
Seat 6: TheWalrus435 (big blind) folded on the Flop


*********** # 126 **************
PokerStars Hand #203470993103:  Hold'em No Limit ($0.02/$0.05 USD) - 2019/09/06 21:08:48 ET
Table 'Icarus' 6-max Seat #3 is the button
Seat 1: Yockit ($7.95 in chips)
Seat 2: PlayTheBlues4U ($9.90 in chips)
Seat 3: FishyFlopp ($3.78 in chips)
Seat 4: jjbenzky ($5.09 in chips)
Seat 5: DeccaDan ($12.28 in chips)
Seat 6: DemolishIT ($5.18 in chips)
jjbenzky: posts small blind $0.02
DeccaDan: posts big blind $0.05
*** HOLE CARDS ***
Dealt to PlayTheBlues4U [8h Ks]
DemolishIT: calls $0.05
Yockit: calls $0.05
PlayTheBlues4U: folds
FishyFlopp: calls $0.05
jjbenzky: calls $0.03
DeccaDan: checks
*** FLOP *** [6c Kd 8d]
jjbenzky: checks
DeccaDan: checks
DemolishIT: checks
Yockit: checks
FishyFlopp: checks
*** TURN *** [6c Kd 8d] [3s]
jjbenzky: bets $0.05
DeccaDan: calls $0.05
DemolishIT: folds
Yockit: calls $0.05
FishyFlopp: calls $0.05
*** RIVER *** [6c Kd 8d 3s] [Tc]
jjbenzky: checks
DeccaDan: checks
Yockit: checks
FishyFlopp: checks
*** SHOW DOWN ***
jjbenzky: shows [4d 8s] (a pair of Eights)
DeccaDan: mucks hand
Yockit: mucks hand
FishyFlopp: mucks hand
jjbenzky collected $0.43 from pot
*** SUMMARY ***
Total pot $0.45 | Rake $0.02
Board [6c Kd 8d 3s Tc]
Seat 1: Yockit mucked [3h Ad]
Seat 2: PlayTheBlues4U folded before Flop (didn't bet)
Seat 3: FishyFlopp (button) mucked [Qd 9c]
Seat 4: jjbenzky (small blind) showed [4d 8s] and won ($0.43) with a pair of Eights
Seat 5: DeccaDan (big blind) mucked [2s 6h]
Seat 6: DemolishIT folded on the Turn


*********** # 127 **************
PokerStars Hand #203470993047:  Hold'em No Limit ($0.01/$0.02 USD) - 2019/09/06 21:08:31 ET
Table 'Pegasus' 6-max Seat #3 is the button
Seat 2: doc112ocean ($0.90 in chips)
Seat 3: robcandy ($1.57 in chips)
Seat 4: PlayTheBlues4U ($3.55 in chips)
Seat 5: tsov252525 ($2.87 in chips)
Seat 6: TheWalrus435 ($1.78 in chips)
PlayTheBlues4U: posts small blind $0.01
tsov252525: posts big blind $0.02
*** HOLE CARDS ***
Dealt to PlayTheBlues4U [Ac 2c]
TheWalrus435: folds
doc112ocean: calls $0.02
robcandy: calls $0.02
PlayTheBlues4U: raises $0.04 to $0.06
tsov252525: folds
doc112ocean: calls $0.04
robcandy: calls $0.04
*** FLOP *** [Jh 5d Qs]
PlayTheBlues4U: checks
doc112ocean: checks
robcandy: checks
*** TURN *** [Jh 5d Qs] [Kc]
PlayTheBlues4U: checks
doc112ocean: checks
robcandy: bets $0.10
PlayTheBlues4U: folds
doc112ocean: folds
Uncalled bet ($0.10) returned to robcandy
robcandy collected $0.19 from pot
*** SUMMARY ***
Total pot $0.20 | Rake $0.01
Board [Jh 5d Qs Kc]
Seat 2: doc112ocean folded on the Turn
Seat 3: robcandy (button) collected ($0.19)
Seat 4: PlayTheBlues4U (small blind) folded on the Turn
Seat 5: tsov252525 (big blind) folded before Flop
Seat 6: TheWalrus435 folded before Flop (didn't bet)


*********** # 128 **************
PokerStars Hand #203470992959:  Hold'em No Limit ($0.02/$0.05 USD) - 2019/09/06 21:08:02 ET
Table 'Icarus' 6-max Seat #2 is the button
Seat 1: Yockit ($8.10 in chips)
Seat 2: PlayTheBlues4U ($9.90 in chips)
Seat 3: FishyFlopp ($3.83 in chips)
Seat 4: jjbenzky ($4.91 in chips)
Seat 5: DeccaDan ($12.28 in chips)
Seat 6: DemolishIT ($5.18 in chips)
FishyFlopp: posts small blind $0.02
jjbenzky: posts big blind $0.05
*** HOLE CARDS ***
Dealt to PlayTheBlues4U [Js 6c]
DeccaDan: folds
DemolishIT: folds
Yockit: calls $0.05
PlayTheBlues4U: folds
FishyFlopp: calls $0.03
jjbenzky: checks
*** FLOP *** [Kc Ah 9h]
FishyFlopp: checks
jjbenzky: bets $0.10
Yockit: calls $0.10
FishyFlopp: folds
*** TURN *** [Kc Ah 9h] [Kd]
jjbenzky: checks
Yockit: checks
*** RIVER *** [Kc Ah 9h Kd] [5d]
jjbenzky: bets $0.16
Yockit: folds
Uncalled bet ($0.16) returned to jjbenzky
jjbenzky collected $0.33 from pot
jjbenzky: doesn't show hand
*** SUMMARY ***
Total pot $0.35 | Rake $0.02
Board [Kc Ah 9h Kd 5d]
Seat 1: Yockit folded on the River
Seat 2: PlayTheBlues4U (button) folded before Flop (didn't bet)
Seat 3: FishyFlopp (small blind) folded on the Flop
Seat 4: jjbenzky (big blind) collected ($0.33)
Seat 5: DeccaDan folded before Flop (didn't bet)
Seat 6: DemolishIT folded before Flop (didn't bet)


*********** # 129 **************
PokerStars Hand #203470992940:  Hold'em No Limit ($0.01/$0.02 USD) - 2019/09/06 21:07:59 ET
Table 'Pegasus' 6-max Seat #2 is the button
Seat 2: doc112ocean ($0.85 in chips)
Seat 3: robcandy ($1.58 in chips)
Seat 4: PlayTheBlues4U ($3.57 in chips)
Seat 5: tsov252525 ($2.87 in chips)
Seat 6: TheWalrus435 ($1.80 in chips)
robcandy: posts small blind $0.01
PlayTheBlues4U: posts big blind $0.02
*** HOLE CARDS ***
Dealt to PlayTheBlues4U [7d Qd]
tsov252525: folds
TheWalrus435: calls $0.02
doc112ocean: calls $0.02
robcandy: folds
PlayTheBlues4U: checks
*** FLOP *** [9s 7h Kd]
PlayTheBlues4U: checks
TheWalrus435: checks
doc112ocean: bets $0.10
PlayTheBlues4U: folds
TheWalrus435: folds
Uncalled bet ($0.10) returned to doc112ocean
doc112ocean collected $0.07 from pot
*** SUMMARY ***
Total pot $0.07 | Rake $0
Board [9s 7h Kd]
Seat 2: doc112ocean (button) collected ($0.07)
Seat 3: robcandy (small blind) folded before Flop
Seat 4: PlayTheBlues4U (big blind) folded on the Flop
Seat 5: tsov252525 folded before Flop (didn't bet)
Seat 6: TheWalrus435 folded on the Flop


*********** # 130 **************
PokerStars Hand #203470992866:  Hold'em No Limit ($0.01/$0.02 USD) - 2019/09/06 21:07:33 ET
Table 'Pegasus' 6-max Seat #6 is the button
Seat 2: doc112ocean ($0.86 in chips)
Seat 3: robcandy ($1.66 in chips)
Seat 4: PlayTheBlues4U ($3.57 in chips)
Seat 5: tsov252525 ($2.79 in chips)
Seat 6: TheWalrus435 ($1.80 in chips)
doc112ocean: posts small blind $0.01
robcandy: posts big blind $0.02
*** HOLE CARDS ***
Dealt to PlayTheBlues4U [Jd 7s]
PlayTheBlues4U: folds
tsov252525: raises $0.06 to $0.08
TheWalrus435: folds
doc112ocean: folds
robcandy: calls $0.06
*** FLOP *** [5d Qd Th]
robcandy: checks
tsov252525: bets $0.12
robcandy: folds
Uncalled bet ($0.12) returned to tsov252525
tsov252525 collected $0.16 from pot
tsov252525: doesn't show hand
*** SUMMARY ***
Total pot $0.17 | Rake $0.01
Board [5d Qd Th]
Seat 2: doc112ocean (small blind) folded before Flop
Seat 3: robcandy (big blind) folded on the Flop
Seat 4: PlayTheBlues4U folded before Flop (didn't bet)
Seat 5: tsov252525 collected ($0.16)
Seat 6: TheWalrus435 (button) folded before Flop (didn't bet)


*********** # 131 **************
PokerStars Hand #203470992732:  Hold'em No Limit ($0.02/$0.05 USD) - 2019/09/06 21:06:43 ET
Table 'Icarus' 6-max Seat #1 is the button
Seat 1: Yockit ($8.20 in chips)
Seat 2: PlayTheBlues4U ($9.92 in chips)
Seat 3: FishyFlopp ($3.58 in chips)
Seat 4: jjbenzky ($5.01 in chips)
Seat 5: DeccaDan ($12.33 in chips)
Seat 6: DemolishIT ($5.18 in chips)
PlayTheBlues4U: posts small blind $0.02
FishyFlopp: posts big blind $0.05
*** HOLE CARDS ***
Dealt to PlayTheBlues4U [2c 7s]
jjbenzky: calls $0.05
DeccaDan: calls $0.05
DemolishIT: folds
Yockit: calls $0.05
PlayTheBlues4U: folds
FishyFlopp: checks
*** FLOP *** [2d 9s 9h]
FishyFlopp: checks
jjbenzky: checks
DeccaDan: checks
Yockit: bets $0.05
FishyFlopp: calls $0.05
jjbenzky: calls $0.05
DeccaDan: folds
*** TURN *** [2d 9s 9h] [4h]
FishyFlopp: checks
jjbenzky: checks
Yockit: checks
*** RIVER *** [2d 9s 9h 4h] [Ac]
FishyFlopp: checks
jjbenzky: checks
Yockit: checks
*** SHOW DOWN ***
FishyFlopp: shows [7d 7c] (two pair, Nines and Sevens)
jjbenzky: mucks hand
Yockit: mucks hand
FishyFlopp collected $0.35 from pot
*** SUMMARY ***
Total pot $0.37 | Rake $0.02
Board [2d 9s 9h 4h Ac]
Seat 1: Yockit (button) mucked [2s 6s]
Seat 2: PlayTheBlues4U (small blind) folded before Flop
Seat 3: FishyFlopp (big blind) showed [7d 7c] and won ($0.35) with two pair, Nines and Sevens
Seat 4: jjbenzky mucked [8d Qs]
Seat 5: DeccaDan folded on the Flop
Seat 6: DemolishIT folded before Flop (didn't bet)


*********** # 132 **************
PokerStars Hand #203470992684:  Hold'em No Limit ($0.01/$0.02 USD) - 2019/09/06 21:06:27 ET
Table 'Pegasus' 6-max Seat #5 is the button
Seat 2: doc112ocean ($0.88 in chips)
Seat 3: robcandy ($1.98 in chips)
Seat 4: PlayTheBlues4U ($3.25 in chips)
Seat 5: tsov252525 ($2.79 in chips)
Seat 6: TheWalrus435 ($1.81 in chips)
TheWalrus435: posts small blind $0.01
doc112ocean: posts big blind $0.02
*** HOLE CARDS ***
Dealt to PlayTheBlues4U [Kh Jc]
robcandy: calls $0.02
PlayTheBlues4U: raises $0.06 to $0.08
tsov252525: folds
TheWalrus435: folds
doc112ocean: folds
robcandy: calls $0.06
*** FLOP *** [4d 9h 9d]
robcandy: bets $0.08
PlayTheBlues4U: calls $0.08
*** TURN *** [4d 9h 9d] [Th]
robcandy: checks
PlayTheBlues4U: bets $0.16
robcandy: calls $0.16
*** RIVER *** [4d 9h 9d Th] [Qd]
robcandy: checks
PlayTheBlues4U: bets $0.52
robcandy: folds
Uncalled bet ($0.52) returned to PlayTheBlues4U
PlayTheBlues4U collected $0.64 from pot
PlayTheBlues4U: doesn't show hand
*** SUMMARY ***
Total pot $0.67 | Rake $0.03
Board [4d 9h 9d Th Qd]
Seat 2: doc112ocean (big blind) folded before Flop
Seat 3: robcandy folded on the River
Seat 4: PlayTheBlues4U collected ($0.64)
Seat 5: tsov252525 (button) folded before Flop (didn't bet)
Seat 6: TheWalrus435 (small blind) folded before Flop


*********** # 133 **************
PokerStars Hand #203470992611:  Hold'em No Limit ($0.02/$0.05 USD) - 2019/09/06 21:06:04 ET
Table 'Icarus' 6-max Seat #6 is the button
Seat 1: Yockit ($8.22 in chips)
Seat 2: PlayTheBlues4U ($9.97 in chips)
Seat 3: FishyFlopp ($3.58 in chips)
Seat 4: jjbenzky ($5.06 in chips)
Seat 5: DeccaDan ($12.33 in chips)
Seat 6: DemolishIT ($5.07 in chips)
Yockit: posts small blind $0.02
PlayTheBlues4U: posts big blind $0.05
*** HOLE CARDS ***
Dealt to PlayTheBlues4U [7s Tc]
FishyFlopp: folds
jjbenzky: calls $0.05
DeccaDan: folds
DemolishIT: calls $0.05
Yockit: folds
PlayTheBlues4U: checks
*** FLOP *** [Kc 6h 3d]
PlayTheBlues4U: checks
jjbenzky: checks
DemolishIT: bets $0.25
PlayTheBlues4U: folds
jjbenzky: folds
Uncalled bet ($0.25) returned to DemolishIT
DemolishIT collected $0.16 from pot
*** SUMMARY ***
Total pot $0.17 | Rake $0.01
Board [Kc 6h 3d]
Seat 1: Yockit (small blind) folded before Flop
Seat 2: PlayTheBlues4U (big blind) folded on the Flop
Seat 3: FishyFlopp folded before Flop (didn't bet)
Seat 4: jjbenzky folded on the Flop
Seat 5: DeccaDan folded before Flop (didn't bet)
Seat 6: DemolishIT (button) collected ($0.16)


*********** # 134 **************
PokerStars Hand #203470992556:  Hold'em No Limit ($0.01/$0.02 USD) - 2019/09/06 21:05:41 ET
Table 'Pegasus' 6-max Seat #4 is the button
Seat 2: doc112ocean ($0.90 in chips)
Seat 3: robcandy ($1.91 in chips)
Seat 4: PlayTheBlues4U ($3.25 in chips)
Seat 5: tsov252525 ($2.80 in chips)
Seat 6: TheWalrus435 ($1.85 in chips)
tsov252525: posts small blind $0.01
TheWalrus435: posts big blind $0.02
*** HOLE CARDS ***
Dealt to PlayTheBlues4U [2d Js]
doc112ocean: calls $0.02
robcandy: calls $0.02
PlayTheBlues4U: folds
tsov252525: folds
TheWalrus435: checks
*** FLOP *** [4c 8c Ts]
TheWalrus435: checks
doc112ocean: checks
robcandy: bets $0.02
TheWalrus435: calls $0.02
doc112ocean: folds
*** TURN *** [4c 8c Ts] [2s]
TheWalrus435: checks
robcandy: bets $0.10
TheWalrus435: folds
Uncalled bet ($0.10) returned to robcandy
robcandy collected $0.11 from pot
*** SUMMARY ***
Total pot $0.11 | Rake $0
Board [4c 8c Ts 2s]
Seat 2: doc112ocean folded on the Flop
Seat 3: robcandy collected ($0.11)
Seat 4: PlayTheBlues4U (button) folded before Flop (didn't bet)
Seat 5: tsov252525 (small blind) folded before Flop
Seat 6: TheWalrus435 (big blind) folded on the Turn


*********** # 135 **************
PokerStars Hand #203470992500:  Hold'em No Limit ($0.02/$0.05 USD) - 2019/09/06 21:05:24 ET
Table 'Icarus' 6-max Seat #5 is the button
Seat 1: Yockit ($8.27 in chips)
Seat 2: PlayTheBlues4U ($9.97 in chips)
Seat 3: FishyFlopp ($3.58 in chips)
Seat 4: jjbenzky ($5 in chips)
Seat 5: DeccaDan ($12.33 in chips)
Seat 6: DemolishIT ($5.09 in chips)
DemolishIT: posts small blind $0.02
Yockit: posts big blind $0.05
jjbenzky: posts big blind $0.05
*** HOLE CARDS ***
Dealt to PlayTheBlues4U [Th Ac]
PlayTheBlues4U: folds
FishyFlopp: folds
jjbenzky: checks
DeccaDan: folds
DemolishIT: folds
Yockit: checks
*** FLOP *** [Kh 3s 8s]
Yockit: checks
jjbenzky: checks
*** TURN *** [Kh 3s 8s] [Jh]
Yockit: checks
jjbenzky: checks
*** RIVER *** [Kh 3s 8s Jh] [Td]
Yockit: checks
jjbenzky: checks
*** SHOW DOWN ***
Yockit: shows [2s 9d] (high card King)
jjbenzky: shows [Qd 4h] (high card King - Queen kicker)
jjbenzky collected $0.11 from pot
*** SUMMARY ***
Total pot $0.12 | Rake $0.01
Board [Kh 3s 8s Jh Td]
Seat 1: Yockit (big blind) showed [2s 9d] and lost with high card King
Seat 2: PlayTheBlues4U folded before Flop (didn't bet)
Seat 3: FishyFlopp folded before Flop (didn't bet)
Seat 4: jjbenzky showed [Qd 4h] and won ($0.11) with high card King
Seat 5: DeccaDan (button) folded before Flop (didn't bet)
Seat 6: DemolishIT (small blind) folded before Flop


*********** # 136 **************
PokerStars Hand #203470992399:  Hold'em No Limit ($0.01/$0.02 USD) - 2019/09/06 21:04:47 ET
Table 'Pegasus' 6-max Seat #3 is the button
Seat 2: doc112ocean ($0.90 in chips)
Seat 3: robcandy ($1.91 in chips)
Seat 4: PlayTheBlues4U ($3.09 in chips)
Seat 5: tsov252525 ($2.82 in chips)
Seat 6: TheWalrus435 ($2.01 in chips)
PlayTheBlues4U: posts small blind $0.01
tsov252525: posts big blind $0.02
*** HOLE CARDS ***
Dealt to PlayTheBlues4U [As 6c]
TheWalrus435: calls $0.02
doc112ocean: folds
robcandy: folds
PlayTheBlues4U: raises $0.06 to $0.08
tsov252525: folds
TheWalrus435: calls $0.06
*** FLOP *** [6s Ks 4h]
PlayTheBlues4U: bets $0.08
TheWalrus435: calls $0.08
*** TURN *** [6s Ks 4h] [5s]
PlayTheBlues4U: checks
TheWalrus435: checks
*** RIVER *** [6s Ks 4h 5s] [9d]
PlayTheBlues4U: checks
TheWalrus435: checks
*** SHOW DOWN ***
PlayTheBlues4U: shows [As 6c] (a pair of Sixes)
TheWalrus435: mucks hand
PlayTheBlues4U collected $0.32 from pot
*** SUMMARY ***
Total pot $0.34 | Rake $0.02
Board [6s Ks 4h 5s 9d]
Seat 2: doc112ocean folded before Flop (didn't bet)
Seat 3: robcandy (button) folded before Flop (didn't bet)
Seat 4: PlayTheBlues4U (small blind) showed [As 6c] and won ($0.32) with a pair of Sixes
Seat 5: tsov252525 (big blind) folded before Flop
Seat 6: TheWalrus435 mucked [6h 7h]


*********** # 137 **************
PokerStars Hand #203470992322:  Hold'em No Limit ($0.02/$0.05 USD) - 2019/09/06 21:04:20 ET
Table 'Icarus' 6-max Seat #3 is the button
Seat 1: Yockit ($8.27 in chips)
Seat 2: PlayTheBlues4U ($9.97 in chips)
Seat 3: FishyFlopp ($3.68 in chips)
Seat 5: DeccaDan ($12.01 in chips)
Seat 6: DemolishIT ($5.34 in chips)
jjbenzky will be allowed to play after the button
DeccaDan: posts small blind $0.02
DemolishIT: posts big blind $0.05
*** HOLE CARDS ***
Dealt to PlayTheBlues4U [Qh Td]
Yockit: folds
PlayTheBlues4U: folds
FishyFlopp: calls $0.05
DeccaDan: raises $0.05 to $0.10
DemolishIT: calls $0.05
FishyFlopp: calls $0.05
*** FLOP *** [6c Qs Js]
DeccaDan: bets $0.15
DemolishIT: calls $0.15
FishyFlopp: folds
*** TURN *** [6c Qs Js] [Kd]
DeccaDan: checks
DemolishIT: checks
*** RIVER *** [6c Qs Js Kd] [Jh]
DeccaDan: bets $0.15
DemolishIT: folds
Uncalled bet ($0.15) returned to DeccaDan
DeccaDan collected $0.57 from pot
DeccaDan: doesn't show hand
*** SUMMARY ***
Total pot $0.60 | Rake $0.03
Board [6c Qs Js Kd Jh]
Seat 1: Yockit folded before Flop (didn't bet)
Seat 2: PlayTheBlues4U folded before Flop (didn't bet)
Seat 3: FishyFlopp (button) folded on the Flop
Seat 5: DeccaDan (small blind) collected ($0.57)
Seat 6: DemolishIT (big blind) folded on the River


*********** # 138 **************
PokerStars Hand #203470992273:  Hold'em No Limit ($0.01/$0.02 USD) - 2019/09/06 21:04:06 ET
Table 'Pegasus' 6-max Seat #2 is the button
Seat 2: doc112ocean ($0.90 in chips)
Seat 3: robcandy ($1.87 in chips)
Seat 4: PlayTheBlues4U ($3.13 in chips)
Seat 5: tsov252525 ($2.82 in chips)
Seat 6: TheWalrus435 ($2.01 in chips)
robcandy: posts small blind $0.01
PlayTheBlues4U: posts big blind $0.02
*** HOLE CARDS ***
Dealt to PlayTheBlues4U [9d 8c]
tsov252525: folds
TheWalrus435: folds
doc112ocean: folds
robcandy: calls $0.01
PlayTheBlues4U: checks
*** FLOP *** [6h Jd 7c]
robcandy: checks
PlayTheBlues4U: bets $0.02
robcandy: calls $0.02
*** TURN *** [6h Jd 7c] [4s]
robcandy: checks
PlayTheBlues4U: checks
*** RIVER *** [6h Jd 7c 4s] [4h]
robcandy: checks
PlayTheBlues4U: checks
*** SHOW DOWN ***
robcandy: shows [Ac 2h] (a pair of Fours)
PlayTheBlues4U: mucks hand
robcandy collected $0.08 from pot
*** SUMMARY ***
Total pot $0.08 | Rake $0
Board [6h Jd 7c 4s 4h]
Seat 2: doc112ocean (button) folded before Flop (didn't bet)
Seat 3: robcandy (small blind) showed [Ac 2h] and won ($0.08) with a pair of Fours
Seat 4: PlayTheBlues4U (big blind) mucked [9d 8c]
Seat 5: tsov252525 folded before Flop (didn't bet)
Seat 6: TheWalrus435 folded before Flop (didn't bet)


*********** # 139 **************
PokerStars Hand #203470992088:  Hold'em No Limit ($0.02/$0.05 USD) - 2019/09/06 21:03:06 ET
Table 'Icarus' 6-max Seat #2 is the button
Seat 1: Yockit ($8.27 in chips)
Seat 2: PlayTheBlues4U ($9.97 in chips)
Seat 3: FishyFlopp ($3.50 in chips)
Seat 5: DeccaDan ($12.11 in chips)
Seat 6: DemolishIT ($5.44 in chips)
FishyFlopp: posts small blind $0.02
DeccaDan: posts big blind $0.05
*** HOLE CARDS ***
Dealt to PlayTheBlues4U [8s 3c]
FishyFlopp said, "had AQ"
DemolishIT: calls $0.05
richy5742 leaves the table
Yockit: folds
jjbenzky joins the table at seat #4
PlayTheBlues4U: folds
FishyFlopp: calls $0.03
DeccaDan: checks
*** FLOP *** [5c 7d 8d]
FishyFlopp: checks
DeccaDan: bets $0.05
DemolishIT: calls $0.05
FishyFlopp: calls $0.05
*** TURN *** [5c 7d 8d] [Ah]
FishyFlopp: checks
DeccaDan: checks
DemolishIT: checks
*** RIVER *** [5c 7d 8d Ah] [3h]
FishyFlopp: bets $0.28
DeccaDan: folds
DemolishIT: folds
Uncalled bet ($0.28) returned to FishyFlopp
FishyFlopp collected $0.28 from pot
FishyFlopp: doesn't show hand
*** SUMMARY ***
Total pot $0.30 | Rake $0.02
Board [5c 7d 8d Ah 3h]
Seat 1: Yockit folded before Flop (didn't bet)
Seat 2: PlayTheBlues4U (button) folded before Flop (didn't bet)
Seat 3: FishyFlopp (small blind) collected ($0.28)
Seat 5: DeccaDan (big blind) folded on the River
Seat 6: DemolishIT folded on the River


*********** # 140 **************
PokerStars Hand #203470992018:  Hold'em No Limit ($0.01/$0.02 USD) - 2019/09/06 21:02:42 ET
Table 'Pegasus' 6-max Seat #6 is the button
Seat 2: doc112ocean ($0.96 in chips)
Seat 3: robcandy ($1.74 in chips)
Seat 4: PlayTheBlues4U ($3.13 in chips)
Seat 5: tsov252525 ($2.82 in chips)
Seat 6: TheWalrus435 ($2.09 in chips)
doc112ocean: posts small blind $0.01
robcandy: posts big blind $0.02
*** HOLE CARDS ***
Dealt to PlayTheBlues4U [Ts 5d]
PlayTheBlues4U: folds
tsov252525 has timed out
tsov252525: folds
TheWalrus435: calls $0.02
doc112ocean: calls $0.01
robcandy: checks
*** FLOP *** [7h 4c 7c]
doc112ocean: checks
robcandy: bets $0.02
TheWalrus435: calls $0.02
doc112ocean: calls $0.02
*** TURN *** [7h 4c 7c] [6h]
doc112ocean: bets $0.02
robcandy: calls $0.02
TheWalrus435: calls $0.02
*** RIVER *** [7h 4c 7c 6h] [2c]
doc112ocean: checks
robcandy: bets $0.02
TheWalrus435: calls $0.02
doc112ocean: folds
*** SHOW DOWN ***
robcandy: shows [6d 5c] (two pair, Sevens and Sixes)
TheWalrus435: mucks hand
robcandy collected $0.21 from pot
*** SUMMARY ***
Total pot $0.22 | Rake $0.01
Board [7h 4c 7c 6h 2c]
Seat 2: doc112ocean (small blind) folded on the River
Seat 3: robcandy (big blind) showed [6d 5c] and won ($0.21) with two pair, Sevens and Sixes
Seat 4: PlayTheBlues4U folded before Flop (didn't bet)
Seat 5: tsov252525 folded before Flop (didn't bet)
Seat 6: TheWalrus435 (button) mucked [Kc As]


*********** # 141 **************
PokerStars Hand #203470991853:  Hold'em No Limit ($0.02/$0.05 USD) - 2019/09/06 21:01:42 ET
Table 'Icarus' 6-max Seat #1 is the button
Seat 1: Yockit ($8.27 in chips)
Seat 2: PlayTheBlues4U ($5.75 in chips)
Seat 3: FishyFlopp ($4 in chips)
Seat 4: richy5742 ($4.16 in chips)
Seat 5: DeccaDan ($12.11 in chips)
Seat 6: DemolishIT ($5.44 in chips)
PlayTheBlues4U: posts small blind $0.02
FishyFlopp: posts big blind $0.05
*** HOLE CARDS ***
Dealt to PlayTheBlues4U [Ks As]
richy5742: raises $0.05 to $0.10
DeccaDan: folds
DemolishIT: folds
Yockit: folds
PlayTheBlues4U: calls $0.08
FishyFlopp: raises $0.05 to $0.15
richy5742: calls $0.05
PlayTheBlues4U: raises $0.35 to $0.50
FishyFlopp: calls $0.35
richy5742: raises $3.66 to $4.16 and is all-in
PlayTheBlues4U: raises $1.59 to $5.75 and is all-in
FishyFlopp: folds
Uncalled bet ($1.59) returned to PlayTheBlues4U
*** FLOP *** [8d 7s 6c]
*** TURN *** [8d 7s 6c] [2s]
FishyFlopp said, "lol"
*** RIVER *** [8d 7s 6c 2s] [3d]
*** SHOW DOWN ***
PlayTheBlues4U: shows [Ks As] (high card Ace)
richy5742: shows [Ah Js] (high card Ace - lower kicker)
PlayTheBlues4U collected $8.38 from pot
*** SUMMARY ***
Total pot $8.82 | Rake $0.44
Board [8d 7s 6c 2s 3d]
Seat 1: Yockit (button) folded before Flop (didn't bet)
Seat 2: PlayTheBlues4U (small blind) showed [Ks As] and won ($8.38) with high card Ace
Seat 3: FishyFlopp (big blind) folded before Flop
Seat 4: richy5742 showed [Ah Js] and lost with high card Ace
Seat 5: DeccaDan folded before Flop (didn't bet)
Seat 6: DemolishIT folded before Flop (didn't bet)


*********** # 142 **************
PokerStars Hand #203470991799:  Hold'em No Limit ($0.02/$0.05 USD) - 2019/09/06 21:01:19 ET
Table 'Icarus' 6-max Seat #6 is the button
Seat 1: Yockit ($8.29 in chips)
Seat 2: PlayTheBlues4U ($5.80 in chips)
Seat 4: richy5742 ($4.10 in chips)
Seat 5: DeccaDan ($12.11 in chips)
Seat 6: DemolishIT ($5.44 in chips)
Yockit: posts small blind $0.02
PlayTheBlues4U: posts big blind $0.05
FishyFlopp: sits out
*** HOLE CARDS ***
Dealt to PlayTheBlues4U [Qc 9s]
richy5742: calls $0.05
DeccaDan: folds
DemolishIT: folds
Yockit: folds
PlayTheBlues4U: checks
*** FLOP *** [4d 6d 5s]
PlayTheBlues4U: checks
richy5742: bets $0.10
PlayTheBlues4U: folds
Uncalled bet ($0.10) returned to richy5742
richy5742 collected $0.11 from pot
richy5742: doesn't show hand
*** SUMMARY ***
Total pot $0.12 | Rake $0.01
Board [4d 6d 5s]
Seat 1: Yockit (small blind) folded before Flop
Seat 2: PlayTheBlues4U (big blind) folded on the Flop
Seat 4: richy5742 collected ($0.11)
Seat 5: DeccaDan folded before Flop (didn't bet)
Seat 6: DemolishIT (button) folded before Flop (didn't bet)


*********** # 143 **************
PokerStars Hand #203470991715:  Hold'em No Limit ($0.01/$0.02 USD) - 2019/09/06 21:00:55 ET
Table 'Pegasus' 6-max Seat #5 is the button
Seat 1: michelina44 ($0.78 in chips)
Seat 2: doc112ocean ($0.96 in chips)
Seat 3: robcandy ($1.88 in chips)
Seat 4: PlayTheBlues4U ($3.21 in chips)
Seat 5: tsov252525 ($2.46 in chips)
Seat 6: TheWalrus435 ($2.23 in chips)
TheWalrus435: posts small blind $0.01
michelina44: posts big blind $0.02
*** HOLE CARDS ***
Dealt to PlayTheBlues4U [Jd 8d]
doc112ocean: folds
robcandy: calls $0.02
PlayTheBlues4U: calls $0.02
tsov252525: raises $0.06 to $0.08
TheWalrus435: calls $0.07
michelina44 has timed out
michelina44: folds
robcandy: calls $0.06
PlayTheBlues4U: calls $0.06
*** FLOP *** [6c Td 3h]
TheWalrus435: bets $0.06
robcandy: calls $0.06
PlayTheBlues4U: folds
tsov252525: raises $0.50 to $0.56
TheWalrus435: folds
robcandy: folds
Uncalled bet ($0.50) returned to tsov252525
tsov252525 collected $0.50 from pot
tsov252525: doesn't show hand
*** SUMMARY ***
Total pot $0.52 | Rake $0.02
Board [6c Td 3h]
Seat 1: michelina44 (big blind) folded before Flop
Seat 2: doc112ocean folded before Flop (didn't bet)
Seat 3: robcandy folded on the Flop
Seat 4: PlayTheBlues4U folded on the Flop
Seat 5: tsov252525 (button) collected ($0.50)
Seat 6: TheWalrus435 (small blind) folded on the Flop


*********** # 144 **************
PokerStars Hand #203470991676:  Hold'em No Limit ($0.02/$0.05 USD) - 2019/09/06 21:00:42 ET
Table 'Icarus' 6-max Seat #5 is the button
Seat 1: Yockit ($8.39 in chips)
Seat 2: PlayTheBlues4U ($5.80 in chips)
Seat 4: richy5742 ($3.99 in chips)
Seat 5: DeccaDan ($12.11 in chips)
Seat 6: DemolishIT ($5.46 in chips)
DemolishIT: posts small blind $0.02
Yockit: posts big blind $0.05
FishyFlopp: sits out
*** HOLE CARDS ***
Dealt to PlayTheBlues4U [4d Tc]
PlayTheBlues4U: folds
richy5742: raises $0.05 to $0.10
DeccaDan: folds
DemolishIT: folds
Yockit: calls $0.05
*** FLOP *** [7d 6c Ah]
Yockit: checks
richy5742: bets $0.10
Yockit: folds
Uncalled bet ($0.10) returned to richy5742
richy5742 collected $0.21 from pot
richy5742: doesn't show hand
*** SUMMARY ***
Total pot $0.22 | Rake $0.01
Board [7d 6c Ah]
Seat 1: Yockit (big blind) folded on the Flop
Seat 2: PlayTheBlues4U folded before Flop (didn't bet)
Seat 4: richy5742 collected ($0.21)
Seat 5: DeccaDan (button) folded before Flop (didn't bet)
Seat 6: DemolishIT (small blind) folded before Flop


*********** # 145 **************
PokerStars Hand #203470991555:  Hold'em No Limit ($0.01/$0.02 USD) - 2019/09/06 20:59:51 ET
Table 'Pegasus' 6-max Seat #4 is the button
Seat 1: michelina44 ($0.78 in chips)
Seat 2: doc112ocean ($1.08 in chips)
Seat 3: robcandy ($2 in chips)
Seat 4: PlayTheBlues4U ($3.21 in chips)
Seat 5: tsov252525 ($2.47 in chips)
Seat 6: TheWalrus435 ($2 in chips)
tsov252525: posts small blind $0.01
TheWalrus435: posts big blind $0.02
robcandy: posts big blind $0.02
*** HOLE CARDS ***
Dealt to PlayTheBlues4U [Js 8h]
michelina44: folds
doc112ocean: calls $0.02
robcandy: checks
PlayTheBlues4U: folds
tsov252525: folds
TheWalrus435: checks
*** FLOP *** [9s Td Th]
TheWalrus435: checks
doc112ocean: checks
robcandy: checks
*** TURN *** [9s Td Th] [9h]
TheWalrus435: checks
doc112ocean: checks
robcandy: checks
*** RIVER *** [9s Td Th 9h] [Tc]
TheWalrus435: bets $0.10
doc112ocean: calls $0.10
robcandy: calls $0.10
*** SHOW DOWN ***
TheWalrus435: shows [Ts 6c] (four of a kind, Tens)
doc112ocean: mucks hand
robcandy: mucks hand
TheWalrus435 collected $0.35 from pot
*** SUMMARY ***
Total pot $0.37 | Rake $0.02
Board [9s Td Th 9h Tc]
Seat 1: michelina44 folded before Flop (didn't bet)
Seat 2: doc112ocean mucked [Jc Qs]
Seat 3: robcandy mucked [Kc 2c]
Seat 4: PlayTheBlues4U (button) folded before Flop (didn't bet)
Seat 5: tsov252525 (small blind) folded before Flop
Seat 6: TheWalrus435 (big blind) showed [Ts 6c] and won ($0.35) with four of a kind, Tens


*********** # 146 **************
PokerStars Hand #203470991538:  Hold'em No Limit ($0.02/$0.05 USD) - 2019/09/06 20:59:45 ET
Table 'Icarus' 6-max Seat #4 is the button
Seat 1: Yockit ($8.39 in chips)
Seat 2: PlayTheBlues4U ($5.80 in chips)
Seat 4: richy5742 ($3.63 in chips)
Seat 5: DeccaDan ($12.46 in chips)
Seat 6: DemolishIT ($5.51 in chips)
DeccaDan: posts small blind $0.02
DemolishIT: posts big blind $0.05
*** HOLE CARDS ***
Dealt to PlayTheBlues4U [3s Qd]
FishyFlopp joins the table at seat #3
Yockit: folds
PlayTheBlues4U: folds
richy5742: calls $0.05
DeccaDan: calls $0.03
DemolishIT: checks
*** FLOP *** [6s 4c Kh]
DeccaDan: checks
DemolishIT: checks
richy5742: bets $0.10
DeccaDan: calls $0.10
DemolishIT: folds
*** TURN *** [6s 4c Kh] [As]
DeccaDan: checks
richy5742: checks
*** RIVER *** [6s 4c Kh As] [7c]
DeccaDan: bets $0.20
richy5742: calls $0.20
*** SHOW DOWN ***
DeccaDan: shows [5d 7h] (a pair of Sevens)
richy5742: shows [2d Kd] (a pair of Kings)
richy5742 collected $0.71 from pot
*** SUMMARY ***
Total pot $0.75 | Rake $0.04
Board [6s 4c Kh As 7c]
Seat 1: Yockit folded before Flop (didn't bet)
Seat 2: PlayTheBlues4U folded before Flop (didn't bet)
Seat 4: richy5742 (button) showed [2d Kd] and won ($0.71) with a pair of Kings
Seat 5: DeccaDan (small blind) showed [5d 7h] and lost with a pair of Sevens
Seat 6: DemolishIT (big blind) folded on the Flop


*********** # 147 **************
PokerStars Hand #203470991436:  Hold'em No Limit ($0.02/$0.05 USD) - 2019/09/06 20:58:59 ET
Table 'Icarus' 6-max Seat #2 is the button
Seat 1: Yockit ($8.39 in chips)
Seat 2: PlayTheBlues4U ($5.80 in chips)
Seat 3: 47xx47 ($4.80 in chips)
Seat 4: richy5742 ($3.68 in chips)
Seat 5: DeccaDan ($12.46 in chips)
Seat 6: DemolishIT ($5.45 in chips)
47xx47: posts small blind $0.02
richy5742: posts big blind $0.05
*** HOLE CARDS ***
Dealt to PlayTheBlues4U [8c 2d]
DeccaDan: folds
DemolishIT: calls $0.05
Yockit: folds
PlayTheBlues4U: folds
47xx47: folds
richy5742: checks
*** FLOP *** [6h 8d Th]
richy5742: checks
DemolishIT: bets $0.20
47xx47 leaves the table
richy5742: folds
Uncalled bet ($0.20) returned to DemolishIT
DemolishIT collected $0.11 from pot
*** SUMMARY ***
Total pot $0.12 | Rake $0.01
Board [6h 8d Th]
Seat 1: Yockit folded before Flop (didn't bet)
Seat 2: PlayTheBlues4U (button) folded before Flop (didn't bet)
Seat 3: 47xx47 (small blind) folded before Flop
Seat 4: richy5742 (big blind) folded on the Flop
Seat 5: DeccaDan folded before Flop (didn't bet)
Seat 6: DemolishIT collected ($0.11)


*********** # 148 **************
PokerStars Hand #203470991428:  Hold'em No Limit ($0.01/$0.02 USD) - 2019/09/06 20:58:54 ET
Table 'Pegasus' 6-max Seat #2 is the button
Seat 1: michelina44 ($0.80 in chips)
Seat 2: doc112ocean ($1.10 in chips)
Seat 4: PlayTheBlues4U ($3.22 in chips)
Seat 5: tsov252525 ($2.42 in chips)
PlayTheBlues4U: posts small blind $0.01
tsov252525: posts big blind $0.02
michelina44: posts big blind $0.02
*** HOLE CARDS ***
Dealt to PlayTheBlues4U [Kc 2d]
michelina44: checks
doc112ocean: calls $0.02
robcandy joins the table at seat #3
PlayTheBlues4U: folds
tsov252525: checks
*** FLOP *** [3d 4s 2h]
TheWalrus435 joins the table at seat #6
tsov252525: checks
michelina44: checks
doc112ocean: checks
*** TURN *** [3d 4s 2h] [6d]
tsov252525: checks
michelina44: checks
doc112ocean: checks
*** RIVER *** [3d 4s 2h 6d] [8s]
tsov252525: checks
michelina44: checks
doc112ocean: checks
*** SHOW DOWN ***
tsov252525: shows [Jc 8c] (a pair of Eights)
michelina44: mucks hand
doc112ocean: mucks hand
tsov252525 collected $0.07 from pot
*** SUMMARY ***
Total pot $0.07 | Rake $0
Board [3d 4s 2h 6d 8s]
Seat 1: michelina44 mucked [Qs Js]
Seat 2: doc112ocean (button) mucked [Ts 9c]
Seat 4: PlayTheBlues4U (small blind) folded before Flop
Seat 5: tsov252525 (big blind) showed [Jc 8c] and won ($0.07) with a pair of Eights


*********** # 149 **************
PokerStars Hand #203470991367:  Hold'em No Limit ($0.01/$0.02 USD) - 2019/09/06 20:58:23 ET
Table 'Pegasus' 6-max Seat #5 is the button
Seat 2: doc112ocean ($1.12 in chips)
Seat 4: PlayTheBlues4U ($3.20 in chips)
Seat 5: tsov252525 ($2.42 in chips)
michelina44 will be allowed to play after the button
doc112ocean: posts small blind $0.01
PlayTheBlues4U: posts big blind $0.02
*** HOLE CARDS ***
Dealt to PlayTheBlues4U [8d 4d]
tsov252525: folds
doc112ocean: calls $0.01
PlayTheBlues4U: checks
*** FLOP *** [5s Tc 2h]
doc112ocean: checks
PlayTheBlues4U: checks
*** TURN *** [5s Tc 2h] [8c]
doc112ocean: checks
PlayTheBlues4U: bets $0.04
doc112ocean: folds
Uncalled bet ($0.04) returned to PlayTheBlues4U
PlayTheBlues4U collected $0.04 from pot
PlayTheBlues4U: doesn't show hand
*** SUMMARY ***
Total pot $0.04 | Rake $0
Board [5s Tc 2h 8c]
Seat 2: doc112ocean (small blind) folded on the Turn
Seat 4: PlayTheBlues4U (big blind) collected ($0.04)
Seat 5: tsov252525 (button) folded before Flop (didn't bet)


*********** # 150 **************
PokerStars Hand #203470991339:  Hold'em No Limit ($0.02/$0.05 USD) - 2019/09/06 20:58:11 ET
Table 'Icarus' 6-max Seat #1 is the button
Seat 1: Yockit ($8.30 in chips)
Seat 2: PlayTheBlues4U ($5.85 in chips)
Seat 3: 47xx47 ($4.85 in chips)
Seat 4: richy5742 ($3.68 in chips)
Seat 5: DeccaDan ($12.46 in chips)
Seat 6: DemolishIT ($5.45 in chips)
PlayTheBlues4U: posts small blind $0.02
47xx47: posts big blind $0.05
*** HOLE CARDS ***
Dealt to PlayTheBlues4U [6h Tc]
richy5742: folds
DeccaDan: folds
DemolishIT: folds
Yockit: calls $0.05
PlayTheBlues4U: calls $0.03
47xx47: checks
*** FLOP *** [Jd 4h 2c]
PlayTheBlues4U: checks
47xx47: checks
Yockit: checks
*** TURN *** [Jd 4h 2c] [5h]
PlayTheBlues4U: checks
47xx47: checks
Yockit: checks
*** RIVER *** [Jd 4h 2c 5h] [8s]
PlayTheBlues4U: checks
47xx47: checks
Yockit: checks
*** SHOW DOWN ***
PlayTheBlues4U: shows [6h Tc] (high card Jack)
47xx47: shows [7c Kh] (high card King)
Yockit: shows [Ks Qh] (high card King - Queen kicker)
Yockit collected $0.14 from pot
*** SUMMARY ***
Total pot $0.15 | Rake $0.01
Board [Jd 4h 2c 5h 8s]
Seat 1: Yockit (button) showed [Ks Qh] and won ($0.14) with high card King
Seat 2: PlayTheBlues4U (small blind) showed [6h Tc] and lost with high card Jack
Seat 3: 47xx47 (big blind) showed [7c Kh] and lost with high card King
Seat 4: richy5742 folded before Flop (didn't bet)
Seat 5: DeccaDan folded before Flop (didn't bet)
Seat 6: DemolishIT folded before Flop (didn't bet)


*********** # 151 **************
PokerStars Hand #203470991314:  Hold'em No Limit ($0.01/$0.02 USD) - 2019/09/06 20:57:59 ET
Table 'Pegasus' 6-max Seat #4 is the button
Seat 2: doc112ocean ($1.20 in chips)
Seat 4: PlayTheBlues4U ($3.20 in chips)
Seat 5: tsov252525 ($2.35 in chips)
tsov252525: posts small blind $0.01
doc112ocean: posts big blind $0.02
*** HOLE CARDS ***
Dealt to PlayTheBlues4U [7c 5h]
PlayTheBlues4U: folds
tsov252525: raises $0.06 to $0.08
doc112ocean: calls $0.06
*** FLOP *** [Qh 7h 9s]
michelina44 joins the table at seat #1
tsov252525: bets $0.10
doc112ocean: folds
Uncalled bet ($0.10) returned to tsov252525
tsov252525 collected $0.15 from pot
tsov252525: doesn't show hand
*** SUMMARY ***
Total pot $0.16 | Rake $0.01
Board [Qh 7h 9s]
Seat 2: doc112ocean (big blind) folded on the Flop
Seat 4: PlayTheBlues4U (button) folded before Flop (didn't bet)
Seat 5: tsov252525 (small blind) collected ($0.15)


*********** # 152 **************
PokerStars Hand #203470991248:  Hold'em No Limit ($0.01/$0.02 USD) - 2019/09/06 20:57:28 ET
Table 'Pegasus' 6-max Seat #2 is the button
Seat 1: Zeos179 ($3.90 in chips)
Seat 2: doc112ocean ($1.20 in chips)
Seat 4: PlayTheBlues4U ($3.18 in chips)
Seat 5: tsov252525 ($2.37 in chips)
PlayTheBlues4U: posts small blind $0.01
tsov252525: posts big blind $0.02
*** HOLE CARDS ***
Dealt to PlayTheBlues4U [6s Js]
Zeos179: folds
doc112ocean: folds
Zeos179 leaves the table
PlayTheBlues4U: calls $0.01
JPcaked joins the table at seat #1
tsov252525: checks
*** FLOP *** [3s Ah 6h]
PlayTheBlues4U: bets $0.04
JPcaked leaves the table
tsov252525: folds
Uncalled bet ($0.04) returned to PlayTheBlues4U
PlayTheBlues4U collected $0.04 from pot
PlayTheBlues4U: doesn't show hand
*** SUMMARY ***
Total pot $0.04 | Rake $0
Board [3s Ah 6h]
Seat 1: Zeos179 folded before Flop (didn't bet)
Seat 2: doc112ocean (button) folded before Flop (didn't bet)
Seat 4: PlayTheBlues4U (small blind) collected ($0.04)
Seat 5: tsov252525 (big blind) folded on the Flop


*********** # 153 **************
PokerStars Hand #203470991233:  Hold'em No Limit ($0.02/$0.05 USD) - 2019/09/06 20:57:23 ET
Table 'Icarus' 6-max Seat #6 is the button
Seat 1: Yockit ($8.12 in chips)
Seat 2: PlayTheBlues4U ($5.90 in chips)
Seat 3: 47xx47 ($4.85 in chips)
Seat 4: richy5742 ($3.78 in chips)
Seat 5: DeccaDan ($12.46 in chips)
Seat 6: DemolishIT ($5.50 in chips)
Yockit: posts small blind $0.02
PlayTheBlues4U: posts big blind $0.05
*** HOLE CARDS ***
Dealt to PlayTheBlues4U [Ks 8s]
47xx47: folds
richy5742: calls $0.05
DeccaDan: folds
DemolishIT: calls $0.05
Yockit: calls $0.03
PlayTheBlues4U: checks
*** FLOP *** [Qc 6h 2d]
Yockit: bets $0.05
PlayTheBlues4U: folds
richy5742: calls $0.05
DemolishIT: folds
*** TURN *** [Qc 6h 2d] [5h]
Yockit: checks
richy5742: checks
*** RIVER *** [Qc 6h 2d 5h] [6d]
Yockit: checks
richy5742: checks
*** SHOW DOWN ***
Yockit: shows [Js Jc] (two pair, Jacks and Sixes)
richy5742: mucks hand
Yockit collected $0.28 from pot
*** SUMMARY ***
Total pot $0.30 | Rake $0.02
Board [Qc 6h 2d 5h 6d]
Seat 1: Yockit (small blind) showed [Js Jc] and won ($0.28) with two pair, Jacks and Sixes
Seat 2: PlayTheBlues4U (big blind) folded on the Flop
Seat 3: 47xx47 folded before Flop (didn't bet)
Seat 4: richy5742 mucked [7c 7h]
Seat 5: DeccaDan folded before Flop (didn't bet)
Seat 6: DemolishIT (button) folded on the Flop


*********** # 154 **************
PokerStars Hand #203470991180:  Hold'em No Limit ($0.01/$0.02 USD) - 2019/09/06 20:57:00 ET
Table 'Pegasus' 6-max Seat #1 is the button
Seat 1: Zeos179 ($3.90 in chips)
Seat 2: doc112ocean ($1.18 in chips)
Seat 4: PlayTheBlues4U ($3.20 in chips)
Seat 5: tsov252525 ($2.37 in chips)
doc112ocean: posts small blind $0.01
PlayTheBlues4U: posts big blind $0.02
*** HOLE CARDS ***
Dealt to PlayTheBlues4U [6c 4h]
tsov252525: folds
Zeos179: folds
doc112ocean: calls $0.01
PlayTheBlues4U: checks
*** FLOP *** [Ks 9d Jh]
doc112ocean: checks
PlayTheBlues4U: checks
*** TURN *** [Ks 9d Jh] [Kh]
doc112ocean: checks
PlayTheBlues4U: checks
*** RIVER *** [Ks 9d Jh Kh] [Kc]
doc112ocean: checks
PlayTheBlues4U: checks
*** SHOW DOWN ***
doc112ocean: shows [4c As] (three of a kind, Kings)
PlayTheBlues4U: mucks hand
doc112ocean collected $0.04 from pot
*** SUMMARY ***
Total pot $0.04 | Rake $0
Board [Ks 9d Jh Kh Kc]
Seat 1: Zeos179 (button) folded before Flop (didn't bet)
Seat 2: doc112ocean (small blind) showed [4c As] and won ($0.04) with three of a kind, Kings
Seat 4: PlayTheBlues4U (big blind) mucked [6c 4h]
Seat 5: tsov252525 folded before Flop (didn't bet)


*********** # 155 **************
PokerStars Hand #203470991166:  Hold'em No Limit ($0.02/$0.05 USD) - 2019/09/06 20:56:54 ET
Table 'Icarus' 6-max Seat #5 is the button
Seat 1: Yockit ($8.17 in chips)
Seat 2: PlayTheBlues4U ($5.90 in chips)
Seat 3: 47xx47 ($2.90 in chips)
Seat 4: richy5742 ($3.78 in chips)
Seat 5: DeccaDan ($12.46 in chips)
Seat 6: DemolishIT ($5.30 in chips)
DemolishIT: posts small blind $0.02
Yockit: posts big blind $0.05
*** HOLE CARDS ***
Dealt to PlayTheBlues4U [5h 8h]
PlayTheBlues4U: folds
47xx47: raises $0.10 to $0.15
richy5742: folds
DeccaDan: folds
DemolishIT: raises $0.60 to $0.75
Yockit: folds
47xx47: folds
Uncalled bet ($0.60) returned to DemolishIT
DemolishIT collected $0.35 from pot
DemolishIT: doesn't show hand
*** SUMMARY ***
Total pot $0.35 | Rake $0
Seat 1: Yockit (big blind) folded before Flop
Seat 2: PlayTheBlues4U folded before Flop (didn't bet)
Seat 3: 47xx47 folded before Flop
Seat 4: richy5742 folded before Flop (didn't bet)
Seat 5: DeccaDan (button) folded before Flop (didn't bet)
Seat 6: DemolishIT (small blind) collected ($0.35)


*********** # 156 **************
PokerStars Hand #203470991148:  Hold'em No Limit ($0.01/$0.02 USD) - 2019/09/06 20:56:48 ET
Table 'Pegasus' 6-max Seat #5 is the button
Seat 1: Zeos179 ($3.91 in chips)
Seat 2: doc112ocean ($1.20 in chips)
Seat 4: PlayTheBlues4U ($3.17 in chips)
Seat 5: tsov252525 ($2.37 in chips)
Zeos179: posts small blind $0.01
doc112ocean: posts big blind $0.02
*** HOLE CARDS ***
Dealt to PlayTheBlues4U [Kd Qd]
PlayTheBlues4U: raises $0.06 to $0.08
tsov252525: folds
Zeos179: folds
doc112ocean: folds
Uncalled bet ($0.06) returned to PlayTheBlues4U
PlayTheBlues4U collected $0.05 from pot
PlayTheBlues4U: doesn't show hand
*** SUMMARY ***
Total pot $0.05 | Rake $0
Seat 1: Zeos179 (small blind) folded before Flop
Seat 2: doc112ocean (big blind) folded before Flop
Seat 4: PlayTheBlues4U collected ($0.05)
Seat 5: tsov252525 (button) folded before Flop (didn't bet)


*********** # 157 **************
PokerStars Hand #203470699983:  Hold'em No Limit ($0.01/$0.02 USD) - 2019/09/06 20:56:18 ET
Table 'Pegasus' 6-max Seat #4 is the button
Seat 1: Zeos179 ($3.79 in chips)
Seat 2: doc112ocean ($1.32 in chips)
Seat 4: PlayTheBlues4U ($3.17 in chips)
Seat 5: tsov252525 ($2.38 in chips)
tsov252525: posts small blind $0.01
Zeos179: posts big blind $0.02
*** HOLE CARDS ***
Dealt to PlayTheBlues4U [7d 3c]
doc112ocean: calls $0.02
PlayTheBlues4U: folds
tsov252525: folds
Zeos179: checks
*** FLOP *** [6c 4s 5c]
Zeos179: checks
doc112ocean: bets $0.10
Zeos179: calls $0.10
*** TURN *** [6c 4s 5c] [6d]
Zeos179: checks
doc112ocean: checks
*** RIVER *** [6c 4s 5c 6d] [Tc]
Zeos179: checks
doc112ocean: checks
*** SHOW DOWN ***
Zeos179: shows [4h 7c] (two pair, Sixes and Fours)
doc112ocean: mucks hand
Zeos179 collected $0.24 from pot
*** SUMMARY ***
Total pot $0.25 | Rake $0.01
Board [6c 4s 5c 6d Tc]
Seat 1: Zeos179 (big blind) showed [4h 7c] and won ($0.24) with two pair, Sixes and Fours
Seat 2: doc112ocean mucked [Ad Ks]
Seat 4: PlayTheBlues4U (button) folded before Flop (didn't bet)
Seat 5: tsov252525 (small blind) folded before Flop


*********** # 158 **************
PokerStars Hand #203470699931:  Hold'em No Limit ($0.01/$0.02 USD) - 2019/09/06 20:55:52 ET
Table 'Pegasus' 6-max Seat #2 is the button
Seat 1: Zeos179 ($3.81 in chips)
Seat 2: doc112ocean ($1.32 in chips)
Seat 4: PlayTheBlues4U ($3.18 in chips)
Seat 5: tsov252525 ($2.35 in chips)
PlayTheBlues4U: posts small blind $0.01
tsov252525: posts big blind $0.02
*** HOLE CARDS ***
Dealt to PlayTheBlues4U [Jd 7h]
Zeos179: calls $0.02
doc112ocean: folds
PlayTheBlues4U: folds
tsov252525: checks
*** FLOP *** [9c 5c 9d]
tsov252525: checks
Zeos179: checks
*** TURN *** [9c 5c 9d] [6s]
tsov252525: bets $0.05
Zeos179: folds
Uncalled bet ($0.05) returned to tsov252525
tsov252525 collected $0.05 from pot
tsov252525: doesn't show hand
*** SUMMARY ***
Total pot $0.05 | Rake $0
Board [9c 5c 9d 6s]
Seat 1: Zeos179 folded on the Turn
Seat 2: doc112ocean (button) folded before Flop (didn't bet)
Seat 4: PlayTheBlues4U (small blind) folded before Flop
Seat 5: tsov252525 (big blind) collected ($0.05)


*********** # 159 **************
PokerStars Hand #203470699899:  Hold'em No Limit ($0.01/$0.02 USD) - 2019/09/06 20:55:36 ET
Table 'Pegasus' 6-max Seat #1 is the button
Seat 1: Zeos179 ($3.78 in chips)
Seat 2: doc112ocean ($1.33 in chips)
Seat 4: PlayTheBlues4U ($3.20 in chips)
Seat 5: tsov252525 ($2.35 in chips)
doc112ocean: posts small blind $0.01
PlayTheBlues4U: posts big blind $0.02
*** HOLE CARDS ***
Dealt to PlayTheBlues4U [Kc Jd]
tsov252525: folds
Zeos179: raises $0.16 to $0.18
doc112ocean: folds
PlayTheBlues4U: folds
Uncalled bet ($0.16) returned to Zeos179
Zeos179 collected $0.05 from pot
Zeos179: doesn't show hand
*** SUMMARY ***
Total pot $0.05 | Rake $0
Seat 1: Zeos179 (button) collected ($0.05)
Seat 2: doc112ocean (small blind) folded before Flop
Seat 4: PlayTheBlues4U (big blind) folded before Flop
Seat 5: tsov252525 folded before Flop (didn't bet)


*********** # 160 **************
PokerStars Hand #203470699894:  Hold'em No Limit ($0.02/$0.05 USD) - 2019/09/06 20:55:34 ET
Table 'Icarus' 6-max Seat #4 is the button
Seat 1: Yockit ($6.54 in chips)
Seat 2: PlayTheBlues4U ($5.90 in chips)
Seat 3: 47xx47 ($2.95 in chips)
Seat 4: richy5742 ($5.43 in chips)
Seat 5: DeccaDan ($12.51 in chips)
Seat 6: DemolishIT ($5.35 in chips)
DeccaDan: posts small blind $0.02
DemolishIT: posts big blind $0.05
*** HOLE CARDS ***
Dealt to PlayTheBlues4U [5d 4h]
Yockit: calls $0.05
PlayTheBlues4U: folds
47xx47: calls $0.05
richy5742: calls $0.05
DeccaDan: calls $0.03
DemolishIT: checks
*** FLOP *** [Ac Ad Jc]
DeccaDan: checks
DemolishIT: checks
Yockit: checks
47xx47: checks
richy5742: bets $0.15
DeccaDan: folds
DemolishIT: folds
Yockit: calls $0.15
47xx47: folds
*** TURN *** [Ac Ad Jc] [Qh]
Yockit: checks
richy5742: bets $0.10
Yockit: raises $0.35 to $0.45
richy5742: calls $0.35
*** RIVER *** [Ac Ad Jc Qh] [7h]
Yockit: bets $1
richy5742: calls $1
*** SHOW DOWN ***
Yockit: shows [Ts Kh] (a straight, Ten to Ace)
richy5742: mucks hand
Yockit collected $3.28 from pot
*** SUMMARY ***
Total pot $3.45 | Rake $0.17
Board [Ac Ad Jc Qh 7h]
Seat 1: Yockit showed [Ts Kh] and won ($3.28) with a straight, Ten to Ace
Seat 2: PlayTheBlues4U folded before Flop (didn't bet)
Seat 3: 47xx47 folded on the Flop
Seat 4: richy5742 (button) mucked [9c Qd]
Seat 5: DeccaDan (small blind) folded on the Flop
Seat 6: DemolishIT (big blind) folded on the Flop


*********** # 161 **************
PokerStars Hand #203470699868:  Hold'em No Limit ($0.01/$0.02 USD) - 2019/09/06 20:55:22 ET
Table 'Pegasus' 6-max Seat #5 is the button
Seat 1: Zeos179 ($3.79 in chips)
Seat 2: doc112ocean ($1.32 in chips)
Seat 4: PlayTheBlues4U ($3.20 in chips)
Seat 5: tsov252525 ($2.35 in chips)
Zeos179: posts small blind $0.01
doc112ocean: posts big blind $0.02
*** HOLE CARDS ***
Dealt to PlayTheBlues4U [Kc 4d]
PlayTheBlues4U: folds
tsov252525: folds
Zeos179: folds
Uncalled bet ($0.01) returned to doc112ocean
doc112ocean collected $0.02 from pot
*** SUMMARY ***
Total pot $0.02 | Rake $0
Seat 1: Zeos179 (small blind) folded before Flop
Seat 2: doc112ocean (big blind) collected ($0.02)
Seat 4: PlayTheBlues4U folded before Flop (didn't bet)
Seat 5: tsov252525 (button) folded before Flop (didn't bet)


*********** # 162 **************
PokerStars Hand #203470699799:  Hold'em No Limit ($0.01/$0.02 USD) - 2019/09/06 20:54:57 ET
Table 'Pegasus' 6-max Seat #4 is the button
Seat 1: Zeos179 ($3.81 in chips)
Seat 2: doc112ocean ($1.32 in chips)
Seat 4: PlayTheBlues4U ($3.17 in chips)
Seat 5: tsov252525 ($2.36 in chips)
tsov252525: posts small blind $0.01
Zeos179: posts big blind $0.02
*** HOLE CARDS ***
Dealt to PlayTheBlues4U [Kd 5h]
doc112ocean: folds
PlayTheBlues4U: raises $0.04 to $0.06
tsov252525: folds
Zeos179: folds
Uncalled bet ($0.04) returned to PlayTheBlues4U
PlayTheBlues4U collected $0.05 from pot
PlayTheBlues4U: doesn't show hand
*** SUMMARY ***
Total pot $0.05 | Rake $0
Seat 1: Zeos179 (big blind) folded before Flop
Seat 2: doc112ocean folded before Flop (didn't bet)
Seat 4: PlayTheBlues4U (button) collected ($0.05)
Seat 5: tsov252525 (small blind) folded before Flop


*********** # 163 **************
PokerStars Hand #203470699695:  Hold'em No Limit ($0.01/$0.02 USD) - 2019/09/06 20:54:21 ET
Table 'Pegasus' 6-max Seat #2 is the button
Seat 1: Zeos179 ($3.81 in chips)
Seat 2: doc112ocean ($1.37 in chips)
Seat 4: PlayTheBlues4U ($3.18 in chips)
Seat 5: tsov252525 ($2.30 in chips)
PlayTheBlues4U: posts small blind $0.01
tsov252525: posts big blind $0.02
*** HOLE CARDS ***
Dealt to PlayTheBlues4U [8s 5d]
Zeos179: folds
doc112ocean: calls $0.02
PlayTheBlues4U: folds
tsov252525: checks
*** FLOP *** [3c 7c Tc]
tsov252525: checks
doc112ocean: checks
*** TURN *** [3c 7c Tc] [2h]
tsov252525: bets $0.03
doc112ocean: calls $0.03
*** RIVER *** [3c 7c Tc 2h] [4s]
tsov252525: bets $0.06
doc112ocean: folds
Uncalled bet ($0.06) returned to tsov252525
tsov252525 collected $0.11 from pot
tsov252525: doesn't show hand
*** SUMMARY ***
Total pot $0.11 | Rake $0
Board [3c 7c Tc 2h 4s]
Seat 1: Zeos179 folded before Flop (didn't bet)
Seat 2: doc112ocean (button) folded on the River
Seat 4: PlayTheBlues4U (small blind) folded before Flop
Seat 5: tsov252525 (big blind) collected ($0.11)


*********** # 164 **************
PokerStars Hand #203470699685:  Hold'em No Limit ($0.02/$0.05 USD) - 2019/09/06 20:54:18 ET
Table 'Icarus' 6-max Seat #3 is the button
Seat 1: Yockit ($6.59 in chips)
Seat 2: PlayTheBlues4U ($5.90 in chips)
Seat 3: 47xx47 ($3 in chips)
Seat 4: richy5742 ($5.78 in chips)
Seat 5: DeccaDan ($12.10 in chips)
Seat 6: DemolishIT ($5.35 in chips)
richy5742: posts small blind $0.02
DeccaDan: posts big blind $0.05
*** HOLE CARDS ***
Dealt to PlayTheBlues4U [5s 2d]
DemolishIT: folds
Yockit: calls $0.05
PlayTheBlues4U: folds
47xx47: calls $0.05
richy5742: calls $0.03
DeccaDan: checks
*** FLOP *** [9d 8c 6h]
richy5742: checks
DeccaDan: bets $0.10
Yockit: folds
47xx47: folds
richy5742: calls $0.10
*** TURN *** [9d 8c 6h] [Ad]
richy5742: checks
DeccaDan: checks
*** RIVER *** [9d 8c 6h Ad] [Js]
richy5742: bets $0.10
DeccaDan: raises $0.10 to $0.20
richy5742: calls $0.10
*** SHOW DOWN ***
DeccaDan: shows [Jh 8s] (two pair, Jacks and Eights)
richy5742: mucks hand
DeccaDan collected $0.76 from pot
*** SUMMARY ***
Total pot $0.80 | Rake $0.04
Board [9d 8c 6h Ad Js]
Seat 1: Yockit folded on the Flop
Seat 2: PlayTheBlues4U folded before Flop (didn't bet)
Seat 3: 47xx47 (button) folded on the Flop
Seat 4: richy5742 (small blind) mucked [6c Kc]
Seat 5: DeccaDan (big blind) showed [Jh 8s] and won ($0.76) with two pair, Jacks and Eights
Seat 6: DemolishIT folded before Flop (didn't bet)


*********** # 165 **************
PokerStars Hand #203470699580:  Hold'em No Limit ($0.01/$0.02 USD) - 2019/09/06 20:53:47 ET
Table 'Pegasus' 6-max Seat #1 is the button
Seat 1: Zeos179 ($3.81 in chips)
Seat 2: doc112ocean ($1.28 in chips)
Seat 4: PlayTheBlues4U ($3.28 in chips)
Seat 5: tsov252525 ($2.30 in chips)
doc112ocean: posts small blind $0.01
PlayTheBlues4U: posts big blind $0.02
*** HOLE CARDS ***
Dealt to PlayTheBlues4U [8c Jh]
tsov252525: folds
Zeos179: folds
doc112ocean: calls $0.01
PlayTheBlues4U: checks
*** FLOP *** [Kc 3d 4s]
doc112ocean: checks
PlayTheBlues4U: bets $0.02
doc112ocean: calls $0.02
*** TURN *** [Kc 3d 4s] [Ah]
doc112ocean: checks
PlayTheBlues4U: checks
*** RIVER *** [Kc 3d 4s Ah] [6d]
doc112ocean: checks
PlayTheBlues4U: bets $0.06
doc112ocean: calls $0.06
*** SHOW DOWN ***
PlayTheBlues4U: shows [8c Jh] (high card Ace)
doc112ocean: shows [4d 5d] (a pair of Fours)
doc112ocean collected $0.19 from pot
*** SUMMARY ***
Total pot $0.20 | Rake $0.01
Board [Kc 3d 4s Ah 6d]
Seat 1: Zeos179 (button) folded before Flop (didn't bet)
Seat 2: doc112ocean (small blind) showed [4d 5d] and won ($0.19) with a pair of Fours
Seat 4: PlayTheBlues4U (big blind) showed [8c Jh] and lost with high card Ace
Seat 5: tsov252525 folded before Flop (didn't bet)


*********** # 166 **************
PokerStars Hand #203470699483:  Hold'em No Limit ($0.02/$0.05 USD) - 2019/09/06 20:53:17 ET
Table 'Icarus' 6-max Seat #2 is the button
Seat 1: Yockit ($6.45 in chips)
Seat 2: PlayTheBlues4U ($5.90 in chips)
Seat 3: 47xx47 ($3.05 in chips)
Seat 4: richy5742 ($5.83 in chips)
Seat 5: DeccaDan ($12.15 in chips)
Seat 6: DemolishIT ($5.35 in chips)
47xx47: posts small blind $0.02
richy5742: posts big blind $0.05
*** HOLE CARDS ***
Dealt to PlayTheBlues4U [2c 9c]
DeccaDan: calls $0.05
DemolishIT: folds
Yockit: calls $0.05
PlayTheBlues4U: folds
47xx47: calls $0.03
richy5742: checks
*** FLOP *** [6s 8s Qc]
47xx47: checks
richy5742: checks
DeccaDan: checks
Yockit: checks
*** TURN *** [6s 8s Qc] [Tc]
47xx47: checks
richy5742: checks
DeccaDan: checks
Yockit: bets $0.15
47xx47: folds
richy5742: folds
DeccaDan: folds
Uncalled bet ($0.15) returned to Yockit
Yockit collected $0.19 from pot
Yockit: doesn't show hand
*** SUMMARY ***
Total pot $0.20 | Rake $0.01
Board [6s 8s Qc Tc]
Seat 1: Yockit collected ($0.19)
Seat 2: PlayTheBlues4U (button) folded before Flop (didn't bet)
Seat 3: 47xx47 (small blind) folded on the Turn
Seat 4: richy5742 (big blind) folded on the Turn
Seat 5: DeccaDan folded on the Turn
Seat 6: DemolishIT folded before Flop (didn't bet)


*********** # 167 **************
PokerStars Hand #203470699407:  Hold'em No Limit ($0.01/$0.02 USD) - 2019/09/06 20:52:52 ET
Table 'Pegasus' 6-max Seat #5 is the button
Seat 1: Zeos179 ($3.46 in chips)
Seat 2: doc112ocean ($1.54 in chips)
Seat 4: PlayTheBlues4U ($3.34 in chips)
Seat 5: tsov252525 ($2.36 in chips)
Zeos179: posts small blind $0.01
doc112ocean: posts big blind $0.02
*** HOLE CARDS ***
Dealt to PlayTheBlues4U [Ad 6c]
PlayTheBlues4U: raises $0.04 to $0.06
tsov252525: calls $0.06
Zeos179: calls $0.05
doc112ocean: calls $0.04
*** FLOP *** [9s 4s Qd]
Zeos179: checks
doc112ocean: bets $0.10
PlayTheBlues4U: folds
tsov252525: folds
Zeos179: calls $0.10
*** TURN *** [9s 4s Qd] [7s]
Zeos179: checks
doc112ocean: bets $0.10
Zeos179: calls $0.10
*** RIVER *** [9s 4s Qd 7s] [Js]
Zeos179: checks
doc112ocean: checks
*** SHOW DOWN ***
Zeos179: shows [Ts Jc] (a flush, Jack high)
doc112ocean: mucks hand
Zeos179 collected $0.61 from pot
*** SUMMARY ***
Total pot $0.64 | Rake $0.03
Board [9s 4s Qd 7s Js]
Seat 1: Zeos179 (small blind) showed [Ts Jc] and won ($0.61) with a flush, Jack high
Seat 2: doc112ocean (big blind) mucked [Qh Td]
Seat 4: PlayTheBlues4U folded on the Flop
Seat 5: tsov252525 (button) folded on the Flop


*********** # 168 **************
PokerStars Hand #203470699358:  Hold'em No Limit ($0.02/$0.05 USD) - 2019/09/06 20:52:36 ET
Table 'Icarus' 6-max Seat #1 is the button
Seat 1: Yockit ($6.34 in chips)
Seat 2: PlayTheBlues4U ($5.92 in chips)
Seat 3: 47xx47 ($3.10 in chips)
Seat 4: richy5742 ($5.83 in chips)
Seat 5: DeccaDan ($12.20 in chips)
Seat 6: DemolishIT ($5.35 in chips)
PlayTheBlues4U: posts small blind $0.02
47xx47: posts big blind $0.05
*** HOLE CARDS ***
Dealt to PlayTheBlues4U [Qd 3h]
richy5742: folds
DeccaDan: calls $0.05
DemolishIT: folds
Yockit: calls $0.05
PlayTheBlues4U: folds
47xx47: checks
*** FLOP *** [3s Kc Ah]
47xx47: checks
DeccaDan: checks
Yockit: bets $0.10
47xx47: folds
DeccaDan: folds
Uncalled bet ($0.10) returned to Yockit
Yockit collected $0.16 from pot
Yockit: doesn't show hand
*** SUMMARY ***
Total pot $0.17 | Rake $0.01
Board [3s Kc Ah]
Seat 1: Yockit (button) collected ($0.16)
Seat 2: PlayTheBlues4U (small blind) folded before Flop
Seat 3: 47xx47 (big blind) folded on the Flop
Seat 4: richy5742 folded before Flop (didn't bet)
Seat 5: DeccaDan folded on the Flop
Seat 6: DemolishIT folded before Flop (didn't bet)


*********** # 169 **************
PokerStars Hand #203470699285:  Hold'em No Limit ($0.01/$0.02 USD) - 2019/09/06 20:52:16 ET
Table 'Pegasus' 6-max Seat #4 is the button
Seat 1: Zeos179 ($3.50 in chips)
Seat 2: doc112ocean ($1.49 in chips)
Seat 4: PlayTheBlues4U ($3.34 in chips)
Seat 5: tsov252525 ($2.37 in chips)
tsov252525: posts small blind $0.01
Zeos179: posts big blind $0.02
*** HOLE CARDS ***
Dealt to PlayTheBlues4U [Qd 6d]
doc112ocean: calls $0.02
PlayTheBlues4U: folds
tsov252525: folds
Zeos179: checks
*** FLOP *** [2h 5h 9d]
Zeos179: bets $0.02
doc112ocean: calls $0.02
*** TURN *** [2h 5h 9d] [Jh]
Zeos179: checks
doc112ocean: bets $0.10
Zeos179: folds
Uncalled bet ($0.10) returned to doc112ocean
doc112ocean collected $0.09 from pot
*** SUMMARY ***
Total pot $0.09 | Rake $0
Board [2h 5h 9d Jh]
Seat 1: Zeos179 (big blind) folded on the Turn
Seat 2: doc112ocean collected ($0.09)
Seat 4: PlayTheBlues4U (button) folded before Flop (didn't bet)
Seat 5: tsov252525 (small blind) folded before Flop


*********** # 170 **************
PokerStars Hand #203470699222:  Hold'em No Limit ($0.01/$0.02 USD) - 2019/09/06 20:51:59 ET
Table 'Pegasus' 6-max Seat #2 is the button
Seat 1: Zeos179 ($3.50 in chips)
Seat 2: doc112ocean ($1.49 in chips)
Seat 4: PlayTheBlues4U ($3.35 in chips)
Seat 5: tsov252525 ($2.36 in chips)
PlayTheBlues4U: posts small blind $0.01
tsov252525: posts big blind $0.02
*** HOLE CARDS ***
Dealt to PlayTheBlues4U [5h 3s]
Zeos179: folds
doc112ocean: folds
PlayTheBlues4U: folds
Uncalled bet ($0.01) returned to tsov252525
tsov252525 collected $0.02 from pot
tsov252525: doesn't show hand
*** SUMMARY ***
Total pot $0.02 | Rake $0
Seat 1: Zeos179 folded before Flop (didn't bet)
Seat 2: doc112ocean (button) folded before Flop (didn't bet)
Seat 4: PlayTheBlues4U (small blind) folded before Flop
Seat 5: tsov252525 (big blind) collected ($0.02)


*********** # 171 **************
PokerStars Hand #203470699189:  Hold'em No Limit ($0.02/$0.05 USD) - 2019/09/06 20:51:49 ET
Table 'Icarus' 6-max Seat #6 is the button
Seat 1: Yockit ($6.36 in chips)
Seat 2: PlayTheBlues4U ($5.97 in chips)
Seat 3: 47xx47 ($3.10 in chips)
Seat 4: richy5742 ($5.83 in chips)
Seat 5: DeccaDan ($12.55 in chips)
Seat 6: DemolishIT ($4.97 in chips)
Yockit: posts small blind $0.02
PlayTheBlues4U: posts big blind $0.05
*** HOLE CARDS ***
Dealt to PlayTheBlues4U [Qs 3h]
47xx47: folds
richy5742: folds
DeccaDan: calls $0.05
DemolishIT: raises $0.30 to $0.35
Yockit: folds
PlayTheBlues4U: folds
DeccaDan: calls $0.30
*** FLOP *** [2c Qd 8d]
DeccaDan: checks
DemolishIT: checks
*** TURN *** [2c Qd 8d] [3s]
DeccaDan: checks
DemolishIT: checks
*** RIVER *** [2c Qd 8d 3s] [Jc]
DeccaDan: checks
DemolishIT: checks
*** SHOW DOWN ***
DeccaDan: shows [4s 5s] (high card Queen)
DemolishIT: shows [Ad Td] (high card Ace)
DemolishIT collected $0.73 from pot
*** SUMMARY ***
Total pot $0.77 | Rake $0.04
Board [2c Qd 8d 3s Jc]
Seat 1: Yockit (small blind) folded before Flop
Seat 2: PlayTheBlues4U (big blind) folded before Flop
Seat 3: 47xx47 folded before Flop (didn't bet)
Seat 4: richy5742 folded before Flop (didn't bet)
Seat 5: DeccaDan showed [4s 5s] and lost with high card Queen
Seat 6: DemolishIT (button) showed [Ad Td] and won ($0.73) with high card Ace


*********** # 172 **************
PokerStars Hand #203470699088:  Hold'em No Limit ($0.02/$0.05 USD) - 2019/09/06 20:51:21 ET
Table 'Icarus' 6-max Seat #5 is the button
Seat 1: Yockit ($6.34 in chips)
Seat 2: PlayTheBlues4U ($5.97 in chips)
Seat 3: 47xx47 ($3.10 in chips)
Seat 4: richy5742 ($5.83 in chips)
Seat 5: DeccaDan ($12.55 in chips)
Seat 6: DemolishIT ($4.99 in chips)
DemolishIT: posts small blind $0.02
Yockit: posts big blind $0.05
*** HOLE CARDS ***
Dealt to PlayTheBlues4U [Tc 4s]
PlayTheBlues4U: folds
47xx47: folds
richy5742: folds
DeccaDan: folds
DemolishIT: folds
Uncalled bet ($0.03) returned to Yockit
Yockit collected $0.04 from pot
*** SUMMARY ***
Total pot $0.04 | Rake $0
Seat 1: Yockit (big blind) collected ($0.04)
Seat 2: PlayTheBlues4U folded before Flop (didn't bet)
Seat 3: 47xx47 folded before Flop (didn't bet)
Seat 4: richy5742 folded before Flop (didn't bet)
Seat 5: DeccaDan (button) folded before Flop (didn't bet)
Seat 6: DemolishIT (small blind) folded before Flop


*********** # 173 **************
PokerStars Hand #203470699063:  Hold'em No Limit ($0.01/$0.02 USD) - 2019/09/06 20:51:13 ET
Table 'Pegasus' 6-max Seat #1 is the button
Seat 1: Zeos179 ($3.81 in chips)
Seat 2: doc112ocean ($1.50 in chips)
Seat 4: PlayTheBlues4U ($3.37 in chips)
Seat 5: tsov252525 ($2.05 in chips)
doc112ocean: posts small blind $0.01
MAAE88: is sitting out
PlayTheBlues4U: posts big blind $0.02
*** HOLE CARDS ***
Dealt to PlayTheBlues4U [4d 3s]
MAAE88 leaves the table
tsov252525: raises $0.04 to $0.06
Zeos179: calls $0.06
doc112ocean: folds
PlayTheBlues4U: folds
*** FLOP *** [Js Jd 3h]
tsov252525: checks
Zeos179: checks
*** TURN *** [Js Jd 3h] [Kh]
tsov252525: bets $0.07
Zeos179: calls $0.07
*** RIVER *** [Js Jd 3h Kh] [Jh]
tsov252525: bets $0.18
Zeos179: calls $0.18
*** SHOW DOWN ***
tsov252525: shows [Jc Tc] (four of a kind, Jacks)
Zeos179: mucks hand
tsov252525 collected $0.62 from pot
*** SUMMARY ***
Total pot $0.65 | Rake $0.03
Board [Js Jd 3h Kh Jh]
Seat 1: Zeos179 (button) mucked [Ac 4h]
Seat 2: doc112ocean (small blind) folded before Flop
Seat 4: PlayTheBlues4U (big blind) folded before Flop
Seat 5: tsov252525 showed [Jc Tc] and won ($0.62) with four of a kind, Jacks


*********** # 174 **************
PokerStars Hand #203470698918:  Hold'em No Limit ($0.02/$0.05 USD) - 2019/09/06 20:50:32 ET
Table 'Icarus' 6-max Seat #4 is the button
Seat 1: Yockit ($6.34 in chips)
Seat 2: PlayTheBlues4U ($5.97 in chips)
Seat 3: 47xx47 ($3.10 in chips)
Seat 4: richy5742 ($5.93 in chips)
Seat 5: DeccaDan ($12.70 in chips)
Seat 6: DemolishIT ($4.76 in chips)
DeccaDan: posts small blind $0.02
DemolishIT: posts big blind $0.05
*** HOLE CARDS ***
Dealt to PlayTheBlues4U [2c Jd]
Yockit: folds
PlayTheBlues4U: folds
47xx47: folds
richy5742: raises $0.05 to $0.10
DeccaDan: calls $0.08
DemolishIT: calls $0.05
*** FLOP *** [As 9d Td]
DeccaDan: checks
DemolishIT: checks
richy5742: checks
*** TURN *** [As 9d Td] [6h]
DeccaDan: bets $0.05
DemolishIT: raises $0.25 to $0.30
richy5742: folds
DeccaDan: folds
Uncalled bet ($0.25) returned to DemolishIT
DemolishIT collected $0.38 from pot
DemolishIT: doesn't show hand
*** SUMMARY ***
Total pot $0.40 | Rake $0.02
Board [As 9d Td 6h]
Seat 1: Yockit folded before Flop (didn't bet)
Seat 2: PlayTheBlues4U folded before Flop (didn't bet)
Seat 3: 47xx47 folded before Flop (didn't bet)
Seat 4: richy5742 (button) folded on the Turn
Seat 5: DeccaDan (small blind) folded on the Turn
Seat 6: DemolishIT (big blind) collected ($0.38)


*********** # 175 **************
PokerStars Hand #203470698879:  Hold'em No Limit ($0.01/$0.02 USD) - 2019/09/06 20:50:19 ET
Table 'Pegasus' 6-max Seat #5 is the button
Seat 1: Zeos179 ($3.82 in chips)
Seat 2: doc112ocean ($1.52 in chips)
Seat 3: MAAE88 ($4.14 in chips)
Seat 4: PlayTheBlues4U ($3.43 in chips)
Seat 5: tsov252525 ($1.97 in chips)
Zeos179: posts small blind $0.01
doc112ocean: posts big blind $0.02
*** HOLE CARDS ***
Dealt to PlayTheBlues4U [Kd Jh]
MAAE88: folds
PlayTheBlues4U: raises $0.04 to $0.06
tsov252525: calls $0.06
Zeos179: folds
doc112ocean: folds
*** FLOP *** [9c 8h 6s]
PlayTheBlues4U: checks
tsov252525: bets $0.08
PlayTheBlues4U: folds
Uncalled bet ($0.08) returned to tsov252525
tsov252525 collected $0.14 from pot
tsov252525: doesn't show hand
*** SUMMARY ***
Total pot $0.15 | Rake $0.01
Board [9c 8h 6s]
Seat 1: Zeos179 (small blind) folded before Flop
Seat 2: doc112ocean (big blind) folded before Flop
Seat 3: MAAE88 folded before Flop (didn't bet)
Seat 4: PlayTheBlues4U folded on the Flop
Seat 5: tsov252525 (button) collected ($0.14)


*********** # 176 **************
PokerStars Hand #203470698700:  Hold'em No Limit ($0.02/$0.05 USD) - 2019/09/06 20:49:28 ET
Table 'Icarus' 6-max Seat #3 is the button
Seat 1: Yockit ($6.34 in chips)
Seat 2: PlayTheBlues4U ($5.97 in chips)
Seat 3: 47xx47 ($4 in chips)
Seat 4: richy5742 ($5.95 in chips)
Seat 5: DeccaDan ($12.75 in chips)
Seat 6: DemolishIT ($3.88 in chips)
richy5742: posts small blind $0.02
DeccaDan: posts big blind $0.05
*** HOLE CARDS ***
Dealt to PlayTheBlues4U [Jd 4s]
DemolishIT: raises $0.20 to $0.25
Yockit: folds
PlayTheBlues4U: folds
47xx47: calls $0.25
richy5742: folds
DeccaDan: folds
*** FLOP *** [8h 9s 2h]
DemolishIT: checks
47xx47: checks
*** TURN *** [8h 9s 2h] [Qc]
DemolishIT: bets $0.65
47xx47: calls $0.65
*** RIVER *** [8h 9s 2h Qc] [Ad]
DemolishIT: bets $1.95
47xx47: folds
Uncalled bet ($1.95) returned to DemolishIT
DemolishIT collected $1.78 from pot
*** SUMMARY ***
Total pot $1.87 | Rake $0.09
Board [8h 9s 2h Qc Ad]
Seat 1: Yockit folded before Flop (didn't bet)
Seat 2: PlayTheBlues4U folded before Flop (didn't bet)
Seat 3: 47xx47 (button) folded on the River
Seat 4: richy5742 (small blind) folded before Flop
Seat 5: DeccaDan (big blind) folded before Flop
Seat 6: DemolishIT collected ($1.78)


*********** # 177 **************
PokerStars Hand #203470698566:  Hold'em No Limit ($0.01/$0.02 USD) - 2019/09/06 20:48:45 ET
Table 'Pegasus' 6-max Seat #4 is the button
Seat 1: Zeos179 ($4.58 in chips)
Seat 2: doc112ocean ($1.60 in chips)
Seat 3: MAAE88 ($4.14 in chips)
Seat 4: PlayTheBlues4U ($2.65 in chips)
Seat 5: tsov252525 ($1.98 in chips)
tsov252525: posts small blind $0.01
Zeos179: posts big blind $0.02
doc112ocean: posts big blind $0.02
*** HOLE CARDS ***
Dealt to PlayTheBlues4U [Kc Kd]
doc112ocean: checks
MAAE88: folds
PlayTheBlues4U: raises $0.06 to $0.08
tsov252525: folds
Zeos179: calls $0.06
doc112ocean: calls $0.06
*** FLOP *** [4c 6c 7d]
Zeos179: checks
doc112ocean: checks
PlayTheBlues4U: bets $0.22
Zeos179: calls $0.22
doc112ocean: folds
*** TURN *** [4c 6c 7d] [9d]
Zeos179: checks
PlayTheBlues4U: bets $0.46
Zeos179: calls $0.46
*** RIVER *** [4c 6c 7d 9d] [Qs]
Zeos179: checks
PlayTheBlues4U: bets $1
Zeos179: folds
Uncalled bet ($1) returned to PlayTheBlues4U
PlayTheBlues4U collected $1.54 from pot
PlayTheBlues4U: doesn't show hand
*** SUMMARY ***
Total pot $1.61 | Rake $0.07
Board [4c 6c 7d 9d Qs]
Seat 1: Zeos179 (big blind) folded on the River
Seat 2: doc112ocean folded on the Flop
Seat 3: MAAE88 folded before Flop (didn't bet)
Seat 4: PlayTheBlues4U (button) collected ($1.54)
Seat 5: tsov252525 (small blind) folded before Flop


*********** # 178 **************
PokerStars Hand #203470698552:  Hold'em No Limit ($0.02/$0.05 USD) - 2019/09/06 20:48:40 ET
Table 'Icarus' 6-max Seat #2 is the button
Seat 1: Yockit ($6.34 in chips)
Seat 2: PlayTheBlues4U ($5.58 in chips)
Seat 3: 47xx47 ($4.02 in chips)
Seat 4: richy5742 ($6.15 in chips)
Seat 5: DeccaDan ($12.75 in chips)
Seat 6: DemolishIT ($4.08 in chips)
47xx47: posts small blind $0.02
richy5742: posts big blind $0.05
*** HOLE CARDS ***
Dealt to PlayTheBlues4U [Qc As]
DeccaDan: folds
DemolishIT: calls $0.05
Yockit: folds
PlayTheBlues4U: raises $0.15 to $0.20
47xx47: folds
richy5742: calls $0.15
DemolishIT: calls $0.15
*** FLOP *** [7d Ad 5d]
richy5742: checks
DemolishIT: checks
PlayTheBlues4U: bets $0.45
richy5742: folds
DemolishIT: folds
Uncalled bet ($0.45) returned to PlayTheBlues4U
PlayTheBlues4U collected $0.59 from pot
PlayTheBlues4U: doesn't show hand
*** SUMMARY ***
Total pot $0.62 | Rake $0.03
Board [7d Ad 5d]
Seat 1: Yockit folded before Flop (didn't bet)
Seat 2: PlayTheBlues4U (button) collected ($0.59)
Seat 3: 47xx47 (small blind) folded before Flop
Seat 4: richy5742 (big blind) folded on the Flop
Seat 5: DeccaDan folded before Flop (didn't bet)
Seat 6: DemolishIT folded on the Flop


*********** # 179 **************
PokerStars Hand #203470698427:  Hold'em No Limit ($0.01/$0.02 USD) - 2019/09/06 20:48:04 ET
Table 'Pegasus' 6-max Seat #3 is the button
Seat 1: Zeos179 ($4.58 in chips)
Seat 3: MAAE88 ($4.14 in chips)
Seat 4: PlayTheBlues4U ($2.63 in chips)
Seat 5: tsov252525 ($2 in chips)
PlayTheBlues4U: posts small blind $0.01
tsov252525: posts big blind $0.02
*** HOLE CARDS ***
Dealt to PlayTheBlues4U [Qs Tc]
Zeos179: folds
MAAE88: folds
PlayTheBlues4U: calls $0.01
tsov252525: checks
*** FLOP *** [6c 3c 9d]
PlayTheBlues4U: checks
tsov252525: checks
*** TURN *** [6c 3c 9d] [2c]
PlayTheBlues4U: checks
doc112ocean joins the table at seat #2
tsov252525: checks
*** RIVER *** [6c 3c 9d 2c] [Td]
PlayTheBlues4U: bets $0.04
tsov252525: folds
Uncalled bet ($0.04) returned to PlayTheBlues4U
PlayTheBlues4U collected $0.04 from pot
PlayTheBlues4U: doesn't show hand
*** SUMMARY ***
Total pot $0.04 | Rake $0
Board [6c 3c 9d 2c Td]
Seat 1: Zeos179 folded before Flop (didn't bet)
Seat 3: MAAE88 (button) folded before Flop (didn't bet)
Seat 4: PlayTheBlues4U (small blind) collected ($0.04)
Seat 5: tsov252525 (big blind) folded on the River


*********** # 180 **************
PokerStars Hand #203470698322:  Hold'em No Limit ($0.01/$0.02 USD) - 2019/09/06 20:47:35 ET
Table 'Pegasus' 6-max Seat #1 is the button
Seat 1: Zeos179 ($4.66 in chips)
Seat 3: MAAE88 ($3.99 in chips)
Seat 4: PlayTheBlues4U ($2.71 in chips)
MAAE88: posts small blind $0.01
PlayTheBlues4U: posts big blind $0.02
tsov252525: sits out
*** HOLE CARDS ***
Dealt to PlayTheBlues4U [Jd Ah]
Zeos179: calls $0.02
MAAE88: raises $0.06 to $0.08
PlayTheBlues4U: calls $0.06
Zeos179: calls $0.06
*** FLOP *** [5h 4h 8s]
MAAE88: bets $0.17
PlayTheBlues4U: folds
Zeos179: folds
Uncalled bet ($0.17) returned to MAAE88
MAAE88 collected $0.23 from pot
MAAE88: doesn't show hand
*** SUMMARY ***
Total pot $0.24 | Rake $0.01
Board [5h 4h 8s]
Seat 1: Zeos179 (button) folded on the Flop
Seat 3: MAAE88 (small blind) collected ($0.23)
Seat 4: PlayTheBlues4U (big blind) folded on the Flop


*********** # 181 **************
PokerStars Hand #203470698306:  Hold'em No Limit ($0.02/$0.05 USD) - 2019/09/06 20:47:32 ET
Table 'Icarus' 6-max Seat #1 is the button
Seat 1: Yockit ($6.49 in chips)
Seat 2: PlayTheBlues4U ($5.60 in chips)
Seat 3: 47xx47 ($3.87 in chips)
Seat 4: richy5742 ($6.15 in chips)
Seat 5: DeccaDan ($12.75 in chips)
Seat 6: DemolishIT ($4.08 in chips)
PlayTheBlues4U: posts small blind $0.02
47xx47: posts big blind $0.05
*** HOLE CARDS ***
Dealt to PlayTheBlues4U [5d 4c]
richy5742 is disconnected
richy5742 has timed out
richy5742: folds
DeccaDan: folds
DemolishIT: folds
Yockit: calls $0.05
PlayTheBlues4U: folds
47xx47: checks
*** FLOP *** [2s Ts Qs]
47xx47: bets $0.10
Yockit: calls $0.10
*** TURN *** [2s Ts Qs] [3s]
47xx47: checks
Yockit: checks
*** RIVER *** [2s Ts Qs 3s] [4d]
47xx47: bets $0.10
Yockit: folds
Uncalled bet ($0.10) returned to 47xx47
47xx47 collected $0.30 from pot
47xx47: doesn't show hand
*** SUMMARY ***
Total pot $0.32 | Rake $0.02
Board [2s Ts Qs 3s 4d]
Seat 1: Yockit (button) folded on the River
Seat 2: PlayTheBlues4U (small blind) folded before Flop
Seat 3: 47xx47 (big blind) collected ($0.30)
Seat 4: richy5742 folded before Flop (didn't bet)
Seat 5: DeccaDan folded before Flop (didn't bet)
Seat 6: DemolishIT folded before Flop (didn't bet)


*********** # 182 **************
PokerStars Hand #203470698188:  Hold'em No Limit ($0.02/$0.05 USD) - 2019/09/06 20:46:59 ET
Table 'Icarus' 6-max Seat #6 is the button
Seat 1: Yockit ($6.51 in chips)
Seat 2: PlayTheBlues4U ($5.65 in chips)
Seat 3: 47xx47 ($3.81 in chips)
Seat 4: richy5742 ($6.15 in chips)
Seat 5: DeccaDan ($12.75 in chips)
Seat 6: DemolishIT ($4.08 in chips)
Yockit: posts small blind $0.02
PlayTheBlues4U: posts big blind $0.05
*** HOLE CARDS ***
Dealt to PlayTheBlues4U [6c Jh]
47xx47: calls $0.05
richy5742: folds
DeccaDan: folds
DemolishIT: folds
Yockit: folds
PlayTheBlues4U: checks
*** FLOP *** [9d 7d 3h]
PlayTheBlues4U: checks
47xx47: bets $0.10
PlayTheBlues4U: folds
Uncalled bet ($0.10) returned to 47xx47
47xx47 collected $0.11 from pot
47xx47: doesn't show hand
*** SUMMARY ***
Total pot $0.12 | Rake $0.01
Board [9d 7d 3h]
Seat 1: Yockit (small blind) folded before Flop
Seat 2: PlayTheBlues4U (big blind) folded on the Flop
Seat 3: 47xx47 collected ($0.11)
Seat 4: richy5742 folded before Flop (didn't bet)
Seat 5: DeccaDan folded before Flop (didn't bet)
Seat 6: DemolishIT (button) folded before Flop (didn't bet)


*********** # 183 **************
PokerStars Hand #203470698166:  Hold'em No Limit ($0.01/$0.02 USD) - 2019/09/06 20:46:52 ET
Table 'Pegasus' 6-max Seat #4 is the button
Seat 1: Zeos179 ($4.67 in chips)
Seat 3: MAAE88 ($3.76 in chips)
Seat 4: PlayTheBlues4U ($2.95 in chips)
Zeos179: posts small blind $0.01
MAAE88: posts big blind $0.02
*** HOLE CARDS ***
Dealt to PlayTheBlues4U [8h 6s]
PlayTheBlues4U: raises $0.04 to $0.06
Zeos179: folds
MAAE88: calls $0.04
*** FLOP *** [Ac 4c 8d]
MAAE88: checks
PlayTheBlues4U: bets $0.06
MAAE88: calls $0.06
*** TURN *** [Ac 4c 8d] [9d]
MAAE88: bets $0.12
tsov252525 joins the table at seat #5
PlayTheBlues4U: calls $0.12
*** RIVER *** [Ac 4c 8d 9d] [9s]
MAAE88: checks
PlayTheBlues4U: checks
*** SHOW DOWN ***
MAAE88: shows [Jc Ad] (two pair, Aces and Nines)
PlayTheBlues4U: mucks hand
MAAE88 collected $0.47 from pot
*** SUMMARY ***
Total pot $0.49 | Rake $0.02
Board [Ac 4c 8d 9d 9s]
Seat 1: Zeos179 (small blind) folded before Flop
Seat 3: MAAE88 (big blind) showed [Jc Ad] and won ($0.47) with two pair, Aces and Nines
Seat 4: PlayTheBlues4U (button) mucked [8h 6s]


*********** # 184 **************
PokerStars Hand #203470698140:  Hold'em No Limit ($0.01/$0.02 USD) - 2019/09/06 20:46:46 ET
Table 'Pegasus' 6-max Seat #3 is the button
Seat 1: Zeos179 ($4.66 in chips)
Seat 3: MAAE88 ($3.76 in chips)
Seat 4: PlayTheBlues4U ($2.96 in chips)
PlayTheBlues4U: posts small blind $0.01
Zeos179: posts big blind $0.02
*** HOLE CARDS ***
Dealt to PlayTheBlues4U [Kc 9s]
AAJMU leaves the table
MAAE88: folds
PlayTheBlues4U: folds
Uncalled bet ($0.01) returned to Zeos179
Zeos179 collected $0.02 from pot
Zeos179: doesn't show hand
*** SUMMARY ***
Total pot $0.02 | Rake $0
Seat 1: Zeos179 (big blind) collected ($0.02)
Seat 3: MAAE88 (button) folded before Flop (didn't bet)
Seat 4: PlayTheBlues4U (small blind) folded before Flop


*********** # 185 **************
PokerStars Hand #203470698029:  Hold'em No Limit ($0.01/$0.02 USD) - 2019/09/06 20:46:09 ET
Table 'Pegasus' 6-max Seat #2 is the button
Seat 1: Zeos179 ($4.54 in chips)
Seat 2: AAJMU ($2.61 in chips)
Seat 3: MAAE88 ($3.77 in chips)
Seat 4: PlayTheBlues4U ($3.02 in chips)
MAAE88: posts small blind $0.01
PlayTheBlues4U: posts big blind $0.02
*** HOLE CARDS ***
Dealt to PlayTheBlues4U [5s 5h]
Zeos179: calls $0.02
AAJMU: calls $0.02
MAAE88: folds
PlayTheBlues4U: checks
*** FLOP *** [8s 3c 6h]
PlayTheBlues4U: checks
Zeos179: checks
AAJMU: checks
*** TURN *** [8s 3c 6h] [8d]
PlayTheBlues4U: bets $0.04
Zeos179: calls $0.04
AAJMU: calls $0.04
*** RIVER *** [8s 3c 6h 8d] [3h]
PlayTheBlues4U: checks
Zeos179: bets $0.18
AAJMU: folds
PlayTheBlues4U: folds
Uncalled bet ($0.18) returned to Zeos179
Zeos179 collected $0.18 from pot
Zeos179: doesn't show hand
*** SUMMARY ***
Total pot $0.19 | Rake $0.01
Board [8s 3c 6h 8d 3h]
Seat 1: Zeos179 collected ($0.18)
Seat 2: AAJMU (button) folded on the River
Seat 3: MAAE88 (small blind) folded before Flop
Seat 4: PlayTheBlues4U (big blind) folded on the River


*********** # 186 **************
PokerStars Hand #203470697988:  Hold'em No Limit ($0.01/$0.02 USD) - 2019/09/06 20:45:58 ET
Table 'Pegasus' 6-max Seat #1 is the button
Seat 1: Zeos179 ($4.54 in chips)
Seat 2: AAJMU ($2.62 in chips)
Seat 3: MAAE88 ($3.76 in chips)
Seat 4: PlayTheBlues4U ($3.02 in chips)
AAJMU: posts small blind $0.01
MAAE88: posts big blind $0.02
*** HOLE CARDS ***
Dealt to PlayTheBlues4U [Kc 4d]
PlayTheBlues4U: folds
Zeos179: folds
AAJMU: folds
Uncalled bet ($0.01) returned to MAAE88
MAAE88 collected $0.02 from pot
MAAE88: doesn't show hand
*** SUMMARY ***
Total pot $0.02 | Rake $0
Seat 1: Zeos179 (button) folded before Flop (didn't bet)
Seat 2: AAJMU (small blind) folded before Flop
Seat 3: MAAE88 (big blind) collected ($0.02)
Seat 4: PlayTheBlues4U folded before Flop (didn't bet)


*********** # 187 **************
PokerStars Hand #203470697943:  Hold'em No Limit ($0.01/$0.02 USD) - 2019/09/06 20:45:44 ET
Table 'Pegasus' 6-max Seat #4 is the button
Seat 1: Zeos179 ($4.52 in chips)
Seat 2: AAJMU ($2.64 in chips)
Seat 3: MAAE88 ($3.76 in chips)
Seat 4: PlayTheBlues4U ($3.02 in chips)
Zeos179: posts small blind $0.01
AAJMU: posts big blind $0.02
*** HOLE CARDS ***
Dealt to PlayTheBlues4U [3c 5h]
MAAE88: folds
PlayTheBlues4U: folds
Zeos179: calls $0.01
AAJMU: checks
*** FLOP *** [6h 5c 8d]
Zeos179: bets $0.04
AAJMU: folds
Uncalled bet ($0.04) returned to Zeos179
Zeos179 collected $0.04 from pot
Zeos179: doesn't show hand
*** SUMMARY ***
Total pot $0.04 | Rake $0
Board [6h 5c 8d]
Seat 1: Zeos179 (small blind) collected ($0.04)
Seat 2: AAJMU (big blind) folded on the Flop
Seat 3: MAAE88 folded before Flop (didn't bet)
Seat 4: PlayTheBlues4U (button) folded before Flop (didn't bet)


*********** # 188 **************
PokerStars Hand #203470697902:  Hold'em No Limit ($0.02/$0.05 USD) - 2019/09/06 20:45:34 ET
Table 'Icarus' 6-max Seat #5 is the button
Seat 1: Yockit ($6.56 in chips)
Seat 2: PlayTheBlues4U ($5.65 in chips)
Seat 3: 47xx47 ($3.86 in chips)
Seat 4: richy5742 ($6.15 in chips)
Seat 5: DeccaDan ($12.34 in chips)
Seat 6: DemolishIT ($4.43 in chips)
DemolishIT: posts small blind $0.02
Yockit: posts big blind $0.05
*** HOLE CARDS ***
Dealt to PlayTheBlues4U [5d 3h]
PlayTheBlues4U: folds
47xx47: calls $0.05
richy5742: folds
DeccaDan: calls $0.05
DemolishIT: calls $0.03
Yockit: checks
*** FLOP *** [4c Kd Jc]
DemolishIT: checks
Yockit: checks
47xx47: checks
DeccaDan: bets $0.10
DemolishIT: calls $0.10
Yockit: folds
47xx47: folds
*** TURN *** [4c Kd Jc] [3c]
DemolishIT: checks
DeccaDan: bets $0.20
DemolishIT: calls $0.20
*** RIVER *** [4c Kd Jc 3c] [6h]
DemolishIT: checks
DeccaDan: bets $0.40
DemolishIT: folds
Uncalled bet ($0.40) returned to DeccaDan
DeccaDan collected $0.76 from pot
DeccaDan: doesn't show hand
*** SUMMARY ***
Total pot $0.80 | Rake $0.04
Board [4c Kd Jc 3c 6h]
Seat 1: Yockit (big blind) folded on the Flop
Seat 2: PlayTheBlues4U folded before Flop (didn't bet)
Seat 3: 47xx47 folded on the Flop
Seat 4: richy5742 folded before Flop (didn't bet)
Seat 5: DeccaDan (button) collected ($0.76)
Seat 6: DemolishIT (small blind) folded on the River


*********** # 189 **************
PokerStars Hand #203470697835:  Hold'em No Limit ($0.01/$0.02 USD) - 2019/09/06 20:45:11 ET
Table 'Pegasus' 6-max Seat #3 is the button
Seat 1: Zeos179 ($4.54 in chips)
Seat 2: AAJMU ($2.60 in chips)
Seat 3: MAAE88 ($3.76 in chips)
Seat 4: PlayTheBlues4U ($3.04 in chips)
PlayTheBlues4U: posts small blind $0.01
Zeos179: posts big blind $0.02
*** HOLE CARDS ***
Dealt to PlayTheBlues4U [5c 5h]
AAJMU: calls $0.02
MAAE88: folds
PlayTheBlues4U: calls $0.01
Zeos179: checks
*** FLOP *** [7c As 2s]
PlayTheBlues4U: checks
Zeos179: checks
AAJMU: checks
*** TURN *** [7c As 2s] [Ks]
PlayTheBlues4U: checks
Zeos179: checks
AAJMU: bets $0.06
PlayTheBlues4U: folds
Zeos179: folds
Uncalled bet ($0.06) returned to AAJMU
AAJMU collected $0.06 from pot
AAJMU: doesn't show hand
*** SUMMARY ***
Total pot $0.06 | Rake $0
Board [7c As 2s Ks]
Seat 1: Zeos179 (big blind) folded on the Turn
Seat 2: AAJMU collected ($0.06)
Seat 3: MAAE88 (button) folded before Flop (didn't bet)
Seat 4: PlayTheBlues4U (small blind) folded on the Turn


*********** # 190 **************
PokerStars Hand #203470697747:  Hold'em No Limit ($0.01/$0.02 USD) - 2019/09/06 20:44:43 ET
Table 'Pegasus' 6-max Seat #2 is the button
Seat 1: Zeos179 ($4.54 in chips)
Seat 2: AAJMU ($3 in chips)
Seat 3: MAAE88 ($3.34 in chips)
Seat 4: PlayTheBlues4U ($3.10 in chips)
MAAE88: posts small blind $0.01
PlayTheBlues4U: posts big blind $0.02
*** HOLE CARDS ***
Dealt to PlayTheBlues4U [6s Jc]
Zeos179: folds
AAJMU: raises $0.04 to $0.06
MAAE88: calls $0.05
PlayTheBlues4U: calls $0.04
*** FLOP *** [4h 4c Ah]
MAAE88: bets $0.13
PlayTheBlues4U: folds
AAJMU: calls $0.13
*** TURN *** [4h 4c Ah] [7s]
MAAE88: bets $0.21
AAJMU: calls $0.21
*** RIVER *** [4h 4c Ah 7s] [5s]
MAAE88: checks
AAJMU: checks
*** SHOW DOWN ***
MAAE88: shows [Kc As] (two pair, Aces and Fours)
AAJMU: mucks hand
MAAE88 collected $0.82 from pot
*** SUMMARY ***
Total pot $0.86 | Rake $0.04
Board [4h 4c Ah 7s 5s]
Seat 1: Zeos179 folded before Flop (didn't bet)
Seat 2: AAJMU (button) mucked [Jd Ad]
Seat 3: MAAE88 (small blind) showed [Kc As] and won ($0.82) with two pair, Aces and Fours
Seat 4: PlayTheBlues4U (big blind) folded on the Flop


*********** # 191 **************
PokerStars Hand #203470697716:  Hold'em No Limit ($0.02/$0.05 USD) - 2019/09/06 20:44:34 ET
Table 'Icarus' 6-max Seat #4 is the button
Seat 1: Yockit ($6.54 in chips)
Seat 2: PlayTheBlues4U ($5.65 in chips)
Seat 3: 47xx47 ($3.86 in chips)
Seat 4: richy5742 ($6.15 in chips)
Seat 5: DeccaDan ($12.39 in chips)
Seat 6: DemolishIT ($4.41 in chips)
DeccaDan: posts small blind $0.02
DemolishIT: posts big blind $0.05
*** HOLE CARDS ***
Dealt to PlayTheBlues4U [Tc Ks]
Yockit: calls $0.05
PlayTheBlues4U: folds
47xx47: folds
richy5742: folds
DeccaDan: calls $0.03
DemolishIT: checks
*** FLOP *** [8h 8c Qd]
DeccaDan: checks
DemolishIT: checks
Yockit: checks
*** TURN *** [8h 8c Qd] [Qs]
DeccaDan: checks
DemolishIT: checks
Yockit: checks
*** RIVER *** [8h 8c Qd Qs] [7d]
DeccaDan: checks
DemolishIT: checks
Yockit: checks
*** SHOW DOWN ***
DeccaDan: shows [4c 4d] (two pair, Queens and Eights)
DemolishIT: shows [Js 4h] (two pair, Queens and Eights - Jack kicker)
Yockit: shows [Jd 9d] (two pair, Queens and Eights)
DemolishIT collected $0.07 from pot
Yockit collected $0.07 from pot
*** SUMMARY ***
Total pot $0.15 | Rake $0.01
Board [8h 8c Qd Qs 7d]
Seat 1: Yockit showed [Jd 9d] and won ($0.07) with two pair, Queens and Eights
Seat 2: PlayTheBlues4U folded before Flop (didn't bet)
Seat 3: 47xx47 folded before Flop (didn't bet)
Seat 4: richy5742 (button) folded before Flop (didn't bet)
Seat 5: DeccaDan (small blind) showed [4c 4d] and lost with two pair, Queens and Eights
Seat 6: DemolishIT (big blind) showed [Js 4h] and won ($0.07) with two pair, Queens and Eights


*********** # 192 **************
PokerStars Hand #203470697622:  Hold'em No Limit ($0.01/$0.02 USD) - 2019/09/06 20:44:07 ET
Table 'Pegasus' 6-max Seat #1 is the button
Seat 1: Zeos179 ($4.54 in chips)
Seat 2: AAJMU ($3.02 in chips)
Seat 3: MAAE88 ($3.32 in chips)
Seat 4: PlayTheBlues4U ($3.10 in chips)
AAJMU: posts small blind $0.01
MAAE88: posts big blind $0.02
*** HOLE CARDS ***
Dealt to PlayTheBlues4U [3d Ts]
PlayTheBlues4U: folds
Zeos179: folds
AAJMU: calls $0.01
MAAE88: checks
*** FLOP *** [Td Ks 5c]
AAJMU: checks
MAAE88: checks
*** TURN *** [Td Ks 5c] [9h]
AAJMU: checks
MAAE88: checks
*** RIVER *** [Td Ks 5c 9h] [Qs]
AAJMU: checks
MAAE88: checks
*** SHOW DOWN ***
AAJMU: shows [6s 3s] (high card King)
MAAE88: shows [Qh 4c] (a pair of Queens)
MAAE88 collected $0.04 from pot
*** SUMMARY ***
Total pot $0.04 | Rake $0
Board [Td Ks 5c 9h Qs]
Seat 1: Zeos179 (button) folded before Flop (didn't bet)
Seat 2: AAJMU (small blind) showed [6s 3s] and lost with high card King
Seat 3: MAAE88 (big blind) showed [Qh 4c] and won ($0.04) with a pair of Queens
Seat 4: PlayTheBlues4U folded before Flop (didn't bet)


*********** # 193 **************
PokerStars Hand #203470697541:  Hold'em No Limit ($0.01/$0.02 USD) - 2019/09/06 20:43:41 ET
Table 'Pegasus' 6-max Seat #4 is the button
Seat 1: Zeos179 ($4.50 in chips)
Seat 2: AAJMU ($3.06 in chips)
Seat 3: MAAE88 ($3.32 in chips)
Seat 4: PlayTheBlues4U ($3.10 in chips)
Zeos179: posts small blind $0.01
AAJMU: posts big blind $0.02
*** HOLE CARDS ***
Dealt to PlayTheBlues4U [2d 9c]
MAAE88: folds
PlayTheBlues4U: folds
Zeos179: calls $0.01
AAJMU: checks
*** FLOP *** [3d 7c 2h]
Zeos179: bets $0.02
AAJMU: calls $0.02
*** TURN *** [3d 7c 2h] [8d]
Zeos179: checks
AAJMU: checks
*** RIVER *** [3d 7c 2h 8d] [9d]
Zeos179: checks
AAJMU: checks
*** SHOW DOWN ***
Zeos179: shows [4d 4s] (a pair of Fours)
AAJMU: mucks hand
Zeos179 collected $0.08 from pot
*** SUMMARY ***
Total pot $0.08 | Rake $0
Board [3d 7c 2h 8d 9d]
Seat 1: Zeos179 (small blind) showed [4d 4s] and won ($0.08) with a pair of Fours
Seat 2: AAJMU (big blind) mucked [3h Ad]
Seat 3: MAAE88 folded before Flop (didn't bet)
Seat 4: PlayTheBlues4U (button) folded before Flop (didn't bet)


*********** # 194 **************
PokerStars Hand #203470697511:  Hold'em No Limit ($0.02/$0.05 USD) - 2019/09/06 20:43:31 ET
Table 'Icarus' 6-max Seat #3 is the button
Seat 1: Yockit ($6.54 in chips)
Seat 2: PlayTheBlues4U ($5.65 in chips)
Seat 3: 47xx47 ($3.88 in chips)
Seat 4: richy5742 ($6.17 in chips)
Seat 5: DeccaDan ($12.40 in chips)
Seat 6: DemolishIT ($4.41 in chips)
richy5742: posts small blind $0.02
DeccaDan: posts big blind $0.05
*** HOLE CARDS ***
Dealt to PlayTheBlues4U [3h Jc]
DemolishIT: folds
Yockit: folds
PlayTheBlues4U: folds
47xx47: raises $0.10 to $0.15
richy5742: folds
DeccaDan: calls $0.10
*** FLOP *** [Kc Ts Td]
DeccaDan: checks
47xx47: bets $0.10
DeccaDan: calls $0.10
*** TURN *** [Kc Ts Td] [Kh]
DeccaDan: checks
47xx47: checks
*** RIVER *** [Kc Ts Td Kh] [Jh]
DeccaDan: bets $0.20
47xx47: calls $0.20
*** SHOW DOWN ***
DeccaDan: shows [2d As] (two pair, Kings and Tens)
47xx47: shows [Ac 4d] (two pair, Kings and Tens)
DeccaDan collected $0.44 from pot
47xx47 collected $0.43 from pot
*** SUMMARY ***
Total pot $0.92 | Rake $0.05
Board [Kc Ts Td Kh Jh]
Seat 1: Yockit folded before Flop (didn't bet)
Seat 2: PlayTheBlues4U folded before Flop (didn't bet)
Seat 3: 47xx47 (button) showed [Ac 4d] and won ($0.43) with two pair, Kings and Tens
Seat 4: richy5742 (small blind) folded before Flop
Seat 5: DeccaDan (big blind) showed [2d As] and won ($0.44) with two pair, Kings and Tens
Seat 6: DemolishIT folded before Flop (didn't bet)


*********** # 195 **************
PokerStars Hand #203470697457:  Hold'em No Limit ($0.01/$0.02 USD) - 2019/09/06 20:43:15 ET
Table 'Pegasus' 6-max Seat #3 is the button
Seat 1: Zeos179 ($4.52 in chips)
Seat 2: AAJMU ($3.06 in chips)
Seat 3: MAAE88 ($3.32 in chips)
Seat 4: PlayTheBlues4U ($3.08 in chips)
PlayTheBlues4U: posts small blind $0.01
Zeos179: posts big blind $0.02
*** HOLE CARDS ***
Dealt to PlayTheBlues4U [3h 3d]
AAJMU: folds
MAAE88: folds
PlayTheBlues4U: calls $0.01
Zeos179: checks
*** FLOP *** [3c 4d 6d]
PlayTheBlues4U: bets $0.06
Zeos179: folds
Uncalled bet ($0.06) returned to PlayTheBlues4U
PlayTheBlues4U collected $0.04 from pot
PlayTheBlues4U: doesn't show hand
*** SUMMARY ***
Total pot $0.04 | Rake $0
Board [3c 4d 6d]
Seat 1: Zeos179 (big blind) folded on the Flop
Seat 2: AAJMU folded before Flop (didn't bet)
Seat 3: MAAE88 (button) folded before Flop (didn't bet)
Seat 4: PlayTheBlues4U (small blind) collected ($0.04)


*********** # 196 **************
PokerStars Hand #203470697315:  Hold'em No Limit ($0.01/$0.02 USD) - 2019/09/06 20:42:29 ET
Table 'Pegasus' 6-max Seat #2 is the button
Seat 1: Zeos179 ($4.52 in chips)
Seat 2: AAJMU ($3.06 in chips)
Seat 3: MAAE88 ($3.46 in chips)
Seat 4: PlayTheBlues4U ($2.95 in chips)
MAAE88: posts small blind $0.01
PlayTheBlues4U: posts big blind $0.02
*** HOLE CARDS ***
Dealt to PlayTheBlues4U [Ad Jc]
Zeos179: folds
AAJMU: folds
MAAE88: raises $0.04 to $0.06
PlayTheBlues4U: raises $0.08 to $0.14
MAAE88: calls $0.08
*** FLOP *** [4h 7c Tc]
MAAE88: checks
PlayTheBlues4U: checks
*** TURN *** [4h 7c Tc] [Qh]
MAAE88: checks
PlayTheBlues4U: bets $0.16
MAAE88: folds
Uncalled bet ($0.16) returned to PlayTheBlues4U
PlayTheBlues4U collected $0.27 from pot
PlayTheBlues4U: doesn't show hand
*** SUMMARY ***
Total pot $0.28 | Rake $0.01
Board [4h 7c Tc Qh]
Seat 1: Zeos179 folded before Flop (didn't bet)
Seat 2: AAJMU (button) folded before Flop (didn't bet)
Seat 3: MAAE88 (small blind) folded on the Turn
Seat 4: PlayTheBlues4U (big blind) collected ($0.27)


*********** # 197 **************
PokerStars Hand #203470697296:  Hold'em No Limit ($0.01/$0.02 USD) - 2019/09/06 20:42:24 ET
Table 'Pegasus' 6-max Seat #1 is the button
Seat 1: Zeos179 ($4.52 in chips)
Seat 2: AAJMU ($3.07 in chips)
Seat 3: MAAE88 ($3.45 in chips)
Seat 4: PlayTheBlues4U ($2.95 in chips)
AAJMU: posts small blind $0.01
MAAE88: posts big blind $0.02
*** HOLE CARDS ***
Dealt to PlayTheBlues4U [Jh 5s]
PlayTheBlues4U: folds
Zeos179: folds
AAJMU: folds
Uncalled bet ($0.01) returned to MAAE88
MAAE88 collected $0.02 from pot
MAAE88: doesn't show hand
*** SUMMARY ***
Total pot $0.02 | Rake $0
Seat 1: Zeos179 (button) folded before Flop (didn't bet)
Seat 2: AAJMU (small blind) folded before Flop
Seat 3: MAAE88 (big blind) collected ($0.02)
Seat 4: PlayTheBlues4U folded before Flop (didn't bet)


*********** # 198 **************
PokerStars Hand #203470697261:  Hold'em No Limit ($0.02/$0.05 USD) - 2019/09/06 20:42:12 ET
Table 'Icarus' 6-max Seat #2 is the button
Seat 1: Yockit ($6.79 in chips)
Seat 2: PlayTheBlues4U ($5.70 in chips)
Seat 3: 47xx47 ($3.90 in chips)
Seat 4: richy5742 ($5.88 in chips)
Seat 5: DeccaDan ($12.40 in chips)
Seat 6: DemolishIT ($4.41 in chips)
47xx47: posts small blind $0.02
richy5742: posts big blind $0.05
*** HOLE CARDS ***
Dealt to PlayTheBlues4U [2s 6s]
DeccaDan: folds
DemolishIT: folds
Yockit: calls $0.05
PlayTheBlues4U: calls $0.05
47xx47: folds
richy5742: checks
*** FLOP *** [Qc Ks 5h]
richy5742: bets $0.10
Yockit: calls $0.10
PlayTheBlues4U: folds
*** TURN *** [Qc Ks 5h] [5c]
richy5742: checks
Yockit: checks
*** RIVER *** [Qc Ks 5h 5c] [Jc]
richy5742: bets $0.10
Yockit: calls $0.10
*** SHOW DOWN ***
richy5742: shows [Kh 9c] (two pair, Kings and Fives)
Yockit: mucks hand
richy5742 collected $0.54 from pot
*** SUMMARY ***
Total pot $0.57 | Rake $0.03
Board [Qc Ks 5h 5c Jc]
Seat 1: Yockit mucked [Ah Js]
Seat 2: PlayTheBlues4U (button) folded on the Flop
Seat 3: 47xx47 (small blind) folded before Flop
Seat 4: richy5742 (big blind) showed [Kh 9c] and won ($0.54) with two pair, Kings and Fives
Seat 5: DeccaDan folded before Flop (didn't bet)
Seat 6: DemolishIT folded before Flop (didn't bet)


*********** # 199 **************
PokerStars Hand #203470697257:  Hold'em No Limit ($0.01/$0.02 USD) - 2019/09/06 20:42:10 ET
Table 'Pegasus' 6-max Seat #4 is the button
Seat 1: Zeos179 ($4.53 in chips)
Seat 2: AAJMU ($3.09 in chips)
Seat 3: MAAE88 ($3.45 in chips)
Seat 4: PlayTheBlues4U ($2.92 in chips)
Zeos179: posts small blind $0.01
AAJMU: posts big blind $0.02
*** HOLE CARDS ***
Dealt to PlayTheBlues4U [Jh Ks]
MAAE88: folds
PlayTheBlues4U: raises $0.06 to $0.08
Zeos179: folds
AAJMU: folds
Uncalled bet ($0.06) returned to PlayTheBlues4U
PlayTheBlues4U collected $0.05 from pot
PlayTheBlues4U: doesn't show hand
*** SUMMARY ***
Total pot $0.05 | Rake $0
Seat 1: Zeos179 (small blind) folded before Flop
Seat 2: AAJMU (big blind) folded before Flop
Seat 3: MAAE88 folded before Flop (didn't bet)
Seat 4: PlayTheBlues4U (button) collected ($0.05)


*********** # 200 **************
PokerStars Hand #203470697197:  Hold'em No Limit ($0.01/$0.02 USD) - 2019/09/06 20:41:48 ET
Table 'Pegasus' 6-max Seat #3 is the button
Seat 1: Zeos179 ($4.51 in chips)
Seat 2: AAJMU ($3.09 in chips)
Seat 3: MAAE88 ($3.45 in chips)
Seat 4: PlayTheBlues4U ($2.94 in chips)
PlayTheBlues4U: posts small blind $0.01
Zeos179: posts big blind $0.02
*** HOLE CARDS ***
Dealt to PlayTheBlues4U [5s 4h]
AAJMU: folds
MAAE88: folds
PlayTheBlues4U: calls $0.01
Zeos179: checks
*** FLOP *** [6s 9h Js]
PlayTheBlues4U: checks
Zeos179: checks
*** TURN *** [6s 9h Js] [Qc]
PlayTheBlues4U: checks
Zeos179: checks
*** RIVER *** [6s 9h Js Qc] [Jd]
PlayTheBlues4U: checks
Zeos179: checks
*** SHOW DOWN ***
PlayTheBlues4U: shows [5s 4h] (a pair of Jacks)
Zeos179: shows [Ah Td] (a pair of Jacks - Ace kicker)
Zeos179 collected $0.04 from pot
*** SUMMARY ***
Total pot $0.04 | Rake $0
Board [6s 9h Js Qc Jd]
Seat 1: Zeos179 (big blind) showed [Ah Td] and won ($0.04) with a pair of Jacks
Seat 2: AAJMU folded before Flop (didn't bet)
Seat 3: MAAE88 (button) folded before Flop (didn't bet)
Seat 4: PlayTheBlues4U (small blind) showed [5s 4h] and lost with a pair of Jacks


