*********** # 1 **************
PokerStars Hand #203844275770:  Hold'em No Limit ($0.05/$0.10 USD) - 2019/09/20 20:06:48 ET
Table 'Lacerta' 6-max Seat #4 is the button
Seat 2: PlayTheBlues4U ($14.02 in chips)
Seat 3: RNixon'sHead ($14.85 in chips)
Seat 4: EddieMoney9 ($10.98 in chips)
Seat 5: pairofdz ($9.45 in chips)
Seat 6: JDM0226 ($7.30 in chips)
pairofdz: posts small blind $0.05
JDM0226: posts big blind $0.10
*** HOLE CARDS ***
Dealt to PlayTheBlues4U [Ad 6c]
PlayTheBlues4U: folds
RNixon'sHead: raises $0.15 to $0.25
EddieMoney9: folds
pairofdz: folds
JDM0226: folds
Uncalled bet ($0.15) returned to RNixon'sHead
RNixon'sHead collected $0.25 from pot
RNixon'sHead: doesn't show hand
*** SUMMARY ***
Total pot $0.25 | Rake $0
Seat 2: PlayTheBlues4U folded before Flop (didn't bet)
Seat 3: RNixon'sHead collected ($0.25)
Seat 4: EddieMoney9 (button) folded before Flop (didn't bet)
Seat 5: pairofdz (small blind) folded before Flop
Seat 6: JDM0226 (big blind) folded before Flop


*********** # 2 **************
PokerStars Hand #203844275710:  Hold'em No Limit ($0.02/$0.05 USD) - 2019/09/20 20:06:22 ET
Table 'Anser' 6-max Seat #4 is the button
Seat 1: CMc172 ($3.12 in chips)
Seat 3: seags21 ($4.14 in chips)
Seat 4: PlayTheBlues4U ($8.66 in chips)
CMc172: posts small blind $0.02
seags21: posts big blind $0.05
*** HOLE CARDS ***
Dealt to PlayTheBlues4U [Ah 3c]
PlayTheBlues4U: raises $0.10 to $0.15
CMc172: folds
seags21: folds
Uncalled bet ($0.10) returned to PlayTheBlues4U
PlayTheBlues4U collected $0.12 from pot
PlayTheBlues4U: doesn't show hand
*** SUMMARY ***
Total pot $0.12 | Rake $0
Seat 1: CMc172 (small blind) folded before Flop
Seat 3: seags21 (big blind) folded before Flop
Seat 4: PlayTheBlues4U (button) collected ($0.12)


*********** # 3 **************
PokerStars Hand #203844275690:  Hold'em No Limit ($0.02/$0.05 USD) - 2019/09/20 20:06:14 ET
Table 'Anser' 6-max Seat #3 is the button
Seat 1: CMc172 ($3.10 in chips)
Seat 3: seags21 ($4.14 in chips)
Seat 4: PlayTheBlues4U ($8.68 in chips)
PlayTheBlues4U: posts small blind $0.02
CMc172: posts big blind $0.05
*** HOLE CARDS ***
Dealt to PlayTheBlues4U [4c Ad]
seags21: folds
PlayTheBlues4U: folds
Uncalled bet ($0.03) returned to CMc172
CMc172 collected $0.04 from pot
CMc172: doesn't show hand
*** SUMMARY ***
Total pot $0.04 | Rake $0
Seat 1: CMc172 (big blind) collected ($0.04)
Seat 3: seags21 (button) folded before Flop (didn't bet)
Seat 4: PlayTheBlues4U (small blind) folded before Flop


*********** # 4 **************
PokerStars Hand #203844275668:  Hold'em No Limit ($0.02/$0.05 USD) - 2019/09/20 20:06:05 ET
Table 'Anser' 6-max Seat #1 is the button
Seat 1: CMc172 ($3.10 in chips)
Seat 2: clovvnfiesta ($4.14 in chips)
Seat 3: seags21 ($4.12 in chips)
Seat 4: PlayTheBlues4U ($8.68 in chips)
clovvnfiesta: posts small blind $0.02
seags21: posts big blind $0.05
*** HOLE CARDS ***
Dealt to PlayTheBlues4U [3s Ah]
PlayTheBlues4U: folds
CMc172: folds
clovvnfiesta: folds
Uncalled bet ($0.03) returned to seags21
clovvnfiesta leaves the table
seags21 collected $0.04 from pot
seags21: doesn't show hand
*** SUMMARY ***
Total pot $0.04 | Rake $0
Seat 1: CMc172 (button) folded before Flop (didn't bet)
Seat 2: clovvnfiesta (small blind) folded before Flop
Seat 3: seags21 (big blind) collected ($0.04)
Seat 4: PlayTheBlues4U folded before Flop (didn't bet)


*********** # 5 **************
PokerStars Hand #203844275547:  Hold'em No Limit ($0.02/$0.05 USD) - 2019/09/20 20:05:11 ET
Table 'Anser' 6-max Seat #4 is the button
Seat 1: CMc172 ($2.57 in chips)
Seat 2: clovvnfiesta ($4.73 in chips)
Seat 3: seags21 ($4.12 in chips)
Seat 4: PlayTheBlues4U ($8.68 in chips)
CMc172: posts small blind $0.02
clovvnfiesta: posts big blind $0.05
*** HOLE CARDS ***
Dealt to PlayTheBlues4U [4h 2s]
seags21: folds
PlayTheBlues4U: folds
CMc172: calls $0.03
clovvnfiesta: raises $0.05 to $0.10
CMc172: raises $0.20 to $0.30
clovvnfiesta: calls $0.20
*** FLOP *** [9d Td Ac]
CMc172: checks
clovvnfiesta: checks
*** TURN *** [9d Td Ac] [2c]
CMc172: checks
clovvnfiesta: checks
*** RIVER *** [9d Td Ac 2c] [Jh]
CMc172: checks
clovvnfiesta: bets $0.29
CMc172: calls $0.29
*** SHOW DOWN ***
clovvnfiesta: shows [Js Qs] (a pair of Jacks)
CMc172: shows [Kd Ks] (a pair of Kings)
CMc172 collected $1.12 from pot
*** SUMMARY ***
Total pot $1.18 | Rake $0.06
Board [9d Td Ac 2c Jh]
Seat 1: CMc172 (small blind) showed [Kd Ks] and won ($1.12) with a pair of Kings
Seat 2: clovvnfiesta (big blind) showed [Js Qs] and lost with a pair of Jacks
Seat 3: seags21 folded before Flop (didn't bet)
Seat 4: PlayTheBlues4U (button) folded before Flop (didn't bet)


*********** # 6 **************
PokerStars Hand #203844275536:  Hold'em No Limit ($0.05/$0.10 USD) - 2019/09/20 20:05:05 ET
Table 'Lacerta' 6-max Seat #3 is the button
Seat 2: PlayTheBlues4U ($12.35 in chips)
Seat 3: RNixon'sHead ($14.85 in chips)
Seat 4: EddieMoney9 ($11.03 in chips)
Seat 5: pairofdz ($11.25 in chips)
Seat 6: JDM0226 ($7.30 in chips)
EddieMoney9: posts small blind $0.05
pairofdz: posts big blind $0.10
clovvnfiesta: sits out
*** HOLE CARDS ***
Dealt to PlayTheBlues4U [5h 8h]
JDM0226: folds
PlayTheBlues4U: raises $0.20 to $0.30
RNixon'sHead: folds
EddieMoney9 has timed out
EddieMoney9: folds
pairofdz: raises $0.80 to $1.10
PlayTheBlues4U: calls $0.80
*** FLOP *** [3c 6c 2d]
pairofdz: bets $0.70
clovvnfiesta leaves the table
PlayTheBlues4U: calls $0.70
*** TURN *** [3c 6c 2d] [2c]
pairofdz: checks
PlayTheBlues4U: bets $1.90
pairofdz: folds
Uncalled bet ($1.90) returned to PlayTheBlues4U
PlayTheBlues4U collected $3.47 from pot
PlayTheBlues4U: doesn't show hand
*** SUMMARY ***
Total pot $3.65 | Rake $0.18
Board [3c 6c 2d 2c]
Seat 2: PlayTheBlues4U collected ($3.47)
Seat 3: RNixon'sHead (button) folded before Flop (didn't bet)
Seat 4: EddieMoney9 (small blind) folded before Flop
Seat 5: pairofdz (big blind) folded on the Turn
Seat 6: JDM0226 folded before Flop (didn't bet)


*********** # 7 **************
PokerStars Hand #203844275447:  Hold'em No Limit ($0.05/$0.10 USD) - 2019/09/20 20:04:31 ET
Table 'Lacerta' 6-max Seat #2 is the button
Seat 2: PlayTheBlues4U ($11.94 in chips)
Seat 3: RNixon'sHead ($14.90 in chips)
Seat 4: EddieMoney9 ($11.13 in chips)
Seat 5: pairofdz ($11.55 in chips)
Seat 6: JDM0226 ($7.30 in chips)
RNixon'sHead: posts small blind $0.05
EddieMoney9: posts big blind $0.10
*** HOLE CARDS ***
Dealt to PlayTheBlues4U [3d 5d]
pairofdz: calls $0.10
JDM0226: folds
PlayTheBlues4U: raises $0.20 to $0.30
RNixon'sHead: folds
EddieMoney9: folds
clovvnfiesta joins the table at seat #1
pairofdz: calls $0.20
*** FLOP *** [Qc 7s Js]
pairofdz: checks
PlayTheBlues4U: bets $0.40
pairofdz: folds
Uncalled bet ($0.40) returned to PlayTheBlues4U
PlayTheBlues4U collected $0.71 from pot
PlayTheBlues4U: doesn't show hand
*** SUMMARY ***
Total pot $0.75 | Rake $0.04
Board [Qc 7s Js]
Seat 2: PlayTheBlues4U (button) collected ($0.71)
Seat 3: RNixon'sHead (small blind) folded before Flop
Seat 4: EddieMoney9 (big blind) folded before Flop
Seat 5: pairofdz folded on the Flop
Seat 6: JDM0226 folded before Flop (didn't bet)


*********** # 8 **************
PokerStars Hand #203844275284:  Hold'em No Limit ($0.02/$0.05 USD) - 2019/09/20 20:03:27 ET
Table 'Anser' 6-max Seat #3 is the button
Seat 1: CMc172 ($2.48 in chips)
Seat 2: clovvnfiesta ($4.73 in chips)
Seat 3: seags21 ($4.12 in chips)
Seat 4: PlayTheBlues4U ($8.73 in chips)
Seat 5: MozenMo ($4.37 in chips)
PlayTheBlues4U: posts small blind $0.02
MozenMo: posts big blind $0.05
*** HOLE CARDS ***
Dealt to PlayTheBlues4U [8s Kc]
CMc172: calls $0.05
clovvnfiesta: folds
seags21: folds
PlayTheBlues4U: calls $0.03
MozenMo: checks
*** FLOP *** [7s Ac 5d]
PlayTheBlues4U: checks
MozenMo: checks
CMc172: checks
*** TURN *** [7s Ac 5d] [7c]
PlayTheBlues4U: checks
MozenMo: checks
CMc172: checks
*** RIVER *** [7s Ac 5d 7c] [Td]
PlayTheBlues4U: checks
MozenMo: checks
CMc172: bets $0.05
PlayTheBlues4U: folds
MozenMo: folds
Uncalled bet ($0.05) returned to CMc172
CMc172 collected $0.14 from pot
CMc172: doesn't show hand
*** SUMMARY ***
Total pot $0.15 | Rake $0.01
Board [7s Ac 5d 7c Td]
Seat 1: CMc172 collected ($0.14)
Seat 2: clovvnfiesta folded before Flop (didn't bet)
Seat 3: seags21 (button) folded before Flop (didn't bet)
Seat 4: PlayTheBlues4U (small blind) folded on the River
Seat 5: MozenMo (big blind) folded on the River


*********** # 9 **************
PokerStars Hand #203844275274:  Hold'em No Limit ($0.05/$0.10 USD) - 2019/09/20 20:03:24 ET
Table 'Lacerta' 6-max Seat #6 is the button
Seat 2: PlayTheBlues4U ($11.99 in chips)
Seat 3: RNixon'sHead ($13.67 in chips)
Seat 4: EddieMoney9 ($11.13 in chips)
Seat 5: pairofdz ($12.65 in chips)
Seat 6: JDM0226 ($7.50 in chips)
PlayTheBlues4U: posts small blind $0.05
RNixon'sHead: posts big blind $0.10
*** HOLE CARDS ***
Dealt to PlayTheBlues4U [Kd 4h]
EddieMoney9: folds
pairofdz: raises $0.10 to $0.20
JDM0226: calls $0.20
PlayTheBlues4U: folds
RNixon'sHead: calls $0.10
*** FLOP *** [Kc 8s 5c]
RNixon'sHead: checks
pairofdz: bets $0.30
JDM0226: folds
RNixon'sHead: calls $0.30
*** TURN *** [Kc 8s 5c] [2d]
RNixon'sHead: checks
pairofdz: bets $0.60
RNixon'sHead: calls $0.60
*** RIVER *** [Kc 8s 5c 2d] [Tc]
RNixon'sHead: bets $1.43
pairofdz: folds
Uncalled bet ($1.43) returned to RNixon'sHead
RNixon'sHead collected $2.33 from pot
RNixon'sHead: doesn't show hand
*** SUMMARY ***
Total pot $2.45 | Rake $0.12
Board [Kc 8s 5c 2d Tc]
Seat 2: PlayTheBlues4U (small blind) folded before Flop
Seat 3: RNixon'sHead (big blind) collected ($2.33)
Seat 4: EddieMoney9 folded before Flop (didn't bet)
Seat 5: pairofdz folded on the River
Seat 6: JDM0226 (button) folded on the Flop


*********** # 10 **************
PokerStars Hand #203844275216:  Hold'em No Limit ($0.05/$0.10 USD) - 2019/09/20 20:03:05 ET
Table 'Lacerta' 6-max Seat #5 is the button
Seat 2: PlayTheBlues4U ($12.09 in chips)
Seat 3: RNixon'sHead ($13.52 in chips)
Seat 4: EddieMoney9 ($11.13 in chips)
Seat 5: pairofdz ($12.65 in chips)
Seat 6: JDM0226 ($7.55 in chips)
JDM0226: posts small blind $0.05
PlayTheBlues4U: posts big blind $0.10
*** HOLE CARDS ***
Dealt to PlayTheBlues4U [6d Qd]
RNixon'sHead: raises $0.15 to $0.25
EddieMoney9: folds
pairofdz: folds
JDM0226: folds
PlayTheBlues4U: folds
Uncalled bet ($0.15) returned to RNixon'sHead
RNixon'sHead collected $0.25 from pot
turk1120 was removed from the table for failing to post
turk1120 leaves the table
RNixon'sHead: doesn't show hand
*** SUMMARY ***
Total pot $0.25 | Rake $0
Seat 2: PlayTheBlues4U (big blind) folded before Flop
Seat 3: RNixon'sHead collected ($0.25)
Seat 4: EddieMoney9 folded before Flop (didn't bet)
Seat 5: pairofdz (button) folded before Flop (didn't bet)
Seat 6: JDM0226 (small blind) folded before Flop


*********** # 11 **************
PokerStars Hand #203844275169:  Hold'em No Limit ($0.02/$0.05 USD) - 2019/09/20 20:02:49 ET
Table 'Anser' 6-max Seat #2 is the button
Seat 1: CMc172 ($2.48 in chips)
Seat 2: clovvnfiesta ($4.88 in chips)
Seat 3: seags21 ($4.14 in chips)
Seat 4: PlayTheBlues4U ($8.88 in chips)
Seat 5: MozenMo ($4.07 in chips)
seags21: posts small blind $0.02
PlayTheBlues4U: posts big blind $0.05
*** HOLE CARDS ***
Dealt to PlayTheBlues4U [3s 5h]
MozenMo: raises $0.10 to $0.15
CMc172: folds
clovvnfiesta: calls $0.15
seags21: folds
PlayTheBlues4U: calls $0.10
*** FLOP *** [Qh 5c Td]
PlayTheBlues4U: checks
MozenMo: bets $0.25
clovvnfiesta: folds
PlayTheBlues4U: folds
Uncalled bet ($0.25) returned to MozenMo
MozenMo collected $0.45 from pot
MozenMo: doesn't show hand
*** SUMMARY ***
Total pot $0.47 | Rake $0.02
Board [Qh 5c Td]
Seat 1: CMc172 folded before Flop (didn't bet)
Seat 2: clovvnfiesta (button) folded on the Flop
Seat 3: seags21 (small blind) folded before Flop
Seat 4: PlayTheBlues4U (big blind) folded on the Flop
Seat 5: MozenMo collected ($0.45)


*********** # 12 **************
PokerStars Hand #203844275098:  Hold'em No Limit ($0.05/$0.10 USD) - 2019/09/20 20:02:18 ET
Table 'Lacerta' 6-max Seat #4 is the button
Seat 2: PlayTheBlues4U ($12.09 in chips)
Seat 3: RNixon'sHead ($13.77 in chips)
Seat 4: EddieMoney9 ($11.38 in chips)
Seat 5: pairofdz ($12.09 in chips)
Seat 6: JDM0226 ($7.65 in chips)
pairofdz: posts small blind $0.05
JDM0226: posts big blind $0.10
*** HOLE CARDS ***
Dealt to PlayTheBlues4U [5h 2c]
PlayTheBlues4U: folds
RNixon'sHead: raises $0.15 to $0.25
EddieMoney9: calls $0.25
pairofdz: calls $0.20
JDM0226: folds
*** FLOP *** [3h Tc Td]
pairofdz: checks
RNixon'sHead: checks
EddieMoney9: checks
*** TURN *** [3h Tc Td] [4d]
pairofdz: bets $0.40
RNixon'sHead: folds
EddieMoney9: folds
Uncalled bet ($0.40) returned to pairofdz
pairofdz collected $0.81 from pot
pairofdz: doesn't show hand
*** SUMMARY ***
Total pot $0.85 | Rake $0.04
Board [3h Tc Td 4d]
Seat 2: PlayTheBlues4U folded before Flop (didn't bet)
Seat 3: RNixon'sHead folded on the Turn
Seat 4: EddieMoney9 (button) folded on the Turn
Seat 5: pairofdz (small blind) collected ($0.81)
Seat 6: JDM0226 (big blind) folded before Flop


*********** # 13 **************
PokerStars Hand #203844275050:  Hold'em No Limit ($0.05/$0.10 USD) - 2019/09/20 20:01:58 ET
Table 'Lacerta' 6-max Seat #3 is the button
Seat 2: PlayTheBlues4U ($12.09 in chips)
Seat 3: RNixon'sHead ($13.77 in chips)
Seat 4: EddieMoney9 ($11.43 in chips)
Seat 5: pairofdz ($12.04 in chips)
Seat 6: JDM0226 ($7.65 in chips)
EddieMoney9: posts small blind $0.05
pairofdz: posts big blind $0.10
*** HOLE CARDS ***
Dealt to PlayTheBlues4U [5c 3h]
JDM0226: folds
PlayTheBlues4U: folds
RNixon'sHead: folds
EddieMoney9: folds
Uncalled bet ($0.05) returned to pairofdz
pairofdz collected $0.10 from pot
pairofdz: doesn't show hand
*** SUMMARY ***
Total pot $0.10 | Rake $0
Seat 2: PlayTheBlues4U folded before Flop (didn't bet)
Seat 3: RNixon'sHead (button) folded before Flop (didn't bet)
Seat 4: EddieMoney9 (small blind) folded before Flop
Seat 5: pairofdz (big blind) collected ($0.10)
Seat 6: JDM0226 folded before Flop (didn't bet)


*********** # 14 **************
PokerStars Hand #203844275000:  Hold'em No Limit ($0.02/$0.05 USD) - 2019/09/20 20:01:38 ET
Table 'Anser' 6-max Seat #1 is the button
Seat 1: CMc172 ($2.53 in chips)
Seat 2: clovvnfiesta ($4.90 in chips)
Seat 3: seags21 ($4.03 in chips)
Seat 4: PlayTheBlues4U ($8.88 in chips)
Seat 5: MozenMo ($4.12 in chips)
clovvnfiesta: posts small blind $0.02
seags21: posts big blind $0.05
*** HOLE CARDS ***
Dealt to PlayTheBlues4U [Kh 8h]
PlayTheBlues4U: folds
MozenMo: calls $0.05
CMc172: calls $0.05
clovvnfiesta: folds
seags21: checks
*** FLOP *** [As 6c 5c]
seags21: checks
MozenMo: checks
CMc172: checks
*** TURN *** [As 6c 5c] [Tc]
seags21: checks
MozenMo: checks
CMc172: checks
*** RIVER *** [As 6c 5c Tc] [Ad]
seags21: bets $0.06
MozenMo: folds
CMc172: folds
Uncalled bet ($0.06) returned to seags21
seags21 collected $0.16 from pot
seags21: doesn't show hand
*** SUMMARY ***
Total pot $0.17 | Rake $0.01
Board [As 6c 5c Tc Ad]
Seat 1: CMc172 (button) folded on the River
Seat 2: clovvnfiesta (small blind) folded before Flop
Seat 3: seags21 (big blind) collected ($0.16)
Seat 4: PlayTheBlues4U folded before Flop (didn't bet)
Seat 5: MozenMo folded on the River


*********** # 15 **************
PokerStars Hand #203844274976:  Hold'em No Limit ($0.02/$0.05 USD) - 2019/09/20 20:01:25 ET
Table 'Anser' 6-max Seat #5 is the button
Seat 1: CMc172 ($2.55 in chips)
Seat 2: clovvnfiesta ($4.95 in chips)
Seat 4: PlayTheBlues4U ($8.81 in chips)
Seat 5: MozenMo ($4.12 in chips)
CMc172: posts small blind $0.02
clovvnfiesta: posts big blind $0.05
seags21: sits out
*** HOLE CARDS ***
Dealt to PlayTheBlues4U [Ad 3d]
PlayTheBlues4U: raises $0.10 to $0.15
MozenMo: folds
CMc172: folds
clovvnfiesta: folds
Uncalled bet ($0.10) returned to PlayTheBlues4U
PlayTheBlues4U collected $0.12 from pot
PlayTheBlues4U: doesn't show hand
*** SUMMARY ***
Total pot $0.12 | Rake $0
Seat 1: CMc172 (small blind) folded before Flop
Seat 2: clovvnfiesta (big blind) folded before Flop
Seat 4: PlayTheBlues4U collected ($0.12)
Seat 5: MozenMo (button) folded before Flop (didn't bet)


*********** # 16 **************
PokerStars Hand #203844274900:  Hold'em No Limit ($0.05/$0.10 USD) - 2019/09/20 20:00:54 ET
Table 'Lacerta' 6-max Seat #2 is the button
Seat 2: PlayTheBlues4U ($12.09 in chips)
Seat 3: RNixon'sHead ($13.82 in chips)
Seat 4: EddieMoney9 ($12.33 in chips)
Seat 5: pairofdz ($11.18 in chips)
Seat 6: JDM0226 ($7.65 in chips)
RNixon'sHead: posts small blind $0.05
EddieMoney9: posts big blind $0.10
*** HOLE CARDS ***
Dealt to PlayTheBlues4U [5h 7s]
pairofdz: raises $0.10 to $0.20
JDM0226: folds
PlayTheBlues4U: folds
RNixon'sHead: folds
EddieMoney9: raises $0.10 to $0.30
pairofdz: raises $0.60 to $0.90
EddieMoney9: calls $0.60
*** FLOP *** [5s Qs 6d]
EddieMoney9: checks
pairofdz: bets $0.80
EddieMoney9: folds
Uncalled bet ($0.80) returned to pairofdz
pairofdz collected $1.76 from pot
pairofdz: doesn't show hand
*** SUMMARY ***
Total pot $1.85 | Rake $0.09
Board [5s Qs 6d]
Seat 2: PlayTheBlues4U (button) folded before Flop (didn't bet)
Seat 3: RNixon'sHead (small blind) folded before Flop
Seat 4: EddieMoney9 (big blind) folded on the Flop
Seat 5: pairofdz collected ($1.76)
Seat 6: JDM0226 folded before Flop (didn't bet)


*********** # 17 **************
PokerStars Hand #203844274820:  Hold'em No Limit ($0.05/$0.10 USD) - 2019/09/20 20:00:14 ET
Table 'Lacerta' 6-max Seat #6 is the button
Seat 2: PlayTheBlues4U ($11.91 in chips)
Seat 3: RNixon'sHead ($13.92 in chips)
Seat 4: EddieMoney9 ($12.33 in chips)
Seat 5: pairofdz ($11.28 in chips)
Seat 6: JDM0226 ($7.65 in chips)
PlayTheBlues4U: posts small blind $0.05
RNixon'sHead: posts big blind $0.10
*** HOLE CARDS ***
Dealt to PlayTheBlues4U [Kd 9d]
EddieMoney9: folds
pairofdz: calls $0.10
JDM0226: folds
PlayTheBlues4U: calls $0.05
RNixon'sHead: checks
*** FLOP *** [5d Ks 7c]
PlayTheBlues4U: checks
RNixon'sHead: checks
pairofdz: checks
*** TURN *** [5d Ks 7c] [Qd]
PlayTheBlues4U: bets $0.20
RNixon'sHead: folds
pairofdz: folds
Uncalled bet ($0.20) returned to PlayTheBlues4U
PlayTheBlues4U collected $0.28 from pot
PlayTheBlues4U: doesn't show hand
*** SUMMARY ***
Total pot $0.30 | Rake $0.02
Board [5d Ks 7c Qd]
Seat 2: PlayTheBlues4U (small blind) collected ($0.28)
Seat 3: RNixon'sHead (big blind) folded on the Turn
Seat 4: EddieMoney9 folded before Flop (didn't bet)
Seat 5: pairofdz folded on the Turn
Seat 6: JDM0226 (button) folded before Flop (didn't bet)


*********** # 18 **************
PokerStars Hand #203844274807:  Hold'em No Limit ($0.02/$0.05 USD) - 2019/09/20 20:00:10 ET
Table 'Anser' 6-max Seat #4 is the button
Seat 1: CMc172 ($2.46 in chips)
Seat 2: clovvnfiesta ($5 in chips)
Seat 4: PlayTheBlues4U ($8.81 in chips)
Seat 5: MozenMo ($4.17 in chips)
MozenMo: posts small blind $0.02
CMc172: posts big blind $0.05
clovvnfiesta: posts big blind $0.05
*** HOLE CARDS ***
Dealt to PlayTheBlues4U [4s 5h]
clovvnfiesta: checks
PlayTheBlues4U: folds
MozenMo: calls $0.03
CMc172: checks
*** FLOP *** [9c 6d Ts]
MozenMo: checks
CMc172: checks
clovvnfiesta: checks
*** TURN *** [9c 6d Ts] [2s]
MozenMo: checks
CMc172: checks
clovvnfiesta: checks
*** RIVER *** [9c 6d Ts 2s] [Qc]
MozenMo: checks
CMc172: checks
clovvnfiesta: checks
*** SHOW DOWN ***
MozenMo: shows [4h 2d] (a pair of Deuces)
CMc172: shows [Ac 9h] (a pair of Nines)
clovvnfiesta: mucks hand
CMc172 collected $0.14 from pot
*** SUMMARY ***
Total pot $0.15 | Rake $0.01
Board [9c 6d Ts 2s Qc]
Seat 1: CMc172 (big blind) showed [Ac 9h] and won ($0.14) with a pair of Nines
Seat 2: clovvnfiesta mucked [8s 5c]
Seat 4: PlayTheBlues4U (button) folded before Flop (didn't bet)
Seat 5: MozenMo (small blind) showed [4h 2d] and lost with a pair of Deuces


*********** # 19 **************
PokerStars Hand #203844274798:  Hold'em No Limit ($0.05/$0.10 USD) - 2019/09/20 20:00:03 ET
Table 'Lacerta' 6-max Seat #5 is the button
Seat 2: PlayTheBlues4U ($11.86 in chips)
Seat 3: RNixon'sHead ($13.92 in chips)
Seat 4: EddieMoney9 ($12.33 in chips)
Seat 5: pairofdz ($11.28 in chips)
Seat 6: JDM0226 ($7.70 in chips)
JDM0226: posts small blind $0.05
PlayTheBlues4U: posts big blind $0.10
*** HOLE CARDS ***
Dealt to PlayTheBlues4U [5c 8d]
RNixon'sHead: folds
EddieMoney9: folds
pairofdz: folds
JDM0226: folds
Uncalled bet ($0.05) returned to PlayTheBlues4U
PlayTheBlues4U collected $0.10 from pot
PlayTheBlues4U: doesn't show hand
*** SUMMARY ***
Total pot $0.10 | Rake $0
Seat 2: PlayTheBlues4U (big blind) collected ($0.10)
Seat 3: RNixon'sHead folded before Flop (didn't bet)
Seat 4: EddieMoney9 folded before Flop (didn't bet)
Seat 5: pairofdz (button) folded before Flop (didn't bet)
Seat 6: JDM0226 (small blind) folded before Flop


*********** # 20 **************
PokerStars Hand #203844274766:  Hold'em No Limit ($0.05/$0.10 USD) - 2019/09/20 19:59:42 ET
Table 'Lacerta' 6-max Seat #4 is the button
Seat 2: PlayTheBlues4U ($11.86 in chips)
Seat 3: RNixon'sHead ($13.92 in chips)
Seat 4: EddieMoney9 ($12.18 in chips)
Seat 5: pairofdz ($11.33 in chips)
Seat 6: JDM0226 ($7.80 in chips)
pairofdz: posts small blind $0.05
JDM0226: posts big blind $0.10
*** HOLE CARDS ***
Dealt to PlayTheBlues4U [Qh 6h]
PlayTheBlues4U: folds
RNixon'sHead: folds
EddieMoney9: raises $0.20 to $0.30
pairofdz: folds
JDM0226: folds
Uncalled bet ($0.20) returned to EddieMoney9
EddieMoney9 collected $0.25 from pot
EddieMoney9: doesn't show hand
*** SUMMARY ***
Total pot $0.25 | Rake $0
Seat 2: PlayTheBlues4U folded before Flop (didn't bet)
Seat 3: RNixon'sHead folded before Flop (didn't bet)
Seat 4: EddieMoney9 (button) collected ($0.25)
Seat 5: pairofdz (small blind) folded before Flop
Seat 6: JDM0226 (big blind) folded before Flop


*********** # 21 **************
PokerStars Hand #203844274724:  Hold'em No Limit ($0.02/$0.05 USD) - 2019/09/20 19:59:17 ET
Table 'Anser' 6-max Seat #1 is the button
Seat 1: CMc172 ($2.66 in chips)
Seat 4: PlayTheBlues4U ($8.83 in chips)
Seat 5: MozenMo ($3.97 in chips)
clovvnfiesta will be allowed to play after the button
PlayTheBlues4U: posts small blind $0.02
MozenMo: posts big blind $0.05
*** HOLE CARDS ***
Dealt to PlayTheBlues4U [6d Ts]
CMc172: calls $0.05
PlayTheBlues4U: folds
MozenMo: raises $0.05 to $0.10
CMc172: calls $0.05
*** FLOP *** [7c 2h 8s]
MozenMo: bets $0.10
CMc172: calls $0.10
*** TURN *** [7c 2h 8s] [7s]
MozenMo: bets $0.20
CMc172: folds
Uncalled bet ($0.20) returned to MozenMo
MozenMo collected $0.40 from pot
MozenMo: doesn't show hand
*** SUMMARY ***
Total pot $0.42 | Rake $0.02
Board [7c 2h 8s 7s]
Seat 1: CMc172 (button) folded on the Turn
Seat 4: PlayTheBlues4U (small blind) folded before Flop
Seat 5: MozenMo (big blind) collected ($0.40)


*********** # 22 **************
PokerStars Hand #203844274692:  Hold'em No Limit ($0.05/$0.10 USD) - 2019/09/20 19:58:59 ET
Table 'Lacerta' 6-max Seat #3 is the button
Seat 2: PlayTheBlues4U ($11.86 in chips)
Seat 3: RNixon'sHead ($13.92 in chips)
Seat 4: EddieMoney9 ($12.09 in chips)
Seat 5: pairofdz ($11.43 in chips)
Seat 6: JDM0226 ($7.80 in chips)
EddieMoney9: posts small blind $0.05
pairofdz: posts big blind $0.10
*** HOLE CARDS ***
Dealt to PlayTheBlues4U [Qd 3c]
JDM0226: folds
PlayTheBlues4U: folds
RNixon'sHead: folds
EddieMoney9: calls $0.05
pairofdz: checks
*** FLOP *** [7d 6c 8s]
EddieMoney9: checks
pairofdz: checks
*** TURN *** [7d 6c 8s] [6h]
EddieMoney9: checks
pairofdz: checks
*** RIVER *** [7d 6c 8s 6h] [5d]
EddieMoney9: checks
pairofdz: checks
*** SHOW DOWN ***
EddieMoney9: shows [Kc Th] (a pair of Sixes)
pairofdz: mucks hand
EddieMoney9 collected $0.19 from pot
*** SUMMARY ***
Total pot $0.20 | Rake $0.01
Board [7d 6c 8s 6h 5d]
Seat 2: PlayTheBlues4U folded before Flop (didn't bet)
Seat 3: RNixon'sHead (button) folded before Flop (didn't bet)
Seat 4: EddieMoney9 (small blind) showed [Kc Th] and won ($0.19) with a pair of Sixes
Seat 5: pairofdz (big blind) mucked [Kd 3h]
Seat 6: JDM0226 folded before Flop (didn't bet)


*********** # 23 **************
PokerStars Hand #203844274665:  Hold'em No Limit ($0.05/$0.10 USD) - 2019/09/20 19:58:46 ET
Table 'Lacerta' 6-max Seat #2 is the button
Seat 2: PlayTheBlues4U ($11.86 in chips)
Seat 3: RNixon'sHead ($13.97 in chips)
Seat 4: EddieMoney9 ($12.04 in chips)
Seat 5: pairofdz ($11.43 in chips)
Seat 6: JDM0226 ($7.80 in chips)
RNixon'sHead: posts small blind $0.05
EddieMoney9: posts big blind $0.10
*** HOLE CARDS ***
Dealt to PlayTheBlues4U [3c 2s]
pairofdz: folds
JDM0226: folds
PlayTheBlues4U: folds
RNixon'sHead: folds
Uncalled bet ($0.05) returned to EddieMoney9
EddieMoney9 collected $0.10 from pot
EddieMoney9: doesn't show hand
*** SUMMARY ***
Total pot $0.10 | Rake $0
Seat 2: PlayTheBlues4U (button) folded before Flop (didn't bet)
Seat 3: RNixon'sHead (small blind) folded before Flop
Seat 4: EddieMoney9 (big blind) collected ($0.10)
Seat 5: pairofdz folded before Flop (didn't bet)
Seat 6: JDM0226 folded before Flop (didn't bet)


*********** # 24 **************
PokerStars Hand #203844274631:  Hold'em No Limit ($0.02/$0.05 USD) - 2019/09/20 19:58:29 ET
Table 'Anser' 6-max Seat #5 is the button
Seat 1: CMc172 ($2.81 in chips)
Seat 3: seags21 ($4.03 in chips)
Seat 4: PlayTheBlues4U ($8.53 in chips)
Seat 5: MozenMo ($4.12 in chips)
Seat 6: DemolishIT ($6.21 in chips)
DemolishIT: posts small blind $0.02
CMc172: posts big blind $0.05
clovvnfiesta: sits out
*** HOLE CARDS ***
Dealt to PlayTheBlues4U [2c Ac]
seags21 has timed out
seags21: folds
PlayTheBlues4U: raises $0.10 to $0.15
MozenMo: calls $0.15
DemolishIT: folds
CMc172: calls $0.10
*** FLOP *** [2h Ah Qh]
CMc172: checks
PlayTheBlues4U: bets $0.45
MozenMo: folds
CMc172: folds
Uncalled bet ($0.45) returned to PlayTheBlues4U
PlayTheBlues4U collected $0.45 from pot
PlayTheBlues4U: doesn't show hand
*** SUMMARY ***
Total pot $0.47 | Rake $0.02
Board [2h Ah Qh]
Seat 1: CMc172 (big blind) folded on the Flop
Seat 3: seags21 folded before Flop (didn't bet)
Seat 4: PlayTheBlues4U collected ($0.45)
Seat 5: MozenMo (button) folded on the Flop
Seat 6: DemolishIT (small blind) folded before Flop


*********** # 25 **************
PokerStars Hand #203844274571:  Hold'em No Limit ($0.05/$0.10 USD) - 2019/09/20 19:57:58 ET
Table 'Lacerta' 6-max Seat #6 is the button
Seat 2: PlayTheBlues4U ($11.77 in chips)
Seat 3: RNixon'sHead ($14.07 in chips)
Seat 4: EddieMoney9 ($12.04 in chips)
Seat 5: pairofdz ($11.43 in chips)
Seat 6: JDM0226 ($7.80 in chips)
PlayTheBlues4U: posts small blind $0.05
RNixon'sHead: posts big blind $0.10
*** HOLE CARDS ***
Dealt to PlayTheBlues4U [Th 9h]
EddieMoney9: folds
pairofdz: folds
JDM0226: folds
PlayTheBlues4U: calls $0.05
RNixon'sHead: checks
*** FLOP *** [6s Qh 3d]
PlayTheBlues4U: checks
RNixon'sHead: checks
*** TURN *** [6s Qh 3d] [Jc]
PlayTheBlues4U: bets $0.10
RNixon'sHead: folds
Uncalled bet ($0.10) returned to PlayTheBlues4U
PlayTheBlues4U collected $0.19 from pot
PlayTheBlues4U: doesn't show hand
*** SUMMARY ***
Total pot $0.20 | Rake $0.01
Board [6s Qh 3d Jc]
Seat 2: PlayTheBlues4U (small blind) collected ($0.19)
Seat 3: RNixon'sHead (big blind) folded on the Turn
Seat 4: EddieMoney9 folded before Flop (didn't bet)
Seat 5: pairofdz folded before Flop (didn't bet)
Seat 6: JDM0226 (button) folded before Flop (didn't bet)


*********** # 26 **************
PokerStars Hand #203844274542:  Hold'em No Limit ($0.02/$0.05 USD) - 2019/09/20 19:57:39 ET
Table 'Anser' 6-max Seat #4 is the button
Seat 1: CMc172 ($2.81 in chips)
Seat 3: seags21 ($4.03 in chips)
Seat 4: PlayTheBlues4U ($8.24 in chips)
Seat 5: MozenMo ($4.14 in chips)
Seat 6: DemolishIT ($6.51 in chips)
MozenMo: posts small blind $0.02
DemolishIT: posts big blind $0.05
clovvnfiesta: sits out
*** HOLE CARDS ***
Dealt to PlayTheBlues4U [Js 8s]
CMc172: folds
seags21: folds
PlayTheBlues4U: raises $0.10 to $0.15
MozenMo: folds
DemolishIT: calls $0.10
*** FLOP *** [Ts As 8c]
DemolishIT: checks
PlayTheBlues4U: bets $0.15
DemolishIT: calls $0.15
*** TURN *** [Ts As 8c] [3s]
DemolishIT: checks
PlayTheBlues4U: bets $0.45
DemolishIT: folds
Uncalled bet ($0.45) returned to PlayTheBlues4U
PlayTheBlues4U collected $0.59 from pot
PlayTheBlues4U: doesn't show hand
*** SUMMARY ***
Total pot $0.62 | Rake $0.03
Board [Ts As 8c 3s]
Seat 1: CMc172 folded before Flop (didn't bet)
Seat 3: seags21 folded before Flop (didn't bet)
Seat 4: PlayTheBlues4U (button) collected ($0.59)
Seat 5: MozenMo (small blind) folded before Flop
Seat 6: DemolishIT (big blind) folded on the Turn


*********** # 27 **************
PokerStars Hand #203844274533:  Hold'em No Limit ($0.05/$0.10 USD) - 2019/09/20 19:57:33 ET
Table 'Lacerta' 6-max Seat #5 is the button
Seat 2: PlayTheBlues4U ($11.87 in chips)
Seat 3: RNixon'sHead ($14.07 in chips)
Seat 4: EddieMoney9 ($11.89 in chips)
Seat 5: pairofdz ($11.43 in chips)
Seat 6: JDM0226 ($7.85 in chips)
JDM0226: posts small blind $0.05
PlayTheBlues4U: posts big blind $0.10
*** HOLE CARDS ***
Dealt to PlayTheBlues4U [6h Js]
RNixon'sHead: folds
EddieMoney9: raises $0.20 to $0.30
pairofdz: folds
JDM0226: folds
PlayTheBlues4U: folds
Uncalled bet ($0.20) returned to EddieMoney9
EddieMoney9 collected $0.25 from pot
EddieMoney9: doesn't show hand
*** SUMMARY ***
Total pot $0.25 | Rake $0
Seat 2: PlayTheBlues4U (big blind) folded before Flop
Seat 3: RNixon'sHead folded before Flop (didn't bet)
Seat 4: EddieMoney9 collected ($0.25)
Seat 5: pairofdz (button) folded before Flop (didn't bet)
Seat 6: JDM0226 (small blind) folded before Flop


*********** # 28 **************
PokerStars Hand #203844274492:  Hold'em No Limit ($0.05/$0.10 USD) - 2019/09/20 19:57:09 ET
Table 'Lacerta' 6-max Seat #4 is the button
Seat 2: PlayTheBlues4U ($11.87 in chips)
Seat 3: RNixon'sHead ($14.07 in chips)
Seat 4: EddieMoney9 ($11.89 in chips)
Seat 5: pairofdz ($11.25 in chips)
Seat 6: JDM0226 ($8.05 in chips)
pairofdz: posts small blind $0.05
JDM0226: posts big blind $0.10
*** HOLE CARDS ***
Dealt to PlayTheBlues4U [3d Td]
PlayTheBlues4U: folds
RNixon'sHead: folds
EddieMoney9: folds
pairofdz: raises $0.10 to $0.20
JDM0226: calls $0.10
*** FLOP *** [Jc Kd Tc]
pairofdz: bets $0.20
JDM0226: folds
Uncalled bet ($0.20) returned to pairofdz
pairofdz collected $0.38 from pot
pairofdz: doesn't show hand
*** SUMMARY ***
Total pot $0.40 | Rake $0.02
Board [Jc Kd Tc]
Seat 2: PlayTheBlues4U folded before Flop (didn't bet)
Seat 3: RNixon'sHead folded before Flop (didn't bet)
Seat 4: EddieMoney9 (button) folded before Flop (didn't bet)
Seat 5: pairofdz (small blind) collected ($0.38)
Seat 6: JDM0226 (big blind) folded on the Flop


*********** # 29 **************
PokerStars Hand #203844274441:  Hold'em No Limit ($0.05/$0.10 USD) - 2019/09/20 19:56:39 ET
Table 'Lacerta' 6-max Seat #3 is the button
Seat 2: PlayTheBlues4U ($11.87 in chips)
Seat 3: RNixon'sHead ($14.07 in chips)
Seat 4: EddieMoney9 ($11.99 in chips)
Seat 5: pairofdz ($11.16 in chips)
Seat 6: JDM0226 ($8.05 in chips)
EddieMoney9: posts small blind $0.05
pairofdz: posts big blind $0.10
*** HOLE CARDS ***
Dealt to PlayTheBlues4U [3d Ks]
JDM0226: folds
PlayTheBlues4U: folds
RNixon'sHead: folds
EddieMoney9: calls $0.05
pairofdz: checks
*** FLOP *** [Qh 7s Td]
EddieMoney9: checks
pairofdz: checks
*** TURN *** [Qh 7s Td] [Js]
EddieMoney9: checks
pairofdz: bets $0.10
EddieMoney9: folds
Uncalled bet ($0.10) returned to pairofdz
pairofdz collected $0.19 from pot
pairofdz: doesn't show hand
*** SUMMARY ***
Total pot $0.20 | Rake $0.01
Board [Qh 7s Td Js]
Seat 2: PlayTheBlues4U folded before Flop (didn't bet)
Seat 3: RNixon'sHead (button) folded before Flop (didn't bet)
Seat 4: EddieMoney9 (small blind) folded on the Turn
Seat 5: pairofdz (big blind) collected ($0.19)
Seat 6: JDM0226 folded before Flop (didn't bet)


*********** # 30 **************
PokerStars Hand #203844274430:  Hold'em No Limit ($0.02/$0.05 USD) - 2019/09/20 19:56:29 ET
Table 'Anser' 6-max Seat #3 is the button
Seat 1: CMc172 ($2.86 in chips)
Seat 3: seags21 ($4.03 in chips)
Seat 4: PlayTheBlues4U ($7.95 in chips)
Seat 5: MozenMo ($4.19 in chips)
Seat 6: DemolishIT ($6.73 in chips)
PlayTheBlues4U: posts small blind $0.02
MozenMo: posts big blind $0.05
DemolishIT: posts small & big blinds $0.07
clovvnfiesta: sits out
*** HOLE CARDS ***
Dealt to PlayTheBlues4U [8c Qd]
DemolishIT: checks
CMc172: calls $0.05
seags21: folds
PlayTheBlues4U: calls $0.03
MozenMo: checks
*** FLOP *** [Jh 6c Qs]
PlayTheBlues4U: checks
MozenMo: checks
DemolishIT: checks
CMc172: checks
*** TURN *** [Jh 6c Qs] [7d]
PlayTheBlues4U: bets $0.15
MozenMo: folds
DemolishIT: calls $0.15
CMc172: folds
*** RIVER *** [Jh 6c Qs 7d] [9s]
PlayTheBlues4U: checks
DemolishIT: checks
*** SHOW DOWN ***
PlayTheBlues4U: shows [8c Qd] (a pair of Queens)
DemolishIT: mucks hand
PlayTheBlues4U collected $0.49 from pot
*** SUMMARY ***
Total pot $0.52 | Rake $0.03
Board [Jh 6c Qs 7d 9s]
Seat 1: CMc172 folded on the Turn
Seat 3: seags21 (button) folded before Flop (didn't bet)
Seat 4: PlayTheBlues4U (small blind) showed [8c Qd] and won ($0.49) with a pair of Queens
Seat 5: MozenMo (big blind) folded on the Turn
Seat 6: DemolishIT mucked [Ks Js]


*********** # 31 **************
PokerStars Hand #203844274385:  Hold'em No Limit ($0.05/$0.10 USD) - 2019/09/20 19:56:05 ET
Table 'Lacerta' 6-max Seat #2 is the button
Seat 2: PlayTheBlues4U ($11.87 in chips)
Seat 3: RNixon'sHead ($14.37 in chips)
Seat 4: EddieMoney9 ($12.09 in chips)
Seat 5: pairofdz ($10.80 in chips)
Seat 6: JDM0226 ($8.05 in chips)
RNixon'sHead: posts small blind $0.05
EddieMoney9: posts big blind $0.10
*** HOLE CARDS ***
Dealt to PlayTheBlues4U [9c 2c]
pairofdz: raises $0.20 to $0.30
JDM0226: folds
PlayTheBlues4U: folds
RNixon'sHead: calls $0.25
EddieMoney9: folds
*** FLOP *** [Jd Qh Th]
RNixon'sHead: checks
pairofdz: bets $0.40
RNixon'sHead: folds
Uncalled bet ($0.40) returned to pairofdz
pairofdz collected $0.66 from pot
pairofdz: doesn't show hand
*** SUMMARY ***
Total pot $0.70 | Rake $0.04
Board [Jd Qh Th]
Seat 2: PlayTheBlues4U (button) folded before Flop (didn't bet)
Seat 3: RNixon'sHead (small blind) folded on the Flop
Seat 4: EddieMoney9 (big blind) folded before Flop
Seat 5: pairofdz collected ($0.66)
Seat 6: JDM0226 folded before Flop (didn't bet)


*********** # 32 **************
PokerStars Hand #203844274367:  Hold'em No Limit ($0.05/$0.10 USD) - 2019/09/20 19:55:52 ET
Table 'Lacerta' 6-max Seat #6 is the button
Seat 2: PlayTheBlues4U ($11.92 in chips)
Seat 3: RNixon'sHead ($14.47 in chips)
Seat 4: EddieMoney9 ($12.09 in chips)
Seat 5: pairofdz ($10.65 in chips)
Seat 6: JDM0226 ($8.05 in chips)
PlayTheBlues4U: posts small blind $0.05
RNixon'sHead: posts big blind $0.10
*** HOLE CARDS ***
Dealt to PlayTheBlues4U [3c Th]
EddieMoney9: folds
pairofdz: raises $0.10 to $0.20
JDM0226: folds
PlayTheBlues4U: folds
RNixon'sHead: folds
Uncalled bet ($0.10) returned to pairofdz
pairofdz collected $0.25 from pot
pairofdz: doesn't show hand
*** SUMMARY ***
Total pot $0.25 | Rake $0
Seat 2: PlayTheBlues4U (small blind) folded before Flop
Seat 3: RNixon'sHead (big blind) folded before Flop
Seat 4: EddieMoney9 folded before Flop (didn't bet)
Seat 5: pairofdz collected ($0.25)
Seat 6: JDM0226 (button) folded before Flop (didn't bet)


*********** # 33 **************
PokerStars Hand #203844274336:  Hold'em No Limit ($0.05/$0.10 USD) - 2019/09/20 19:55:34 ET
Table 'Lacerta' 6-max Seat #5 is the button
Seat 2: PlayTheBlues4U ($11.87 in chips)
Seat 3: RNixon'sHead ($14.47 in chips)
Seat 4: EddieMoney9 ($12.09 in chips)
Seat 5: pairofdz ($10.65 in chips)
Seat 6: JDM0226 ($8.10 in chips)
JDM0226: posts small blind $0.05
PlayTheBlues4U: posts big blind $0.10
*** HOLE CARDS ***
Dealt to PlayTheBlues4U [Jh 4d]
RNixon'sHead: folds
EddieMoney9: folds
pairofdz: folds
JDM0226: folds
Uncalled bet ($0.05) returned to PlayTheBlues4U
PlayTheBlues4U collected $0.10 from pot
PlayTheBlues4U: doesn't show hand
*** SUMMARY ***
Total pot $0.10 | Rake $0
Seat 2: PlayTheBlues4U (big blind) collected ($0.10)
Seat 3: RNixon'sHead folded before Flop (didn't bet)
Seat 4: EddieMoney9 folded before Flop (didn't bet)
Seat 5: pairofdz (button) folded before Flop (didn't bet)
Seat 6: JDM0226 (small blind) folded before Flop


*********** # 34 **************
PokerStars Hand #203844274279:  Hold'em No Limit ($0.02/$0.05 USD) - 2019/09/20 19:54:58 ET
Table 'Anser' 6-max Seat #1 is the button
Seat 1: CMc172 ($3.41 in chips)
Seat 3: seags21 ($4.05 in chips)
Seat 4: PlayTheBlues4U ($8.05 in chips)
Seat 5: MozenMo ($3.58 in chips)
seags21: posts small blind $0.02
PlayTheBlues4U: posts big blind $0.05
*** HOLE CARDS ***
Dealt to PlayTheBlues4U [4d 5d]
MozenMo: raises $0.05 to $0.10
CMc172: calls $0.10
UmmmYummy leaves the table
seags21: folds
PlayTheBlues4U: calls $0.05
*** FLOP *** [Jd Kc 7c]
clovvnfiesta joins the table at seat #2
PlayTheBlues4U: checks
MozenMo: bets $0.30
CMc172: calls $0.30
PlayTheBlues4U: folds
*** TURN *** [Jd Kc 7c] [2d]
MozenMo: checks
CMc172: bets $0.15
MozenMo: calls $0.15
*** RIVER *** [Jd Kc 7c 2d] [6c]
MozenMo: bets $1.15
CMc172: folds
Uncalled bet ($1.15) returned to MozenMo
MozenMo collected $1.16 from pot
MozenMo: doesn't show hand
*** SUMMARY ***
Total pot $1.22 | Rake $0.06
Board [Jd Kc 7c 2d 6c]
Seat 1: CMc172 (button) folded on the River
Seat 3: seags21 (small blind) folded before Flop
Seat 4: PlayTheBlues4U (big blind) folded on the Flop
Seat 5: MozenMo collected ($1.16)


*********** # 35 **************
PokerStars Hand #203844274260:  Hold'em No Limit ($0.05/$0.10 USD) - 2019/09/20 19:54:48 ET
Table 'Lacerta' 6-max Seat #4 is the button
Seat 2: PlayTheBlues4U ($11.87 in chips)
Seat 3: RNixon'sHead ($14.47 in chips)
Seat 4: EddieMoney9 ($11.77 in chips)
Seat 5: pairofdz ($10.70 in chips)
Seat 6: JDM0226 ($8.40 in chips)
pairofdz: posts small blind $0.05
JDM0226: posts big blind $0.10
*** HOLE CARDS ***
Dealt to PlayTheBlues4U [8h 3d]
PlayTheBlues4U: folds
RNixon'sHead: folds
EddieMoney9: raises $0.20 to $0.30
pairofdz: folds
JDM0226: calls $0.20
*** FLOP *** [Jh 5c 7d]
JDM0226: checks
EddieMoney9: checks
*** TURN *** [Jh 5c 7d] [Th]
JDM0226: checks
EddieMoney9: bets $0.25
JDM0226: folds
Uncalled bet ($0.25) returned to EddieMoney9
EddieMoney9 collected $0.62 from pot
EddieMoney9: doesn't show hand
*** SUMMARY ***
Total pot $0.65 | Rake $0.03
Board [Jh 5c 7d Th]
Seat 2: PlayTheBlues4U folded before Flop (didn't bet)
Seat 3: RNixon'sHead folded before Flop (didn't bet)
Seat 4: EddieMoney9 (button) collected ($0.62)
Seat 5: pairofdz (small blind) folded before Flop
Seat 6: JDM0226 (big blind) folded on the Turn


*********** # 36 **************
PokerStars Hand #203844274238:  Hold'em No Limit ($0.02/$0.05 USD) - 2019/09/20 19:54:40 ET
Table 'Anser' 6-max Seat #5 is the button
Seat 1: CMc172 ($3.58 in chips)
Seat 3: seags21 ($4.10 in chips)
Seat 4: PlayTheBlues4U ($8.05 in chips)
Seat 5: MozenMo ($3.38 in chips)
CMc172: posts small blind $0.02
seags21: posts big blind $0.05
*** HOLE CARDS ***
Dealt to PlayTheBlues4U [2s 4c]
PlayTheBlues4U: folds
MozenMo: raises $0.12 to $0.17
CMc172: calls $0.15
seags21: folds
*** FLOP *** [5s Js Ad]
CMc172: checks
MozenMo: bets $0.35
CMc172: folds
Uncalled bet ($0.35) returned to MozenMo
MozenMo collected $0.37 from pot
MozenMo: doesn't show hand
*** SUMMARY ***
Total pot $0.39 | Rake $0.02
Board [5s Js Ad]
Seat 1: CMc172 (small blind) folded on the Flop
Seat 3: seags21 (big blind) folded before Flop
Seat 4: PlayTheBlues4U folded before Flop (didn't bet)
Seat 5: MozenMo (button) collected ($0.37)


*********** # 37 **************
PokerStars Hand #203844274203:  Hold'em No Limit ($0.05/$0.10 USD) - 2019/09/20 19:54:22 ET
Table 'Lacerta' 6-max Seat #3 is the button
Seat 2: PlayTheBlues4U ($11.87 in chips)
Seat 3: RNixon'sHead ($14.47 in chips)
Seat 4: EddieMoney9 ($11.82 in chips)
Seat 5: pairofdz ($10.65 in chips)
Seat 6: JDM0226 ($8.40 in chips)
EddieMoney9: posts small blind $0.05
pairofdz: posts big blind $0.10
*** HOLE CARDS ***
Dealt to PlayTheBlues4U [Js 4d]
JDM0226: folds
PlayTheBlues4U: folds
RNixon'sHead: folds
EddieMoney9: folds
Uncalled bet ($0.05) returned to pairofdz
pairofdz collected $0.10 from pot
pairofdz: doesn't show hand
*** SUMMARY ***
Total pot $0.10 | Rake $0
Seat 2: PlayTheBlues4U folded before Flop (didn't bet)
Seat 3: RNixon'sHead (button) folded before Flop (didn't bet)
Seat 4: EddieMoney9 (small blind) folded before Flop
Seat 5: pairofdz (big blind) collected ($0.10)
Seat 6: JDM0226 folded before Flop (didn't bet)


*********** # 38 **************
PokerStars Hand #203844274176:  Hold'em No Limit ($0.05/$0.10 USD) - 2019/09/20 19:54:05 ET
Table 'Lacerta' 6-max Seat #2 is the button
Seat 2: PlayTheBlues4U ($11.87 in chips)
Seat 3: RNixon'sHead ($14.37 in chips)
Seat 4: EddieMoney9 ($11.92 in chips)
Seat 5: pairofdz ($10.65 in chips)
Seat 6: JDM0226 ($8.40 in chips)
RNixon'sHead: posts small blind $0.05
EddieMoney9: posts big blind $0.10
*** HOLE CARDS ***
Dealt to PlayTheBlues4U [5s 9c]
pairofdz: folds
JDM0226: folds
PlayTheBlues4U: folds
RNixon'sHead: raises $0.20 to $0.30
EddieMoney9: folds
Uncalled bet ($0.20) returned to RNixon'sHead
RNixon'sHead collected $0.20 from pot
RNixon'sHead: doesn't show hand
*** SUMMARY ***
Total pot $0.20 | Rake $0
Seat 2: PlayTheBlues4U (button) folded before Flop (didn't bet)
Seat 3: RNixon'sHead (small blind) collected ($0.20)
Seat 4: EddieMoney9 (big blind) folded before Flop
Seat 5: pairofdz folded before Flop (didn't bet)
Seat 6: JDM0226 folded before Flop (didn't bet)


*********** # 39 **************
PokerStars Hand #203844274155:  Hold'em No Limit ($0.05/$0.10 USD) - 2019/09/20 19:53:52 ET
Table 'Lacerta' 6-max Seat #6 is the button
Seat 2: PlayTheBlues4U ($11.92 in chips)
Seat 3: RNixon'sHead ($14.47 in chips)
Seat 5: pairofdz ($10.50 in chips)
Seat 6: JDM0226 ($8.40 in chips)
PlayTheBlues4U: posts small blind $0.05
RNixon'sHead: posts big blind $0.10
EddieMoney9: sits out
*** HOLE CARDS ***
Dealt to PlayTheBlues4U [9c 2h]
pairofdz: raises $0.10 to $0.20
JDM0226: folds
PlayTheBlues4U: folds
RNixon'sHead: folds
Uncalled bet ($0.10) returned to pairofdz
pairofdz collected $0.25 from pot
pairofdz: doesn't show hand
*** SUMMARY ***
Total pot $0.25 | Rake $0
Seat 2: PlayTheBlues4U (small blind) folded before Flop
Seat 3: RNixon'sHead (big blind) folded before Flop
Seat 5: pairofdz collected ($0.25)
Seat 6: JDM0226 (button) folded before Flop (didn't bet)


*********** # 40 **************
PokerStars Hand #203844274150:  Hold'em No Limit ($0.02/$0.05 USD) - 2019/09/20 19:53:51 ET
Table 'Anser' 6-max Seat #4 is the button
Seat 1: CMc172 ($3.38 in chips)
Seat 2: UmmmYummy ($4.78 in chips)
Seat 3: seags21 ($4.10 in chips)
Seat 4: PlayTheBlues4U ($8.25 in chips)
Seat 5: MozenMo ($3.40 in chips)
MozenMo: posts small blind $0.02
CMc172: posts big blind $0.05
*** HOLE CARDS ***
Dealt to PlayTheBlues4U [Jd 6d]
UmmmYummy: folds
seags21: folds
PlayTheBlues4U: raises $0.05 to $0.10
MozenMo: folds
CMc172: calls $0.05
*** FLOP *** [9d 5h Ks]
CMc172: checks
PlayTheBlues4U: bets $0.10
CMc172: calls $0.10
*** TURN *** [9d 5h Ks] [Qs]
CMc172: checks
PlayTheBlues4U: checks
*** RIVER *** [9d 5h Ks Qs] [Kd]
CMc172: checks
PlayTheBlues4U: checks
*** SHOW DOWN ***
CMc172: shows [8h Ah] (a pair of Kings)
PlayTheBlues4U: mucks hand
CMc172 collected $0.40 from pot
*** SUMMARY ***
Total pot $0.42 | Rake $0.02
Board [9d 5h Ks Qs Kd]
Seat 1: CMc172 (big blind) showed [8h Ah] and won ($0.40) with a pair of Kings
Seat 2: UmmmYummy folded before Flop (didn't bet)
Seat 3: seags21 folded before Flop (didn't bet)
Seat 4: PlayTheBlues4U (button) mucked [Jd 6d]
Seat 5: MozenMo (small blind) folded before Flop


*********** # 41 **************
PokerStars Hand #203844274113:  Hold'em No Limit ($0.05/$0.10 USD) - 2019/09/20 19:53:34 ET
Table 'Lacerta' 6-max Seat #5 is the button
Seat 2: PlayTheBlues4U ($12.02 in chips)
Seat 3: RNixon'sHead ($14.47 in chips)
Seat 5: pairofdz ($10.50 in chips)
Seat 6: JDM0226 ($8.31 in chips)
JDM0226: posts small blind $0.05
PlayTheBlues4U: posts big blind $0.10
EddieMoney9: sits out
*** HOLE CARDS ***
Dealt to PlayTheBlues4U [2s Jh]
RNixon'sHead: folds
pairofdz: folds
JDM0226: calls $0.05
PlayTheBlues4U: checks
*** FLOP *** [5h 3c 3d]
JDM0226: checks
PlayTheBlues4U: checks
*** TURN *** [5h 3c 3d] [6s]
JDM0226: checks
PlayTheBlues4U: checks
*** RIVER *** [5h 3c 3d 6s] [Qh]
JDM0226: bets $0.10
PlayTheBlues4U: folds
Uncalled bet ($0.10) returned to JDM0226
JDM0226 collected $0.19 from pot
JDM0226: doesn't show hand
*** SUMMARY ***
Total pot $0.20 | Rake $0.01
Board [5h 3c 3d 6s Qh]
Seat 2: PlayTheBlues4U (big blind) folded on the River
Seat 3: RNixon'sHead folded before Flop (didn't bet)
Seat 5: pairofdz (button) folded before Flop (didn't bet)
Seat 6: JDM0226 (small blind) collected ($0.19)


*********** # 42 **************
PokerStars Hand #203844274088:  Hold'em No Limit ($0.05/$0.10 USD) - 2019/09/20 19:53:20 ET
Table 'Lacerta' 6-max Seat #3 is the button
Seat 2: PlayTheBlues4U ($11.87 in chips)
Seat 3: RNixon'sHead ($14.47 in chips)
Seat 5: pairofdz ($10.55 in chips)
Seat 6: JDM0226 ($8.41 in chips)
EddieMoney9 will be allowed to play after the button
pairofdz: posts small blind $0.05
JDM0226: posts big blind $0.10
*** HOLE CARDS ***
Dealt to PlayTheBlues4U [9c Kh]
PlayTheBlues4U: raises $0.20 to $0.30
RNixon'sHead: folds
pairofdz: folds
JDM0226: folds
Uncalled bet ($0.20) returned to PlayTheBlues4U
PlayTheBlues4U collected $0.25 from pot
PlayTheBlues4U: doesn't show hand
*** SUMMARY ***
Total pot $0.25 | Rake $0
Seat 2: PlayTheBlues4U collected ($0.25)
Seat 3: RNixon'sHead (button) folded before Flop (didn't bet)
Seat 5: pairofdz (small blind) folded before Flop
Seat 6: JDM0226 (big blind) folded before Flop


*********** # 43 **************
PokerStars Hand #203844274060:  Hold'em No Limit ($0.05/$0.10 USD) - 2019/09/20 19:53:07 ET
Table 'Lacerta' 6-max Seat #2 is the button
Seat 2: PlayTheBlues4U ($11.87 in chips)
Seat 3: RNixon'sHead ($14.52 in chips)
Seat 5: pairofdz ($10.50 in chips)
Seat 6: JDM0226 ($8.41 in chips)
RNixon'sHead: posts small blind $0.05
pairofdz: posts big blind $0.10
*** HOLE CARDS ***
Dealt to PlayTheBlues4U [9h 7c]
JDM0226: folds
PlayTheBlues4U: folds
RNixon'sHead: folds
Uncalled bet ($0.05) returned to pairofdz
pairofdz collected $0.10 from pot
pairofdz: doesn't show hand
*** SUMMARY ***
Total pot $0.10 | Rake $0
Seat 2: PlayTheBlues4U (button) folded before Flop (didn't bet)
Seat 3: RNixon'sHead (small blind) folded before Flop
Seat 5: pairofdz (big blind) collected ($0.10)
Seat 6: JDM0226 folded before Flop (didn't bet)


*********** # 44 **************
PokerStars Hand #203844273996:  Hold'em No Limit ($0.05/$0.10 USD) - 2019/09/20 19:52:29 ET
Table 'Lacerta' 6-max Seat #6 is the button
Seat 2: PlayTheBlues4U ($11.92 in chips)
Seat 3: RNixon'sHead ($14.62 in chips)
Seat 4: EddieMoney9 ($11.92 in chips)
Seat 5: pairofdz ($10.35 in chips)
Seat 6: JDM0226 ($8.41 in chips)
PlayTheBlues4U: posts small blind $0.05
RNixon'sHead: posts big blind $0.10
*** HOLE CARDS ***
Dealt to PlayTheBlues4U [9d Qd]
EddieMoney9 has timed out
EddieMoney9: folds
pairofdz: raises $0.20 to $0.30
JDM0226: folds
PlayTheBlues4U: folds
RNixon'sHead: folds
Uncalled bet ($0.20) returned to pairofdz
pairofdz collected $0.25 from pot
*** SUMMARY ***
Total pot $0.25 | Rake $0
Seat 2: PlayTheBlues4U (small blind) folded before Flop
Seat 3: RNixon'sHead (big blind) folded before Flop
Seat 4: EddieMoney9 folded before Flop (didn't bet)
Seat 5: pairofdz collected ($0.25)
Seat 6: JDM0226 (button) folded before Flop (didn't bet)


*********** # 45 **************
PokerStars Hand #203844273992:  Hold'em No Limit ($0.02/$0.05 USD) - 2019/09/20 19:52:27 ET
Table 'Anser' 6-max Seat #3 is the button
Seat 1: CMc172 ($3.48 in chips)
Seat 2: UmmmYummy ($4.78 in chips)
Seat 3: seags21 ($4.10 in chips)
Seat 4: PlayTheBlues4U ($7.89 in chips)
Seat 5: MozenMo ($3.70 in chips)
PlayTheBlues4U: posts small blind $0.02
MozenMo: posts big blind $0.05
*** HOLE CARDS ***
Dealt to PlayTheBlues4U [3s Ks]
CMc172: calls $0.05
UmmmYummy: folds
seags21: folds
PlayTheBlues4U: calls $0.03
MozenMo: checks
*** FLOP *** [Jh 6s 7s]
PlayTheBlues4U: checks
MozenMo: bets $0.05
CMc172: calls $0.05
PlayTheBlues4U: calls $0.05
*** TURN *** [Jh 6s 7s] [Qs]
PlayTheBlues4U: bets $0.20
MozenMo: calls $0.20
CMc172: folds
*** RIVER *** [Jh 6s 7s Qs] [8c]
PlayTheBlues4U: bets $0.60
MozenMo: folds
Uncalled bet ($0.60) returned to PlayTheBlues4U
PlayTheBlues4U collected $0.66 from pot
PlayTheBlues4U: doesn't show hand
*** SUMMARY ***
Total pot $0.70 | Rake $0.04
Board [Jh 6s 7s Qs 8c]
Seat 1: CMc172 folded on the Turn
Seat 2: UmmmYummy folded before Flop (didn't bet)
Seat 3: seags21 (button) folded before Flop (didn't bet)
Seat 4: PlayTheBlues4U (small blind) collected ($0.66)
Seat 5: MozenMo (big blind) folded on the River


*********** # 46 **************
PokerStars Hand #203844273947:  Hold'em No Limit ($0.02/$0.05 USD) - 2019/09/20 19:52:00 ET
Table 'Anser' 6-max Seat #2 is the button
Seat 1: CMc172 ($3.42 in chips)
Seat 2: UmmmYummy ($4.78 in chips)
Seat 3: seags21 ($4.12 in chips)
Seat 4: PlayTheBlues4U ($7.94 in chips)
Seat 5: MozenMo ($3.70 in chips)
seags21: posts small blind $0.02
PlayTheBlues4U: posts big blind $0.05
*** HOLE CARDS ***
Dealt to PlayTheBlues4U [8h 9d]
MozenMo: folds
CMc172: calls $0.05
UmmmYummy: folds
seags21: folds
PlayTheBlues4U: checks
*** FLOP *** [6h 6d Qc]
PlayTheBlues4U: checks
CMc172: bets $0.05
PlayTheBlues4U: folds
Uncalled bet ($0.05) returned to CMc172
CMc172 collected $0.11 from pot
CMc172: doesn't show hand
*** SUMMARY ***
Total pot $0.12 | Rake $0.01
Board [6h 6d Qc]
Seat 1: CMc172 collected ($0.11)
Seat 2: UmmmYummy (button) folded before Flop (didn't bet)
Seat 3: seags21 (small blind) folded before Flop
Seat 4: PlayTheBlues4U (big blind) folded on the Flop
Seat 5: MozenMo folded before Flop (didn't bet)


*********** # 47 **************
PokerStars Hand #203844273881:  Hold'em No Limit ($0.05/$0.10 USD) - 2019/09/20 19:51:23 ET
Table 'Lacerta' 6-max Seat #5 is the button
Seat 2: PlayTheBlues4U ($12.02 in chips)
Seat 3: RNixon'sHead ($14.62 in chips)
Seat 4: EddieMoney9 ($12.32 in chips)
Seat 5: pairofdz ($9.85 in chips)
Seat 6: JDM0226 ($8.46 in chips)
JDM0226: posts small blind $0.05
PlayTheBlues4U: posts big blind $0.10
*** HOLE CARDS ***
Dealt to PlayTheBlues4U [8d 4c]
RNixon'sHead: folds
EddieMoney9: calls $0.10
pairofdz: raises $0.30 to $0.40
JDM0226: folds
PlayTheBlues4U: folds
EddieMoney9: calls $0.30
*** FLOP *** [4h 9c 5s]
EddieMoney9: checks
pairofdz: bets $0.30
EddieMoney9: folds
Uncalled bet ($0.30) returned to pairofdz
pairofdz collected $0.90 from pot
pairofdz: doesn't show hand
*** SUMMARY ***
Total pot $0.95 | Rake $0.05
Board [4h 9c 5s]
Seat 2: PlayTheBlues4U (big blind) folded before Flop
Seat 3: RNixon'sHead folded before Flop (didn't bet)
Seat 4: EddieMoney9 folded on the Flop
Seat 5: pairofdz (button) collected ($0.90)
Seat 6: JDM0226 (small blind) folded before Flop


*********** # 48 **************
PokerStars Hand #203844273856:  Hold'em No Limit ($0.02/$0.05 USD) - 2019/09/20 19:51:10 ET
Table 'Anser' 6-max Seat #1 is the button
Seat 1: CMc172 ($3.47 in chips)
Seat 2: UmmmYummy ($4.83 in chips)
Seat 3: seags21 ($4.17 in chips)
Seat 4: PlayTheBlues4U ($7.94 in chips)
Seat 5: MozenMo ($3.56 in chips)
UmmmYummy: posts small blind $0.02
seags21: posts big blind $0.05
*** HOLE CARDS ***
Dealt to PlayTheBlues4U [8c 3h]
PlayTheBlues4U: folds
MozenMo: calls $0.05
CMc172: calls $0.05
UmmmYummy: calls $0.03
seags21: checks
*** FLOP *** [6c 7d 2s]
UmmmYummy: checks
seags21: checks
MozenMo: bets $0.20
CMc172: folds
UmmmYummy: folds
seags21: folds
Uncalled bet ($0.20) returned to MozenMo
MozenMo collected $0.19 from pot
MozenMo: doesn't show hand
*** SUMMARY ***
Total pot $0.20 | Rake $0.01
Board [6c 7d 2s]
Seat 1: CMc172 (button) folded on the Flop
Seat 2: UmmmYummy (small blind) folded on the Flop
Seat 3: seags21 (big blind) folded on the Flop
Seat 4: PlayTheBlues4U folded before Flop (didn't bet)
Seat 5: MozenMo collected ($0.19)


*********** # 49 **************
PokerStars Hand #203844273807:  Hold'em No Limit ($0.05/$0.10 USD) - 2019/09/20 19:50:41 ET
Table 'Lacerta' 6-max Seat #4 is the button
Seat 1: turk1120 ($6.79 in chips)
Seat 2: PlayTheBlues4U ($12.02 in chips)
Seat 3: RNixon'sHead ($14.35 in chips)
Seat 4: EddieMoney9 ($12.32 in chips)
Seat 5: pairofdz ($9.90 in chips)
Seat 6: JDM0226 ($8.71 in chips)
pairofdz: posts small blind $0.05
JDM0226: posts big blind $0.10
*** HOLE CARDS ***
Dealt to PlayTheBlues4U [8h Tc]
turk1120: folds
PlayTheBlues4U: folds
RNixon'sHead: raises $0.15 to $0.25
EddieMoney9: folds
pairofdz: folds
JDM0226: calls $0.15
*** FLOP *** [3h Qh 2h]
JDM0226: checks
RNixon'sHead: bets $0.22
JDM0226: folds
Uncalled bet ($0.22) returned to RNixon'sHead
RNixon'sHead collected $0.52 from pot
RNixon'sHead: doesn't show hand
*** SUMMARY ***
Total pot $0.55 | Rake $0.03
Board [3h Qh 2h]
Seat 1: turk1120 folded before Flop (didn't bet)
Seat 2: PlayTheBlues4U folded before Flop (didn't bet)
Seat 3: RNixon'sHead collected ($0.52)
Seat 4: EddieMoney9 (button) folded before Flop (didn't bet)
Seat 5: pairofdz (small blind) folded before Flop
Seat 6: JDM0226 (big blind) folded on the Flop


*********** # 50 **************
PokerStars Hand #203844273779:  Hold'em No Limit ($0.02/$0.05 USD) - 2019/09/20 19:50:23 ET
Table 'Anser' 6-max Seat #5 is the button
Seat 1: CMc172 ($3.52 in chips)
Seat 2: UmmmYummy ($4.36 in chips)
Seat 3: seags21 ($4.17 in chips)
Seat 4: PlayTheBlues4U ($8.09 in chips)
Seat 5: MozenMo ($3.71 in chips)
Seat 6: DemolishIT ($6.88 in chips)
DemolishIT: posts small blind $0.02
CMc172: posts big blind $0.05
*** HOLE CARDS ***
Dealt to PlayTheBlues4U [Ad 3h]
UmmmYummy: calls $0.05
seags21: folds
PlayTheBlues4U: raises $0.10 to $0.15
MozenMo: calls $0.15
DemolishIT: calls $0.13
CMc172: folds
UmmmYummy: calls $0.10
*** FLOP *** [7c Qd 3d]
DemolishIT: checks
UmmmYummy: bets $0.42
PlayTheBlues4U: folds
MozenMo: folds
DemolishIT: folds
Uncalled bet ($0.42) returned to UmmmYummy
UmmmYummy collected $0.62 from pot
UmmmYummy: doesn't show hand
*** SUMMARY ***
Total pot $0.65 | Rake $0.03
Board [7c Qd 3d]
Seat 1: CMc172 (big blind) folded before Flop
Seat 2: UmmmYummy collected ($0.62)
Seat 3: seags21 folded before Flop (didn't bet)
Seat 4: PlayTheBlues4U folded on the Flop
Seat 5: MozenMo (button) folded on the Flop
Seat 6: DemolishIT (small blind) folded on the Flop


*********** # 51 **************
PokerStars Hand #203844273690:  Hold'em No Limit ($0.05/$0.10 USD) - 2019/09/20 19:49:35 ET
Table 'Lacerta' 6-max Seat #3 is the button
Seat 1: turk1120 ($2.21 in chips)
Seat 2: PlayTheBlues4U ($12.02 in chips)
Seat 3: RNixon'sHead ($14.35 in chips)
Seat 4: EddieMoney9 ($11.86 in chips)
Seat 5: pairofdz ($10 in chips)
Seat 6: JDM0226 ($8.71 in chips)
EddieMoney9: posts small blind $0.05
pairofdz: posts big blind $0.10
*** HOLE CARDS ***
Dealt to PlayTheBlues4U [Ah 6d]
JDM0226: folds
turk1120: calls $0.10
PlayTheBlues4U: folds
RNixon'sHead: folds
EddieMoney9: raises $0.30 to $0.40
pairofdz: folds
turk1120: calls $0.30
*** FLOP *** [Jc Jd 6h]
EddieMoney9: bets $0.60
turk1120: folds
Uncalled bet ($0.60) returned to EddieMoney9
EddieMoney9 collected $0.86 from pot
EddieMoney9: doesn't show hand
*** SUMMARY ***
Total pot $0.90 | Rake $0.04
Board [Jc Jd 6h]
Seat 1: turk1120 folded on the Flop
Seat 2: PlayTheBlues4U folded before Flop (didn't bet)
Seat 3: RNixon'sHead (button) folded before Flop (didn't bet)
Seat 4: EddieMoney9 (small blind) collected ($0.86)
Seat 5: pairofdz (big blind) folded before Flop
Seat 6: JDM0226 folded before Flop (didn't bet)


*********** # 52 **************
PokerStars Hand #203844273633:  Hold'em No Limit ($0.02/$0.05 USD) - 2019/09/20 19:49:03 ET
Table 'Anser' 6-max Seat #4 is the button
Seat 1: CMc172 ($3.57 in chips)
Seat 2: UmmmYummy ($4.36 in chips)
Seat 3: seags21 ($4.17 in chips)
Seat 4: PlayTheBlues4U ($8.09 in chips)
Seat 5: MozenMo ($3.76 in chips)
Seat 6: DemolishIT ($6.79 in chips)
MozenMo: posts small blind $0.02
DemolishIT: posts big blind $0.05
*** HOLE CARDS ***
Dealt to PlayTheBlues4U [3h Kd]
CMc172: calls $0.05
UmmmYummy: folds
seags21: folds
PlayTheBlues4U: folds
MozenMo: calls $0.03
DemolishIT: checks
*** FLOP *** [Kc 9c Ad]
MozenMo: checks
DemolishIT: checks
CMc172: checks
*** TURN *** [Kc 9c Ad] [Td]
MozenMo: checks
DemolishIT: checks
CMc172: checks
*** RIVER *** [Kc 9c Ad Td] [As]
MozenMo: checks
DemolishIT: checks
CMc172: checks
*** SHOW DOWN ***
MozenMo: shows [7h 6h] (a pair of Aces)
DemolishIT: shows [Qd 4c] (a pair of Aces - King+Queen kicker)
CMc172: mucks hand
DemolishIT collected $0.14 from pot
*** SUMMARY ***
Total pot $0.15 | Rake $0.01
Board [Kc 9c Ad Td As]
Seat 1: CMc172 mucked [8h 4h]
Seat 2: UmmmYummy folded before Flop (didn't bet)
Seat 3: seags21 folded before Flop (didn't bet)
Seat 4: PlayTheBlues4U (button) folded before Flop (didn't bet)
Seat 5: MozenMo (small blind) showed [7h 6h] and lost with a pair of Aces
Seat 6: DemolishIT (big blind) showed [Qd 4c] and won ($0.14) with a pair of Aces


*********** # 53 **************
PokerStars Hand #203844273562:  Hold'em No Limit ($0.05/$0.10 USD) - 2019/09/20 19:48:31 ET
Table 'Lacerta' 6-max Seat #2 is the button
Seat 1: turk1120 ($3.31 in chips)
Seat 2: PlayTheBlues4U ($10.89 in chips)
Seat 3: RNixon'sHead ($14.40 in chips)
Seat 4: EddieMoney9 ($11.96 in chips)
Seat 6: JDM0226 ($8.71 in chips)
RNixon'sHead: posts small blind $0.05
EddieMoney9: posts big blind $0.10
*** HOLE CARDS ***
Dealt to PlayTheBlues4U [Kh Qc]
JDM0226: folds
turk1120: calls $0.10
PlayTheBlues4U: raises $0.20 to $0.30
PlayTheBlues4U said, "arroooo"
RNixon'sHead: folds
EddieMoney9: folds
turk1120: calls $0.20
*** FLOP *** [2s 9s Jh]
GoodKnight1365 was removed from the table for failing to post
GoodKnight1365 leaves the table
turk1120: bets $0.10
PlayTheBlues4U: calls $0.10
*** TURN *** [2s 9s Jh] [Qs]
turk1120: bets $0.20
PlayTheBlues4U: raises $0.50 to $0.70
pairofdz joins the table at seat #5
turk1120: calls $0.50
*** RIVER *** [2s 9s Jh Qs] [Ad]
turk1120: checks
PlayTheBlues4U: checks
*** SHOW DOWN ***
turk1120: shows [Kd Js] (a pair of Jacks)
PlayTheBlues4U: shows [Kh Qc] (a pair of Queens)
PlayTheBlues4U collected $2.23 from pot
*** SUMMARY ***
Total pot $2.35 | Rake $0.12
Board [2s 9s Jh Qs Ad]
Seat 1: turk1120 showed [Kd Js] and lost with a pair of Jacks
Seat 2: PlayTheBlues4U (button) showed [Kh Qc] and won ($2.23) with a pair of Queens
Seat 3: RNixon'sHead (small blind) folded before Flop
Seat 4: EddieMoney9 (big blind) folded before Flop
Seat 6: JDM0226 folded before Flop (didn't bet)


*********** # 54 **************
PokerStars Hand #203844273529:  Hold'em No Limit ($0.05/$0.10 USD) - 2019/09/20 19:48:15 ET
Table 'Lacerta' 6-max Seat #1 is the button
Seat 1: turk1120 ($3.31 in chips)
Seat 2: PlayTheBlues4U ($10.94 in chips)
Seat 3: RNixon'sHead ($14.35 in chips)
Seat 4: EddieMoney9 ($11.96 in chips)
Seat 6: JDM0226 ($8.71 in chips)
PlayTheBlues4U: posts small blind $0.05
RNixon'sHead: posts big blind $0.10
*** HOLE CARDS ***
Dealt to PlayTheBlues4U [Qd 4c]
EddieMoney9: folds
JDM0226: folds
turk1120: folds
PlayTheBlues4U: folds
Uncalled bet ($0.05) returned to RNixon'sHead
RNixon'sHead collected $0.10 from pot
RNixon'sHead: doesn't show hand
*** SUMMARY ***
Total pot $0.10 | Rake $0
Seat 1: turk1120 (button) folded before Flop (didn't bet)
Seat 2: PlayTheBlues4U (small blind) folded before Flop
Seat 3: RNixon'sHead (big blind) collected ($0.10)
Seat 4: EddieMoney9 folded before Flop (didn't bet)
Seat 6: JDM0226 folded before Flop (didn't bet)


*********** # 55 **************
PokerStars Hand #203844273504:  Hold'em No Limit ($0.02/$0.05 USD) - 2019/09/20 19:48:00 ET
Table 'Anser' 6-max Seat #3 is the button
Seat 1: CMc172 ($3.87 in chips)
Seat 2: UmmmYummy ($4.36 in chips)
Seat 3: seags21 ($4.17 in chips)
Seat 4: PlayTheBlues4U ($8.14 in chips)
Seat 5: MozenMo ($3.38 in chips)
Seat 6: DemolishIT ($6.86 in chips)
PlayTheBlues4U: posts small blind $0.02
MozenMo: posts big blind $0.05
DemolishIT: posts small & big blinds $0.07
*** HOLE CARDS ***
Dealt to PlayTheBlues4U [Js 2h]
DemolishIT: checks
CMc172: calls $0.05
UmmmYummy: folds
seags21: folds
PlayTheBlues4U: calls $0.03
MozenMo: checks
*** FLOP *** [3h 8c Td]
PlayTheBlues4U: checks
MozenMo: checks
DemolishIT: checks
CMc172: bets $0.10
PlayTheBlues4U: folds
MozenMo: calls $0.10
DemolishIT: folds
*** TURN *** [3h 8c Td] [7c]
MozenMo: bets $0.15
CMc172: calls $0.15
*** RIVER *** [3h 8c Td 7c] [2c]
MozenMo: checks
CMc172: checks
*** SHOW DOWN ***
MozenMo: shows [Jd 7d] (a pair of Sevens)
CMc172: mucks hand
MozenMo collected $0.68 from pot
*** SUMMARY ***
Total pot $0.72 | Rake $0.04
Board [3h 8c Td 7c 2c]
Seat 1: CMc172 mucked [3c Qd]
Seat 2: UmmmYummy folded before Flop (didn't bet)
Seat 3: seags21 (button) folded before Flop (didn't bet)
Seat 4: PlayTheBlues4U (small blind) folded on the Flop
Seat 5: MozenMo (big blind) showed [Jd 7d] and won ($0.68) with a pair of Sevens
Seat 6: DemolishIT folded on the Flop (didn't bet)


*********** # 56 **************
PokerStars Hand #203844273457:  Hold'em No Limit ($0.05/$0.10 USD) - 2019/09/20 19:47:40 ET
Table 'Lacerta' 6-max Seat #6 is the button
Seat 1: turk1120 ($3.22 in chips)
Seat 2: PlayTheBlues4U ($11.04 in chips)
Seat 3: RNixon'sHead ($14.35 in chips)
Seat 4: EddieMoney9 ($11.96 in chips)
Seat 6: JDM0226 ($8.71 in chips)
turk1120: posts small blind $0.05
PlayTheBlues4U: posts big blind $0.10
*** HOLE CARDS ***
Dealt to PlayTheBlues4U [8h Kc]
RNixon'sHead: folds
EddieMoney9 said, "worst flop ever for KK"
EddieMoney9: folds
JDM0226: folds
turk1120: calls $0.05
PlayTheBlues4U: checks
*** FLOP *** [6s 2d 5h]
turk1120: checks
PlayTheBlues4U: checks
*** TURN *** [6s 2d 5h] [7c]
turk1120: bets $0.10
PlayTheBlues4U: folds
Uncalled bet ($0.10) returned to turk1120
turk1120 collected $0.19 from pot
*** SUMMARY ***
Total pot $0.20 | Rake $0.01
Board [6s 2d 5h 7c]
Seat 1: turk1120 (small blind) collected ($0.19)
Seat 2: PlayTheBlues4U (big blind) folded on the Turn
Seat 3: RNixon'sHead folded before Flop (didn't bet)
Seat 4: EddieMoney9 folded before Flop (didn't bet)
Seat 6: JDM0226 (button) folded before Flop (didn't bet)


*********** # 57 **************
PokerStars Hand #203844273419:  Hold'em No Limit ($0.02/$0.05 USD) - 2019/09/20 19:47:22 ET
Table 'Anser' 6-max Seat #2 is the button
Seat 1: CMc172 ($4.02 in chips)
Seat 2: UmmmYummy ($4.36 in chips)
Seat 3: seags21 ($3.99 in chips)
Seat 4: PlayTheBlues4U ($8.19 in chips)
Seat 5: MozenMo ($3.38 in chips)
seags21: posts small blind $0.02
PlayTheBlues4U: posts big blind $0.05
*** HOLE CARDS ***
Dealt to PlayTheBlues4U [9c 4c]
MozenMo: folds
CMc172: calls $0.05
UmmmYummy: folds
seags21: raises $0.10 to $0.15
PlayTheBlues4U: folds
CMc172: calls $0.10
*** FLOP *** [Th Qd Qc]
seags21: bets $0.20
CMc172: folds
Uncalled bet ($0.20) returned to seags21
seags21 collected $0.33 from pot
*** SUMMARY ***
Total pot $0.35 | Rake $0.02
Board [Th Qd Qc]
Seat 1: CMc172 folded on the Flop
Seat 2: UmmmYummy (button) folded before Flop (didn't bet)
Seat 3: seags21 (small blind) collected ($0.33)
Seat 4: PlayTheBlues4U (big blind) folded before Flop
Seat 5: MozenMo folded before Flop (didn't bet)


*********** # 58 **************
PokerStars Hand #203844009959:  Hold'em No Limit ($0.02/$0.05 USD) - 2019/09/20 19:46:53 ET
Table 'Anser' 6-max Seat #1 is the button
Seat 1: CMc172 ($3.96 in chips)
Seat 2: UmmmYummy ($4.38 in chips)
Seat 3: seags21 ($4.04 in chips)
Seat 4: PlayTheBlues4U ($8.19 in chips)
Seat 5: MozenMo ($3.38 in chips)
UmmmYummy: posts small blind $0.02
seags21: posts big blind $0.05
*** HOLE CARDS ***
Dealt to PlayTheBlues4U [5s Kh]
PlayTheBlues4U: folds
MozenMo: folds
CMc172: calls $0.05
UmmmYummy: folds
seags21: checks
*** FLOP *** [2c 3s 3d]
seags21: checks
CMc172: checks
*** TURN *** [2c 3s 3d] [Ad]
seags21: checks
CMc172: checks
*** RIVER *** [2c 3s 3d Ad] [7d]
seags21: checks
CMc172: bets $0.05
seags21: folds
Uncalled bet ($0.05) returned to CMc172
CMc172 collected $0.11 from pot
CMc172: doesn't show hand
*** SUMMARY ***
Total pot $0.12 | Rake $0.01
Board [2c 3s 3d Ad 7d]
Seat 1: CMc172 (button) collected ($0.11)
Seat 2: UmmmYummy (small blind) folded before Flop
Seat 3: seags21 (big blind) folded on the River
Seat 4: PlayTheBlues4U folded before Flop (didn't bet)
Seat 5: MozenMo folded before Flop (didn't bet)


*********** # 59 **************
PokerStars Hand #203844009893:  Hold'em No Limit ($0.05/$0.10 USD) - 2019/09/20 19:46:22 ET
Table 'Lacerta' 6-max Seat #4 is the button
Seat 1: turk1120 ($3.32 in chips)
Seat 2: PlayTheBlues4U ($9.95 in chips)
Seat 3: RNixon'sHead ($14.35 in chips)
Seat 4: EddieMoney9 ($13.01 in chips)
Seat 6: JDM0226 ($8.76 in chips)
JDM0226: posts small blind $0.05
turk1120: posts big blind $0.10
*** HOLE CARDS ***
Dealt to PlayTheBlues4U [Ac Jc]
PlayTheBlues4U: raises $0.20 to $0.30
RNixon'sHead: folds
EddieMoney9: raises $0.75 to $1.05
JDM0226: folds
turk1120: folds
PlayTheBlues4U: calls $0.75
*** FLOP *** [6d 5d Ad]
PlayTheBlues4U: checks
EddieMoney9: checks
*** TURN *** [6d 5d Ad] [5s]
PlayTheBlues4U: bets $1.30
EddieMoney9: folds
Uncalled bet ($1.30) returned to PlayTheBlues4U
PlayTheBlues4U collected $2.14 from pot
PlayTheBlues4U: doesn't show hand
*** SUMMARY ***
Total pot $2.25 | Rake $0.11
Board [6d 5d Ad 5s]
Seat 1: turk1120 (big blind) folded before Flop
Seat 2: PlayTheBlues4U collected ($2.14)
Seat 3: RNixon'sHead folded before Flop (didn't bet)
Seat 4: EddieMoney9 (button) folded on the Turn
Seat 6: JDM0226 (small blind) folded before Flop


*********** # 60 **************
PokerStars Hand #203844009868:  Hold'em No Limit ($0.02/$0.05 USD) - 2019/09/20 19:46:09 ET
Table 'Anser' 6-max Seat #5 is the button
Seat 1: CMc172 ($3.98 in chips)
Seat 2: UmmmYummy ($5.07 in chips)
Seat 3: seags21 ($3.40 in chips)
Seat 4: PlayTheBlues4U ($8.19 in chips)
Seat 5: MozenMo ($3.38 in chips)
CMc172: posts small blind $0.02
UmmmYummy: posts big blind $0.05
*** HOLE CARDS ***
Dealt to PlayTheBlues4U [3h 8d]
seags21: raises $0.15 to $0.20
PlayTheBlues4U: folds
MozenMo: folds
CMc172: folds
UmmmYummy: calls $0.15
*** FLOP *** [6d Kd 8h]
UmmmYummy: checks
seags21: bets $0.15
UmmmYummy: calls $0.15
*** TURN *** [6d Kd 8h] [6s]
UmmmYummy: checks
seags21: checks
*** RIVER *** [6d Kd 8h 6s] [Jh]
UmmmYummy: bets $0.34
seags21: calls $0.34
*** SHOW DOWN ***
UmmmYummy: shows [Tc Td] (two pair, Tens and Sixes)
seags21: shows [Qd Kh] (two pair, Kings and Sixes)
seags21 collected $1.33 from pot
*** SUMMARY ***
Total pot $1.40 | Rake $0.07
Board [6d Kd 8h 6s Jh]
Seat 1: CMc172 (small blind) folded before Flop
Seat 2: UmmmYummy (big blind) showed [Tc Td] and lost with two pair, Tens and Sixes
Seat 3: seags21 showed [Qd Kh] and won ($1.33) with two pair, Kings and Sixes
Seat 4: PlayTheBlues4U folded before Flop (didn't bet)
Seat 5: MozenMo (button) folded before Flop (didn't bet)


*********** # 61 **************
PokerStars Hand #203844009859:  Hold'em No Limit ($0.05/$0.10 USD) - 2019/09/20 19:46:08 ET
Table 'Lacerta' 6-max Seat #3 is the button
Seat 1: turk1120 ($3.32 in chips)
Seat 2: PlayTheBlues4U ($9.95 in chips)
Seat 3: RNixon'sHead ($14.35 in chips)
Seat 4: EddieMoney9 ($13.06 in chips)
Seat 6: JDM0226 ($8.71 in chips)
EddieMoney9: posts small blind $0.05
JDM0226: posts big blind $0.10
*** HOLE CARDS ***
Dealt to PlayTheBlues4U [7c 4c]
turk1120: folds
PlayTheBlues4U: folds
RNixon'sHead: folds
EddieMoney9: folds
Uncalled bet ($0.05) returned to JDM0226
JDM0226 collected $0.10 from pot
JDM0226: doesn't show hand
*** SUMMARY ***
Total pot $0.10 | Rake $0
Seat 1: turk1120 folded before Flop (didn't bet)
Seat 2: PlayTheBlues4U folded before Flop (didn't bet)
Seat 3: RNixon'sHead (button) folded before Flop (didn't bet)
Seat 4: EddieMoney9 (small blind) folded before Flop
Seat 6: JDM0226 (big blind) collected ($0.10)


*********** # 62 **************
PokerStars Hand #203844009833:  Hold'em No Limit ($0.02/$0.05 USD) - 2019/09/20 19:45:53 ET
Table 'Anser' 6-max Seat #4 is the button
Seat 1: CMc172 ($4.03 in chips)
Seat 2: UmmmYummy ($5 in chips)
Seat 3: seags21 ($3.40 in chips)
Seat 4: PlayTheBlues4U ($8.19 in chips)
Seat 5: MozenMo ($3.40 in chips)
MozenMo: posts small blind $0.02
CMc172: posts big blind $0.05
*** HOLE CARDS ***
Dealt to PlayTheBlues4U [Td 7s]
UmmmYummy: raises $0.12 to $0.17
seags21: folds
PlayTheBlues4U: folds
MozenMo: folds
CMc172: folds
Uncalled bet ($0.12) returned to UmmmYummy
UmmmYummy collected $0.12 from pot
UmmmYummy: doesn't show hand
*** SUMMARY ***
Total pot $0.12 | Rake $0
Seat 1: CMc172 (big blind) folded before Flop
Seat 2: UmmmYummy collected ($0.12)
Seat 3: seags21 folded before Flop (didn't bet)
Seat 4: PlayTheBlues4U (button) folded before Flop (didn't bet)
Seat 5: MozenMo (small blind) folded before Flop


*********** # 63 **************
PokerStars Hand #203844009787:  Hold'em No Limit ($0.05/$0.10 USD) - 2019/09/20 19:45:28 ET
Table 'Lacerta' 6-max Seat #2 is the button
Seat 1: turk1120 ($3.62 in chips)
Seat 2: PlayTheBlues4U ($9.54 in chips)
Seat 3: RNixon'sHead ($14.40 in chips)
Seat 4: EddieMoney9 ($13.16 in chips)
Seat 6: JDM0226 ($8.71 in chips)
RNixon'sHead: posts small blind $0.05
EddieMoney9: posts big blind $0.10
*** HOLE CARDS ***
Dealt to PlayTheBlues4U [Ad 4c]
JDM0226: folds
turk1120: calls $0.10
PlayTheBlues4U: raises $0.20 to $0.30
RNixon'sHead: folds
EddieMoney9: folds
turk1120: calls $0.20
*** FLOP *** [9s Kd 7d]
turk1120: checks
PlayTheBlues4U: bets $0.40
turk1120: folds
Uncalled bet ($0.40) returned to PlayTheBlues4U
PlayTheBlues4U collected $0.71 from pot
PlayTheBlues4U: doesn't show hand
*** SUMMARY ***
Total pot $0.75 | Rake $0.04
Board [9s Kd 7d]
Seat 1: turk1120 folded on the Flop
Seat 2: PlayTheBlues4U (button) collected ($0.71)
Seat 3: RNixon'sHead (small blind) folded before Flop
Seat 4: EddieMoney9 (big blind) folded before Flop
Seat 6: JDM0226 folded before Flop (didn't bet)


*********** # 64 **************
PokerStars Hand #203844009695:  Hold'em No Limit ($0.02/$0.05 USD) - 2019/09/20 19:44:46 ET
Table 'Anser' 6-max Seat #3 is the button
Seat 1: CMc172 ($3.47 in chips)
Seat 2: UmmmYummy ($3.14 in chips)
Seat 3: seags21 ($3.40 in chips)
Seat 4: PlayTheBlues4U ($8.21 in chips)
Seat 5: MozenMo ($4 in chips)
PlayTheBlues4U: posts small blind $0.02
MozenMo: posts big blind $0.05
*** HOLE CARDS ***
Dealt to PlayTheBlues4U [Js Qd]
CMc172: calls $0.05
UmmmYummy: folds
seags21: folds
PlayTheBlues4U: folds
MozenMo: raises $0.10 to $0.15
CMc172: calls $0.10
*** FLOP *** [Td Kh Jh]
MozenMo: bets $0.15
CMc172: calls $0.15
*** TURN *** [Td Kh Jh] [Ah]
MozenMo: bets $0.30
CMc172: calls $0.30
*** RIVER *** [Td Kh Jh Ah] [9c]
MozenMo: checks
CMc172: checks
*** SHOW DOWN ***
MozenMo: shows [Ac 3d] (a pair of Aces)
CMc172: shows [Ks 9h] (two pair, Kings and Nines)
CMc172 collected $1.16 from pot
*** SUMMARY ***
Total pot $1.22 | Rake $0.06
Board [Td Kh Jh Ah 9c]
Seat 1: CMc172 showed [Ks 9h] and won ($1.16) with two pair, Kings and Nines
Seat 2: UmmmYummy folded before Flop (didn't bet)
Seat 3: seags21 (button) folded before Flop (didn't bet)
Seat 4: PlayTheBlues4U (small blind) folded before Flop
Seat 5: MozenMo (big blind) showed [Ac 3d] and lost with a pair of Aces


*********** # 65 **************
PokerStars Hand #203844009638:  Hold'em No Limit ($0.02/$0.05 USD) - 2019/09/20 19:44:18 ET
Table 'Anser' 6-max Seat #2 is the button
Seat 1: CMc172 ($3.47 in chips)
Seat 2: UmmmYummy ($3.34 in chips)
Seat 3: seags21 ($3.42 in chips)
Seat 4: PlayTheBlues4U ($8.01 in chips)
seags21: posts small blind $0.02
PlayTheBlues4U: posts big blind $0.05
MozenMo: sits out
*** HOLE CARDS ***
Dealt to PlayTheBlues4U [As 3s]
CMc172: folds
UmmmYummy: calls $0.05
seags21: folds
PlayTheBlues4U: raises $0.15 to $0.20
UmmmYummy: calls $0.15
*** FLOP *** [Qs Jc 7d]
PlayTheBlues4U: bets $0.25
UmmmYummy: folds
Uncalled bet ($0.25) returned to PlayTheBlues4U
PlayTheBlues4U collected $0.40 from pot
PlayTheBlues4U: doesn't show hand
*** SUMMARY ***
Total pot $0.42 | Rake $0.02
Board [Qs Jc 7d]
Seat 1: CMc172 folded before Flop (didn't bet)
Seat 2: UmmmYummy (button) folded on the Flop
Seat 3: seags21 (small blind) folded before Flop
Seat 4: PlayTheBlues4U (big blind) collected ($0.40)


*********** # 66 **************
PokerStars Hand #203844009635:  Hold'em No Limit ($0.05/$0.10 USD) - 2019/09/20 19:44:16 ET
Table 'Lacerta' 6-max Seat #1 is the button
Seat 1: turk1120 ($3.72 in chips)
Seat 2: PlayTheBlues4U ($9.36 in chips)
Seat 3: RNixon'sHead ($14.50 in chips)
Seat 4: EddieMoney9 ($13.16 in chips)
Seat 6: JDM0226 ($8.71 in chips)
PlayTheBlues4U: posts small blind $0.05
RNixon'sHead: posts big blind $0.10
*** HOLE CARDS ***
Dealt to PlayTheBlues4U [Kc Th]
EddieMoney9: folds
JDM0226: folds
turk1120: calls $0.10
PlayTheBlues4U: calls $0.05
RNixon'sHead: checks
*** FLOP *** [Tc Ah Qd]
PlayTheBlues4U: checks
RNixon'sHead: checks
turk1120: checks
*** TURN *** [Tc Ah Qd] [7d]
PlayTheBlues4U: checks
RNixon'sHead: checks
turk1120: checks
*** RIVER *** [Tc Ah Qd 7d] [8c]
PlayTheBlues4U: checks
RNixon'sHead: checks
turk1120: checks
*** SHOW DOWN ***
PlayTheBlues4U: shows [Kc Th] (a pair of Tens)
RNixon'sHead: mucks hand
turk1120: mucks hand
PlayTheBlues4U collected $0.28 from pot
*** SUMMARY ***
Total pot $0.30 | Rake $0.02
Board [Tc Ah Qd 7d 8c]
Seat 1: turk1120 (button) mucked [6c 5s]
Seat 2: PlayTheBlues4U (small blind) showed [Kc Th] and won ($0.28) with a pair of Tens
Seat 3: RNixon'sHead (big blind) mucked [2c 3c]
Seat 4: EddieMoney9 folded before Flop (didn't bet)
Seat 6: JDM0226 folded before Flop (didn't bet)


*********** # 67 **************
PokerStars Hand #203844009538:  Hold'em No Limit ($0.02/$0.05 USD) - 2019/09/20 19:43:23 ET
Table 'Anser' 6-max Seat #1 is the button
Seat 1: CMc172 ($3.62 in chips)
Seat 2: UmmmYummy ($4.84 in chips)
Seat 3: seags21 ($3.57 in chips)
Seat 4: PlayTheBlues4U ($6.37 in chips)
UmmmYummy: posts small blind $0.02
seags21: posts big blind $0.05
MozenMo: sits out
*** HOLE CARDS ***
Dealt to PlayTheBlues4U [6h Ah]
PlayTheBlues4U: raises $0.10 to $0.15
CMc172: calls $0.15
UmmmYummy: calls $0.13
seags21: calls $0.10
*** FLOP *** [Ad 7h 6s]
UmmmYummy: checks
seags21: checks
PlayTheBlues4U: bets $0.40
CMc172: folds
UmmmYummy: calls $0.40
seags21: folds
*** TURN *** [Ad 7h 6s] [Js]
UmmmYummy: checks
PlayTheBlues4U: checks
*** RIVER *** [Ad 7h 6s Js] [2d]
UmmmYummy: checks
PlayTheBlues4U: bets $0.95
UmmmYummy: calls $0.95
*** SHOW DOWN ***
PlayTheBlues4U: shows [6h Ah] (two pair, Aces and Sixes)
UmmmYummy: mucks hand
PlayTheBlues4U collected $3.14 from pot
*** SUMMARY ***
Total pot $3.30 | Rake $0.16
Board [Ad 7h 6s Js 2d]
Seat 1: CMc172 (button) folded on the Flop
Seat 2: UmmmYummy (small blind) mucked [As Th]
Seat 3: seags21 (big blind) folded on the Flop
Seat 4: PlayTheBlues4U showed [6h Ah] and won ($3.14) with two pair, Aces and Sixes


*********** # 68 **************
PokerStars Hand #203844009476:  Hold'em No Limit ($0.02/$0.05 USD) - 2019/09/20 19:42:55 ET
Table 'Anser' 6-max Seat #4 is the button
Seat 1: CMc172 ($3.67 in chips)
Seat 2: UmmmYummy ($4.79 in chips)
Seat 3: seags21 ($3.57 in chips)
Seat 4: PlayTheBlues4U ($6.37 in chips)
CMc172: posts small blind $0.02
UmmmYummy: posts big blind $0.05
*** HOLE CARDS ***
Dealt to PlayTheBlues4U [2c 8s]
lj001ll leaves the table
seags21: folds
MozenMo joins the table at seat #5
PlayTheBlues4U: folds
CMc172: calls $0.03
UmmmYummy: raises $0.15 to $0.20
CMc172: folds
Uncalled bet ($0.15) returned to UmmmYummy
UmmmYummy collected $0.10 from pot
UmmmYummy: doesn't show hand
*** SUMMARY ***
Total pot $0.10 | Rake $0
Seat 1: CMc172 (small blind) folded before Flop
Seat 2: UmmmYummy (big blind) collected ($0.10)
Seat 3: seags21 folded before Flop (didn't bet)
Seat 4: PlayTheBlues4U (button) folded before Flop (didn't bet)


*********** # 69 **************
PokerStars Hand #203844009468:  Hold'em No Limit ($0.05/$0.10 USD) - 2019/09/20 19:42:49 ET
Table 'Lacerta' 6-max Seat #6 is the button
Seat 1: turk1120 ($9.05 in chips)
Seat 2: PlayTheBlues4U ($9.66 in chips)
Seat 3: RNixon'sHead ($14.50 in chips)
Seat 4: EddieMoney9 ($7.79 in chips)
Seat 6: JDM0226 ($9.01 in chips)
turk1120: posts small blind $0.05
PlayTheBlues4U: posts big blind $0.10
*** HOLE CARDS ***
Dealt to PlayTheBlues4U [8s 9h]
RNixon'sHead: folds
EddieMoney9: raises $0.20 to $0.30
JDM0226: calls $0.30
turk1120: calls $0.25
PlayTheBlues4U: calls $0.20
*** FLOP *** [Qh 8h 5d]
turk1120: bets $0.57
PlayTheBlues4U: folds
EddieMoney9: calls $0.57
JDM0226: folds
*** TURN *** [Qh 8h 5d] [Ts]
turk1120: bets $0.20
EddieMoney9: raises $1.83 to $2.03
turk1120: calls $1.83
*** RIVER *** [Qh 8h 5d Ts] [3c]
turk1120: checks
EddieMoney9: bets $2.43
turk1120: calls $2.43
*** SHOW DOWN ***
EddieMoney9: shows [Qd Qs] (three of a kind, Queens)
turk1120: mucks hand
EddieMoney9 collected $10.70 from pot
*** SUMMARY ***
Total pot $11.26 | Rake $0.56
Board [Qh 8h 5d Ts 3c]
Seat 1: turk1120 (small blind) mucked [Qc Ks]
Seat 2: PlayTheBlues4U (big blind) folded on the Flop
Seat 3: RNixon'sHead folded before Flop (didn't bet)
Seat 4: EddieMoney9 showed [Qd Qs] and won ($10.70) with three of a kind, Queens
Seat 6: JDM0226 (button) folded on the Flop


*********** # 70 **************
PokerStars Hand #203844009429:  Hold'em No Limit ($0.02/$0.05 USD) - 2019/09/20 19:42:29 ET
Table 'Anser' 6-max Seat #3 is the button
Seat 1: CMc172 ($3.77 in chips)
Seat 2: UmmmYummy ($4.65 in chips)
Seat 3: seags21 ($3.57 in chips)
Seat 4: PlayTheBlues4U ($6.42 in chips)
PlayTheBlues4U: posts small blind $0.02
CMc172: posts big blind $0.05
*** HOLE CARDS ***
Dealt to PlayTheBlues4U [6c Qd]
UmmmYummy: calls $0.05
seags21: folds
PlayTheBlues4U: calls $0.03
CMc172: checks
*** FLOP *** [8c Ks Ac]
PlayTheBlues4U: checks
CMc172: bets $0.05
UmmmYummy: raises $0.12 to $0.17
PlayTheBlues4U: folds
CMc172: folds
Uncalled bet ($0.12) returned to UmmmYummy
UmmmYummy collected $0.24 from pot
UmmmYummy: doesn't show hand
*** SUMMARY ***
Total pot $0.25 | Rake $0.01
Board [8c Ks Ac]
Seat 1: CMc172 (big blind) folded on the Flop
Seat 2: UmmmYummy collected ($0.24)
Seat 3: seags21 (button) folded before Flop (didn't bet)
Seat 4: PlayTheBlues4U (small blind) folded on the Flop


*********** # 71 **************
PokerStars Hand #203844009376:  Hold'em No Limit ($0.02/$0.05 USD) - 2019/09/20 19:42:02 ET
Table 'Anser' 6-max Seat #2 is the button
Seat 1: CMc172 ($3.82 in chips)
Seat 2: UmmmYummy ($4.65 in chips)
Seat 3: seags21 ($3.47 in chips)
Seat 4: PlayTheBlues4U ($6.47 in chips)
seags21: posts small blind $0.02
PlayTheBlues4U: posts big blind $0.05
*** HOLE CARDS ***
Dealt to PlayTheBlues4U [5c 3h]
CMc172: calls $0.05
UmmmYummy: folds
seags21: raises $0.15 to $0.20
PlayTheBlues4U: folds
CMc172: folds
Uncalled bet ($0.15) returned to seags21
seags21 collected $0.15 from pot
seags21: doesn't show hand
*** SUMMARY ***
Total pot $0.15 | Rake $0
Seat 1: CMc172 folded before Flop
Seat 2: UmmmYummy (button) folded before Flop (didn't bet)
Seat 3: seags21 (small blind) collected ($0.15)
Seat 4: PlayTheBlues4U (big blind) folded before Flop


*********** # 72 **************
PokerStars Hand #203844009359:  Hold'em No Limit ($0.05/$0.10 USD) - 2019/09/20 19:41:55 ET
Table 'Lacerta' 6-max Seat #4 is the button
Seat 1: turk1120 ($7.90 in chips)
Seat 2: PlayTheBlues4U ($9.66 in chips)
Seat 3: RNixon'sHead ($14.50 in chips)
Seat 4: EddieMoney9 ($9.01 in chips)
Seat 6: JDM0226 ($9.06 in chips)
JDM0226: posts small blind $0.05
turk1120: posts big blind $0.10
*** HOLE CARDS ***
Dealt to PlayTheBlues4U [5d 4h]
PlayTheBlues4U: folds
RNixon'sHead: folds
EddieMoney9: raises $0.20 to $0.30
JDM0226: folds
turk1120: calls $0.20
*** FLOP *** [Kh 6s Ts]
turk1120: bets $0.31
EddieMoney9: calls $0.31
*** TURN *** [Kh 6s Ts] [Qs]
turk1120: bets $0.61
EddieMoney9: calls $0.61
*** RIVER *** [Kh 6s Ts Qs] [7s]
turk1120: checks
EddieMoney9: checks
*** SHOW DOWN ***
turk1120: shows [Kc Tc] (two pair, Kings and Tens)
EddieMoney9: mucks hand
turk1120 collected $2.37 from pot
*** SUMMARY ***
Total pot $2.49 | Rake $0.12
Board [Kh 6s Ts Qs 7s]
Seat 1: turk1120 (big blind) showed [Kc Tc] and won ($2.37) with two pair, Kings and Tens
Seat 2: PlayTheBlues4U folded before Flop (didn't bet)
Seat 3: RNixon'sHead folded before Flop (didn't bet)
Seat 4: EddieMoney9 (button) mucked [Qh 9h]
Seat 6: JDM0226 (small blind) folded before Flop


*********** # 73 **************
PokerStars Hand #203844009252:  Hold'em No Limit ($0.05/$0.10 USD) - 2019/09/20 19:40:57 ET
Table 'Lacerta' 6-max Seat #3 is the button
Seat 1: turk1120 ($8 in chips)
Seat 2: PlayTheBlues4U ($9.11 in chips)
Seat 3: RNixon'sHead ($14.50 in chips)
Seat 4: EddieMoney9 ($9.41 in chips)
Seat 6: JDM0226 ($9.16 in chips)
EddieMoney9: posts small blind $0.05
JDM0226: posts big blind $0.10
*** HOLE CARDS ***
Dealt to PlayTheBlues4U [Ac 7c]
turk1120: calls $0.10
PlayTheBlues4U: raises $0.30 to $0.40
RNixon'sHead: folds
EddieMoney9: calls $0.35
JDM0226: folds
turk1120: folds
*** FLOP *** [7d Qc Qd]
EddieMoney9: checks
PlayTheBlues4U: bets $0.60
EddieMoney9: folds
Uncalled bet ($0.60) returned to PlayTheBlues4U
PlayTheBlues4U collected $0.95 from pot
PlayTheBlues4U: doesn't show hand
*** SUMMARY ***
Total pot $1 | Rake $0.05
Board [7d Qc Qd]
Seat 1: turk1120 folded before Flop
Seat 2: PlayTheBlues4U collected ($0.95)
Seat 3: RNixon'sHead (button) folded before Flop (didn't bet)
Seat 4: EddieMoney9 (small blind) folded on the Flop
Seat 6: JDM0226 (big blind) folded before Flop


*********** # 74 **************
PokerStars Hand #203844009240:  Hold'em No Limit ($0.02/$0.05 USD) - 2019/09/20 19:40:49 ET
Table 'Anser' 6-max Seat #1 is the button
Seat 1: CMc172 ($3.99 in chips)
Seat 2: UmmmYummy ($4.67 in chips)
Seat 3: seags21 ($5.07 in chips)
Seat 4: PlayTheBlues4U ($6.47 in chips)
Seat 5: lj001ll ($1.60 in chips)
UmmmYummy: posts small blind $0.02
seags21: posts big blind $0.05
*** HOLE CARDS ***
Dealt to PlayTheBlues4U [Ah 7s]
PlayTheBlues4U: folds
lj001ll: calls $0.05
CMc172: calls $0.05
UmmmYummy: folds
seags21: checks
*** FLOP *** [Qc Jh 6s]
seags21: checks
lj001ll: checks
CMc172: checks
*** TURN *** [Qc Jh 6s] [3s]
seags21: bets $0.06
lj001ll: raises $0.06 to $0.12
CMc172: calls $0.12
seags21: raises $0.52 to $0.64
lj001ll: calls $0.52
CMc172: folds
*** RIVER *** [Qc Jh 6s 3s] [Ts]
seags21: bets $0.91
lj001ll: calls $0.91 and is all-in
*** SHOW DOWN ***
seags21: shows [3c 6c] (two pair, Sixes and Threes)
lj001ll: shows [3d 3h] (three of a kind, Threes)
lj001ll collected $3.22 from pot
*** SUMMARY ***
Total pot $3.39 | Rake $0.17
Board [Qc Jh 6s 3s Ts]
Seat 1: CMc172 (button) folded on the Turn
Seat 2: UmmmYummy (small blind) folded before Flop
Seat 3: seags21 (big blind) showed [3c 6c] and lost with two pair, Sixes and Threes
Seat 4: PlayTheBlues4U folded before Flop (didn't bet)
Seat 5: lj001ll showed [3d 3h] and won ($3.22) with three of a kind, Threes


*********** # 75 **************
PokerStars Hand #203844009150:  Hold'em No Limit ($0.02/$0.05 USD) - 2019/09/20 19:40:02 ET
Table 'Anser' 6-max Seat #5 is the button
Seat 1: CMc172 ($4.14 in chips)
Seat 2: UmmmYummy ($4.77 in chips)
Seat 3: seags21 ($5.07 in chips)
Seat 4: PlayTheBlues4U ($6.47 in chips)
Seat 5: lj001ll ($1.37 in chips)
CMc172: posts small blind $0.02
UmmmYummy: posts big blind $0.05
*** HOLE CARDS ***
Dealt to PlayTheBlues4U [5h 2c]
seags21: folds
PlayTheBlues4U: folds
lj001ll: calls $0.05
CMc172: calls $0.03
UmmmYummy: checks
*** FLOP *** [3s 5d 7d]
CMc172: checks
UmmmYummy: checks
lj001ll: checks
*** TURN *** [3s 5d 7d] [Jc]
CMc172: bets $0.05
UmmmYummy: calls $0.05
lj001ll: calls $0.05
*** RIVER *** [3s 5d 7d Jc] [Ts]
CMc172: bets $0.05
UmmmYummy: folds
lj001ll: raises $0.19 to $0.24
CMc172: folds
Uncalled bet ($0.19) returned to lj001ll
lj001ll collected $0.38 from pot
lj001ll: doesn't show hand
*** SUMMARY ***
Total pot $0.40 | Rake $0.02
Board [3s 5d 7d Jc Ts]
Seat 1: CMc172 (small blind) folded on the River
Seat 2: UmmmYummy (big blind) folded on the River
Seat 3: seags21 folded before Flop (didn't bet)
Seat 4: PlayTheBlues4U folded before Flop (didn't bet)
Seat 5: lj001ll (button) collected ($0.38)


*********** # 76 **************
PokerStars Hand #203844009120:  Hold'em No Limit ($0.02/$0.05 USD) - 2019/09/20 19:39:43 ET
Table 'Anser' 6-max Seat #4 is the button
Seat 1: CMc172 ($4.12 in chips)
Seat 2: UmmmYummy ($4.77 in chips)
Seat 3: seags21 ($5.07 in chips)
Seat 4: PlayTheBlues4U ($6.47 in chips)
Seat 5: lj001ll ($1.39 in chips)
lj001ll: posts small blind $0.02
CMc172: posts big blind $0.05
*** HOLE CARDS ***
Dealt to PlayTheBlues4U [3h Jd]
UmmmYummy: folds
seags21: folds
PlayTheBlues4U: folds
lj001ll: folds
Uncalled bet ($0.03) returned to CMc172
CMc172 collected $0.04 from pot
CMc172: doesn't show hand
*** SUMMARY ***
Total pot $0.04 | Rake $0
Seat 1: CMc172 (big blind) collected ($0.04)
Seat 2: UmmmYummy folded before Flop (didn't bet)
Seat 3: seags21 folded before Flop (didn't bet)
Seat 4: PlayTheBlues4U (button) folded before Flop (didn't bet)
Seat 5: lj001ll (small blind) folded before Flop


*********** # 77 **************
PokerStars Hand #203844009108:  Hold'em No Limit ($0.05/$0.10 USD) - 2019/09/20 19:39:39 ET
Table 'Lacerta' 6-max Seat #2 is the button
Seat 1: turk1120 ($9.05 in chips)
Seat 2: PlayTheBlues4U ($9.41 in chips)
Seat 3: RNixon'sHead ($14.55 in chips)
Seat 4: EddieMoney9 ($8.13 in chips)
Seat 6: JDM0226 ($9.16 in chips)
RNixon'sHead: posts small blind $0.05
EddieMoney9: posts big blind $0.10
*** HOLE CARDS ***
Dealt to PlayTheBlues4U [4d Kd]
JDM0226: folds
turk1120: calls $0.10
PlayTheBlues4U: raises $0.20 to $0.30
RNixon'sHead: folds
EddieMoney9: raises $0.75 to $1.05
turk1120: calls $0.95
PlayTheBlues4U: folds
*** FLOP *** [6s 3h 4s]
EddieMoney9: checks
turk1120: checks
*** TURN *** [6s 3h 4s] [5c]
EddieMoney9: checks
turk1120: checks
*** RIVER *** [6s 3h 4s 5c] [Jh]
EddieMoney9: bets $0.93
turk1120: folds
Uncalled bet ($0.93) returned to EddieMoney9
EddieMoney9 collected $2.33 from pot
EddieMoney9: doesn't show hand
*** SUMMARY ***
Total pot $2.45 | Rake $0.12
Board [6s 3h 4s 5c Jh]
Seat 1: turk1120 folded on the River
Seat 2: PlayTheBlues4U (button) folded before Flop
Seat 3: RNixon'sHead (small blind) folded before Flop
Seat 4: EddieMoney9 (big blind) collected ($2.33)
Seat 6: JDM0226 folded before Flop (didn't bet)


*********** # 78 **************
PokerStars Hand #203844009034:  Hold'em No Limit ($0.05/$0.10 USD) - 2019/09/20 19:39:01 ET
Table 'Lacerta' 6-max Seat #1 is the button
Seat 1: turk1120 ($8.91 in chips)
Seat 2: PlayTheBlues4U ($9.46 in chips)
Seat 3: RNixon'sHead ($14.65 in chips)
Seat 4: EddieMoney9 ($8.13 in chips)
Seat 6: JDM0226 ($9.16 in chips)
PlayTheBlues4U: posts small blind $0.05
RNixon'sHead: posts big blind $0.10
*** HOLE CARDS ***
Dealt to PlayTheBlues4U [4d 8c]
EddieMoney9: folds
JDM0226: folds
turk1120: calls $0.10
PlayTheBlues4U: folds
RNixon'sHead: checks
*** FLOP *** [3d Jh 3h]
RNixon'sHead: checks
turk1120: bets $0.20
RNixon'sHead: folds
Uncalled bet ($0.20) returned to turk1120
turk1120 collected $0.24 from pot
*** SUMMARY ***
Total pot $0.25 | Rake $0.01
Board [3d Jh 3h]
Seat 1: turk1120 (button) collected ($0.24)
Seat 2: PlayTheBlues4U (small blind) folded before Flop
Seat 3: RNixon'sHead (big blind) folded on the Flop
Seat 4: EddieMoney9 folded before Flop (didn't bet)
Seat 6: JDM0226 folded before Flop (didn't bet)


*********** # 79 **************
PokerStars Hand #203844009005:  Hold'em No Limit ($0.02/$0.05 USD) - 2019/09/20 19:38:48 ET
Table 'Anser' 6-max Seat #3 is the button
Seat 1: CMc172 ($4.06 in chips)
Seat 2: UmmmYummy ($4.77 in chips)
Seat 3: seags21 ($5.07 in chips)
Seat 4: PlayTheBlues4U ($6.49 in chips)
Seat 5: lj001ll ($1.44 in chips)
PlayTheBlues4U: posts small blind $0.02
lj001ll: posts big blind $0.05
*** HOLE CARDS ***
Dealt to PlayTheBlues4U [4h Jh]
CMc172: calls $0.05
UmmmYummy: folds
seags21: folds
PlayTheBlues4U: folds
lj001ll: checks
*** FLOP *** [4d Ts Kc]
lj001ll: checks
CMc172: checks
*** TURN *** [4d Ts Kc] [9h]
lj001ll: checks
CMc172: bets $0.05
lj001ll: folds
Uncalled bet ($0.05) returned to CMc172
CMc172 collected $0.11 from pot
CMc172: doesn't show hand
*** SUMMARY ***
Total pot $0.12 | Rake $0.01
Board [4d Ts Kc 9h]
Seat 1: CMc172 collected ($0.11)
Seat 2: UmmmYummy folded before Flop (didn't bet)
Seat 3: seags21 (button) folded before Flop (didn't bet)
Seat 4: PlayTheBlues4U (small blind) folded before Flop
Seat 5: lj001ll (big blind) folded on the Turn


*********** # 80 **************
PokerStars Hand #203841579959:  Hold'em No Limit ($0.05/$0.10 USD) - 2019/09/20 19:38:25 ET
Table 'Lacerta' 6-max Seat #6 is the button
Seat 1: turk1120 ($9.01 in chips)
Seat 2: PlayTheBlues4U ($9.37 in chips)
Seat 3: RNixon'sHead ($14.65 in chips)
Seat 4: EddieMoney9 ($8.13 in chips)
Seat 6: JDM0226 ($9.16 in chips)
turk1120: posts small blind $0.05
PlayTheBlues4U: posts big blind $0.10
*** HOLE CARDS ***
Dealt to PlayTheBlues4U [Kd 4h]
RNixon'sHead said, "combo draw"
RNixon'sHead: folds
EddieMoney9 said, "i had overpair"
EddieMoney9: folds
JDM0226: folds
RNixon'sHead said, "head"
RNixon'sHead said, "ahead"
turk1120: calls $0.05
PlayTheBlues4U: checks
*** FLOP *** [2h Tc 8s]
turk1120: checks
PlayTheBlues4U: checks
*** TURN *** [2h Tc 8s] [7c]
turk1120: checks
PlayTheBlues4U: checks
*** RIVER *** [2h Tc 8s 7c] [As]
EddieMoney9 said, "good bet i guess"
turk1120: checks
PlayTheBlues4U: checks
*** SHOW DOWN ***
turk1120: shows [Js 5c] (high card Ace)
PlayTheBlues4U: shows [Kd 4h] (high card Ace - King kicker)
GoodKnight1365 is disconnected
PlayTheBlues4U collected $0.19 from pot
*** SUMMARY ***
Total pot $0.20 | Rake $0.01
Board [2h Tc 8s 7c As]
Seat 1: turk1120 (small blind) showed [Js 5c] and lost with high card Ace
Seat 2: PlayTheBlues4U (big blind) showed [Kd 4h] and won ($0.19) with high card Ace
Seat 3: RNixon'sHead folded before Flop (didn't bet)
Seat 4: EddieMoney9 folded before Flop (didn't bet)
Seat 6: JDM0226 (button) folded before Flop (didn't bet)


*********** # 81 **************
PokerStars Hand #203841579905:  Hold'em No Limit ($0.02/$0.05 USD) - 2019/09/20 19:38:01 ET
Table 'Anser' 6-max Seat #2 is the button
Seat 1: CMc172 ($4.40 in chips)
Seat 2: UmmmYummy ($4.40 in chips)
Seat 3: seags21 ($5.09 in chips)
Seat 4: PlayTheBlues4U ($6.54 in chips)
Seat 5: lj001ll ($1.44 in chips)
seags21: posts small blind $0.02
PlayTheBlues4U: posts big blind $0.05
*** HOLE CARDS ***
Dealt to PlayTheBlues4U [2c 4s]
lj001ll: folds
CMc172: calls $0.05
UmmmYummy: raises $0.07 to $0.12
seags21: folds
PlayTheBlues4U: folds
CMc172: calls $0.07
*** FLOP *** [Qh 9h Jd]
CMc172: checks
UmmmYummy: bets $0.22
CMc172: calls $0.22
*** TURN *** [Qh 9h Jd] [7h]
CMc172: checks
UmmmYummy: bets $0.53
CMc172: folds
Uncalled bet ($0.53) returned to UmmmYummy
UmmmYummy collected $0.71 from pot
UmmmYummy: doesn't show hand
*** SUMMARY ***
Total pot $0.75 | Rake $0.04
Board [Qh 9h Jd 7h]
Seat 1: CMc172 folded on the Turn
Seat 2: UmmmYummy (button) collected ($0.71)
Seat 3: seags21 (small blind) folded before Flop
Seat 4: PlayTheBlues4U (big blind) folded before Flop
Seat 5: lj001ll folded before Flop (didn't bet)


*********** # 82 **************
PokerStars Hand #203841579864:  Hold'em No Limit ($0.02/$0.05 USD) - 2019/09/20 19:37:37 ET
Table 'Anser' 6-max Seat #1 is the button
Seat 1: CMc172 ($4.45 in chips)
Seat 2: UmmmYummy ($4.45 in chips)
Seat 3: seags21 ($5 in chips)
Seat 4: PlayTheBlues4U ($6.54 in chips)
Seat 5: lj001ll ($1.44 in chips)
UmmmYummy: posts small blind $0.02
seags21: posts big blind $0.05
*** HOLE CARDS ***
Dealt to PlayTheBlues4U [Td 5h]
PlayTheBlues4U: folds
lj001ll: folds
CMc172: calls $0.05
UmmmYummy: calls $0.03
seags21: checks
*** FLOP *** [6c Ad 4s]
UmmmYummy: checks
seags21: checks
CMc172: checks
*** TURN *** [6c Ad 4s] [9d]
UmmmYummy: checks
seags21: checks
CMc172: checks
*** RIVER *** [6c Ad 4s 9d] [2s]
UmmmYummy: checks
seags21: checks
CMc172: checks
*** SHOW DOWN ***
UmmmYummy: shows [Jh 8h] (high card Ace)
seags21: shows [7s 2c] (a pair of Deuces)
CMc172: mucks hand
seags21 collected $0.14 from pot
*** SUMMARY ***
Total pot $0.15 | Rake $0.01
Board [6c Ad 4s 9d 2s]
Seat 1: CMc172 (button) mucked [Jc Kh]
Seat 2: UmmmYummy (small blind) showed [Jh 8h] and lost with high card Ace
Seat 3: seags21 (big blind) showed [7s 2c] and won ($0.14) with a pair of Deuces
Seat 4: PlayTheBlues4U folded before Flop (didn't bet)
Seat 5: lj001ll folded before Flop (didn't bet)


*********** # 83 **************
PokerStars Hand #203841579783:  Hold'em No Limit ($0.02/$0.05 USD) - 2019/09/20 19:36:56 ET
Table 'Anser' 6-max Seat #5 is the button
Seat 1: CMc172 ($4.25 in chips)
Seat 2: UmmmYummy ($4.67 in chips)
Seat 3: dmakai ($5.85 in chips)
Seat 4: PlayTheBlues4U ($6.54 in chips)
Seat 5: lj001ll ($1.44 in chips)
CMc172: posts small blind $0.02
UmmmYummy: posts big blind $0.05
*** HOLE CARDS ***
Dealt to PlayTheBlues4U [8h Tc]
dmakai: folds
PlayTheBlues4U: folds
lj001ll: folds
CMc172: calls $0.03
dmakai leaves the table
UmmmYummy: checks
*** FLOP *** [Ah 6h 2s]
CMc172: checks
UmmmYummy: bets $0.06
seags21 joins the table at seat #3
CMc172: calls $0.06
*** TURN *** [Ah 6h 2s] [Jh]
CMc172: checks
UmmmYummy: bets $0.11
CMc172: calls $0.11
*** RIVER *** [Ah 6h 2s Jh] [5s]
CMc172: bets $0.25
UmmmYummy: folds
Uncalled bet ($0.25) returned to CMc172
CMc172 collected $0.42 from pot
CMc172: doesn't show hand
*** SUMMARY ***
Total pot $0.44 | Rake $0.02
Board [Ah 6h 2s Jh 5s]
Seat 1: CMc172 (small blind) collected ($0.42)
Seat 2: UmmmYummy (big blind) folded on the River
Seat 3: dmakai folded before Flop (didn't bet)
Seat 4: PlayTheBlues4U folded before Flop (didn't bet)
Seat 5: lj001ll (button) folded before Flop (didn't bet)


*********** # 84 **************
PokerStars Hand #203841579709:  Hold'em No Limit ($0.02/$0.05 USD) - 2019/09/20 19:36:17 ET
Table 'Anser' 6-max Seat #4 is the button
Seat 1: CMc172 ($3.96 in chips)
Seat 2: UmmmYummy ($4.67 in chips)
Seat 3: dmakai ($6.15 in chips)
Seat 4: PlayTheBlues4U ($6.54 in chips)
Seat 5: lj001ll ($1.46 in chips)
lj001ll: posts small blind $0.02
CMc172: posts big blind $0.05
*** HOLE CARDS ***
Dealt to PlayTheBlues4U [4d 2c]
UmmmYummy: folds
dmakai: calls $0.05
PlayTheBlues4U: folds
lj001ll: folds
CMc172: checks
*** FLOP *** [3s 4c 5d]
CMc172: checks
dmakai: checks
*** TURN *** [3s 4c 5d] [Jd]
CMc172: checks
dmakai: bets $0.10
CMc172: calls $0.10
*** RIVER *** [3s 4c 5d Jd] [Qh]
CMc172: bets $0.15
dmakai: calls $0.15
*** SHOW DOWN ***
CMc172: shows [3d Qc] (two pair, Queens and Threes)
dmakai: mucks hand
CMc172 collected $0.59 from pot
*** SUMMARY ***
Total pot $0.62 | Rake $0.03
Board [3s 4c 5d Jd Qh]
Seat 1: CMc172 (big blind) showed [3d Qc] and won ($0.59) with two pair, Queens and Threes
Seat 2: UmmmYummy folded before Flop (didn't bet)
Seat 3: dmakai mucked [9d Jc]
Seat 4: PlayTheBlues4U (button) folded before Flop (didn't bet)
Seat 5: lj001ll (small blind) folded before Flop


*********** # 85 **************
PokerStars Hand #203841579702:  Hold'em No Limit ($0.05/$0.10 USD) - 2019/09/20 19:36:12 ET
Table 'Lacerta' 6-max Seat #4 is the button
Seat 1: turk1120 ($9.01 in chips)
Seat 2: PlayTheBlues4U ($9.37 in chips)
Seat 3: RNixon'sHead ($12.80 in chips)
Seat 4: EddieMoney9 ($9.87 in chips)
Seat 5: GoodKnight1365 ($15.39 in chips)
Seat 6: JDM0226 ($9.41 in chips)
GoodKnight1365: posts small blind $0.05
JDM0226: posts big blind $0.10
*** HOLE CARDS ***
Dealt to PlayTheBlues4U [5s Jd]
turk1120: folds
PlayTheBlues4U: folds
RNixon'sHead: raises $0.15 to $0.25
EddieMoney9: calls $0.25
GoodKnight1365: folds
JDM0226: calls $0.15
*** FLOP *** [2h 7c 3c]
JDM0226: checks
RNixon'sHead: bets $0.40
EddieMoney9: raises $1.09 to $1.49
JDM0226: folds
RNixon'sHead: raises $2.88 to $4.37
EddieMoney9 said, "set?"
EddieMoney9: folds
Uncalled bet ($2.88) returned to RNixon'sHead
RNixon'sHead collected $3.59 from pot
RNixon'sHead: doesn't show hand
*** SUMMARY ***
Total pot $3.78 | Rake $0.19
Board [2h 7c 3c]
Seat 1: turk1120 folded before Flop (didn't bet)
Seat 2: PlayTheBlues4U folded before Flop (didn't bet)
Seat 3: RNixon'sHead collected ($3.59)
Seat 4: EddieMoney9 (button) folded on the Flop
Seat 5: GoodKnight1365 (small blind) folded before Flop
Seat 6: JDM0226 (big blind) folded on the Flop


*********** # 86 **************
PokerStars Hand #203841579617:  Hold'em No Limit ($0.02/$0.05 USD) - 2019/09/20 19:35:14 ET
Table 'Anser' 6-max Seat #3 is the button
Seat 1: CMc172 ($4.11 in chips)
Seat 2: UmmmYummy ($4.61 in chips)
Seat 3: dmakai ($6.15 in chips)
Seat 4: PlayTheBlues4U ($6.56 in chips)
Seat 5: lj001ll ($1.39 in chips)
PlayTheBlues4U: posts small blind $0.02
lj001ll: posts big blind $0.05
*** HOLE CARDS ***
Dealt to PlayTheBlues4U [3s Th]
CMc172: calls $0.05
UmmmYummy: calls $0.05
dmakai: folds
PlayTheBlues4U: folds
lj001ll: checks
*** FLOP *** [Jh 9h 6h]
lj001ll: checks
CMc172: checks
UmmmYummy: checks
*** TURN *** [Jh 9h 6h] [Tc]
lj001ll: bets $0.10
CMc172: calls $0.10
UmmmYummy: calls $0.10
*** RIVER *** [Jh 9h 6h Tc] [7c]
lj001ll: checks
CMc172: checks
UmmmYummy: bets $0.14
lj001ll: calls $0.14
CMc172: folds
*** SHOW DOWN ***
UmmmYummy: shows [Ah 8s] (a straight, Seven to Jack)
lj001ll: shows [2c 8c] (a straight, Seven to Jack)
lj001ll collected $0.36 from pot
UmmmYummy collected $0.35 from pot
*** SUMMARY ***
Total pot $0.75 | Rake $0.04
Board [Jh 9h 6h Tc 7c]
Seat 1: CMc172 folded on the River
Seat 2: UmmmYummy showed [Ah 8s] and won ($0.35) with a straight, Seven to Jack
Seat 3: dmakai (button) folded before Flop (didn't bet)
Seat 4: PlayTheBlues4U (small blind) folded before Flop
Seat 5: lj001ll (big blind) showed [2c 8c] and won ($0.36) with a straight, Seven to Jack


*********** # 87 **************
PokerStars Hand #203841579601:  Hold'em No Limit ($0.02/$0.05 USD) - 2019/09/20 19:35:05 ET
Table 'Anser' 6-max Seat #2 is the button
Seat 1: CMc172 ($4.11 in chips)
Seat 2: UmmmYummy ($4.61 in chips)
Seat 3: dmakai ($6.17 in chips)
Seat 4: PlayTheBlues4U ($6.54 in chips)
Seat 5: lj001ll ($1.39 in chips)
dmakai: posts small blind $0.02
PlayTheBlues4U: posts big blind $0.05
*** HOLE CARDS ***
Dealt to PlayTheBlues4U [7c Qc]
lj001ll: folds
CMc172: folds
UmmmYummy: folds
dmakai: folds
Uncalled bet ($0.03) returned to PlayTheBlues4U
PlayTheBlues4U collected $0.04 from pot
PlayTheBlues4U: doesn't show hand
*** SUMMARY ***
Total pot $0.04 | Rake $0
Seat 1: CMc172 folded before Flop (didn't bet)
Seat 2: UmmmYummy (button) folded before Flop (didn't bet)
Seat 3: dmakai (small blind) folded before Flop
Seat 4: PlayTheBlues4U (big blind) collected ($0.04)
Seat 5: lj001ll folded before Flop (didn't bet)


*********** # 88 **************
PokerStars Hand #203841579541:  Hold'em No Limit ($0.02/$0.05 USD) - 2019/09/20 19:34:36 ET
Table 'Anser' 6-max Seat #1 is the button
Seat 1: CMc172 ($4.11 in chips)
Seat 2: UmmmYummy ($4.63 in chips)
Seat 3: dmakai ($6.15 in chips)
Seat 4: PlayTheBlues4U ($6.54 in chips)
Seat 5: lj001ll ($1.39 in chips)
UmmmYummy: posts small blind $0.02
dmakai: posts big blind $0.05
*** HOLE CARDS ***
Dealt to PlayTheBlues4U [3s 9h]
PlayTheBlues4U: folds
lj001ll: folds
CMc172: folds
UmmmYummy: folds
Uncalled bet ($0.03) returned to dmakai
dmakai collected $0.04 from pot
dmakai: doesn't show hand
*** SUMMARY ***
Total pot $0.04 | Rake $0
Seat 1: CMc172 (button) folded before Flop (didn't bet)
Seat 2: UmmmYummy (small blind) folded before Flop
Seat 3: dmakai (big blind) collected ($0.04)
Seat 4: PlayTheBlues4U folded before Flop (didn't bet)
Seat 5: lj001ll folded before Flop (didn't bet)


*********** # 89 **************
PokerStars Hand #203841579535:  Hold'em No Limit ($0.05/$0.10 USD) - 2019/09/20 19:34:31 ET
Table 'Lacerta' 6-max Seat #3 is the button
Seat 1: turk1120 ($8.09 in chips)
Seat 2: PlayTheBlues4U ($9.37 in chips)
Seat 3: RNixon'sHead ($12.80 in chips)
Seat 4: EddieMoney9 ($10.17 in chips)
Seat 5: GoodKnight1365 ($16.09 in chips)
Seat 6: JDM0226 ($9.41 in chips)
EddieMoney9: posts small blind $0.05
GoodKnight1365: posts big blind $0.10
*** HOLE CARDS ***
Dealt to PlayTheBlues4U [9c 7h]
JDM0226: folds
turk1120: calls $0.10
PlayTheBlues4U: folds
RNixon'sHead: folds
EddieMoney9: raises $0.20 to $0.30
GoodKnight1365: calls $0.20
turk1120: calls $0.20
*** FLOP *** [Jd 2d Ts]
EddieMoney9: checks
GoodKnight1365: bets $0.40
turk1120: calls $0.40
EddieMoney9: folds
*** TURN *** [Jd 2d Ts] [8d]
GoodKnight1365: checks
turk1120: checks
*** RIVER *** [Jd 2d Ts 8d] [9d]
GoodKnight1365: checks
turk1120: bets $0.50
GoodKnight1365: folds
Uncalled bet ($0.50) returned to turk1120
turk1120 collected $1.62 from pot
*** SUMMARY ***
Total pot $1.70 | Rake $0.08
Board [Jd 2d Ts 8d 9d]
Seat 1: turk1120 collected ($1.62)
Seat 2: PlayTheBlues4U folded before Flop (didn't bet)
Seat 3: RNixon'sHead (button) folded before Flop (didn't bet)
Seat 4: EddieMoney9 (small blind) folded on the Flop
Seat 5: GoodKnight1365 (big blind) folded on the River
Seat 6: JDM0226 folded before Flop (didn't bet)


*********** # 90 **************
PokerStars Hand #203841579502:  Hold'em No Limit ($0.02/$0.05 USD) - 2019/09/20 19:34:12 ET
Table 'Anser' 6-max Seat #5 is the button
Seat 1: CMc172 ($4.16 in chips)
Seat 2: UmmmYummy ($4.58 in chips)
Seat 3: dmakai ($6.15 in chips)
Seat 4: PlayTheBlues4U ($6.54 in chips)
Seat 5: lj001ll ($1.39 in chips)
CMc172: posts small blind $0.02
UmmmYummy: posts big blind $0.05
*** HOLE CARDS ***
Dealt to PlayTheBlues4U [7s 8c]
dmakai: folds
PlayTheBlues4U: folds
lj001ll: folds
CMc172: calls $0.03
UmmmYummy: checks
*** FLOP *** [6d 4c 9d]
CMc172: checks
UmmmYummy: checks
*** TURN *** [6d 4c 9d] [3d]
CMc172: checks
UmmmYummy: bets $0.08
CMc172: folds
Uncalled bet ($0.08) returned to UmmmYummy
UmmmYummy collected $0.10 from pot
UmmmYummy: doesn't show hand
*** SUMMARY ***
Total pot $0.10 | Rake $0
Board [6d 4c 9d 3d]
Seat 1: CMc172 (small blind) folded on the Turn
Seat 2: UmmmYummy (big blind) collected ($0.10)
Seat 3: dmakai folded before Flop (didn't bet)
Seat 4: PlayTheBlues4U folded before Flop (didn't bet)
Seat 5: lj001ll (button) folded before Flop (didn't bet)


*********** # 91 **************
PokerStars Hand #203841579459:  Hold'em No Limit ($0.05/$0.10 USD) - 2019/09/20 19:33:52 ET
Table 'Lacerta' 6-max Seat #2 is the button
Seat 1: turk1120 ($8.39 in chips)
Seat 2: PlayTheBlues4U ($9.37 in chips)
Seat 3: RNixon'sHead ($12.85 in chips)
Seat 4: EddieMoney9 ($9.85 in chips)
Seat 5: GoodKnight1365 ($16.09 in chips)
Seat 6: JDM0226 ($9.41 in chips)
RNixon'sHead: posts small blind $0.05
EddieMoney9: posts big blind $0.10
*** HOLE CARDS ***
Dealt to PlayTheBlues4U [Qd 5h]
GoodKnight1365: folds
JDM0226: folds
turk1120: calls $0.10
PlayTheBlues4U: folds
RNixon'sHead: folds
EddieMoney9: raises $0.20 to $0.30
turk1120: calls $0.20
*** FLOP *** [Kh 8h Ac]
EddieMoney9: bets $0.40
turk1120: folds
Uncalled bet ($0.40) returned to EddieMoney9
EddieMoney9 collected $0.62 from pot
EddieMoney9: doesn't show hand
*** SUMMARY ***
Total pot $0.65 | Rake $0.03
Board [Kh 8h Ac]
Seat 1: turk1120 folded on the Flop
Seat 2: PlayTheBlues4U (button) folded before Flop (didn't bet)
Seat 3: RNixon'sHead (small blind) folded before Flop
Seat 4: EddieMoney9 (big blind) collected ($0.62)
Seat 5: GoodKnight1365 folded before Flop (didn't bet)
Seat 6: JDM0226 folded before Flop (didn't bet)


*********** # 92 **************
PokerStars Hand #203841579447:  Hold'em No Limit ($0.02/$0.05 USD) - 2019/09/20 19:33:44 ET
Table 'Anser' 6-max Seat #4 is the button
Seat 1: CMc172 ($4.21 in chips)
Seat 2: UmmmYummy ($4.42 in chips)
Seat 3: dmakai ($6.20 in chips)
Seat 4: PlayTheBlues4U ($6.54 in chips)
Seat 5: lj001ll ($1.41 in chips)
Seat 6: DemolishIT ($6.91 in chips)
lj001ll: posts small blind $0.02
DemolishIT: posts big blind $0.05
*** HOLE CARDS ***
Dealt to PlayTheBlues4U [3s 2d]
CMc172: calls $0.05
UmmmYummy: calls $0.05
dmakai: calls $0.05
PlayTheBlues4U: folds
lj001ll: folds
DemolishIT: checks
*** FLOP *** [9s 8h 5c]
DemolishIT: checks
CMc172: checks
UmmmYummy: bets $0.16
dmakai: folds
DemolishIT: folds
CMc172: folds
Uncalled bet ($0.16) returned to UmmmYummy
UmmmYummy collected $0.21 from pot
UmmmYummy: doesn't show hand
*** SUMMARY ***
Total pot $0.22 | Rake $0.01
Board [9s 8h 5c]
Seat 1: CMc172 folded on the Flop
Seat 2: UmmmYummy collected ($0.21)
Seat 3: dmakai folded on the Flop
Seat 4: PlayTheBlues4U (button) folded before Flop (didn't bet)
Seat 5: lj001ll (small blind) folded before Flop
Seat 6: DemolishIT (big blind) folded on the Flop


*********** # 93 **************
PokerStars Hand #203841579421:  Hold'em No Limit ($0.05/$0.10 USD) - 2019/09/20 19:33:31 ET
Table 'Lacerta' 6-max Seat #1 is the button
Seat 1: turk1120 ($8.39 in chips)
Seat 2: PlayTheBlues4U ($9.42 in chips)
Seat 3: RNixon'sHead ($12.95 in chips)
Seat 4: EddieMoney9 ($9.85 in chips)
Seat 5: GoodKnight1365 ($15.94 in chips)
Seat 6: JDM0226 ($9.41 in chips)
PlayTheBlues4U: posts small blind $0.05
RNixon'sHead: posts big blind $0.10
*** HOLE CARDS ***
Dealt to PlayTheBlues4U [Qd 7h]
EddieMoney9: folds
GoodKnight1365: raises $0.10 to $0.20
JDM0226: folds
turk1120: folds
PlayTheBlues4U: folds
RNixon'sHead: folds
Uncalled bet ($0.10) returned to GoodKnight1365
GoodKnight1365 collected $0.25 from pot
GoodKnight1365: doesn't show hand
*** SUMMARY ***
Total pot $0.25 | Rake $0
Seat 1: turk1120 (button) folded before Flop (didn't bet)
Seat 2: PlayTheBlues4U (small blind) folded before Flop
Seat 3: RNixon'sHead (big blind) folded before Flop
Seat 4: EddieMoney9 folded before Flop (didn't bet)
Seat 5: GoodKnight1365 collected ($0.25)
Seat 6: JDM0226 folded before Flop (didn't bet)


*********** # 94 **************
PokerStars Hand #203841579372:  Hold'em No Limit ($0.02/$0.05 USD) - 2019/09/20 19:33:08 ET
Table 'Anser' 6-max Seat #3 is the button
Seat 1: CMc172 ($4.21 in chips)
Seat 2: UmmmYummy ($4.42 in chips)
Seat 3: dmakai ($6.20 in chips)
Seat 4: PlayTheBlues4U ($6.31 in chips)
Seat 5: lj001ll ($1.46 in chips)
Seat 6: DemolishIT ($7.11 in chips)
PlayTheBlues4U: posts small blind $0.02
lj001ll: posts big blind $0.05
*** HOLE CARDS ***
Dealt to PlayTheBlues4U [6h 7h]
DemolishIT: raises $0.15 to $0.20
CMc172: folds
UmmmYummy: folds
dmakai: folds
PlayTheBlues4U: calls $0.18
lj001ll: folds
*** FLOP *** [Tc Ks Qh]
PlayTheBlues4U: checks
DemolishIT: checks
*** TURN *** [Tc Ks Qh] [4c]
PlayTheBlues4U: checks
DemolishIT: checks
*** RIVER *** [Tc Ks Qh 4c] [7s]
PlayTheBlues4U: checks
DemolishIT: checks
*** SHOW DOWN ***
PlayTheBlues4U: shows [6h 7h] (a pair of Sevens)
DemolishIT: mucks hand
PlayTheBlues4U collected $0.43 from pot
*** SUMMARY ***
Total pot $0.45 | Rake $0.02
Board [Tc Ks Qh 4c 7s]
Seat 1: CMc172 folded before Flop (didn't bet)
Seat 2: UmmmYummy folded before Flop (didn't bet)
Seat 3: dmakai (button) folded before Flop (didn't bet)
Seat 4: PlayTheBlues4U (small blind) showed [6h 7h] and won ($0.43) with a pair of Sevens
Seat 5: lj001ll (big blind) folded before Flop
Seat 6: DemolishIT mucked [3s As]


*********** # 95 **************
PokerStars Hand #203841579342:  Hold'em No Limit ($0.05/$0.10 USD) - 2019/09/20 19:32:55 ET
Table 'Lacerta' 6-max Seat #6 is the button
Seat 1: turk1120 ($7.98 in chips)
Seat 2: PlayTheBlues4U ($9.52 in chips)
Seat 3: RNixon'sHead ($13.30 in chips)
Seat 4: EddieMoney9 ($9.85 in chips)
Seat 5: GoodKnight1365 ($15.94 in chips)
Seat 6: JDM0226 ($9.41 in chips)
turk1120: posts small blind $0.05
PlayTheBlues4U: posts big blind $0.10
*** HOLE CARDS ***
Dealt to PlayTheBlues4U [Kh 9d]
RNixon'sHead: raises $0.15 to $0.25
EddieMoney9: folds
GoodKnight1365: folds
JDM0226: folds
turk1120: calls $0.20
PlayTheBlues4U: folds
*** FLOP *** [8d 6c 2d]
turk1120: bets $0.10
RNixon'sHead: calls $0.10
*** TURN *** [8d 6c 2d] [7s]
turk1120: bets $0.10
RNixon'sHead: folds
Uncalled bet ($0.10) returned to turk1120
turk1120 collected $0.76 from pot
*** SUMMARY ***
Total pot $0.80 | Rake $0.04
Board [8d 6c 2d 7s]
Seat 1: turk1120 (small blind) collected ($0.76)
Seat 2: PlayTheBlues4U (big blind) folded before Flop
Seat 3: RNixon'sHead folded on the Turn
Seat 4: EddieMoney9 folded before Flop (didn't bet)
Seat 5: GoodKnight1365 folded before Flop (didn't bet)
Seat 6: JDM0226 (button) folded before Flop (didn't bet)


*********** # 96 **************
PokerStars Hand #203841579264:  Hold'em No Limit ($0.05/$0.10 USD) - 2019/09/20 19:32:22 ET
Table 'Lacerta' 6-max Seat #5 is the button
Seat 1: turk1120 ($7.57 in chips)
Seat 2: PlayTheBlues4U ($9.52 in chips)
Seat 3: RNixon'sHead ($13.30 in chips)
Seat 4: EddieMoney9 ($9.85 in chips)
Seat 5: GoodKnight1365 ($16.34 in chips)
Seat 6: JDM0226 ($9.46 in chips)
JDM0226: posts small blind $0.05
turk1120: posts big blind $0.10
*** HOLE CARDS ***
Dealt to PlayTheBlues4U [8s Jd]
PlayTheBlues4U: folds
RNixon'sHead: folds
EddieMoney9: folds
GoodKnight1365: raises $0.10 to $0.20
JDM0226: folds
turk1120: calls $0.10
*** FLOP *** [2c 9d 3s]
turk1120: bets $0.10
GoodKnight1365: calls $0.10
*** TURN *** [2c 9d 3s] [Qd]
turk1120: bets $0.10
GoodKnight1365: calls $0.10
*** RIVER *** [2c 9d 3s Qd] [Jh]
turk1120: bets $0.20
GoodKnight1365: folds
Uncalled bet ($0.20) returned to turk1120
turk1120 collected $0.81 from pot
*** SUMMARY ***
Total pot $0.85 | Rake $0.04
Board [2c 9d 3s Qd Jh]
Seat 1: turk1120 (big blind) collected ($0.81)
Seat 2: PlayTheBlues4U folded before Flop (didn't bet)
Seat 3: RNixon'sHead folded before Flop (didn't bet)
Seat 4: EddieMoney9 folded before Flop (didn't bet)
Seat 5: GoodKnight1365 (button) folded on the River
Seat 6: JDM0226 (small blind) folded before Flop


*********** # 97 **************
PokerStars Hand #203841579241:  Hold'em No Limit ($0.02/$0.05 USD) - 2019/09/20 19:32:11 ET
Table 'Anser' 6-max Seat #2 is the button
Seat 1: CMc172 ($3.96 in chips)
Seat 2: UmmmYummy ($4.62 in chips)
Seat 3: dmakai ($6.22 in chips)
Seat 4: PlayTheBlues4U ($6.36 in chips)
Seat 6: DemolishIT ($7.11 in chips)
dmakai: posts small blind $0.02
PlayTheBlues4U: posts big blind $0.05
*** HOLE CARDS ***
Dealt to PlayTheBlues4U [3h 2h]
DemolishIT: folds
CMc172: calls $0.05
UmmmYummy: calls $0.05
dmakai: folds
PlayTheBlues4U: checks
*** FLOP *** [Kd Qc Ah]
PlayTheBlues4U: checks
CMc172: checks
UmmmYummy: checks
*** TURN *** [Kd Qc Ah] [7s]
PlayTheBlues4U: checks
CMc172: bets $0.10
UmmmYummy: calls $0.10
PlayTheBlues4U: folds
*** RIVER *** [Kd Qc Ah 7s] [4c]
CMc172: bets $0.05
UmmmYummy: calls $0.05
*** SHOW DOWN ***
CMc172: shows [Tc Qh] (a pair of Queens)
UmmmYummy: mucks hand
CMc172 collected $0.45 from pot
*** SUMMARY ***
Total pot $0.47 | Rake $0.02
Board [Kd Qc Ah 7s 4c]
Seat 1: CMc172 showed [Tc Qh] and won ($0.45) with a pair of Queens
Seat 2: UmmmYummy (button) mucked [7h 5h]
Seat 3: dmakai (small blind) folded before Flop
Seat 4: PlayTheBlues4U (big blind) folded on the Turn
Seat 6: DemolishIT folded before Flop (didn't bet)


*********** # 98 **************
PokerStars Hand #203841579203:  Hold'em No Limit ($0.05/$0.10 USD) - 2019/09/20 19:31:56 ET
Table 'Lacerta' 6-max Seat #4 is the button
Seat 1: turk1120 ($7.39 in chips)
Seat 2: PlayTheBlues4U ($9.52 in chips)
Seat 3: RNixon'sHead ($13.30 in chips)
Seat 4: EddieMoney9 ($9.85 in chips)
Seat 5: GoodKnight1365 ($16.44 in chips)
Seat 6: JDM0226 ($9.56 in chips)
GoodKnight1365: posts small blind $0.05
JDM0226: posts big blind $0.10
*** HOLE CARDS ***
Dealt to PlayTheBlues4U [6c Ts]
turk1120: calls $0.10
PlayTheBlues4U: folds
RNixon'sHead: folds
EddieMoney9: folds
GoodKnight1365: calls $0.05
JDM0226: checks
*** FLOP *** [5s 2d 2h]
GoodKnight1365: checks
JDM0226: checks
turk1120: bets $0.20
GoodKnight1365: folds
JDM0226: folds
Uncalled bet ($0.20) returned to turk1120
turk1120 collected $0.28 from pot
*** SUMMARY ***
Total pot $0.30 | Rake $0.02
Board [5s 2d 2h]
Seat 1: turk1120 collected ($0.28)
Seat 2: PlayTheBlues4U folded before Flop (didn't bet)
Seat 3: RNixon'sHead folded before Flop (didn't bet)
Seat 4: EddieMoney9 (button) folded before Flop (didn't bet)
Seat 5: GoodKnight1365 (small blind) folded on the Flop
Seat 6: JDM0226 (big blind) folded on the Flop


*********** # 99 **************
PokerStars Hand #203841579199:  Hold'em No Limit ($0.02/$0.05 USD) - 2019/09/20 19:31:54 ET
Table 'Anser' 6-max Seat #1 is the button
Seat 1: CMc172 ($4.01 in chips)
Seat 2: UmmmYummy ($4.53 in chips)
Seat 3: dmakai ($6.27 in chips)
Seat 4: PlayTheBlues4U ($6.36 in chips)
Seat 6: DemolishIT ($7.11 in chips)
UmmmYummy: posts small blind $0.02
dmakai: posts big blind $0.05
*** HOLE CARDS ***
Dealt to PlayTheBlues4U [4c Qh]
PlayTheBlues4U: folds
DemolishIT: folds
CMc172: calls $0.05
UmmmYummy: calls $0.03
dmakai: checks
*** FLOP *** [Qs As 8s]
UmmmYummy: bets $0.11
dmakai: folds
CMc172: folds
Uncalled bet ($0.11) returned to UmmmYummy
UmmmYummy collected $0.14 from pot
UmmmYummy: doesn't show hand
*** SUMMARY ***
Total pot $0.15 | Rake $0.01
Board [Qs As 8s]
Seat 1: CMc172 (button) folded on the Flop
Seat 2: UmmmYummy (small blind) collected ($0.14)
Seat 3: dmakai (big blind) folded on the Flop
Seat 4: PlayTheBlues4U folded before Flop (didn't bet)
Seat 6: DemolishIT folded before Flop (didn't bet)


*********** # 100 **************
PokerStars Hand #203841579122:  Hold'em No Limit ($0.05/$0.10 USD) - 2019/09/20 19:31:16 ET
Table 'Lacerta' 6-max Seat #3 is the button
Seat 1: turk1120 ($7.49 in chips)
Seat 2: PlayTheBlues4U ($9.82 in chips)
Seat 3: RNixon'sHead ($12.75 in chips)
Seat 4: EddieMoney9 ($9.90 in chips)
Seat 5: GoodKnight1365 ($16.54 in chips)
Seat 6: JDM0226 ($9.56 in chips)
EddieMoney9: posts small blind $0.05
GoodKnight1365: posts big blind $0.10
*** HOLE CARDS ***
Dealt to PlayTheBlues4U [Ah 9s]
JDM0226: folds
turk1120: calls $0.10
PlayTheBlues4U: raises $0.20 to $0.30
RNixon'sHead: raises $0.85 to $1.15
EddieMoney9: folds
GoodKnight1365: folds
turk1120: folds
PlayTheBlues4U: folds
Uncalled bet ($0.85) returned to RNixon'sHead
RNixon'sHead collected $0.85 from pot
RNixon'sHead: doesn't show hand
*** SUMMARY ***
Total pot $0.85 | Rake $0
Seat 1: turk1120 folded before Flop
Seat 2: PlayTheBlues4U folded before Flop
Seat 3: RNixon'sHead (button) collected ($0.85)
Seat 4: EddieMoney9 (small blind) folded before Flop
Seat 5: GoodKnight1365 (big blind) folded before Flop
Seat 6: JDM0226 folded before Flop (didn't bet)


*********** # 101 **************
PokerStars Hand #203841579074:  Hold'em No Limit ($0.02/$0.05 USD) - 2019/09/20 19:30:54 ET
Table 'Anser' 6-max Seat #6 is the button
Seat 1: CMc172 ($3.73 in chips)
Seat 2: UmmmYummy ($4.63 in chips)
Seat 3: dmakai ($6.27 in chips)
Seat 4: PlayTheBlues4U ($6.36 in chips)
Seat 5: lj001ll ($1.56 in chips)
Seat 6: DemolishIT ($7.21 in chips)
CMc172: posts small blind $0.02
UmmmYummy: posts big blind $0.05
*** HOLE CARDS ***
Dealt to PlayTheBlues4U [5h Qh]
dmakai: folds
PlayTheBlues4U: folds
lj001ll: raises $0.05 to $0.10
DemolishIT: calls $0.10
CMc172: calls $0.08
UmmmYummy: calls $0.05
*** FLOP *** [3c Th 2d]
CMc172: checks
UmmmYummy: checks
lj001ll: checks
DemolishIT: checks
*** TURN *** [3c Th 2d] [6d]
CMc172: bets $0.10
UmmmYummy: folds
lj001ll: folds
DemolishIT: folds
Uncalled bet ($0.10) returned to CMc172
CMc172 collected $0.38 from pot
CMc172: doesn't show hand
*** SUMMARY ***
Total pot $0.40 | Rake $0.02
Board [3c Th 2d 6d]
Seat 1: CMc172 (small blind) collected ($0.38)
Seat 2: UmmmYummy (big blind) folded on the Turn
Seat 3: dmakai folded before Flop (didn't bet)
Seat 4: PlayTheBlues4U folded before Flop (didn't bet)
Seat 5: lj001ll folded on the Turn
Seat 6: DemolishIT (button) folded on the Turn


*********** # 102 **************
PokerStars Hand #203841579003:  Hold'em No Limit ($0.02/$0.05 USD) - 2019/09/20 19:30:18 ET
Table 'Anser' 6-max Seat #5 is the button
Seat 1: CMc172 ($3.78 in chips)
Seat 2: UmmmYummy ($4.63 in chips)
Seat 3: dmakai ($6.32 in chips)
Seat 4: PlayTheBlues4U ($6.36 in chips)
Seat 5: lj001ll ($1.45 in chips)
Seat 6: DemolishIT ($7.23 in chips)
DemolishIT: posts small blind $0.02
CMc172: posts big blind $0.05
*** HOLE CARDS ***
Dealt to PlayTheBlues4U [Js 3c]
UmmmYummy: folds
dmakai: calls $0.05
PlayTheBlues4U: folds
lj001ll: calls $0.05
DemolishIT: folds
CMc172: checks
*** FLOP *** [Ks 9s Kd]
CMc172: checks
dmakai: checks
lj001ll: checks
*** TURN *** [Ks 9s Kd] [2h]
CMc172: checks
dmakai: checks
lj001ll: checks
*** RIVER *** [Ks 9s Kd 2h] [3s]
CMc172: checks
dmakai: checks
lj001ll: bets $0.05
CMc172: folds
dmakai: folds
Uncalled bet ($0.05) returned to lj001ll
lj001ll collected $0.16 from pot
lj001ll: doesn't show hand
*** SUMMARY ***
Total pot $0.17 | Rake $0.01
Board [Ks 9s Kd 2h 3s]
Seat 1: CMc172 (big blind) folded on the River
Seat 2: UmmmYummy folded before Flop (didn't bet)
Seat 3: dmakai folded on the River
Seat 4: PlayTheBlues4U folded before Flop (didn't bet)
Seat 5: lj001ll (button) collected ($0.16)
Seat 6: DemolishIT (small blind) folded before Flop


*********** # 103 **************
PokerStars Hand #203841578987:  Hold'em No Limit ($0.05/$0.10 USD) - 2019/09/20 19:30:11 ET
Table 'Lacerta' 6-max Seat #2 is the button
Seat 1: turk1120 ($7.08 in chips)
Seat 2: PlayTheBlues4U ($10.12 in chips)
Seat 3: RNixon'sHead ($12.80 in chips)
Seat 4: EddieMoney9 ($10 in chips)
Seat 5: GoodKnight1365 ($16.54 in chips)
Seat 6: JDM0226 ($9.56 in chips)
RNixon'sHead: posts small blind $0.05
EddieMoney9: posts big blind $0.10
*** HOLE CARDS ***
Dealt to PlayTheBlues4U [9h Ts]
GoodKnight1365: folds
JDM0226: folds
turk1120: calls $0.10
PlayTheBlues4U: calls $0.10
RNixon'sHead: folds
EddieMoney9: checks
*** FLOP *** [7s 3d 7c]
EddieMoney9: checks
turk1120: bets $0.20
PlayTheBlues4U: calls $0.20
EddieMoney9: folds
*** TURN *** [7s 3d 7c] [6s]
turk1120: checks
PlayTheBlues4U: checks
*** RIVER *** [7s 3d 7c 6s] [5d]
turk1120: bets $0.10
PlayTheBlues4U: folds
Uncalled bet ($0.10) returned to turk1120
turk1120 collected $0.71 from pot
*** SUMMARY ***
Total pot $0.75 | Rake $0.04
Board [7s 3d 7c 6s 5d]
Seat 1: turk1120 collected ($0.71)
Seat 2: PlayTheBlues4U (button) folded on the River
Seat 3: RNixon'sHead (small blind) folded before Flop
Seat 4: EddieMoney9 (big blind) folded on the Flop
Seat 5: GoodKnight1365 folded before Flop (didn't bet)
Seat 6: JDM0226 folded before Flop (didn't bet)


*********** # 104 **************
PokerStars Hand #203841578917:  Hold'em No Limit ($0.02/$0.05 USD) - 2019/09/20 19:29:36 ET
Table 'Anser' 6-max Seat #4 is the button
Seat 1: CMc172 ($3.83 in chips)
Seat 2: UmmmYummy ($4.63 in chips)
Seat 3: dmakai ($6.37 in chips)
Seat 4: PlayTheBlues4U ($6.36 in chips)
Seat 5: lj001ll ($1.47 in chips)
Seat 6: DemolishIT ($7.12 in chips)
lj001ll: posts small blind $0.02
DemolishIT: posts big blind $0.05
*** HOLE CARDS ***
Dealt to PlayTheBlues4U [Qc 4d]
CMc172: calls $0.05
UmmmYummy: folds
dmakai: calls $0.05
PlayTheBlues4U: folds
lj001ll: folds
DemolishIT: checks
*** FLOP *** [9s 9h Qs]
DemolishIT: checks
CMc172: checks
dmakai: checks
*** TURN *** [9s 9h Qs] [Ah]
DemolishIT: bets $0.16
CMc172 is disconnected
CMc172 is connected
CMc172: folds
dmakai: folds
Uncalled bet ($0.16) returned to DemolishIT
DemolishIT collected $0.16 from pot
DemolishIT: doesn't show hand
*** SUMMARY ***
Total pot $0.17 | Rake $0.01
Board [9s 9h Qs Ah]
Seat 1: CMc172 folded on the Turn
Seat 2: UmmmYummy folded before Flop (didn't bet)
Seat 3: dmakai folded on the Turn
Seat 4: PlayTheBlues4U (button) folded before Flop (didn't bet)
Seat 5: lj001ll (small blind) folded before Flop
Seat 6: DemolishIT (big blind) collected ($0.16)


*********** # 105 **************
PokerStars Hand #203841578858:  Hold'em No Limit ($0.02/$0.05 USD) - 2019/09/20 19:29:07 ET
Table 'Anser' 6-max Seat #3 is the button
Seat 1: CMc172 ($3.93 in chips)
Seat 2: UmmmYummy ($4.63 in chips)
Seat 3: dmakai ($6.17 in chips)
Seat 4: PlayTheBlues4U ($6.38 in chips)
Seat 5: lj001ll ($1.57 in chips)
Seat 6: DemolishIT ($7.12 in chips)
PlayTheBlues4U: posts small blind $0.02
lj001ll: posts big blind $0.05
*** HOLE CARDS ***
Dealt to PlayTheBlues4U [9d 2s]
DemolishIT: folds
CMc172: calls $0.05
UmmmYummy: folds
dmakai: raises $0.05 to $0.10
PlayTheBlues4U: folds
lj001ll: calls $0.05
CMc172: calls $0.05
*** FLOP *** [8c 7s Qs]
lj001ll: checks
CMc172: checks
dmakai: bets $0.30
lj001ll: folds
CMc172: folds
Uncalled bet ($0.30) returned to dmakai
dmakai collected $0.30 from pot
dmakai: doesn't show hand
*** SUMMARY ***
Total pot $0.32 | Rake $0.02
Board [8c 7s Qs]
Seat 1: CMc172 folded on the Flop
Seat 2: UmmmYummy folded before Flop (didn't bet)
Seat 3: dmakai (button) collected ($0.30)
Seat 4: PlayTheBlues4U (small blind) folded before Flop
Seat 5: lj001ll (big blind) folded on the Flop
Seat 6: DemolishIT folded before Flop (didn't bet)


*********** # 106 **************
PokerStars Hand #203841578836:  Hold'em No Limit ($0.05/$0.10 USD) - 2019/09/20 19:29:00 ET
Table 'Lacerta' 6-max Seat #1 is the button
Seat 1: turk1120 ($7.78 in chips)
Seat 2: PlayTheBlues4U ($9.40 in chips)
Seat 3: RNixon'sHead ($12.90 in chips)
Seat 5: GoodKnight1365 ($16.54 in chips)
Seat 6: JDM0226 ($9.56 in chips)
PlayTheBlues4U: posts small blind $0.05
RNixon'sHead: posts big blind $0.10
EddieMoney9: sits out
*** HOLE CARDS ***
Dealt to PlayTheBlues4U [8c 6d]
GoodKnight1365: folds
JDM0226: folds
turk1120: calls $0.10
PlayTheBlues4U: calls $0.05
RNixon'sHead: checks
*** FLOP *** [Jc 6s 4s]
PlayTheBlues4U: checks
RNixon'sHead: checks
turk1120: bets $0.10
PlayTheBlues4U: calls $0.10
RNixon'sHead: folds
*** TURN *** [Jc 6s 4s] [2h]
PlayTheBlues4U: checks
turk1120: bets $0.10
PlayTheBlues4U: calls $0.10
*** RIVER *** [Jc 6s 4s 2h] [8h]
PlayTheBlues4U: checks
turk1120: bets $0.10
PlayTheBlues4U: raises $0.30 to $0.40
turk1120: calls $0.30
*** SHOW DOWN ***
PlayTheBlues4U: shows [8c 6d] (two pair, Eights and Sixes)
turk1120: mucks hand
PlayTheBlues4U collected $1.42 from pot
*** SUMMARY ***
Total pot $1.50 | Rake $0.08
Board [Jc 6s 4s 2h 8h]
Seat 1: turk1120 (button) mucked [7s Jd]
Seat 2: PlayTheBlues4U (small blind) showed [8c 6d] and won ($1.42) with two pair, Eights and Sixes
Seat 3: RNixon'sHead (big blind) folded on the Flop
Seat 5: GoodKnight1365 folded before Flop (didn't bet)
Seat 6: JDM0226 folded before Flop (didn't bet)


*********** # 107 **************
PokerStars Hand #203841578785:  Hold'em No Limit ($0.02/$0.05 USD) - 2019/09/20 19:28:34 ET
Table 'Anser' 6-max Seat #2 is the button
Seat 1: CMc172 ($3.93 in chips)
Seat 2: UmmmYummy ($4.16 in chips)
Seat 3: dmakai ($6.19 in chips)
Seat 4: PlayTheBlues4U ($6.43 in chips)
Seat 5: lj001ll ($1.57 in chips)
Seat 6: DemolishIT ($7.52 in chips)
dmakai: posts small blind $0.02
PlayTheBlues4U: posts big blind $0.05
*** HOLE CARDS ***
Dealt to PlayTheBlues4U [2s Tc]
lj001ll: folds
DemolishIT: raises $0.35 to $0.40
CMc172: folds
UmmmYummy: raises $3.76 to $4.16 and is all-in
dmakai: folds
PlayTheBlues4U: folds
DemolishIT: folds
Uncalled bet ($3.76) returned to UmmmYummy
UmmmYummy collected $0.87 from pot
UmmmYummy: doesn't show hand
*** SUMMARY ***
Total pot $0.87 | Rake $0
Seat 1: CMc172 folded before Flop (didn't bet)
Seat 2: UmmmYummy (button) collected ($0.87)
Seat 3: dmakai (small blind) folded before Flop
Seat 4: PlayTheBlues4U (big blind) folded before Flop
Seat 5: lj001ll folded before Flop (didn't bet)
Seat 6: DemolishIT folded before Flop


*********** # 108 **************
PokerStars Hand #203841578759:  Hold'em No Limit ($0.05/$0.10 USD) - 2019/09/20 19:28:22 ET
Table 'Lacerta' 6-max Seat #6 is the button
Seat 1: turk1120 ($7.98 in chips)
Seat 2: PlayTheBlues4U ($9.22 in chips)
Seat 3: RNixon'sHead ($12.90 in chips)
Seat 4: Pergy21 ($1.06 in chips)
Seat 5: GoodKnight1365 ($16.54 in chips)
Seat 6: JDM0226 ($9.56 in chips)
turk1120: posts small blind $0.05
PlayTheBlues4U: posts big blind $0.10
*** HOLE CARDS ***
Dealt to PlayTheBlues4U [8s 7s]
RNixon'sHead: folds
Pergy21: folds
Pergy21 leaves the table
GoodKnight1365: folds
JDM0226: folds
PlayTheBlues4U said, "he is right!"
turk1120: calls $0.05
EddieMoney9 joins the table at seat #4
PlayTheBlues4U: checks
*** FLOP *** [Jc 4c 8c]
turk1120: checks
PlayTheBlues4U: checks
*** TURN *** [Jc 4c 8c] [Js]
turk1120: checks
PlayTheBlues4U: bets $0.10
turk1120: calls $0.10
*** RIVER *** [Jc 4c 8c Js] [7h]
turk1120: checks
PlayTheBlues4U: checks
*** SHOW DOWN ***
turk1120: shows [Qd Kh] (a pair of Jacks)
PlayTheBlues4U: shows [8s 7s] (two pair, Jacks and Eights)
PlayTheBlues4U collected $0.38 from pot
*** SUMMARY ***
Total pot $0.40 | Rake $0.02
Board [Jc 4c 8c Js 7h]
Seat 1: turk1120 (small blind) showed [Qd Kh] and lost with a pair of Jacks
Seat 2: PlayTheBlues4U (big blind) showed [8s 7s] and won ($0.38) with two pair, Jacks and Eights
Seat 3: RNixon'sHead folded before Flop (didn't bet)
Seat 4: Pergy21 folded before Flop (didn't bet)
Seat 5: GoodKnight1365 folded before Flop (didn't bet)
Seat 6: JDM0226 (button) folded before Flop (didn't bet)


*********** # 109 **************
PokerStars Hand #203841578733:  Hold'em No Limit ($0.02/$0.05 USD) - 2019/09/20 19:28:08 ET
Table 'Anser' 6-max Seat #1 is the button
Seat 1: CMc172 ($3.98 in chips)
Seat 2: UmmmYummy ($4.18 in chips)
Seat 3: dmakai ($6.13 in chips)
Seat 4: PlayTheBlues4U ($6.43 in chips)
Seat 5: lj001ll ($1.57 in chips)
Seat 6: DemolishIT ($7.52 in chips)
UmmmYummy: posts small blind $0.02
dmakai: posts big blind $0.05
*** HOLE CARDS ***
Dealt to PlayTheBlues4U [Js Tc]
PlayTheBlues4U: folds
lj001ll: folds
DemolishIT: folds
CMc172: calls $0.05
UmmmYummy: folds
dmakai: checks
*** FLOP *** [9c 4c 8h]
dmakai: checks
CMc172: checks
*** TURN *** [9c 4c 8h] [6s]
dmakai: bets $0.05
CMc172: folds
Uncalled bet ($0.05) returned to dmakai
dmakai collected $0.11 from pot
dmakai: doesn't show hand
*** SUMMARY ***
Total pot $0.12 | Rake $0.01
Board [9c 4c 8h 6s]
Seat 1: CMc172 (button) folded on the Turn
Seat 2: UmmmYummy (small blind) folded before Flop
Seat 3: dmakai (big blind) collected ($0.11)
Seat 4: PlayTheBlues4U folded before Flop (didn't bet)
Seat 5: lj001ll folded before Flop (didn't bet)
Seat 6: DemolishIT folded before Flop (didn't bet)


*********** # 110 **************
PokerStars Hand #203841578650:  Hold'em No Limit ($0.02/$0.05 USD) - 2019/09/20 19:27:29 ET
Table 'Anser' 6-max Seat #6 is the button
Seat 1: CMc172 ($4.08 in chips)
Seat 2: UmmmYummy ($4 in chips)
Seat 3: dmakai ($6.13 in chips)
Seat 4: PlayTheBlues4U ($6.43 in chips)
Seat 5: lj001ll ($1.67 in chips)
Seat 6: DemolishIT ($7.52 in chips)
CMc172: posts small blind $0.02
UmmmYummy: posts big blind $0.05
*** HOLE CARDS ***
Dealt to PlayTheBlues4U [Qh 4c]
dmakai: folds
PlayTheBlues4U: folds
lj001ll: raises $0.05 to $0.10
DemolishIT: folds
CMc172: calls $0.08
UmmmYummy: calls $0.05
*** FLOP *** [7s 3d 8h]
CMc172: checks
UmmmYummy: checks
lj001ll: checks
*** TURN *** [7s 3d 8h] [Th]
CMc172: checks
UmmmYummy: checks
lj001ll: checks
*** RIVER *** [7s 3d 8h Th] [2c]
CMc172: checks
UmmmYummy: checks
lj001ll: checks
*** SHOW DOWN ***
CMc172: shows [5h 6s] (high card Ten)
UmmmYummy: shows [2h Kc] (a pair of Deuces)
lj001ll: mucks hand
UmmmYummy collected $0.28 from pot
*** SUMMARY ***
Total pot $0.30 | Rake $0.02
Board [7s 3d 8h Th 2c]
Seat 1: CMc172 (small blind) showed [5h 6s] and lost with high card Ten
Seat 2: UmmmYummy (big blind) showed [2h Kc] and won ($0.28) with a pair of Deuces
Seat 3: dmakai folded before Flop (didn't bet)
Seat 4: PlayTheBlues4U folded before Flop (didn't bet)
Seat 5: lj001ll mucked [Qd Ah]
Seat 6: DemolishIT (button) folded before Flop (didn't bet)


*********** # 111 **************
PokerStars Hand #203841578583:  Hold'em No Limit ($0.02/$0.05 USD) - 2019/09/20 19:26:49 ET
Table 'Anser' 6-max Seat #5 is the button
Seat 1: CMc172 ($4.23 in chips)
Seat 3: dmakai ($6.28 in chips)
Seat 4: PlayTheBlues4U ($6.43 in chips)
Seat 5: lj001ll ($1.37 in chips)
Seat 6: DemolishIT ($7.54 in chips)
DemolishIT: posts small blind $0.02
CMc172: posts big blind $0.05
UmmmYummy: sits out
*** HOLE CARDS ***
Dealt to PlayTheBlues4U [7s 9c]
dmakai: raises $0.10 to $0.15
PlayTheBlues4U: folds
lj001ll: calls $0.15
DemolishIT: folds
CMc172: calls $0.10
*** FLOP *** [8c 4d Td]
CMc172: checks
dmakai: checks
lj001ll: checks
*** TURN *** [8c 4d Td] [9d]
CMc172: checks
dmakai: checks
lj001ll: bets $0.23
CMc172: folds
dmakai: folds
Uncalled bet ($0.23) returned to lj001ll
lj001ll collected $0.45 from pot
lj001ll: doesn't show hand
*** SUMMARY ***
Total pot $0.47 | Rake $0.02
Board [8c 4d Td 9d]
Seat 1: CMc172 (big blind) folded on the Turn
Seat 3: dmakai folded on the Turn
Seat 4: PlayTheBlues4U folded before Flop (didn't bet)
Seat 5: lj001ll (button) collected ($0.45)
Seat 6: DemolishIT (small blind) folded before Flop


*********** # 112 **************
PokerStars Hand #203841578524:  Hold'em No Limit ($0.05/$0.10 USD) - 2019/09/20 19:26:17 ET
Table 'Lacerta' 6-max Seat #5 is the button
Seat 1: turk1120 ($8.18 in chips)
Seat 2: PlayTheBlues4U ($9.22 in chips)
Seat 3: RNixon'sHead ($12.90 in chips)
Seat 4: Pergy21 ($8.16 in chips)
Seat 5: GoodKnight1365 ($9.91 in chips)
Seat 6: JDM0226 ($9.61 in chips)
JDM0226: posts small blind $0.05
turk1120: posts big blind $0.10
*** HOLE CARDS ***
Dealt to PlayTheBlues4U [7s Kc]
PlayTheBlues4U: folds
RNixon'sHead: folds
Pergy21: raises $0.10 to $0.20
GoodKnight1365: calls $0.20
JDM0226: folds
turk1120: calls $0.10
*** FLOP *** [4d Ts Ad]
turk1120: checks
turk1120 said, "/////////////////"
Pergy21: bets $0.30
GoodKnight1365: raises $0.60 to $0.90
turk1120 said, "///////////////////////////////////////////////////////////////////////////"
turk1120: folds
Pergy21: calls $0.60
*** TURN *** [4d Ts Ad] [Qh]
Pergy21: checks
GoodKnight1365: bets $1.20
RNixon'sHead said, "\ is better"
Pergy21: raises $1.80 to $3
GoodKnight1365: calls $1.80
*** RIVER *** [4d Ts Ad Qh] [Tc]
Pergy21: checks
GoodKnight1365: bets $3
Pergy21: calls $3
*** SHOW DOWN ***
GoodKnight1365: shows [As Th] (a full house, Tens full of Aces)
PlayTheBlues4U said, "\\\\\\\\\\\\"
Pergy21: shows [Qs Ac] (two pair, Aces and Queens)
GoodKnight1365 collected $13.73 from pot
*** SUMMARY ***
Total pot $14.45 | Rake $0.72
Board [4d Ts Ad Qh Tc]
Seat 1: turk1120 (big blind) folded on the Flop
Seat 2: PlayTheBlues4U folded before Flop (didn't bet)
Seat 3: RNixon'sHead folded before Flop (didn't bet)
Seat 4: Pergy21 showed [Qs Ac] and lost with two pair, Aces and Queens
Seat 5: GoodKnight1365 (button) showed [As Th] and won ($13.73) with a full house, Tens full of Aces
Seat 6: JDM0226 (small blind) folded before Flop


*********** # 113 **************
PokerStars Hand #203841578520:  Hold'em No Limit ($0.02/$0.05 USD) - 2019/09/20 19:26:14 ET
Table 'Anser' 6-max Seat #4 is the button
Seat 1: CMc172 ($4.23 in chips)
Seat 3: dmakai ($6.28 in chips)
Seat 4: PlayTheBlues4U ($6.88 in chips)
Seat 5: lj001ll ($1.39 in chips)
Seat 6: DemolishIT ($7.12 in chips)
lj001ll: posts small blind $0.02
DemolishIT: posts big blind $0.05
UmmmYummy: sits out
*** HOLE CARDS ***
Dealt to PlayTheBlues4U [7s 7c]
CMc172: folds
dmakai: folds
PlayTheBlues4U: raises $0.10 to $0.15
lj001ll: folds
DemolishIT: calls $0.10
*** FLOP *** [8s Jc 9c]
DemolishIT: checks
PlayTheBlues4U: checks
*** TURN *** [8s Jc 9c] [6c]
DemolishIT: bets $0.30
PlayTheBlues4U: calls $0.30
*** RIVER *** [8s Jc 9c 6c] [Qs]
DemolishIT: checks
PlayTheBlues4U: checks
*** SHOW DOWN ***
DemolishIT: shows [7d 5s] (a straight, Five to Nine)
PlayTheBlues4U: mucks hand
DemolishIT collected $0.87 from pot
*** SUMMARY ***
Total pot $0.92 | Rake $0.05
Board [8s Jc 9c 6c Qs]
Seat 1: CMc172 folded before Flop (didn't bet)
Seat 3: dmakai folded before Flop (didn't bet)
Seat 4: PlayTheBlues4U (button) mucked [7s 7c]
Seat 5: lj001ll (small blind) folded before Flop
Seat 6: DemolishIT (big blind) showed [7d 5s] and won ($0.87) with a straight, Five to Nine


*********** # 114 **************
PokerStars Hand #203841578403:  Hold'em No Limit ($0.02/$0.05 USD) - 2019/09/20 19:25:18 ET
Table 'Anser' 6-max Seat #3 is the button
Seat 1: CMc172 ($4.43 in chips)
Seat 2: Star6543 ($2.88 in chips)
Seat 3: dmakai ($5.53 in chips)
Seat 4: PlayTheBlues4U ($6.90 in chips)
Seat 5: lj001ll ($1.44 in chips)
Seat 6: DemolishIT ($7.67 in chips)
PlayTheBlues4U: posts small blind $0.02
lj001ll: posts big blind $0.05
*** HOLE CARDS ***
Dealt to PlayTheBlues4U [2h 3s]
Star6543 said, "gh"
DemolishIT: calls $0.05
CMc172: calls $0.05
Star6543: folds
dmakai: raises $0.15 to $0.20
PlayTheBlues4U: folds
lj001ll: folds
DemolishIT: calls $0.15
CMc172: calls $0.15
*** FLOP *** [Td 7s 7c]
DemolishIT: checks
CMc172: checks
dmakai: bets $0.35
DemolishIT: calls $0.35
Star6543 leaves the table
CMc172: folds
*** TURN *** [Td 7s 7c] [Ts]
UmmmYummy joins the table at seat #2
DemolishIT: checks
dmakai: checks
*** RIVER *** [Td 7s 7c Ts] [Qc]
DemolishIT: checks
dmakai: checks
*** SHOW DOWN ***
DemolishIT: shows [9c 6c] (two pair, Tens and Sevens)
dmakai: shows [Kc Kd] (two pair, Kings and Tens)
dmakai collected $1.30 from pot
*** SUMMARY ***
Total pot $1.37 | Rake $0.07
Board [Td 7s 7c Ts Qc]
Seat 1: CMc172 folded on the Flop
Seat 2: Star6543 folded before Flop (didn't bet)
Seat 3: dmakai (button) showed [Kc Kd] and won ($1.30) with two pair, Kings and Tens
Seat 4: PlayTheBlues4U (small blind) folded before Flop
Seat 5: lj001ll (big blind) folded before Flop
Seat 6: DemolishIT showed [9c 6c] and lost with two pair, Tens and Sevens


*********** # 115 **************
PokerStars Hand #203841578385:  Hold'em No Limit ($0.05/$0.10 USD) - 2019/09/20 19:25:11 ET
Table 'Lacerta' 6-max Seat #4 is the button
Seat 1: turk1120 ($6.82 in chips)
Seat 2: PlayTheBlues4U ($9.22 in chips)
Seat 3: RNixon'sHead ($12.90 in chips)
Seat 4: Pergy21 ($8.16 in chips)
Seat 5: GoodKnight1365 ($11.31 in chips)
Seat 6: JDM0226 ($9.71 in chips)
GoodKnight1365: posts small blind $0.05
JDM0226: posts big blind $0.10
*** HOLE CARDS ***
Dealt to PlayTheBlues4U [4s 8c]
turk1120: calls $0.10
PlayTheBlues4U: folds
RNixon'sHead: folds
Pergy21: folds
GoodKnight1365: raises $0.20 to $0.30
JDM0226: folds
turk1120: calls $0.20
*** FLOP *** [4c 9d Kd]
GoodKnight1365: checks
turk1120: bets $0.30
GoodKnight1365: calls $0.30
*** TURN *** [4c 9d Kd] [Ks]
GoodKnight1365: checks
turk1120: bets $0.10
GoodKnight1365: raises $0.70 to $0.80
turk1120: calls $0.70
*** RIVER *** [4c 9d Kd Ks] [2d]
GoodKnight1365: checks
turk1120: checks
*** SHOW DOWN ***
GoodKnight1365: shows [Jh Ad] (a pair of Kings)
turk1120: shows [Qh Qs] (two pair, Kings and Queens)
turk1120 collected $2.76 from pot
*** SUMMARY ***
Total pot $2.90 | Rake $0.14
Board [4c 9d Kd Ks 2d]
Seat 1: turk1120 showed [Qh Qs] and won ($2.76) with two pair, Kings and Queens
Seat 2: PlayTheBlues4U folded before Flop (didn't bet)
Seat 3: RNixon'sHead folded before Flop (didn't bet)
Seat 4: Pergy21 (button) folded before Flop (didn't bet)
Seat 5: GoodKnight1365 (small blind) showed [Jh Ad] and lost with a pair of Kings
Seat 6: JDM0226 (big blind) folded before Flop


*********** # 116 **************
PokerStars Hand #203841578347:  Hold'em No Limit ($0.05/$0.10 USD) - 2019/09/20 19:24:43 ET
Table 'Lacerta' 6-max Seat #3 is the button
Seat 1: turk1120 ($6.82 in chips)
Seat 2: PlayTheBlues4U ($9.22 in chips)
Seat 3: RNixon'sHead ($12.58 in chips)
Seat 4: Pergy21 ($8.41 in chips)
Seat 5: GoodKnight1365 ($11.41 in chips)
Seat 6: JDM0226 ($9.71 in chips)
Pergy21: posts small blind $0.05
GoodKnight1365: posts big blind $0.10
*** HOLE CARDS ***
Dealt to PlayTheBlues4U [4c 8h]
JDM0226: folds
turk1120: folds
PlayTheBlues4U: folds
RNixon'sHead: raises $0.15 to $0.25
Pergy21: calls $0.20
GoodKnight1365: folds
*** FLOP *** [Js 9h Jh]
Pergy21: checks
RNixon'sHead: bets $0.25
Pergy21: folds
Uncalled bet ($0.25) returned to RNixon'sHead
RNixon'sHead collected $0.57 from pot
RNixon'sHead: doesn't show hand
*** SUMMARY ***
Total pot $0.60 | Rake $0.03
Board [Js 9h Jh]
Seat 1: turk1120 folded before Flop (didn't bet)
Seat 2: PlayTheBlues4U folded before Flop (didn't bet)
Seat 3: RNixon'sHead (button) collected ($0.57)
Seat 4: Pergy21 (small blind) folded on the Flop
Seat 5: GoodKnight1365 (big blind) folded before Flop
Seat 6: JDM0226 folded before Flop (didn't bet)


*********** # 117 **************
PokerStars Hand #203841578323:  Hold'em No Limit ($0.02/$0.05 USD) - 2019/09/20 19:24:31 ET
Table 'Anser' 6-max Seat #2 is the button
Seat 1: CMc172 ($4.43 in chips)
Seat 2: Star6543 ($1.48 in chips)
Seat 3: dmakai ($5.55 in chips)
Seat 4: PlayTheBlues4U ($6.95 in chips)
Seat 5: lj001ll ($2.92 in chips)
Seat 6: DemolishIT ($7.67 in chips)
dmakai: posts small blind $0.02
PlayTheBlues4U: posts big blind $0.05
*** HOLE CARDS ***
Dealt to PlayTheBlues4U [6d 4s]
lj001ll: raises $0.15 to $0.20
DemolishIT: folds
CMc172: folds
Star6543: raises $0.30 to $0.50
dmakai: folds
PlayTheBlues4U: folds
lj001ll: calls $0.30
*** FLOP *** [Qc 3h Td]
lj001ll: checks
Star6543: bets $0.15
lj001ll: calls $0.15
*** TURN *** [Qc 3h Td] [Jd]
lj001ll: bets $1.83
Star6543: calls $0.83 and is all-in
Uncalled bet ($1) returned to lj001ll
*** RIVER *** [Qc 3h Td Jd] [Jc]
*** SHOW DOWN ***
lj001ll: shows [Kh As] (a straight, Ten to Ace)
Star6543: shows [Th Tc] (a full house, Tens full of Jacks)
Star6543 collected $2.88 from pot
*** SUMMARY ***
Total pot $3.03 | Rake $0.15
Board [Qc 3h Td Jd Jc]
Seat 1: CMc172 folded before Flop (didn't bet)
Seat 2: Star6543 (button) showed [Th Tc] and won ($2.88) with a full house, Tens full of Jacks
Seat 3: dmakai (small blind) folded before Flop
Seat 4: PlayTheBlues4U (big blind) folded before Flop
Seat 5: lj001ll showed [Kh As] and lost with a straight, Ten to Ace
Seat 6: DemolishIT folded before Flop (didn't bet)


*********** # 118 **************
PokerStars Hand #203841578292:  Hold'em No Limit ($0.05/$0.10 USD) - 2019/09/20 19:24:16 ET
Table 'Lacerta' 6-max Seat #2 is the button
Seat 1: turk1120 ($7.22 in chips)
Seat 2: PlayTheBlues4U ($9.22 in chips)
Seat 3: RNixon'sHead ($12.63 in chips)
Seat 4: Pergy21 ($8 in chips)
Seat 5: GoodKnight1365 ($11.41 in chips)
Seat 6: JDM0226 ($9.71 in chips)
RNixon'sHead: posts small blind $0.05
Pergy21: posts big blind $0.10
*** HOLE CARDS ***
Dealt to PlayTheBlues4U [3h 6c]
GoodKnight1365: folds
JDM0226: folds
turk1120: calls $0.10
PlayTheBlues4U: folds
RNixon'sHead: folds
Pergy21: checks
*** FLOP *** [Kc Ts 7d]
Pergy21: bets $0.10
turk1120: calls $0.10
*** TURN *** [Kc Ts 7d] [2h]
Pergy21: bets $0.10
turk1120: calls $0.10
*** RIVER *** [Kc Ts 7d 2h] [4s]
Pergy21: bets $0.10
turk1120: calls $0.10
*** SHOW DOWN ***
Pergy21: shows [Ac Th] (a pair of Tens)
turk1120: mucks hand
Pergy21 collected $0.81 from pot
*** SUMMARY ***
Total pot $0.85 | Rake $0.04
Board [Kc Ts 7d 2h 4s]
Seat 1: turk1120 mucked [9h Qd]
Seat 2: PlayTheBlues4U (button) folded before Flop (didn't bet)
Seat 3: RNixon'sHead (small blind) folded before Flop
Seat 4: Pergy21 (big blind) showed [Ac Th] and won ($0.81) with a pair of Tens
Seat 5: GoodKnight1365 folded before Flop (didn't bet)
Seat 6: JDM0226 folded before Flop (didn't bet)


*********** # 119 **************
PokerStars Hand #203841578214:  Hold'em No Limit ($0.02/$0.05 USD) - 2019/09/20 19:23:35 ET
Table 'Anser' 6-max Seat #1 is the button
Seat 1: CMc172 ($4.63 in chips)
Seat 2: Star6543 ($1.68 in chips)
Seat 3: dmakai ($5.65 in chips)
Seat 4: PlayTheBlues4U ($6.95 in chips)
Seat 5: lj001ll ($2.46 in chips)
Seat 6: DemolishIT ($7.67 in chips)
Star6543: posts small blind $0.02
dmakai: posts big blind $0.05
*** HOLE CARDS ***
Dealt to PlayTheBlues4U [Qs 2c]
PlayTheBlues4U: folds
lj001ll: calls $0.05
DemolishIT: folds
CMc172: calls $0.05
Star6543: calls $0.03
dmakai: checks
*** FLOP *** [8c Ad Jh]
Star6543: checks
dmakai: checks
lj001ll: bets $0.05
CMc172: calls $0.05
Star6543: calls $0.05
dmakai: calls $0.05
*** TURN *** [8c Ad Jh] [4h]
Star6543: checks
dmakai: checks
lj001ll: bets $0.10
CMc172: calls $0.10
Star6543: calls $0.10
dmakai: folds
*** RIVER *** [8c Ad Jh 4h] [Js]
Star6543: checks
lj001ll: bets $0.33
CMc172: folds
Star6543: folds
Uncalled bet ($0.33) returned to lj001ll
lj001ll collected $0.66 from pot
lj001ll: doesn't show hand
*** SUMMARY ***
Total pot $0.70 | Rake $0.04
Board [8c Ad Jh 4h Js]
Seat 1: CMc172 (button) folded on the River
Seat 2: Star6543 (small blind) folded on the River
Seat 3: dmakai (big blind) folded on the Turn
Seat 4: PlayTheBlues4U folded before Flop (didn't bet)
Seat 5: lj001ll collected ($0.66)
Seat 6: DemolishIT folded before Flop (didn't bet)


*********** # 120 **************
PokerStars Hand #203841578180:  Hold'em No Limit ($0.05/$0.10 USD) - 2019/09/20 19:23:18 ET
Table 'Lacerta' 6-max Seat #1 is the button
Seat 1: turk1120 ($7.32 in chips)
Seat 2: PlayTheBlues4U ($9.62 in chips)
Seat 3: RNixon'sHead ($12.73 in chips)
Seat 4: Pergy21 ($8 in chips)
Seat 5: GoodKnight1365 ($11.41 in chips)
Seat 6: JDM0226 ($9.16 in chips)
PlayTheBlues4U: posts small blind $0.05
RNixon'sHead: posts big blind $0.10
*** HOLE CARDS ***
Dealt to PlayTheBlues4U [Th 5h]
Pergy21: folds
GoodKnight1365: folds
JDM0226: calls $0.10
turk1120: calls $0.10
PlayTheBlues4U: calls $0.05
RNixon'sHead: checks
*** FLOP *** [Ah As Td]
PlayTheBlues4U: checks
RNixon'sHead: checks
JDM0226: checks
turk1120: checks
*** TURN *** [Ah As Td] [3s]
PlayTheBlues4U: checks
RNixon'sHead: checks
JDM0226: checks
turk1120: checks
*** RIVER *** [Ah As Td 3s] [4c]
PlayTheBlues4U: bets $0.30
RNixon'sHead: folds
JDM0226: calls $0.30
turk1120: folds
*** SHOW DOWN ***
PlayTheBlues4U: shows [Th 5h] (two pair, Aces and Tens)
JDM0226: shows [Jh Jc] (two pair, Aces and Jacks)
JDM0226 collected $0.95 from pot
*** SUMMARY ***
Total pot $1 | Rake $0.05
Board [Ah As Td 3s 4c]
Seat 1: turk1120 (button) folded on the River
Seat 2: PlayTheBlues4U (small blind) showed [Th 5h] and lost with two pair, Aces and Tens
Seat 3: RNixon'sHead (big blind) folded on the River
Seat 4: Pergy21 folded before Flop (didn't bet)
Seat 5: GoodKnight1365 folded before Flop (didn't bet)
Seat 6: JDM0226 showed [Jh Jc] and won ($0.95) with two pair, Aces and Jacks


*********** # 121 **************
PokerStars Hand #203841578128:  Hold'em No Limit ($0.05/$0.10 USD) - 2019/09/20 19:22:56 ET
Table 'Lacerta' 6-max Seat #6 is the button
Seat 1: turk1120 ($7.57 in chips)
Seat 2: PlayTheBlues4U ($9.72 in chips)
Seat 3: RNixon'sHead ($12.41 in chips)
Seat 4: Pergy21 ($8 in chips)
Seat 5: GoodKnight1365 ($11.41 in chips)
Seat 6: JDM0226 ($9.16 in chips)
turk1120: posts small blind $0.05
PlayTheBlues4U: posts big blind $0.10
*** HOLE CARDS ***
Dealt to PlayTheBlues4U [Jh 5h]
RNixon'sHead: raises $0.15 to $0.25
Pergy21: folds
GoodKnight1365: folds
JDM0226: folds
turk1120: calls $0.20
PlayTheBlues4U: folds
*** FLOP *** [Th Qh 3h]
turk1120: checks
RNixon'sHead: bets $0.25
turk1120: folds
Uncalled bet ($0.25) returned to RNixon'sHead
RNixon'sHead collected $0.57 from pot
RNixon'sHead: doesn't show hand
*** SUMMARY ***
Total pot $0.60 | Rake $0.03
Board [Th Qh 3h]
Seat 1: turk1120 (small blind) folded on the Flop
Seat 2: PlayTheBlues4U (big blind) folded before Flop
Seat 3: RNixon'sHead collected ($0.57)
Seat 4: Pergy21 folded before Flop (didn't bet)
Seat 5: GoodKnight1365 folded before Flop (didn't bet)
Seat 6: JDM0226 (button) folded before Flop (didn't bet)


*********** # 122 **************
PokerStars Hand #203841578076:  Hold'em No Limit ($0.02/$0.05 USD) - 2019/09/20 19:22:28 ET
Table 'Anser' 6-max Seat #6 is the button
Seat 1: CMc172 ($4.65 in chips)
Seat 2: Star6543 ($1.73 in chips)
Seat 3: dmakai ($5.65 in chips)
Seat 4: PlayTheBlues4U ($6.12 in chips)
Seat 5: lj001ll ($2.46 in chips)
Seat 6: DemolishIT ($8.52 in chips)
CMc172: posts small blind $0.02
Star6543: posts big blind $0.05
*** HOLE CARDS ***
Dealt to PlayTheBlues4U [9h 9s]
dmakai: folds
PlayTheBlues4U: raises $0.10 to $0.15
lj001ll: folds
DemolishIT: calls $0.15
CMc172: folds
Star6543: folds
*** FLOP *** [3d 8c 9c]
PlayTheBlues4U: bets $0.20
DemolishIT: calls $0.20
*** TURN *** [3d 8c 9c] [2h]
PlayTheBlues4U: bets $0.50
DemolishIT: calls $0.50
*** RIVER *** [3d 8c 9c 2h] [8h]
PlayTheBlues4U: bets $1.25
DemolishIT: folds
Uncalled bet ($1.25) returned to PlayTheBlues4U
PlayTheBlues4U collected $1.68 from pot
PlayTheBlues4U: doesn't show hand
*** SUMMARY ***
Total pot $1.77 | Rake $0.09
Board [3d 8c 9c 2h 8h]
Seat 1: CMc172 (small blind) folded before Flop
Seat 2: Star6543 (big blind) folded before Flop
Seat 3: dmakai folded before Flop (didn't bet)
Seat 4: PlayTheBlues4U collected ($1.68)
Seat 5: lj001ll folded before Flop (didn't bet)
Seat 6: DemolishIT (button) folded on the River


*********** # 123 **************
PokerStars Hand #203841578068:  Hold'em No Limit ($0.05/$0.10 USD) - 2019/09/20 19:22:25 ET
Table 'Lacerta' 6-max Seat #5 is the button
Seat 1: turk1120 ($7.48 in chips)
Seat 2: PlayTheBlues4U ($9.72 in chips)
Seat 3: RNixon'sHead ($12.41 in chips)
Seat 4: Pergy21 ($8 in chips)
Seat 5: GoodKnight1365 ($11.41 in chips)
Seat 6: JDM0226 ($9.26 in chips)
JDM0226: posts small blind $0.05
turk1120: posts big blind $0.10
*** HOLE CARDS ***
Dealt to PlayTheBlues4U [Js 9d]
PlayTheBlues4U: folds
RNixon'sHead: folds
Pergy21: folds
GoodKnight1365: folds
JDM0226: calls $0.05
turk1120: checks
*** FLOP *** [Kc 9h Kh]
JDM0226: checks
turk1120: checks
*** TURN *** [Kc 9h Kh] [Td]
JDM0226: checks
turk1120: checks
*** RIVER *** [Kc 9h Kh Td] [7s]
JDM0226: checks
turk1120: checks
*** SHOW DOWN ***
JDM0226: shows [5d 4c] (a pair of Kings)
turk1120: shows [3d As] (a pair of Kings - Ace kicker)
turk1120 collected $0.19 from pot
*** SUMMARY ***
Total pot $0.20 | Rake $0.01
Board [Kc 9h Kh Td 7s]
Seat 1: turk1120 (big blind) showed [3d As] and won ($0.19) with a pair of Kings
Seat 2: PlayTheBlues4U folded before Flop (didn't bet)
Seat 3: RNixon'sHead folded before Flop (didn't bet)
Seat 4: Pergy21 folded before Flop (didn't bet)
Seat 5: GoodKnight1365 (button) folded before Flop (didn't bet)
Seat 6: JDM0226 (small blind) showed [5d 4c] and lost with a pair of Kings


*********** # 124 **************
PokerStars Hand #203841578039:  Hold'em No Limit ($0.02/$0.05 USD) - 2019/09/20 19:22:14 ET
Table 'Anser' 6-max Seat #5 is the button
Seat 1: CMc172 ($4.63 in chips)
Seat 2: Star6543 ($1.73 in chips)
Seat 3: dmakai ($5.65 in chips)
Seat 4: PlayTheBlues4U ($6.12 in chips)
Seat 5: lj001ll ($2.46 in chips)
Seat 6: DemolishIT ($8.54 in chips)
DemolishIT: posts small blind $0.02
CMc172: posts big blind $0.05
*** HOLE CARDS ***
Dealt to PlayTheBlues4U [5d 8d]
Star6543: folds
dmakai: folds
PlayTheBlues4U: folds
lj001ll: folds
DemolishIT: folds
Uncalled bet ($0.03) returned to CMc172
CMc172 collected $0.04 from pot
CMc172: doesn't show hand
*** SUMMARY ***
Total pot $0.04 | Rake $0
Seat 1: CMc172 (big blind) collected ($0.04)
Seat 2: Star6543 folded before Flop (didn't bet)
Seat 3: dmakai folded before Flop (didn't bet)
Seat 4: PlayTheBlues4U folded before Flop (didn't bet)
Seat 5: lj001ll (button) folded before Flop (didn't bet)
Seat 6: DemolishIT (small blind) folded before Flop


*********** # 125 **************
PokerStars Hand #203841577995:  Hold'em No Limit ($0.05/$0.10 USD) - 2019/09/20 19:21:51 ET
Table 'Lacerta' 6-max Seat #4 is the button
Seat 1: turk1120 ($7.48 in chips)
Seat 2: PlayTheBlues4U ($9.72 in chips)
Seat 3: RNixon'sHead ($12.41 in chips)
Seat 4: Pergy21 ($8.40 in chips)
Seat 5: GoodKnight1365 ($11.46 in chips)
Seat 6: JDM0226 ($8.85 in chips)
GoodKnight1365: posts small blind $0.05
JDM0226: posts big blind $0.10
*** HOLE CARDS ***
Dealt to PlayTheBlues4U [7c Js]
turk1120: folds
PlayTheBlues4U: folds
RNixon'sHead: folds
Pergy21: calls $0.10
GoodKnight1365: folds
JDM0226: checks
*** FLOP *** [7d 2c Jh]
JDM0226: checks
Pergy21: checks
*** TURN *** [7d 2c Jh] [Qh]
JDM0226: bets $0.30
Pergy21: calls $0.30
*** RIVER *** [7d 2c Jh Qh] [Ah]
JDM0226: checks
Pergy21: checks
*** SHOW DOWN ***
JDM0226: shows [2h 2d] (three of a kind, Deuces)
Pergy21: mucks hand
JDM0226 collected $0.81 from pot
*** SUMMARY ***
Total pot $0.85 | Rake $0.04
Board [7d 2c Jh Qh Ah]
Seat 1: turk1120 folded before Flop (didn't bet)
Seat 2: PlayTheBlues4U folded before Flop (didn't bet)
Seat 3: RNixon'sHead folded before Flop (didn't bet)
Seat 4: Pergy21 (button) mucked [Qd 9c]
Seat 5: GoodKnight1365 (small blind) folded before Flop
Seat 6: JDM0226 (big blind) showed [2h 2d] and won ($0.81) with three of a kind, Deuces


*********** # 126 **************
PokerStars Hand #203841577960:  Hold'em No Limit ($0.02/$0.05 USD) - 2019/09/20 19:21:36 ET
Table 'Anser' 6-max Seat #4 is the button
Seat 1: CMc172 ($4.63 in chips)
Seat 2: Star6543 ($1.73 in chips)
Seat 3: dmakai ($5.65 in chips)
Seat 4: PlayTheBlues4U ($6.12 in chips)
Seat 5: lj001ll ($2.37 in chips)
Seat 6: DemolishIT ($8.64 in chips)
lj001ll: posts small blind $0.02
DemolishIT: posts big blind $0.05
*** HOLE CARDS ***
Dealt to PlayTheBlues4U [3d 6h]
CMc172: folds
Star6543: folds
dmakai: folds
PlayTheBlues4U: folds
lj001ll: calls $0.03
DemolishIT: checks
*** FLOP *** [Ts 9h Qh]
lj001ll: checks
DemolishIT: checks
*** TURN *** [Ts 9h Qh] [Qs]
lj001ll: bets $0.05
DemolishIT: calls $0.05
*** RIVER *** [Ts 9h Qh Qs] [5d]
lj001ll: checks
DemolishIT: checks
*** SHOW DOWN ***
lj001ll: shows [As Tc] (two pair, Queens and Tens)
DemolishIT: mucks hand
lj001ll collected $0.19 from pot
*** SUMMARY ***
Total pot $0.20 | Rake $0.01
Board [Ts 9h Qh Qs 5d]
Seat 1: CMc172 folded before Flop (didn't bet)
Seat 2: Star6543 folded before Flop (didn't bet)
Seat 3: dmakai folded before Flop (didn't bet)
Seat 4: PlayTheBlues4U (button) folded before Flop (didn't bet)
Seat 5: lj001ll (small blind) showed [As Tc] and won ($0.19) with two pair, Queens and Tens
Seat 6: DemolishIT (big blind) mucked [9c 7h]


*********** # 127 **************
PokerStars Hand #203841577911:  Hold'em No Limit ($0.05/$0.10 USD) - 2019/09/20 19:21:11 ET
Table 'Lacerta' 6-max Seat #3 is the button
Seat 1: turk1120 ($6.53 in chips)
Seat 2: PlayTheBlues4U ($9.72 in chips)
Seat 3: RNixon'sHead ($12.41 in chips)
Seat 4: Pergy21 ($8.45 in chips)
Seat 5: GoodKnight1365 ($12.46 in chips)
Seat 6: JDM0226 ($8.85 in chips)
Pergy21: posts small blind $0.05
GoodKnight1365: posts big blind $0.10
*** HOLE CARDS ***
Dealt to PlayTheBlues4U [4s Qh]
JDM0226: folds
turk1120: calls $0.10
PlayTheBlues4U: folds
RNixon'sHead: folds
Pergy21: folds
GoodKnight1365: raises $0.10 to $0.20
turk1120: calls $0.10
*** FLOP *** [3c 2d 3s]
GoodKnight1365: bets $0.20
turk1120: calls $0.20
*** TURN *** [3c 2d 3s] [Ad]
GoodKnight1365: bets $0.60
turk1120: calls $0.60
*** RIVER *** [3c 2d 3s Ad] [7c]
GoodKnight1365: checks
turk1120: checks
*** SHOW DOWN ***
GoodKnight1365: shows [5d 6d] (a pair of Threes)
turk1120: shows [Kh Ks] (two pair, Kings and Threes)
turk1120 collected $1.95 from pot
*** SUMMARY ***
Total pot $2.05 | Rake $0.10
Board [3c 2d 3s Ad 7c]
Seat 1: turk1120 showed [Kh Ks] and won ($1.95) with two pair, Kings and Threes
Seat 2: PlayTheBlues4U folded before Flop (didn't bet)
Seat 3: RNixon'sHead (button) folded before Flop (didn't bet)
Seat 4: Pergy21 (small blind) folded before Flop
Seat 5: GoodKnight1365 (big blind) showed [5d 6d] and lost with a pair of Threes
Seat 6: JDM0226 folded before Flop (didn't bet)


*********** # 128 **************
PokerStars Hand #203841577895:  Hold'em No Limit ($0.02/$0.05 USD) - 2019/09/20 19:21:03 ET
Table 'Anser' 6-max Seat #3 is the button
Seat 1: CMc172 ($4.68 in chips)
Seat 2: Star6543 ($1.73 in chips)
Seat 3: dmakai ($5.65 in chips)
Seat 4: PlayTheBlues4U ($6.17 in chips)
Seat 5: lj001ll ($2.28 in chips)
Seat 6: DemolishIT ($8.64 in chips)
PlayTheBlues4U: posts small blind $0.02
lj001ll: posts big blind $0.05
*** HOLE CARDS ***
Dealt to PlayTheBlues4U [Qs 9d]
DemolishIT: folds
CMc172: calls $0.05
Star6543: folds
dmakai: folds
PlayTheBlues4U: calls $0.03
lj001ll: checks
*** FLOP *** [6d 6s Tc]
PlayTheBlues4U: checks
lj001ll: bets $0.07
CMc172: folds
PlayTheBlues4U: folds
Uncalled bet ($0.07) returned to lj001ll
lj001ll collected $0.14 from pot
lj001ll: doesn't show hand
*** SUMMARY ***
Total pot $0.15 | Rake $0.01
Board [6d 6s Tc]
Seat 1: CMc172 folded on the Flop
Seat 2: Star6543 folded before Flop (didn't bet)
Seat 3: dmakai (button) folded before Flop (didn't bet)
Seat 4: PlayTheBlues4U (small blind) folded on the Flop
Seat 5: lj001ll (big blind) collected ($0.14)
Seat 6: DemolishIT folded before Flop (didn't bet)


*********** # 129 **************
PokerStars Hand #203841577824:  Hold'em No Limit ($0.02/$0.05 USD) - 2019/09/20 19:20:21 ET
Table 'Anser' 6-max Seat #2 is the button
Seat 1: CMc172 ($4.68 in chips)
Seat 2: Star6543 ($1.45 in chips)
Seat 3: dmakai ($5.75 in chips)
Seat 4: PlayTheBlues4U ($6.27 in chips)
Seat 5: lj001ll ($2.38 in chips)
Seat 6: DemolishIT ($8.64 in chips)
dmakai: posts small blind $0.02
PlayTheBlues4U: posts big blind $0.05
*** HOLE CARDS ***
Dealt to PlayTheBlues4U [9s As]
lj001ll: calls $0.05
DemolishIT: folds
CMc172: folds
Star6543: calls $0.05
dmakai: calls $0.03
PlayTheBlues4U: raises $0.05 to $0.10
lj001ll: calls $0.05
Star6543: calls $0.05
dmakai: calls $0.05
*** FLOP *** [Qd Ks 4c]
dmakai: checks
PlayTheBlues4U: checks
lj001ll: checks
Star6543: bets $0.38
dmakai: folds
PlayTheBlues4U: folds
lj001ll: folds
Uncalled bet ($0.38) returned to Star6543
Star6543 collected $0.38 from pot
Star6543: doesn't show hand
*** SUMMARY ***
Total pot $0.40 | Rake $0.02
Board [Qd Ks 4c]
Seat 1: CMc172 folded before Flop (didn't bet)
Seat 2: Star6543 (button) collected ($0.38)
Seat 3: dmakai (small blind) folded on the Flop
Seat 4: PlayTheBlues4U (big blind) folded on the Flop
Seat 5: lj001ll folded on the Flop
Seat 6: DemolishIT folded before Flop (didn't bet)


*********** # 130 **************
PokerStars Hand #203841577809:  Hold'em No Limit ($0.05/$0.10 USD) - 2019/09/20 19:20:14 ET
Table 'Lacerta' 6-max Seat #2 is the button
Seat 1: turk1120 ($6.53 in chips)
Seat 2: PlayTheBlues4U ($9.92 in chips)
Seat 3: RNixon'sHead ($12.46 in chips)
Seat 4: Pergy21 ($8.95 in chips)
Seat 5: GoodKnight1365 ($11.77 in chips)
Seat 6: JDM0226 ($8.85 in chips)
RNixon'sHead: posts small blind $0.05
Pergy21: posts big blind $0.10
*** HOLE CARDS ***
Dealt to PlayTheBlues4U [8h Jh]
GoodKnight1365: raises $0.10 to $0.20
JDM0226: folds
turk1120: folds
PlayTheBlues4U: calls $0.20
RNixon'sHead: folds
Pergy21: calls $0.10
*** FLOP *** [Qd Tc 3h]
Pergy21: checks
GoodKnight1365: bets $0.30
PlayTheBlues4U: folds
Pergy21: calls $0.30
*** TURN *** [Qd Tc 3h] [3c]
Pergy21: checks
GoodKnight1365: checks
*** RIVER *** [Qd Tc 3h 3c] [Ad]
Pergy21: checks
GoodKnight1365: checks
*** SHOW DOWN ***
Pergy21: shows [Ks 7s] (a pair of Threes)
GoodKnight1365: shows [Qh 9h] (two pair, Queens and Threes)
GoodKnight1365 collected $1.19 from pot
*** SUMMARY ***
Total pot $1.25 | Rake $0.06
Board [Qd Tc 3h 3c Ad]
Seat 1: turk1120 folded before Flop (didn't bet)
Seat 2: PlayTheBlues4U (button) folded on the Flop
Seat 3: RNixon'sHead (small blind) folded before Flop
Seat 4: Pergy21 (big blind) showed [Ks 7s] and lost with a pair of Threes
Seat 5: GoodKnight1365 showed [Qh 9h] and won ($1.19) with two pair, Queens and Threes
Seat 6: JDM0226 folded before Flop (didn't bet)


*********** # 131 **************
PokerStars Hand #203841577746:  Hold'em No Limit ($0.02/$0.05 USD) - 2019/09/20 19:19:42 ET
Table 'Anser' 6-max Seat #1 is the button
Seat 1: CMc172 ($4.73 in chips)
Seat 2: Star6543 ($1.70 in chips)
Seat 3: dmakai ($5.80 in chips)
Seat 4: PlayTheBlues4U ($6.27 in chips)
Seat 5: lj001ll ($2.38 in chips)
Seat 6: DemolishIT ($8.32 in chips)
Star6543: posts small blind $0.02
dmakai: posts big blind $0.05
*** HOLE CARDS ***
Dealt to PlayTheBlues4U [9d Kd]
PlayTheBlues4U: folds
lj001ll: folds
DemolishIT: calls $0.05
CMc172: calls $0.05
Star6543: calls $0.03
dmakai: checks
*** FLOP *** [7h 8s 7c]
Star6543: bets $0.05
dmakai: folds
DemolishIT: calls $0.05
CMc172: folds
*** TURN *** [7h 8s 7c] [Jd]
Star6543: bets $0.05
DemolishIT: calls $0.05
*** RIVER *** [7h 8s 7c Jd] [Tc]
Star6543: bets $0.05
DemolishIT: raises $0.05 to $0.10
Star6543: calls $0.05
*** SHOW DOWN ***
DemolishIT: shows [As 9s] (a straight, Seven to Jack)
Star6543: mucks hand
DemolishIT collected $0.57 from pot
*** SUMMARY ***
Total pot $0.60 | Rake $0.03
Board [7h 8s 7c Jd Tc]
Seat 1: CMc172 (button) folded on the Flop
Seat 2: Star6543 (small blind) mucked [Ad 8c]
Seat 3: dmakai (big blind) folded on the Flop
Seat 4: PlayTheBlues4U folded before Flop (didn't bet)
Seat 5: lj001ll folded before Flop (didn't bet)
Seat 6: DemolishIT showed [As 9s] and won ($0.57) with a straight, Seven to Jack


*********** # 132 **************
PokerStars Hand #203841577743:  Hold'em No Limit ($0.05/$0.10 USD) - 2019/09/20 19:19:39 ET
Table 'Lacerta' 6-max Seat #1 is the button
Seat 1: turk1120 ($6.35 in chips)
Seat 2: PlayTheBlues4U ($10.02 in chips)
Seat 3: RNixon'sHead ($12.56 in chips)
Seat 4: Pergy21 ($8.95 in chips)
Seat 5: GoodKnight1365 ($11.77 in chips)
Seat 6: JDM0226 ($8.85 in chips)
PlayTheBlues4U: posts small blind $0.05
RNixon'sHead: posts big blind $0.10
*** HOLE CARDS ***
Dealt to PlayTheBlues4U [6s Kh]
Pergy21: folds
GoodKnight1365: folds
JDM0226: folds
turk1120: calls $0.10
PlayTheBlues4U: calls $0.05
RNixon'sHead: checks
*** FLOP *** [Ac Qd 2d]
PlayTheBlues4U: checks
RNixon'sHead: checks
turk1120: checks
*** TURN *** [Ac Qd 2d] [7d]
PlayTheBlues4U: checks
RNixon'sHead: checks
turk1120: bets $0.10
PlayTheBlues4U: folds
RNixon'sHead: folds
Uncalled bet ($0.10) returned to turk1120
turk1120 collected $0.28 from pot
*** SUMMARY ***
Total pot $0.30 | Rake $0.02
Board [Ac Qd 2d 7d]
Seat 1: turk1120 (button) collected ($0.28)
Seat 2: PlayTheBlues4U (small blind) folded on the Turn
Seat 3: RNixon'sHead (big blind) folded on the Turn
Seat 4: Pergy21 folded before Flop (didn't bet)
Seat 5: GoodKnight1365 folded before Flop (didn't bet)
Seat 6: JDM0226 folded before Flop (didn't bet)


*********** # 133 **************
PokerStars Hand #203841577685:  Hold'em No Limit ($0.02/$0.05 USD) - 2019/09/20 19:19:08 ET
Table 'Anser' 6-max Seat #6 is the button
Seat 1: CMc172 ($4.12 in chips)
Seat 2: Star6543 ($1.75 in chips)
Seat 3: dmakai ($5.80 in chips)
Seat 4: PlayTheBlues4U ($6.27 in chips)
Seat 5: lj001ll ($2.38 in chips)
Seat 6: DemolishIT ($8.95 in chips)
CMc172: posts small blind $0.02
Star6543: posts big blind $0.05
*** HOLE CARDS ***
Dealt to PlayTheBlues4U [8s 4h]
dmakai: folds
PlayTheBlues4U: folds
lj001ll: folds
DemolishIT: raises $0.15 to $0.20
CMc172: calls $0.18
Star6543: folds
*** FLOP *** [8h Ac 5s]
CMc172: checks
DemolishIT: checks
*** TURN *** [8h Ac 5s] [2d]
CMc172: checks
DemolishIT: bets $0.43
CMc172: calls $0.43
*** RIVER *** [8h Ac 5s 2d] [5c]
CMc172: checks
DemolishIT: checks
*** SHOW DOWN ***
CMc172: shows [Ad Qh] (two pair, Aces and Fives)
DemolishIT: mucks hand
CMc172 collected $1.24 from pot
*** SUMMARY ***
Total pot $1.31 | Rake $0.07
Board [8h Ac 5s 2d 5c]
Seat 1: CMc172 (small blind) showed [Ad Qh] and won ($1.24) with two pair, Aces and Fives
Seat 2: Star6543 (big blind) folded before Flop
Seat 3: dmakai folded before Flop (didn't bet)
Seat 4: PlayTheBlues4U folded before Flop (didn't bet)
Seat 5: lj001ll folded before Flop (didn't bet)
Seat 6: DemolishIT (button) mucked [4c 2c]


*********** # 134 **************
PokerStars Hand #203841577632:  Hold'em No Limit ($0.05/$0.10 USD) - 2019/09/20 19:18:40 ET
Table 'Lacerta' 6-max Seat #6 is the button
Seat 1: turk1120 ($6.40 in chips)
Seat 2: PlayTheBlues4U ($10.12 in chips)
Seat 3: RNixon'sHead ($12.56 in chips)
Seat 4: Pergy21 ($9.55 in chips)
Seat 5: GoodKnight1365 ($11.09 in chips)
Seat 6: JDM0226 ($8.85 in chips)
turk1120: posts small blind $0.05
PlayTheBlues4U: posts big blind $0.10
*** HOLE CARDS ***
Dealt to PlayTheBlues4U [2h Th]
RNixon'sHead: folds
Pergy21: raises $0.10 to $0.20
GoodKnight1365: raises $0.40 to $0.60
JDM0226: folds
turk1120: folds
PlayTheBlues4U: folds
Pergy21: calls $0.40
*** FLOP *** [5c 4d 6s]
Pergy21: checks
GoodKnight1365: checks
*** TURN *** [5c 4d 6s] [Kd]
Pergy21: checks
GoodKnight1365: bets $0.80
Pergy21: folds
Uncalled bet ($0.80) returned to GoodKnight1365
GoodKnight1365 collected $1.28 from pot
GoodKnight1365: doesn't show hand
*** SUMMARY ***
Total pot $1.35 | Rake $0.07
Board [5c 4d 6s Kd]
Seat 1: turk1120 (small blind) folded before Flop
Seat 2: PlayTheBlues4U (big blind) folded before Flop
Seat 3: RNixon'sHead folded before Flop (didn't bet)
Seat 4: Pergy21 folded on the Turn
Seat 5: GoodKnight1365 collected ($1.28)
Seat 6: JDM0226 (button) folded before Flop (didn't bet)


*********** # 135 **************
PokerStars Hand #203841577616:  Hold'em No Limit ($0.02/$0.05 USD) - 2019/09/20 19:18:32 ET
Table 'Anser' 6-max Seat #5 is the button
Seat 1: CMc172 ($4.27 in chips)
Seat 2: Star6543 ($1.75 in chips)
Seat 3: dmakai ($5.80 in chips)
Seat 4: PlayTheBlues4U ($5.99 in chips)
Seat 5: lj001ll ($2.38 in chips)
Seat 6: DemolishIT ($9.10 in chips)
DemolishIT: posts small blind $0.02
CMc172: posts big blind $0.05
*** HOLE CARDS ***
Dealt to PlayTheBlues4U [Ac 2c]
Star6543: folds
dmakai: folds
PlayTheBlues4U: raises $0.10 to $0.15
lj001ll: folds
DemolishIT: calls $0.13
CMc172: calls $0.10
*** FLOP *** [7h 4s Ks]
DemolishIT: checks
CMc172: checks
PlayTheBlues4U: bets $0.20
DemolishIT: folds
CMc172: folds
Uncalled bet ($0.20) returned to PlayTheBlues4U
PlayTheBlues4U collected $0.43 from pot
PlayTheBlues4U: doesn't show hand
*** SUMMARY ***
Total pot $0.45 | Rake $0.02
Board [7h 4s Ks]
Seat 1: CMc172 (big blind) folded on the Flop
Seat 2: Star6543 folded before Flop (didn't bet)
Seat 3: dmakai folded before Flop (didn't bet)
Seat 4: PlayTheBlues4U collected ($0.43)
Seat 5: lj001ll (button) folded before Flop (didn't bet)
Seat 6: DemolishIT (small blind) folded on the Flop


*********** # 136 **************
PokerStars Hand #203841577607:  Hold'em No Limit ($0.05/$0.10 USD) - 2019/09/20 19:18:27 ET
Table 'Lacerta' 6-max Seat #5 is the button
Seat 1: turk1120 ($6.50 in chips)
Seat 2: PlayTheBlues4U ($9.97 in chips)
Seat 3: RNixon'sHead ($12.56 in chips)
Seat 4: Pergy21 ($9.55 in chips)
Seat 5: GoodKnight1365 ($11.09 in chips)
Seat 6: JDM0226 ($8.90 in chips)
JDM0226: posts small blind $0.05
turk1120: posts big blind $0.10
*** HOLE CARDS ***
Dealt to PlayTheBlues4U [Qh Kh]
PlayTheBlues4U: raises $0.20 to $0.30
RNixon'sHead: folds
Pergy21: folds
GoodKnight1365: folds
JDM0226: folds
turk1120: folds
Uncalled bet ($0.20) returned to PlayTheBlues4U
PlayTheBlues4U collected $0.25 from pot
PlayTheBlues4U: doesn't show hand
*** SUMMARY ***
Total pot $0.25 | Rake $0
Seat 1: turk1120 (big blind) folded before Flop
Seat 2: PlayTheBlues4U collected ($0.25)
Seat 3: RNixon'sHead folded before Flop (didn't bet)
Seat 4: Pergy21 folded before Flop (didn't bet)
Seat 5: GoodKnight1365 (button) folded before Flop (didn't bet)
Seat 6: JDM0226 (small blind) folded before Flop


*********** # 137 **************
PokerStars Hand #203841577540:  Hold'em No Limit ($0.05/$0.10 USD) - 2019/09/20 19:17:44 ET
Table 'Lacerta' 6-max Seat #4 is the button
Seat 1: turk1120 ($6.95 in chips)
Seat 2: PlayTheBlues4U ($9.97 in chips)
Seat 3: RNixon'sHead ($12.01 in chips)
Seat 4: Pergy21 ($9.55 in chips)
Seat 5: GoodKnight1365 ($11.14 in chips)
Seat 6: JDM0226 ($9 in chips)
GoodKnight1365: posts small blind $0.05
JDM0226: posts big blind $0.10
*** HOLE CARDS ***
Dealt to PlayTheBlues4U [5s Tc]
turk1120: calls $0.10
PlayTheBlues4U: folds
RNixon'sHead: raises $0.35 to $0.45
Pergy21: folds
GoodKnight1365: folds
JDM0226: folds
turk1120: calls $0.35
*** FLOP *** [6s Kh 9c]
turk1120: checks
RNixon'sHead: checks
*** TURN *** [6s Kh 9c] [Ac]
turk1120: checks
RNixon'sHead: bets $0.77
turk1120: folds
Uncalled bet ($0.77) returned to RNixon'sHead
RNixon'sHead collected $1 from pot
RNixon'sHead: doesn't show hand
*** SUMMARY ***
Total pot $1.05 | Rake $0.05
Board [6s Kh 9c Ac]
Seat 1: turk1120 folded on the Turn
Seat 2: PlayTheBlues4U folded before Flop (didn't bet)
Seat 3: RNixon'sHead collected ($1)
Seat 4: Pergy21 (button) folded before Flop (didn't bet)
Seat 5: GoodKnight1365 (small blind) folded before Flop
Seat 6: JDM0226 (big blind) folded before Flop


*********** # 138 **************
PokerStars Hand #203841577504:  Hold'em No Limit ($0.02/$0.05 USD) - 2019/09/20 19:17:26 ET
Table 'Anser' 6-max Seat #4 is the button
Seat 1: CMc172 ($4.72 in chips)
Seat 2: Star6543 ($1.75 in chips)
Seat 3: dmakai ($5.80 in chips)
Seat 4: PlayTheBlues4U ($5.14 in chips)
Seat 5: lj001ll ($2.40 in chips)
Seat 6: DemolishIT ($9.55 in chips)
lj001ll: posts small blind $0.02
DemolishIT: posts big blind $0.05
*** HOLE CARDS ***
Dealt to PlayTheBlues4U [7s 8s]
CMc172: calls $0.05
Star6543: folds
dmakai: folds
PlayTheBlues4U: raises $0.10 to $0.15
lj001ll: folds
DemolishIT: calls $0.10
CMc172: calls $0.10
*** FLOP *** [9d Qs 8h]
DemolishIT: checks
CMc172: checks
PlayTheBlues4U: bets $0.30
DemolishIT: calls $0.30
CMc172: calls $0.30
*** TURN *** [9d Qs 8h] [2d]
DemolishIT: checks
CMc172: checks
PlayTheBlues4U: checks
*** RIVER *** [9d Qs 8h 2d] [Kc]
DemolishIT: checks
CMc172: checks
PlayTheBlues4U: bets $0.80
DemolishIT: folds
CMc172: folds
Uncalled bet ($0.80) returned to PlayTheBlues4U
PlayTheBlues4U collected $1.30 from pot
PlayTheBlues4U: doesn't show hand
*** SUMMARY ***
Total pot $1.37 | Rake $0.07
Board [9d Qs 8h 2d Kc]
Seat 1: CMc172 folded on the River
Seat 2: Star6543 folded before Flop (didn't bet)
Seat 3: dmakai folded before Flop (didn't bet)
Seat 4: PlayTheBlues4U (button) collected ($1.30)
Seat 5: lj001ll (small blind) folded before Flop
Seat 6: DemolishIT (big blind) folded on the River


*********** # 139 **************
PokerStars Hand #203841577442:  Hold'em No Limit ($0.05/$0.10 USD) - 2019/09/20 19:16:47 ET
Table 'Lacerta' 6-max Seat #3 is the button
Seat 1: turk1120 ($7.25 in chips)
Seat 2: PlayTheBlues4U ($10.87 in chips)
Seat 3: RNixon'sHead ($12.01 in chips)
Seat 4: Pergy21 ($9.60 in chips)
Seat 5: GoodKnight1365 ($10 in chips)
Pergy21: posts small blind $0.05
GoodKnight1365: posts big blind $0.10
*** HOLE CARDS ***
Dealt to PlayTheBlues4U [4d 5d]
turk1120: calls $0.10
PlayTheBlues4U: calls $0.10
JDM0226 joins the table at seat #6
RNixon'sHead: folds
Pergy21: folds
GoodKnight1365: checks
*** FLOP *** [2d 3c Kh]
GoodKnight1365: bets $0.20
turk1120: calls $0.20
PlayTheBlues4U: calls $0.20
*** TURN *** [2d 3c Kh] [8d]
GoodKnight1365: bets $0.60
turk1120: folds
PlayTheBlues4U: calls $0.60
*** RIVER *** [2d 3c Kh 8d] [9c]
GoodKnight1365: bets $1
PlayTheBlues4U: folds
Uncalled bet ($1) returned to GoodKnight1365
GoodKnight1365 collected $2.04 from pot
GoodKnight1365: doesn't show hand
*** SUMMARY ***
Total pot $2.15 | Rake $0.11
Board [2d 3c Kh 8d 9c]
Seat 1: turk1120 folded on the Turn
Seat 2: PlayTheBlues4U folded on the River
Seat 3: RNixon'sHead (button) folded before Flop (didn't bet)
Seat 4: Pergy21 (small blind) folded before Flop
Seat 5: GoodKnight1365 (big blind) collected ($2.04)


*********** # 140 **************
PokerStars Hand #203841577435:  Hold'em No Limit ($0.02/$0.05 USD) - 2019/09/20 19:16:39 ET
Table 'Anser' 6-max Seat #3 is the button
Seat 1: CMc172 ($4.77 in chips)
Seat 2: Star6543 ($1.80 in chips)
Seat 3: dmakai ($5.85 in chips)
Seat 4: PlayTheBlues4U ($4.95 in chips)
Seat 5: lj001ll ($2.45 in chips)
Seat 6: DemolishIT ($9.55 in chips)
PlayTheBlues4U: posts small blind $0.02
lj001ll: posts big blind $0.05
*** HOLE CARDS ***
Dealt to PlayTheBlues4U [4h Ah]
DemolishIT: folds
CMc172: calls $0.05
Star6543: calls $0.05
dmakai: calls $0.05
PlayTheBlues4U: calls $0.03
lj001ll: checks
*** FLOP *** [7h 7c Ad]
PlayTheBlues4U: checks
lj001ll: checks
CMc172: checks
Star6543: checks
dmakai: checks
*** TURN *** [7h 7c Ad] [9c]
PlayTheBlues4U: bets $0.15
lj001ll: folds
CMc172: folds
Star6543: folds
dmakai: folds
Uncalled bet ($0.15) returned to PlayTheBlues4U
PlayTheBlues4U collected $0.24 from pot
PlayTheBlues4U: doesn't show hand
*** SUMMARY ***
Total pot $0.25 | Rake $0.01
Board [7h 7c Ad 9c]
Seat 1: CMc172 folded on the Turn
Seat 2: Star6543 folded on the Turn
Seat 3: dmakai (button) folded on the Turn
Seat 4: PlayTheBlues4U (small blind) collected ($0.24)
Seat 5: lj001ll (big blind) folded on the Turn
Seat 6: DemolishIT folded before Flop (didn't bet)


*********** # 141 **************
PokerStars Hand #203841577346:  Hold'em No Limit ($0.02/$0.05 USD) - 2019/09/20 19:15:53 ET
Table 'Anser' 6-max Seat #2 is the button
Seat 1: CMc172 ($4.66 in chips)
Seat 2: Star6543 ($1.85 in chips)
Seat 3: dmakai ($5.87 in chips)
Seat 4: PlayTheBlues4U ($5 in chips)
Seat 5: lj001ll ($2.45 in chips)
Seat 6: DemolishIT ($9.55 in chips)
dmakai: posts small blind $0.02
PlayTheBlues4U: posts big blind $0.05
*** HOLE CARDS ***
Dealt to PlayTheBlues4U [2h 8s]
lj001ll: folds
DemolishIT: folds
CMc172: calls $0.05
Star6543: calls $0.05
dmakai: folds
PlayTheBlues4U: checks
*** FLOP *** [Qc Ah As]
PlayTheBlues4U: checks
CMc172: checks
Star6543: checks
*** TURN *** [Qc Ah As] [9s]
PlayTheBlues4U: checks
CMc172: checks
Star6543: checks
*** RIVER *** [Qc Ah As 9s] [5d]
PlayTheBlues4U: checks
CMc172: bets $0.10
Star6543: folds
PlayTheBlues4U: folds
Uncalled bet ($0.10) returned to CMc172
CMc172 collected $0.16 from pot
CMc172: doesn't show hand
*** SUMMARY ***
Total pot $0.17 | Rake $0.01
Board [Qc Ah As 9s 5d]
Seat 1: CMc172 collected ($0.16)
Seat 2: Star6543 (button) folded on the River
Seat 3: dmakai (small blind) folded before Flop
Seat 4: PlayTheBlues4U (big blind) folded on the River
Seat 5: lj001ll folded before Flop (didn't bet)
Seat 6: DemolishIT folded before Flop (didn't bet)


*********** # 142 **************
PokerStars Hand #203841577322:  Hold'em No Limit ($0.05/$0.10 USD) - 2019/09/20 19:15:42 ET
Table 'Lacerta' 6-max Seat #2 is the button
Seat 1: turk1120 ($7.25 in chips)
Seat 2: PlayTheBlues4U ($10.87 in chips)
Seat 3: RNixon'sHead ($12.06 in chips)
Seat 4: Pergy21 ($9.60 in chips)
RNixon'sHead: posts small blind $0.05
Pergy21: posts big blind $0.10
*** HOLE CARDS ***
Dealt to PlayTheBlues4U [Ac 4s]
GoodKnight1365 joins the table at seat #5
turk1120: folds
PlayTheBlues4U: raises $0.10 to $0.20
RNixon'sHead: folds
Pergy21: calls $0.10
*** FLOP *** [Qd 7d Td]
Pergy21: checks
PlayTheBlues4U: checks
*** TURN *** [Qd 7d Td] [As]
Pergy21: checks
PlayTheBlues4U: bets $0.30
Pergy21: calls $0.30
*** RIVER *** [Qd 7d Td As] [Ts]
Pergy21: checks
PlayTheBlues4U: checks
*** SHOW DOWN ***
Pergy21: shows [4d Ah] (two pair, Aces and Tens)
PlayTheBlues4U: shows [Ac 4s] (two pair, Aces and Tens)
Pergy21 collected $0.50 from pot
PlayTheBlues4U collected $0.50 from pot
*** SUMMARY ***
Total pot $1.05 | Rake $0.05
Board [Qd 7d Td As Ts]
Seat 1: turk1120 folded before Flop (didn't bet)
Seat 2: PlayTheBlues4U (button) showed [Ac 4s] and won ($0.50) with two pair, Aces and Tens
Seat 3: RNixon'sHead (small blind) folded before Flop
Seat 4: Pergy21 (big blind) showed [4d Ah] and won ($0.50) with two pair, Aces and Tens


*********** # 143 **************
PokerStars Hand #203841577280:  Hold'em No Limit ($0.02/$0.05 USD) - 2019/09/20 19:15:20 ET
Table 'Anser' 6-max Seat #1 is the button
Seat 1: CMc172 ($4.52 in chips)
Seat 2: Star6543 ($1.90 in chips)
Seat 3: dmakai ($5.92 in chips)
Seat 4: PlayTheBlues4U ($5 in chips)
Seat 5: lj001ll ($2.45 in chips)
Seat 6: DemolishIT ($9.60 in chips)
Star6543: posts small blind $0.02
dmakai: posts big blind $0.05
*** HOLE CARDS ***
Dealt to PlayTheBlues4U [7c 2d]
PlayTheBlues4U: folds
lj001ll: folds
DemolishIT: calls $0.05
CMc172: calls $0.05
Star6543: calls $0.03
dmakai: checks
*** FLOP *** [Ts 3s 3d]
Star6543: checks
dmakai: checks
DemolishIT: checks
CMc172: checks
*** TURN *** [Ts 3s 3d] [Qs]
Star6543: checks
dmakai: checks
DemolishIT: checks
CMc172: bets $0.10
Star6543: folds
dmakai: folds
DemolishIT: folds
Uncalled bet ($0.10) returned to CMc172
CMc172 collected $0.19 from pot
CMc172: doesn't show hand
*** SUMMARY ***
Total pot $0.20 | Rake $0.01
Board [Ts 3s 3d Qs]
Seat 1: CMc172 (button) collected ($0.19)
Seat 2: Star6543 (small blind) folded on the Turn
Seat 3: dmakai (big blind) folded on the Turn
Seat 4: PlayTheBlues4U folded before Flop (didn't bet)
Seat 5: lj001ll folded before Flop (didn't bet)
Seat 6: DemolishIT folded on the Turn


*********** # 144 **************
PokerStars Hand #203841577262:  Hold'em No Limit ($0.05/$0.10 USD) - 2019/09/20 19:15:10 ET
Table 'Lacerta' 6-max Seat #1 is the button
Seat 1: turk1120 ($7.25 in chips)
Seat 2: PlayTheBlues4U ($10.97 in chips)
Seat 3: RNixon'sHead ($11.97 in chips)
Seat 4: Pergy21 ($9.60 in chips)
Seat 6: TylerD1775 ($19.95 in chips)
PlayTheBlues4U: posts small blind $0.05
RNixon'sHead: posts big blind $0.10
*** HOLE CARDS ***
Dealt to PlayTheBlues4U [7h Jc]
Pergy21: folds
TylerD1775: folds
turk1120: folds
tomasz2016 leaves the table
PlayTheBlues4U: calls $0.05
TylerD1775 leaves the table
RNixon'sHead: checks
*** FLOP *** [6h Qc 8s]
PlayTheBlues4U: checks
RNixon'sHead: bets $0.13
PlayTheBlues4U: folds
Uncalled bet ($0.13) returned to RNixon'sHead
RNixon'sHead collected $0.19 from pot
RNixon'sHead: doesn't show hand
*** SUMMARY ***
Total pot $0.20 | Rake $0.01
Board [6h Qc 8s]
Seat 1: turk1120 (button) folded before Flop (didn't bet)
Seat 2: PlayTheBlues4U (small blind) folded on the Flop
Seat 3: RNixon'sHead (big blind) collected ($0.19)
Seat 4: Pergy21 folded before Flop (didn't bet)
Seat 6: TylerD1775 folded before Flop (didn't bet)


*********** # 145 **************
PokerStars Hand #203841577220:  Hold'em No Limit ($0.02/$0.05 USD) - 2019/09/20 19:14:50 ET
Table 'Anser' 6-max Seat #6 is the button
Seat 1: CMc172 ($4.43 in chips)
Seat 2: Star6543 ($2 in chips)
Seat 3: dmakai ($5.92 in chips)
Seat 4: PlayTheBlues4U ($5 in chips)
Seat 5: lj001ll ($2.45 in chips)
Seat 6: DemolishIT ($9.60 in chips)
CMc172: posts small blind $0.02
Star6543: posts big blind $0.05
*** HOLE CARDS ***
Dealt to PlayTheBlues4U [6s 8s]
dmakai: folds
PlayTheBlues4U: folds
lj001ll: folds
DemolishIT: folds
CMc172: calls $0.03
Star6543: checks
*** FLOP *** [Ah 9s Kc]
CMc172: checks
Star6543: checks
*** TURN *** [Ah 9s Kc] [3s]
CMc172: checks
Star6543: bets $0.05
CMc172: calls $0.05
*** RIVER *** [Ah 9s Kc 3s] [7s]
CMc172: checks
Star6543: checks
*** SHOW DOWN ***
CMc172: shows [Jd Js] (a pair of Jacks)
Star6543: mucks hand
CMc172 collected $0.19 from pot
*** SUMMARY ***
Total pot $0.20 | Rake $0.01
Board [Ah 9s Kc 3s 7s]
Seat 1: CMc172 (small blind) showed [Jd Js] and won ($0.19) with a pair of Jacks
Seat 2: Star6543 (big blind) mucked [8d 3c]
Seat 3: dmakai folded before Flop (didn't bet)
Seat 4: PlayTheBlues4U folded before Flop (didn't bet)
Seat 5: lj001ll folded before Flop (didn't bet)
Seat 6: DemolishIT (button) folded before Flop (didn't bet)


*********** # 146 **************
PokerStars Hand #203841577190:  Hold'em No Limit ($0.05/$0.10 USD) - 2019/09/20 19:14:32 ET
Table 'Lacerta' 6-max Seat #6 is the button
Seat 1: turk1120 ($7.30 in chips)
Seat 2: PlayTheBlues4U ($9.38 in chips)
Seat 3: RNixon'sHead ($11.97 in chips)
Seat 4: Pergy21 ($9.80 in chips)
Seat 5: tomasz2016 ($1.50 in chips)
Seat 6: TylerD1775 ($19.95 in chips)
turk1120: posts small blind $0.05
PlayTheBlues4U: posts big blind $0.10
*** HOLE CARDS ***
Dealt to PlayTheBlues4U [Kd As]
RNixon'sHead: folds
Pergy21: raises $0.10 to $0.20
tomasz2016: raises $0.55 to $0.75
TylerD1775: folds
turk1120: folds
PlayTheBlues4U: raises $1.15 to $1.90
Pergy21: folds
tomasz2016: calls $0.75 and is all-in
Uncalled bet ($0.40) returned to PlayTheBlues4U
*** FLOP *** [2c 8d 5s]
*** TURN *** [2c 8d 5s] [Ad]
*** RIVER *** [2c 8d 5s Ad] [3s]
*** SHOW DOWN ***
PlayTheBlues4U: shows [Kd As] (a pair of Aces)
tomasz2016: shows [6c Ac] (a pair of Aces - lower kicker)
PlayTheBlues4U collected $3.09 from pot
*** SUMMARY ***
Total pot $3.25 | Rake $0.16
Board [2c 8d 5s Ad 3s]
Seat 1: turk1120 (small blind) folded before Flop
Seat 2: PlayTheBlues4U (big blind) showed [Kd As] and won ($3.09) with a pair of Aces
Seat 3: RNixon'sHead folded before Flop (didn't bet)
Seat 4: Pergy21 folded before Flop
Seat 5: tomasz2016 showed [6c Ac] and lost with a pair of Aces
Seat 6: TylerD1775 (button) folded before Flop (didn't bet)


*********** # 147 **************
PokerStars Hand #203841577150:  Hold'em No Limit ($0.05/$0.10 USD) - 2019/09/20 19:14:11 ET
Table 'Lacerta' 6-max Seat #5 is the button
Seat 1: turk1120 ($7.21 in chips)
Seat 2: PlayTheBlues4U ($9.38 in chips)
Seat 3: RNixon'sHead ($11.97 in chips)
Seat 4: Pergy21 ($9.80 in chips)
Seat 5: tomasz2016 ($1.50 in chips)
Seat 6: TylerD1775 ($20.05 in chips)
TylerD1775: posts small blind $0.05
turk1120: posts big blind $0.10
*** HOLE CARDS ***
Dealt to PlayTheBlues4U [7h 3c]
PlayTheBlues4U: folds
RNixon'sHead: folds
Pergy21: folds
tomasz2016: folds
TylerD1775: calls $0.05
turk1120: checks
*** FLOP *** [4c Js 6c]
TylerD1775: checks
turk1120: checks
*** TURN *** [4c Js 6c] [2d]
TylerD1775: checks
turk1120: bets $0.10
TylerD1775: folds
Uncalled bet ($0.10) returned to turk1120
turk1120 collected $0.19 from pot
*** SUMMARY ***
Total pot $0.20 | Rake $0.01
Board [4c Js 6c 2d]
Seat 1: turk1120 (big blind) collected ($0.19)
Seat 2: PlayTheBlues4U folded before Flop (didn't bet)
Seat 3: RNixon'sHead folded before Flop (didn't bet)
Seat 4: Pergy21 folded before Flop (didn't bet)
Seat 5: tomasz2016 (button) folded before Flop (didn't bet)
Seat 6: TylerD1775 (small blind) folded on the Turn


*********** # 148 **************
PokerStars Hand #203841577097:  Hold'em No Limit ($0.02/$0.05 USD) - 2019/09/20 19:13:40 ET
Table 'Anser' 6-max Seat #5 is the button
Seat 1: CMc172 ($4.53 in chips)
Seat 3: dmakai ($5.92 in chips)
Seat 4: PlayTheBlues4U ($5 in chips)
Seat 5: lj001ll ($3.78 in chips)
Seat 6: DemolishIT ($8.31 in chips)
DemolishIT: posts small blind $0.02
CMc172: posts big blind $0.05
*** HOLE CARDS ***
Dealt to PlayTheBlues4U [Td 7s]
dmakai: folds
PlayTheBlues4U: folds
lj001ll: raises $0.05 to $0.10
Star6543 said, "fkn donk gets lucky"
DemolishIT: calls $0.08
CMc172: calls $0.05
*** FLOP *** [Jc Ac 4s]
DemolishIT: bets $0.28
CMc172: folds
lj001ll: calls $0.28
*** TURN *** [Jc Ac 4s] [2c]
DemolishIT: checks
lj001ll: checks
*** RIVER *** [Jc Ac 4s 2c] [Ks]
DemolishIT: bets $0.95
lj001ll: calls $0.95
*** SHOW DOWN ***
DemolishIT: shows [Kc 7c] (a flush, Ace high)
lj001ll: mucks hand
DemolishIT collected $2.62 from pot
*** SUMMARY ***
Total pot $2.76 | Rake $0.14
Board [Jc Ac 4s 2c Ks]
Seat 1: CMc172 (big blind) folded on the Flop
Seat 3: dmakai folded before Flop (didn't bet)
Seat 4: PlayTheBlues4U folded before Flop (didn't bet)
Seat 5: lj001ll (button) mucked [Ad 9h]
Seat 6: DemolishIT (small blind) showed [Kc 7c] and won ($2.62) with a flush, Ace high


*********** # 149 **************
PokerStars Hand #203841577078:  Hold'em No Limit ($0.05/$0.10 USD) - 2019/09/20 19:13:31 ET
Table 'Lacerta' 6-max Seat #4 is the button
Seat 1: turk1120 ($7.68 in chips)
Seat 2: PlayTheBlues4U ($9.85 in chips)
Seat 3: RNixon'sHead ($11.97 in chips)
Seat 4: Pergy21 ($9.80 in chips)
Seat 5: tomasz2016 ($1.55 in chips)
Seat 6: TylerD1775 ($19.13 in chips)
tomasz2016: posts small blind $0.05
TylerD1775: posts big blind $0.10
*** HOLE CARDS ***
Dealt to PlayTheBlues4U [2h 2s]
turk1120: calls $0.10
PlayTheBlues4U: calls $0.10
RNixon'sHead: folds
Pergy21: folds
tomasz2016: folds
TylerD1775: raises $0.37 to $0.47
turk1120: calls $0.37
PlayTheBlues4U: calls $0.37
*** FLOP *** [7c 7s 5c]
TylerD1775: bets $1.14
turk1120: folds
PlayTheBlues4U: folds
Uncalled bet ($1.14) returned to TylerD1775
TylerD1775 collected $1.39 from pot
*** SUMMARY ***
Total pot $1.46 | Rake $0.07
Board [7c 7s 5c]
Seat 1: turk1120 folded on the Flop
Seat 2: PlayTheBlues4U folded on the Flop
Seat 3: RNixon'sHead folded before Flop (didn't bet)
Seat 4: Pergy21 (button) folded before Flop (didn't bet)
Seat 5: tomasz2016 (small blind) folded before Flop
Seat 6: TylerD1775 (big blind) collected ($1.39)


*********** # 150 **************
PokerStars Hand #203841577021:  Hold'em No Limit ($0.05/$0.10 USD) - 2019/09/20 19:13:01 ET
Table 'Lacerta' 6-max Seat #3 is the button
Seat 1: turk1120 ($7.50 in chips)
Seat 2: PlayTheBlues4U ($9.85 in chips)
Seat 3: RNixon'sHead ($11.97 in chips)
Seat 4: Pergy21 ($9.90 in chips)
Seat 5: tomasz2016 ($1.65 in chips)
Seat 6: TylerD1775 ($19.13 in chips)
Pergy21: posts small blind $0.05
tomasz2016: posts big blind $0.10
*** HOLE CARDS ***
Dealt to PlayTheBlues4U [7d 8s]
TylerD1775: folds
turk1120: calls $0.10
PlayTheBlues4U: folds
RNixon'sHead: folds
Pergy21: calls $0.05
tomasz2016: checks
*** FLOP *** [4d Ad Kh]
Pergy21: checks
tomasz2016: checks
turk1120: bets $0.10
Pergy21: folds
tomasz2016: folds
Uncalled bet ($0.10) returned to turk1120
turk1120 collected $0.28 from pot
*** SUMMARY ***
Total pot $0.30 | Rake $0.02
Board [4d Ad Kh]
Seat 1: turk1120 collected ($0.28)
Seat 2: PlayTheBlues4U folded before Flop (didn't bet)
Seat 3: RNixon'sHead (button) folded before Flop (didn't bet)
Seat 4: Pergy21 (small blind) folded on the Flop
Seat 5: tomasz2016 (big blind) folded on the Flop
Seat 6: TylerD1775 folded before Flop (didn't bet)


*********** # 151 **************
PokerStars Hand #203841576998:  Hold'em No Limit ($0.02/$0.05 USD) - 2019/09/20 19:12:44 ET
Table 'Anser' 6-max Seat #4 is the button
Seat 1: CMc172 ($4.58 in chips)
Seat 2: Star6543 ($1.90 in chips)
Seat 3: dmakai ($4 in chips)
Seat 4: PlayTheBlues4U ($0.63 in chips)
Seat 5: lj001ll ($3.80 in chips)
Seat 6: DemolishIT ($8.46 in chips)
lj001ll: posts small blind $0.02
DemolishIT: posts big blind $0.05
Star6543: posts big blind $0.05
dmakai: posts big blind $0.05
*** HOLE CARDS ***
Dealt to PlayTheBlues4U [5c 2s]
CMc172: calls $0.05
Star6543: checks
dmakai: checks
PlayTheBlues4U: folds
lj001ll: folds
DemolishIT: checks
*** FLOP *** [Jd Jh Kc]
DemolishIT: checks
CMc172: checks
Star6543: bets $0.10
dmakai: calls $0.10
DemolishIT: calls $0.10
CMc172: folds
*** TURN *** [Jd Jh Kc] [Th]
DemolishIT: checks
Star6543: bets $0.20
dmakai: raises $0.50 to $0.70
DemolishIT: folds
Star6543: calls $0.50
*** RIVER *** [Jd Jh Kc Th] [3c]
Star6543: checks
dmakai: bets $1.80
Star6543: calls $1.05 and is all-in
Uncalled bet ($0.75) returned to dmakai
*** SHOW DOWN ***
dmakai: shows [Js 3s] (a full house, Jacks full of Threes)
Star6543: shows [Ts Ks] (two pair, Kings and Jacks)
dmakai collected $3.82 from pot
*** SUMMARY ***
Total pot $4.02 | Rake $0.20
Board [Jd Jh Kc Th 3c]
Seat 1: CMc172 folded on the Flop
Seat 2: Star6543 showed [Ts Ks] and lost with two pair, Kings and Jacks
Seat 3: dmakai showed [Js 3s] and won ($3.82) with a full house, Jacks full of Threes
Seat 4: PlayTheBlues4U (button) folded before Flop (didn't bet)
Seat 5: lj001ll (small blind) folded before Flop
Seat 6: DemolishIT (big blind) folded on the Turn


*********** # 152 **************
PokerStars Hand #203841576996:  Hold'em No Limit ($0.05/$0.10 USD) - 2019/09/20 19:12:41 ET
Table 'Lacerta' 6-max Seat #2 is the button
Seat 1: turk1120 ($7.50 in chips)
Seat 2: PlayTheBlues4U ($9.85 in chips)
Seat 3: RNixon'sHead ($12.02 in chips)
Seat 4: Pergy21 ($10 in chips)
Seat 5: tomasz2016 ($1.50 in chips)
Seat 6: TylerD1775 ($19.13 in chips)
RNixon'sHead: posts small blind $0.05
Pergy21: posts big blind $0.10
*** HOLE CARDS ***
Dealt to PlayTheBlues4U [Tc 4s]
tomasz2016: raises $0.25 to $0.35
TylerD1775: folds
turk1120: folds
PlayTheBlues4U: folds
RNixon'sHead: folds
Pergy21: folds
Uncalled bet ($0.25) returned to tomasz2016
tomasz2016 collected $0.25 from pot
tomasz2016: doesn't show hand
*** SUMMARY ***
Total pot $0.25 | Rake $0
Seat 1: turk1120 folded before Flop (didn't bet)
Seat 2: PlayTheBlues4U (button) folded before Flop (didn't bet)
Seat 3: RNixon'sHead (small blind) folded before Flop
Seat 4: Pergy21 (big blind) folded before Flop
Seat 5: tomasz2016 collected ($0.25)
Seat 6: TylerD1775 folded before Flop (didn't bet)


*********** # 153 **************
PokerStars Hand #203841576933:  Hold'em No Limit ($0.05/$0.10 USD) - 2019/09/20 19:12:05 ET
Table 'Lacerta' 6-max Seat #1 is the button
Seat 1: turk1120 ($8 in chips)
Seat 2: PlayTheBlues4U ($9.90 in chips)
Seat 3: RNixon'sHead ($11.52 in chips)
Seat 5: tomasz2016 ($1.50 in chips)
Seat 6: TylerD1775 ($19.13 in chips)
PlayTheBlues4U: posts small blind $0.05
RNixon'sHead: posts big blind $0.10
*** HOLE CARDS ***
Dealt to PlayTheBlues4U [4c Jh]
tomasz2016: folds
Pergy21 joins the table at seat #4
TylerD1775: folds
turk1120: calls $0.10
PlayTheBlues4U: folds
RNixon'sHead: raises $0.40 to $0.50
turk1120: calls $0.40
*** FLOP *** [6h 9h Qc]
RNixon'sHead: bets $0.52
turk1120: folds
Uncalled bet ($0.52) returned to RNixon'sHead
RNixon'sHead collected $1 from pot
RNixon'sHead: doesn't show hand
*** SUMMARY ***
Total pot $1.05 | Rake $0.05
Board [6h 9h Qc]
Seat 1: turk1120 (button) folded on the Flop
Seat 2: PlayTheBlues4U (small blind) folded before Flop
Seat 3: RNixon'sHead (big blind) collected ($1)
Seat 5: tomasz2016 folded before Flop (didn't bet)
Seat 6: TylerD1775 folded before Flop (didn't bet)


*********** # 154 **************
PokerStars Hand #203841576892:  Hold'em No Limit ($0.02/$0.05 USD) - 2019/09/20 19:11:43 ET
Table 'Anser' 6-max Seat #1 is the button
Seat 1: CMc172 ($4.78 in chips)
Seat 4: PlayTheBlues4U ($4.96 in chips)
Seat 5: lj001ll ($3.85 in chips)
Seat 6: DemolishIT ($4.33 in chips)
Star6543 will be allowed to play after the button
dmakai will be allowed to play after the button
PlayTheBlues4U: posts small blind $0.02
lj001ll: posts big blind $0.05
*** HOLE CARDS ***
Dealt to PlayTheBlues4U [4s As]
DemolishIT: raises $0.15 to $0.20
CMc172: calls $0.20
PlayTheBlues4U: calls $0.18
lj001ll: folds
*** FLOP *** [Js Qs Tc]
PlayTheBlues4U: bets $0.30
DemolishIT: raises $0.95 to $1.25
CMc172: folds
PlayTheBlues4U: raises $3.51 to $4.76 and is all-in
DemolishIT: calls $2.88 and is all-in
Uncalled bet ($0.63) returned to PlayTheBlues4U
*** TURN *** [Js Qs Tc] [Th]
*** RIVER *** [Js Qs Tc Th] [Qd]
*** SHOW DOWN ***
PlayTheBlues4U: shows [4s As] (two pair, Queens and Tens)
DemolishIT: shows [Ah Ad] (two pair, Aces and Queens)
DemolishIT collected $8.46 from pot
*** SUMMARY ***
Total pot $8.91 | Rake $0.45
Board [Js Qs Tc Th Qd]
Seat 1: CMc172 (button) folded on the Flop
Seat 4: PlayTheBlues4U (small blind) showed [4s As] and lost with two pair, Queens and Tens
Seat 5: lj001ll (big blind) folded before Flop
Seat 6: DemolishIT showed [Ah Ad] and won ($8.46) with two pair, Aces and Queens


*********** # 155 **************
PokerStars Hand #203841576877:  Hold'em No Limit ($0.05/$0.10 USD) - 2019/09/20 19:11:35 ET
Table 'Lacerta' 6-max Seat #6 is the button
Seat 1: turk1120 ($8.05 in chips)
Seat 2: PlayTheBlues4U ($10 in chips)
Seat 5: tomasz2016 ($1.50 in chips)
Seat 6: TylerD1775 ($18.98 in chips)
turk1120: posts small blind $0.05
PlayTheBlues4U: posts big blind $0.10
*** HOLE CARDS ***
Dealt to PlayTheBlues4U [6c Jh]
tomasz2016: folds
TylerD1775: raises $0.15 to $0.25
turk1120: folds
PlayTheBlues4U: folds
Uncalled bet ($0.15) returned to TylerD1775
TylerD1775 collected $0.25 from pot
*** SUMMARY ***
Total pot $0.25 | Rake $0
Seat 1: turk1120 (small blind) folded before Flop
Seat 2: PlayTheBlues4U (big blind) folded before Flop
Seat 5: tomasz2016 folded before Flop (didn't bet)
Seat 6: TylerD1775 (button) collected ($0.25)


*********** # 156 **************
PokerStars Hand #203841576786:  Hold'em No Limit ($0.02/$0.05 USD) - 2019/09/20 19:10:40 ET
Table 'Anser' 6-max Seat #6 is the button
Seat 1: CMc172 ($4.93 in chips)
Seat 4: PlayTheBlues4U ($5.01 in chips)
Seat 5: lj001ll ($3.62 in chips)
Seat 6: DemolishIT ($4.38 in chips)
CMc172: posts small blind $0.02
Star6543 joins the table at seat #2
dmakai is disconnected
dmakai has timed out
dmakai: is sitting out
PlayTheBlues4U: posts big blind $0.05
*** HOLE CARDS ***
Dealt to PlayTheBlues4U [7h 3c]
lj001ll: calls $0.05
DemolishIT: calls $0.05
CMc172: calls $0.03
PlayTheBlues4U: checks
*** FLOP *** [6h Ad 2c]
CMc172: checks
PlayTheBlues4U: checks
lj001ll: checks
DemolishIT: checks
*** TURN *** [6h Ad 2c] [Qs]
CMc172: checks
PlayTheBlues4U: checks
lj001ll: bets $0.10
DemolishIT: folds
CMc172: calls $0.10
PlayTheBlues4U: folds
*** RIVER *** [6h Ad 2c Qs] [6s]
CMc172: checks
lj001ll: checks
*** SHOW DOWN ***
CMc172: shows [3h 5s] (a pair of Sixes)
lj001ll: shows [Kc Td] (a pair of Sixes - Ace+King kicker)
lj001ll collected $0.38 from pot
*** SUMMARY ***
Total pot $0.40 | Rake $0.02
Board [6h Ad 2c Qs 6s]
Seat 1: CMc172 (small blind) showed [3h 5s] and lost with a pair of Sixes
Seat 4: PlayTheBlues4U (big blind) folded on the Turn
Seat 5: lj001ll showed [Kc Td] and won ($0.38) with a pair of Sixes
Seat 6: DemolishIT (button) folded on the Turn


*********** # 157 **************
PokerStars Hand #203841576691:  Hold'em No Limit ($0.02/$0.05 USD) - 2019/09/20 19:09:51 ET
Table 'Anser' 6-max Seat #5 is the button
Seat 1: CMc172 ($4.91 in chips)
Seat 4: PlayTheBlues4U ($5 in chips)
Seat 5: lj001ll ($3.62 in chips)
Seat 6: DemolishIT ($4.43 in chips)
DemolishIT: posts small blind $0.02
CMc172: posts big blind $0.05
*** HOLE CARDS ***
Dealt to PlayTheBlues4U [6c 6h]
dmakai joins the table at seat #3
PlayTheBlues4U: calls $0.05
lj001ll: folds
DemolishIT: calls $0.03
CMc172: checks
*** FLOP *** [Tc 7d 7h]
DemolishIT: checks
CMc172: checks
PlayTheBlues4U: bets $0.10
DemolishIT: folds
CMc172: calls $0.10
*** TURN *** [Tc 7d 7h] [Td]
CMc172: checks
PlayTheBlues4U: checks
*** RIVER *** [Tc 7d 7h Td] [Ts]
CMc172: checks
PlayTheBlues4U: checks
*** SHOW DOWN ***
CMc172: shows [8d Jh] (a full house, Tens full of Sevens)
PlayTheBlues4U: shows [6c 6h] (a full house, Tens full of Sevens)
CMc172 collected $0.17 from pot
PlayTheBlues4U collected $0.16 from pot
*** SUMMARY ***
Total pot $0.35 | Rake $0.02
Board [Tc 7d 7h Td Ts]
Seat 1: CMc172 (big blind) showed [8d Jh] and won ($0.17) with a full house, Tens full of Sevens
Seat 4: PlayTheBlues4U showed [6c 6h] and won ($0.16) with a full house, Tens full of Sevens
Seat 5: lj001ll (button) folded before Flop (didn't bet)
Seat 6: DemolishIT (small blind) folded on the Flop


*********** # 158 **************
PokerStars Hand #203841576619:  Hold'em No Limit ($0.02/$0.05 USD) - 2019/09/20 19:09:11 ET
Table 'Anser' 6-max Seat #4 is the button
Seat 1: CMc172 ($4.96 in chips)
Seat 4: PlayTheBlues4U ($5 in chips)
Seat 5: lj001ll ($3.64 in chips)
Seat 6: DemolishIT ($4.37 in chips)
lj001ll: posts small blind $0.02
DemolishIT: posts big blind $0.05
*** HOLE CARDS ***
Dealt to PlayTheBlues4U [3s Qs]
CMc172: calls $0.05
PlayTheBlues4U: folds
lj001ll: folds
DemolishIT: checks
*** FLOP *** [8c Kd 6h]
DemolishIT: checks
CMc172: checks
*** TURN *** [8c Kd 6h] [4h]
DemolishIT: checks
CMc172: checks
*** RIVER *** [8c Kd 6h 4h] [Ts]
DemolishIT: checks
CMc172: checks
*** SHOW DOWN ***
DemolishIT: shows [4c Th] (two pair, Tens and Fours)
CMc172: mucks hand
DemolishIT collected $0.11 from pot
*** SUMMARY ***
Total pot $0.12 | Rake $0.01
Board [8c Kd 6h 4h Ts]
Seat 1: CMc172 mucked [2d Ac]
Seat 4: PlayTheBlues4U (button) folded before Flop (didn't bet)
Seat 5: lj001ll (small blind) folded before Flop
Seat 6: DemolishIT (big blind) showed [4c Th] and won ($0.11) with two pair, Tens and Fours


*********** # 159 **************
PokerStars Hand #203841576497:  Hold'em No Limit ($0.02/$0.05 USD) - 2019/09/20 19:08:11 ET
Table 'Anser' 6-max Seat #1 is the button
Seat 1: CMc172 ($5.01 in chips)
Seat 4: PlayTheBlues4U ($5.05 in chips)
Seat 5: lj001ll ($3.50 in chips)
Seat 6: DemolishIT ($4.42 in chips)
PlayTheBlues4U: posts small blind $0.02
lj001ll: posts big blind $0.05
*** HOLE CARDS ***
Dealt to PlayTheBlues4U [6h 9s]
DemolishIT: calls $0.05
CMc172: calls $0.05
PlayTheBlues4U: calls $0.03
lj001ll: checks
*** FLOP *** [8h Kh 2s]
PlayTheBlues4U: checks
lj001ll: checks
DemolishIT: checks
CMc172: checks
*** TURN *** [8h Kh 2s] [Qc]
PlayTheBlues4U: checks
lj001ll: checks
DemolishIT: checks
CMc172: checks
*** RIVER *** [8h Kh 2s Qc] [7c]
PlayTheBlues4U: checks
lj001ll: checks
DemolishIT: checks
CMc172: checks
*** SHOW DOWN ***
PlayTheBlues4U: shows [6h 9s] (high card King)
lj001ll: shows [3s 2c] (a pair of Deuces)
DemolishIT: mucks hand
CMc172: mucks hand
lj001ll collected $0.19 from pot
*** SUMMARY ***
Total pot $0.20 | Rake $0.01
Board [8h Kh 2s Qc 7c]
Seat 1: CMc172 (button) mucked [As Jd]
Seat 4: PlayTheBlues4U (small blind) showed [6h 9s] and lost with high card King
Seat 5: lj001ll (big blind) showed [3s 2c] and won ($0.19) with a pair of Deuces
Seat 6: DemolishIT mucked [5d Ad]


*********** # 160 **************
PokerStars Hand #203841576448:  Hold'em No Limit ($0.02/$0.05 USD) - 2019/09/20 19:07:45 ET
Table 'Anser' 6-max Seat #6 is the button
Seat 1: CMc172 ($4.96 in chips)
Seat 4: PlayTheBlues4U ($5.10 in chips)
Seat 6: DemolishIT ($4.42 in chips)
CMc172: posts small blind $0.02
PlayTheBlues4U: posts big blind $0.05
lj001ll: sits out
*** HOLE CARDS ***
Dealt to PlayTheBlues4U [5c 6h]
DemolishIT: folds
CMc172: calls $0.03
PlayTheBlues4U: checks
*** FLOP *** [Qs 2h 7s]
CMc172: checks
PlayTheBlues4U: checks
*** TURN *** [Qs 2h 7s] [2c]
CMc172: checks
PlayTheBlues4U: checks
*** RIVER *** [Qs 2h 7s 2c] [4c]
CMc172: bets $0.05
PlayTheBlues4U: folds
Uncalled bet ($0.05) returned to CMc172
CMc172 collected $0.10 from pot
CMc172: doesn't show hand
*** SUMMARY ***
Total pot $0.10 | Rake $0
Board [Qs 2h 7s 2c 4c]
Seat 1: CMc172 (small blind) collected ($0.10)
Seat 4: PlayTheBlues4U (big blind) folded on the River
Seat 6: DemolishIT (button) folded before Flop (didn't bet)


*********** # 161 **************
PokerStars Hand #203841576407:  Hold'em No Limit ($0.02/$0.05 USD) - 2019/09/20 19:07:27 ET
Table 'Anser' 6-max Seat #4 is the button
Seat 1: CMc172 ($5.11 in chips)
Seat 4: PlayTheBlues4U ($4.95 in chips)
Seat 6: DemolishIT ($4.44 in chips)
lj001ll will be allowed to play after the button
DemolishIT: posts small blind $0.02
CMc172: posts big blind $0.05
*** HOLE CARDS ***
Dealt to PlayTheBlues4U [9c Kh]
PlayTheBlues4U: raises $0.10 to $0.15
DemolishIT: folds
CMc172: calls $0.10
*** FLOP *** [2s 2h Th]
CMc172: checks
PlayTheBlues4U: bets $0.15
CMc172: folds
Uncalled bet ($0.15) returned to PlayTheBlues4U
PlayTheBlues4U collected $0.30 from pot
PlayTheBlues4U: doesn't show hand
*** SUMMARY ***
Total pot $0.32 | Rake $0.02
Board [2s 2h Th]
Seat 1: CMc172 (big blind) folded on the Flop
Seat 4: PlayTheBlues4U (button) collected ($0.30)
Seat 6: DemolishIT (small blind) folded before Flop


*********** # 162 **************
PokerStars Hand #203841576295:  Hold'em No Limit ($0.02/$0.05 USD) - 2019/09/20 19:06:38 ET
Table 'Anser' 6-max Seat #1 is the button
Seat 1: CMc172 ($5.49 in chips)
Seat 3: HardMerch ($4.21 in chips)
Seat 4: PlayTheBlues4U ($5 in chips)
Seat 6: DemolishIT ($4 in chips)
HardMerch: posts small blind $0.02
PlayTheBlues4U: posts big blind $0.05
DemolishIT: posts big blind $0.05
*** HOLE CARDS ***
Dealt to PlayTheBlues4U [Js 4h]
DemolishIT: checks
CMc172: calls $0.05
HardMerch: calls $0.03
PlayTheBlues4U: checks
*** FLOP *** [7c Ad 7h]
HardMerch: checks
PlayTheBlues4U: checks
DemolishIT: checks
CMc172: bets $0.05
HardMerch: folds
lj001ll joins the table at seat #5
HardMerch leaves the table
PlayTheBlues4U: folds
DemolishIT: calls $0.05
*** TURN *** [7c Ad 7h] [Ks]
DemolishIT: checks
CMc172: checks
*** RIVER *** [7c Ad 7h Ks] [Jd]
DemolishIT: bets $0.28
CMc172: calls $0.28
*** SHOW DOWN ***
DemolishIT: shows [7s As] (a full house, Sevens full of Aces)
CMc172: mucks hand
DemolishIT collected $0.82 from pot
*** SUMMARY ***
Total pot $0.86 | Rake $0.04
Board [7c Ad 7h Ks Jd]
Seat 1: CMc172 (button) mucked [7d 2h]
Seat 3: HardMerch (small blind) folded on the Flop
Seat 4: PlayTheBlues4U (big blind) folded on the Flop
Seat 6: DemolishIT showed [7s As] and won ($0.82) with a full house, Sevens full of Aces


*********** # 163 **************
PokerStars Hand #203824859333:  Hold'em No Limit ($0.02/$0.05 USD) - 2019/09/19 21:13:41 ET
Table 'Pollux' 6-max Seat #6 is the button
Seat 1: PornoBob777 ($7.41 in chips)
Seat 2: absalon1320 ($3.24 in chips)
Seat 3: PlayTheBlues4U ($6.08 in chips)
Seat 5: JohanFlohan ($2.20 in chips)
Seat 6: Part77 ($4.90 in chips)
PornoBob777: posts small blind $0.02
absalon1320: posts big blind $0.05
timdalyiiiNJ: sits out
*** HOLE CARDS ***
Dealt to PlayTheBlues4U [Ad 9h]
PlayTheBlues4U: raises $0.10 to $0.15
JohanFlohan: calls $0.15
Part77: folds
PornoBob777: folds
absalon1320: calls $0.10
*** FLOP *** [6s 5s 7h]
absalon1320: bets $0.25
PlayTheBlues4U: folds
PlayTheBlues4U leaves the table
JohanFlohan is connected
JohanFlohan: calls $0.25
*** TURN *** [6s 5s 7h] [Qc]
absalon1320: checks
JohanFlohan: checks
*** RIVER *** [6s 5s 7h Qc] [4c]
absalon1320: bets $0.90
JohanFlohan: calls $0.90
*** SHOW DOWN ***
absalon1320: shows [8s Ac] (a straight, Four to Eight)
JohanFlohan: mucks hand
absalon1320 collected $2.63 from pot
*** SUMMARY ***
Total pot $2.77 | Rake $0.14
Board [6s 5s 7h Qc 4c]
Seat 1: PornoBob777 (small blind) folded before Flop
Seat 2: absalon1320 (big blind) showed [8s Ac] and won ($2.63) with a straight, Four to Eight
Seat 3: PlayTheBlues4U folded on the Flop
Seat 5: JohanFlohan mucked [9d 5d]
Seat 6: Part77 (button) folded before Flop (didn't bet)


*********** # 164 **************
PokerStars Hand #203824859159:  Hold'em No Limit ($0.02/$0.05 USD) - 2019/09/19 21:12:54 ET
Table 'Semele' 6-max Seat #5 is the button
Seat 2: V@nce12 ($4.39 in chips)
Seat 3: PlayTheBlues4U ($7.47 in chips)
Seat 5: tss22 ($2.05 in chips)
Seat 6: liaocs2016 ($8.12 in chips)
liaocs2016: posts small blind $0.02
V@nce12: posts big blind $0.05
*** HOLE CARDS ***
Dealt to PlayTheBlues4U [9d 9h]
PlayTheBlues4U: raises $0.10 to $0.15
tss22: folds
liaocs2016: folds
V@nce12: folds
Uncalled bet ($0.10) returned to PlayTheBlues4U
PlayTheBlues4U collected $0.12 from pot
seags21 was removed from the table for failing to post
seags21 leaves the table
PlayTheBlues4U: doesn't show hand
*** SUMMARY ***
Total pot $0.12 | Rake $0
Seat 2: V@nce12 (big blind) folded before Flop
Seat 3: PlayTheBlues4U collected ($0.12)
Seat 5: tss22 (button) folded before Flop (didn't bet)
Seat 6: liaocs2016 (small blind) folded before Flop


*********** # 165 **************
PokerStars Hand #203824859119:  Hold'em No Limit ($0.02/$0.05 USD) - 2019/09/19 21:12:42 ET
Table 'Pollux' 6-max Seat #5 is the button
Seat 1: PornoBob777 ($6.82 in chips)
Seat 2: absalon1320 ($3.84 in chips)
Seat 3: PlayTheBlues4U ($6.08 in chips)
Seat 5: JohanFlohan ($2.20 in chips)
Seat 6: Part77 ($4.95 in chips)
Part77: posts small blind $0.02
PornoBob777: posts big blind $0.05
timdalyiiiNJ: sits out
*** HOLE CARDS ***
Dealt to PlayTheBlues4U [2h Td]
absalon1320: calls $0.05
PlayTheBlues4U: folds
JohanFlohan: folds
Part77: calls $0.03
PornoBob777: checks
*** FLOP *** [5d 7h Jh]
Part77: checks
PornoBob777: bets $0.25
absalon1320: calls $0.25
Part77: folds
*** TURN *** [5d 7h Jh] [6c]
PornoBob777: checks
absalon1320: bets $0.30
PornoBob777: raises $3.75 to $4.05
absalon1320: folds
Uncalled bet ($3.75) returned to PornoBob777
PornoBob777 collected $1.19 from pot
PornoBob777: doesn't show hand
*** SUMMARY ***
Total pot $1.25 | Rake $0.06
Board [5d 7h Jh 6c]
Seat 1: PornoBob777 (big blind) collected ($1.19)
Seat 2: absalon1320 folded on the Turn
Seat 3: PlayTheBlues4U folded before Flop (didn't bet)
Seat 5: JohanFlohan (button) folded before Flop (didn't bet)
Seat 6: Part77 (small blind) folded on the Flop


*********** # 166 **************
PokerStars Hand #203824859069:  Hold'em No Limit ($0.02/$0.05 USD) - 2019/09/19 21:12:30 ET
Table 'Semele' 6-max Seat #3 is the button
Seat 2: V@nce12 ($4.51 in chips)
Seat 3: PlayTheBlues4U ($7.47 in chips)
Seat 5: tss22 ($1.88 in chips)
Seat 6: liaocs2016 ($8.17 in chips)
tss22: posts small blind $0.02
liaocs2016: posts big blind $0.05
*** HOLE CARDS ***
Dealt to PlayTheBlues4U [Qs 2c]
V@nce12: raises $0.07 to $0.12
PlayTheBlues4U: folds
tss22: raises $1.76 to $1.88 and is all-in
liaocs2016: folds
V@nce12: folds
Uncalled bet ($1.76) returned to tss22
tss22 collected $0.29 from pot
tss22: doesn't show hand
*** SUMMARY ***
Total pot $0.29 | Rake $0
Seat 2: V@nce12 folded before Flop
Seat 3: PlayTheBlues4U (button) folded before Flop (didn't bet)
Seat 5: tss22 (small blind) collected ($0.29)
Seat 6: liaocs2016 (big blind) folded before Flop


*********** # 167 **************
PokerStars Hand #203824859021:  Hold'em No Limit ($0.02/$0.05 USD) - 2019/09/19 21:12:15 ET
Table 'Semele' 6-max Seat #2 is the button
Seat 2: V@nce12 ($4.44 in chips)
Seat 3: PlayTheBlues4U ($7.49 in chips)
Seat 5: tss22 ($1.93 in chips)
Seat 6: liaocs2016 ($8.17 in chips)
PlayTheBlues4U: posts small blind $0.02
tss22: posts big blind $0.05
*** HOLE CARDS ***
Dealt to PlayTheBlues4U [2h Ks]
liaocs2016: folds
V@nce12: raises $0.07 to $0.12
PlayTheBlues4U: folds
seags21 is disconnected
tss22: folds
Uncalled bet ($0.07) returned to V@nce12
V@nce12 collected $0.12 from pot
V@nce12: doesn't show hand
*** SUMMARY ***
Total pot $0.12 | Rake $0
Seat 2: V@nce12 (button) collected ($0.12)
Seat 3: PlayTheBlues4U (small blind) folded before Flop
Seat 5: tss22 (big blind) folded before Flop
Seat 6: liaocs2016 folded before Flop (didn't bet)


*********** # 168 **************
PokerStars Hand #203824858891:  Hold'em No Limit ($0.02/$0.05 USD) - 2019/09/19 21:11:35 ET
Table 'Semele' 6-max Seat #6 is the button
Seat 2: V@nce12 ($4.39 in chips)
Seat 3: PlayTheBlues4U ($7.54 in chips)
Seat 4: crazy turfer ($4.91 in chips)
Seat 5: tss22 ($1.93 in chips)
Seat 6: liaocs2016 ($8.17 in chips)
V@nce12: posts small blind $0.02
PlayTheBlues4U: posts big blind $0.05
*** HOLE CARDS ***
Dealt to PlayTheBlues4U [Qd 9d]
crazy turfer has timed out
crazy turfer: folds
tss22: folds
liaocs2016: folds
V@nce12: calls $0.03
PlayTheBlues4U: checks
*** FLOP *** [7s 5s 4s]
V@nce12: checks
PlayTheBlues4U: checks
*** TURN *** [7s 5s 4s] [Th]
V@nce12: bets $0.06
PlayTheBlues4U: folds
Uncalled bet ($0.06) returned to V@nce12
V@nce12 collected $0.10 from pot
V@nce12: doesn't show hand
*** SUMMARY ***
Total pot $0.10 | Rake $0
Board [7s 5s 4s Th]
Seat 2: V@nce12 (small blind) collected ($0.10)
Seat 3: PlayTheBlues4U (big blind) folded on the Turn
Seat 4: crazy turfer folded before Flop (didn't bet)
Seat 5: tss22 folded before Flop (didn't bet)
Seat 6: liaocs2016 (button) folded before Flop (didn't bet)


*********** # 169 **************
PokerStars Hand #203824858850:  Hold'em No Limit ($0.02/$0.05 USD) - 2019/09/19 21:11:21 ET
Table 'Pollux' 6-max Seat #3 is the button
Seat 1: PornoBob777 ($5.06 in chips)
Seat 2: absalon1320 ($4.03 in chips)
Seat 3: PlayTheBlues4U ($7.32 in chips)
Seat 5: JohanFlohan ($2.64 in chips)
Seat 6: Part77 ($5 in chips)
JohanFlohan: posts small blind $0.02
Part77: posts big blind $0.05
absalon1320: posts small & big blinds $0.07
*** HOLE CARDS ***
Dealt to PlayTheBlues4U [Jd Ad]
PornoBob777: raises $0.12 to $0.17
absalon1320: calls $0.12
PlayTheBlues4U: raises $0.27 to $0.44
timdalyiiiNJ joins the table at seat #4
JohanFlohan: calls $0.42
Part77: folds
PornoBob777: calls $0.27
absalon1320: folds
*** FLOP *** [9s Ks 4c]
JohanFlohan: checks
PornoBob777: checks
PlayTheBlues4U: bets $0.80
JohanFlohan: folds
PornoBob777: calls $0.80
*** TURN *** [9s Ks 4c] [6c]
PornoBob777: checks
PlayTheBlues4U: checks
*** RIVER *** [9s Ks 4c 6c] [Kc]
PornoBob777: checks
PlayTheBlues4U: checks
*** SHOW DOWN ***
PornoBob777: shows [9h 8s] (two pair, Kings and Nines)
PlayTheBlues4U: mucks hand
PornoBob777 collected $3 from pot
*** SUMMARY ***
Total pot $3.16 | Rake $0.16
Board [9s Ks 4c 6c Kc]
Seat 1: PornoBob777 showed [9h 8s] and won ($3) with two pair, Kings and Nines
Seat 2: absalon1320 folded before Flop
Seat 3: PlayTheBlues4U (button) mucked [Jd Ad]
Seat 5: JohanFlohan (small blind) folded on the Flop
Seat 6: Part77 (big blind) folded before Flop


*********** # 170 **************
PokerStars Hand #203824858769:  Hold'em No Limit ($0.02/$0.05 USD) - 2019/09/19 21:10:56 ET
Table 'Semele' 6-max Seat #5 is the button
Seat 2: V@nce12 ($4.74 in chips)
Seat 3: PlayTheBlues4U ($7.21 in chips)
Seat 4: crazy turfer ($4.91 in chips)
Seat 5: tss22 ($1.93 in chips)
Seat 6: liaocs2016 ($8.19 in chips)
liaocs2016: posts small blind $0.02
V@nce12: posts big blind $0.05
*** HOLE CARDS ***
Dealt to PlayTheBlues4U [Ad Ac]
PlayTheBlues4U: raises $0.10 to $0.15
crazy turfer: folds
tss22: folds
liaocs2016: folds
V@nce12: calls $0.10
*** FLOP *** [Js 9h 2h]
V@nce12: checks
PlayTheBlues4U: bets $0.20
V@nce12: calls $0.20
*** TURN *** [Js 9h 2h] [Kh]
V@nce12: checks
PlayTheBlues4U: checks
*** RIVER *** [Js 9h 2h Kh] [Ah]
V@nce12: checks
PlayTheBlues4U: checks
*** SHOW DOWN ***
V@nce12: shows [8s Ks] (a pair of Kings)
PlayTheBlues4U: shows [Ad Ac] (three of a kind, Aces)
PlayTheBlues4U collected $0.68 from pot
*** SUMMARY ***
Total pot $0.72 | Rake $0.04
Board [Js 9h 2h Kh Ah]
Seat 2: V@nce12 (big blind) showed [8s Ks] and lost with a pair of Kings
Seat 3: PlayTheBlues4U showed [Ad Ac] and won ($0.68) with three of a kind, Aces
Seat 4: crazy turfer folded before Flop (didn't bet)
Seat 5: tss22 (button) folded before Flop (didn't bet)
Seat 6: liaocs2016 (small blind) folded before Flop


*********** # 171 **************
PokerStars Hand #203824858758:  Hold'em No Limit ($0.02/$0.05 USD) - 2019/09/19 21:10:54 ET
Table 'Pollux' 6-max Seat #1 is the button
Seat 1: PornoBob777 ($5.06 in chips)
Seat 3: PlayTheBlues4U ($7.27 in chips)
Seat 5: JohanFlohan ($2.69 in chips)
absalon1320 will be allowed to play after the button
PlayTheBlues4U: posts small blind $0.02
JohanFlohan: posts big blind $0.05
*** HOLE CARDS ***
Dealt to PlayTheBlues4U [Ac 2s]
PornoBob777: folds
Part77 joins the table at seat #6
PlayTheBlues4U: calls $0.03
JohanFlohan: checks
*** FLOP *** [9d 2d 9s]
PlayTheBlues4U: checks
JohanFlohan: checks
*** TURN *** [9d 2d 9s] [Kh]
PlayTheBlues4U: bets $0.05
JohanFlohan: folds
Uncalled bet ($0.05) returned to PlayTheBlues4U
PlayTheBlues4U collected $0.10 from pot
PlayTheBlues4U: doesn't show hand
*** SUMMARY ***
Total pot $0.10 | Rake $0
Board [9d 2d 9s Kh]
Seat 1: PornoBob777 (button) folded before Flop (didn't bet)
Seat 3: PlayTheBlues4U (small blind) collected ($0.10)
Seat 5: JohanFlohan (big blind) folded on the Turn


*********** # 172 **************
PokerStars Hand #203824858652:  Hold'em No Limit ($0.02/$0.05 USD) - 2019/09/19 21:10:22 ET
Table 'Pollux' 6-max Seat #5 is the button
Seat 1: PornoBob777 ($5.08 in chips)
Seat 3: PlayTheBlues4U ($7.16 in chips)
Seat 5: JohanFlohan ($2.79 in chips)
PornoBob777: posts small blind $0.02
PlayTheBlues4U: posts big blind $0.05
*** HOLE CARDS ***
Dealt to PlayTheBlues4U [Th Jd]
JohanFlohan: calls $0.05
PornoBob777: folds
PlayTheBlues4U: checks
*** FLOP *** [Qd 5d Qc]
PlayTheBlues4U: checks
JohanFlohan: checks
*** TURN *** [Qd 5d Qc] [Td]
PlayTheBlues4U: bets $0.05
JohanFlohan: calls $0.05
*** RIVER *** [Qd 5d Qc Td] [5s]
PlayTheBlues4U: checks
JohanFlohan: checks
*** SHOW DOWN ***
PlayTheBlues4U: shows [Th Jd] (two pair, Queens and Tens)
JohanFlohan: mucks hand
PlayTheBlues4U collected $0.21 from pot
*** SUMMARY ***
Total pot $0.22 | Rake $0.01
Board [Qd 5d Qc Td 5s]
Seat 1: PornoBob777 (small blind) folded before Flop
Seat 3: PlayTheBlues4U (big blind) showed [Th Jd] and won ($0.21) with two pair, Queens and Tens
Seat 5: JohanFlohan (button) mucked [Ah 9c]


*********** # 173 **************
PokerStars Hand #203824858612:  Hold'em No Limit ($0.02/$0.05 USD) - 2019/09/19 21:10:09 ET
Table 'Semele' 6-max Seat #4 is the button
Seat 2: V@nce12 ($4.74 in chips)
Seat 3: PlayTheBlues4U ($7.21 in chips)
Seat 4: crazy turfer ($4.76 in chips)
Seat 5: tss22 ($1.95 in chips)
Seat 6: liaocs2016 ($8.34 in chips)
tss22: posts small blind $0.02
liaocs2016: posts big blind $0.05
*** HOLE CARDS ***
Dealt to PlayTheBlues4U [Qd 6s]
V@nce12: folds
PlayTheBlues4U: folds
crazy turfer: raises $0.10 to $0.15
tss22: folds
liaocs2016: calls $0.10
*** FLOP *** [Jh 8d 7d]
liaocs2016: checks
crazy turfer: bets $0.30
liaocs2016: folds
Uncalled bet ($0.30) returned to crazy turfer
crazy turfer collected $0.30 from pot
*** SUMMARY ***
Total pot $0.32 | Rake $0.02
Board [Jh 8d 7d]
Seat 2: V@nce12 folded before Flop (didn't bet)
Seat 3: PlayTheBlues4U folded before Flop (didn't bet)
Seat 4: crazy turfer (button) collected ($0.30)
Seat 5: tss22 (small blind) folded before Flop
Seat 6: liaocs2016 (big blind) folded on the Flop


*********** # 174 **************
PokerStars Hand #203824858521:  Hold'em No Limit ($0.02/$0.05 USD) - 2019/09/19 21:09:44 ET
Table 'Pollux' 6-max Seat #3 is the button
Seat 1: PornoBob777 ($5.13 in chips)
Seat 3: PlayTheBlues4U ($6.66 in chips)
Seat 5: JohanFlohan ($3.29 in chips)
JohanFlohan: posts small blind $0.02
PornoBob777: posts big blind $0.05
*** HOLE CARDS ***
Dealt to PlayTheBlues4U [Th 7h]
PlayTheBlues4U: raises $0.10 to $0.15
JohanFlohan: calls $0.13
PornoBob777: folds
*** FLOP *** [8c 3d 5d]
JohanFlohan: checks
PlayTheBlues4U: checks
*** TURN *** [8c 3d 5d] [Ts]
JohanFlohan: bets $0.10
PlayTheBlues4U: calls $0.10
*** RIVER *** [8c 3d 5d Ts] [4c]
JohanFlohan: bets $0.25
PlayTheBlues4U: calls $0.25
*** SHOW DOWN ***
JohanFlohan: shows [As 7c] (high card Ace)
PlayTheBlues4U: shows [Th 7h] (a pair of Tens)
PlayTheBlues4U collected $1 from pot
*** SUMMARY ***
Total pot $1.05 | Rake $0.05
Board [8c 3d 5d Ts 4c]
Seat 1: PornoBob777 (big blind) folded before Flop
Seat 3: PlayTheBlues4U (button) showed [Th 7h] and won ($1) with a pair of Tens
Seat 5: JohanFlohan (small blind) showed [As 7c] and lost with high card Ace


*********** # 175 **************
PokerStars Hand #203824858507:  Hold'em No Limit ($0.02/$0.05 USD) - 2019/09/19 21:09:40 ET
Table 'Semele' 6-max Seat #3 is the button
Seat 2: V@nce12 ($4.74 in chips)
Seat 3: PlayTheBlues4U ($7.14 in chips)
Seat 4: crazy turfer ($4.78 in chips)
Seat 5: tss22 ($2 in chips)
Seat 6: liaocs2016 ($8.34 in chips)
crazy turfer: posts small blind $0.02
tss22: posts big blind $0.05
*** HOLE CARDS ***
Dealt to PlayTheBlues4U [9d 8d]
liaocs2016: folds
V@nce12: folds
PlayTheBlues4U: raises $0.10 to $0.15
seags21 is disconnected
crazy turfer: folds
tss22: folds
Uncalled bet ($0.10) returned to PlayTheBlues4U
PlayTheBlues4U collected $0.12 from pot
PlayTheBlues4U: doesn't show hand
*** SUMMARY ***
Total pot $0.12 | Rake $0
Seat 2: V@nce12 folded before Flop (didn't bet)
Seat 3: PlayTheBlues4U (button) collected ($0.12)
Seat 4: crazy turfer (small blind) folded before Flop
Seat 5: tss22 (big blind) folded before Flop
Seat 6: liaocs2016 folded before Flop (didn't bet)


*********** # 176 **************
PokerStars Hand #203824858381:  Hold'em No Limit ($0.02/$0.05 USD) - 2019/09/19 21:09:01 ET
Table 'Pollux' 6-max Seat #1 is the button
Seat 1: PornoBob777 ($5.13 in chips)
Seat 3: PlayTheBlues4U ($6.61 in chips)
Seat 5: JohanFlohan ($3.34 in chips)
PlayTheBlues4U: posts small blind $0.02
JohanFlohan: posts big blind $0.05
*** HOLE CARDS ***
Dealt to PlayTheBlues4U [8s 2h]
PornoBob777: folds
PlayTheBlues4U: calls $0.03
JohanFlohan: checks
*** FLOP *** [3s 3h Ac]
PlayTheBlues4U: checks
JohanFlohan: checks
*** TURN *** [3s 3h Ac] [6s]
PlayTheBlues4U: checks
JohanFlohan: checks
*** RIVER *** [3s 3h Ac 6s] [8c]
PlayTheBlues4U: checks
JohanFlohan: checks
*** SHOW DOWN ***
PlayTheBlues4U: shows [8s 2h] (two pair, Eights and Threes)
JohanFlohan: mucks hand
PlayTheBlues4U collected $0.10 from pot
xxzuluzuluxx was removed from the table for failing to post
xxzuluzuluxx leaves the table
*** SUMMARY ***
Total pot $0.10 | Rake $0
Board [3s 3h Ac 6s 8c]
Seat 1: PornoBob777 (button) folded before Flop (didn't bet)
Seat 3: PlayTheBlues4U (small blind) showed [8s 2h] and won ($0.10) with two pair, Eights and Threes
Seat 5: JohanFlohan (big blind) mucked [9d Ks]


*********** # 177 **************
PokerStars Hand #203824858355:  Hold'em No Limit ($0.02/$0.05 USD) - 2019/09/19 21:08:56 ET
Table 'Pollux' 6-max Seat #5 is the button
Seat 1: PornoBob777 ($5.15 in chips)
Seat 3: PlayTheBlues4U ($6.59 in chips)
Seat 5: JohanFlohan ($3.34 in chips)
PornoBob777: posts small blind $0.02
PlayTheBlues4U: posts big blind $0.05
*** HOLE CARDS ***
Dealt to PlayTheBlues4U [Tc 6s]
JohanFlohan: folds
PornoBob777: folds
Uncalled bet ($0.03) returned to PlayTheBlues4U
PlayTheBlues4U collected $0.04 from pot
PlayTheBlues4U: doesn't show hand
*** SUMMARY ***
Total pot $0.04 | Rake $0
Seat 1: PornoBob777 (small blind) folded before Flop
Seat 3: PlayTheBlues4U (big blind) collected ($0.04)
Seat 5: JohanFlohan (button) folded before Flop (didn't bet)


*********** # 178 **************
PokerStars Hand #203824858298:  Hold'em No Limit ($0.02/$0.05 USD) - 2019/09/19 21:08:37 ET
Table 'Pollux' 6-max Seat #3 is the button
Seat 1: PornoBob777 ($5.10 in chips)
Seat 3: PlayTheBlues4U ($6.59 in chips)
Seat 5: JohanFlohan ($3.39 in chips)
JohanFlohan: posts small blind $0.02
PornoBob777: posts big blind $0.05
*** HOLE CARDS ***
Dealt to PlayTheBlues4U [Jd 2d]
PlayTheBlues4U: folds
JohanFlohan: calls $0.03
PornoBob777: checks
*** FLOP *** [7h Tc 4h]
JohanFlohan: checks
PornoBob777: checks
*** TURN *** [7h Tc 4h] [9h]
JohanFlohan: checks
PornoBob777: checks
*** RIVER *** [7h Tc 4h 9h] [4c]
JohanFlohan: checks
PornoBob777: checks
*** SHOW DOWN ***
JohanFlohan: shows [Kc Ah] (a pair of Fours)
PornoBob777: shows [7s 3s] (two pair, Sevens and Fours)
PornoBob777 collected $0.10 from pot
crazy turfer was removed from the table for failing to post
crazy turfer leaves the table
*** SUMMARY ***
Total pot $0.10 | Rake $0
Board [7h Tc 4h 9h 4c]
Seat 1: PornoBob777 (big blind) showed [7s 3s] and won ($0.10) with two pair, Sevens and Fours
Seat 3: PlayTheBlues4U (button) folded before Flop (didn't bet)
Seat 5: JohanFlohan (small blind) showed [Kc Ah] and lost with a pair of Fours


*********** # 179 **************
PokerStars Hand #203824858296:  Hold'em No Limit ($0.02/$0.05 USD) - 2019/09/19 21:08:37 ET
Table 'Semele' 6-max Seat #2 is the button
Seat 2: V@nce12 ($4.74 in chips)
Seat 3: PlayTheBlues4U ($7.49 in chips)
Seat 4: crazy turfer ($4.93 in chips)
Seat 6: liaocs2016 ($7.88 in chips)
PlayTheBlues4U: posts small blind $0.02
crazy turfer: posts big blind $0.05
tss22: sits out
*** HOLE CARDS ***
Dealt to PlayTheBlues4U [Ts Js]
liaocs2016: raises $0.10 to $0.15
V@nce12: folds
PlayTheBlues4U: calls $0.13
crazy turfer: calls $0.10
*** FLOP *** [Kh Th 2h]
PlayTheBlues4U: bets $0.20
crazy turfer: folds
liaocs2016: calls $0.20
*** TURN *** [Kh Th 2h] [7s]
PlayTheBlues4U: checks
liaocs2016: bets $0.80
PlayTheBlues4U: folds
Uncalled bet ($0.80) returned to liaocs2016
liaocs2016 collected $0.81 from pot
liaocs2016: doesn't show hand
*** SUMMARY ***
Total pot $0.85 | Rake $0.04
Board [Kh Th 2h 7s]
Seat 2: V@nce12 (button) folded before Flop (didn't bet)
Seat 3: PlayTheBlues4U (small blind) folded on the Turn
Seat 4: crazy turfer (big blind) folded on the Flop
Seat 6: liaocs2016 collected ($0.81)


*********** # 180 **************
PokerStars Hand #203824858265:  Hold'em No Limit ($0.02/$0.05 USD) - 2019/09/19 21:08:27 ET
Table 'Pollux' 6-max Seat #1 is the button
Seat 1: PornoBob777 ($5.10 in chips)
Seat 2: absalon1320 ($4.05 in chips)
Seat 3: PlayTheBlues4U ($6.57 in chips)
Seat 5: JohanFlohan ($3.39 in chips)
absalon1320: posts small blind $0.02
PlayTheBlues4U: posts big blind $0.05
*** HOLE CARDS ***
Dealt to PlayTheBlues4U [2c Qh]
JohanFlohan: folds
PornoBob777: folds
absalon1320: folds
Uncalled bet ($0.03) returned to PlayTheBlues4U
PlayTheBlues4U collected $0.04 from pot
PlayTheBlues4U: doesn't show hand
*** SUMMARY ***
Total pot $0.04 | Rake $0
Seat 1: PornoBob777 (button) folded before Flop (didn't bet)
Seat 2: absalon1320 (small blind) folded before Flop
Seat 3: PlayTheBlues4U (big blind) collected ($0.04)
Seat 5: JohanFlohan folded before Flop (didn't bet)


*********** # 181 **************
PokerStars Hand #203824858193:  Hold'em No Limit ($0.02/$0.05 USD) - 2019/09/19 21:08:07 ET
Table 'Pollux' 6-max Seat #5 is the button
Seat 1: PornoBob777 ($5 in chips)
Seat 2: absalon1320 ($4.10 in chips)
Seat 3: PlayTheBlues4U ($6.57 in chips)
Seat 5: JohanFlohan ($3.44 in chips)
PornoBob777: posts small blind $0.02
absalon1320: posts big blind $0.05
*** HOLE CARDS ***
Dealt to PlayTheBlues4U [2d 4d]
PlayTheBlues4U: folds
JohanFlohan: calls $0.05
PornoBob777: raises $0.12 to $0.17
absalon1320: folds
JohanFlohan: folds
Uncalled bet ($0.12) returned to PornoBob777
PornoBob777 collected $0.15 from pot
PornoBob777: doesn't show hand
*** SUMMARY ***
Total pot $0.15 | Rake $0
Seat 1: PornoBob777 (small blind) collected ($0.15)
Seat 2: absalon1320 (big blind) folded before Flop
Seat 3: PlayTheBlues4U folded before Flop (didn't bet)
Seat 5: JohanFlohan (button) folded before Flop


*********** # 182 **************
PokerStars Hand #203824858187:  Hold'em No Limit ($0.02/$0.05 USD) - 2019/09/19 21:08:06 ET
Table 'Semele' 6-max Seat #6 is the button
Seat 2: V@nce12 ($4.76 in chips)
Seat 3: PlayTheBlues4U ($7.54 in chips)
Seat 4: crazy turfer ($5 in chips)
Seat 6: liaocs2016 ($7.75 in chips)
V@nce12: posts small blind $0.02
PlayTheBlues4U: posts big blind $0.05
crazy turfer: posts small & big blinds $0.07
*** HOLE CARDS ***
Dealt to PlayTheBlues4U [Qc 9d]
crazy turfer: checks
liaocs2016: calls $0.05
V@nce12: folds
PlayTheBlues4U: checks
*** FLOP *** [7d 5s 5c]
PlayTheBlues4U: checks
tss22 joins the table at seat #5
crazy turfer: checks
liaocs2016: bets $0.20
PlayTheBlues4U: folds
crazy turfer: folds
Uncalled bet ($0.20) returned to liaocs2016
liaocs2016 collected $0.18 from pot
liaocs2016: doesn't show hand
*** SUMMARY ***
Total pot $0.19 | Rake $0.01
Board [7d 5s 5c]
Seat 2: V@nce12 (small blind) folded before Flop
Seat 3: PlayTheBlues4U (big blind) folded on the Flop
Seat 4: crazy turfer folded on the Flop (didn't bet)
Seat 6: liaocs2016 (button) collected ($0.18)


*********** # 183 **************
PokerStars Hand #203824858150:  Hold'em No Limit ($0.02/$0.05 USD) - 2019/09/19 21:07:54 ET
Table 'Semele' 6-max Seat #3 is the button
Seat 2: V@nce12 ($4.81 in chips)
Seat 3: PlayTheBlues4U ($7.54 in chips)
Seat 6: liaocs2016 ($7.70 in chips)
crazy turfer will be allowed to play after the button
liaocs2016: posts small blind $0.02
V@nce12: posts big blind $0.05
*** HOLE CARDS ***
Dealt to PlayTheBlues4U [3h 8c]
PlayTheBlues4U: folds
liaocs2016: raises $0.10 to $0.15
V@nce12: folds
Uncalled bet ($0.10) returned to liaocs2016
liaocs2016 collected $0.10 from pot
liaocs2016: doesn't show hand
*** SUMMARY ***
Total pot $0.10 | Rake $0
Seat 2: V@nce12 (big blind) folded before Flop
Seat 3: PlayTheBlues4U (button) folded before Flop (didn't bet)
Seat 6: liaocs2016 (small blind) collected ($0.10)


*********** # 184 **************
PokerStars Hand #203824858084:  Hold'em No Limit ($0.02/$0.05 USD) - 2019/09/19 21:07:34 ET
Table 'Pollux' 6-max Seat #3 is the button
Seat 1: PornoBob777 ($5 in chips)
Seat 2: absalon1320 ($4.04 in chips)
Seat 3: PlayTheBlues4U ($6.57 in chips)
Seat 5: JohanFlohan ($3.46 in chips)
JohanFlohan: posts small blind $0.02
PornoBob777: posts big blind $0.05
*** HOLE CARDS ***
Dealt to PlayTheBlues4U [Jc 3d]
absalon1320: calls $0.05
PlayTheBlues4U: folds
JohanFlohan: folds
PornoBob777: checks
*** FLOP *** [Jh 2s 9d]
PornoBob777: checks
absalon1320: checks
*** TURN *** [Jh 2s 9d] [7d]
PornoBob777: checks
absalon1320: checks
*** RIVER *** [Jh 2s 9d 7d] [5d]
PornoBob777: checks
absalon1320: checks
*** SHOW DOWN ***
PornoBob777: shows [Td 3s] (high card Jack)
absalon1320: shows [3c 7c] (a pair of Sevens)
absalon1320 collected $0.11 from pot
*** SUMMARY ***
Total pot $0.12 | Rake $0.01
Board [Jh 2s 9d 7d 5d]
Seat 1: PornoBob777 (big blind) showed [Td 3s] and lost with high card Jack
Seat 2: absalon1320 showed [3c 7c] and won ($0.11) with a pair of Sevens
Seat 3: PlayTheBlues4U (button) folded before Flop (didn't bet)
Seat 5: JohanFlohan (small blind) folded before Flop


*********** # 185 **************
PokerStars Hand #203824858078:  Hold'em No Limit ($0.02/$0.05 USD) - 2019/09/19 21:07:32 ET
Table 'Semele' 6-max Seat #2 is the button
Seat 2: V@nce12 ($4.93 in chips)
Seat 3: PlayTheBlues4U ($7.37 in chips)
Seat 6: liaocs2016 ($7.75 in chips)
PlayTheBlues4U: posts small blind $0.02
liaocs2016: posts big blind $0.05
*** HOLE CARDS ***
Dealt to PlayTheBlues4U [Jc Jd]
V@nce12: raises $0.07 to $0.12
PlayTheBlues4U: raises $0.22 to $0.34
liaocs2016: folds
V@nce12: folds
Uncalled bet ($0.22) returned to PlayTheBlues4U
PlayTheBlues4U collected $0.29 from pot
PlayTheBlues4U: doesn't show hand
*** SUMMARY ***
Total pot $0.29 | Rake $0
Seat 2: V@nce12 (button) folded before Flop
Seat 3: PlayTheBlues4U (small blind) collected ($0.29)
Seat 6: liaocs2016 (big blind) folded before Flop


*********** # 186 **************
PokerStars Hand #203824858032:  Hold'em No Limit ($0.02/$0.05 USD) - 2019/09/19 21:07:19 ET
Table 'Semele' 6-max Seat #6 is the button
Seat 2: V@nce12 ($4.95 in chips)
Seat 3: PlayTheBlues4U ($7.35 in chips)
Seat 6: liaocs2016 ($7.75 in chips)
V@nce12: posts small blind $0.02
PlayTheBlues4U: posts big blind $0.05
*** HOLE CARDS ***
Dealt to PlayTheBlues4U [2d 5c]
liaocs2016: folds
V@nce12: folds
Uncalled bet ($0.03) returned to PlayTheBlues4U
PlayTheBlues4U collected $0.04 from pot
PlayTheBlues4U: doesn't show hand
*** SUMMARY ***
Total pot $0.04 | Rake $0
Seat 2: V@nce12 (small blind) folded before Flop
Seat 3: PlayTheBlues4U (big blind) collected ($0.04)
Seat 6: liaocs2016 (button) folded before Flop (didn't bet)


*********** # 187 **************
PokerStars Hand #203824857856:  Hold'em No Limit ($0.02/$0.05 USD) - 2019/09/19 21:06:27 ET
Table 'Pollux' 6-max Seat #2 is the button
Seat 1: PornoBob777 ($5 in chips)
Seat 2: absalon1320 ($3.87 in chips)
Seat 3: PlayTheBlues4U ($6.59 in chips)
Seat 5: JohanFlohan ($3.51 in chips)
PlayTheBlues4U: posts small blind $0.02
JohanFlohan: posts big blind $0.05
*** HOLE CARDS ***
Dealt to PlayTheBlues4U [2h 9d]
PornoBob777: raises $0.07 to $0.12
absalon1320: calls $0.12
PlayTheBlues4U: folds
JohanFlohan: folds
*** FLOP *** [7s 4s 4h]
PornoBob777: checks
absalon1320: bets $0.15
PornoBob777: folds
Uncalled bet ($0.15) returned to absalon1320
absalon1320 collected $0.29 from pot
*** SUMMARY ***
Total pot $0.31 | Rake $0.02
Board [7s 4s 4h]
Seat 1: PornoBob777 folded on the Flop
Seat 2: absalon1320 (button) collected ($0.29)
Seat 3: PlayTheBlues4U (small blind) folded before Flop
Seat 5: JohanFlohan (big blind) folded before Flop


*********** # 188 **************
PokerStars Hand #203824857741:  Hold'em No Limit ($0.02/$0.05 USD) - 2019/09/19 21:05:54 ET
Table 'Semele' 6-max Seat #5 is the button
Seat 2: V@nce12 ($5 in chips)
Seat 3: PlayTheBlues4U ($7.35 in chips)
Seat 4: crazy turfer ($3.49 in chips)
Seat 5: boxerpupp727 ($6.43 in chips)
Seat 6: liaocs2016 ($4.56 in chips)
liaocs2016: posts small blind $0.02
V@nce12: posts big blind $0.05
*** HOLE CARDS ***
Dealt to PlayTheBlues4U [Ah 7s]
PlayTheBlues4U: folds
crazy turfer: calls $0.05
boxerpupp727: folds
liaocs2016: raises $0.10 to $0.15
V@nce12: folds
crazy turfer: calls $0.10
*** FLOP *** [Tc Ks 2h]
liaocs2016: bets $0.20
crazy turfer: calls $0.20
*** TURN *** [Tc Ks 2h] [Jc]
boxerpupp727 leaves the table
liaocs2016: bets $0.50
crazy turfer: raises $0.50 to $1
liaocs2016: calls $0.50
*** RIVER *** [Tc Ks 2h Jc] [2d]
liaocs2016: bets $2.60
crazy turfer: calls $2.14 and is all-in
Uncalled bet ($0.46) returned to liaocs2016
*** SHOW DOWN ***
liaocs2016: shows [Kh Th] (two pair, Kings and Tens)
crazy turfer: shows [Kd 9c] (two pair, Kings and Deuces)
liaocs2016 collected $6.68 from pot
*** SUMMARY ***
Total pot $7.03 | Rake $0.35
Board [Tc Ks 2h Jc 2d]
Seat 2: V@nce12 (big blind) folded before Flop
Seat 3: PlayTheBlues4U folded before Flop (didn't bet)
Seat 4: crazy turfer showed [Kd 9c] and lost with two pair, Kings and Deuces
Seat 5: boxerpupp727 (button) folded before Flop (didn't bet)
Seat 6: liaocs2016 (small blind) showed [Kh Th] and won ($6.68) with two pair, Kings and Tens


*********** # 189 **************
PokerStars Hand #203824857554:  Hold'em No Limit ($0.02/$0.05 USD) - 2019/09/19 21:05:00 ET
Table 'Pollux' 6-max Seat #1 is the button
Seat 1: PornoBob777 ($5 in chips)
Seat 2: absalon1320 ($4.35 in chips)
Seat 3: PlayTheBlues4U ($5.57 in chips)
Seat 5: JohanFlohan ($3.65 in chips)
absalon1320: posts small blind $0.02
PlayTheBlues4U: posts big blind $0.05
JohanFlohan: posts small & big blinds $0.07
*** HOLE CARDS ***
Dealt to PlayTheBlues4U [Ah 7c]
JohanFlohan: checks
PornoBob777: raises $0.07 to $0.12
absalon1320: calls $0.10
PlayTheBlues4U: calls $0.07
JohanFlohan: calls $0.07
*** FLOP *** [Ac 7h 2d]
absalon1320: checks
PlayTheBlues4U: checks
JohanFlohan: checks
PornoBob777: bets $0.36
absalon1320: calls $0.36
PlayTheBlues4U: calls $0.36
JohanFlohan: folds
*** TURN *** [Ac 7h 2d] [Ks]
absalon1320: checks
PlayTheBlues4U: checks
PornoBob777: checks
*** RIVER *** [Ac 7h 2d Ks] [2s]
absalon1320: checks
PlayTheBlues4U: bets $1.15
PornoBob777: folds
absalon1320: folds
Uncalled bet ($1.15) returned to PlayTheBlues4U
PlayTheBlues4U collected $1.50 from pot
PlayTheBlues4U: doesn't show hand
*** SUMMARY ***
Total pot $1.58 | Rake $0.08
Board [Ac 7h 2d Ks 2s]
Seat 1: PornoBob777 (button) folded on the River
Seat 2: absalon1320 (small blind) folded on the River
Seat 3: PlayTheBlues4U (big blind) collected ($1.50)
Seat 5: JohanFlohan folded on the Flop


*********** # 190 **************
PokerStars Hand #203824857539:  Hold'em No Limit ($0.02/$0.05 USD) - 2019/09/19 21:04:55 ET
Table 'Pollux' 6-max Seat #3 is the button
Seat 1: PornoBob777 ($5 in chips)
Seat 2: absalon1320 ($4.33 in chips)
Seat 3: PlayTheBlues4U ($5.57 in chips)
JohanFlohan will be allowed to play after the button
PornoBob777: posts small blind $0.02
absalon1320: posts big blind $0.05
*** HOLE CARDS ***
Dealt to PlayTheBlues4U [Qc 8c]
PlayTheBlues4U: folds
PornoBob777: folds
Uncalled bet ($0.03) returned to absalon1320
absalon1320 collected $0.04 from pot
*** SUMMARY ***
Total pot $0.04 | Rake $0
Seat 1: PornoBob777 (small blind) folded before Flop
Seat 2: absalon1320 (big blind) collected ($0.04)
Seat 3: PlayTheBlues4U (button) folded before Flop (didn't bet)


*********** # 191 **************
PokerStars Hand #203824857430:  Hold'em No Limit ($0.02/$0.05 USD) - 2019/09/19 21:04:25 ET
Table 'Semele' 6-max Seat #4 is the button
Seat 2: CMc172 ($5.67 in chips)
Seat 3: PlayTheBlues4U ($7.35 in chips)
Seat 4: crazy turfer ($4.09 in chips)
Seat 5: boxerpupp727 ($6.45 in chips)
Seat 6: liaocs2016 ($4 in chips)
boxerpupp727: posts small blind $0.02
liaocs2016: posts big blind $0.05
*** HOLE CARDS ***
Dealt to PlayTheBlues4U [6h Qc]
CMc172: folds
PlayTheBlues4U: folds
crazy turfer: raises $0.10 to $0.15
CMc172 leaves the table
V@nce12 joins the table at seat #2
boxerpupp727: folds
liaocs2016: calls $0.10
*** FLOP *** [7d 5s 7s]
liaocs2016: checks
crazy turfer: bets $0.15
liaocs2016: calls $0.15
*** TURN *** [7d 5s 7s] [Ah]
liaocs2016: checks
crazy turfer: bets $0.30
liaocs2016: calls $0.30
*** RIVER *** [7d 5s 7s Ah] [Ad]
liaocs2016: bets $0.60
crazy turfer: folds
Uncalled bet ($0.60) returned to liaocs2016
liaocs2016 collected $1.16 from pot
liaocs2016: doesn't show hand
*** SUMMARY ***
Total pot $1.22 | Rake $0.06
Board [7d 5s 7s Ah Ad]
Seat 2: CMc172 folded before Flop (didn't bet)
Seat 3: PlayTheBlues4U folded before Flop (didn't bet)
Seat 4: crazy turfer (button) folded on the River
Seat 5: boxerpupp727 (small blind) folded before Flop
Seat 6: liaocs2016 (big blind) collected ($1.16)


*********** # 192 **************
PokerStars Hand #203824857339:  Hold'em No Limit ($0.02/$0.05 USD) - 2019/09/19 21:03:59 ET
Table 'Pollux' 6-max Seat #2 is the button
Seat 1: PornoBob777 ($5 in chips)
Seat 2: absalon1320 ($4.38 in chips)
Seat 3: PlayTheBlues4U ($5.07 in chips)
PlayTheBlues4U: posts small blind $0.02
PornoBob777: posts big blind $0.05
*** HOLE CARDS ***
Dealt to PlayTheBlues4U [Ad Qc]
absalon1320: calls $0.05
PlayTheBlues4U: raises $0.15 to $0.20
PornoBob777: calls $0.15
absalon1320: folds
*** FLOP *** [Ah 7h Qd]
PlayTheBlues4U: bets $0.30
PornoBob777: calls $0.30
*** TURN *** [Ah 7h Qd] [Jd]
PlayTheBlues4U: bets $0.80
PornoBob777: folds
Uncalled bet ($0.80) returned to PlayTheBlues4U
PlayTheBlues4U collected $1 from pot
PlayTheBlues4U: doesn't show hand
*** SUMMARY ***
Total pot $1.05 | Rake $0.05
Board [Ah 7h Qd Jd]
Seat 1: PornoBob777 (big blind) folded on the Turn
Seat 2: absalon1320 (button) folded before Flop
Seat 3: PlayTheBlues4U (small blind) collected ($1)


*********** # 193 **************
PokerStars Hand #203824857329:  Hold'em No Limit ($0.02/$0.05 USD) - 2019/09/19 21:03:55 ET
Table 'Semele' 6-max Seat #3 is the button
Seat 2: CMc172 ($5.82 in chips)
Seat 3: PlayTheBlues4U ($7.35 in chips)
Seat 4: crazy turfer ($0.88 in chips)
Seat 5: boxerpupp727 ($6.50 in chips)
Seat 6: liaocs2016 ($3.67 in chips)
crazy turfer: posts small blind $0.02
boxerpupp727: posts big blind $0.05
*** HOLE CARDS ***
Dealt to PlayTheBlues4U [5c 2h]
liaocs2016: raises $0.10 to $0.15
CMc172: calls $0.15
PlayTheBlues4U: folds
crazy turfer: calls $0.13
boxerpupp727: folds
*** FLOP *** [5d 6h Ah]
crazy turfer: checks
liaocs2016: bets $0.30
CMc172: folds
crazy turfer: folds
Uncalled bet ($0.30) returned to liaocs2016
liaocs2016 collected $0.48 from pot
liaocs2016: doesn't show hand
*** SUMMARY ***
Total pot $0.50 | Rake $0.02
Board [5d 6h Ah]
Seat 2: CMc172 folded on the Flop
Seat 3: PlayTheBlues4U (button) folded before Flop (didn't bet)
Seat 4: crazy turfer (small blind) folded on the Flop
Seat 5: boxerpupp727 (big blind) folded before Flop
Seat 6: liaocs2016 collected ($0.48)


*********** # 194 **************
PokerStars Hand #203824857207:  Hold'em No Limit ($0.02/$0.05 USD) - 2019/09/19 21:03:21 ET
Table 'Pollux' 6-max Seat #1 is the button
Seat 1: PornoBob777 ($5 in chips)
Seat 2: absalon1320 ($4.40 in chips)
Seat 3: PlayTheBlues4U ($5.05 in chips)
Seat 5: JohanFlohan ($3.65 in chips)
absalon1320: posts small blind $0.02
PlayTheBlues4U: posts big blind $0.05
*** HOLE CARDS ***
Dealt to PlayTheBlues4U [8d 5d]
JohanFlohan has timed out
JohanFlohan: folds
PornoBob777: folds
absalon1320: folds
Uncalled bet ($0.03) returned to PlayTheBlues4U
PlayTheBlues4U collected $0.04 from pot
PlayTheBlues4U: doesn't show hand
*** SUMMARY ***
Total pot $0.04 | Rake $0
Seat 1: PornoBob777 (button) folded before Flop (didn't bet)
Seat 2: absalon1320 (small blind) folded before Flop
Seat 3: PlayTheBlues4U (big blind) collected ($0.04)
Seat 5: JohanFlohan folded before Flop (didn't bet)


*********** # 195 **************
PokerStars Hand #203824857118:  Hold'em No Limit ($0.02/$0.05 USD) - 2019/09/19 21:02:53 ET
Table 'Semele' 6-max Seat #2 is the button
Seat 2: CMc172 ($6.02 in chips)
Seat 3: PlayTheBlues4U ($6.98 in chips)
Seat 4: crazy turfer ($1.08 in chips)
Seat 5: boxerpupp727 ($6.50 in chips)
Seat 6: liaocs2016 ($3.67 in chips)
PlayTheBlues4U: posts small blind $0.02
crazy turfer: posts big blind $0.05
*** HOLE CARDS ***
Dealt to PlayTheBlues4U [9h Ts]
boxerpupp727: folds
boxerpupp727 said, "under. bet smart"
liaocs2016: folds
CMc172: calls $0.05
boxerpupp727 said, "givven"
PlayTheBlues4U: calls $0.03
boxerpupp727 said, "both suck lol"
crazy turfer: raises $0.15 to $0.20
CMc172: calls $0.15
PlayTheBlues4U: calls $0.15
*** FLOP *** [Kc 2d 5d]
PlayTheBlues4U: checks
crazy turfer: checks
CMc172: checks
*** TURN *** [Kc 2d 5d] [8h]
PlayTheBlues4U: bets $0.35
crazy turfer: folds
CMc172: folds
Uncalled bet ($0.35) returned to PlayTheBlues4U
PlayTheBlues4U collected $0.57 from pot
PlayTheBlues4U: doesn't show hand
*** SUMMARY ***
Total pot $0.60 | Rake $0.03
Board [Kc 2d 5d 8h]
Seat 2: CMc172 (button) folded on the Turn
Seat 3: PlayTheBlues4U (small blind) collected ($0.57)
Seat 4: crazy turfer (big blind) folded on the Turn
Seat 5: boxerpupp727 folded before Flop (didn't bet)
Seat 6: liaocs2016 folded before Flop (didn't bet)


*********** # 196 **************
PokerStars Hand #203824857017:  Hold'em No Limit ($0.02/$0.05 USD) - 2019/09/19 21:02:25 ET
Table 'Pollux' 6-max Seat #5 is the button
Seat 1: PornoBob777 ($5 in chips)
Seat 2: absalon1320 ($3.42 in chips)
Seat 3: PlayTheBlues4U ($5.05 in chips)
Seat 5: JohanFlohan ($3.65 in chips)
PornoBob777: posts small blind $0.02
absalon1320: posts big blind $0.05
*** HOLE CARDS ***
Dealt to PlayTheBlues4U [9d 6s]
PlayTheBlues4U: folds
JohanFlohan: folds
PornoBob777: raises $0.07 to $0.12
absalon1320: calls $0.07
*** FLOP *** [3h 7s 4s]
PornoBob777: bets $0.17
absalon1320: calls $0.17
*** TURN *** [3h 7s 4s] [6c]
PornoBob777: checks
absalon1320: checks
*** RIVER *** [3h 7s 4s 6c] [As]
PornoBob777: bets $0.25
absalon1320: raises $0.55 to $0.80
PornoBob777: calls $0.55
*** SHOW DOWN ***
absalon1320: shows [Qs Ks] (a flush, Ace high)
PornoBob777: mucks hand
absalon1320 collected $2.07 from pot
*** SUMMARY ***
Total pot $2.18 | Rake $0.11
Board [3h 7s 4s 6c As]
Seat 1: PornoBob777 (small blind) mucked [7c 7d]
Seat 2: absalon1320 (big blind) showed [Qs Ks] and won ($2.07) with a flush, Ace high
Seat 3: PlayTheBlues4U folded before Flop (didn't bet)
Seat 5: JohanFlohan (button) folded before Flop (didn't bet)


*********** # 197 **************
PokerStars Hand #203824856901:  Hold'em No Limit ($0.02/$0.05 USD) - 2019/09/19 21:01:54 ET
Table 'Pollux' 6-max Seat #3 is the button
Seat 1: PornoBob777 ($5 in chips)
Seat 2: absalon1320 ($3.12 in chips)
Seat 3: PlayTheBlues4U ($5.20 in chips)
Seat 5: JohanFlohan ($3.67 in chips)
JohanFlohan: posts small blind $0.02
PornoBob777: posts big blind $0.05
*** HOLE CARDS ***
Dealt to PlayTheBlues4U [Ks 9d]
absalon1320: calls $0.05
PlayTheBlues4U: raises $0.10 to $0.15
JohanFlohan: folds
PornoBob777: calls $0.10
absalon1320: calls $0.10
*** FLOP *** [Jh 9h 4h]
PornoBob777: checks
absalon1320: bets $0.25
PlayTheBlues4U: folds
PornoBob777: folds
Uncalled bet ($0.25) returned to absalon1320
absalon1320 collected $0.45 from pot
*** SUMMARY ***
Total pot $0.47 | Rake $0.02
Board [Jh 9h 4h]
Seat 1: PornoBob777 (big blind) folded on the Flop
Seat 2: absalon1320 collected ($0.45)
Seat 3: PlayTheBlues4U (button) folded on the Flop
Seat 5: JohanFlohan (small blind) folded before Flop


*********** # 198 **************
PokerStars Hand #203824856888:  Hold'em No Limit ($0.02/$0.05 USD) - 2019/09/19 21:01:50 ET
Table 'Semele' 6-max Seat #6 is the button
Seat 2: CMc172 ($6.27 in chips)
Seat 3: PlayTheBlues4U ($6.38 in chips)
Seat 4: crazy turfer ($1.48 in chips)
Seat 5: boxerpupp727 ($6.50 in chips)
Seat 6: liaocs2016 ($3.67 in chips)
CMc172: posts small blind $0.02
PlayTheBlues4U: posts big blind $0.05
*** HOLE CARDS ***
Dealt to PlayTheBlues4U [4d 8d]
crazy turfer: raises $0.10 to $0.15
boxerpupp727: folds
liaocs2016: folds
CMc172: calls $0.13
PlayTheBlues4U: calls $0.10
*** FLOP *** [Kh 8s Kd]
CMc172: checks
PlayTheBlues4U: checks
crazy turfer: bets $0.10
CMc172: calls $0.10
PlayTheBlues4U: calls $0.10
*** TURN *** [Kh 8s Kd] [2s]
CMc172: checks
PlayTheBlues4U: checks
crazy turfer: bets $0.15
CMc172: folds
PlayTheBlues4U: calls $0.15
*** RIVER *** [Kh 8s Kd 2s] [9c]
PlayTheBlues4U: checks
crazy turfer: checks
*** SHOW DOWN ***
PlayTheBlues4U: shows [4d 8d] (two pair, Kings and Eights)
crazy turfer: mucks hand
PlayTheBlues4U collected $1 from pot
*** SUMMARY ***
Total pot $1.05 | Rake $0.05
Board [Kh 8s Kd 2s 9c]
Seat 2: CMc172 (small blind) folded on the Turn
Seat 3: PlayTheBlues4U (big blind) showed [4d 8d] and won ($1) with two pair, Kings and Eights
Seat 4: crazy turfer mucked [Th Qd]
Seat 5: boxerpupp727 folded before Flop (didn't bet)
Seat 6: liaocs2016 (button) folded before Flop (didn't bet)


*********** # 199 **************
PokerStars Hand #203824856867:  Hold'em No Limit ($0.02/$0.05 USD) - 2019/09/19 21:01:42 ET
Table 'Pollux' 6-max Seat #2 is the button
Seat 1: jvilla119 ($2.24 in chips)
Seat 2: absalon1320 ($3.05 in chips)
Seat 3: PlayTheBlues4U ($5.22 in chips)
Seat 5: JohanFlohan ($3.72 in chips)
PlayTheBlues4U: posts small blind $0.02
JohanFlohan: posts big blind $0.05
*** HOLE CARDS ***
Dealt to PlayTheBlues4U [9d 3c]
jvilla119: folds
jvilla119 leaves the table
absalon1320: raises $0.12 to $0.17
PornoBob777 joins the table at seat #1
PlayTheBlues4U: folds
JohanFlohan: folds
Uncalled bet ($0.12) returned to absalon1320
absalon1320 collected $0.12 from pot
*** SUMMARY ***
Total pot $0.12 | Rake $0
Seat 1: jvilla119 folded before Flop (didn't bet)
Seat 2: absalon1320 (button) collected ($0.12)
Seat 3: PlayTheBlues4U (small blind) folded before Flop
Seat 5: JohanFlohan (big blind) folded before Flop


*********** # 200 **************
PokerStars Hand #203824856769:  Hold'em No Limit ($0.02/$0.05 USD) - 2019/09/19 21:01:15 ET
Table 'Pollux' 6-max Seat #1 is the button
Seat 1: jvilla119 ($2.24 in chips)
Seat 2: absalon1320 ($2.78 in chips)
Seat 3: PlayTheBlues4U ($5.52 in chips)
Seat 5: JohanFlohan ($3.72 in chips)
absalon1320: posts small blind $0.02
PlayTheBlues4U: posts big blind $0.05
*** HOLE CARDS ***
Dealt to PlayTheBlues4U [8h 9c]
JohanFlohan: folds
jvilla119: folds
absalon1320: raises $0.10 to $0.15
PlayTheBlues4U: calls $0.10
*** FLOP *** [5d 6s 3h]
absalon1320: bets $0.15
PlayTheBlues4U: calls $0.15
*** TURN *** [5d 6s 3h] [2d]
absalon1320: bets $0.30
PlayTheBlues4U: folds
Uncalled bet ($0.30) returned to absalon1320
absalon1320 collected $0.57 from pot
*** SUMMARY ***
Total pot $0.60 | Rake $0.03
Board [5d 6s 3h 2d]
Seat 1: jvilla119 (button) folded before Flop (didn't bet)
Seat 2: absalon1320 (small blind) collected ($0.57)
Seat 3: PlayTheBlues4U (big blind) folded on the Turn
Seat 5: JohanFlohan folded before Flop (didn't bet)


