*********** # 1 **************
PokerStars Hand #203998489753:  Hold'em No Limit ($0.05/$0.10 USD) - 2019/09/26 22:53:56 ET
Table 'Lynx' 6-max Seat #4 is the button
Seat 1: BigBlue ($7.10 in chips)
Seat 2: winbabywin7 ($6.40 in chips)
Seat 3: mellneazy ($17.29 in chips)
Seat 4: Ribeye63 ($12.17 in chips)
Seat 5: PlayTheBlues4U ($19.74 in chips)
Seat 6: donjt2653 ($10.12 in chips)
PlayTheBlues4U: posts small blind $0.05
donjt2653: posts big blind $0.10
*** HOLE CARDS ***
Dealt to PlayTheBlues4U [Qh Tc]
BigBlue: folds
winbabywin7: calls $0.10
mellneazy: folds
Ribeye63: calls $0.10
PlayTheBlues4U: calls $0.05
donjt2653: checks
*** FLOP *** [As 5d Ah]
PlayTheBlues4U: checks
donjt2653: bets $0.10
winbabywin7: folds
Ribeye63: folds
PlayTheBlues4U: folds
Uncalled bet ($0.10) returned to donjt2653
donjt2653 collected $0.38 from pot
donjt2653: doesn't show hand
*** SUMMARY ***
Total pot $0.40 | Rake $0.02
Board [As 5d Ah]
Seat 1: BigBlue folded before Flop (didn't bet)
Seat 2: winbabywin7 folded on the Flop
Seat 3: mellneazy folded before Flop (didn't bet)
Seat 4: Ribeye63 (button) folded on the Flop
Seat 5: PlayTheBlues4U (small blind) folded on the Flop
Seat 6: donjt2653 (big blind) collected ($0.38)


*********** # 2 **************
PokerStars Hand #203998489589: Tournament #2091372260, $0.93+$0.07 USD Hold'em No Limit - Level II (15/30) - 2019/09/26 22:52:58 ET
Table '2091372260 1' 3-max Seat #3 is the button
Seat 1: JoJoe482 (555 in chips)
Seat 2: PlayTheBlues4U (260 in chips)
Seat 3: kten5150 (685 in chips)
JoJoe482: posts small blind 15
PlayTheBlues4U: posts big blind 30
*** HOLE CARDS ***
Dealt to PlayTheBlues4U [2h 2d]
kten5150: raises 75 to 105
JoJoe482: folds
PlayTheBlues4U: raises 155 to 260 and is all-in
kten5150: calls 155
*** FLOP *** [9h 7d 6s]
*** TURN *** [9h 7d 6s] [5h]
*** RIVER *** [9h 7d 6s 5h] [9d]
*** SHOW DOWN ***
PlayTheBlues4U: shows [2h 2d] (two pair, Nines and Deuces)
kten5150: shows [Th Tc] (two pair, Tens and Nines)
kten5150 collected 535 from pot
PlayTheBlues4U finished the tournament in 3rd place
*** SUMMARY ***
Total pot 535 | Rake 0
Board [9h 7d 6s 5h 9d]
Seat 1: JoJoe482 (small blind) folded before Flop
Seat 2: PlayTheBlues4U (big blind) showed [2h 2d] and lost with two pair, Nines and Deuces
Seat 3: kten5150 (button) showed [Th Tc] and won (535) with two pair, Tens and Nines


*********** # 3 **************
PokerStars Hand #203998489522: Tournament #2091372260, $0.93+$0.07 USD Hold'em No Limit - Level II (15/30) - 2019/09/26 22:52:35 ET
Table '2091372260 1' 3-max Seat #2 is the button
Seat 1: JoJoe482 (585 in chips)
Seat 2: PlayTheBlues4U (260 in chips)
Seat 3: kten5150 (655 in chips)
kten5150: posts small blind 15
JoJoe482: posts big blind 30
*** HOLE CARDS ***
Dealt to PlayTheBlues4U [Qd 2c]
PlayTheBlues4U: folds
kten5150: calls 15
JoJoe482: checks
*** FLOP *** [Kc Ks 9s]
kten5150: bets 30
JoJoe482: folds
Uncalled bet (30) returned to kten5150
kten5150 collected 60 from pot
*** SUMMARY ***
Total pot 60 | Rake 0
Board [Kc Ks 9s]
Seat 1: JoJoe482 (big blind) folded on the Flop
Seat 2: PlayTheBlues4U (button) folded before Flop (didn't bet)
Seat 3: kten5150 (small blind) collected (60)


*********** # 4 **************
PokerStars Hand #203998489514:  Hold'em No Limit ($0.05/$0.10 USD) - 2019/09/26 22:52:33 ET
Table 'Lynx' 6-max Seat #3 is the button
Seat 1: BigBlue ($7.10 in chips)
Seat 2: winbabywin7 ($6.40 in chips)
Seat 3: mellneazy ($13.98 in chips)
Seat 4: Ribeye63 ($12.22 in chips)
Seat 5: PlayTheBlues4U ($22.89 in chips)
Seat 6: donjt2653 ($10.57 in chips)
Ribeye63: posts small blind $0.05
PlayTheBlues4U: posts big blind $0.10
*** HOLE CARDS ***
Dealt to PlayTheBlues4U [As 6c]
donjt2653: calls $0.10
BigBlue: folds
winbabywin7: folds
mellneazy: raises $0.35 to $0.45
Ribeye63: folds
PlayTheBlues4U: calls $0.35
donjt2653: calls $0.35
*** FLOP *** [6d 6s Js]
PlayTheBlues4U: checks
donjt2653: checks
mellneazy: bets $0.70
PlayTheBlues4U: calls $0.70
donjt2653: folds
*** TURN *** [6d 6s Js] [4s]
PlayTheBlues4U: checks
mellneazy: checks
*** RIVER *** [6d 6s Js 4s] [Tc]
PlayTheBlues4U: checks
mellneazy: bets $2
PlayTheBlues4U: calls $2
*** SHOW DOWN ***
mellneazy: shows [Jh 6h] (a full house, Sixes full of Jacks)
PlayTheBlues4U: mucks hand
mellneazy collected $6.46 from pot
*** SUMMARY ***
Total pot $6.80 | Rake $0.34
Board [6d 6s Js 4s Tc]
Seat 1: BigBlue folded before Flop (didn't bet)
Seat 2: winbabywin7 folded before Flop (didn't bet)
Seat 3: mellneazy (button) showed [Jh 6h] and won ($6.46) with a full house, Sixes full of Jacks
Seat 4: Ribeye63 (small blind) folded before Flop
Seat 5: PlayTheBlues4U (big blind) mucked [As 6c]
Seat 6: donjt2653 folded on the Flop


*********** # 5 **************
PokerStars Hand #203998489439:  Hold'em No Limit ($0.05/$0.10 USD) - 2019/09/26 22:52:06 ET
Table 'Lynx' 6-max Seat #2 is the button
Seat 1: BigBlue ($7.10 in chips)
Seat 2: winbabywin7 ($6.40 in chips)
Seat 3: mellneazy ($13.80 in chips)
Seat 4: Ribeye63 ($12.32 in chips)
Seat 5: PlayTheBlues4U ($22.89 in chips)
Seat 6: donjt2653 ($10.67 in chips)
mellneazy: posts small blind $0.05
Ribeye63: posts big blind $0.10
*** HOLE CARDS ***
Dealt to PlayTheBlues4U [Ad 4s]
PlayTheBlues4U: folds
donjt2653: calls $0.10
BigBlue: folds
winbabywin7: folds
mellneazy: calls $0.05
Ribeye63: checks
*** FLOP *** [9d 7c Jh]
mellneazy: bets $13.70 and is all-in
Ribeye63: folds
donjt2653: folds
Uncalled bet ($13.70) returned to mellneazy
mellneazy collected $0.28 from pot
mellneazy: doesn't show hand
*** SUMMARY ***
Total pot $0.30 | Rake $0.02
Board [9d 7c Jh]
Seat 1: BigBlue folded before Flop (didn't bet)
Seat 2: winbabywin7 (button) folded before Flop (didn't bet)
Seat 3: mellneazy (small blind) collected ($0.28)
Seat 4: Ribeye63 (big blind) folded on the Flop
Seat 5: PlayTheBlues4U folded before Flop (didn't bet)
Seat 6: donjt2653 folded on the Flop


*********** # 6 **************
PokerStars Hand #203998489438: Tournament #2091372260, $0.93+$0.07 USD Hold'em No Limit - Level II (15/30) - 2019/09/26 22:52:05 ET
Table '2091372260 1' 3-max Seat #1 is the button
Seat 1: JoJoe482 (435 in chips)
Seat 2: PlayTheBlues4U (380 in chips)
Seat 3: kten5150 (685 in chips)
PlayTheBlues4U: posts small blind 15
kten5150: posts big blind 30
*** HOLE CARDS ***
Dealt to PlayTheBlues4U [Jd Qs]
JoJoe482: calls 30
PlayTheBlues4U: raises 30 to 60
kten5150: folds
JoJoe482: calls 30
*** FLOP *** [4h 9s 8h]
PlayTheBlues4U: bets 60
JoJoe482: calls 60
*** TURN *** [4h 9s 8h] [7h]
PlayTheBlues4U: checks
JoJoe482: bets 270
PlayTheBlues4U: folds
Uncalled bet (270) returned to JoJoe482
JoJoe482 collected 270 from pot
JoJoe482: doesn't show hand
*** SUMMARY ***
Total pot 270 | Rake 0
Board [4h 9s 8h 7h]
Seat 1: JoJoe482 (button) collected (270)
Seat 2: PlayTheBlues4U (small blind) folded on the Turn
Seat 3: kten5150 (big blind) folded before Flop


*********** # 7 **************
PokerStars Hand #203998489372: Tournament #2091372260, $0.93+$0.07 USD Hold'em No Limit - Level II (15/30) - 2019/09/26 22:51:42 ET
Table '2091372260 1' 3-max Seat #3 is the button
Seat 1: JoJoe482 (450 in chips)
Seat 2: PlayTheBlues4U (410 in chips)
Seat 3: kten5150 (640 in chips)
JoJoe482: posts small blind 15
PlayTheBlues4U: posts big blind 30
*** HOLE CARDS ***
Dealt to PlayTheBlues4U [8h Jh]
kten5150: raises 75 to 105
JoJoe482: folds
PlayTheBlues4U: folds
Uncalled bet (75) returned to kten5150
kten5150 collected 75 from pot
*** SUMMARY ***
Total pot 75 | Rake 0
Seat 1: JoJoe482 (small blind) folded before Flop
Seat 2: PlayTheBlues4U (big blind) folded before Flop
Seat 3: kten5150 (button) collected (75)


*********** # 8 **************
PokerStars Hand #203998489280: Tournament #2091372260, $0.93+$0.07 USD Hold'em No Limit - Level II (15/30) - 2019/09/26 22:51:11 ET
Table '2091372260 1' 3-max Seat #2 is the button
Seat 1: JoJoe482 (480 in chips)
Seat 2: PlayTheBlues4U (410 in chips)
Seat 3: kten5150 (610 in chips)
kten5150: posts small blind 15
JoJoe482: posts big blind 30
*** HOLE CARDS ***
Dealt to PlayTheBlues4U [Jc Th]
PlayTheBlues4U: folds
kten5150: calls 15
JoJoe482: checks
*** FLOP *** [8c Qh Qs]
kten5150: checks
JoJoe482: checks
*** TURN *** [8c Qh Qs] [7h]
kten5150: bets 30
JoJoe482: folds
Uncalled bet (30) returned to kten5150
kten5150 collected 60 from pot
*** SUMMARY ***
Total pot 60 | Rake 0
Board [8c Qh Qs 7h]
Seat 1: JoJoe482 (big blind) folded on the Turn
Seat 2: PlayTheBlues4U (button) folded before Flop (didn't bet)
Seat 3: kten5150 (small blind) collected (60)


*********** # 9 **************
PokerStars Hand #203998489275:  Hold'em No Limit ($0.05/$0.10 USD) - 2019/09/26 22:51:09 ET
Table 'Lynx' 6-max Seat #1 is the button
Seat 1: BigBlue ($7.10 in chips)
Seat 2: winbabywin7 ($7.60 in chips)
Seat 3: mellneazy ($11.58 in chips)
Seat 4: Ribeye63 ($12.32 in chips)
Seat 5: PlayTheBlues4U ($22.89 in chips)
Seat 6: donjt2653 ($11.87 in chips)
winbabywin7: posts small blind $0.05
mellneazy: posts big blind $0.10
*** HOLE CARDS ***
Dealt to PlayTheBlues4U [Qd 6s]
Ribeye63: folds
PlayTheBlues4U: folds
donjt2653: raises $0.20 to $0.30
BigBlue: folds
winbabywin7: calls $0.25
mellneazy: raises $0.90 to $1.20
donjt2653: calls $0.90
winbabywin7: calls $0.90
*** FLOP *** [Ts 9c Kh]
winbabywin7: checks
mellneazy: bets $2
donjt2653: folds
winbabywin7: folds
Uncalled bet ($2) returned to mellneazy
mellneazy collected $3.42 from pot
mellneazy: doesn't show hand
*** SUMMARY ***
Total pot $3.60 | Rake $0.18
Board [Ts 9c Kh]
Seat 1: BigBlue (button) folded before Flop (didn't bet)
Seat 2: winbabywin7 (small blind) folded on the Flop
Seat 3: mellneazy (big blind) collected ($3.42)
Seat 4: Ribeye63 folded before Flop (didn't bet)
Seat 5: PlayTheBlues4U folded before Flop (didn't bet)
Seat 6: donjt2653 folded on the Flop


*********** # 10 **************
PokerStars Hand #203998489072: Tournament #2091372260, $0.93+$0.07 USD Hold'em No Limit - Level I (10/20) - 2019/09/26 22:49:59 ET
Table '2091372260 1' 3-max Seat #1 is the button
Seat 1: JoJoe482 (480 in chips)
Seat 2: PlayTheBlues4U (410 in chips)
Seat 3: kten5150 (610 in chips)
PlayTheBlues4U: posts small blind 10
kten5150: posts big blind 20
*** HOLE CARDS ***
Dealt to PlayTheBlues4U [5c 4h]
JoJoe482: folds
PlayTheBlues4U: calls 10
kten5150: checks
*** FLOP *** [7s Ah Tc]
PlayTheBlues4U: checks
kten5150: checks
*** TURN *** [7s Ah Tc] [8c]
PlayTheBlues4U: checks
kten5150: checks
*** RIVER *** [7s Ah Tc 8c] [8h]
PlayTheBlues4U has timed out
PlayTheBlues4U: checks
kten5150: checks
*** SHOW DOWN ***
PlayTheBlues4U: shows [5c 4h] (a pair of Eights)
kten5150: shows [3d 6s] (a pair of Eights)
PlayTheBlues4U collected 20 from pot
kten5150 collected 20 from pot
*** SUMMARY ***
Total pot 40 | Rake 0
Board [7s Ah Tc 8c 8h]
Seat 1: JoJoe482 (button) folded before Flop (didn't bet)
Seat 2: PlayTheBlues4U (small blind) showed [5c 4h] and won (20) with a pair of Eights
Seat 3: kten5150 (big blind) showed [3d 6s] and won (20) with a pair of Eights


*********** # 11 **************
PokerStars Hand #203998488967:  Hold'em No Limit ($0.05/$0.10 USD) - 2019/09/26 22:49:29 ET
Table 'Lynx' 6-max Seat #6 is the button
Seat 1: BigBlue ($7.15 in chips)
Seat 2: winbabywin7 ($7.70 in chips)
Seat 3: mellneazy ($20.38 in chips)
Seat 4: Ribeye63 ($12.32 in chips)
Seat 5: PlayTheBlues4U ($14.07 in chips)
Seat 6: donjt2653 ($12.67 in chips)
BigBlue: posts small blind $0.05
winbabywin7: posts big blind $0.10
*** HOLE CARDS ***
Dealt to PlayTheBlues4U [7c 7d]
mellneazy: raises $0.20 to $0.30
Ribeye63: folds
PlayTheBlues4U: calls $0.30
donjt2653: calls $0.30
BigBlue: folds
winbabywin7: folds
*** FLOP *** [5h 5s 7h]
mellneazy: bets $0.50
PlayTheBlues4U: calls $0.50
donjt2653: calls $0.50
*** TURN *** [5h 5s 7h] [Kh]
mellneazy: checks
PlayTheBlues4U: bets $1.60
donjt2653: folds
mellneazy: calls $1.60
*** RIVER *** [5h 5s 7h Kh] [Ts]
mellneazy: bets $3
PlayTheBlues4U: raises $3.40 to $6.40
mellneazy: calls $3.40
*** SHOW DOWN ***
PlayTheBlues4U: shows [7c 7d] (a full house, Sevens full of Fives)
mellneazy: mucks hand
PlayTheBlues4U collected $17.62 from pot
*** SUMMARY ***
Total pot $18.55 | Rake $0.93
Board [5h 5s 7h Kh Ts]
Seat 1: BigBlue (small blind) folded before Flop
Seat 2: winbabywin7 (big blind) folded before Flop
Seat 3: mellneazy mucked [Ah 9h]
Seat 4: Ribeye63 folded before Flop (didn't bet)
Seat 5: PlayTheBlues4U showed [7c 7d] and won ($17.62) with a full house, Sevens full of Fives
Seat 6: donjt2653 (button) folded on the Turn


*********** # 12 **************
PokerStars Hand #203998488947: Tournament #2091372260, $0.93+$0.07 USD Hold'em No Limit - Level I (10/20) - 2019/09/26 22:49:21 ET
Table '2091372260 1' 3-max Seat #3 is the button
Seat 1: JoJoe482 (490 in chips)
Seat 2: PlayTheBlues4U (600 in chips)
Seat 3: kten5150 (410 in chips)
JoJoe482: posts small blind 10
PlayTheBlues4U: posts big blind 20
*** HOLE CARDS ***
Dealt to PlayTheBlues4U [Qh Jh]
kten5150: raises 50 to 70
JoJoe482: folds
PlayTheBlues4U: raises 50 to 120
kten5150: raises 70 to 190
PlayTheBlues4U: calls 70
*** FLOP *** [3c 5d Td]
PlayTheBlues4U: checks
kten5150: bets 220 and is all-in
PlayTheBlues4U: folds
Uncalled bet (220) returned to kten5150
kten5150 collected 390 from pot
*** SUMMARY ***
Total pot 390 | Rake 0
Board [3c 5d Td]
Seat 1: JoJoe482 (small blind) folded before Flop
Seat 2: PlayTheBlues4U (big blind) folded on the Flop
Seat 3: kten5150 (button) collected (390)


*********** # 13 **************
PokerStars Hand #203998488926: Tournament #2091372260, $0.93+$0.07 USD Hold'em No Limit - Level I (10/20) - 2019/09/26 22:49:17 ET
Table '2091372260 1' 3-max Seat #2 is the button
Seat 1: JoJoe482 (480 in chips)
Seat 2: PlayTheBlues4U (600 in chips)
Seat 3: kten5150 (420 in chips)
kten5150: posts small blind 10
JoJoe482: posts big blind 20
*** HOLE CARDS ***
Dealt to PlayTheBlues4U [8d 2s]
PlayTheBlues4U: folds
kten5150: folds
Uncalled bet (10) returned to JoJoe482
JoJoe482 collected 20 from pot
JoJoe482: doesn't show hand
*** SUMMARY ***
Total pot 20 | Rake 0
Seat 1: JoJoe482 (big blind) collected (20)
Seat 2: PlayTheBlues4U (button) folded before Flop (didn't bet)
Seat 3: kten5150 (small blind) folded before Flop


*********** # 14 **************
PokerStars Hand #203998488872: Tournament #2091372260, $0.93+$0.07 USD Hold'em No Limit - Level I (10/20) - 2019/09/26 22:48:56 ET
Table '2091372260 1' 3-max Seat #1 is the button
Seat 1: JoJoe482 (520 in chips)
Seat 2: PlayTheBlues4U (520 in chips)
Seat 3: kten5150 (460 in chips)
PlayTheBlues4U: posts small blind 10
kten5150: posts big blind 20
*** HOLE CARDS ***
Dealt to PlayTheBlues4U [Js 9d]
JoJoe482: raises 20 to 40
PlayTheBlues4U: calls 30
kten5150: calls 20
*** FLOP *** [2d 7d 9c]
PlayTheBlues4U: bets 60
kten5150: folds
JoJoe482: folds
Uncalled bet (60) returned to PlayTheBlues4U
PlayTheBlues4U collected 120 from pot
PlayTheBlues4U: doesn't show hand
*** SUMMARY ***
Total pot 120 | Rake 0
Board [2d 7d 9c]
Seat 1: JoJoe482 (button) folded on the Flop
Seat 2: PlayTheBlues4U (small blind) collected (120)
Seat 3: kten5150 (big blind) folded on the Flop


*********** # 15 **************
PokerStars Hand #203998488838:  Hold'em No Limit ($0.05/$0.10 USD) - 2019/09/26 22:48:42 ET
Table 'Delphinus' 6-max Seat #1 is the button
Seat 1: daughterstuitio ($9.72 in chips)
Seat 2: maxplans323 ($6.68 in chips)
Seat 3: joncruise ($14.76 in chips)
Seat 4: 921zhaopeng ($8.23 in chips)
Seat 5: SuWasup ($9.27 in chips)
Seat 6: PlayTheBlues4U ($7.48 in chips)
maxplans323: posts small blind $0.05
joncruise: posts big blind $0.10
*** HOLE CARDS ***
Dealt to PlayTheBlues4U [Kc Kh]
921zhaopeng: raises $0.10 to $0.20
SuWasup: calls $0.20
PlayTheBlues4U: raises $0.10 to $0.30
daughterstuitio: calls $0.30
maxplans323: folds
joncruise: calls $0.20
921zhaopeng: raises $1.15 to $1.45
SuWasup: folds
PlayTheBlues4U: raises $1.75 to $3.20
daughterstuitio: folds
joncruise: folds
921zhaopeng: calls $1.75
*** FLOP *** [3d 4d 2c]
921zhaopeng: bets $3.40
PlayTheBlues4U: raises $0.88 to $4.28 and is all-in
921zhaopeng: calls $0.88
*** TURN *** [3d 4d 2c] [5d]
*** RIVER *** [3d 4d 2c 5d] [3s]
*** SHOW DOWN ***
921zhaopeng: shows [Ad Jc] (a straight, Ace to Five)
PlayTheBlues4U: shows [Kc Kh] (two pair, Kings and Threes)
921zhaopeng collected $15.02 from pot
*** SUMMARY ***
Total pot $15.81 | Rake $0.79
Board [3d 4d 2c 5d 3s]
Seat 1: daughterstuitio (button) folded before Flop
Seat 2: maxplans323 (small blind) folded before Flop
Seat 3: joncruise (big blind) folded before Flop
Seat 4: 921zhaopeng showed [Ad Jc] and won ($15.02) with a straight, Ace to Five
Seat 5: SuWasup folded before Flop
Seat 6: PlayTheBlues4U showed [Kc Kh] and lost with two pair, Kings and Threes


*********** # 16 **************
PokerStars Hand #203998488804:  Hold'em No Limit ($0.05/$0.10 USD) - 2019/09/26 22:48:31 ET
Table 'Lynx' 6-max Seat #5 is the button
Seat 1: BigBlue ($7.25 in chips)
Seat 2: winbabywin7 ($7.70 in chips)
Seat 3: mellneazy ($20.38 in chips)
Seat 4: Ribeye63 ($12.32 in chips)
Seat 5: PlayTheBlues4U ($14.07 in chips)
Seat 6: donjt2653 ($12.58 in chips)
donjt2653: posts small blind $0.05
BigBlue: posts big blind $0.10
*** HOLE CARDS ***
Dealt to PlayTheBlues4U [Ts 2s]
winbabywin7: folds
mellneazy: folds
Ribeye63: folds
PlayTheBlues4U: folds
donjt2653: calls $0.05
BigBlue: checks
*** FLOP *** [4c 7s 8d]
donjt2653: checks
BigBlue: checks
*** TURN *** [4c 7s 8d] [4h]
donjt2653: bets $0.10
BigBlue: folds
Uncalled bet ($0.10) returned to donjt2653
donjt2653 collected $0.19 from pot
donjt2653: doesn't show hand
*** SUMMARY ***
Total pot $0.20 | Rake $0.01
Board [4c 7s 8d 4h]
Seat 1: BigBlue (big blind) folded on the Turn
Seat 2: winbabywin7 folded before Flop (didn't bet)
Seat 3: mellneazy folded before Flop (didn't bet)
Seat 4: Ribeye63 folded before Flop (didn't bet)
Seat 5: PlayTheBlues4U (button) folded before Flop (didn't bet)
Seat 6: donjt2653 (small blind) collected ($0.19)


*********** # 17 **************
PokerStars Hand #203998488802: Tournament #2091372260, $0.93+$0.07 USD Hold'em No Limit - Level I (10/20) - 2019/09/26 22:48:31 ET
Table '2091372260 1' 3-max Seat #3 is the button
Seat 1: JoJoe482 (520 in chips)
Seat 2: PlayTheBlues4U (520 in chips)
Seat 3: kten5150 (460 in chips)
JoJoe482: posts small blind 10
PlayTheBlues4U: posts big blind 20
*** HOLE CARDS ***
Dealt to PlayTheBlues4U [8c Kh]
kten5150: folds
JoJoe482: raises 40 to 60
PlayTheBlues4U: calls 40
*** FLOP *** [3c As 3d]
JoJoe482: checks
PlayTheBlues4U: checks
*** TURN *** [3c As 3d] [9s]
JoJoe482: checks
PlayTheBlues4U: checks
*** RIVER *** [3c As 3d 9s] [Ah]
JoJoe482: bets 60
PlayTheBlues4U: calls 60
*** SHOW DOWN ***
JoJoe482: shows [8d Kd] (two pair, Aces and Threes)
PlayTheBlues4U: shows [8c Kh] (two pair, Aces and Threes)
JoJoe482 collected 120 from pot
PlayTheBlues4U collected 120 from pot
*** SUMMARY ***
Total pot 240 | Rake 0
Board [3c As 3d 9s Ah]
Seat 1: JoJoe482 (small blind) showed [8d Kd] and won (120) with two pair, Aces and Threes
Seat 2: PlayTheBlues4U (big blind) showed [8c Kh] and won (120) with two pair, Aces and Threes
Seat 3: kten5150 (button) folded before Flop (didn't bet)


*********** # 18 **************
PokerStars Hand #203998488767: Tournament #2091372260, $0.93+$0.07 USD Hold'em No Limit - Level I (10/20) - 2019/09/26 22:48:18 ET
Table '2091372260 1' 3-max Seat #2 is the button
Seat 1: JoJoe482 (500 in chips)
Seat 2: PlayTheBlues4U (520 in chips)
Seat 3: kten5150 (480 in chips)
kten5150: posts small blind 10
JoJoe482: posts big blind 20
*** HOLE CARDS ***
Dealt to PlayTheBlues4U [Td 8c]
PlayTheBlues4U: folds
kten5150: calls 10
JoJoe482: raises 40 to 60
kten5150: folds
Uncalled bet (40) returned to JoJoe482
JoJoe482 collected 40 from pot
JoJoe482: doesn't show hand
*** SUMMARY ***
Total pot 40 | Rake 0
Seat 1: JoJoe482 (big blind) collected (40)
Seat 2: PlayTheBlues4U (button) folded before Flop (didn't bet)
Seat 3: kten5150 (small blind) folded before Flop


*********** # 19 **************
PokerStars Hand #203998488732: Tournament #2091372260, $0.93+$0.07 USD Hold'em No Limit - Level I (10/20) - 2019/09/26 22:48:05 ET
Table '2091372260 1' 3-max Seat #1 is the button
Seat 1: JoJoe482 (500 in chips)
Seat 2: PlayTheBlues4U (500 in chips)
Seat 3: kten5150 (500 in chips)
PlayTheBlues4U: posts small blind 10
kten5150: posts big blind 20
*** HOLE CARDS ***
Dealt to PlayTheBlues4U [As 9s]
JoJoe482: folds
PlayTheBlues4U: raises 40 to 60
kten5150: folds
Uncalled bet (40) returned to PlayTheBlues4U
PlayTheBlues4U collected 40 from pot
PlayTheBlues4U: doesn't show hand
*** SUMMARY ***
Total pot 40 | Rake 0
Seat 1: JoJoe482 (button) folded before Flop (didn't bet)
Seat 2: PlayTheBlues4U (small blind) collected (40)
Seat 3: kten5150 (big blind) folded before Flop


*********** # 20 **************
PokerStars Hand #203998488649:  Hold'em No Limit ($0.05/$0.10 USD) - 2019/09/26 22:47:35 ET
Table 'Delphinus' 6-max Seat #6 is the button
Seat 1: daughterstuitio ($10.02 in chips)
Seat 2: maxplans323 ($7.38 in chips)
Seat 3: joncruise ($14.76 in chips)
Seat 4: 921zhaopeng ($7.31 in chips)
Seat 5: SuWasup ($9.27 in chips)
Seat 6: PlayTheBlues4U ($7.48 in chips)
daughterstuitio: posts small blind $0.05
maxplans323: posts big blind $0.10
*** HOLE CARDS ***
Dealt to PlayTheBlues4U [5h 2c]
joncruise: folds
921zhaopeng: raises $0.20 to $0.30
SuWasup: folds
PlayTheBlues4U: folds
daughterstuitio: calls $0.25
maxplans323: calls $0.20
*** FLOP *** [Ah Ts 3d]
daughterstuitio: checks
maxplans323: checks
921zhaopeng: checks
*** TURN *** [Ah Ts 3d] [Ks]
daughterstuitio: checks
maxplans323: checks
921zhaopeng: bets $0.40
daughterstuitio: folds
maxplans323: calls $0.40
*** RIVER *** [Ah Ts 3d Ks] [Tc]
maxplans323: checks
921zhaopeng: checks
*** SHOW DOWN ***
maxplans323: shows [5s 6s] (a pair of Tens)
921zhaopeng: shows [9h 8h] (a pair of Tens - Ace+King+Nine kicker)
921zhaopeng collected $1.62 from pot
*** SUMMARY ***
Total pot $1.70 | Rake $0.08
Board [Ah Ts 3d Ks Tc]
Seat 1: daughterstuitio (small blind) folded on the Turn
Seat 2: maxplans323 (big blind) showed [5s 6s] and lost with a pair of Tens
Seat 3: joncruise folded before Flop (didn't bet)
Seat 4: 921zhaopeng showed [9h 8h] and won ($1.62) with a pair of Tens
Seat 5: SuWasup folded before Flop (didn't bet)
Seat 6: PlayTheBlues4U (button) folded before Flop (didn't bet)


*********** # 21 **************
PokerStars Hand #203998488633:  Hold'em No Limit ($0.05/$0.10 USD) - 2019/09/26 22:47:32 ET
Table 'Lynx' 6-max Seat #4 is the button
Seat 1: BigBlue ($7.25 in chips)
Seat 2: winbabywin7 ($8 in chips)
Seat 3: mellneazy ($20.38 in chips)
Seat 4: Ribeye63 ($12.42 in chips)
Seat 5: PlayTheBlues4U ($14.12 in chips)
Seat 6: donjt2653 ($12.17 in chips)
PlayTheBlues4U: posts small blind $0.05
donjt2653: posts big blind $0.10
winbabywin7: posts big blind $0.10
*** HOLE CARDS ***
Dealt to PlayTheBlues4U [6s Jd]
BigBlue: folds
winbabywin7: checks
mellneazy: folds
Ribeye63: calls $0.10
PlayTheBlues4U: folds
donjt2653: checks
*** FLOP *** [4d Kh Tc]
donjt2653: checks
winbabywin7: checks
Ribeye63: checks
*** TURN *** [4d Kh Tc] [3s]
donjt2653: checks
winbabywin7: checks
Ribeye63: checks
*** RIVER *** [4d Kh Tc 3s] [3c]
donjt2653: bets $0.20
winbabywin7: calls $0.20
Ribeye63: folds
*** SHOW DOWN ***
donjt2653: shows [Ts Kd] (two pair, Kings and Tens)
winbabywin7: mucks hand
donjt2653 collected $0.71 from pot
*** SUMMARY ***
Total pot $0.75 | Rake $0.04
Board [4d Kh Tc 3s 3c]
Seat 1: BigBlue folded before Flop (didn't bet)
Seat 2: winbabywin7 mucked [4h 2c]
Seat 3: mellneazy folded before Flop (didn't bet)
Seat 4: Ribeye63 (button) folded on the River
Seat 5: PlayTheBlues4U (small blind) folded before Flop
Seat 6: donjt2653 (big blind) showed [Ts Kd] and won ($0.71) with two pair, Kings and Tens


*********** # 22 **************
PokerStars Hand #203998488460:  Hold'em No Limit ($0.05/$0.10 USD) - 2019/09/26 22:46:30 ET
Table 'Delphinus' 6-max Seat #5 is the button
Seat 1: daughterstuitio ($10.12 in chips)
Seat 2: maxplans323 ($6.66 in chips)
Seat 3: joncruise ($14.76 in chips)
Seat 4: 921zhaopeng ($7.31 in chips)
Seat 5: SuWasup ($9.27 in chips)
Seat 6: PlayTheBlues4U ($8.18 in chips)
PlayTheBlues4U: posts small blind $0.05
daughterstuitio: posts big blind $0.10
*** HOLE CARDS ***
Dealt to PlayTheBlues4U [8d 6d]
maxplans323: raises $0.20 to $0.30
joncruise: folds
921zhaopeng: folds
SuWasup: folds
PlayTheBlues4U: calls $0.25
daughterstuitio: folds
*** FLOP *** [5h Qc Kd]
PlayTheBlues4U: bets $0.40
maxplans323: calls $0.40
*** TURN *** [5h Qc Kd] [3c]
PlayTheBlues4U: checks
maxplans323: checks
*** RIVER *** [5h Qc Kd 3c] [Th]
PlayTheBlues4U: checks
maxplans323: bets $0.95
PlayTheBlues4U: folds
Uncalled bet ($0.95) returned to maxplans323
maxplans323 collected $1.42 from pot
maxplans323: doesn't show hand
*** SUMMARY ***
Total pot $1.50 | Rake $0.08
Board [5h Qc Kd 3c Th]
Seat 1: daughterstuitio (big blind) folded before Flop
Seat 2: maxplans323 collected ($1.42)
Seat 3: joncruise folded before Flop (didn't bet)
Seat 4: 921zhaopeng folded before Flop (didn't bet)
Seat 5: SuWasup (button) folded before Flop (didn't bet)
Seat 6: PlayTheBlues4U (small blind) folded on the River


*********** # 23 **************
PokerStars Hand #203998488434:  Hold'em No Limit ($0.05/$0.10 USD) - 2019/09/26 22:46:18 ET
Table 'Lynx' 6-max Seat #3 is the button
Seat 1: BigBlue ($7.25 in chips)
Seat 3: mellneazy ($21.53 in chips)
Seat 4: Ribeye63 ($12.47 in chips)
Seat 5: PlayTheBlues4U ($15.27 in chips)
Seat 6: donjt2653 ($10 in chips)
Ribeye63: posts small blind $0.05
PlayTheBlues4U: posts big blind $0.10
*** HOLE CARDS ***
Dealt to PlayTheBlues4U [4s 5h]
winbabywin7 joins the table at seat #2
donjt2653: calls $0.10
BigBlue: folds
mellneazy: raises $0.35 to $0.45
Ribeye63: folds
PlayTheBlues4U: calls $0.35
donjt2653: calls $0.35
*** FLOP *** [4d 2s Ad]
PlayTheBlues4U: checks
donjt2653: checks
mellneazy: bets $0.70
PlayTheBlues4U: calls $0.70
donjt2653: raises $1 to $1.70
mellneazy: folds
PlayTheBlues4U: folds
Uncalled bet ($1) returned to donjt2653
donjt2653 collected $3.32 from pot
donjt2653: doesn't show hand
*** SUMMARY ***
Total pot $3.50 | Rake $0.18
Board [4d 2s Ad]
Seat 1: BigBlue folded before Flop (didn't bet)
Seat 3: mellneazy (button) folded on the Flop
Seat 4: Ribeye63 (small blind) folded before Flop
Seat 5: PlayTheBlues4U (big blind) folded on the Flop
Seat 6: donjt2653 collected ($3.32)


*********** # 24 **************
PokerStars Hand #203998488361:  Hold'em No Limit ($0.05/$0.10 USD) - 2019/09/26 22:45:57 ET
Table 'Lynx' 6-max Seat #2 is the button
Seat 1: BigBlue ($7.55 in chips)
Seat 2: DigBickBlad ($14.43 in chips)
Seat 3: mellneazy ($21.13 in chips)
Seat 4: Ribeye63 ($12.57 in chips)
Seat 5: PlayTheBlues4U ($15.27 in chips)
mellneazy: posts small blind $0.05
Ribeye63: posts big blind $0.10
*** HOLE CARDS ***
Dealt to PlayTheBlues4U [5s 2h]
PlayTheBlues4U: folds
BigBlue: raises $0.20 to $0.30
DigBickBlad: folds
DigBickBlad leaves the table
mellneazy: raises $0.70 to $1
Ribeye63: folds
BigBlue: folds
Uncalled bet ($0.70) returned to mellneazy
mellneazy collected $0.70 from pot
mellneazy: doesn't show hand
*** SUMMARY ***
Total pot $0.70 | Rake $0
Seat 1: BigBlue folded before Flop
Seat 2: DigBickBlad (button) folded before Flop (didn't bet)
Seat 3: mellneazy (small blind) collected ($0.70)
Seat 4: Ribeye63 (big blind) folded before Flop
Seat 5: PlayTheBlues4U folded before Flop (didn't bet)


*********** # 25 **************
PokerStars Hand #203998488209:  Hold'em No Limit ($0.05/$0.10 USD) - 2019/09/26 22:45:00 ET
Table 'Delphinus' 6-max Seat #4 is the button
Seat 1: daughterstuitio ($10.12 in chips)
Seat 2: maxplans323 ($6.66 in chips)
Seat 3: joncruise ($11.74 in chips)
Seat 4: 921zhaopeng ($9.71 in chips)
Seat 5: SuWasup ($10.07 in chips)
Seat 6: PlayTheBlues4U ($8.28 in chips)
SuWasup: posts small blind $0.05
PlayTheBlues4U: posts big blind $0.10
*** HOLE CARDS ***
Dealt to PlayTheBlues4U [Jh 5h]
daughterstuitio: folds
maxplans323: folds
joncruise: raises $0.10 to $0.20
921zhaopeng: calls $0.20
SuWasup: raises $0.60 to $0.80
PlayTheBlues4U: folds
joncruise: calls $0.60
921zhaopeng: calls $0.60
*** FLOP *** [Td Jd 9d]
SuWasup: checks
joncruise: checks
921zhaopeng: checks
*** TURN *** [Td Jd 9d] [8h]
SuWasup: checks
joncruise: bets $0.70
921zhaopeng: calls $0.70
SuWasup: folds
*** RIVER *** [Td Jd 9d 8h] [9s]
joncruise: bets $0.90
921zhaopeng: calls $0.90
*** SHOW DOWN ***
joncruise: shows [7h 7s] (a straight, Seven to Jack)
921zhaopeng: mucks hand
joncruise collected $5.42 from pot
*** SUMMARY ***
Total pot $5.70 | Rake $0.28
Board [Td Jd 9d 8h 9s]
Seat 1: daughterstuitio folded before Flop (didn't bet)
Seat 2: maxplans323 folded before Flop (didn't bet)
Seat 3: joncruise showed [7h 7s] and won ($5.42) with a straight, Seven to Jack
Seat 4: 921zhaopeng (button) mucked [Jc Ah]
Seat 5: SuWasup (small blind) folded on the Turn
Seat 6: PlayTheBlues4U (big blind) folded before Flop


*********** # 26 **************
PokerStars Hand #203998488188:  Hold'em No Limit ($0.05/$0.10 USD) - 2019/09/26 22:44:54 ET
Table 'Lynx' 6-max Seat #1 is the button
Seat 1: BigBlue ($7.55 in chips)
Seat 2: DigBickBlad ($9.49 in chips)
Seat 3: mellneazy ($21.23 in chips)
Seat 4: Ribeye63 ($12.57 in chips)
Seat 5: PlayTheBlues4U ($15.27 in chips)
Seat 6: donjt2653 ($5.38 in chips)
DigBickBlad: posts small blind $0.05
mellneazy: posts big blind $0.10
*** HOLE CARDS ***
Dealt to PlayTheBlues4U [8h Qs]
Ribeye63: folds
PlayTheBlues4U: folds
donjt2653: raises $0.20 to $0.30
BigBlue: folds
DigBickBlad: calls $0.25
mellneazy: folds
*** FLOP *** [2c As 9s]
DigBickBlad: bets $1
donjt2653: calls $1
*** TURN *** [2c As 9s] [6c]
DigBickBlad: bets $1.10
donjt2653: calls $1.10
*** RIVER *** [2c As 9s 6c] [Ts]
DigBickBlad: bets $3.70
donjt2653: calls $2.98 and is all-in
Uncalled bet ($0.72) returned to DigBickBlad
*** SHOW DOWN ***
DigBickBlad: shows [2h Ad] (two pair, Aces and Deuces)
donjt2653: shows [9h Tc] (two pair, Tens and Nines)
DigBickBlad collected $10.32 from pot
*** SUMMARY ***
Total pot $10.86 | Rake $0.54
Board [2c As 9s 6c Ts]
Seat 1: BigBlue (button) folded before Flop (didn't bet)
Seat 2: DigBickBlad (small blind) showed [2h Ad] and won ($10.32) with two pair, Aces and Deuces
Seat 3: mellneazy (big blind) folded before Flop
Seat 4: Ribeye63 folded before Flop (didn't bet)
Seat 5: PlayTheBlues4U folded before Flop (didn't bet)
Seat 6: donjt2653 showed [9h Tc] and lost with two pair, Tens and Nines


*********** # 27 **************
PokerStars Hand #203998488087:  Hold'em No Limit ($0.05/$0.10 USD) - 2019/09/26 22:44:24 ET
Table 'Delphinus' 6-max Seat #3 is the button
Seat 1: daughterstuitio ($10.12 in chips)
Seat 2: maxplans323 ($6.66 in chips)
Seat 3: joncruise ($7.85 in chips)
Seat 4: 921zhaopeng ($13.61 in chips)
Seat 5: SuWasup ($10.17 in chips)
Seat 6: PlayTheBlues4U ($8.58 in chips)
921zhaopeng: posts small blind $0.05
SuWasup: posts big blind $0.10
*** HOLE CARDS ***
Dealt to PlayTheBlues4U [7c Ac]
PlayTheBlues4U: raises $0.20 to $0.30
daughterstuitio: folds
maxplans323: folds
joncruise: calls $0.30
921zhaopeng: calls $0.25
SuWasup: folds
*** FLOP *** [Th 4c 4s]
921zhaopeng: bets $0.60
PlayTheBlues4U: folds
joncruise: calls $0.60
*** TURN *** [Th 4c 4s] [4d]
921zhaopeng: bets $1
joncruise: calls $1
*** RIVER *** [Th 4c 4s 4d] [8s]
921zhaopeng: bets $2
joncruise: calls $2
*** SHOW DOWN ***
921zhaopeng: shows [3d Qd] (three of a kind, Fours)
joncruise: shows [Tc 9d] (a full house, Fours full of Tens)
joncruise collected $7.79 from pot
*** SUMMARY ***
Total pot $8.20 | Rake $0.41
Board [Th 4c 4s 4d 8s]
Seat 1: daughterstuitio folded before Flop (didn't bet)
Seat 2: maxplans323 folded before Flop (didn't bet)
Seat 3: joncruise (button) showed [Tc 9d] and won ($7.79) with a full house, Fours full of Tens
Seat 4: 921zhaopeng (small blind) showed [3d Qd] and lost with three of a kind, Fours
Seat 5: SuWasup (big blind) folded before Flop
Seat 6: PlayTheBlues4U folded on the Flop


*********** # 28 **************
PokerStars Hand #203998488036:  Hold'em No Limit ($0.05/$0.10 USD) - 2019/09/26 22:44:09 ET
Table 'Lynx' 6-max Seat #6 is the button
Seat 1: BigBlue ($7.60 in chips)
Seat 2: DigBickBlad ($9.59 in chips)
Seat 3: mellneazy ($20.37 in chips)
Seat 4: Ribeye63 ($12.57 in chips)
Seat 5: PlayTheBlues4U ($16.07 in chips)
Seat 6: donjt2653 ($5.38 in chips)
BigBlue: posts small blind $0.05
DigBickBlad: posts big blind $0.10
*** HOLE CARDS ***
Dealt to PlayTheBlues4U [Tc Qc]
mellneazy: raises $0.20 to $0.30
Ribeye63: folds
PlayTheBlues4U: raises $0.50 to $0.80
donjt2653: folds
BigBlue: folds
DigBickBlad: folds
mellneazy: calls $0.50
*** FLOP *** [9h 6d 6h]
mellneazy: checks
PlayTheBlues4U: checks
*** TURN *** [9h 6d 6h] [3d]
mellneazy: checks
PlayTheBlues4U: checks
*** RIVER *** [9h 6d 6h 3d] [2c]
mellneazy: bets $1
PlayTheBlues4U: folds
Uncalled bet ($1) returned to mellneazy
mellneazy collected $1.66 from pot
mellneazy: doesn't show hand
*** SUMMARY ***
Total pot $1.75 | Rake $0.09
Board [9h 6d 6h 3d 2c]
Seat 1: BigBlue (small blind) folded before Flop
Seat 2: DigBickBlad (big blind) folded before Flop
Seat 3: mellneazy collected ($1.66)
Seat 4: Ribeye63 folded before Flop (didn't bet)
Seat 5: PlayTheBlues4U folded on the River
Seat 6: donjt2653 (button) folded before Flop (didn't bet)


*********** # 29 **************
PokerStars Hand #203998488011:  Hold'em No Limit ($0.05/$0.10 USD) - 2019/09/26 22:44:01 ET
Table 'Delphinus' 6-max Seat #2 is the button
Seat 1: daughterstuitio ($9.71 in chips)
Seat 2: maxplans323 ($6.96 in chips)
Seat 3: joncruise ($7.90 in chips)
Seat 4: 921zhaopeng ($13.71 in chips)
Seat 5: SuWasup ($10.17 in chips)
Seat 6: PlayTheBlues4U ($8.58 in chips)
joncruise: posts small blind $0.05
921zhaopeng: posts big blind $0.10
*** HOLE CARDS ***
Dealt to PlayTheBlues4U [Ks 4s]
SuWasup: folds
PlayTheBlues4U: folds
daughterstuitio: calls $0.10
maxplans323: raises $0.20 to $0.30
joncruise: folds
921zhaopeng: folds
daughterstuitio: calls $0.20
*** FLOP *** [5h 8d 3h]
daughterstuitio: bets $0.40
maxplans323: folds
Uncalled bet ($0.40) returned to daughterstuitio
daughterstuitio collected $0.71 from pot
daughterstuitio: doesn't show hand
*** SUMMARY ***
Total pot $0.75 | Rake $0.04
Board [5h 8d 3h]
Seat 1: daughterstuitio collected ($0.71)
Seat 2: maxplans323 (button) folded on the Flop
Seat 3: joncruise (small blind) folded before Flop
Seat 4: 921zhaopeng (big blind) folded before Flop
Seat 5: SuWasup folded before Flop (didn't bet)
Seat 6: PlayTheBlues4U folded before Flop (didn't bet)


*********** # 30 **************
PokerStars Hand #203998487950:  Hold'em No Limit ($0.05/$0.10 USD) - 2019/09/26 22:43:43 ET
Table 'Lynx' 6-max Seat #5 is the button
Seat 1: BigBlue ($7.70 in chips)
Seat 2: DigBickBlad ($10.04 in chips)
Seat 3: mellneazy ($19.82 in chips)
Seat 4: Ribeye63 ($12.57 in chips)
Seat 5: PlayTheBlues4U ($16.07 in chips)
Seat 6: donjt2653 ($5.43 in chips)
donjt2653: posts small blind $0.05
BigBlue: posts big blind $0.10
*** HOLE CARDS ***
Dealt to PlayTheBlues4U [Kc 3h]
DigBickBlad: calls $0.10
mellneazy: raises $0.35 to $0.45
Ribeye63: folds
PlayTheBlues4U: folds
donjt2653: folds
BigBlue: folds
DigBickBlad: calls $0.35
*** FLOP *** [Tc 8s 5d]
DigBickBlad: checks
mellneazy: bets $0.50
DigBickBlad: folds
Uncalled bet ($0.50) returned to mellneazy
mellneazy collected $1 from pot
mellneazy: doesn't show hand
*** SUMMARY ***
Total pot $1.05 | Rake $0.05
Board [Tc 8s 5d]
Seat 1: BigBlue (big blind) folded before Flop
Seat 2: DigBickBlad folded on the Flop
Seat 3: mellneazy collected ($1)
Seat 4: Ribeye63 folded before Flop (didn't bet)
Seat 5: PlayTheBlues4U (button) folded before Flop (didn't bet)
Seat 6: donjt2653 (small blind) folded before Flop


*********** # 31 **************
PokerStars Hand #203998487892:  Hold'em No Limit ($0.05/$0.10 USD) - 2019/09/26 22:43:21 ET
Table 'Delphinus' 6-max Seat #1 is the button
Seat 1: daughterstuitio ($9.71 in chips)
Seat 2: maxplans323 ($7.26 in chips)
Seat 3: joncruise ($7.34 in chips)
Seat 4: 921zhaopeng ($13.71 in chips)
Seat 5: SuWasup ($10.47 in chips)
Seat 6: PlayTheBlues4U ($8.58 in chips)
maxplans323: posts small blind $0.05
joncruise: posts big blind $0.10
*** HOLE CARDS ***
Dealt to PlayTheBlues4U [3d Jd]
921zhaopeng: folds
SuWasup: raises $0.20 to $0.30
PlayTheBlues4U: folds
daughterstuitio: folds
maxplans323: calls $0.25
joncruise: calls $0.20
*** FLOP *** [6h Tc 4c]
maxplans323: checks
joncruise: bets $0.40
SuWasup: folds
maxplans323: folds
Uncalled bet ($0.40) returned to joncruise
joncruise collected $0.86 from pot
joncruise: doesn't show hand
*** SUMMARY ***
Total pot $0.90 | Rake $0.04
Board [6h Tc 4c]
Seat 1: daughterstuitio (button) folded before Flop (didn't bet)
Seat 2: maxplans323 (small blind) folded on the Flop
Seat 3: joncruise (big blind) collected ($0.86)
Seat 4: 921zhaopeng folded before Flop (didn't bet)
Seat 5: SuWasup folded on the Flop
Seat 6: PlayTheBlues4U folded before Flop (didn't bet)


*********** # 32 **************
PokerStars Hand #203998487822:  Hold'em No Limit ($0.05/$0.10 USD) - 2019/09/26 22:42:58 ET
Table 'Lynx' 6-max Seat #4 is the button
Seat 1: BigBlue ($7.70 in chips)
Seat 2: DigBickBlad ($10.04 in chips)
Seat 3: mellneazy ($19.82 in chips)
Seat 4: Ribeye63 ($12.34 in chips)
Seat 5: PlayTheBlues4U ($16.12 in chips)
Seat 6: donjt2653 ($5.63 in chips)
PlayTheBlues4U: posts small blind $0.05
donjt2653: posts big blind $0.10
*** HOLE CARDS ***
Dealt to PlayTheBlues4U [2h Kh]
BigBlue: folds
DigBickBlad: folds
mellneazy: folds
Ribeye63: raises $0.10 to $0.20
PlayTheBlues4U: folds
donjt2653: calls $0.10
*** FLOP *** [8c 2s 4c]
donjt2653: checks
Ribeye63: checks
*** TURN *** [8c 2s 4c] [8h]
donjt2653: checks
Ribeye63: checks
*** RIVER *** [8c 2s 4c 8h] [7c]
donjt2653: checks
Ribeye63: checks
*** SHOW DOWN ***
donjt2653: shows [9c Ks] (a pair of Eights)
Ribeye63: shows [Ad Qd] (a pair of Eights - Ace kicker)
Ribeye63 collected $0.43 from pot
*** SUMMARY ***
Total pot $0.45 | Rake $0.02
Board [8c 2s 4c 8h 7c]
Seat 1: BigBlue folded before Flop (didn't bet)
Seat 2: DigBickBlad folded before Flop (didn't bet)
Seat 3: mellneazy folded before Flop (didn't bet)
Seat 4: Ribeye63 (button) showed [Ad Qd] and won ($0.43) with a pair of Eights
Seat 5: PlayTheBlues4U (small blind) folded before Flop
Seat 6: donjt2653 (big blind) showed [9c Ks] and lost with a pair of Eights


*********** # 33 **************
PokerStars Hand #203998487793:  Hold'em No Limit ($0.05/$0.10 USD) - 2019/09/26 22:42:48 ET
Table 'Delphinus' 6-max Seat #6 is the button
Seat 1: daughterstuitio ($10.01 in chips)
Seat 2: maxplans323 ($7.56 in chips)
Seat 3: joncruise ($7.34 in chips)
Seat 4: 921zhaopeng ($13.71 in chips)
Seat 5: SuWasup ($10.47 in chips)
Seat 6: PlayTheBlues4U ($8.02 in chips)
daughterstuitio: posts small blind $0.05
maxplans323: posts big blind $0.10
*** HOLE CARDS ***
Dealt to PlayTheBlues4U [Qd Tc]
joncruise: folds
921zhaopeng: folds
SuWasup: folds
PlayTheBlues4U: raises $0.20 to $0.30
daughterstuitio: calls $0.25
maxplans323: calls $0.20
*** FLOP *** [5d Js 8c]
daughterstuitio: checks
maxplans323: checks
PlayTheBlues4U: bets $0.40
daughterstuitio: folds
maxplans323: folds
Uncalled bet ($0.40) returned to PlayTheBlues4U
PlayTheBlues4U collected $0.86 from pot
PlayTheBlues4U: doesn't show hand
*** SUMMARY ***
Total pot $0.90 | Rake $0.04
Board [5d Js 8c]
Seat 1: daughterstuitio (small blind) folded on the Flop
Seat 2: maxplans323 (big blind) folded on the Flop
Seat 3: joncruise folded before Flop (didn't bet)
Seat 4: 921zhaopeng folded before Flop (didn't bet)
Seat 5: SuWasup folded before Flop (didn't bet)
Seat 6: PlayTheBlues4U (button) collected ($0.86)


*********** # 34 **************
PokerStars Hand #203998487757:  Hold'em No Limit ($0.05/$0.10 USD) - 2019/09/26 22:42:37 ET
Table 'Delphinus' 6-max Seat #5 is the button
Seat 1: daughterstuitio ($9.96 in chips)
Seat 2: maxplans323 ($7.56 in chips)
Seat 3: joncruise ($7.34 in chips)
Seat 4: 921zhaopeng ($13.71 in chips)
Seat 5: SuWasup ($10.47 in chips)
Seat 6: PlayTheBlues4U ($8.07 in chips)
PlayTheBlues4U: posts small blind $0.05
daughterstuitio: posts big blind $0.10
*** HOLE CARDS ***
Dealt to PlayTheBlues4U [Ts 3c]
maxplans323: folds
joncruise: folds
921zhaopeng: folds
SuWasup: folds
PlayTheBlues4U: folds
Uncalled bet ($0.05) returned to daughterstuitio
daughterstuitio collected $0.10 from pot
daughterstuitio: doesn't show hand
*** SUMMARY ***
Total pot $0.10 | Rake $0
Seat 1: daughterstuitio (big blind) collected ($0.10)
Seat 2: maxplans323 folded before Flop (didn't bet)
Seat 3: joncruise folded before Flop (didn't bet)
Seat 4: 921zhaopeng folded before Flop (didn't bet)
Seat 5: SuWasup (button) folded before Flop (didn't bet)
Seat 6: PlayTheBlues4U (small blind) folded before Flop


*********** # 35 **************
PokerStars Hand #203998487705:  Hold'em No Limit ($0.05/$0.10 USD) - 2019/09/26 22:42:19 ET
Table 'Lynx' 6-max Seat #3 is the button
Seat 1: BigBlue ($7.70 in chips)
Seat 2: DigBickBlad ($10.14 in chips)
Seat 3: mellneazy ($20.37 in chips)
Seat 4: Ribeye63 ($12.39 in chips)
Seat 5: PlayTheBlues4U ($16.67 in chips)
Seat 6: donjt2653 ($4.38 in chips)
Ribeye63: posts small blind $0.05
PlayTheBlues4U: posts big blind $0.10
*** HOLE CARDS ***
Dealt to PlayTheBlues4U [Ah 8h]
donjt2653: calls $0.10
BigBlue: folds
DigBickBlad: calls $0.10
mellneazy: raises $0.45 to $0.55
Ribeye63: folds
PlayTheBlues4U: calls $0.45
donjt2653: raises $3.83 to $4.38 and is all-in
DigBickBlad: folds
mellneazy: folds
PlayTheBlues4U: folds
Uncalled bet ($3.83) returned to donjt2653
donjt2653 collected $1.80 from pot
donjt2653: doesn't show hand
*** SUMMARY ***
Total pot $1.80 | Rake $0
Seat 1: BigBlue folded before Flop (didn't bet)
Seat 2: DigBickBlad folded before Flop
Seat 3: mellneazy (button) folded before Flop
Seat 4: Ribeye63 (small blind) folded before Flop
Seat 5: PlayTheBlues4U (big blind) folded before Flop
Seat 6: donjt2653 collected ($1.80)


*********** # 36 **************
PokerStars Hand #203998487543:  Hold'em No Limit ($0.05/$0.10 USD) - 2019/09/26 22:41:32 ET
Table 'Lynx' 6-max Seat #2 is the button
Seat 1: BigBlue ($7.70 in chips)
Seat 2: DigBickBlad ($10.64 in chips)
Seat 3: mellneazy ($18.63 in chips)
Seat 4: Ribeye63 ($12.49 in chips)
Seat 5: PlayTheBlues4U ($16.67 in chips)
Seat 6: donjt2653 ($5.68 in chips)
mellneazy: posts small blind $0.05
Ribeye63: posts big blind $0.10
*** HOLE CARDS ***
Dealt to PlayTheBlues4U [6h 3h]
PlayTheBlues4U: folds
donjt2653: calls $0.10
BigBlue: folds
DigBickBlad: calls $0.10
mellneazy: raises $0.40 to $0.50
Ribeye63: folds
donjt2653: calls $0.40
DigBickBlad: calls $0.40
*** FLOP *** [8h 5s 4c]
mellneazy: bets $0.80
donjt2653: calls $0.80
DigBickBlad: folds
*** TURN *** [8h 5s 4c] [Js]
mellneazy: checks
donjt2653: checks
*** RIVER *** [8h 5s 4c Js] [Qs]
mellneazy: checks
donjt2653: checks
*** SHOW DOWN ***
mellneazy: shows [Qh Ah] (a pair of Queens)
donjt2653: mucks hand
mellneazy collected $3.04 from pot
*** SUMMARY ***
Total pot $3.20 | Rake $0.16
Board [8h 5s 4c Js Qs]
Seat 1: BigBlue folded before Flop (didn't bet)
Seat 2: DigBickBlad (button) folded on the Flop
Seat 3: mellneazy (small blind) showed [Qh Ah] and won ($3.04) with a pair of Queens
Seat 4: Ribeye63 (big blind) folded before Flop
Seat 5: PlayTheBlues4U folded before Flop (didn't bet)
Seat 6: donjt2653 mucked [6d 4d]


*********** # 37 **************
PokerStars Hand #203998487420:  Hold'em No Limit ($0.05/$0.10 USD) - 2019/09/26 22:40:50 ET
Table 'Lynx' 6-max Seat #1 is the button
Seat 1: BigBlue ($7.70 in chips)
Seat 2: DigBickBlad ($5.45 in chips)
Seat 3: mellneazy ($18.93 in chips)
Seat 4: Ribeye63 ($12.49 in chips)
Seat 5: PlayTheBlues4U ($16.67 in chips)
Seat 6: donjt2653 ($11.13 in chips)
DigBickBlad: posts small blind $0.05
mellneazy: posts big blind $0.10
*** HOLE CARDS ***
Dealt to PlayTheBlues4U [4c 9s]
Ribeye63: folds
PlayTheBlues4U: folds
donjt2653: raises $0.20 to $0.30
BigBlue: folds
DigBickBlad: calls $0.25
mellneazy: calls $0.20
*** FLOP *** [2s 3s Qh]
DigBickBlad: bets $1
mellneazy: folds
donjt2653: calls $1
*** TURN *** [2s 3s Qh] [7d]
DigBickBlad: bets $1
donjt2653: raises $8.83 to $9.83 and is all-in
DigBickBlad: calls $3.15 and is all-in
Uncalled bet ($5.68) returned to donjt2653
*** RIVER *** [2s 3s Qh 7d] [9c]
*** SHOW DOWN ***
DigBickBlad: shows [Qs Jh] (a pair of Queens)
donjt2653: shows [Th Qd] (a pair of Queens - lower kicker)
DigBickBlad collected $10.64 from pot
*** SUMMARY ***
Total pot $11.20 | Rake $0.56
Board [2s 3s Qh 7d 9c]
Seat 1: BigBlue (button) folded before Flop (didn't bet)
Seat 2: DigBickBlad (small blind) showed [Qs Jh] and won ($10.64) with a pair of Queens
Seat 3: mellneazy (big blind) folded on the Flop
Seat 4: Ribeye63 folded before Flop (didn't bet)
Seat 5: PlayTheBlues4U folded before Flop (didn't bet)
Seat 6: donjt2653 showed [Th Qd] and lost with a pair of Queens


*********** # 38 **************
PokerStars Hand #203998487416:  Hold'em No Limit ($0.05/$0.10 USD) - 2019/09/26 22:40:49 ET
Table 'Delphinus' 6-max Seat #4 is the button
Seat 1: daughterstuitio ($9.96 in chips)
Seat 2: maxplans323 ($7.56 in chips)
Seat 3: joncruise ($7.34 in chips)
Seat 4: 921zhaopeng ($13.71 in chips)
Seat 5: SuWasup ($8.94 in chips)
Seat 6: PlayTheBlues4U ($9.77 in chips)
SuWasup: posts small blind $0.05
PlayTheBlues4U: posts big blind $0.10
*** HOLE CARDS ***
Dealt to PlayTheBlues4U [Ad 6s]
daughterstuitio: folds
maxplans323: folds
joncruise: folds
921zhaopeng: folds
SuWasup: raises $0.30 to $0.40
PlayTheBlues4U: calls $0.30
*** FLOP *** [5d Js Kh]
SuWasup: checks
PlayTheBlues4U: bets $0.40
SuWasup: calls $0.40
*** TURN *** [5d Js Kh] [3c]
SuWasup: checks
PlayTheBlues4U: checks
*** RIVER *** [5d Js Kh 3c] [9d]
SuWasup: checks
PlayTheBlues4U: bets $0.90
SuWasup: raises $1.30 to $2.20
PlayTheBlues4U: folds
Uncalled bet ($1.30) returned to SuWasup
SuWasup collected $3.23 from pot
SuWasup: doesn't show hand
*** SUMMARY ***
Total pot $3.40 | Rake $0.17
Board [5d Js Kh 3c 9d]
Seat 1: daughterstuitio folded before Flop (didn't bet)
Seat 2: maxplans323 folded before Flop (didn't bet)
Seat 3: joncruise folded before Flop (didn't bet)
Seat 4: 921zhaopeng (button) folded before Flop (didn't bet)
Seat 5: SuWasup (small blind) collected ($3.23)
Seat 6: PlayTheBlues4U (big blind) folded on the River


*********** # 39 **************
PokerStars Hand #203998487292:  Hold'em No Limit ($0.05/$0.10 USD) - 2019/09/26 22:40:04 ET
Table 'Lynx' 6-max Seat #6 is the button
Seat 1: BigBlue ($7.75 in chips)
Seat 2: DigBickBlad ($5.75 in chips)
Seat 3: mellneazy ($19.63 in chips)
Seat 4: Ribeye63 ($13.19 in chips)
Seat 5: PlayTheBlues4U ($16.67 in chips)
Seat 6: donjt2653 ($9.50 in chips)
BigBlue: posts small blind $0.05
DigBickBlad: posts big blind $0.10
*** HOLE CARDS ***
Dealt to PlayTheBlues4U [9d 7h]
mellneazy: raises $0.20 to $0.30
Ribeye63: calls $0.30
PlayTheBlues4U: folds
donjt2653: calls $0.30
BigBlue: folds
DigBickBlad: calls $0.20
*** FLOP *** [4h 8h 6d]
DigBickBlad: checks
mellneazy: checks
Ribeye63: bets $0.40
donjt2653: calls $0.40
DigBickBlad: folds
mellneazy: calls $0.40
*** TURN *** [4h 8h 6d] [5c]
mellneazy: checks
Ribeye63: checks
donjt2653: bets $2.30
mellneazy: folds
Ribeye63: folds
Uncalled bet ($2.30) returned to donjt2653
donjt2653 collected $2.33 from pot
donjt2653: doesn't show hand
*** SUMMARY ***
Total pot $2.45 | Rake $0.12
Board [4h 8h 6d 5c]
Seat 1: BigBlue (small blind) folded before Flop
Seat 2: DigBickBlad (big blind) folded on the Flop
Seat 3: mellneazy folded on the Turn
Seat 4: Ribeye63 folded on the Turn
Seat 5: PlayTheBlues4U folded before Flop (didn't bet)
Seat 6: donjt2653 (button) collected ($2.33)


*********** # 40 **************
PokerStars Hand #203998487224:  Hold'em No Limit ($0.05/$0.10 USD) - 2019/09/26 22:39:41 ET
Table 'Delphinus' 6-max Seat #3 is the button
Seat 1: daughterstuitio ($9.96 in chips)
Seat 2: maxplans323 ($7.56 in chips)
Seat 3: joncruise ($7.34 in chips)
Seat 4: 921zhaopeng ($13.17 in chips)
Seat 5: SuWasup ($9.54 in chips)
Seat 6: PlayTheBlues4U ($9.77 in chips)
921zhaopeng: posts small blind $0.05
SuWasup: posts big blind $0.10
*** HOLE CARDS ***
Dealt to PlayTheBlues4U [As 4c]
PlayTheBlues4U: folds
daughterstuitio: folds
maxplans323: folds
joncruise: folds
921zhaopeng: calls $0.05
SuWasup: checks
*** FLOP *** [3h Ks 8s]
921zhaopeng: bets $0.20
SuWasup: calls $0.20
*** TURN *** [3h Ks 8s] [Qh]
921zhaopeng: bets $0.30
SuWasup: calls $0.30
*** RIVER *** [3h Ks 8s Qh] [8d]
921zhaopeng: checks
SuWasup: checks
*** SHOW DOWN ***
921zhaopeng: shows [Kd 6h] (two pair, Kings and Eights)
SuWasup: mucks hand
921zhaopeng collected $1.14 from pot
*** SUMMARY ***
Total pot $1.20 | Rake $0.06
Board [3h Ks 8s Qh 8d]
Seat 1: daughterstuitio folded before Flop (didn't bet)
Seat 2: maxplans323 folded before Flop (didn't bet)
Seat 3: joncruise (button) folded before Flop (didn't bet)
Seat 4: 921zhaopeng (small blind) showed [Kd 6h] and won ($1.14) with two pair, Kings and Eights
Seat 5: SuWasup (big blind) mucked [Jh 3s]
Seat 6: PlayTheBlues4U folded before Flop (didn't bet)


*********** # 41 **************
PokerStars Hand #203998487208:  Hold'em No Limit ($0.05/$0.10 USD) - 2019/09/26 22:39:35 ET
Table 'Lynx' 6-max Seat #5 is the button
Seat 1: BigBlue ($7.85 in chips)
Seat 3: mellneazy ($19.27 in chips)
Seat 4: Ribeye63 ($13.19 in chips)
Seat 5: PlayTheBlues4U ($16.67 in chips)
Seat 6: donjt2653 ($9.80 in chips)
donjt2653: posts small blind $0.05
BigBlue: posts big blind $0.10
DigBickBlad: sits out
*** HOLE CARDS ***
Dealt to PlayTheBlues4U [7c Qd]
mellneazy: raises $0.20 to $0.30
Ribeye63: folds
PlayTheBlues4U: folds
donjt2653: calls $0.25
BigBlue: folds
*** FLOP *** [9s 5c 3c]
donjt2653: checks
mellneazy: bets $0.30
donjt2653: folds
Uncalled bet ($0.30) returned to mellneazy
mellneazy collected $0.66 from pot
mellneazy: doesn't show hand
*** SUMMARY ***
Total pot $0.70 | Rake $0.04
Board [9s 5c 3c]
Seat 1: BigBlue (big blind) folded before Flop
Seat 3: mellneazy collected ($0.66)
Seat 4: Ribeye63 folded before Flop (didn't bet)
Seat 5: PlayTheBlues4U (button) folded before Flop (didn't bet)
Seat 6: donjt2653 (small blind) folded on the Flop


*********** # 42 **************
PokerStars Hand #203998487143:  Hold'em No Limit ($0.05/$0.10 USD) - 2019/09/26 22:39:17 ET
Table 'Delphinus' 6-max Seat #2 is the button
Seat 1: daughterstuitio ($10.26 in chips)
Seat 2: maxplans323 ($7.56 in chips)
Seat 3: joncruise ($7.39 in chips)
Seat 4: 921zhaopeng ($13.27 in chips)
Seat 5: SuWasup ($9.54 in chips)
Seat 6: PlayTheBlues4U ($9.36 in chips)
joncruise: posts small blind $0.05
921zhaopeng: posts big blind $0.10
*** HOLE CARDS ***
Dealt to PlayTheBlues4U [Ac Td]
SuWasup: folds
PlayTheBlues4U: raises $0.20 to $0.30
daughterstuitio: calls $0.30
maxplans323: folds
joncruise: folds
921zhaopeng: folds
*** FLOP *** [8s 2h 4h]
PlayTheBlues4U: bets $0.40
daughterstuitio: folds
Uncalled bet ($0.40) returned to PlayTheBlues4U
PlayTheBlues4U collected $0.71 from pot
PlayTheBlues4U: doesn't show hand
*** SUMMARY ***
Total pot $0.75 | Rake $0.04
Board [8s 2h 4h]
Seat 1: daughterstuitio folded on the Flop
Seat 2: maxplans323 (button) folded before Flop (didn't bet)
Seat 3: joncruise (small blind) folded before Flop
Seat 4: 921zhaopeng (big blind) folded before Flop
Seat 5: SuWasup folded before Flop (didn't bet)
Seat 6: PlayTheBlues4U collected ($0.71)


*********** # 43 **************
PokerStars Hand #203998487088:  Hold'em No Limit ($0.05/$0.10 USD) - 2019/09/26 22:39:01 ET
Table 'Lynx' 6-max Seat #4 is the button
Seat 1: BigBlue ($7.85 in chips)
Seat 3: mellneazy ($19.27 in chips)
Seat 4: Ribeye63 ($12.01 in chips)
Seat 5: PlayTheBlues4U ($17.77 in chips)
Seat 6: donjt2653 ($10 in chips)
PlayTheBlues4U: posts small blind $0.05
donjt2653: posts big blind $0.10
*** HOLE CARDS ***
Dealt to PlayTheBlues4U [Jh Kc]
BigBlue: folds
mellneazy: folds
Ribeye63: raises $0.10 to $0.20
PlayTheBlues4U: calls $0.15
donjt2653: calls $0.10
*** FLOP *** [Ts Ac 4c]
PlayTheBlues4U: checks
donjt2653: checks
Ribeye63: checks
*** TURN *** [Ts Ac 4c] [6s]
PlayTheBlues4U: bets $0.30
DigBickBlad joins the table at seat #2
donjt2653: folds
Ribeye63: calls $0.30
*** RIVER *** [Ts Ac 4c 6s] [7h]
PlayTheBlues4U: bets $0.60
Ribeye63: calls $0.60
*** SHOW DOWN ***
PlayTheBlues4U: shows [Jh Kc] (high card Ace)
Ribeye63: shows [3h Ah] (a pair of Aces)
Ribeye63 collected $2.28 from pot
*** SUMMARY ***
Total pot $2.40 | Rake $0.12
Board [Ts Ac 4c 6s 7h]
Seat 1: BigBlue folded before Flop (didn't bet)
Seat 3: mellneazy folded before Flop (didn't bet)
Seat 4: Ribeye63 (button) showed [3h Ah] and won ($2.28) with a pair of Aces
Seat 5: PlayTheBlues4U (small blind) showed [Jh Kc] and lost with high card Ace
Seat 6: donjt2653 (big blind) folded on the Turn


*********** # 44 **************
PokerStars Hand #203998487039:  Hold'em No Limit ($0.05/$0.10 USD) - 2019/09/26 22:38:44 ET
Table 'Delphinus' 6-max Seat #1 is the button
Seat 1: daughterstuitio ($10.26 in chips)
Seat 2: maxplans323 ($7.61 in chips)
Seat 3: joncruise ($7.07 in chips)
Seat 4: 921zhaopeng ($13.57 in chips)
Seat 5: SuWasup ($9.54 in chips)
Seat 6: PlayTheBlues4U ($9.36 in chips)
maxplans323: posts small blind $0.05
joncruise: posts big blind $0.10
*** HOLE CARDS ***
Dealt to PlayTheBlues4U [7d Ks]
921zhaopeng: raises $0.10 to $0.20
SuWasup: folds
PlayTheBlues4U: folds
daughterstuitio: folds
maxplans323: folds
joncruise: calls $0.10
*** FLOP *** [2d 9s 7s]
joncruise: checks
921zhaopeng: checks
*** TURN *** [2d 9s 7s] [Qh]
joncruise: bets $0.10
921zhaopeng: calls $0.10
*** RIVER *** [2d 9s 7s Qh] [8d]
joncruise: checks
921zhaopeng: checks
*** SHOW DOWN ***
joncruise: shows [Ah Jd] (high card Ace)
921zhaopeng: mucks hand
joncruise collected $0.62 from pot
*** SUMMARY ***
Total pot $0.65 | Rake $0.03
Board [2d 9s 7s Qh 8d]
Seat 1: daughterstuitio (button) folded before Flop (didn't bet)
Seat 2: maxplans323 (small blind) folded before Flop
Seat 3: joncruise (big blind) showed [Ah Jd] and won ($0.62) with high card Ace
Seat 4: 921zhaopeng mucked [As 6s]
Seat 5: SuWasup folded before Flop (didn't bet)
Seat 6: PlayTheBlues4U folded before Flop (didn't bet)


*********** # 45 **************
PokerStars Hand #203998486873:  Hold'em No Limit ($0.05/$0.10 USD) - 2019/09/26 22:37:45 ET
Table 'Delphinus' 6-max Seat #6 is the button
Seat 1: daughterstuitio ($10.31 in chips)
Seat 2: maxplans323 ($7.91 in chips)
Seat 3: joncruise ($7.07 in chips)
Seat 4: 921zhaopeng ($11.71 in chips)
Seat 5: SuWasup ($9.54 in chips)
Seat 6: PlayTheBlues4U ($11.06 in chips)
daughterstuitio: posts small blind $0.05
maxplans323: posts big blind $0.10
*** HOLE CARDS ***
Dealt to PlayTheBlues4U [Ad 4h]
joncruise: folds
921zhaopeng: raises $0.20 to $0.30
SuWasup: folds
PlayTheBlues4U: calls $0.30
daughterstuitio: folds
maxplans323: calls $0.20
*** FLOP *** [Qc Ts 2s]
maxplans323: checks
921zhaopeng: bets $0.60
PlayTheBlues4U: raises $0.80 to $1.40
maxplans323: folds
921zhaopeng: raises $0.80 to $2.20
PlayTheBlues4U: folds
Uncalled bet ($0.80) returned to 921zhaopeng
921zhaopeng collected $3.56 from pot
921zhaopeng: doesn't show hand
*** SUMMARY ***
Total pot $3.75 | Rake $0.19
Board [Qc Ts 2s]
Seat 1: daughterstuitio (small blind) folded before Flop
Seat 2: maxplans323 (big blind) folded on the Flop
Seat 3: joncruise folded before Flop (didn't bet)
Seat 4: 921zhaopeng collected ($3.56)
Seat 5: SuWasup folded before Flop (didn't bet)
Seat 6: PlayTheBlues4U (button) folded on the Flop


*********** # 46 **************
PokerStars Hand #203998486860:  Hold'em No Limit ($0.05/$0.10 USD) - 2019/09/26 22:37:40 ET
Table 'Lynx' 6-max Seat #3 is the button
Seat 1: BigBlue ($7.85 in chips)
Seat 3: mellneazy ($23.77 in chips)
Seat 4: Ribeye63 ($12.06 in chips)
Seat 5: PlayTheBlues4U ($13.67 in chips)
Ribeye63: posts small blind $0.05
PlayTheBlues4U: posts big blind $0.10
donjt2653: sits out
*** HOLE CARDS ***
Dealt to PlayTheBlues4U [Ts Jh]
BigBlue: folds
mellneazy: raises $0.20 to $0.30
Ribeye63: folds
PlayTheBlues4U: calls $0.20
*** FLOP *** [Ac Qs Kc]
PlayTheBlues4U: checks
mellneazy: bets $0.30
PlayTheBlues4U: calls $0.30
*** TURN *** [Ac Qs Kc] [5h]
PlayTheBlues4U: checks
mellneazy: bets $0.60
PlayTheBlues4U: raises $0.80 to $1.40
mellneazy: calls $0.80
*** RIVER *** [Ac Qs Kc 5h] [5s]
PlayTheBlues4U: checks
mellneazy: bets $2.50
PlayTheBlues4U: raises $2.50 to $5
mellneazy: folds
Uncalled bet ($2.50) returned to PlayTheBlues4U
PlayTheBlues4U collected $8.60 from pot
PlayTheBlues4U: doesn't show hand
*** SUMMARY ***
Total pot $9.05 | Rake $0.45
Board [Ac Qs Kc 5h 5s]
Seat 1: BigBlue folded before Flop (didn't bet)
Seat 3: mellneazy (button) folded on the River
Seat 4: Ribeye63 (small blind) folded before Flop
Seat 5: PlayTheBlues4U (big blind) collected ($8.60)


*********** # 47 **************
PokerStars Hand #203998486834:  Hold'em No Limit ($0.05/$0.10 USD) - 2019/09/26 22:37:30 ET
Table 'Lynx' 6-max Seat #1 is the button
Seat 1: BigBlue ($7.85 in chips)
Seat 3: mellneazy ($23.82 in chips)
Seat 4: Ribeye63 ($12.16 in chips)
Seat 5: PlayTheBlues4U ($13.52 in chips)
mellneazy: posts small blind $0.05
Ribeye63: posts big blind $0.10
donjt2653: sits out
*** HOLE CARDS ***
Dealt to PlayTheBlues4U [Jd Th]
PlayTheBlues4U: raises $0.20 to $0.30
BigBlue: folds
mellneazy: folds
Ribeye63: folds
Uncalled bet ($0.20) returned to PlayTheBlues4U
PlayTheBlues4U collected $0.25 from pot
PlayTheBlues4U: doesn't show hand
*** SUMMARY ***
Total pot $0.25 | Rake $0
Seat 1: BigBlue (button) folded before Flop (didn't bet)
Seat 3: mellneazy (small blind) folded before Flop
Seat 4: Ribeye63 (big blind) folded before Flop
Seat 5: PlayTheBlues4U collected ($0.25)


*********** # 48 **************
PokerStars Hand #203998486806:  Hold'em No Limit ($0.05/$0.10 USD) - 2019/09/26 22:37:20 ET
Table 'Lynx' 6-max Seat #5 is the button
Seat 1: BigBlue ($7.90 in chips)
Seat 3: mellneazy ($23.92 in chips)
Seat 4: Ribeye63 ($12.16 in chips)
Seat 5: PlayTheBlues4U ($13.37 in chips)
donjt2653 will be allowed to play after the button
BigBlue: posts small blind $0.05
ironons: is sitting out
mellneazy: posts big blind $0.10
*** HOLE CARDS ***
Dealt to PlayTheBlues4U [Jh Qh]
Ribeye63: folds
ironons leaves the table
PlayTheBlues4U: raises $0.20 to $0.30
BigBlue: folds
mellneazy: folds
Uncalled bet ($0.20) returned to PlayTheBlues4U
PlayTheBlues4U collected $0.25 from pot
PlayTheBlues4U: doesn't show hand
*** SUMMARY ***
Total pot $0.25 | Rake $0
Seat 1: BigBlue (small blind) folded before Flop
Seat 3: mellneazy (big blind) folded before Flop
Seat 4: Ribeye63 folded before Flop (didn't bet)
Seat 5: PlayTheBlues4U (button) collected ($0.25)


*********** # 49 **************
PokerStars Hand #203998486762:  Hold'em No Limit ($0.05/$0.10 USD) - 2019/09/26 22:37:07 ET
Table 'Delphinus' 6-max Seat #5 is the button
Seat 1: daughterstuitio ($10.61 in chips)
Seat 2: maxplans323 ($7.91 in chips)
Seat 3: joncruise ($7.07 in chips)
Seat 4: 921zhaopeng ($11.71 in chips)
Seat 5: SuWasup ($9.22 in chips)
Seat 6: PlayTheBlues4U ($11.11 in chips)
PlayTheBlues4U: posts small blind $0.05
daughterstuitio: posts big blind $0.10
*** HOLE CARDS ***
Dealt to PlayTheBlues4U [Ts 2d]
maxplans323: folds
joncruise: folds
921zhaopeng: folds
SuWasup: raises $0.20 to $0.30
PlayTheBlues4U: folds
daughterstuitio: calls $0.20
*** FLOP *** [Qh Td Ah]
daughterstuitio: checks
SuWasup: bets $0.40
daughterstuitio: folds
Uncalled bet ($0.40) returned to SuWasup
SuWasup collected $0.62 from pot
SuWasup: doesn't show hand
*** SUMMARY ***
Total pot $0.65 | Rake $0.03
Board [Qh Td Ah]
Seat 1: daughterstuitio (big blind) folded on the Flop
Seat 2: maxplans323 folded before Flop (didn't bet)
Seat 3: joncruise folded before Flop (didn't bet)
Seat 4: 921zhaopeng folded before Flop (didn't bet)
Seat 5: SuWasup (button) collected ($0.62)
Seat 6: PlayTheBlues4U (small blind) folded before Flop


*********** # 50 **************
PokerStars Hand #203998486611:  Hold'em No Limit ($0.05/$0.10 USD) - 2019/09/26 22:36:15 ET
Table 'Delphinus' 6-max Seat #4 is the button
Seat 1: daughterstuitio ($10.61 in chips)
Seat 2: maxplans323 ($7.91 in chips)
Seat 3: joncruise ($6.30 in chips)
Seat 4: 921zhaopeng ($12.41 in chips)
Seat 5: SuWasup ($9.27 in chips)
Seat 6: PlayTheBlues4U ($11.21 in chips)
SuWasup: posts small blind $0.05
PlayTheBlues4U: posts big blind $0.10
*** HOLE CARDS ***
Dealt to PlayTheBlues4U [7s 4c]
daughterstuitio: folds
maxplans323: folds
joncruise: calls $0.10
921zhaopeng: calls $0.10
SuWasup: folds
PlayTheBlues4U: checks
*** FLOP *** [Qh Ks 2d]
PlayTheBlues4U: checks
joncruise: bets $0.20
921zhaopeng: calls $0.20
PlayTheBlues4U: folds
*** TURN *** [Qh Ks 2d] [9d]
joncruise: bets $0.40
921zhaopeng: calls $0.40
*** RIVER *** [Qh Ks 2d 9d] [6s]
joncruise: bets $0.70
921zhaopeng: folds
Uncalled bet ($0.70) returned to joncruise
joncruise collected $1.47 from pot
joncruise: doesn't show hand
*** SUMMARY ***
Total pot $1.55 | Rake $0.08
Board [Qh Ks 2d 9d 6s]
Seat 1: daughterstuitio folded before Flop (didn't bet)
Seat 2: maxplans323 folded before Flop (didn't bet)
Seat 3: joncruise collected ($1.47)
Seat 4: 921zhaopeng (button) folded on the River
Seat 5: SuWasup (small blind) folded before Flop
Seat 6: PlayTheBlues4U (big blind) folded on the Flop


*********** # 51 **************
PokerStars Hand #203998486592:  Hold'em No Limit ($0.05/$0.10 USD) - 2019/09/26 22:36:09 ET
Table 'Lynx' 6-max Seat #4 is the button
Seat 1: BigBlue ($8 in chips)
Seat 2: ironons ($7.90 in chips)
Seat 3: mellneazy ($25.72 in chips)
Seat 4: Ribeye63 ($10.40 in chips)
Seat 5: PlayTheBlues4U ($13.42 in chips)
PlayTheBlues4U: posts small blind $0.05
BigBlue: posts big blind $0.10
*** HOLE CARDS ***
Dealt to PlayTheBlues4U [4h 9s]
ironons: folds
PlayTheBlues4U said, "wow"
mellneazy: raises $0.20 to $0.30
Ribeye63: calls $0.30
PlayTheBlues4U: folds
BigBlue: folds
*** FLOP *** [6d 8c 8h]
mellneazy: checks
Ribeye63: bets $0.53
mellneazy: raises $0.97 to $1.50
Ribeye63: calls $0.97
*** TURN *** [6d 8c 8h] [7d]
mellneazy: checks
Ribeye63: bets $1
mellneazy: folds
Uncalled bet ($1) returned to Ribeye63
Ribeye63 collected $3.56 from pot
Ribeye63: doesn't show hand
*** SUMMARY ***
Total pot $3.75 | Rake $0.19
Board [6d 8c 8h 7d]
Seat 1: BigBlue (big blind) folded before Flop
Seat 2: ironons folded before Flop (didn't bet)
Seat 3: mellneazy folded on the Turn
Seat 4: Ribeye63 (button) collected ($3.56)
Seat 5: PlayTheBlues4U (small blind) folded before Flop


*********** # 52 **************
PokerStars Hand #203998486444:  Hold'em No Limit ($0.05/$0.10 USD) - 2019/09/26 22:35:10 ET
Table 'Lynx' 6-max Seat #3 is the button
Seat 2: ironons ($8.45 in chips)
Seat 3: mellneazy ($18.78 in chips)
Seat 4: Ribeye63 ($10.45 in chips)
Seat 5: PlayTheBlues4U ($13.52 in chips)
Seat 6: donjt2653 ($6.97 in chips)
Ribeye63: posts small blind $0.05
PlayTheBlues4U: posts big blind $0.10
BigBlue: sits out
*** HOLE CARDS ***
Dealt to PlayTheBlues4U [8c 7d]
donjt2653: calls $0.10
ironons: calls $0.10
mellneazy: raises $0.45 to $0.55
Ribeye63: folds
PlayTheBlues4U: folds
donjt2653: calls $0.45
ironons: calls $0.45
*** FLOP *** [Ts Qs 4c]
donjt2653: checks
ironons: checks
mellneazy: bets $0.90
donjt2653: raises $5.52 to $6.42 and is all-in
ironons: folds
mellneazy: calls $5.52
*** TURN *** [Ts Qs 4c] [4s]
*** RIVER *** [Ts Qs 4c 4s] [3h]
*** SHOW DOWN ***
donjt2653: shows [Qc Ks] (two pair, Queens and Fours)
mellneazy: shows [4d Qd] (a full house, Fours full of Queens)
mellneazy collected $13.91 from pot
*** SUMMARY ***
Total pot $14.64 | Rake $0.73
Board [Ts Qs 4c 4s 3h]
Seat 2: ironons folded on the Flop
Seat 3: mellneazy (button) showed [4d Qd] and won ($13.91) with a full house, Fours full of Queens
Seat 4: Ribeye63 (small blind) folded before Flop
Seat 5: PlayTheBlues4U (big blind) folded before Flop
Seat 6: donjt2653 showed [Qc Ks] and lost with two pair, Queens and Fours


*********** # 53 **************
PokerStars Hand #203998486413:  Hold'em No Limit ($0.05/$0.10 USD) - 2019/09/26 22:35:00 ET
Table 'Lynx' 6-max Seat #2 is the button
Seat 2: ironons ($8.45 in chips)
Seat 3: mellneazy ($18.68 in chips)
Seat 4: Ribeye63 ($10.55 in chips)
Seat 5: PlayTheBlues4U ($13.52 in chips)
Seat 6: donjt2653 ($6.97 in chips)
mellneazy: posts small blind $0.05
Ribeye63: posts big blind $0.10
BigBlue: sits out
*** HOLE CARDS ***
Dealt to PlayTheBlues4U [8d 4d]
PlayTheBlues4U: folds
donjt2653: folds
ironons: folds
mellneazy: raises $0.20 to $0.30
Ribeye63: folds
Uncalled bet ($0.20) returned to mellneazy
mellneazy collected $0.20 from pot
mellneazy: doesn't show hand
*** SUMMARY ***
Total pot $0.20 | Rake $0
Seat 2: ironons (button) folded before Flop (didn't bet)
Seat 3: mellneazy (small blind) collected ($0.20)
Seat 4: Ribeye63 (big blind) folded before Flop
Seat 5: PlayTheBlues4U folded before Flop (didn't bet)
Seat 6: donjt2653 folded before Flop (didn't bet)


*********** # 54 **************
PokerStars Hand #203998486375:  Hold'em No Limit ($0.05/$0.10 USD) - 2019/09/26 22:34:48 ET
Table 'Lynx' 6-max Seat #6 is the button
Seat 2: ironons ($8.50 in chips)
Seat 3: mellneazy ($18.78 in chips)
Seat 4: Ribeye63 ($10.40 in chips)
Seat 5: PlayTheBlues4U ($13.52 in chips)
Seat 6: donjt2653 ($6.97 in chips)
ironons: posts small blind $0.05
mellneazy: posts big blind $0.10
*** HOLE CARDS ***
Dealt to PlayTheBlues4U [8h 7s]
BigBlue joins the table at seat #1
Ribeye63: raises $0.30 to $0.40
PlayTheBlues4U: folds
donjt2653: folds
ironons: folds
mellneazy: folds
Uncalled bet ($0.30) returned to Ribeye63
Ribeye63 collected $0.25 from pot
Ribeye63: doesn't show hand
*** SUMMARY ***
Total pot $0.25 | Rake $0
Seat 2: ironons (small blind) folded before Flop
Seat 3: mellneazy (big blind) folded before Flop
Seat 4: Ribeye63 collected ($0.25)
Seat 5: PlayTheBlues4U folded before Flop (didn't bet)
Seat 6: donjt2653 (button) folded before Flop (didn't bet)


*********** # 55 **************
PokerStars Hand #203998486352:  Hold'em No Limit ($0.05/$0.10 USD) - 2019/09/26 22:34:39 ET
Table 'Delphinus' 6-max Seat #3 is the button
Seat 1: daughterstuitio ($10.61 in chips)
Seat 2: maxplans323 ($7.91 in chips)
Seat 3: joncruise ($6.30 in chips)
Seat 4: 921zhaopeng ($10.97 in chips)
Seat 5: SuWasup ($10.87 in chips)
Seat 6: PlayTheBlues4U ($11.21 in chips)
921zhaopeng: posts small blind $0.05
SuWasup: posts big blind $0.10
*** HOLE CARDS ***
Dealt to PlayTheBlues4U [6s 9h]
PlayTheBlues4U: folds
daughterstuitio: folds
maxplans323: folds
joncruise: folds
921zhaopeng: raises $0.10 to $0.20
SuWasup: raises $0.60 to $0.80
921zhaopeng: calls $0.60
*** FLOP *** [8s 4d 7s]
921zhaopeng: bets $0.80
SuWasup: calls $0.80
*** TURN *** [8s 4d 7s] [4c]
921zhaopeng: bets $1.50
SuWasup: folds
Uncalled bet ($1.50) returned to 921zhaopeng
921zhaopeng collected $3.04 from pot
921zhaopeng: doesn't show hand
*** SUMMARY ***
Total pot $3.20 | Rake $0.16
Board [8s 4d 7s 4c]
Seat 1: daughterstuitio folded before Flop (didn't bet)
Seat 2: maxplans323 folded before Flop (didn't bet)
Seat 3: joncruise (button) folded before Flop (didn't bet)
Seat 4: 921zhaopeng (small blind) collected ($3.04)
Seat 5: SuWasup (big blind) folded on the Turn
Seat 6: PlayTheBlues4U folded before Flop (didn't bet)


*********** # 56 **************
PokerStars Hand #203998486328:  Hold'em No Limit ($0.05/$0.10 USD) - 2019/09/26 22:34:31 ET
Table 'Lynx' 6-max Seat #5 is the button
Seat 2: ironons ($8.80 in chips)
Seat 3: mellneazy ($18.46 in chips)
Seat 4: Ribeye63 ($10.40 in chips)
Seat 5: PlayTheBlues4U ($13.52 in chips)
Seat 6: donjt2653 ($7.02 in chips)
donjt2653: posts small blind $0.05
ironons: posts big blind $0.10
*** HOLE CARDS ***
Dealt to PlayTheBlues4U [3c 8d]
mellneazy: raises $0.20 to $0.30
Ribeye63: folds
PlayTheBlues4U: folds
donjt2653: folds
ironons: calls $0.20
*** FLOP *** [Td Ad 8h]
ironons: checks
mellneazy: bets $0.30
ironons: folds
Uncalled bet ($0.30) returned to mellneazy
mellneazy collected $0.62 from pot
mellneazy: doesn't show hand
*** SUMMARY ***
Total pot $0.65 | Rake $0.03
Board [Td Ad 8h]
Seat 2: ironons (big blind) folded on the Flop
Seat 3: mellneazy collected ($0.62)
Seat 4: Ribeye63 folded before Flop (didn't bet)
Seat 5: PlayTheBlues4U (button) folded before Flop (didn't bet)
Seat 6: donjt2653 (small blind) folded before Flop


*********** # 57 **************
PokerStars Hand #203998486260:  Hold'em No Limit ($0.05/$0.10 USD) - 2019/09/26 22:34:04 ET
Table 'Delphinus' 6-max Seat #2 is the button
Seat 1: daughterstuitio ($10.61 in chips)
Seat 2: maxplans323 ($8.21 in chips)
Seat 3: joncruise ($6.35 in chips)
Seat 4: 921zhaopeng ($11.07 in chips)
Seat 5: SuWasup ($10.46 in chips)
Seat 6: PlayTheBlues4U ($11.21 in chips)
joncruise: posts small blind $0.05
921zhaopeng: posts big blind $0.10
*** HOLE CARDS ***
Dealt to PlayTheBlues4U [Jd 4h]
SuWasup: raises $0.20 to $0.30
PlayTheBlues4U: folds
daughterstuitio: folds
maxplans323: calls $0.30
joncruise: folds
921zhaopeng: folds
*** FLOP *** [6d Js Jh]
SuWasup: bets $0.30
maxplans323: folds
Uncalled bet ($0.30) returned to SuWasup
SuWasup collected $0.71 from pot
SuWasup: doesn't show hand
*** SUMMARY ***
Total pot $0.75 | Rake $0.04
Board [6d Js Jh]
Seat 1: daughterstuitio folded before Flop (didn't bet)
Seat 2: maxplans323 (button) folded on the Flop
Seat 3: joncruise (small blind) folded before Flop
Seat 4: 921zhaopeng (big blind) folded before Flop
Seat 5: SuWasup collected ($0.71)
Seat 6: PlayTheBlues4U folded before Flop (didn't bet)


*********** # 58 **************
PokerStars Hand #203998486251:  Hold'em No Limit ($0.05/$0.10 USD) - 2019/09/26 22:34:01 ET
Table 'Lynx' 6-max Seat #4 is the button
Seat 2: ironons ($8.80 in chips)
Seat 3: mellneazy ($19.36 in chips)
Seat 4: Ribeye63 ($9.45 in chips)
Seat 5: PlayTheBlues4U ($13.57 in chips)
Seat 6: donjt2653 ($7.12 in chips)
PlayTheBlues4U: posts small blind $0.05
donjt2653: posts big blind $0.10
*** HOLE CARDS ***
Dealt to PlayTheBlues4U [3h Tc]
ironons: folds
mellneazy: raises $0.20 to $0.30
Ribeye63: raises $0.60 to $0.90
PlayTheBlues4U: folds
donjt2653: folds
mellneazy: calls $0.60
*** FLOP *** [5c 2s Ac]
mellneazy: checks
Ribeye63: bets $1.39
mellneazy: folds
Uncalled bet ($1.39) returned to Ribeye63
Ribeye63 collected $1.85 from pot
Ribeye63: doesn't show hand
*** SUMMARY ***
Total pot $1.95 | Rake $0.10
Board [5c 2s Ac]
Seat 2: ironons folded before Flop (didn't bet)
Seat 3: mellneazy folded on the Flop
Seat 4: Ribeye63 (button) collected ($1.85)
Seat 5: PlayTheBlues4U (small blind) folded before Flop
Seat 6: donjt2653 (big blind) folded before Flop


*********** # 59 **************
PokerStars Hand #203998486106:  Hold'em No Limit ($0.05/$0.10 USD) - 2019/09/26 22:33:12 ET
Table 'Delphinus' 6-max Seat #1 is the button
Seat 1: daughterstuitio ($9.20 in chips)
Seat 2: maxplans323 ($8.26 in chips)
Seat 3: joncruise ($6.65 in chips)
Seat 4: 921zhaopeng ($12.27 in chips)
Seat 5: SuWasup ($10.46 in chips)
Seat 6: PlayTheBlues4U ($11.21 in chips)
maxplans323: posts small blind $0.05
joncruise: posts big blind $0.10
*** HOLE CARDS ***
Dealt to PlayTheBlues4U [Qd 3s]
921zhaopeng: raises $0.20 to $0.30
SuWasup: folds
PlayTheBlues4U: folds
daughterstuitio: calls $0.30
maxplans323: folds
joncruise: calls $0.20
*** FLOP *** [Ad 9h 2c]
joncruise: checks
921zhaopeng: bets $0.90
daughterstuitio: calls $0.90
joncruise: folds
*** TURN *** [Ad 9h 2c] [Qc]
921zhaopeng: checks
daughterstuitio: bets $1.30
921zhaopeng: folds [Kd Kc]
Uncalled bet ($1.30) returned to daughterstuitio
daughterstuitio collected $2.61 from pot
daughterstuitio: doesn't show hand
*** SUMMARY ***
Total pot $2.75 | Rake $0.14
Board [Ad 9h 2c Qc]
Seat 1: daughterstuitio (button) collected ($2.61)
Seat 2: maxplans323 (small blind) folded before Flop
Seat 3: joncruise (big blind) folded on the Flop
Seat 4: 921zhaopeng folded on the Turn
Seat 5: SuWasup folded before Flop (didn't bet)
Seat 6: PlayTheBlues4U folded before Flop (didn't bet)


*********** # 60 **************
PokerStars Hand #203998486096:  Hold'em No Limit ($0.05/$0.10 USD) - 2019/09/26 22:33:11 ET
Table 'Lynx' 6-max Seat #3 is the button
Seat 1: clovvnfiesta ($3.70 in chips)
Seat 2: ironons ($8.25 in chips)
Seat 3: mellneazy ($19.81 in chips)
Seat 4: Ribeye63 ($9.50 in chips)
Seat 5: PlayTheBlues4U ($13.67 in chips)
Seat 6: donjt2653 ($7.12 in chips)
Ribeye63: posts small blind $0.05
PlayTheBlues4U: posts big blind $0.10
*** HOLE CARDS ***
Dealt to PlayTheBlues4U [8d 2d]
donjt2653: folds
clovvnfiesta: folds
ironons: calls $0.10
mellneazy: raises $0.35 to $0.45
clovvnfiesta leaves the table
Ribeye63: folds
PlayTheBlues4U: folds
ironons: calls $0.35
*** FLOP *** [Td 4s 4h]
ironons: checks
mellneazy: checks
*** TURN *** [Td 4s 4h] [Js]
ironons: checks
mellneazy: checks
*** RIVER *** [Td 4s 4h Js] [Qc]
ironons: bets $0.30
mellneazy: folds
Uncalled bet ($0.30) returned to ironons
ironons collected $1 from pot
ironons: doesn't show hand
*** SUMMARY ***
Total pot $1.05 | Rake $0.05
Board [Td 4s 4h Js Qc]
Seat 1: clovvnfiesta folded before Flop (didn't bet)
Seat 2: ironons collected ($1)
Seat 3: mellneazy (button) folded on the River
Seat 4: Ribeye63 (small blind) folded before Flop
Seat 5: PlayTheBlues4U (big blind) folded before Flop
Seat 6: donjt2653 folded before Flop (didn't bet)


*********** # 61 **************
PokerStars Hand #203998485987:  Hold'em No Limit ($0.05/$0.10 USD) - 2019/09/26 22:32:34 ET
Table 'Delphinus' 6-max Seat #6 is the button
Seat 1: daughterstuitio ($9.50 in chips)
Seat 2: maxplans323 ($8.36 in chips)
Seat 3: joncruise ($6.95 in chips)
Seat 4: 921zhaopeng ($11.33 in chips)
Seat 5: SuWasup ($10.76 in chips)
Seat 6: PlayTheBlues4U ($11.21 in chips)
daughterstuitio: posts small blind $0.05
maxplans323: posts big blind $0.10
*** HOLE CARDS ***
Dealt to PlayTheBlues4U [Jd 2s]
joncruise: calls $0.10
921zhaopeng: raises $0.20 to $0.30
SuWasup: calls $0.30
PlayTheBlues4U: folds
daughterstuitio: calls $0.25
maxplans323: folds
joncruise: calls $0.20
*** FLOP *** [Js Tc 3h]
daughterstuitio: checks
joncruise: checks
921zhaopeng: bets $0.80
SuWasup: folds
daughterstuitio: folds
joncruise: folds
Uncalled bet ($0.80) returned to 921zhaopeng
921zhaopeng collected $1.24 from pot
921zhaopeng: doesn't show hand
*** SUMMARY ***
Total pot $1.30 | Rake $0.06
Board [Js Tc 3h]
Seat 1: daughterstuitio (small blind) folded on the Flop
Seat 2: maxplans323 (big blind) folded before Flop
Seat 3: joncruise folded on the Flop
Seat 4: 921zhaopeng collected ($1.24)
Seat 5: SuWasup folded on the Flop
Seat 6: PlayTheBlues4U (button) folded before Flop (didn't bet)


*********** # 62 **************
PokerStars Hand #203998485904:  Hold'em No Limit ($0.05/$0.10 USD) - 2019/09/26 22:32:06 ET
Table 'Lynx' 6-max Seat #2 is the button
Seat 1: clovvnfiesta ($3.70 in chips)
Seat 2: ironons ($8.25 in chips)
Seat 3: mellneazy ($18.55 in chips)
Seat 4: Ribeye63 ($9.60 in chips)
Seat 5: PlayTheBlues4U ($13.67 in chips)
Seat 6: donjt2653 ($8.42 in chips)
mellneazy: posts small blind $0.05
Ribeye63: posts big blind $0.10
*** HOLE CARDS ***
Dealt to PlayTheBlues4U [9c 2h]
PlayTheBlues4U: folds
donjt2653: calls $0.10
clovvnfiesta: folds
ironons: folds
mellneazy: calls $0.05
Ribeye63: checks
*** FLOP *** [As 2c Ad]
mellneazy: checks
Ribeye63: checks
donjt2653: bets $0.10
mellneazy: calls $0.10
Ribeye63: folds
*** TURN *** [As 2c Ad] [5h]
mellneazy: checks
donjt2653: bets $0.20
mellneazy: calls $0.20
*** RIVER *** [As 2c Ad 5h] [3h]
mellneazy: bets $0.90
donjt2653: calls $0.90
*** SHOW DOWN ***
mellneazy: shows [4s 6d] (a straight, Deuce to Six)
donjt2653: mucks hand
mellneazy collected $2.56 from pot
*** SUMMARY ***
Total pot $2.70 | Rake $0.14
Board [As 2c Ad 5h 3h]
Seat 1: clovvnfiesta folded before Flop (didn't bet)
Seat 2: ironons (button) folded before Flop (didn't bet)
Seat 3: mellneazy (small blind) showed [4s 6d] and won ($2.56) with a straight, Deuce to Six
Seat 4: Ribeye63 (big blind) folded on the Flop
Seat 5: PlayTheBlues4U folded before Flop (didn't bet)
Seat 6: donjt2653 mucked [6h 6s]


*********** # 63 **************
PokerStars Hand #203998485895:  Hold'em No Limit ($0.05/$0.10 USD) - 2019/09/26 22:32:04 ET
Table 'Delphinus' 6-max Seat #5 is the button
Seat 1: daughterstuitio ($9.80 in chips)
Seat 2: maxplans323 ($8.36 in chips)
Seat 3: joncruise ($6.95 in chips)
Seat 4: 921zhaopeng ($11.33 in chips)
Seat 5: SuWasup ($10.44 in chips)
Seat 6: PlayTheBlues4U ($11.26 in chips)
PlayTheBlues4U: posts small blind $0.05
daughterstuitio: posts big blind $0.10
*** HOLE CARDS ***
Dealt to PlayTheBlues4U [2c 3d]
maxplans323: folds
joncruise: folds
921zhaopeng: folds
SuWasup: raises $0.20 to $0.30
PlayTheBlues4U: folds
daughterstuitio: calls $0.20
*** FLOP *** [3h 7h Jh]
daughterstuitio: checks
SuWasup: bets $0.40
daughterstuitio: folds
Uncalled bet ($0.40) returned to SuWasup
SuWasup collected $0.62 from pot
SuWasup: doesn't show hand
*** SUMMARY ***
Total pot $0.65 | Rake $0.03
Board [3h 7h Jh]
Seat 1: daughterstuitio (big blind) folded on the Flop
Seat 2: maxplans323 folded before Flop (didn't bet)
Seat 3: joncruise folded before Flop (didn't bet)
Seat 4: 921zhaopeng folded before Flop (didn't bet)
Seat 5: SuWasup (button) collected ($0.62)
Seat 6: PlayTheBlues4U (small blind) folded before Flop


*********** # 64 **************
PokerStars Hand #203998485810:  Hold'em No Limit ($0.05/$0.10 USD) - 2019/09/26 22:31:35 ET
Table 'Lynx' 6-max Seat #1 is the button
Seat 1: clovvnfiesta ($3.70 in chips)
Seat 2: ironons ($8.65 in chips)
Seat 3: mellneazy ($18.95 in chips)
Seat 4: Ribeye63 ($9.60 in chips)
Seat 5: PlayTheBlues4U ($13.67 in chips)
Seat 6: donjt2653 ($7.68 in chips)
ironons: posts small blind $0.05
mellneazy: posts big blind $0.10
*** HOLE CARDS ***
Dealt to PlayTheBlues4U [2c 8h]
Ribeye63: folds
PlayTheBlues4U: folds
donjt2653: raises $0.30 to $0.40
clovvnfiesta: folds
ironons: calls $0.35
mellneazy: calls $0.30
*** FLOP *** [9c 2d 2s]
ironons: checks
mellneazy: checks
donjt2653: bets $1.10
ironons: folds
mellneazy: folds
Uncalled bet ($1.10) returned to donjt2653
donjt2653 collected $1.14 from pot
donjt2653: doesn't show hand
*** SUMMARY ***
Total pot $1.20 | Rake $0.06
Board [9c 2d 2s]
Seat 1: clovvnfiesta (button) folded before Flop (didn't bet)
Seat 2: ironons (small blind) folded on the Flop
Seat 3: mellneazy (big blind) folded on the Flop
Seat 4: Ribeye63 folded before Flop (didn't bet)
Seat 5: PlayTheBlues4U folded before Flop (didn't bet)
Seat 6: donjt2653 collected ($1.14)


*********** # 65 **************
PokerStars Hand #203998485757:  Hold'em No Limit ($0.05/$0.10 USD) - 2019/09/26 22:31:16 ET
Table 'Delphinus' 6-max Seat #4 is the button
Seat 1: daughterstuitio ($9.80 in chips)
Seat 2: maxplans323 ($8.36 in chips)
Seat 3: joncruise ($6.95 in chips)
Seat 4: 921zhaopeng ($11.33 in chips)
Seat 5: SuWasup ($10.45 in chips)
Seat 6: PlayTheBlues4U ($11.28 in chips)
SuWasup: posts small blind $0.05
PlayTheBlues4U: posts big blind $0.10
*** HOLE CARDS ***
Dealt to PlayTheBlues4U [Kd Jc]
daughterstuitio: folds
maxplans323: folds
joncruise: folds
921zhaopeng: folds
SuWasup: raises $0.20 to $0.30
PlayTheBlues4U: calls $0.20
*** FLOP *** [Td Th 5s]
SuWasup: checks
PlayTheBlues4U: checks
*** TURN *** [Td Th 5s] [3s]
SuWasup: checks
PlayTheBlues4U: checks
*** RIVER *** [Td Th 5s 3s] [3h]
SuWasup: checks
PlayTheBlues4U: checks
*** SHOW DOWN ***
SuWasup: shows [Kh 9c] (two pair, Tens and Threes)
PlayTheBlues4U: shows [Kd Jc] (two pair, Tens and Threes)
SuWasup collected $0.29 from pot
PlayTheBlues4U collected $0.28 from pot
*** SUMMARY ***
Total pot $0.60 | Rake $0.03
Board [Td Th 5s 3s 3h]
Seat 1: daughterstuitio folded before Flop (didn't bet)
Seat 2: maxplans323 folded before Flop (didn't bet)
Seat 3: joncruise folded before Flop (didn't bet)
Seat 4: 921zhaopeng (button) folded before Flop (didn't bet)
Seat 5: SuWasup (small blind) showed [Kh 9c] and won ($0.29) with two pair, Tens and Threes
Seat 6: PlayTheBlues4U (big blind) showed [Kd Jc] and won ($0.28) with two pair, Tens and Threes


*********** # 66 **************
PokerStars Hand #203998485694:  Hold'em No Limit ($0.05/$0.10 USD) - 2019/09/26 22:30:54 ET
Table 'Lynx' 6-max Seat #6 is the button
Seat 1: clovvnfiesta ($3.75 in chips)
Seat 2: ironons ($8.75 in chips)
Seat 3: mellneazy ($17.55 in chips)
Seat 4: Ribeye63 ($9.60 in chips)
Seat 5: PlayTheBlues4U ($13.67 in chips)
Seat 6: donjt2653 ($9.08 in chips)
clovvnfiesta: posts small blind $0.05
ironons: posts big blind $0.10
*** HOLE CARDS ***
Dealt to PlayTheBlues4U [Jh 2s]
mellneazy: raises $0.20 to $0.30
Ribeye63: folds
PlayTheBlues4U: folds
donjt2653: calls $0.30
clovvnfiesta: folds
ironons: folds
*** FLOP *** [6c 6d 4d]
mellneazy: bets $0.40
donjt2653: calls $0.40
*** TURN *** [6c 6d 4d] [Tc]
mellneazy: bets $0.70
donjt2653: calls $0.70
*** RIVER *** [6c 6d 4d Tc] [Qh]
mellneazy: bets $1.50
donjt2653: folds
Uncalled bet ($1.50) returned to mellneazy
mellneazy collected $2.80 from pot
mellneazy: doesn't show hand
*** SUMMARY ***
Total pot $2.95 | Rake $0.15
Board [6c 6d 4d Tc Qh]
Seat 1: clovvnfiesta (small blind) folded before Flop
Seat 2: ironons (big blind) folded before Flop
Seat 3: mellneazy collected ($2.80)
Seat 4: Ribeye63 folded before Flop (didn't bet)
Seat 5: PlayTheBlues4U folded before Flop (didn't bet)
Seat 6: donjt2653 (button) folded on the River


*********** # 67 **************
PokerStars Hand #203998485547:  Hold'em No Limit ($0.05/$0.10 USD) - 2019/09/26 22:30:09 ET
Table 'Delphinus' 6-max Seat #3 is the button
Seat 1: daughterstuitio ($9.80 in chips)
Seat 2: maxplans323 ($8.97 in chips)
Seat 3: joncruise ($6.95 in chips)
Seat 4: 921zhaopeng ($11.38 in chips)
Seat 5: SuWasup ($9.85 in chips)
Seat 6: PlayTheBlues4U ($11.28 in chips)
921zhaopeng: posts small blind $0.05
SuWasup: posts big blind $0.10
*** HOLE CARDS ***
Dealt to PlayTheBlues4U [Ac 5d]
PlayTheBlues4U: folds
daughterstuitio: folds
maxplans323: raises $0.20 to $0.30
joncruise: folds
921zhaopeng: folds
SuWasup: calls $0.20
*** FLOP *** [Tc 5c Qh]
SuWasup: checks
maxplans323: bets $0.31
SuWasup: calls $0.31
*** TURN *** [Tc 5c Qh] [4c]
SuWasup: checks
maxplans323: checks
*** RIVER *** [Tc 5c Qh 4c] [Ks]
SuWasup: bets $0.61
maxplans323: folds
Uncalled bet ($0.61) returned to SuWasup
SuWasup collected $1.21 from pot
SuWasup: doesn't show hand
*** SUMMARY ***
Total pot $1.27 | Rake $0.06
Board [Tc 5c Qh 4c Ks]
Seat 1: daughterstuitio folded before Flop (didn't bet)
Seat 2: maxplans323 folded on the River
Seat 3: joncruise (button) folded before Flop (didn't bet)
Seat 4: 921zhaopeng (small blind) folded before Flop
Seat 5: SuWasup (big blind) collected ($1.21)
Seat 6: PlayTheBlues4U folded before Flop (didn't bet)


*********** # 68 **************
PokerStars Hand #203998485470:  Hold'em No Limit ($0.05/$0.10 USD) - 2019/09/26 22:29:43 ET
Table 'Lynx' 6-max Seat #5 is the button
Seat 1: clovvnfiesta ($3.85 in chips)
Seat 2: ironons ($8.75 in chips)
Seat 3: mellneazy ($18.75 in chips)
Seat 4: Ribeye63 ($9.60 in chips)
Seat 5: PlayTheBlues4U ($13.67 in chips)
Seat 6: donjt2653 ($7.90 in chips)
donjt2653: posts small blind $0.05
clovvnfiesta: posts big blind $0.10
*** HOLE CARDS ***
Dealt to PlayTheBlues4U [2h 9s]
ironons: folds
mellneazy: raises $0.20 to $0.30
Ribeye63: folds
PlayTheBlues4U: folds
donjt2653: calls $0.25
clovvnfiesta: folds
*** FLOP *** [4s Ks Ac]
donjt2653: checks
mellneazy: bets $0.30
donjt2653: raises $0.60 to $0.90
mellneazy: calls $0.60
*** TURN *** [4s Ks Ac] [Qh]
donjt2653: bets $1.20
mellneazy: folds
Uncalled bet ($1.20) returned to donjt2653
donjt2653 collected $2.38 from pot
donjt2653: doesn't show hand
*** SUMMARY ***
Total pot $2.50 | Rake $0.12
Board [4s Ks Ac Qh]
Seat 1: clovvnfiesta (big blind) folded before Flop
Seat 2: ironons folded before Flop (didn't bet)
Seat 3: mellneazy folded on the Turn
Seat 4: Ribeye63 folded before Flop (didn't bet)
Seat 5: PlayTheBlues4U (button) folded before Flop (didn't bet)
Seat 6: donjt2653 (small blind) collected ($2.38)


*********** # 69 **************
PokerStars Hand #203998485379:  Hold'em No Limit ($0.05/$0.10 USD) - 2019/09/26 22:29:12 ET
Table 'Lynx' 6-max Seat #4 is the button
Seat 1: clovvnfiesta ($3.85 in chips)
Seat 2: ironons ($8.75 in chips)
Seat 3: mellneazy ($18.60 in chips)
Seat 4: Ribeye63 ($9.60 in chips)
Seat 5: PlayTheBlues4U ($13.72 in chips)
Seat 6: donjt2653 ($8 in chips)
PlayTheBlues4U: posts small blind $0.05
donjt2653: posts big blind $0.10
*** HOLE CARDS ***
Dealt to PlayTheBlues4U [2h 5s]
clovvnfiesta: folds
ironons: folds
mellneazy: raises $0.20 to $0.30
Ribeye63: folds
PlayTheBlues4U: folds
donjt2653: folds
Uncalled bet ($0.20) returned to mellneazy
mellneazy collected $0.25 from pot
mellneazy: doesn't show hand
*** SUMMARY ***
Total pot $0.25 | Rake $0
Seat 1: clovvnfiesta folded before Flop (didn't bet)
Seat 2: ironons folded before Flop (didn't bet)
Seat 3: mellneazy collected ($0.25)
Seat 4: Ribeye63 (button) folded before Flop (didn't bet)
Seat 5: PlayTheBlues4U (small blind) folded before Flop
Seat 6: donjt2653 (big blind) folded before Flop


*********** # 70 **************
PokerStars Hand #203998485375:  Hold'em No Limit ($0.05/$0.10 USD) - 2019/09/26 22:29:11 ET
Table 'Delphinus' 6-max Seat #2 is the button
Seat 1: daughterstuitio ($9.80 in chips)
Seat 2: maxplans323 ($7.72 in chips)
Seat 3: joncruise ($8.23 in chips)
Seat 4: 921zhaopeng ($11.48 in chips)
Seat 5: SuWasup ($9.85 in chips)
Seat 6: PlayTheBlues4U ($11.28 in chips)
joncruise: posts small blind $0.05
921zhaopeng: posts big blind $0.10
*** HOLE CARDS ***
Dealt to PlayTheBlues4U [Jh 7c]
SuWasup: folds
PlayTheBlues4U: folds
daughterstuitio: folds
maxplans323: raises $0.20 to $0.30
joncruise: calls $0.25
921zhaopeng: folds
*** FLOP *** [Js 9h 4s]
joncruise: checks
maxplans323: bets $0.33
joncruise: calls $0.33
*** TURN *** [Js 9h 4s] [7h]
joncruise: checks
maxplans323: bets $0.65
joncruise: calls $0.65
*** RIVER *** [Js 9h 4s 7h] [As]
joncruise: checks
maxplans323: bets $1.50
joncruise: folds
Uncalled bet ($1.50) returned to maxplans323
maxplans323 collected $2.53 from pot
maxplans323: doesn't show hand
*** SUMMARY ***
Total pot $2.66 | Rake $0.13
Board [Js 9h 4s 7h As]
Seat 1: daughterstuitio folded before Flop (didn't bet)
Seat 2: maxplans323 (button) collected ($2.53)
Seat 3: joncruise (small blind) folded on the River
Seat 4: 921zhaopeng (big blind) folded before Flop
Seat 5: SuWasup folded before Flop (didn't bet)
Seat 6: PlayTheBlues4U folded before Flop (didn't bet)


*********** # 71 **************
PokerStars Hand #203998485322:  Hold'em No Limit ($0.05/$0.10 USD) - 2019/09/26 22:28:55 ET
Table 'Delphinus' 6-max Seat #1 is the button
Seat 1: daughterstuitio ($9.80 in chips)
Seat 2: maxplans323 ($7.77 in chips)
Seat 3: joncruise ($8.33 in chips)
Seat 4: 921zhaopeng ($11.33 in chips)
Seat 5: SuWasup ($9.85 in chips)
Seat 6: PlayTheBlues4U ($11.28 in chips)
maxplans323: posts small blind $0.05
joncruise: posts big blind $0.10
*** HOLE CARDS ***
Dealt to PlayTheBlues4U [Kc 7h]
921zhaopeng: raises $0.20 to $0.30
SuWasup: folds
PlayTheBlues4U: folds
daughterstuitio: folds
maxplans323: folds
joncruise: folds
Uncalled bet ($0.20) returned to 921zhaopeng
921zhaopeng collected $0.25 from pot
921zhaopeng: doesn't show hand
*** SUMMARY ***
Total pot $0.25 | Rake $0
Seat 1: daughterstuitio (button) folded before Flop (didn't bet)
Seat 2: maxplans323 (small blind) folded before Flop
Seat 3: joncruise (big blind) folded before Flop
Seat 4: 921zhaopeng collected ($0.25)
Seat 5: SuWasup folded before Flop (didn't bet)
Seat 6: PlayTheBlues4U folded before Flop (didn't bet)


*********** # 72 **************
PokerStars Hand #203998485190:  Hold'em No Limit ($0.05/$0.10 USD) - 2019/09/26 22:28:10 ET
Table 'Lynx' 6-max Seat #3 is the button
Seat 1: clovvnfiesta ($3.85 in chips)
Seat 2: ironons ($10.45 in chips)
Seat 3: mellneazy ($16.69 in chips)
Seat 4: Ribeye63 ($9.90 in chips)
Seat 5: PlayTheBlues4U ($13.82 in chips)
Ribeye63: posts small blind $0.05
PlayTheBlues4U: posts big blind $0.10
donjt2653: sits out
*** HOLE CARDS ***
Dealt to PlayTheBlues4U [8c Qs]
clovvnfiesta: folds
ironons: raises $0.20 to $0.30
mellneazy: calls $0.30
Ribeye63: calls $0.25
PlayTheBlues4U: folds
*** FLOP *** [6d Kh 5h]
Ribeye63: checks
ironons: bets $0.48
mellneazy: raises $0.92 to $1.40
Ribeye63: folds
ironons: calls $0.92
*** TURN *** [6d Kh 5h] [Ks]
ironons: checks
mellneazy: checks
*** RIVER *** [6d Kh 5h Ks] [8h]
ironons: checks
mellneazy: bets $3
ironons: folds
Uncalled bet ($3) returned to mellneazy
mellneazy collected $3.61 from pot
mellneazy: doesn't show hand
*** SUMMARY ***
Total pot $3.80 | Rake $0.19
Board [6d Kh 5h Ks 8h]
Seat 1: clovvnfiesta folded before Flop (didn't bet)
Seat 2: ironons folded on the River
Seat 3: mellneazy (button) collected ($3.61)
Seat 4: Ribeye63 (small blind) folded on the Flop
Seat 5: PlayTheBlues4U (big blind) folded before Flop


*********** # 73 **************
PokerStars Hand #203998485140:  Hold'em No Limit ($0.05/$0.10 USD) - 2019/09/26 22:27:54 ET
Table 'Delphinus' 6-max Seat #6 is the button
Seat 1: daughterstuitio ($9.85 in chips)
Seat 2: maxplans323 ($6.54 in chips)
Seat 3: joncruise ($9.33 in chips)
Seat 4: 921zhaopeng ($11.63 in chips)
Seat 5: SuWasup ($9.85 in chips)
Seat 6: PlayTheBlues4U ($11.28 in chips)
daughterstuitio: posts small blind $0.05
maxplans323: posts big blind $0.10
*** HOLE CARDS ***
Dealt to PlayTheBlues4U [Qc 9h]
joncruise: calls $0.10
921zhaopeng: raises $0.20 to $0.30
SuWasup: folds
PlayTheBlues4U: folds
daughterstuitio: folds
maxplans323: calls $0.20
joncruise: calls $0.20
*** FLOP *** [6c 8h 3s]
maxplans323: bets $0.70
joncruise: calls $0.70
921zhaopeng: folds
*** TURN *** [6c 8h 3s] [Ad]
maxplans323: checks
joncruise: checks
*** RIVER *** [6c 8h 3s Ad] [2c]
maxplans323: checks
joncruise: checks
*** SHOW DOWN ***
maxplans323: shows [9s 9d] (a pair of Nines)
joncruise: mucks hand
maxplans323 collected $2.23 from pot
*** SUMMARY ***
Total pot $2.35 | Rake $0.12
Board [6c 8h 3s Ad 2c]
Seat 1: daughterstuitio (small blind) folded before Flop
Seat 2: maxplans323 (big blind) showed [9s 9d] and won ($2.23) with a pair of Nines
Seat 3: joncruise mucked [8d Tc]
Seat 4: 921zhaopeng folded on the Flop
Seat 5: SuWasup folded before Flop (didn't bet)
Seat 6: PlayTheBlues4U (button) folded before Flop (didn't bet)


*********** # 74 **************
PokerStars Hand #203998485130:  Hold'em No Limit ($0.05/$0.10 USD) - 2019/09/26 22:27:51 ET
Table 'Lynx' 6-max Seat #2 is the button
Seat 1: clovvnfiesta ($3.85 in chips)
Seat 2: ironons ($10.09 in chips)
Seat 3: mellneazy ($16.99 in chips)
Seat 4: Ribeye63 ($10 in chips)
Seat 5: PlayTheBlues4U ($13.82 in chips)
mellneazy: posts small blind $0.05
Ribeye63: posts big blind $0.10
donjt2653: sits out
*** HOLE CARDS ***
Dealt to PlayTheBlues4U [2s Ts]
PlayTheBlues4U: folds
clovvnfiesta: folds
ironons: raises $0.20 to $0.30
mellneazy: calls $0.25
Ribeye63: folds
*** FLOP *** [6d Jc 8s]
mellneazy: checks
ironons: checks
*** TURN *** [6d Jc 8s] [9h]
mellneazy: checks
ironons: bets $0.33
mellneazy: folds
Uncalled bet ($0.33) returned to ironons
ironons collected $0.66 from pot
ironons: doesn't show hand
*** SUMMARY ***
Total pot $0.70 | Rake $0.04
Board [6d Jc 8s 9h]
Seat 1: clovvnfiesta folded before Flop (didn't bet)
Seat 2: ironons (button) collected ($0.66)
Seat 3: mellneazy (small blind) folded on the Turn
Seat 4: Ribeye63 (big blind) folded before Flop
Seat 5: PlayTheBlues4U folded before Flop (didn't bet)


*********** # 75 **************
PokerStars Hand #203998485069:  Hold'em No Limit ($0.05/$0.10 USD) - 2019/09/26 22:27:33 ET
Table 'Lynx' 6-max Seat #1 is the button
Seat 1: clovvnfiesta ($3.85 in chips)
Seat 2: ironons ($10.19 in chips)
Seat 3: mellneazy ($16.90 in chips)
Seat 4: Ribeye63 ($10 in chips)
Seat 5: PlayTheBlues4U ($13.82 in chips)
ironons: posts small blind $0.05
mellneazy: posts big blind $0.10
donjt2653: sits out
*** HOLE CARDS ***
Dealt to PlayTheBlues4U [2h Qh]
Ribeye63: folds
PlayTheBlues4U: folds
clovvnfiesta: folds
ironons: calls $0.05
mellneazy: checks
*** FLOP *** [Ac 3s 6s]
ironons: checks
mellneazy: checks
*** TURN *** [Ac 3s 6s] [3h]
ironons: checks
mellneazy: checks
*** RIVER *** [Ac 3s 6s 3h] [5d]
ironons: checks
mellneazy: checks
*** SHOW DOWN ***
ironons: shows [9h Jc] (a pair of Threes)
mellneazy: shows [Jh Kc] (a pair of Threes - Ace+King kicker)
mellneazy collected $0.19 from pot
*** SUMMARY ***
Total pot $0.20 | Rake $0.01
Board [Ac 3s 6s 3h 5d]
Seat 1: clovvnfiesta (button) folded before Flop (didn't bet)
Seat 2: ironons (small blind) showed [9h Jc] and lost with a pair of Threes
Seat 3: mellneazy (big blind) showed [Jh Kc] and won ($0.19) with a pair of Threes
Seat 4: Ribeye63 folded before Flop (didn't bet)
Seat 5: PlayTheBlues4U folded before Flop (didn't bet)


*********** # 76 **************
PokerStars Hand #203998484988:  Hold'em No Limit ($0.05/$0.10 USD) - 2019/09/26 22:27:03 ET
Table 'Delphinus' 6-max Seat #5 is the button
Seat 1: daughterstuitio ($10.15 in chips)
Seat 2: maxplans323 ($6.54 in chips)
Seat 3: joncruise ($9.01 in chips)
Seat 4: 921zhaopeng ($11.63 in chips)
Seat 5: SuWasup ($9.85 in chips)
Seat 6: PlayTheBlues4U ($11.33 in chips)
PlayTheBlues4U: posts small blind $0.05
daughterstuitio: posts big blind $0.10
*** HOLE CARDS ***
Dealt to PlayTheBlues4U [4h Kd]
maxplans323: folds
joncruise: raises $0.20 to $0.30
921zhaopeng: folds
SuWasup: folds
PlayTheBlues4U: folds
daughterstuitio: calls $0.20
*** FLOP *** [9h Ah Ks]
daughterstuitio: checks
joncruise: checks
*** TURN *** [9h Ah Ks] [9s]
daughterstuitio: checks
joncruise: checks
*** RIVER *** [9h Ah Ks 9s] [2c]
daughterstuitio: checks
joncruise: bets $0.60
daughterstuitio: folds
Uncalled bet ($0.60) returned to joncruise
joncruise collected $0.62 from pot
joncruise: doesn't show hand
*** SUMMARY ***
Total pot $0.65 | Rake $0.03
Board [9h Ah Ks 9s 2c]
Seat 1: daughterstuitio (big blind) folded on the River
Seat 2: maxplans323 folded before Flop (didn't bet)
Seat 3: joncruise collected ($0.62)
Seat 4: 921zhaopeng folded before Flop (didn't bet)
Seat 5: SuWasup (button) folded before Flop (didn't bet)
Seat 6: PlayTheBlues4U (small blind) folded before Flop


*********** # 77 **************
PokerStars Hand #203998484880:  Hold'em No Limit ($0.05/$0.10 USD) - 2019/09/26 22:26:31 ET
Table 'Lynx' 6-max Seat #5 is the button
Seat 1: clovvnfiesta ($3.90 in chips)
Seat 2: ironons ($8.76 in chips)
Seat 3: mellneazy ($17.65 in chips)
Seat 4: Ribeye63 ($1.78 in chips)
Seat 5: PlayTheBlues4U ($14.57 in chips)
donjt2653 will be allowed to play after the button
clovvnfiesta: posts small blind $0.05
ironons: posts big blind $0.10
*** HOLE CARDS ***
Dealt to PlayTheBlues4U [Th Td]
mellneazy: raises $0.20 to $0.30
Ribeye63: folds
PlayTheBlues4U: calls $0.30
clovvnfiesta: folds
ironons: calls $0.20
*** FLOP *** [Jh 8s 5h]
ironons: checks
mellneazy: checks
PlayTheBlues4U: checks
*** TURN *** [Jh 8s 5h] [5s]
ironons: bets $0.45
mellneazy: calls $0.45
PlayTheBlues4U: calls $0.45
*** RIVER *** [Jh 8s 5h 5s] [6s]
ironons: bets $2
mellneazy: folds
PlayTheBlues4U: folds
Uncalled bet ($2) returned to ironons
ironons collected $2.18 from pot
ironons: doesn't show hand
*** SUMMARY ***
Total pot $2.30 | Rake $0.12
Board [Jh 8s 5h 5s 6s]
Seat 1: clovvnfiesta (small blind) folded before Flop
Seat 2: ironons (big blind) collected ($2.18)
Seat 3: mellneazy folded on the River
Seat 4: Ribeye63 folded before Flop (didn't bet)
Seat 5: PlayTheBlues4U (button) folded on the River


*********** # 78 **************
PokerStars Hand #203998484804:  Hold'em No Limit ($0.05/$0.10 USD) - 2019/09/26 22:26:05 ET
Table 'Delphinus' 6-max Seat #4 is the button
Seat 1: daughterstuitio ($10.25 in chips)
Seat 2: maxplans323 ($6.54 in chips)
Seat 3: joncruise ($9.01 in chips)
Seat 4: 921zhaopeng ($11.63 in chips)
Seat 5: SuWasup ($9.49 in chips)
Seat 6: PlayTheBlues4U ($11.63 in chips)
SuWasup: posts small blind $0.05
PlayTheBlues4U: posts big blind $0.10
*** HOLE CARDS ***
Dealt to PlayTheBlues4U [5c Qs]
daughterstuitio: calls $0.10
maxplans323: folds
joncruise: folds
921zhaopeng: folds
SuWasup: calls $0.05
PlayTheBlues4U: checks
*** FLOP *** [9d Qd 7h]
SuWasup: checks
PlayTheBlues4U: checks
daughterstuitio: checks
*** TURN *** [9d Qd 7h] [2d]
SuWasup: checks
PlayTheBlues4U: bets $0.20
daughterstuitio: folds
SuWasup: calls $0.20
*** RIVER *** [9d Qd 7h 2d] [9c]
SuWasup: checks
PlayTheBlues4U: checks
*** SHOW DOWN ***
SuWasup: shows [9s Jh] (three of a kind, Nines)
PlayTheBlues4U: mucks hand
SuWasup collected $0.66 from pot
*** SUMMARY ***
Total pot $0.70 | Rake $0.04
Board [9d Qd 7h 2d 9c]
Seat 1: daughterstuitio folded on the Turn
Seat 2: maxplans323 folded before Flop (didn't bet)
Seat 3: joncruise folded before Flop (didn't bet)
Seat 4: 921zhaopeng (button) folded before Flop (didn't bet)
Seat 5: SuWasup (small blind) showed [9s Jh] and won ($0.66) with three of a kind, Nines
Seat 6: PlayTheBlues4U (big blind) mucked [5c Qs]


*********** # 79 **************
PokerStars Hand #203998484735:  Hold'em No Limit ($0.05/$0.10 USD) - 2019/09/26 22:25:42 ET
Table 'Delphinus' 6-max Seat #3 is the button
Seat 1: daughterstuitio ($10.25 in chips)
Seat 2: maxplans323 ($6.54 in chips)
Seat 3: joncruise ($9.11 in chips)
Seat 4: 921zhaopeng ($11.73 in chips)
Seat 5: SuWasup ($9.31 in chips)
Seat 6: PlayTheBlues4U ($11.63 in chips)
921zhaopeng: posts small blind $0.05
SuWasup: posts big blind $0.10
*** HOLE CARDS ***
Dealt to PlayTheBlues4U [4c 3h]
PlayTheBlues4U: folds
daughterstuitio: folds
maxplans323: folds
joncruise: calls $0.10
921zhaopeng: calls $0.05
SuWasup: checks
*** FLOP *** [Ac 5h 6c]
921zhaopeng: checks
SuWasup: bets $0.20
joncruise: folds
921zhaopeng: folds
Uncalled bet ($0.20) returned to SuWasup
SuWasup collected $0.28 from pot
SuWasup: doesn't show hand
*** SUMMARY ***
Total pot $0.30 | Rake $0.02
Board [Ac 5h 6c]
Seat 1: daughterstuitio folded before Flop (didn't bet)
Seat 2: maxplans323 folded before Flop (didn't bet)
Seat 3: joncruise (button) folded on the Flop
Seat 4: 921zhaopeng (small blind) folded on the Flop
Seat 5: SuWasup (big blind) collected ($0.28)
Seat 6: PlayTheBlues4U folded before Flop (didn't bet)


*********** # 80 **************
PokerStars Hand #203998484710:  Hold'em No Limit ($0.05/$0.10 USD) - 2019/09/26 22:25:34 ET
Table 'Lynx' 6-max Seat #4 is the button
Seat 1: clovvnfiesta ($4 in chips)
Seat 2: ironons ($8.86 in chips)
Seat 3: mellneazy ($17.65 in chips)
Seat 4: Ribeye63 ($9.35 in chips)
Seat 5: PlayTheBlues4U ($7.57 in chips)
PlayTheBlues4U: posts small blind $0.05
clovvnfiesta: posts big blind $0.10
*** HOLE CARDS ***
Dealt to PlayTheBlues4U [Ah Qh]
ironons: calls $0.10
mellneazy: folds
Ribeye63: raises $0.30 to $0.40
donjt2653 joins the table at seat #6
PlayTheBlues4U: raises $0.60 to $1
clovvnfiesta: folds
ironons: folds
Ribeye63: calls $0.60
*** FLOP *** [6h 9s 3h]
PlayTheBlues4U: bets $1.10
Ribeye63: raises $1.10 to $2.20
PlayTheBlues4U: raises $4.37 to $6.57 and is all-in
Ribeye63: calls $4.37
*** TURN *** [6h 9s 3h] [7s]
*** RIVER *** [6h 9s 3h 7s] [9h]
*** SHOW DOWN ***
PlayTheBlues4U: shows [Ah Qh] (a flush, Ace high)
Ribeye63: shows [Kc Ks] (two pair, Kings and Nines)
PlayTheBlues4U collected $14.57 from pot
*** SUMMARY ***
Total pot $15.34 | Rake $0.77
Board [6h 9s 3h 7s 9h]
Seat 1: clovvnfiesta (big blind) folded before Flop
Seat 2: ironons folded before Flop
Seat 3: mellneazy folded before Flop (didn't bet)
Seat 4: Ribeye63 (button) showed [Kc Ks] and lost with two pair, Kings and Nines
Seat 5: PlayTheBlues4U (small blind) showed [Ah Qh] and won ($14.57) with a flush, Ace high


*********** # 81 **************
PokerStars Hand #203998484640:  Hold'em No Limit ($0.05/$0.10 USD) - 2019/09/26 22:25:11 ET
Table 'Delphinus' 6-max Seat #2 is the button
Seat 1: daughterstuitio ($10.55 in chips)
Seat 2: maxplans323 ($6.09 in chips)
Seat 3: joncruise ($9.16 in chips)
Seat 4: 921zhaopeng ($11.83 in chips)
Seat 5: SuWasup ($9.31 in chips)
Seat 6: PlayTheBlues4U ($11.63 in chips)
joncruise: posts small blind $0.05
921zhaopeng: posts big blind $0.10
*** HOLE CARDS ***
Dealt to PlayTheBlues4U [8h Jd]
SuWasup: folds
PlayTheBlues4U: folds
daughterstuitio: raises $0.20 to $0.30
maxplans323: raises $0.60 to $0.90
joncruise: folds
921zhaopeng: folds
daughterstuitio: folds
Uncalled bet ($0.60) returned to maxplans323
maxplans323 collected $0.75 from pot
maxplans323: doesn't show hand
*** SUMMARY ***
Total pot $0.75 | Rake $0
Seat 1: daughterstuitio folded before Flop
Seat 2: maxplans323 (button) collected ($0.75)
Seat 3: joncruise (small blind) folded before Flop
Seat 4: 921zhaopeng (big blind) folded before Flop
Seat 5: SuWasup folded before Flop (didn't bet)
Seat 6: PlayTheBlues4U folded before Flop (didn't bet)


*********** # 82 **************
PokerStars Hand #203998484575:  Hold'em No Limit ($0.05/$0.10 USD) - 2019/09/26 22:24:50 ET
Table 'Delphinus' 6-max Seat #1 is the button
Seat 1: daughterstuitio ($10.40 in chips)
Seat 2: maxplans323 ($6.14 in chips)
Seat 3: joncruise ($9.26 in chips)
Seat 4: 921zhaopeng ($11.83 in chips)
Seat 5: SuWasup ($9.31 in chips)
Seat 6: PlayTheBlues4U ($11.63 in chips)
maxplans323: posts small blind $0.05
joncruise: posts big blind $0.10
*** HOLE CARDS ***
Dealt to PlayTheBlues4U [Jd 3d]
921zhaopeng: folds
SuWasup: folds
PlayTheBlues4U: folds
daughterstuitio: raises $0.20 to $0.30
maxplans323: folds
joncruise: folds
Uncalled bet ($0.20) returned to daughterstuitio
daughterstuitio collected $0.25 from pot
daughterstuitio: doesn't show hand
*** SUMMARY ***
Total pot $0.25 | Rake $0
Seat 1: daughterstuitio (button) collected ($0.25)
Seat 2: maxplans323 (small blind) folded before Flop
Seat 3: joncruise (big blind) folded before Flop
Seat 4: 921zhaopeng folded before Flop (didn't bet)
Seat 5: SuWasup folded before Flop (didn't bet)
Seat 6: PlayTheBlues4U folded before Flop (didn't bet)


*********** # 83 **************
PokerStars Hand #203998484549:  Hold'em No Limit ($0.05/$0.10 USD) - 2019/09/26 22:24:42 ET
Table 'Lynx' 6-max Seat #3 is the button
Seat 2: ironons ($8.26 in chips)
Seat 3: mellneazy ($17.65 in chips)
Seat 4: Ribeye63 ($9.40 in chips)
Seat 5: PlayTheBlues4U ($8.18 in chips)
Ribeye63: posts small blind $0.05
PlayTheBlues4U: posts big blind $0.10
*** HOLE CARDS ***
Dealt to PlayTheBlues4U [8s 7c]
ironons: raises $0.20 to $0.30
StarsAccount1 leaves the table
mellneazy: folds
Ribeye63: folds
PlayTheBlues4U: calls $0.20
*** FLOP *** [7s Jd 9d]
PlayTheBlues4U: checks
ironons: bets $0.31
PlayTheBlues4U: calls $0.31
*** TURN *** [7s Jd 9d] [Kh]
PlayTheBlues4U: checks
ironons: bets $0.90
clovvnfiesta joins the table at seat #1
PlayTheBlues4U: folds
Uncalled bet ($0.90) returned to ironons
ironons collected $1.21 from pot
ironons: doesn't show hand
*** SUMMARY ***
Total pot $1.27 | Rake $0.06
Board [7s Jd 9d Kh]
Seat 2: ironons collected ($1.21)
Seat 3: mellneazy (button) folded before Flop (didn't bet)
Seat 4: Ribeye63 (small blind) folded before Flop
Seat 5: PlayTheBlues4U (big blind) folded on the Turn


*********** # 84 **************
PokerStars Hand #203998484413:  Hold'em No Limit ($0.05/$0.10 USD) - 2019/09/26 22:23:58 ET
Table 'Delphinus' 6-max Seat #6 is the button
Seat 1: daughterstuitio ($10.45 in chips)
Seat 2: maxplans323 ($6.75 in chips)
Seat 3: joncruise ($8.66 in chips)
Seat 4: 921zhaopeng ($11.83 in chips)
Seat 5: SuWasup ($9.31 in chips)
Seat 6: PlayTheBlues4U ($11.63 in chips)
daughterstuitio: posts small blind $0.05
maxplans323: posts big blind $0.10
*** HOLE CARDS ***
Dealt to PlayTheBlues4U [6h 2d]
joncruise: calls $0.10
921zhaopeng: folds
SuWasup: folds
PlayTheBlues4U: folds
daughterstuitio: folds
maxplans323: raises $0.20 to $0.30
joncruise: calls $0.20
*** FLOP *** [Ks 3h 9h]
maxplans323: bets $0.31
joncruise: calls $0.31
*** TURN *** [Ks 3h 9h] [Ah]
maxplans323: checks
joncruise: bets $0.60
maxplans323: folds
Uncalled bet ($0.60) returned to joncruise
joncruise collected $1.21 from pot
joncruise: doesn't show hand
*** SUMMARY ***
Total pot $1.27 | Rake $0.06
Board [Ks 3h 9h Ah]
Seat 1: daughterstuitio (small blind) folded before Flop
Seat 2: maxplans323 (big blind) folded on the Turn
Seat 3: joncruise collected ($1.21)
Seat 4: 921zhaopeng folded before Flop (didn't bet)
Seat 5: SuWasup folded before Flop (didn't bet)
Seat 6: PlayTheBlues4U (button) folded before Flop (didn't bet)


*********** # 85 **************
PokerStars Hand #203998484384:  Hold'em No Limit ($0.05/$0.10 USD) - 2019/09/26 22:23:49 ET
Table 'Lynx' 6-max Seat #2 is the button
Seat 2: ironons ($5.46 in chips)
Seat 3: mellneazy ($17.70 in chips)
Seat 4: Ribeye63 ($9.50 in chips)
Seat 5: PlayTheBlues4U ($8.98 in chips)
Seat 6: StarsAccount1 ($2.11 in chips)
mellneazy: posts small blind $0.05
Ribeye63: posts big blind $0.10
*** HOLE CARDS ***
Dealt to PlayTheBlues4U [Jd As]
PlayTheBlues4U: raises $0.20 to $0.30
StarsAccount1: calls $0.30
ironons: calls $0.30
mellneazy: folds
Ribeye63: folds
*** FLOP *** [Th 6h 9s]
PlayTheBlues4U: checks
StarsAccount1: bets $0.50
ironons: calls $0.50
PlayTheBlues4U: calls $0.50
*** TURN *** [Th 6h 9s] [5s]
PlayTheBlues4U: checks
StarsAccount1: bets $1.31 and is all-in
ironons: calls $1.31
PlayTheBlues4U: folds
*** RIVER *** [Th 6h 9s 5s] [2c]
*** SHOW DOWN ***
StarsAccount1: shows [Qh Jh] (high card Queen)
ironons: shows [5h 7h] (a pair of Fives)
ironons collected $4.91 from pot
*** SUMMARY ***
Total pot $5.17 | Rake $0.26
Board [Th 6h 9s 5s 2c]
Seat 2: ironons (button) showed [5h 7h] and won ($4.91) with a pair of Fives
Seat 3: mellneazy (small blind) folded before Flop
Seat 4: Ribeye63 (big blind) folded before Flop
Seat 5: PlayTheBlues4U folded on the Turn
Seat 6: StarsAccount1 showed [Qh Jh] and lost with high card Queen


*********** # 86 **************
PokerStars Hand #203998484290:  Hold'em No Limit ($0.05/$0.10 USD) - 2019/09/26 22:23:20 ET
Table 'Delphinus' 6-max Seat #5 is the button
Seat 1: daughterstuitio ($10 in chips)
Seat 2: maxplans323 ($6.75 in chips)
Seat 3: joncruise ($8.66 in chips)
Seat 4: 921zhaopeng ($11.83 in chips)
Seat 5: SuWasup ($9.71 in chips)
Seat 6: PlayTheBlues4U ($11.68 in chips)
PlayTheBlues4U: posts small blind $0.05
daughterstuitio: posts big blind $0.10
*** HOLE CARDS ***
Dealt to PlayTheBlues4U [5c Td]
maxplans323: folds
joncruise: folds
921zhaopeng: folds
SuWasup: raises $0.30 to $0.40
PlayTheBlues4U: folds
daughterstuitio: raises $0.80 to $1.20
SuWasup: folds
Uncalled bet ($0.80) returned to daughterstuitio
daughterstuitio collected $0.85 from pot
daughterstuitio: doesn't show hand
*** SUMMARY ***
Total pot $0.85 | Rake $0
Seat 1: daughterstuitio (big blind) collected ($0.85)
Seat 2: maxplans323 folded before Flop (didn't bet)
Seat 3: joncruise folded before Flop (didn't bet)
Seat 4: 921zhaopeng folded before Flop (didn't bet)
Seat 5: SuWasup (button) folded before Flop
Seat 6: PlayTheBlues4U (small blind) folded before Flop


*********** # 87 **************
PokerStars Hand #203998484182:  Hold'em No Limit ($0.05/$0.10 USD) - 2019/09/26 22:22:47 ET
Table 'Delphinus' 6-max Seat #4 is the button
Seat 2: maxplans323 ($6.75 in chips)
Seat 3: joncruise ($7.62 in chips)
Seat 4: 921zhaopeng ($12.83 in chips)
Seat 5: SuWasup ($9.76 in chips)
Seat 6: PlayTheBlues4U ($11.78 in chips)
SuWasup: posts small blind $0.05
PlayTheBlues4U: posts big blind $0.10
daughterstuitio: sits out
*** HOLE CARDS ***
Dealt to PlayTheBlues4U [8c 2d]
maxplans323: folds
joncruise: calls $0.10
921zhaopeng: raises $0.10 to $0.20
SuWasup: folds
PlayTheBlues4U: folds
joncruise: calls $0.10
*** FLOP *** [8s 7c 3h]
joncruise: checks
921zhaopeng: bets $0.30
joncruise: calls $0.30
*** TURN *** [8s 7c 3h] [4c]
joncruise: checks
921zhaopeng: bets $0.50
joncruise: calls $0.50
*** RIVER *** [8s 7c 3h 4c] [6d]
joncruise: checks
921zhaopeng: checks
*** SHOW DOWN ***
joncruise: shows [9c Th] (a straight, Six to Ten)
921zhaopeng: mucks hand
joncruise collected $2.04 from pot
*** SUMMARY ***
Total pot $2.15 | Rake $0.11
Board [8s 7c 3h 4c 6d]
Seat 2: maxplans323 folded before Flop (didn't bet)
Seat 3: joncruise showed [9c Th] and won ($2.04) with a straight, Six to Ten
Seat 4: 921zhaopeng (button) mucked [8h Jd]
Seat 5: SuWasup (small blind) folded before Flop
Seat 6: PlayTheBlues4U (big blind) folded before Flop


*********** # 88 **************
PokerStars Hand #203998484040:  Hold'em No Limit ($0.05/$0.10 USD) - 2019/09/26 22:22:04 ET
Table 'Lynx' 6-max Seat #6 is the button
Seat 1: DaGoodz33 ($12.24 in chips)
Seat 2: ironons ($5.76 in chips)
Seat 3: mellneazy ($14.32 in chips)
Seat 4: Ribeye63 ($9.50 in chips)
Seat 5: PlayTheBlues4U ($11.78 in chips)
Seat 6: StarsAccount1 ($2.41 in chips)
DaGoodz33: posts small blind $0.05
ironons: posts big blind $0.10
*** HOLE CARDS ***
Dealt to PlayTheBlues4U [Jh Td]
mellneazy: raises $0.20 to $0.30
Ribeye63: folds
PlayTheBlues4U: calls $0.30
StarsAccount1: calls $0.30
DaGoodz33: calls $0.25
ironons: calls $0.20
*** FLOP *** [Jc 2c 5d]
DaGoodz33: checks
ironons: checks
mellneazy: checks
PlayTheBlues4U: bets $0.90
StarsAccount1: folds
DaGoodz33: folds
DaGoodz33 leaves the table
ironons: folds
mellneazy: raises $1.60 to $2.50
PlayTheBlues4U: calls $1.60
*** TURN *** [Jc 2c 5d] [Ad]
mellneazy: bets $2
PlayTheBlues4U: folds
Uncalled bet ($2) returned to mellneazy
mellneazy collected $6.18 from pot
mellneazy: doesn't show hand
*** SUMMARY ***
Total pot $6.50 | Rake $0.32
Board [Jc 2c 5d Ad]
Seat 1: DaGoodz33 (small blind) folded on the Flop
Seat 2: ironons (big blind) folded on the Flop
Seat 3: mellneazy collected ($6.18)
Seat 4: Ribeye63 folded before Flop (didn't bet)
Seat 5: PlayTheBlues4U folded on the Turn
Seat 6: StarsAccount1 (button) folded on the Flop


*********** # 89 **************
PokerStars Hand #203998484024:  Hold'em No Limit ($0.05/$0.10 USD) - 2019/09/26 22:21:59 ET
Table 'Delphinus' 6-max Seat #3 is the button
Seat 2: maxplans323 ($7.05 in chips)
Seat 3: joncruise ($7.62 in chips)
Seat 4: 921zhaopeng ($12.88 in chips)
Seat 5: SuWasup ($9.86 in chips)
Seat 6: PlayTheBlues4U ($11.37 in chips)
921zhaopeng: posts small blind $0.05
SuWasup: posts big blind $0.10
daughterstuitio: sits out
*** HOLE CARDS ***
Dealt to PlayTheBlues4U [7h 7s]
PlayTheBlues4U: calls $0.10
maxplans323: raises $0.20 to $0.30
joncruise: folds
921zhaopeng: folds
SuWasup: folds
PlayTheBlues4U: calls $0.20
*** FLOP *** [Jc 5s 2c]
PlayTheBlues4U: checks
maxplans323: checks
*** TURN *** [Jc 5s 2c] [Tc]
PlayTheBlues4U: checks
maxplans323: checks
*** RIVER *** [Jc 5s 2c Tc] [Kd]
PlayTheBlues4U: bets $0.40
maxplans323: folds
Uncalled bet ($0.40) returned to PlayTheBlues4U
PlayTheBlues4U collected $0.71 from pot
PlayTheBlues4U: doesn't show hand
*** SUMMARY ***
Total pot $0.75 | Rake $0.04
Board [Jc 5s 2c Tc Kd]
Seat 2: maxplans323 folded on the River
Seat 3: joncruise (button) folded before Flop (didn't bet)
Seat 4: 921zhaopeng (small blind) folded before Flop
Seat 5: SuWasup (big blind) folded before Flop
Seat 6: PlayTheBlues4U collected ($0.71)


*********** # 90 **************
PokerStars Hand #203998483883:  Hold'em No Limit ($0.05/$0.10 USD) - 2019/09/26 22:21:19 ET
Table 'Delphinus' 6-max Seat #2 is the button
Seat 2: maxplans323 ($7.35 in chips)
Seat 3: joncruise ($7.92 in chips)
Seat 4: 921zhaopeng ($12.98 in chips)
Seat 5: SuWasup ($9.21 in chips)
Seat 6: PlayTheBlues4U ($11.37 in chips)
joncruise: posts small blind $0.05
921zhaopeng: posts big blind $0.10
daughterstuitio: sits out
*** HOLE CARDS ***
Dealt to PlayTheBlues4U [3h 9d]
SuWasup: raises $0.20 to $0.30
PlayTheBlues4U: folds
maxplans323: calls $0.30
joncruise: calls $0.25
921zhaopeng: folds
*** FLOP *** [5d Qd 6s]
joncruise: checks
SuWasup: bets $0.40
maxplans323: folds
joncruise: folds
Uncalled bet ($0.40) returned to SuWasup
SuWasup collected $0.95 from pot
SuWasup: doesn't show hand
*** SUMMARY ***
Total pot $1 | Rake $0.05
Board [5d Qd 6s]
Seat 2: maxplans323 (button) folded on the Flop
Seat 3: joncruise (small blind) folded on the Flop
Seat 4: 921zhaopeng (big blind) folded before Flop
Seat 5: SuWasup collected ($0.95)
Seat 6: PlayTheBlues4U folded before Flop (didn't bet)


*********** # 91 **************
PokerStars Hand #203998483750:  Hold'em No Limit ($0.05/$0.10 USD) - 2019/09/26 22:20:32 ET
Table 'Lynx' 6-max Seat #5 is the button
Seat 1: DaGoodz33 ($14.34 in chips)
Seat 2: ironons ($5.76 in chips)
Seat 3: mellneazy ($16.42 in chips)
Seat 4: Ribeye63 ($9.50 in chips)
Seat 5: PlayTheBlues4U ($7.85 in chips)
Seat 6: StarsAccount1 ($2.46 in chips)
StarsAccount1: posts small blind $0.05
DaGoodz33: posts big blind $0.10
*** HOLE CARDS ***
Dealt to PlayTheBlues4U [Tc Td]
ironons: folds
mellneazy: raises $0.20 to $0.30
Ribeye63: folds
PlayTheBlues4U: raises $0.50 to $0.80
StarsAccount1: folds
DaGoodz33: calls $0.70
mellneazy: calls $0.50
*** FLOP *** [9c 4s Kh]
DaGoodz33: checks
mellneazy: checks
PlayTheBlues4U: bets $1.30
DaGoodz33: calls $1.30
mellneazy: calls $1.30
*** TURN *** [9c 4s Kh] [Jh]
DaGoodz33: checks
mellneazy: checks
PlayTheBlues4U: checks
*** RIVER *** [9c 4s Kh Jh] [Jc]
DaGoodz33: checks
mellneazy: checks
PlayTheBlues4U: checks
*** SHOW DOWN ***
DaGoodz33: shows [9h 8h] (two pair, Jacks and Nines)
mellneazy: shows [9s 8c] (two pair, Jacks and Nines)
PlayTheBlues4U: shows [Tc Td] (two pair, Jacks and Tens)
PlayTheBlues4U collected $6.03 from pot
*** SUMMARY ***
Total pot $6.35 | Rake $0.32
Board [9c 4s Kh Jh Jc]
Seat 1: DaGoodz33 (big blind) showed [9h 8h] and lost with two pair, Jacks and Nines
Seat 2: ironons folded before Flop (didn't bet)
Seat 3: mellneazy showed [9s 8c] and lost with two pair, Jacks and Nines
Seat 4: Ribeye63 folded before Flop (didn't bet)
Seat 5: PlayTheBlues4U (button) showed [Tc Td] and won ($6.03) with two pair, Jacks and Tens
Seat 6: StarsAccount1 (small blind) folded before Flop


*********** # 92 **************
PokerStars Hand #203998483724:  Hold'em No Limit ($0.05/$0.10 USD) - 2019/09/26 22:20:25 ET
Table 'Delphinus' 6-max Seat #6 is the button
Seat 2: maxplans323 ($7.40 in chips)
Seat 3: joncruise ($8.02 in chips)
Seat 4: 921zhaopeng ($12.98 in chips)
Seat 5: SuWasup ($9.51 in chips)
Seat 6: PlayTheBlues4U ($10.96 in chips)
daughterstuitio will be allowed to play after the button
maxplans323: posts small blind $0.05
joncruise: posts big blind $0.10
*** HOLE CARDS ***
Dealt to PlayTheBlues4U [8s 8c]
921zhaopeng: folds
SuWasup: raises $0.20 to $0.30
PlayTheBlues4U: calls $0.30
maxplans323: folds
joncruise: folds
*** FLOP *** [As 9c Ks]
SuWasup: checks
PlayTheBlues4U: checks
*** TURN *** [As 9c Ks] [2s]
SuWasup: checks
PlayTheBlues4U: checks
*** RIVER *** [As 9c Ks 2s] [Ts]
SuWasup: checks
PlayTheBlues4U: checks
*** SHOW DOWN ***
SuWasup: shows [Ad Td] (two pair, Aces and Tens)
PlayTheBlues4U: shows [8s 8c] (a flush, Ace high)
PlayTheBlues4U collected $0.71 from pot
*** SUMMARY ***
Total pot $0.75 | Rake $0.04
Board [As 9c Ks 2s Ts]
Seat 2: maxplans323 (small blind) folded before Flop
Seat 3: joncruise (big blind) folded before Flop
Seat 4: 921zhaopeng folded before Flop (didn't bet)
Seat 5: SuWasup showed [Ad Td] and lost with two pair, Aces and Tens
Seat 6: PlayTheBlues4U (button) showed [8s 8c] and won ($0.71) with a flush, Ace high


*********** # 93 **************
PokerStars Hand #203995379849:  Hold'em No Limit ($0.05/$0.10 USD) - 2019/09/26 22:19:30 ET
Table 'Delphinus' 6-max Seat #5 is the button
Seat 2: maxplans323 ($7.50 in chips)
Seat 3: joncruise ($8.02 in chips)
Seat 4: 921zhaopeng ($15.08 in chips)
Seat 5: SuWasup ($7.48 in chips)
Seat 6: PlayTheBlues4U ($11.01 in chips)
PlayTheBlues4U: posts small blind $0.05
maxplans323: posts big blind $0.10
*** HOLE CARDS ***
Dealt to PlayTheBlues4U [4h Ts]
joncruise: folds
921zhaopeng: raises $0.20 to $0.30
SuWasup: raises $0.60 to $0.90
PlayTheBlues4U: folds
maxplans323: folds
921zhaopeng: calls $0.60
*** FLOP *** [8s 6d Ac]
921zhaopeng: bets $0.10
SuWasup: calls $0.10
*** TURN *** [8s 6d Ac] [Qs]
daughterstuitio joins the table at seat #1
921zhaopeng: bets $0.10
SuWasup: calls $0.10
*** RIVER *** [8s 6d Ac Qs] [9c]
921zhaopeng: bets $0.10
SuWasup: raises $0.90 to $1
921zhaopeng: calls $0.90
*** SHOW DOWN ***
SuWasup: shows [As Jh] (a pair of Aces)
921zhaopeng: mucks hand
SuWasup collected $4.13 from pot
*** SUMMARY ***
Total pot $4.35 | Rake $0.22
Board [8s 6d Ac Qs 9c]
Seat 2: maxplans323 (big blind) folded before Flop
Seat 3: joncruise folded before Flop (didn't bet)
Seat 4: 921zhaopeng mucked [Qd Tc]
Seat 5: SuWasup (button) showed [As Jh] and won ($4.13) with a pair of Aces
Seat 6: PlayTheBlues4U (small blind) folded before Flop


*********** # 94 **************
PokerStars Hand #203995379825:  Hold'em No Limit ($0.05/$0.10 USD) - 2019/09/26 22:19:24 ET
Table 'Lynx' 6-max Seat #4 is the button
Seat 1: DaGoodz33 ($15.24 in chips)
Seat 2: ironons ($6.06 in chips)
Seat 3: mellneazy ($14.38 in chips)
Seat 4: Ribeye63 ($9.50 in chips)
Seat 5: PlayTheBlues4U ($7.95 in chips)
Seat 6: StarsAccount1 ($3.36 in chips)
PlayTheBlues4U: posts small blind $0.05
StarsAccount1: posts big blind $0.10
*** HOLE CARDS ***
Dealt to PlayTheBlues4U [6c 7d]
DaGoodz33: calls $0.10
ironons: calls $0.10
mellneazy: calls $0.10
Ribeye63: folds
PlayTheBlues4U: calls $0.05
StarsAccount1: raises $0.20 to $0.30
DaGoodz33: calls $0.20
ironons: calls $0.20
mellneazy: calls $0.20
PlayTheBlues4U: folds
*** FLOP *** [Kd Js 4h]
StarsAccount1: checks
DaGoodz33: checks
ironons: checks
mellneazy: bets $0.60
StarsAccount1: calls $0.60
DaGoodz33: calls $0.60
ironons: folds
*** TURN *** [Kd Js 4h] [Ks]
StarsAccount1: checks
DaGoodz33: checks
mellneazy: checks
*** RIVER *** [Kd Js 4h Ks] [4s]
StarsAccount1: checks
DaGoodz33: checks
mellneazy: checks
*** SHOW DOWN ***
StarsAccount1: shows [As Ad] (two pair, Aces and Kings)
DaGoodz33: mucks hand
mellneazy: shows [Qh 4c] (a full house, Fours full of Kings)
mellneazy collected $2.94 from pot
*** SUMMARY ***
Total pot $3.10 | Rake $0.16
Board [Kd Js 4h Ks 4s]
Seat 1: DaGoodz33 mucked [Th Qc]
Seat 2: ironons folded on the Flop
Seat 3: mellneazy showed [Qh 4c] and won ($2.94) with a full house, Fours full of Kings
Seat 4: Ribeye63 (button) folded before Flop (didn't bet)
Seat 5: PlayTheBlues4U (small blind) folded before Flop
Seat 6: StarsAccount1 (big blind) showed [As Ad] and lost with two pair, Aces and Kings


*********** # 95 **************
PokerStars Hand #203995379728:  Hold'em No Limit ($0.05/$0.10 USD) - 2019/09/26 22:18:50 ET
Table 'Lynx' 6-max Seat #3 is the button
Seat 1: DaGoodz33 ($15.24 in chips)
Seat 2: ironons ($7.01 in chips)
Seat 3: mellneazy ($13.38 in chips)
Seat 4: Ribeye63 ($9.55 in chips)
Seat 5: PlayTheBlues4U ($8.05 in chips)
Seat 6: StarsAccount1 ($3.36 in chips)
Ribeye63: posts small blind $0.05
PlayTheBlues4U: posts big blind $0.10
*** HOLE CARDS ***
Dealt to PlayTheBlues4U [9d 3h]
StarsAccount1: folds
DaGoodz33: folds
ironons: calls $0.10
mellneazy: raises $0.35 to $0.45
Ribeye63: folds
PlayTheBlues4U: folds
ironons: calls $0.35
*** FLOP *** [6h Kd 7s]
ironons: checks
mellneazy: bets $0.50
ironons: calls $0.50
*** TURN *** [6h Kd 7s] [8c]
ironons: checks
mellneazy: checks
*** RIVER *** [6h Kd 7s 8c] [Ks]
ironons: checks
mellneazy: checks
*** SHOW DOWN ***
ironons: shows [3s 6s] (two pair, Kings and Sixes)
mellneazy: shows [7d Ac] (two pair, Kings and Sevens)
mellneazy collected $1.95 from pot
*** SUMMARY ***
Total pot $2.05 | Rake $0.10
Board [6h Kd 7s 8c Ks]
Seat 1: DaGoodz33 folded before Flop (didn't bet)
Seat 2: ironons showed [3s 6s] and lost with two pair, Kings and Sixes
Seat 3: mellneazy (button) showed [7d Ac] and won ($1.95) with two pair, Kings and Sevens
Seat 4: Ribeye63 (small blind) folded before Flop
Seat 5: PlayTheBlues4U (big blind) folded before Flop
Seat 6: StarsAccount1 folded before Flop (didn't bet)


*********** # 96 **************
PokerStars Hand #203995379643:  Hold'em No Limit ($0.05/$0.10 USD) - 2019/09/26 22:18:22 ET
Table 'Delphinus' 6-max Seat #4 is the button
Seat 1: SourShoes9 ($20.05 in chips)
Seat 2: maxplans323 ($8.25 in chips)
Seat 3: joncruise ($8.02 in chips)
Seat 4: 921zhaopeng ($15.08 in chips)
Seat 5: SuWasup ($7.53 in chips)
Seat 6: PlayTheBlues4U ($10 in chips)
SuWasup: posts small blind $0.05
PlayTheBlues4U: posts big blind $0.10
*** HOLE CARDS ***
Dealt to PlayTheBlues4U [Js Ah]
SourShoes9: calls $0.10
joncruise said, "hahaha sweating that out"
maxplans323: raises $0.20 to $0.30
joncruise: folds
921zhaopeng: folds
SuWasup: folds
PlayTheBlues4U: calls $0.20
SourShoes9: calls $0.20
*** FLOP *** [Qc 2h 3d]
joncruise said, "never easy ever"
PlayTheBlues4U: checks
SourShoes9: checks
maxplans323: bets $0.45
PlayTheBlues4U: calls $0.45
SourShoes9: folds
*** TURN *** [Qc 2h 3d] [Ad]
SourShoes9 leaves the table
PlayTheBlues4U: checks
maxplans323: checks
*** RIVER *** [Qc 2h 3d Ad] [2s]
PlayTheBlues4U: checks
maxplans323: checks
*** SHOW DOWN ***
PlayTheBlues4U: shows [Js Ah] (two pair, Aces and Deuces)
maxplans323: mucks hand
PlayTheBlues4U collected $1.76 from pot
*** SUMMARY ***
Total pot $1.85 | Rake $0.09
Board [Qc 2h 3d Ad 2s]
Seat 1: SourShoes9 folded on the Flop
Seat 2: maxplans323 mucked [9d 9h]
Seat 3: joncruise folded before Flop (didn't bet)
Seat 4: 921zhaopeng (button) folded before Flop (didn't bet)
Seat 5: SuWasup (small blind) folded before Flop
Seat 6: PlayTheBlues4U (big blind) showed [Js Ah] and won ($1.76) with two pair, Aces and Deuces


*********** # 97 **************
PokerStars Hand #203995379631:  Hold'em No Limit ($0.05/$0.10 USD) - 2019/09/26 22:18:17 ET
Table 'Lynx' 6-max Seat #2 is the button
Seat 1: DaGoodz33 ($15.24 in chips)
Seat 2: ironons ($8.27 in chips)
Seat 3: mellneazy ($12.15 in chips)
Seat 4: Ribeye63 ($9.65 in chips)
Seat 5: PlayTheBlues4U ($8.05 in chips)
Seat 6: StarsAccount1 ($3.36 in chips)
mellneazy: posts small blind $0.05
Ribeye63: posts big blind $0.10
*** HOLE CARDS ***
Dealt to PlayTheBlues4U [6d 4h]
PlayTheBlues4U: folds
StarsAccount1: folds
DaGoodz33: folds
ironons: calls $0.10
mellneazy: raises $0.30 to $0.40
Ribeye63: folds
ironons: calls $0.30
*** FLOP *** [8c 5c 4c]
mellneazy: checks
ironons: bets $0.86
mellneazy: calls $0.86
*** TURN *** [8c 5c 4c] [8h]
mellneazy: checks
ironons: checks
*** RIVER *** [8c 5c 4c 8h] [7h]
mellneazy: checks
ironons: checks
*** SHOW DOWN ***
mellneazy: shows [Qh 8s] (three of a kind, Eights)
ironons: mucks hand
mellneazy collected $2.49 from pot
*** SUMMARY ***
Total pot $2.62 | Rake $0.13
Board [8c 5c 4c 8h 7h]
Seat 1: DaGoodz33 folded before Flop (didn't bet)
Seat 2: ironons (button) mucked [5d Kc]
Seat 3: mellneazy (small blind) showed [Qh 8s] and won ($2.49) with three of a kind, Eights
Seat 4: Ribeye63 (big blind) folded before Flop
Seat 5: PlayTheBlues4U folded before Flop (didn't bet)
Seat 6: StarsAccount1 folded before Flop (didn't bet)


*********** # 98 **************
PokerStars Hand #203995379471:  Hold'em No Limit ($0.05/$0.10 USD) - 2019/09/26 22:17:24 ET
Table 'Lynx' 6-max Seat #1 is the button
Seat 1: DaGoodz33 ($15.24 in chips)
Seat 2: ironons ($9.54 in chips)
Seat 3: mellneazy ($10.44 in chips)
Seat 4: Ribeye63 ($9.65 in chips)
Seat 5: PlayTheBlues4U ($8.35 in chips)
Seat 6: StarsAccount1 ($3.66 in chips)
ironons: posts small blind $0.05
mellneazy: posts big blind $0.10
*** HOLE CARDS ***
Dealt to PlayTheBlues4U [4s As]
Ribeye63: folds
PlayTheBlues4U: raises $0.20 to $0.30
StarsAccount1: calls $0.30
DaGoodz33: folds
ironons: calls $0.25
mellneazy: calls $0.20
*** FLOP *** [Ts 6h 4h]
ironons: checks
mellneazy: checks
PlayTheBlues4U: checks
StarsAccount1: checks
*** TURN *** [Ts 6h 4h] [5d]
ironons: bets $0.57
mellneazy: calls $0.57
PlayTheBlues4U: folds
StarsAccount1: folds
*** RIVER *** [Ts 6h 4h 5d] [9h]
ironons: bets $0.40
mellneazy: calls $0.40
*** SHOW DOWN ***
ironons: shows [6s 7c] (a pair of Sixes)
mellneazy: shows [8s Td] (a pair of Tens)
mellneazy collected $2.98 from pot
*** SUMMARY ***
Total pot $3.14 | Rake $0.16
Board [Ts 6h 4h 5d 9h]
Seat 1: DaGoodz33 (button) folded before Flop (didn't bet)
Seat 2: ironons (small blind) showed [6s 7c] and lost with a pair of Sixes
Seat 3: mellneazy (big blind) showed [8s Td] and won ($2.98) with a pair of Tens
Seat 4: Ribeye63 folded before Flop (didn't bet)
Seat 5: PlayTheBlues4U folded on the Turn
Seat 6: StarsAccount1 folded on the Turn


*********** # 99 **************
PokerStars Hand #203995379385:  Hold'em No Limit ($0.05/$0.10 USD) - 2019/09/26 22:16:55 ET
Table 'Lynx' 6-max Seat #6 is the button
Seat 1: DaGoodz33 ($15.29 in chips)
Seat 2: ironons ($9.22 in chips)
Seat 3: mellneazy ($10.44 in chips)
Seat 4: Ribeye63 ($9.65 in chips)
Seat 5: PlayTheBlues4U ($8.65 in chips)
Seat 6: StarsAccount1 ($3.66 in chips)
DaGoodz33: posts small blind $0.05
ironons: posts big blind $0.10
*** HOLE CARDS ***
Dealt to PlayTheBlues4U [7h 6h]
mellneazy: folds
Ribeye63: folds
PlayTheBlues4U: raises $0.20 to $0.30
StarsAccount1: folds
DaGoodz33: folds
ironons: calls $0.20
*** FLOP *** [Ts 9d 4s]
ironons: checks
PlayTheBlues4U: checks
*** TURN *** [Ts 9d 4s] [Td]
ironons: bets $0.31
PlayTheBlues4U: folds
Uncalled bet ($0.31) returned to ironons
ironons collected $0.62 from pot
ironons: doesn't show hand
*** SUMMARY ***
Total pot $0.65 | Rake $0.03
Board [Ts 9d 4s Td]
Seat 1: DaGoodz33 (small blind) folded before Flop
Seat 2: ironons (big blind) collected ($0.62)
Seat 3: mellneazy folded before Flop (didn't bet)
Seat 4: Ribeye63 folded before Flop (didn't bet)
Seat 5: PlayTheBlues4U folded on the Turn
Seat 6: StarsAccount1 (button) folded before Flop (didn't bet)


*********** # 100 **************
PokerStars Hand #203995379325:  Hold'em No Limit ($0.05/$0.10 USD) - 2019/09/26 22:16:32 ET
Table 'Delphinus' 6-max Seat #2 is the button
Seat 1: SourShoes9 ($10.69 in chips)
Seat 2: maxplans323 ($8.75 in chips)
Seat 3: joncruise ($8.07 in chips)
Seat 4: 921zhaopeng ($14.64 in chips)
Seat 5: SuWasup ($7.63 in chips)
Seat 6: PlayTheBlues4U ($10.24 in chips)
joncruise: posts small blind $0.05
921zhaopeng: posts big blind $0.10
*** HOLE CARDS ***
Dealt to PlayTheBlues4U [Qc Kc]
SuWasup: folds
PlayTheBlues4U: raises $0.20 to $0.30
SourShoes9: raises $0.85 to $1.15
maxplans323: folds
joncruise: folds
921zhaopeng: folds
PlayTheBlues4U: calls $0.85
*** FLOP *** [Jh 4c 7c]
PlayTheBlues4U: checks
SourShoes9: bets $2.20
PlayTheBlues4U: raises $3.60 to $5.80
SourShoes9: raises $3.74 to $9.54 and is all-in
PlayTheBlues4U: calls $3.29 and is all-in
Uncalled bet ($0.45) returned to SourShoes9
*** TURN *** [Jh 4c 7c] [Js]
*** RIVER *** [Jh 4c 7c Js] [4h]
*** SHOW DOWN ***
PlayTheBlues4U: shows [Qc Kc] (two pair, Jacks and Fours)
SourShoes9: shows [Kd Kh] (two pair, Kings and Jacks)
SourShoes9 collected $19.60 from pot
*** SUMMARY ***
Total pot $20.63 | Rake $1.03
Board [Jh 4c 7c Js 4h]
Seat 1: SourShoes9 showed [Kd Kh] and won ($19.60) with two pair, Kings and Jacks
Seat 2: maxplans323 (button) folded before Flop (didn't bet)
Seat 3: joncruise (small blind) folded before Flop
Seat 4: 921zhaopeng (big blind) folded before Flop
Seat 5: SuWasup folded before Flop (didn't bet)
Seat 6: PlayTheBlues4U showed [Qc Kc] and lost with two pair, Jacks and Fours


*********** # 101 **************
PokerStars Hand #203995379236:  Hold'em No Limit ($0.05/$0.10 USD) - 2019/09/26 22:15:58 ET
Table 'Lynx' 6-max Seat #5 is the button
Seat 1: DaGoodz33 ($15.39 in chips)
Seat 2: ironons ($9.22 in chips)
Seat 3: mellneazy ($8.86 in chips)
Seat 4: Ribeye63 ($9.65 in chips)
Seat 5: PlayTheBlues4U ($10.25 in chips)
Seat 6: StarsAccount1 ($3.71 in chips)
StarsAccount1: posts small blind $0.05
DaGoodz33: posts big blind $0.10
*** HOLE CARDS ***
Dealt to PlayTheBlues4U [8h Ts]
ironons: folds
mellneazy: raises $0.20 to $0.30
Ribeye63: folds
PlayTheBlues4U: calls $0.30
StarsAccount1: folds
DaGoodz33: folds
*** FLOP *** [Qs Qd 2d]
mellneazy: bets $0.40
PlayTheBlues4U: calls $0.40
*** TURN *** [Qs Qd 2d] [Ah]
mellneazy: checks
PlayTheBlues4U: bets $0.90
mellneazy: calls $0.90
*** RIVER *** [Qs Qd 2d Ah] [4s]
mellneazy: checks
PlayTheBlues4U: checks
*** SHOW DOWN ***
mellneazy: shows [Qh Kc] (three of a kind, Queens)
PlayTheBlues4U: mucks hand
mellneazy collected $3.18 from pot
*** SUMMARY ***
Total pot $3.35 | Rake $0.17
Board [Qs Qd 2d Ah 4s]
Seat 1: DaGoodz33 (big blind) folded before Flop
Seat 2: ironons folded before Flop (didn't bet)
Seat 3: mellneazy showed [Qh Kc] and won ($3.18) with three of a kind, Queens
Seat 4: Ribeye63 folded before Flop (didn't bet)
Seat 5: PlayTheBlues4U (button) mucked [8h Ts]
Seat 6: StarsAccount1 (small blind) folded before Flop


*********** # 102 **************
PokerStars Hand #203995379144:  Hold'em No Limit ($0.05/$0.10 USD) - 2019/09/26 22:15:27 ET
Table 'Delphinus' 6-max Seat #1 is the button
Seat 1: SourShoes9 ($10.69 in chips)
Seat 2: maxplans323 ($8.80 in chips)
Seat 3: joncruise ($8.17 in chips)
Seat 4: 921zhaopeng ($13.33 in chips)
Seat 5: SuWasup ($8.93 in chips)
Seat 6: PlayTheBlues4U ($10.24 in chips)
maxplans323: posts small blind $0.05
joncruise: posts big blind $0.10
*** HOLE CARDS ***
Dealt to PlayTheBlues4U [9s 6c]
921zhaopeng: calls $0.10
SuWasup: raises $0.30 to $0.40
PlayTheBlues4U: folds
SourShoes9: folds
maxplans323: folds
joncruise: folds
921zhaopeng: calls $0.30
*** FLOP *** [Kd 7d Jh]
921zhaopeng: bets $0.90
SuWasup: calls $0.90
*** TURN *** [Kd 7d Jh] [2s]
921zhaopeng: bets $1.30
SuWasup: folds
Uncalled bet ($1.30) returned to 921zhaopeng
921zhaopeng collected $2.61 from pot
921zhaopeng: doesn't show hand
*** SUMMARY ***
Total pot $2.75 | Rake $0.14
Board [Kd 7d Jh 2s]
Seat 1: SourShoes9 (button) folded before Flop (didn't bet)
Seat 2: maxplans323 (small blind) folded before Flop
Seat 3: joncruise (big blind) folded before Flop
Seat 4: 921zhaopeng collected ($2.61)
Seat 5: SuWasup folded on the Turn
Seat 6: PlayTheBlues4U folded before Flop (didn't bet)


*********** # 103 **************
PokerStars Hand #203995379107:  Hold'em No Limit ($0.05/$0.10 USD) - 2019/09/26 22:15:13 ET
Table 'Lynx' 6-max Seat #4 is the button
Seat 1: DaGoodz33 ($14.59 in chips)
Seat 2: ironons ($9.32 in chips)
Seat 3: mellneazy ($9.41 in chips)
Seat 4: Ribeye63 ($9.65 in chips)
Seat 5: PlayTheBlues4U ($10.30 in chips)
Seat 6: StarsAccount1 ($3.81 in chips)
PlayTheBlues4U: posts small blind $0.05
StarsAccount1: posts big blind $0.10
*** HOLE CARDS ***
Dealt to PlayTheBlues4U [3d 5d]
DaGoodz33: calls $0.10
ironons: calls $0.10
mellneazy: raises $0.45 to $0.55
Ribeye63: folds
PlayTheBlues4U: folds
StarsAccount1: folds
DaGoodz33: raises $2.10 to $2.65
ironons: folds
mellneazy: folds
Uncalled bet ($2.10) returned to DaGoodz33
DaGoodz33 collected $1.35 from pot
DaGoodz33: doesn't show hand
*** SUMMARY ***
Total pot $1.35 | Rake $0
Seat 1: DaGoodz33 collected ($1.35)
Seat 2: ironons folded before Flop
Seat 3: mellneazy folded before Flop
Seat 4: Ribeye63 (button) folded before Flop (didn't bet)
Seat 5: PlayTheBlues4U (small blind) folded before Flop
Seat 6: StarsAccount1 (big blind) folded before Flop


*********** # 104 **************
PokerStars Hand #203995378997:  Hold'em No Limit ($0.05/$0.10 USD) - 2019/09/26 22:14:40 ET
Table 'Lynx' 6-max Seat #3 is the button
Seat 1: DaGoodz33 ($14.59 in chips)
Seat 2: ironons ($8.91 in chips)
Seat 3: mellneazy ($9.41 in chips)
Seat 4: Ribeye63 ($9.70 in chips)
Seat 5: PlayTheBlues4U ($10.40 in chips)
Seat 6: StarsAccount1 ($4.11 in chips)
Ribeye63: posts small blind $0.05
PlayTheBlues4U: posts big blind $0.10
*** HOLE CARDS ***
Dealt to PlayTheBlues4U [7c Kh]
StarsAccount1: calls $0.10
DaGoodz33: folds
ironons: raises $0.20 to $0.30
mellneazy: folds
Ribeye63: folds
PlayTheBlues4U: folds
StarsAccount1: calls $0.20
*** FLOP *** [3s 8s 8d]
StarsAccount1: checks
ironons: bets $0.36
StarsAccount1: folds
Uncalled bet ($0.36) returned to ironons
ironons collected $0.71 from pot
ironons: doesn't show hand
*** SUMMARY ***
Total pot $0.75 | Rake $0.04
Board [3s 8s 8d]
Seat 1: DaGoodz33 folded before Flop (didn't bet)
Seat 2: ironons collected ($0.71)
Seat 3: mellneazy (button) folded before Flop (didn't bet)
Seat 4: Ribeye63 (small blind) folded before Flop
Seat 5: PlayTheBlues4U (big blind) folded before Flop
Seat 6: StarsAccount1 folded on the Flop


*********** # 105 **************
PokerStars Hand #203995378907:  Hold'em No Limit ($0.05/$0.10 USD) - 2019/09/26 22:14:12 ET
Table 'Lynx' 6-max Seat #2 is the button
Seat 1: DaGoodz33 ($14.89 in chips)
Seat 2: ironons ($8.91 in chips)
Seat 3: mellneazy ($9.46 in chips)
Seat 4: Ribeye63 ($10 in chips)
Seat 5: PlayTheBlues4U ($9.80 in chips)
Seat 6: StarsAccount1 ($4.11 in chips)
mellneazy: posts small blind $0.05
Ribeye63: posts big blind $0.10
*** HOLE CARDS ***
Dealt to PlayTheBlues4U [Qd Kh]
PlayTheBlues4U: raises $0.20 to $0.30
StarsAccount1: folds
DaGoodz33: calls $0.30
ironons: folds
mellneazy: folds
Ribeye63: calls $0.20
*** FLOP *** [8s Ks 4s]
Ribeye63: checks
PlayTheBlues4U: bets $0.60
DaGoodz33: folds
Ribeye63: folds
Uncalled bet ($0.60) returned to PlayTheBlues4U
PlayTheBlues4U collected $0.90 from pot
PlayTheBlues4U: doesn't show hand
*** SUMMARY ***
Total pot $0.95 | Rake $0.05
Board [8s Ks 4s]
Seat 1: DaGoodz33 folded on the Flop
Seat 2: ironons (button) folded before Flop (didn't bet)
Seat 3: mellneazy (small blind) folded before Flop
Seat 4: Ribeye63 (big blind) folded on the Flop
Seat 5: PlayTheBlues4U collected ($0.90)
Seat 6: StarsAccount1 folded before Flop (didn't bet)


*********** # 106 **************
PokerStars Hand #203995378872:  Hold'em No Limit ($0.05/$0.10 USD) - 2019/09/26 22:14:03 ET
Table 'Delphinus' 6-max Seat #6 is the button
Seat 1: SourShoes9 ($9.95 in chips)
Seat 2: maxplans323 ($8.90 in chips)
Seat 3: joncruise ($8.17 in chips)
Seat 4: 921zhaopeng ($13.83 in chips)
Seat 5: SuWasup ($9.13 in chips)
Seat 6: PlayTheBlues4U ($10.24 in chips)
SourShoes9: posts small blind $0.05
maxplans323: posts big blind $0.10
*** HOLE CARDS ***
Dealt to PlayTheBlues4U [5h 2h]
joncruise: folds
921zhaopeng: raises $0.10 to $0.20
SuWasup: calls $0.20
PlayTheBlues4U: folds
SourShoes9: calls $0.15
maxplans323: folds
*** FLOP *** [7d Qs 8c]
SourShoes9: checks
921zhaopeng: checks
SuWasup: checks
*** TURN *** [7d Qs 8c] [Qd]
SourShoes9: bets $0.30
921zhaopeng: calls $0.30
SuWasup: folds
*** RIVER *** [7d Qs 8c Qd] [7s]
SourShoes9: bets $1.10
921zhaopeng: folds
Uncalled bet ($1.10) returned to SourShoes9
SourShoes9 collected $1.24 from pot
SourShoes9: doesn't show hand
*** SUMMARY ***
Total pot $1.30 | Rake $0.06
Board [7d Qs 8c Qd 7s]
Seat 1: SourShoes9 (small blind) collected ($1.24)
Seat 2: maxplans323 (big blind) folded before Flop
Seat 3: joncruise folded before Flop (didn't bet)
Seat 4: 921zhaopeng folded on the River
Seat 5: SuWasup folded on the Turn
Seat 6: PlayTheBlues4U (button) folded before Flop (didn't bet)


*********** # 107 **************
PokerStars Hand #203995378801:  Hold'em No Limit ($0.05/$0.10 USD) - 2019/09/26 22:13:42 ET
Table 'Lynx' 6-max Seat #1 is the button
Seat 1: DaGoodz33 ($14.89 in chips)
Seat 2: ironons ($8.65 in chips)
Seat 3: mellneazy ($9.75 in chips)
Seat 4: LeanLamar2233 ($7.99 in chips)
Seat 5: PlayTheBlues4U ($9.80 in chips)
Seat 6: StarsAccount1 ($4.11 in chips)
ironons: posts small blind $0.05
mellneazy: posts big blind $0.10
*** HOLE CARDS ***
Dealt to PlayTheBlues4U [8h 9d]
LeanLamar2233: folds
PlayTheBlues4U: folds
StarsAccount1: folds
DaGoodz33: folds
ironons: calls $0.05
mellneazy: checks
*** FLOP *** [Jh 4h 6s]
LeanLamar2233 leaves the table
ironons: bets $0.19
mellneazy: calls $0.19
*** TURN *** [Jh 4h 6s] [Qs]
ironons: bets $0.28
Ribeye63 joins the table at seat #4
mellneazy: folds
Uncalled bet ($0.28) returned to ironons
ironons collected $0.55 from pot
ironons: doesn't show hand
*** SUMMARY ***
Total pot $0.58 | Rake $0.03
Board [Jh 4h 6s Qs]
Seat 1: DaGoodz33 (button) folded before Flop (didn't bet)
Seat 2: ironons (small blind) collected ($0.55)
Seat 3: mellneazy (big blind) folded on the Turn
Seat 4: LeanLamar2233 folded before Flop (didn't bet)
Seat 5: PlayTheBlues4U folded before Flop (didn't bet)
Seat 6: StarsAccount1 folded before Flop (didn't bet)


*********** # 108 **************
PokerStars Hand #203995378684:  Hold'em No Limit ($0.05/$0.10 USD) - 2019/09/26 22:13:04 ET
Table 'Lynx' 6-max Seat #6 is the button
Seat 1: DaGoodz33 ($14.94 in chips)
Seat 2: ironons ($7.44 in chips)
Seat 3: mellneazy ($9.75 in chips)
Seat 4: LeanLamar2233 ($8.97 in chips)
Seat 5: PlayTheBlues4U ($9.80 in chips)
Seat 6: StarsAccount1 ($4.41 in chips)
DaGoodz33: posts small blind $0.05
ironons: posts big blind $0.10
*** HOLE CARDS ***
Dealt to PlayTheBlues4U [4s Kh]
mellneazy: folds
LeanLamar2233: raises $0.20 to $0.30
PlayTheBlues4U: folds
StarsAccount1: calls $0.30
DaGoodz33: folds
ironons: calls $0.20
*** FLOP *** [9h 8c 5s]
ironons: checks
LeanLamar2233: bets $0.68
StarsAccount1: folds
ironons: calls $0.68
*** TURN *** [9h 8c 5s] [3h]
ironons: checks
LeanLamar2233: checks
*** RIVER *** [9h 8c 5s 3h] [6d]
ironons: bets $1.10
LeanLamar2233: folds
Uncalled bet ($1.10) returned to ironons
ironons collected $2.19 from pot
ironons: doesn't show hand
*** SUMMARY ***
Total pot $2.31 | Rake $0.12
Board [9h 8c 5s 3h 6d]
Seat 1: DaGoodz33 (small blind) folded before Flop
Seat 2: ironons (big blind) collected ($2.19)
Seat 3: mellneazy folded before Flop (didn't bet)
Seat 4: LeanLamar2233 folded on the River
Seat 5: PlayTheBlues4U folded before Flop (didn't bet)
Seat 6: StarsAccount1 (button) folded on the Flop


*********** # 109 **************
PokerStars Hand #203995378664:  Hold'em No Limit ($0.05/$0.10 USD) - 2019/09/26 22:12:56 ET
Table 'Delphinus' 6-max Seat #5 is the button
Seat 1: SourShoes9 ($10.55 in chips)
Seat 2: maxplans323 ($8.90 in chips)
Seat 3: joncruise ($8.27 in chips)
Seat 4: 921zhaopeng ($13.83 in chips)
Seat 5: SuWasup ($9.13 in chips)
Seat 6: PlayTheBlues4U ($9.60 in chips)
PlayTheBlues4U: posts small blind $0.05
SourShoes9: posts big blind $0.10
*** HOLE CARDS ***
Dealt to PlayTheBlues4U [7h 7d]
maxplans323: folds
joncruise: calls $0.10
921zhaopeng: folds
SuWasup: folds
PlayTheBlues4U: calls $0.05
SourShoes9: checks
*** FLOP *** [Js 3c Jd]
PlayTheBlues4U: checks
SourShoes9: bets $0.20
joncruise: folds
PlayTheBlues4U: calls $0.20
*** TURN *** [Js 3c Jd] [4c]
PlayTheBlues4U: checks
SourShoes9: bets $0.30
PlayTheBlues4U: calls $0.30
*** RIVER *** [Js 3c Jd 4c] [Kh]
PlayTheBlues4U: bets $0.70
SourShoes9: folds
Uncalled bet ($0.70) returned to PlayTheBlues4U
PlayTheBlues4U collected $1.24 from pot
PlayTheBlues4U: doesn't show hand
*** SUMMARY ***
Total pot $1.30 | Rake $0.06
Board [Js 3c Jd 4c Kh]
Seat 1: SourShoes9 (big blind) folded on the River
Seat 2: maxplans323 folded before Flop (didn't bet)
Seat 3: joncruise folded on the Flop
Seat 4: 921zhaopeng folded before Flop (didn't bet)
Seat 5: SuWasup (button) folded before Flop (didn't bet)
Seat 6: PlayTheBlues4U (small blind) collected ($1.24)


*********** # 110 **************
PokerStars Hand #203995378459:  Hold'em No Limit ($0.05/$0.10 USD) - 2019/09/26 22:11:49 ET
Table 'Delphinus' 6-max Seat #4 is the button
Seat 1: SourShoes9 ($10.55 in chips)
Seat 2: maxplans323 ($8.90 in chips)
Seat 3: joncruise ($8.27 in chips)
Seat 4: 921zhaopeng ($15.03 in chips)
Seat 5: SuWasup ($7.95 in chips)
Seat 6: PlayTheBlues4U ($9.70 in chips)
SuWasup: posts small blind $0.05
PlayTheBlues4U: posts big blind $0.10
*** HOLE CARDS ***
Dealt to PlayTheBlues4U [5c 6d]
SourShoes9: folds
maxplans323: folds
joncruise: folds
921zhaopeng: raises $0.20 to $0.30
SourShoes9 said, "knew it"
SuWasup: calls $0.25
SourShoes9 said, "hated thar Q"
PlayTheBlues4U: folds
*** FLOP *** [Ah 4c Td]
SuWasup: checks
921zhaopeng: bets $0.30
joncruise said, "lol tough"
PlayTheBlues4U said, "I had pair too"
SuWasup: calls $0.30
*** TURN *** [Ah 4c Td] [6h]
SuWasup: checks
921zhaopeng: bets $0.60
SuWasup: calls $0.60
*** RIVER *** [Ah 4c Td 6h] [Jd]
SuWasup: checks
921zhaopeng: checks
*** SHOW DOWN ***
SuWasup: shows [Qd Kh] (a straight, Ten to Ace)
921zhaopeng: mucks hand
SuWasup collected $2.38 from pot
*** SUMMARY ***
Total pot $2.50 | Rake $0.12
Board [Ah 4c Td 6h Jd]
Seat 1: SourShoes9 folded before Flop (didn't bet)
Seat 2: maxplans323 folded before Flop (didn't bet)
Seat 3: joncruise folded before Flop (didn't bet)
Seat 4: 921zhaopeng (button) mucked [Kc Ad]
Seat 5: SuWasup (small blind) showed [Qd Kh] and won ($2.38) with a straight, Ten to Ace
Seat 6: PlayTheBlues4U (big blind) folded before Flop


*********** # 111 **************
PokerStars Hand #203995378445:  Hold'em No Limit ($0.05/$0.10 USD) - 2019/09/26 22:11:44 ET
Table 'Lynx' 6-max Seat #5 is the button
Seat 1: DaGoodz33 ($12.97 in chips)
Seat 2: ironons ($7.68 in chips)
Seat 3: mellneazy ($9.75 in chips)
Seat 4: LeanLamar2233 ($8.97 in chips)
Seat 5: PlayTheBlues4U ($9.80 in chips)
Seat 6: StarsAccount1 ($6.35 in chips)
StarsAccount1: posts small blind $0.05
DaGoodz33: posts big blind $0.10
*** HOLE CARDS ***
Dealt to PlayTheBlues4U [Ad 2h]
ironons: calls $0.10
mellneazy: folds
LeanLamar2233: folds
PlayTheBlues4U: folds
StarsAccount1: calls $0.05
DaGoodz33: checks
*** FLOP *** [Jd Ac 6s]
StarsAccount1: checks
DaGoodz33: checks
ironons: checks
*** TURN *** [Jd Ac 6s] [3d]
StarsAccount1: bets $0.14
DaGoodz33: calls $0.14
ironons: calls $0.14
*** RIVER *** [Jd Ac 6s 3d] [Qh]
StarsAccount1: bets $0.34
DaGoodz33: raises $1.36 to $1.70
ironons: folds
StarsAccount1: calls $1.36
*** SHOW DOWN ***
DaGoodz33: shows [Kc Ts] (a straight, Ten to Ace)
StarsAccount1: mucks hand
DaGoodz33 collected $3.91 from pot
*** SUMMARY ***
Total pot $4.12 | Rake $0.21
Board [Jd Ac 6s 3d Qh]
Seat 1: DaGoodz33 (big blind) showed [Kc Ts] and won ($3.91) with a straight, Ten to Ace
Seat 2: ironons folded on the River
Seat 3: mellneazy folded before Flop (didn't bet)
Seat 4: LeanLamar2233 folded before Flop (didn't bet)
Seat 5: PlayTheBlues4U (button) folded before Flop (didn't bet)
Seat 6: StarsAccount1 (small blind) mucked [Jh 6h]


*********** # 112 **************
PokerStars Hand #203995378285:  Hold'em No Limit ($0.05/$0.10 USD) - 2019/09/26 22:10:47 ET
Table 'Delphinus' 6-max Seat #3 is the button
Seat 1: SourShoes9 ($13.21 in chips)
Seat 2: maxplans323 ($6.08 in chips)
Seat 3: joncruise ($8.27 in chips)
Seat 4: 921zhaopeng ($15.08 in chips)
Seat 5: SuWasup ($8.05 in chips)
Seat 6: PlayTheBlues4U ($10 in chips)
921zhaopeng: posts small blind $0.05
SuWasup: posts big blind $0.10
*** HOLE CARDS ***
Dealt to PlayTheBlues4U [Ah 2h]
PlayTheBlues4U: raises $0.20 to $0.30
SourShoes9: raises $0.75 to $1.05
maxplans323: calls $1.05
joncruise: folds
921zhaopeng: folds
SuWasup: folds
PlayTheBlues4U: folds
*** FLOP *** [3s 4c Ac]
SourShoes9: checks
maxplans323: checks
*** TURN *** [3s 4c Ac] [7s]
SourShoes9: checks
maxplans323: checks
*** RIVER *** [3s 4c Ac 7s] [Qd]
SourShoes9: checks
maxplans323: bets $1.61
SourShoes9: calls $1.61
*** SHOW DOWN ***
maxplans323: shows [Qs Qh] (three of a kind, Queens)
SourShoes9: mucks hand
maxplans323 collected $5.48 from pot
*** SUMMARY ***
Total pot $5.77 | Rake $0.29
Board [3s 4c Ac 7s Qd]
Seat 1: SourShoes9 mucked [Kd Ks]
Seat 2: maxplans323 showed [Qs Qh] and won ($5.48) with three of a kind, Queens
Seat 3: joncruise (button) folded before Flop (didn't bet)
Seat 4: 921zhaopeng (small blind) folded before Flop
Seat 5: SuWasup (big blind) folded before Flop
Seat 6: PlayTheBlues4U folded before Flop


*********** # 113 **************
PokerStars Hand #203995378260:  Hold'em No Limit ($0.05/$0.10 USD) - 2019/09/26 22:10:37 ET
Table 'Lynx' 6-max Seat #4 is the button
Seat 1: DaGoodz33 ($12.97 in chips)
Seat 2: ironons ($8.77 in chips)
Seat 3: mellneazy ($9.75 in chips)
Seat 4: LeanLamar2233 ($7.80 in chips)
Seat 5: PlayTheBlues4U ($9.90 in chips)
Seat 6: StarsAccount1 ($6.45 in chips)
PlayTheBlues4U: posts small blind $0.05
StarsAccount1: posts big blind $0.10
*** HOLE CARDS ***
Dealt to PlayTheBlues4U [9d 6d]
DaGoodz33: folds
ironons: calls $0.10
mellneazy: folds
LeanLamar2233: calls $0.10
PlayTheBlues4U: calls $0.05
StarsAccount1: checks
*** FLOP *** [Kc Tc 9s]
PlayTheBlues4U: checks
StarsAccount1: checks
ironons: checks
LeanLamar2233: bets $0.29
PlayTheBlues4U: folds
StarsAccount1: folds
ironons: calls $0.29
*** TURN *** [Kc Tc 9s] [4s]
ironons: checks
LeanLamar2233: bets $0.70
ironons: calls $0.70
*** RIVER *** [Kc Tc 9s 4s] [4d]
ironons: checks
LeanLamar2233: bets $1.13
ironons: folds
Uncalled bet ($1.13) returned to LeanLamar2233
LeanLamar2233 collected $2.26 from pot
*** SUMMARY ***
Total pot $2.38 | Rake $0.12
Board [Kc Tc 9s 4s 4d]
Seat 1: DaGoodz33 folded before Flop (didn't bet)
Seat 2: ironons folded on the River
Seat 3: mellneazy folded before Flop (didn't bet)
Seat 4: LeanLamar2233 (button) collected ($2.26)
Seat 5: PlayTheBlues4U (small blind) folded on the Flop
Seat 6: StarsAccount1 (big blind) folded on the Flop


*********** # 114 **************
PokerStars Hand #203995378206:  Hold'em No Limit ($0.05/$0.10 USD) - 2019/09/26 22:10:15 ET
Table 'Lynx' 6-max Seat #3 is the button
Seat 1: DaGoodz33 ($12.97 in chips)
Seat 2: ironons ($8.77 in chips)
Seat 3: mellneazy ($9.75 in chips)
Seat 4: LeanLamar2233 ($7.85 in chips)
Seat 5: PlayTheBlues4U ($10 in chips)
Seat 6: StarsAccount1 ($6.30 in chips)
LeanLamar2233: posts small blind $0.05
PlayTheBlues4U: posts big blind $0.10
*** HOLE CARDS ***
Dealt to PlayTheBlues4U [9s 6s]
StarsAccount1: raises $0.30 to $0.40
DaGoodz33: folds
ironons: folds
mellneazy: folds
LeanLamar2233: folds
PlayTheBlues4U: folds
Uncalled bet ($0.30) returned to StarsAccount1
StarsAccount1 collected $0.25 from pot
StarsAccount1: doesn't show hand
*** SUMMARY ***
Total pot $0.25 | Rake $0
Seat 1: DaGoodz33 folded before Flop (didn't bet)
Seat 2: ironons folded before Flop (didn't bet)
Seat 3: mellneazy (button) folded before Flop (didn't bet)
Seat 4: LeanLamar2233 (small blind) folded before Flop
Seat 5: PlayTheBlues4U (big blind) folded before Flop
Seat 6: StarsAccount1 collected ($0.25)


*********** # 115 **************
PokerStars Hand #203995378174:  Hold'em No Limit ($0.05/$0.10 USD) - 2019/09/26 22:10:03 ET
Table 'Delphinus' 6-max Seat #2 is the button
Seat 1: SourShoes9 ($13.21 in chips)
Seat 2: maxplans323 ($6.08 in chips)
Seat 3: joncruise ($9.77 in chips)
Seat 4: 921zhaopeng ($13.73 in chips)
Seat 5: SuWasup ($8.05 in chips)
Seat 6: PlayTheBlues4U ($10 in chips)
joncruise: posts small blind $0.05
921zhaopeng: posts big blind $0.10
*** HOLE CARDS ***
Dealt to PlayTheBlues4U [Ks Th]
SuWasup: folds
PlayTheBlues4U: folds
SourShoes9: folds
maxplans323: folds
joncruise: calls $0.05
921zhaopeng: checks
*** FLOP *** [4c 6c Tc]
joncruise: checks
921zhaopeng: bets $0.20
joncruise: calls $0.20
*** TURN *** [4c 6c Tc] [6d]
joncruise: checks
921zhaopeng: checks
*** RIVER *** [4c 6c Tc 6d] [4s]
joncruise: bets $0.60
921zhaopeng: raises $0.60 to $1.20
joncruise: calls $0.60
*** SHOW DOWN ***
921zhaopeng: shows [2h 4d] (a full house, Fours full of Sixes)
joncruise: mucks hand
921zhaopeng collected $2.85 from pot
*** SUMMARY ***
Total pot $3 | Rake $0.15
Board [4c 6c Tc 6d 4s]
Seat 1: SourShoes9 folded before Flop (didn't bet)
Seat 2: maxplans323 (button) folded before Flop (didn't bet)
Seat 3: joncruise (small blind) mucked [5c 5h]
Seat 4: 921zhaopeng (big blind) showed [2h 4d] and won ($2.85) with a full house, Fours full of Sixes
Seat 5: SuWasup folded before Flop (didn't bet)
Seat 6: PlayTheBlues4U folded before Flop (didn't bet)


*********** # 116 **************
PokerStars Hand #203995377992:  Hold'em No Limit ($0.05/$0.10 USD) - 2019/09/26 22:08:57 ET
Table 'Delphinus' 6-max Seat #1 is the button
Seat 1: SourShoes9 ($13.21 in chips)
Seat 2: maxplans323 ($6.13 in chips)
Seat 3: joncruise ($9.87 in chips)
Seat 4: 921zhaopeng ($12.78 in chips)
Seat 5: SuWasup ($8.95 in chips)
Seat 6: PlayTheBlues4U ($7.12 in chips)
maxplans323: posts small blind $0.05
joncruise: posts big blind $0.10
*** HOLE CARDS ***
Dealt to PlayTheBlues4U [Kc 7s]
921zhaopeng: calls $0.10
SuWasup: raises $0.20 to $0.30
PlayTheBlues4U: folds
SourShoes9: folds
921zhaopeng said, "nh"
maxplans323: folds
joncruise: folds
921zhaopeng: calls $0.20
*** FLOP *** [Qh 9h Jh]
921zhaopeng: checks
SourShoes9 said, "thx"
SuWasup: bets $0.30
921zhaopeng: raises $0.30 to $0.60
SuWasup: calls $0.30
*** TURN *** [Qh 9h Jh] [7c]
921zhaopeng: bets $0.90
SuWasup: folds
Uncalled bet ($0.90) returned to 921zhaopeng
921zhaopeng collected $1.85 from pot
921zhaopeng: doesn't show hand
*** SUMMARY ***
Total pot $1.95 | Rake $0.10
Board [Qh 9h Jh 7c]
Seat 1: SourShoes9 (button) folded before Flop (didn't bet)
Seat 2: maxplans323 (small blind) folded before Flop
Seat 3: joncruise (big blind) folded before Flop
Seat 4: 921zhaopeng collected ($1.85)
Seat 5: SuWasup folded on the Turn
Seat 6: PlayTheBlues4U folded before Flop (didn't bet)


*********** # 117 **************
PokerStars Hand #203995377825:  Hold'em No Limit ($0.05/$0.10 USD) - 2019/09/26 22:07:56 ET
Table 'Delphinus' 6-max Seat #6 is the button
Seat 1: SourShoes9 ($11.13 in chips)
Seat 2: maxplans323 ($6.43 in chips)
Seat 3: joncruise ($9.87 in chips)
Seat 4: 921zhaopeng ($12.78 in chips)
Seat 5: SuWasup ($8.95 in chips)
Seat 6: PlayTheBlues4U ($9.12 in chips)
SourShoes9: posts small blind $0.05
maxplans323: posts big blind $0.10
*** HOLE CARDS ***
Dealt to PlayTheBlues4U [Kd 6h]
joncruise: folds
921zhaopeng: folds
SuWasup: folds
PlayTheBlues4U: raises $0.20 to $0.30
SourShoes9: calls $0.25
maxplans323: calls $0.20
*** FLOP *** [3s 4c 8d]
SourShoes9: checks
maxplans323: checks
PlayTheBlues4U: bets $0.50
SourShoes9: calls $0.50
maxplans323: folds
*** TURN *** [3s 4c 8d] [Jh]
SourShoes9: checks
PlayTheBlues4U: checks
*** RIVER *** [3s 4c 8d Jh] [5s]
SourShoes9: checks
PlayTheBlues4U: bets $1.20
SourShoes9: calls $1.20
*** SHOW DOWN ***
PlayTheBlues4U: shows [Kd 6h] (high card King)
SourShoes9: shows [Ad 9d] (high card Ace)
SourShoes9 collected $4.08 from pot
*** SUMMARY ***
Total pot $4.30 | Rake $0.22
Board [3s 4c 8d Jh 5s]
Seat 1: SourShoes9 (small blind) showed [Ad 9d] and won ($4.08) with high card Ace
Seat 2: maxplans323 (big blind) folded on the Flop
Seat 3: joncruise folded before Flop (didn't bet)
Seat 4: 921zhaopeng folded before Flop (didn't bet)
Seat 5: SuWasup folded before Flop (didn't bet)
Seat 6: PlayTheBlues4U (button) showed [Kd 6h] and lost with high card King


*********** # 118 **************
PokerStars Hand #203995377727:  Hold'em No Limit ($0.05/$0.10 USD) - 2019/09/26 22:07:22 ET
Table 'Delphinus' 6-max Seat #5 is the button
Seat 1: SourShoes9 ($11.23 in chips)
Seat 2: maxplans323 ($6.43 in chips)
Seat 3: joncruise ($9.87 in chips)
Seat 4: 921zhaopeng ($12.37 in chips)
Seat 5: SuWasup ($9.25 in chips)
Seat 6: PlayTheBlues4U ($9.17 in chips)
PlayTheBlues4U: posts small blind $0.05
SourShoes9: posts big blind $0.10
*** HOLE CARDS ***
Dealt to PlayTheBlues4U [Js 6h]
maxplans323: folds
joncruise: folds
921zhaopeng: raises $0.20 to $0.30
SuWasup: calls $0.30
PlayTheBlues4U: folds
SourShoes9: folds
*** FLOP *** [2h 7d 4d]
921zhaopeng: bets $0.40
SuWasup: folds
Uncalled bet ($0.40) returned to 921zhaopeng
921zhaopeng collected $0.71 from pot
921zhaopeng: doesn't show hand
*** SUMMARY ***
Total pot $0.75 | Rake $0.04
Board [2h 7d 4d]
Seat 1: SourShoes9 (big blind) folded before Flop
Seat 2: maxplans323 folded before Flop (didn't bet)
Seat 3: joncruise folded before Flop (didn't bet)
Seat 4: 921zhaopeng collected ($0.71)
Seat 5: SuWasup (button) folded on the Flop
Seat 6: PlayTheBlues4U (small blind) folded before Flop


*********** # 119 **************
PokerStars Hand #203995377592:  Hold'em No Limit ($0.05/$0.10 USD) - 2019/09/26 22:06:39 ET
Table 'Delphinus' 6-max Seat #4 is the button
Seat 1: SourShoes9 ($11.23 in chips)
Seat 2: maxplans323 ($5.69 in chips)
Seat 3: joncruise ($10.53 in chips)
Seat 4: 921zhaopeng ($12.37 in chips)
Seat 5: SuWasup ($9.30 in chips)
Seat 6: PlayTheBlues4U ($9.27 in chips)
SuWasup: posts small blind $0.05
PlayTheBlues4U: posts big blind $0.10
*** HOLE CARDS ***
Dealt to PlayTheBlues4U [2s 8s]
SourShoes9: folds
maxplans323: raises $0.20 to $0.30
joncruise: calls $0.30
921zhaopeng: folds
SuWasup: folds
PlayTheBlues4U: folds
*** FLOP *** [6c Qd 2h]
maxplans323: checks
joncruise: checks
*** TURN *** [6c Qd 2h] [8h]
maxplans323: bets $0.36
joncruise: calls $0.36
*** RIVER *** [6c Qd 2h 8h] [Ah]
maxplans323: checks
joncruise: checks
*** SHOW DOWN ***
maxplans323: shows [9d 8d] (a pair of Eights)
joncruise: mucks hand
maxplans323 collected $1.40 from pot
*** SUMMARY ***
Total pot $1.47 | Rake $0.07
Board [6c Qd 2h 8h Ah]
Seat 1: SourShoes9 folded before Flop (didn't bet)
Seat 2: maxplans323 showed [9d 8d] and won ($1.40) with a pair of Eights
Seat 3: joncruise mucked [6d 4d]
Seat 4: 921zhaopeng (button) folded before Flop (didn't bet)
Seat 5: SuWasup (small blind) folded before Flop
Seat 6: PlayTheBlues4U (big blind) folded before Flop


*********** # 120 **************
PokerStars Hand #203995377443:  Hold'em No Limit ($0.05/$0.10 USD) - 2019/09/26 22:05:49 ET
Table 'Delphinus' 6-max Seat #3 is the button
Seat 1: SourShoes9 ($11.73 in chips)
Seat 2: maxplans323 ($5.69 in chips)
Seat 3: joncruise ($10.53 in chips)
Seat 4: 921zhaopeng ($12.42 in chips)
Seat 5: SuWasup ($8.80 in chips)
Seat 6: PlayTheBlues4U ($9.27 in chips)
921zhaopeng: posts small blind $0.05
SuWasup: posts big blind $0.10
*** HOLE CARDS ***
Dealt to PlayTheBlues4U [6s 5h]
PlayTheBlues4U: folds
SourShoes9: raises $0.20 to $0.30
maxplans323: folds
joncruise: folds
921zhaopeng: folds
SuWasup: calls $0.20
*** FLOP *** [Jd 8c Kc]
SuWasup: checks
SourShoes9: checks
*** TURN *** [Jd 8c Kc] [Qh]
SuWasup: bets $0.20
SourShoes9: calls $0.20
*** RIVER *** [Jd 8c Kc Qh] [2c]
SuWasup: bets $0.50
SourShoes9: folds
Uncalled bet ($0.50) returned to SuWasup
SuWasup collected $1 from pot
SuWasup: doesn't show hand
*** SUMMARY ***
Total pot $1.05 | Rake $0.05
Board [Jd 8c Kc Qh 2c]
Seat 1: SourShoes9 folded on the River
Seat 2: maxplans323 folded before Flop (didn't bet)
Seat 3: joncruise (button) folded before Flop (didn't bet)
Seat 4: 921zhaopeng (small blind) folded before Flop
Seat 5: SuWasup (big blind) collected ($1)
Seat 6: PlayTheBlues4U folded before Flop (didn't bet)


*********** # 121 **************
PokerStars Hand #203995377360:  Hold'em No Limit ($0.05/$0.10 USD) - 2019/09/26 22:05:22 ET
Table 'Delphinus' 6-max Seat #2 is the button
Seat 1: SourShoes9 ($11.37 in chips)
Seat 2: maxplans323 ($5.69 in chips)
Seat 3: joncruise ($10.58 in chips)
Seat 4: 921zhaopeng ($12.77 in chips)
Seat 5: SuWasup ($8.80 in chips)
Seat 6: PlayTheBlues4U ($9.27 in chips)
joncruise: posts small blind $0.05
921zhaopeng: posts big blind $0.10
*** HOLE CARDS ***
Dealt to PlayTheBlues4U [Tc Qh]
SuWasup: folds
PlayTheBlues4U: folds
SourShoes9: raises $0.25 to $0.35
maxplans323: folds
joncruise: folds
921zhaopeng: calls $0.25
*** FLOP *** [3s Kc 6d]
921zhaopeng: checks
SourShoes9: bets $0.60
921zhaopeng: folds
Uncalled bet ($0.60) returned to SourShoes9
SourShoes9 collected $0.71 from pot
SourShoes9: doesn't show hand
*** SUMMARY ***
Total pot $0.75 | Rake $0.04
Board [3s Kc 6d]
Seat 1: SourShoes9 collected ($0.71)
Seat 2: maxplans323 (button) folded before Flop (didn't bet)
Seat 3: joncruise (small blind) folded before Flop
Seat 4: 921zhaopeng (big blind) folded on the Flop
Seat 5: SuWasup folded before Flop (didn't bet)
Seat 6: PlayTheBlues4U folded before Flop (didn't bet)


*********** # 122 **************
PokerStars Hand #203995377260:  Hold'em No Limit ($0.05/$0.10 USD) - 2019/09/26 22:04:47 ET
Table 'Delphinus' 6-max Seat #1 is the button
Seat 1: SourShoes9 ($11.77 in chips)
Seat 2: maxplans323 ($5.23 in chips)
Seat 3: joncruise ($10.68 in chips)
Seat 4: 921zhaopeng ($12.77 in chips)
Seat 5: SuWasup ($8.80 in chips)
Seat 6: PlayTheBlues4U ($9.27 in chips)
maxplans323: posts small blind $0.05
joncruise: posts big blind $0.10
*** HOLE CARDS ***
Dealt to PlayTheBlues4U [Ts Jc]
921zhaopeng: folds
SuWasup: folds
PlayTheBlues4U: folds
SourShoes9: calls $0.10
maxplans323: calls $0.05
joncruise: checks
*** FLOP *** [4d 7c 2c]
maxplans323: checks
joncruise: checks
SourShoes9: bets $0.30
maxplans323: calls $0.30
joncruise: folds
*** TURN *** [4d 7c 2c] [Kc]
maxplans323: checks
SourShoes9: checks
*** RIVER *** [4d 7c 2c Kc] [8d]
maxplans323: checks
SourShoes9: checks
*** SHOW DOWN ***
maxplans323: shows [6d 5d] (a straight, Four to Eight)
SourShoes9: mucks hand
maxplans323 collected $0.86 from pot
*** SUMMARY ***
Total pot $0.90 | Rake $0.04
Board [4d 7c 2c Kc 8d]
Seat 1: SourShoes9 (button) mucked [9h 8h]
Seat 2: maxplans323 (small blind) showed [6d 5d] and won ($0.86) with a straight, Four to Eight
Seat 3: joncruise (big blind) folded on the Flop
Seat 4: 921zhaopeng folded before Flop (didn't bet)
Seat 5: SuWasup folded before Flop (didn't bet)
Seat 6: PlayTheBlues4U folded before Flop (didn't bet)


*********** # 123 **************
PokerStars Hand #203995377103:  Hold'em No Limit ($0.05/$0.10 USD) - 2019/09/26 22:04:00 ET
Table 'Delphinus' 6-max Seat #6 is the button
Seat 1: SourShoes9 ($11.82 in chips)
Seat 2: maxplans323 ($5.33 in chips)
Seat 3: joncruise ($10.78 in chips)
Seat 4: 921zhaopeng ($11.81 in chips)
Seat 5: SuWasup ($9.60 in chips)
Seat 6: PlayTheBlues4U ($9.27 in chips)
SourShoes9: posts small blind $0.05
maxplans323: posts big blind $0.10
*** HOLE CARDS ***
Dealt to PlayTheBlues4U [9h 5h]
joncruise: calls $0.10
921zhaopeng: raises $0.20 to $0.30
SuWasup: raises $0.50 to $0.80
PlayTheBlues4U: folds
SourShoes9: folds
maxplans323: folds
joncruise: folds
921zhaopeng: calls $0.50
*** FLOP *** [4c 4h 9s]
921zhaopeng: bets $0.90
SuWasup: folds
Uncalled bet ($0.90) returned to 921zhaopeng
921zhaopeng collected $1.76 from pot
921zhaopeng: doesn't show hand
*** SUMMARY ***
Total pot $1.85 | Rake $0.09
Board [4c 4h 9s]
Seat 1: SourShoes9 (small blind) folded before Flop
Seat 2: maxplans323 (big blind) folded before Flop
Seat 3: joncruise folded before Flop
Seat 4: 921zhaopeng collected ($1.76)
Seat 5: SuWasup folded on the Flop
Seat 6: PlayTheBlues4U (button) folded before Flop (didn't bet)


*********** # 124 **************
PokerStars Hand #203995377037:  Hold'em No Limit ($0.05/$0.10 USD) - 2019/09/26 22:03:43 ET
Table 'Delphinus' 6-max Seat #5 is the button
Seat 1: SourShoes9 ($11.92 in chips)
Seat 2: maxplans323 ($5.33 in chips)
Seat 3: joncruise ($10.78 in chips)
Seat 4: 921zhaopeng ($11.81 in chips)
Seat 5: SuWasup ($9.45 in chips)
Seat 6: PlayTheBlues4U ($9.32 in chips)
PlayTheBlues4U: posts small blind $0.05
SourShoes9: posts big blind $0.10
*** HOLE CARDS ***
Dealt to PlayTheBlues4U [4d Jd]
maxplans323: folds
joncruise: folds
921zhaopeng: folds
SuWasup: raises $0.30 to $0.40
PlayTheBlues4U: folds
SourShoes9: folds
Uncalled bet ($0.30) returned to SuWasup
SuWasup collected $0.25 from pot
SuWasup: doesn't show hand
*** SUMMARY ***
Total pot $0.25 | Rake $0
Seat 1: SourShoes9 (big blind) folded before Flop
Seat 2: maxplans323 folded before Flop (didn't bet)
Seat 3: joncruise folded before Flop (didn't bet)
Seat 4: 921zhaopeng folded before Flop (didn't bet)
Seat 5: SuWasup (button) collected ($0.25)
Seat 6: PlayTheBlues4U (small blind) folded before Flop


*********** # 125 **************
PokerStars Hand #203995376930:  Hold'em No Limit ($0.05/$0.10 USD) - 2019/09/26 22:03:11 ET
Table 'Delphinus' 6-max Seat #4 is the button
Seat 1: SourShoes9 ($12.92 in chips)
Seat 2: maxplans323 ($5.33 in chips)
Seat 3: joncruise ($10.98 in chips)
Seat 4: 921zhaopeng ($10.48 in chips)
Seat 5: SuWasup ($9.50 in chips)
Seat 6: PlayTheBlues4U ($9.52 in chips)
SuWasup: posts small blind $0.05
PlayTheBlues4U: posts big blind $0.10
*** HOLE CARDS ***
Dealt to PlayTheBlues4U [Kh 6c]
SourShoes9: raises $0.10 to $0.20
maxplans323: folds
joncruise: calls $0.20
921zhaopeng: calls $0.20
SuWasup: folds
PlayTheBlues4U: calls $0.10
*** FLOP *** [8h 5s 9s]
PlayTheBlues4U: checks
SourShoes9: checks
joncruise: checks
921zhaopeng: bets $0.80
PlayTheBlues4U: folds
SourShoes9: calls $0.80
joncruise: folds
*** TURN *** [8h 5s 9s] [5h]
SourShoes9: checks
921zhaopeng: bets $2.30
SourShoes9: folds
Uncalled bet ($2.30) returned to 921zhaopeng
921zhaopeng collected $2.33 from pot
921zhaopeng: doesn't show hand
*** SUMMARY ***
Total pot $2.45 | Rake $0.12
Board [8h 5s 9s 5h]
Seat 1: SourShoes9 folded on the Turn
Seat 2: maxplans323 folded before Flop (didn't bet)
Seat 3: joncruise folded on the Flop
Seat 4: 921zhaopeng (button) collected ($2.33)
Seat 5: SuWasup (small blind) folded before Flop
Seat 6: PlayTheBlues4U (big blind) folded on the Flop


*********** # 126 **************
PokerStars Hand #203995376885:  Hold'em No Limit ($0.05/$0.10 USD) - 2019/09/26 22:02:54 ET
Table 'Delphinus' 6-max Seat #3 is the button
Seat 1: SourShoes9 ($12.77 in chips)
Seat 2: maxplans323 ($5.33 in chips)
Seat 3: joncruise ($10.98 in chips)
Seat 4: 921zhaopeng ($10.53 in chips)
Seat 5: SuWasup ($9.60 in chips)
Seat 6: PlayTheBlues4U ($9.52 in chips)
921zhaopeng: posts small blind $0.05
SuWasup: posts big blind $0.10
*** HOLE CARDS ***
Dealt to PlayTheBlues4U [4h 3s]
PlayTheBlues4U: folds
SourShoes9: raises $0.35 to $0.45
maxplans323: folds
joncruise: folds
921zhaopeng: folds
SuWasup: folds
Uncalled bet ($0.35) returned to SourShoes9
SourShoes9 collected $0.25 from pot
SourShoes9: doesn't show hand
*** SUMMARY ***
Total pot $0.25 | Rake $0
Seat 1: SourShoes9 collected ($0.25)
Seat 2: maxplans323 folded before Flop (didn't bet)
Seat 3: joncruise (button) folded before Flop (didn't bet)
Seat 4: 921zhaopeng (small blind) folded before Flop
Seat 5: SuWasup (big blind) folded before Flop
Seat 6: PlayTheBlues4U folded before Flop (didn't bet)


*********** # 127 **************
PokerStars Hand #203995376742:  Hold'em No Limit ($0.05/$0.10 USD) - 2019/09/26 22:02:05 ET
Table 'Delphinus' 6-max Seat #2 is the button
Seat 1: SourShoes9 ($12.77 in chips)
Seat 2: maxplans323 ($5.33 in chips)
Seat 3: joncruise ($11.28 in chips)
Seat 4: 921zhaopeng ($9.61 in chips)
Seat 5: SuWasup ($9.60 in chips)
Seat 6: PlayTheBlues4U ($10.22 in chips)
joncruise: posts small blind $0.05
921zhaopeng: posts big blind $0.10
*** HOLE CARDS ***
Dealt to PlayTheBlues4U [6h 3h]
SuWasup: folds
PlayTheBlues4U: raises $0.20 to $0.30
SourShoes9: folds
maxplans323: folds
joncruise: calls $0.25
921zhaopeng: calls $0.20
*** FLOP *** [4s 5d 9c]
joncruise: checks
921zhaopeng: bets $0.40
PlayTheBlues4U: calls $0.40
joncruise: folds
*** TURN *** [4s 5d 9c] [5s]
921zhaopeng: bets $1
PlayTheBlues4U: folds
Uncalled bet ($1) returned to 921zhaopeng
921zhaopeng collected $1.62 from pot
921zhaopeng: doesn't show hand
*** SUMMARY ***
Total pot $1.70 | Rake $0.08
Board [4s 5d 9c 5s]
Seat 1: SourShoes9 folded before Flop (didn't bet)
Seat 2: maxplans323 (button) folded before Flop (didn't bet)
Seat 3: joncruise (small blind) folded on the Flop
Seat 4: 921zhaopeng (big blind) collected ($1.62)
Seat 5: SuWasup folded before Flop (didn't bet)
Seat 6: PlayTheBlues4U folded on the Turn


*********** # 128 **************
PokerStars Hand #203995376617:  Hold'em No Limit ($0.05/$0.10 USD) - 2019/09/26 22:01:23 ET
Table 'Delphinus' 6-max Seat #1 is the button
Seat 1: SourShoes9 ($13.17 in chips)
Seat 2: maxplans323 ($5.38 in chips)
Seat 3: joncruise ($10.49 in chips)
Seat 4: 921zhaopeng ($10.01 in chips)
Seat 5: SuWasup ($9.60 in chips)
Seat 6: PlayTheBlues4U ($10.22 in chips)
maxplans323: posts small blind $0.05
joncruise: posts big blind $0.10
*** HOLE CARDS ***
Dealt to PlayTheBlues4U [Qd 3c]
921zhaopeng: raises $0.20 to $0.30
SuWasup: folds
PlayTheBlues4U: folds
SourShoes9: calls $0.30
maxplans323: folds
joncruise: calls $0.20
*** FLOP *** [5h 6d Jh]
joncruise: checks
921zhaopeng: checks
SourShoes9: checks
*** TURN *** [5h 6d Jh] [9d]
joncruise: bets $0.10
921zhaopeng: calls $0.10
SourShoes9: calls $0.10
*** RIVER *** [5h 6d Jh 9d] [3h]
joncruise: bets $0.60
921zhaopeng: folds
SourShoes9: folds
Uncalled bet ($0.60) returned to joncruise
joncruise collected $1.19 from pot
joncruise: doesn't show hand
*** SUMMARY ***
Total pot $1.25 | Rake $0.06
Board [5h 6d Jh 9d 3h]
Seat 1: SourShoes9 (button) folded on the River
Seat 2: maxplans323 (small blind) folded before Flop
Seat 3: joncruise (big blind) collected ($1.19)
Seat 4: 921zhaopeng folded on the River
Seat 5: SuWasup folded before Flop (didn't bet)
Seat 6: PlayTheBlues4U folded before Flop (didn't bet)


*********** # 129 **************
PokerStars Hand #203995376534:  Hold'em No Limit ($0.05/$0.10 USD) - 2019/09/26 22:00:50 ET
Table 'Delphinus' 6-max Seat #6 is the button
Seat 1: SourShoes9 ($13.22 in chips)
Seat 2: maxplans323 ($5.48 in chips)
Seat 3: joncruise ($10.59 in chips)
Seat 4: 921zhaopeng ($9.68 in chips)
Seat 5: SuWasup ($9.60 in chips)
Seat 6: PlayTheBlues4U ($10.32 in chips)
SourShoes9: posts small blind $0.05
maxplans323: posts big blind $0.10
*** HOLE CARDS ***
Dealt to PlayTheBlues4U [7h Th]
joncruise: calls $0.10
921zhaopeng: calls $0.10
SuWasup: folds
PlayTheBlues4U: calls $0.10
SourShoes9: folds
maxplans323: checks
*** FLOP *** [Ah As Kd]
maxplans323: checks
joncruise: checks
921zhaopeng: bets $0.20
PlayTheBlues4U: folds
maxplans323: folds
joncruise: folds
Uncalled bet ($0.20) returned to 921zhaopeng
921zhaopeng collected $0.43 from pot
921zhaopeng: doesn't show hand
*** SUMMARY ***
Total pot $0.45 | Rake $0.02
Board [Ah As Kd]
Seat 1: SourShoes9 (small blind) folded before Flop
Seat 2: maxplans323 (big blind) folded on the Flop
Seat 3: joncruise folded on the Flop
Seat 4: 921zhaopeng collected ($0.43)
Seat 5: SuWasup folded before Flop (didn't bet)
Seat 6: PlayTheBlues4U (button) folded on the Flop


*********** # 130 **************
PokerStars Hand #203995376403:  Hold'em No Limit ($0.05/$0.10 USD) - 2019/09/26 22:00:08 ET
Table 'Delphinus' 6-max Seat #5 is the button
Seat 1: SourShoes9 ($12.66 in chips)
Seat 2: maxplans323 ($5.48 in chips)
Seat 3: joncruise ($10.59 in chips)
Seat 4: 921zhaopeng ($9.68 in chips)
Seat 5: SuWasup ($9.90 in chips)
Seat 6: PlayTheBlues4U ($10.62 in chips)
PlayTheBlues4U: posts small blind $0.05
SourShoes9: posts big blind $0.10
*** HOLE CARDS ***
Dealt to PlayTheBlues4U [Ac 3d]
maxplans323: folds
joncruise: folds
921zhaopeng: folds
SuWasup: raises $0.20 to $0.30
PlayTheBlues4U: calls $0.25
SourShoes9: calls $0.20
*** FLOP *** [6d 4s 6s]
PlayTheBlues4U: checks
SourShoes9: bets $0.40
SuWasup: folds
PlayTheBlues4U: folds
Uncalled bet ($0.40) returned to SourShoes9
SourShoes9 collected $0.86 from pot
SourShoes9: doesn't show hand
*** SUMMARY ***
Total pot $0.90 | Rake $0.04
Board [6d 4s 6s]
Seat 1: SourShoes9 (big blind) collected ($0.86)
Seat 2: maxplans323 folded before Flop (didn't bet)
Seat 3: joncruise folded before Flop (didn't bet)
Seat 4: 921zhaopeng folded before Flop (didn't bet)
Seat 5: SuWasup (button) folded on the Flop
Seat 6: PlayTheBlues4U (small blind) folded on the Flop


*********** # 131 **************
PokerStars Hand #203995376378:  Hold'em No Limit ($0.05/$0.10 USD) - 2019/09/26 21:59:56 ET
Table 'Delphinus' 6-max Seat #4 is the button
Seat 1: SourShoes9 ($12.66 in chips)
Seat 2: maxplans323 ($5.33 in chips)
Seat 3: joncruise ($10.59 in chips)
Seat 4: 921zhaopeng ($9.68 in chips)
Seat 5: SuWasup ($9.95 in chips)
Seat 6: PlayTheBlues4U ($10.72 in chips)
SuWasup: posts small blind $0.05
PlayTheBlues4U: posts big blind $0.10
*** HOLE CARDS ***
Dealt to PlayTheBlues4U [4h 2c]
SourShoes9: folds
maxplans323: raises $0.20 to $0.30
joncruise: folds
921zhaopeng: folds
SuWasup: folds
PlayTheBlues4U: folds
Uncalled bet ($0.20) returned to maxplans323
maxplans323 collected $0.25 from pot
maxplans323: doesn't show hand
*** SUMMARY ***
Total pot $0.25 | Rake $0
Seat 1: SourShoes9 folded before Flop (didn't bet)
Seat 2: maxplans323 collected ($0.25)
Seat 3: joncruise folded before Flop (didn't bet)
Seat 4: 921zhaopeng (button) folded before Flop (didn't bet)
Seat 5: SuWasup (small blind) folded before Flop
Seat 6: PlayTheBlues4U (big blind) folded before Flop


*********** # 132 **************
PokerStars Hand #203995376174:  Hold'em No Limit ($0.05/$0.10 USD) - 2019/09/26 21:58:12 ET
Table 'Delphinus' 6-max Seat #3 is the button
Seat 1: SourShoes9 ($11.89 in chips)
Seat 2: maxplans323 ($5.33 in chips)
Seat 3: joncruise ($10.59 in chips)
Seat 4: 921zhaopeng ($9.73 in chips)
Seat 5: SuWasup ($10.75 in chips)
Seat 6: PlayTheBlues4U ($10.72 in chips)
921zhaopeng: posts small blind $0.05
SuWasup: posts big blind $0.10
*** HOLE CARDS ***
Dealt to PlayTheBlues4U [Qh 7d]
PlayTheBlues4U: folds
SourShoes9: calls $0.10
maxplans323: folds
joncruise: folds
921zhaopeng: folds
SuWasup: raises $0.30 to $0.40
SourShoes9: calls $0.30
*** FLOP *** [As Jc Th]
SuWasup: checks
SourShoes9: checks
*** TURN *** [As Jc Th] [8d]
SuWasup: bets $0.40
SourShoes9: calls $0.40
*** RIVER *** [As Jc Th 8d] [6s]
SuWasup: checks
SourShoes9: bets $1.50
SuWasup: folds
Uncalled bet ($1.50) returned to SourShoes9
SourShoes9 collected $1.57 from pot
SourShoes9: doesn't show hand
*** SUMMARY ***
Total pot $1.65 | Rake $0.08
Board [As Jc Th 8d 6s]
Seat 1: SourShoes9 collected ($1.57)
Seat 2: maxplans323 folded before Flop (didn't bet)
Seat 3: joncruise (button) folded before Flop (didn't bet)
Seat 4: 921zhaopeng (small blind) folded before Flop
Seat 5: SuWasup (big blind) folded on the River
Seat 6: PlayTheBlues4U folded before Flop (didn't bet)


*********** # 133 **************
PokerStars Hand #203995376132:  Hold'em No Limit ($0.05/$0.10 USD) - 2019/09/26 21:57:49 ET
Table 'Delphinus' 6-max Seat #2 is the button
Seat 1: SourShoes9 ($11.89 in chips)
Seat 2: maxplans323 ($5.33 in chips)
Seat 3: joncruise ($10.89 in chips)
Seat 4: 921zhaopeng ($9.83 in chips)
Seat 5: SuWasup ($10.75 in chips)
Seat 6: PlayTheBlues4U ($10.36 in chips)
joncruise: posts small blind $0.05
921zhaopeng: posts big blind $0.10
*** HOLE CARDS ***
Dealt to PlayTheBlues4U [Tc Td]
SuWasup: folds
PlayTheBlues4U: raises $0.20 to $0.30
SourShoes9: folds
maxplans323: folds
joncruise: calls $0.25
921zhaopeng: folds
*** FLOP *** [Ts 7d Kd]
joncruise: checks
PlayTheBlues4U: bets $0.50
joncruise: folds
Uncalled bet ($0.50) returned to PlayTheBlues4U
PlayTheBlues4U collected $0.66 from pot
PlayTheBlues4U: doesn't show hand
*** SUMMARY ***
Total pot $0.70 | Rake $0.04
Board [Ts 7d Kd]
Seat 1: SourShoes9 folded before Flop (didn't bet)
Seat 2: maxplans323 (button) folded before Flop (didn't bet)
Seat 3: joncruise (small blind) folded on the Flop
Seat 4: 921zhaopeng (big blind) folded before Flop
Seat 5: SuWasup folded before Flop (didn't bet)
Seat 6: PlayTheBlues4U collected ($0.66)


*********** # 134 **************
PokerStars Hand #203995376061:  Hold'em No Limit ($0.05/$0.10 USD) - 2019/09/26 21:57:22 ET
Table 'Delphinus' 6-max Seat #1 is the button
Seat 1: SourShoes9 ($11.89 in chips)
Seat 2: maxplans323 ($5.63 in chips)
Seat 3: joncruise ($10.99 in chips)
Seat 4: 921zhaopeng ($9.83 in chips)
Seat 5: SuWasup ($10.75 in chips)
Seat 6: PlayTheBlues4U ($10 in chips)
maxplans323: posts small blind $0.05
joncruise: posts big blind $0.10
*** HOLE CARDS ***
Dealt to PlayTheBlues4U [As 7s]
921zhaopeng: folds
SuWasup: folds
PlayTheBlues4U: raises $0.20 to $0.30
SourShoes9: folds
maxplans323: calls $0.25
joncruise: folds
*** FLOP *** [3c 7d 6h]
maxplans323: checks
PlayTheBlues4U: bets $0.40
maxplans323: folds
Uncalled bet ($0.40) returned to PlayTheBlues4U
PlayTheBlues4U collected $0.66 from pot
PlayTheBlues4U: doesn't show hand
*** SUMMARY ***
Total pot $0.70 | Rake $0.04
Board [3c 7d 6h]
Seat 1: SourShoes9 (button) folded before Flop (didn't bet)
Seat 2: maxplans323 (small blind) folded on the Flop
Seat 3: joncruise (big blind) folded before Flop
Seat 4: 921zhaopeng folded before Flop (didn't bet)
Seat 5: SuWasup folded before Flop (didn't bet)
Seat 6: PlayTheBlues4U collected ($0.66)


*********** # 135 **************
PokerStars Hand #203995375876:  Hold'em No Limit ($0.05/$0.10 USD) - 2019/09/26 21:55:48 ET
Table 'Delphinus' 6-max Seat #6 is the button
Seat 1: SourShoes9 ($11.94 in chips)
Seat 2: maxplans323 ($6.63 in chips)
Seat 3: joncruise ($10.99 in chips)
Seat 4: 921zhaopeng ($9.83 in chips)
Seat 5: SuWasup ($9.80 in chips)
Seat 6: PlayTheBlues4U ($8.55 in chips)
SourShoes9: posts small blind $0.05
maxplans323: posts big blind $0.10
*** HOLE CARDS ***
Dealt to PlayTheBlues4U [6c 7s]
joncruise: folds
921zhaopeng: folds
SuWasup: raises $0.20 to $0.30
PlayTheBlues4U: folds
SourShoes9: folds
maxplans323: calls $0.20
*** FLOP *** [As Kc Kh]
maxplans323: checks
SuWasup: bets $0.20
maxplans323: calls $0.20
*** TURN *** [As Kc Kh] [6h]
maxplans323: checks
SuWasup: bets $0.50
maxplans323: calls $0.50
*** RIVER *** [As Kc Kh 6h] [4d]
maxplans323: checks
SuWasup: bets $1.20
maxplans323: folds
Uncalled bet ($1.20) returned to SuWasup
SuWasup collected $1.95 from pot
SuWasup: doesn't show hand
*** SUMMARY ***
Total pot $2.05 | Rake $0.10
Board [As Kc Kh 6h 4d]
Seat 1: SourShoes9 (small blind) folded before Flop
Seat 2: maxplans323 (big blind) folded on the River
Seat 3: joncruise folded before Flop (didn't bet)
Seat 4: 921zhaopeng folded before Flop (didn't bet)
Seat 5: SuWasup collected ($1.95)
Seat 6: PlayTheBlues4U (button) folded before Flop (didn't bet)


*********** # 136 **************
PokerStars Hand #203995375703:  Hold'em No Limit ($0.05/$0.10 USD) - 2019/09/26 21:54:27 ET
Table 'Delphinus' 6-max Seat #5 is the button
Seat 1: SourShoes9 ($11.47 in chips)
Seat 2: maxplans323 ($6.63 in chips)
Seat 3: joncruise ($11.79 in chips)
Seat 4: 921zhaopeng ($9.37 in chips)
Seat 5: SuWasup ($10 in chips)
Seat 6: PlayTheBlues4U ($8.75 in chips)
PlayTheBlues4U: posts small blind $0.05
SourShoes9: posts big blind $0.10
*** HOLE CARDS ***
Dealt to PlayTheBlues4U [9d Jc]
maxplans323: folds
joncruise: raises $0.10 to $0.20
921zhaopeng: calls $0.20
SuWasup: calls $0.20
PlayTheBlues4U: calls $0.15
SourShoes9: calls $0.10
*** FLOP *** [Qh 4d Kc]
PlayTheBlues4U: checks
SourShoes9: bets $0.60
joncruise: calls $0.60
921zhaopeng: calls $0.60
SuWasup: folds
PlayTheBlues4U: folds
*** TURN *** [Qh 4d Kc] [Ts]
SourShoes9: checks
joncruise: checks
921zhaopeng: bets $1.30
SourShoes9: calls $1.30
joncruise: folds
*** RIVER *** [Qh 4d Kc Ts] [3h]
SourShoes9: checks
921zhaopeng: checks
*** SHOW DOWN ***
SourShoes9: shows [Ks 9s] (a pair of Kings)
921zhaopeng: shows [Kh 9h] (a pair of Kings)
SourShoes9 collected $2.57 from pot
921zhaopeng collected $2.56 from pot
*** SUMMARY ***
Total pot $5.40 | Rake $0.27
Board [Qh 4d Kc Ts 3h]
Seat 1: SourShoes9 (big blind) showed [Ks 9s] and won ($2.57) with a pair of Kings
Seat 2: maxplans323 folded before Flop (didn't bet)
Seat 3: joncruise folded on the Turn
Seat 4: 921zhaopeng showed [Kh 9h] and won ($2.56) with a pair of Kings
Seat 5: SuWasup (button) folded on the Flop
Seat 6: PlayTheBlues4U (small blind) folded on the Flop


*********** # 137 **************
PokerStars Hand #203995375628:  Hold'em No Limit ($0.05/$0.10 USD) - 2019/09/26 21:54:01 ET
Table 'Delphinus' 6-max Seat #4 is the button
Seat 1: SourShoes9 ($11.57 in chips)
Seat 2: maxplans323 ($6.38 in chips)
Seat 3: joncruise ($11.79 in chips)
Seat 4: 921zhaopeng ($9.37 in chips)
Seat 5: SuWasup ($10.05 in chips)
Seat 6: PlayTheBlues4U ($8.85 in chips)
SuWasup: posts small blind $0.05
PlayTheBlues4U: posts big blind $0.10
*** HOLE CARDS ***
Dealt to PlayTheBlues4U [2d 4s]
SourShoes9: calls $0.10
maxplans323: raises $0.35 to $0.45
joncruise: folds
921zhaopeng: folds
SuWasup: folds
PlayTheBlues4U: folds
SourShoes9: folds
Uncalled bet ($0.35) returned to maxplans323
maxplans323 collected $0.35 from pot
maxplans323: doesn't show hand
*** SUMMARY ***
Total pot $0.35 | Rake $0
Seat 1: SourShoes9 folded before Flop
Seat 2: maxplans323 collected ($0.35)
Seat 3: joncruise folded before Flop (didn't bet)
Seat 4: 921zhaopeng (button) folded before Flop (didn't bet)
Seat 5: SuWasup (small blind) folded before Flop
Seat 6: PlayTheBlues4U (big blind) folded before Flop


*********** # 138 **************
PokerStars Hand #203995375599:  Hold'em No Limit ($0.05/$0.10 USD) - 2019/09/26 21:53:51 ET
Table 'Delphinus' 6-max Seat #3 is the button
Seat 1: SourShoes9 ($11.57 in chips)
Seat 2: maxplans323 ($6.38 in chips)
Seat 3: joncruise ($11.79 in chips)
Seat 4: 921zhaopeng ($9.42 in chips)
Seat 5: SuWasup ($10 in chips)
Seat 6: PlayTheBlues4U ($8.85 in chips)
921zhaopeng: posts small blind $0.05
SuWasup: posts big blind $0.10
*** HOLE CARDS ***
Dealt to PlayTheBlues4U [6c Kc]
PlayTheBlues4U: folds
SourShoes9: folds
maxplans323: folds
joncruise: folds
921zhaopeng: folds
Uncalled bet ($0.05) returned to SuWasup
SuWasup collected $0.10 from pot
SuWasup: doesn't show hand
*** SUMMARY ***
Total pot $0.10 | Rake $0
Seat 1: SourShoes9 folded before Flop (didn't bet)
Seat 2: maxplans323 folded before Flop (didn't bet)
Seat 3: joncruise (button) folded before Flop (didn't bet)
Seat 4: 921zhaopeng (small blind) folded before Flop
Seat 5: SuWasup (big blind) collected ($0.10)
Seat 6: PlayTheBlues4U folded before Flop (didn't bet)


*********** # 139 **************
PokerStars Hand #203995375441:  Hold'em No Limit ($0.05/$0.10 USD) - 2019/09/26 21:52:59 ET
Table 'Delphinus' 6-max Seat #2 is the button
Seat 1: SourShoes9 ($11.57 in chips)
Seat 2: maxplans323 ($4.91 in chips)
Seat 3: joncruise ($12.09 in chips)
Seat 4: 921zhaopeng ($9.72 in chips)
Seat 5: SuWasup ($10 in chips)
Seat 6: PlayTheBlues4U ($9.85 in chips)
joncruise: posts small blind $0.05
921zhaopeng: posts big blind $0.10
*** HOLE CARDS ***
Dealt to PlayTheBlues4U [Jh Ah]
SuWasup: folds
PlayTheBlues4U: raises $0.20 to $0.30
SourShoes9: folds
maxplans323: calls $0.30
joncruise: calls $0.25
921zhaopeng: calls $0.20
*** FLOP *** [6h 6d 8d]
joncruise: checks
921zhaopeng: checks
PlayTheBlues4U: bets $0.70
maxplans323: calls $0.70
joncruise: folds
921zhaopeng: folds
*** TURN *** [6h 6d 8d] [4d]
PlayTheBlues4U: checks
maxplans323: bets $1.24
PlayTheBlues4U: folds
Uncalled bet ($1.24) returned to maxplans323
maxplans323 collected $2.47 from pot
maxplans323: doesn't show hand
*** SUMMARY ***
Total pot $2.60 | Rake $0.13
Board [6h 6d 8d 4d]
Seat 1: SourShoes9 folded before Flop (didn't bet)
Seat 2: maxplans323 (button) collected ($2.47)
Seat 3: joncruise (small blind) folded on the Flop
Seat 4: 921zhaopeng (big blind) folded on the Flop
Seat 5: SuWasup folded before Flop (didn't bet)
Seat 6: PlayTheBlues4U folded on the Turn


*********** # 140 **************
PokerStars Hand #203995375340:  Hold'em No Limit ($0.05/$0.10 USD) - 2019/09/26 21:52:21 ET
Table 'Delphinus' 6-max Seat #1 is the button
Seat 1: SourShoes9 ($10.48 in chips)
Seat 2: maxplans323 ($4.96 in chips)
Seat 3: joncruise ($12.19 in chips)
Seat 4: 921zhaopeng ($10.77 in chips)
Seat 5: SuWasup ($10 in chips)
Seat 6: PlayTheBlues4U ($9.85 in chips)
maxplans323: posts small blind $0.05
joncruise: posts big blind $0.10
*** HOLE CARDS ***
Dealt to PlayTheBlues4U [8s 4s]
921zhaopeng: raises $0.20 to $0.30
SuWasup: folds
PlayTheBlues4U: folds
SourShoes9: raises $0.75 to $1.05
maxplans323: folds
joncruise: folds
921zhaopeng: calls $0.75
*** FLOP *** [4d 6c Kc]
921zhaopeng: checks
SourShoes9: bets $1.80
921zhaopeng: folds
Uncalled bet ($1.80) returned to SourShoes9
SourShoes9 collected $2.14 from pot
SourShoes9: doesn't show hand
*** SUMMARY ***
Total pot $2.25 | Rake $0.11
Board [4d 6c Kc]
Seat 1: SourShoes9 (button) collected ($2.14)
Seat 2: maxplans323 (small blind) folded before Flop
Seat 3: joncruise (big blind) folded before Flop
Seat 4: 921zhaopeng folded on the Flop
Seat 5: SuWasup folded before Flop (didn't bet)
Seat 6: PlayTheBlues4U folded before Flop (didn't bet)


*********** # 141 **************
PokerStars Hand #203995375283:  Hold'em No Limit ($0.05/$0.10 USD) - 2019/09/26 21:52:03 ET
Table 'Delphinus' 6-max Seat #6 is the button
Seat 1: SourShoes9 ($10.53 in chips)
Seat 2: maxplans323 ($5.06 in chips)
Seat 3: joncruise ($12.05 in chips)
Seat 4: 921zhaopeng ($10.77 in chips)
Seat 5: SuWasup ($10 in chips)
Seat 6: PlayTheBlues4U ($9.85 in chips)
SourShoes9: posts small blind $0.05
maxplans323: posts big blind $0.10
*** HOLE CARDS ***
Dealt to PlayTheBlues4U [Qc 6d]
joncruise: calls $0.10
921zhaopeng: folds
SuWasup: folds
PlayTheBlues4U: folds
SourShoes9: folds
maxplans323: checks
*** FLOP *** [Qd Kh Kc]
maxplans323: checks
joncruise: bets $0.10
maxplans323: folds
Uncalled bet ($0.10) returned to joncruise
joncruise collected $0.24 from pot
joncruise: doesn't show hand
*** SUMMARY ***
Total pot $0.25 | Rake $0.01
Board [Qd Kh Kc]
Seat 1: SourShoes9 (small blind) folded before Flop
Seat 2: maxplans323 (big blind) folded on the Flop
Seat 3: joncruise collected ($0.24)
Seat 4: 921zhaopeng folded before Flop (didn't bet)
Seat 5: SuWasup folded before Flop (didn't bet)
Seat 6: PlayTheBlues4U (button) folded before Flop (didn't bet)


*********** # 142 **************
PokerStars Hand #203995375250:  Hold'em No Limit ($0.05/$0.10 USD) - 2019/09/26 21:51:46 ET
Table 'Delphinus' 6-max Seat #5 is the button
Seat 1: SourShoes9 ($10.63 in chips)
Seat 2: maxplans323 ($5.06 in chips)
Seat 3: joncruise ($12.05 in chips)
Seat 4: 921zhaopeng ($10.77 in chips)
Seat 5: SuWasup ($9.85 in chips)
Seat 6: PlayTheBlues4U ($9.90 in chips)
PlayTheBlues4U: posts small blind $0.05
SourShoes9: posts big blind $0.10
*** HOLE CARDS ***
Dealt to PlayTheBlues4U [Kc 4h]
maxplans323: folds
joncruise: folds
921zhaopeng: folds
SuWasup: raises $0.30 to $0.40
PlayTheBlues4U: folds
SourShoes9: folds
Uncalled bet ($0.30) returned to SuWasup
SuWasup collected $0.25 from pot
SuWasup: doesn't show hand
*** SUMMARY ***
Total pot $0.25 | Rake $0
Seat 1: SourShoes9 (big blind) folded before Flop
Seat 2: maxplans323 folded before Flop (didn't bet)
Seat 3: joncruise folded before Flop (didn't bet)
Seat 4: 921zhaopeng folded before Flop (didn't bet)
Seat 5: SuWasup (button) collected ($0.25)
Seat 6: PlayTheBlues4U (small blind) folded before Flop


*********** # 143 **************
PokerStars Hand #203995375194:  Hold'em No Limit ($0.05/$0.10 USD) - 2019/09/26 21:51:27 ET
Table 'Delphinus' 6-max Seat #4 is the button
Seat 1: SourShoes9 ($10.63 in chips)
Seat 2: maxplans323 ($5.06 in chips)
Seat 3: joncruise ($12.25 in chips)
Seat 4: 921zhaopeng ($10.45 in chips)
Seat 5: SuWasup ($9.90 in chips)
Seat 6: PlayTheBlues4U ($10 in chips)
SuWasup: posts small blind $0.05
PlayTheBlues4U: posts big blind $0.10
*** HOLE CARDS ***
Dealt to PlayTheBlues4U [3h 9c]
SourShoes9: folds
maxplans323: folds
joncruise: calls $0.10
921zhaopeng: raises $0.10 to $0.20
SuWasup: folds
PlayTheBlues4U: folds
joncruise: calls $0.10
*** FLOP *** [3d 7d 3s]
joncruise: checks
921zhaopeng: bets $0.30
joncruise: folds
Uncalled bet ($0.30) returned to 921zhaopeng
921zhaopeng collected $0.52 from pot
921zhaopeng: doesn't show hand
*** SUMMARY ***
Total pot $0.55 | Rake $0.03
Board [3d 7d 3s]
Seat 1: SourShoes9 folded before Flop (didn't bet)
Seat 2: maxplans323 folded before Flop (didn't bet)
Seat 3: joncruise folded on the Flop
Seat 4: 921zhaopeng (button) collected ($0.52)
Seat 5: SuWasup (small blind) folded before Flop
Seat 6: PlayTheBlues4U (big blind) folded before Flop


*********** # 144 **************
PokerStars Hand #203945144425:  Hold'em No Limit ($0.05/$0.10 USD) - 2019/09/24 23:47:01 ET
Table 'Botein' 6-max Seat #6 is the button
Seat 1: trumpcaddy ($11.90 in chips)
Seat 2: KeithTurbo48 ($9.15 in chips)
Seat 3: PlayTheBlues4U ($5.10 in chips)
Seat 4: traderneal ($11.25 in chips)
Seat 5: NBoula ($21.85 in chips)
Seat 6: Aikido85 ($7.97 in chips)
trumpcaddy: posts small blind $0.05
KeithTurbo48: posts big blind $0.10
*** HOLE CARDS ***
Dealt to PlayTheBlues4U [Kc 8d]
PlayTheBlues4U: folds
traderneal: folds
PlayTheBlues4U leaves the table
NBoula: folds
Aikido85: calls $0.10
trumpcaddy: folds
KeithTurbo48: checks
*** FLOP *** [Ts 7d 9c]
KeithTurbo48: checks
Aikido85: checks
*** TURN *** [Ts 7d 9c] [3d]
KeithTurbo48: bets $0.20
Aikido85: folds
Uncalled bet ($0.20) returned to KeithTurbo48
KeithTurbo48 collected $0.24 from pot
KeithTurbo48: doesn't show hand
*** SUMMARY ***
Total pot $0.25 | Rake $0.01
Board [Ts 7d 9c 3d]
Seat 1: trumpcaddy (small blind) folded before Flop
Seat 2: KeithTurbo48 (big blind) collected ($0.24)
Seat 3: PlayTheBlues4U folded before Flop (didn't bet)
Seat 4: traderneal folded before Flop (didn't bet)
Seat 5: NBoula folded before Flop (didn't bet)
Seat 6: Aikido85 (button) folded on the Turn


*********** # 145 **************
PokerStars Hand #203945144328:  Hold'em No Limit ($0.05/$0.10 USD) - 2019/09/24 23:46:27 ET
Table 'Botein' 6-max Seat #5 is the button
Seat 1: trumpcaddy ($12 in chips)
Seat 2: KeithTurbo48 ($9.40 in chips)
Seat 3: PlayTheBlues4U ($5.10 in chips)
Seat 4: traderneal ($11.25 in chips)
Seat 5: NBoula ($21.85 in chips)
Seat 6: Aikido85 ($7.65 in chips)
Aikido85: posts small blind $0.05
trumpcaddy: posts big blind $0.10
*** HOLE CARDS ***
Dealt to PlayTheBlues4U [9s 2c]
KeithTurbo48: raises $0.15 to $0.25
PlayTheBlues4U: folds
traderneal: folds
NBoula: folds
Aikido85: calls $0.20
trumpcaddy: folds
*** FLOP *** [9c 8d 8c]
Aikido85: bets $0.30
KeithTurbo48: folds
Uncalled bet ($0.30) returned to Aikido85
Aikido85 collected $0.57 from pot
Aikido85: doesn't show hand
*** SUMMARY ***
Total pot $0.60 | Rake $0.03
Board [9c 8d 8c]
Seat 1: trumpcaddy (big blind) folded before Flop
Seat 2: KeithTurbo48 folded on the Flop
Seat 3: PlayTheBlues4U folded before Flop (didn't bet)
Seat 4: traderneal folded before Flop (didn't bet)
Seat 5: NBoula (button) folded before Flop (didn't bet)
Seat 6: Aikido85 (small blind) collected ($0.57)


*********** # 146 **************
PokerStars Hand #203945144288:  Hold'em No Limit ($0.05/$0.10 USD) - 2019/09/24 23:46:15 ET
Table 'Botein' 6-max Seat #4 is the button
Seat 1: trumpcaddy ($12 in chips)
Seat 2: KeithTurbo48 ($9.40 in chips)
Seat 3: PlayTheBlues4U ($5.10 in chips)
Seat 4: traderneal ($11.25 in chips)
Seat 5: NBoula ($21.90 in chips)
Seat 6: Aikido85 ($7.60 in chips)
NBoula: posts small blind $0.05
Aikido85: posts big blind $0.10
*** HOLE CARDS ***
Dealt to PlayTheBlues4U [4c 6s]
trumpcaddy: folds
KeithTurbo48: folds
PlayTheBlues4U: folds
traderneal: folds
NBoula: folds
Uncalled bet ($0.05) returned to Aikido85
Aikido85 collected $0.10 from pot
Aikido85: doesn't show hand
*** SUMMARY ***
Total pot $0.10 | Rake $0
Seat 1: trumpcaddy folded before Flop (didn't bet)
Seat 2: KeithTurbo48 folded before Flop (didn't bet)
Seat 3: PlayTheBlues4U folded before Flop (didn't bet)
Seat 4: traderneal (button) folded before Flop (didn't bet)
Seat 5: NBoula (small blind) folded before Flop
Seat 6: Aikido85 (big blind) collected ($0.10)


*********** # 147 **************
PokerStars Hand #203945144157:  Hold'em No Limit ($0.05/$0.10 USD) - 2019/09/24 23:45:21 ET
Table 'Botein' 6-max Seat #3 is the button
Seat 1: trumpcaddy ($12 in chips)
Seat 2: KeithTurbo48 ($9.40 in chips)
Seat 3: PlayTheBlues4U ($5.10 in chips)
Seat 4: traderneal ($11.30 in chips)
Seat 5: NBoula ($22 in chips)
Seat 6: Aikido85 ($7.46 in chips)
traderneal: posts small blind $0.05
NBoula: posts big blind $0.10
*** HOLE CARDS ***
Dealt to PlayTheBlues4U [9h Jc]
Aikido85: calls $0.10
trumpcaddy: folds
KeithTurbo48: folds
PlayTheBlues4U: folds
traderneal: folds
NBoula: checks
*** FLOP *** [Kh 5c 6d]
NBoula: checks
Aikido85: checks
*** TURN *** [Kh 5c 6d] [2d]
NBoula: checks
Aikido85: checks
*** RIVER *** [Kh 5c 6d 2d] [Jd]
NBoula: checks
Aikido85: bets $0.30
NBoula: folds
Uncalled bet ($0.30) returned to Aikido85
Aikido85 collected $0.24 from pot
Aikido85: doesn't show hand
*** SUMMARY ***
Total pot $0.25 | Rake $0.01
Board [Kh 5c 6d 2d Jd]
Seat 1: trumpcaddy folded before Flop (didn't bet)
Seat 2: KeithTurbo48 folded before Flop (didn't bet)
Seat 3: PlayTheBlues4U (button) folded before Flop (didn't bet)
Seat 4: traderneal (small blind) folded before Flop
Seat 5: NBoula (big blind) folded on the River
Seat 6: Aikido85 collected ($0.24)


*********** # 148 **************
PokerStars Hand #203945144064:  Hold'em No Limit ($0.05/$0.10 USD) - 2019/09/24 23:44:42 ET
Table 'Botein' 6-max Seat #2 is the button
Seat 1: trumpcaddy ($12 in chips)
Seat 2: KeithTurbo48 ($10.35 in chips)
Seat 3: PlayTheBlues4U ($5.35 in chips)
Seat 4: traderneal ($10.21 in chips)
Seat 5: NBoula ($22 in chips)
Seat 6: Aikido85 ($7.46 in chips)
PlayTheBlues4U: posts small blind $0.05
traderneal: posts big blind $0.10
*** HOLE CARDS ***
Dealt to PlayTheBlues4U [7c 6c]
NBoula: folds
Aikido85: folds
trumpcaddy: folds
KeithTurbo48: raises $0.15 to $0.25
PlayTheBlues4U: calls $0.20
traderneal: calls $0.15
*** FLOP *** [Qs 3h 9d]
PlayTheBlues4U: checks
traderneal: checks
KeithTurbo48: checks
*** TURN *** [Qs 3h 9d] [Ac]
PlayTheBlues4U: checks
traderneal: checks
Aikido85 said, "who?"
KeithTurbo48: checks
*** RIVER *** [Qs 3h 9d Ac] [4d]
PlayTheBlues4U: checks
traderneal: bets $0.70
KeithTurbo48: calls $0.70
PlayTheBlues4U: folds
*** SHOW DOWN ***
traderneal: shows [4h 3d] (two pair, Fours and Threes)
KeithTurbo48: mucks hand
traderneal collected $2.04 from pot
*** SUMMARY ***
Total pot $2.15 | Rake $0.11
Board [Qs 3h 9d Ac 4d]
Seat 1: trumpcaddy folded before Flop (didn't bet)
Seat 2: KeithTurbo48 (button) mucked [9s 8h]
Seat 3: PlayTheBlues4U (small blind) folded on the River
Seat 4: traderneal (big blind) showed [4h 3d] and won ($2.04) with two pair, Fours and Threes
Seat 5: NBoula folded before Flop (didn't bet)
Seat 6: Aikido85 folded before Flop (didn't bet)


*********** # 149 **************
PokerStars Hand #203945143936:  Hold'em No Limit ($0.05/$0.10 USD) - 2019/09/24 23:43:51 ET
Table 'Botein' 6-max Seat #1 is the button
Seat 1: trumpcaddy ($12.50 in chips)
Seat 2: KeithTurbo48 ($10.45 in chips)
Seat 3: PlayTheBlues4U ($4.33 in chips)
Seat 4: traderneal ($10.71 in chips)
Seat 5: NBoula ($22 in chips)
Seat 6: Aikido85 ($7.46 in chips)
KeithTurbo48: posts small blind $0.05
PlayTheBlues4U: posts big blind $0.10
*** HOLE CARDS ***
Dealt to PlayTheBlues4U [Ts Th]
traderneal: calls $0.10
NBoula: folds
Aikido85: folds
trumpcaddy: calls $0.10
KeithTurbo48: calls $0.05
PlayTheBlues4U: raises $0.40 to $0.50
traderneal: calls $0.40
trumpcaddy: calls $0.40
KeithTurbo48: folds
*** FLOP *** [Qd 7h 7s]
PlayTheBlues4U: bets $0.90
traderneal: folds
trumpcaddy: folds
Uncalled bet ($0.90) returned to PlayTheBlues4U
PlayTheBlues4U collected $1.52 from pot
PlayTheBlues4U: doesn't show hand
*** SUMMARY ***
Total pot $1.60 | Rake $0.08
Board [Qd 7h 7s]
Seat 1: trumpcaddy (button) folded on the Flop
Seat 2: KeithTurbo48 (small blind) folded before Flop
Seat 3: PlayTheBlues4U (big blind) collected ($1.52)
Seat 4: traderneal folded on the Flop
Seat 5: NBoula folded before Flop (didn't bet)
Seat 6: Aikido85 folded before Flop (didn't bet)


*********** # 150 **************
PokerStars Hand #203945143830:  Hold'em No Limit ($0.05/$0.10 USD) - 2019/09/24 23:43:10 ET
Table 'Botein' 6-max Seat #6 is the button
Seat 1: trumpcaddy ($12.55 in chips)
Seat 2: KeithTurbo48 ($10.55 in chips)
Seat 3: PlayTheBlues4U ($4.33 in chips)
Seat 4: traderneal ($10.71 in chips)
Seat 5: NBoula ($22 in chips)
Seat 6: Aikido85 ($7.32 in chips)
trumpcaddy: posts small blind $0.05
KeithTurbo48: posts big blind $0.10
*** HOLE CARDS ***
Dealt to PlayTheBlues4U [Td 2s]
PlayTheBlues4U: folds
traderneal: folds
NBoula: folds
PlayTheBlues4U said, "can't. beat this guy lol"
Aikido85: calls $0.10
trumpcaddy: folds
KeithTurbo48: checks
*** FLOP *** [6c 6h As]
KeithTurbo48: checks
Aikido85: bets $0.30
KeithTurbo48: folds
Uncalled bet ($0.30) returned to Aikido85
Aikido85 collected $0.24 from pot
Aikido85: doesn't show hand
*** SUMMARY ***
Total pot $0.25 | Rake $0.01
Board [6c 6h As]
Seat 1: trumpcaddy (small blind) folded before Flop
Seat 2: KeithTurbo48 (big blind) folded on the Flop
Seat 3: PlayTheBlues4U folded before Flop (didn't bet)
Seat 4: traderneal folded before Flop (didn't bet)
Seat 5: NBoula folded before Flop (didn't bet)
Seat 6: Aikido85 (button) collected ($0.24)


*********** # 151 **************
PokerStars Hand #203945143676:  Hold'em No Limit ($0.05/$0.10 USD) - 2019/09/24 23:42:14 ET
Table 'Botein' 6-max Seat #5 is the button
Seat 1: trumpcaddy ($12.65 in chips)
Seat 2: KeithTurbo48 ($10.55 in chips)
Seat 3: PlayTheBlues4U ($7.68 in chips)
Seat 4: traderneal ($10.71 in chips)
Seat 5: NBoula ($22.90 in chips)
Seat 6: Aikido85 ($3.35 in chips)
Aikido85: posts small blind $0.05
trumpcaddy: posts big blind $0.10
*** HOLE CARDS ***
Dealt to PlayTheBlues4U [Ac Jd]
KeithTurbo48: folds
PlayTheBlues4U: raises $0.20 to $0.30
traderneal: folds
NBoula: calls $0.30
Aikido85: calls $0.25
trumpcaddy: folds
*** FLOP *** [4s As Qh]
Aikido85: checks
PlayTheBlues4U: bets $0.60
NBoula: calls $0.60
Aikido85: calls $0.60
*** TURN *** [4s As Qh] [5d]
Aikido85: bets $0.50
PlayTheBlues4U: raises $1.80 to $2.30
NBoula: folds
Aikido85: raises $0.15 to $2.45 and is all-in
PlayTheBlues4U: calls $0.15
*** RIVER *** [4s As Qh 5d] [8c]
*** SHOW DOWN ***
Aikido85: shows [Qd Ad] (two pair, Aces and Queens)
PlayTheBlues4U: shows [Ac Jd] (a pair of Aces)
Aikido85 collected $7.32 from pot
*** SUMMARY ***
Total pot $7.70 | Rake $0.38
Board [4s As Qh 5d 8c]
Seat 1: trumpcaddy (big blind) folded before Flop
Seat 2: KeithTurbo48 folded before Flop (didn't bet)
Seat 3: PlayTheBlues4U showed [Ac Jd] and lost with a pair of Aces
Seat 4: traderneal folded before Flop (didn't bet)
Seat 5: NBoula (button) folded on the Turn
Seat 6: Aikido85 (small blind) showed [Qd Ad] and won ($7.32) with two pair, Aces and Queens


*********** # 152 **************
PokerStars Hand #203945143563:  Hold'em No Limit ($0.05/$0.10 USD) - 2019/09/24 23:41:29 ET
Table 'Botein' 6-max Seat #4 is the button
Seat 1: trumpcaddy ($12.65 in chips)
Seat 2: KeithTurbo48 ($10.55 in chips)
Seat 3: PlayTheBlues4U ($7.68 in chips)
Seat 4: traderneal ($10.71 in chips)
Seat 5: NBoula ($23.10 in chips)
Seat 6: Aikido85 ($3.17 in chips)
NBoula: posts small blind $0.05
Aikido85: posts big blind $0.10
*** HOLE CARDS ***
Dealt to PlayTheBlues4U [2c Kd]
trumpcaddy: folds
KeithTurbo48: folds
PlayTheBlues4U: folds
traderneal: folds
NBoula: raises $0.10 to $0.20
Aikido85: calls $0.10
*** FLOP *** [Kh 3s Qs]
NBoula: checks
Aikido85: bets $0.30
NBoula: folds
Uncalled bet ($0.30) returned to Aikido85
Aikido85 collected $0.38 from pot
Aikido85: doesn't show hand
*** SUMMARY ***
Total pot $0.40 | Rake $0.02
Board [Kh 3s Qs]
Seat 1: trumpcaddy folded before Flop (didn't bet)
Seat 2: KeithTurbo48 folded before Flop (didn't bet)
Seat 3: PlayTheBlues4U folded before Flop (didn't bet)
Seat 4: traderneal (button) folded before Flop (didn't bet)
Seat 5: NBoula (small blind) folded on the Flop
Seat 6: Aikido85 (big blind) collected ($0.38)


*********** # 153 **************
PokerStars Hand #203945143464:  Hold'em No Limit ($0.05/$0.10 USD) - 2019/09/24 23:40:52 ET
Table 'Botein' 6-max Seat #3 is the button
Seat 1: trumpcaddy ($12.65 in chips)
Seat 2: KeithTurbo48 ($10.55 in chips)
Seat 3: PlayTheBlues4U ($7.68 in chips)
Seat 4: traderneal ($10.81 in chips)
Seat 5: NBoula ($23.20 in chips)
Seat 6: Aikido85 ($2.99 in chips)
traderneal: posts small blind $0.05
NBoula: posts big blind $0.10
*** HOLE CARDS ***
Dealt to PlayTheBlues4U [Jh 6d]
Aikido85: calls $0.10
trumpcaddy: folds
KeithTurbo48: folds
PlayTheBlues4U: folds
traderneal: calls $0.05
NBoula: checks
*** FLOP *** [2h Qc 5s]
traderneal: checks
NBoula: checks
Aikido85: checks
*** TURN *** [2h Qc 5s] [Qd]
traderneal: checks
NBoula: checks
Aikido85: bets $0.30
traderneal: folds
NBoula: folds
Uncalled bet ($0.30) returned to Aikido85
Aikido85 collected $0.28 from pot
Aikido85: doesn't show hand
*** SUMMARY ***
Total pot $0.30 | Rake $0.02
Board [2h Qc 5s Qd]
Seat 1: trumpcaddy folded before Flop (didn't bet)
Seat 2: KeithTurbo48 folded before Flop (didn't bet)
Seat 3: PlayTheBlues4U (button) folded before Flop (didn't bet)
Seat 4: traderneal (small blind) folded on the Turn
Seat 5: NBoula (big blind) folded on the Turn
Seat 6: Aikido85 collected ($0.28)


*********** # 154 **************
PokerStars Hand #203945143343:  Hold'em No Limit ($0.05/$0.10 USD) - 2019/09/24 23:40:04 ET
Table 'Camilla' 6-max Seat #5 is the button
Seat 2: yuni80 ($12.63 in chips)
Seat 4: SeaofLove ($19.42 in chips)
Seat 5: PlayTheBlues4U ($16.79 in chips)
yuni80: posts small blind $0.05
SeaofLove: posts big blind $0.10
*** HOLE CARDS ***
Dealt to PlayTheBlues4U [Kc 4c]
PlayTheBlues4U: folds
yuni80: calls $0.05
SeaofLove: checks
*** FLOP *** [3s Ah Qs]
yuni80: checks
SeaofLove: checks
*** TURN *** [3s Ah Qs] [6d]
yuni80: checks
SeaofLove: checks
*** RIVER *** [3s Ah Qs 6d] [5s]
yuni80: bets $2.10
SeaofLove: folds
Uncalled bet ($2.10) returned to yuni80
yuni80 collected $0.19 from pot
yuni80: doesn't show hand
*** SUMMARY ***
Total pot $0.20 | Rake $0.01
Board [3s Ah Qs 6d 5s]
Seat 2: yuni80 (small blind) collected ($0.19)
Seat 4: SeaofLove (big blind) folded on the River
Seat 5: PlayTheBlues4U (button) folded before Flop (didn't bet)


*********** # 155 **************
PokerStars Hand #203945143339:  Hold'em No Limit ($0.05/$0.10 USD) - 2019/09/24 23:40:02 ET
Table 'Botein' 6-max Seat #2 is the button
Seat 1: trumpcaddy ($13.85 in chips)
Seat 2: KeithTurbo48 ($10.55 in chips)
Seat 3: PlayTheBlues4U ($7.73 in chips)
Seat 4: traderneal ($9.40 in chips)
Seat 5: NBoula ($23.20 in chips)
Seat 6: Aikido85 ($3.29 in chips)
PlayTheBlues4U: posts small blind $0.05
traderneal: posts big blind $0.10
*** HOLE CARDS ***
Dealt to PlayTheBlues4U [Qs 8h]
NBoula: folds
Aikido85: calls $0.10
trumpcaddy: calls $0.10
KeithTurbo48: folds
PlayTheBlues4U: folds
traderneal: raises $0.20 to $0.30
Aikido85: calls $0.20
trumpcaddy: calls $0.20
*** FLOP *** [2s Ks 7c]
traderneal: bets $0.90
Aikido85: folds
trumpcaddy: calls $0.90
*** TURN *** [2s Ks 7c] [Jc]
traderneal: bets $1.30
trumpcaddy: folds
Uncalled bet ($1.30) returned to traderneal
traderneal collected $2.61 from pot
traderneal: doesn't show hand
*** SUMMARY ***
Total pot $2.75 | Rake $0.14
Board [2s Ks 7c Jc]
Seat 1: trumpcaddy folded on the Turn
Seat 2: KeithTurbo48 (button) folded before Flop (didn't bet)
Seat 3: PlayTheBlues4U (small blind) folded before Flop
Seat 4: traderneal (big blind) collected ($2.61)
Seat 5: NBoula folded before Flop (didn't bet)
Seat 6: Aikido85 folded on the Flop


*********** # 156 **************
PokerStars Hand #203945143287:  Hold'em No Limit ($0.05/$0.10 USD) - 2019/09/24 23:39:43 ET
Table 'Botein' 6-max Seat #1 is the button
Seat 1: trumpcaddy ($13.85 in chips)
Seat 2: KeithTurbo48 ($10.60 in chips)
Seat 3: PlayTheBlues4U ($7.83 in chips)
Seat 4: traderneal ($9.40 in chips)
Seat 5: NBoula ($23.05 in chips)
Seat 6: Aikido85 ($3.29 in chips)
KeithTurbo48: posts small blind $0.05
PlayTheBlues4U: posts big blind $0.10
*** HOLE CARDS ***
Dealt to PlayTheBlues4U [9s Jh]
traderneal: folds
NBoula: raises $0.20 to $0.30
Aikido85: folds
trumpcaddy: folds
KeithTurbo48: folds
PlayTheBlues4U: folds
Uncalled bet ($0.20) returned to NBoula
NBoula collected $0.25 from pot
NBoula: doesn't show hand
*** SUMMARY ***
Total pot $0.25 | Rake $0
Seat 1: trumpcaddy (button) folded before Flop (didn't bet)
Seat 2: KeithTurbo48 (small blind) folded before Flop
Seat 3: PlayTheBlues4U (big blind) folded before Flop
Seat 4: traderneal folded before Flop (didn't bet)
Seat 5: NBoula collected ($0.25)
Seat 6: Aikido85 folded before Flop (didn't bet)


*********** # 157 **************
PokerStars Hand #203945143285:  Hold'em No Limit ($0.05/$0.10 USD) - 2019/09/24 23:39:43 ET
Table 'Camilla' 6-max Seat #4 is the button
Seat 2: yuni80 ($12.54 in chips)
Seat 4: SeaofLove ($19.42 in chips)
Seat 5: PlayTheBlues4U ($16.89 in chips)
PlayTheBlues4U: posts small blind $0.05
yuni80: posts big blind $0.10
*** HOLE CARDS ***
Dealt to PlayTheBlues4U [8d 9d]
SeaofLove: folds
PlayTheBlues4U: calls $0.05
yuni80: checks
*** FLOP *** [6h Kh 5c]
PlayTheBlues4U: checks
yuni80: checks
*** TURN *** [6h Kh 5c] [2s]
PlayTheBlues4U: checks
yuni80: checks
*** RIVER *** [6h Kh 5c 2s] [3d]
PlayTheBlues4U: checks
yuni80: bets $0.10
PlayTheBlues4U: folds
Uncalled bet ($0.10) returned to yuni80
yuni80 collected $0.19 from pot
yuni80: doesn't show hand
*** SUMMARY ***
Total pot $0.20 | Rake $0.01
Board [6h Kh 5c 2s 3d]
Seat 2: yuni80 (big blind) collected ($0.19)
Seat 4: SeaofLove (button) folded before Flop (didn't bet)
Seat 5: PlayTheBlues4U (small blind) folded on the River


*********** # 158 **************
PokerStars Hand #203945143229:  Hold'em No Limit ($0.05/$0.10 USD) - 2019/09/24 23:39:22 ET
Table 'Camilla' 6-max Seat #2 is the button
Seat 2: yuni80 ($12.64 in chips)
Seat 4: SeaofLove ($19.47 in chips)
Seat 5: PlayTheBlues4U ($16.75 in chips)
SeaofLove: posts small blind $0.05
PlayTheBlues4U: posts big blind $0.10
*** HOLE CARDS ***
Dealt to PlayTheBlues4U [6c Js]
yuni80: calls $0.10
SeaofLove: folds
PlayTheBlues4U: checks
*** FLOP *** [Th Jh 3s]
PlayTheBlues4U: checks
yuni80: checks
*** TURN *** [Th Jh 3s] [4s]
PlayTheBlues4U: bets $0.20
yuni80: folds
Uncalled bet ($0.20) returned to PlayTheBlues4U
PlayTheBlues4U collected $0.24 from pot
PlayTheBlues4U: doesn't show hand
*** SUMMARY ***
Total pot $0.25 | Rake $0.01
Board [Th Jh 3s 4s]
Seat 2: yuni80 (button) folded on the Turn
Seat 4: SeaofLove (small blind) folded before Flop
Seat 5: PlayTheBlues4U (big blind) collected ($0.24)


*********** # 159 **************
PokerStars Hand #203945143184:  Hold'em No Limit ($0.05/$0.10 USD) - 2019/09/24 23:39:00 ET
Table 'Camilla' 6-max Seat #5 is the button
Seat 2: yuni80 ($12.94 in chips)
Seat 4: SeaofLove ($19.57 in chips)
Seat 5: PlayTheBlues4U ($16.39 in chips)
yuni80: posts small blind $0.05
SeaofLove: posts big blind $0.10
*** HOLE CARDS ***
Dealt to PlayTheBlues4U [Ah Kd]
PlayTheBlues4U: raises $0.20 to $0.30
yuni80: calls $0.25
SeaofLove: folds
*** FLOP *** [3s Js 3d]
yuni80: checks
PlayTheBlues4U: checks
*** TURN *** [3s Js 3d] [Jc]
yuni80: checks
PlayTheBlues4U: checks
*** RIVER *** [3s Js 3d Jc] [8d]
yuni80: checks
PlayTheBlues4U: checks
*** SHOW DOWN ***
yuni80: shows [Th 5h] (two pair, Jacks and Threes)
PlayTheBlues4U: shows [Ah Kd] (two pair, Jacks and Threes - Ace kicker)
PlayTheBlues4U collected $0.66 from pot
*** SUMMARY ***
Total pot $0.70 | Rake $0.04
Board [3s Js 3d Jc 8d]
Seat 2: yuni80 (small blind) showed [Th 5h] and lost with two pair, Jacks and Threes
Seat 4: SeaofLove (big blind) folded before Flop
Seat 5: PlayTheBlues4U (button) showed [Ah Kd] and won ($0.66) with two pair, Jacks and Threes


*********** # 160 **************
PokerStars Hand #203945143179:  Hold'em No Limit ($0.05/$0.10 USD) - 2019/09/24 23:38:58 ET
Table 'Botein' 6-max Seat #6 is the button
Seat 1: trumpcaddy ($13.90 in chips)
Seat 2: KeithTurbo48 ($10.70 in chips)
Seat 3: PlayTheBlues4U ($7.83 in chips)
Seat 4: traderneal ($9.40 in chips)
Seat 5: NBoula ($23.05 in chips)
Seat 6: Aikido85 ($3.15 in chips)
trumpcaddy: posts small blind $0.05
KeithTurbo48: posts big blind $0.10
*** HOLE CARDS ***
Dealt to PlayTheBlues4U [8c 5s]
PlayTheBlues4U: folds
traderneal: folds
NBoula: folds
Aikido85: calls $0.10
trumpcaddy: folds
KeithTurbo48: checks
*** FLOP *** [8d 5h Ts]
KeithTurbo48: checks
Aikido85: checks
*** TURN *** [8d 5h Ts] [As]
KeithTurbo48: checks
Aikido85: bets $0.10
KeithTurbo48: folds
Uncalled bet ($0.10) returned to Aikido85
Aikido85 collected $0.24 from pot
Aikido85: doesn't show hand
*** SUMMARY ***
Total pot $0.25 | Rake $0.01
Board [8d 5h Ts As]
Seat 1: trumpcaddy (small blind) folded before Flop
Seat 2: KeithTurbo48 (big blind) folded on the Turn
Seat 3: PlayTheBlues4U folded before Flop (didn't bet)
Seat 4: traderneal folded before Flop (didn't bet)
Seat 5: NBoula folded before Flop (didn't bet)
Seat 6: Aikido85 (button) collected ($0.24)


*********** # 161 **************
PokerStars Hand #203945143147:  Hold'em No Limit ($0.05/$0.10 USD) - 2019/09/24 23:38:49 ET
Table 'Camilla' 6-max Seat #4 is the button
Seat 2: yuni80 ($12.89 in chips)
Seat 4: SeaofLove ($19.57 in chips)
Seat 5: PlayTheBlues4U ($16.44 in chips)
PlayTheBlues4U: posts small blind $0.05
yuni80: posts big blind $0.10
*** HOLE CARDS ***
Dealt to PlayTheBlues4U [4d 8s]
SeaofLove: folds
PlayTheBlues4U: folds
Uncalled bet ($0.05) returned to yuni80
yuni80 collected $0.10 from pot
yuni80: doesn't show hand
*** SUMMARY ***
Total pot $0.10 | Rake $0
Seat 2: yuni80 (big blind) collected ($0.10)
Seat 4: SeaofLove (button) folded before Flop (didn't bet)
Seat 5: PlayTheBlues4U (small blind) folded before Flop


*********** # 162 **************
PokerStars Hand #203945143093:  Hold'em No Limit ($0.05/$0.10 USD) - 2019/09/24 23:38:30 ET
Table 'Camilla' 6-max Seat #2 is the button
Seat 2: yuni80 ($12.99 in chips)
Seat 4: SeaofLove ($19.62 in chips)
Seat 5: PlayTheBlues4U ($16.30 in chips)
SeaofLove: posts small blind $0.05
PlayTheBlues4U: posts big blind $0.10
*** HOLE CARDS ***
Dealt to PlayTheBlues4U [Kc 8h]
yuni80: calls $0.10
SeaofLove: folds
PlayTheBlues4U: checks
*** FLOP *** [5c Kd 7h]
PlayTheBlues4U: bets $0.10
yuni80: folds
Uncalled bet ($0.10) returned to PlayTheBlues4U
PlayTheBlues4U collected $0.24 from pot
PlayTheBlues4U: doesn't show hand
*** SUMMARY ***
Total pot $0.25 | Rake $0.01
Board [5c Kd 7h]
Seat 2: yuni80 (button) folded on the Flop
Seat 4: SeaofLove (small blind) folded before Flop
Seat 5: PlayTheBlues4U (big blind) collected ($0.24)


*********** # 163 **************
PokerStars Hand #203945143010:  Hold'em No Limit ($0.05/$0.10 USD) - 2019/09/24 23:38:03 ET
Table 'Botein' 6-max Seat #5 is the button
Seat 1: trumpcaddy ($14 in chips)
Seat 2: KeithTurbo48 ($10.70 in chips)
Seat 3: PlayTheBlues4U ($8.13 in chips)
Seat 4: traderneal ($8.46 in chips)
Seat 5: NBoula ($23.35 in chips)
Seat 6: Aikido85 ($3.45 in chips)
Aikido85: posts small blind $0.05
trumpcaddy: posts big blind $0.10
*** HOLE CARDS ***
Dealt to PlayTheBlues4U [9h As]
KeithTurbo48: folds
PlayTheBlues4U: calls $0.10
traderneal: calls $0.10
NBoula: raises $0.20 to $0.30
Aikido85: calls $0.25
trumpcaddy: folds
PlayTheBlues4U: calls $0.20
traderneal: calls $0.20
*** FLOP *** [4d 4s Qc]
Aikido85: checks
PlayTheBlues4U: checks
traderneal: bets $0.30
NBoula: folds
Aikido85: folds
PlayTheBlues4U: folds
Uncalled bet ($0.30) returned to traderneal
traderneal collected $1.24 from pot
traderneal: doesn't show hand
*** SUMMARY ***
Total pot $1.30 | Rake $0.06
Board [4d 4s Qc]
Seat 1: trumpcaddy (big blind) folded before Flop
Seat 2: KeithTurbo48 folded before Flop (didn't bet)
Seat 3: PlayTheBlues4U folded on the Flop
Seat 4: traderneal collected ($1.24)
Seat 5: NBoula (button) folded on the Flop
Seat 6: Aikido85 (small blind) folded on the Flop


*********** # 164 **************
PokerStars Hand #203945143008:  Hold'em No Limit ($0.05/$0.10 USD) - 2019/09/24 23:38:02 ET
Table 'Camilla' 6-max Seat #5 is the button
Seat 2: yuni80 ($12.90 in chips)
Seat 4: SeaofLove ($19.72 in chips)
Seat 5: PlayTheBlues4U ($16.30 in chips)
yuni80: posts small blind $0.05
SeaofLove: posts big blind $0.10
*** HOLE CARDS ***
Dealt to PlayTheBlues4U [5d Th]
PlayTheBlues4U: folds
yuni80: calls $0.05
SeaofLove: checks
*** FLOP *** [7s 8d 4c]
yuni80: checks
SeaofLove: checks
*** TURN *** [7s 8d 4c] [2h]
yuni80: checks
SeaofLove: checks
*** RIVER *** [7s 8d 4c 2h] [9c]
yuni80: checks
SeaofLove: checks
*** SHOW DOWN ***
yuni80: shows [9h Ah] (a pair of Nines)
SeaofLove: mucks hand
yuni80 collected $0.19 from pot
*** SUMMARY ***
Total pot $0.20 | Rake $0.01
Board [7s 8d 4c 2h 9c]
Seat 2: yuni80 (small blind) showed [9h Ah] and won ($0.19) with a pair of Nines
Seat 4: SeaofLove (big blind) mucked [4h 5c]
Seat 5: PlayTheBlues4U (button) folded before Flop (didn't bet)


*********** # 165 **************
PokerStars Hand #203945142881:  Hold'em No Limit ($0.05/$0.10 USD) - 2019/09/24 23:37:21 ET
Table 'Botein' 6-max Seat #4 is the button
Seat 1: trumpcaddy ($14 in chips)
Seat 2: KeithTurbo48 ($10.70 in chips)
Seat 3: PlayTheBlues4U ($8.13 in chips)
Seat 4: traderneal ($10.86 in chips)
Seat 5: NBoula ($21.09 in chips)
Seat 6: Aikido85 ($3.55 in chips)
NBoula: posts small blind $0.05
Aikido85: posts big blind $0.10
*** HOLE CARDS ***
Dealt to PlayTheBlues4U [7h Kh]
trumpcaddy: folds
KeithTurbo48: folds
PlayTheBlues4U: folds
traderneal: calls $0.10
NBoula: raises $0.20 to $0.30
Aikido85: folds
traderneal: calls $0.20
*** FLOP *** [8s 8c Ts]
NBoula: bets $0.30
traderneal: calls $0.30
*** TURN *** [8s 8c Ts] [9d]
NBoula: checks
traderneal: bets $0.60
NBoula: calls $0.60
*** RIVER *** [8s 8c Ts 9d] [5h]
NBoula: checks
traderneal: bets $1.20
NBoula: calls $1.20
*** SHOW DOWN ***
traderneal: shows [9h 7d] (two pair, Nines and Eights)
NBoula: shows [Ah Th] (two pair, Tens and Eights)
NBoula collected $4.66 from pot
*** SUMMARY ***
Total pot $4.90 | Rake $0.24
Board [8s 8c Ts 9d 5h]
Seat 1: trumpcaddy folded before Flop (didn't bet)
Seat 2: KeithTurbo48 folded before Flop (didn't bet)
Seat 3: PlayTheBlues4U folded before Flop (didn't bet)
Seat 4: traderneal (button) showed [9h 7d] and lost with two pair, Nines and Eights
Seat 5: NBoula (small blind) showed [Ah Th] and won ($4.66) with two pair, Tens and Eights
Seat 6: Aikido85 (big blind) folded before Flop


*********** # 166 **************
PokerStars Hand #203945142877:  Hold'em No Limit ($0.05/$0.10 USD) - 2019/09/24 23:37:18 ET
Table 'Camilla' 6-max Seat #4 is the button
Seat 2: yuni80 ($12.72 in chips)
Seat 3: KeithTurbo48 ($22.19 in chips)
Seat 4: SeaofLove ($19.72 in chips)
Seat 5: PlayTheBlues4U ($16.50 in chips)
PlayTheBlues4U: posts small blind $0.05
yuni80: posts big blind $0.10
*** HOLE CARDS ***
Dealt to PlayTheBlues4U [9s Qd]
KeithTurbo48: folds
KeithTurbo48 leaves the table
SeaofLove: folds
PlayTheBlues4U: calls $0.05
yuni80: checks
*** FLOP *** [Jh 7s Jc]
PlayTheBlues4U: checks
yuni80: checks
*** TURN *** [Jh 7s Jc] [8s]
PlayTheBlues4U: checks
yuni80: checks
*** RIVER *** [Jh 7s Jc 8s] [9h]
PlayTheBlues4U: bets $0.10
yuni80: raises $1.50 to $1.60
PlayTheBlues4U: folds
Uncalled bet ($1.50) returned to yuni80
yuni80 collected $0.38 from pot
yuni80: doesn't show hand
*** SUMMARY ***
Total pot $0.40 | Rake $0.02
Board [Jh 7s Jc 8s 9h]
Seat 2: yuni80 (big blind) collected ($0.38)
Seat 3: KeithTurbo48 folded before Flop (didn't bet)
Seat 4: SeaofLove (button) folded before Flop (didn't bet)
Seat 5: PlayTheBlues4U (small blind) folded on the River


*********** # 167 **************
PokerStars Hand #203945142645:  Hold'em No Limit ($0.05/$0.10 USD) - 2019/09/24 23:36:03 ET
Table 'Camilla' 6-max Seat #3 is the button
Seat 2: yuni80 ($16.52 in chips)
Seat 3: KeithTurbo48 ($25.99 in chips)
Seat 4: SeaofLove ($20.12 in chips)
Seat 5: PlayTheBlues4U ($9.09 in chips)
SeaofLove: posts small blind $0.05
PlayTheBlues4U: posts big blind $0.10
*** HOLE CARDS ***
Dealt to PlayTheBlues4U [Ah Kd]
yuni80: calls $0.10
KeithTurbo48: raises $0.30 to $0.40
SeaofLove: calls $0.35
PlayTheBlues4U: raises $0.60 to $1
yuni80: calls $0.90
KeithTurbo48: raises $2.80 to $3.80
SeaofLove: folds
PlayTheBlues4U: calls $2.80
yuni80: calls $2.80
*** FLOP *** [Td Qd 2d]
PlayTheBlues4U: checks
yuni80: checks
KeithTurbo48: checks
*** TURN *** [Td Qd 2d] [5h]
PlayTheBlues4U: bets $5.29 and is all-in
yuni80: folds
KeithTurbo48: folds
Uncalled bet ($5.29) returned to PlayTheBlues4U
PlayTheBlues4U collected $11.21 from pot
PlayTheBlues4U: doesn't show hand
*** SUMMARY ***
Total pot $11.80 | Rake $0.59
Board [Td Qd 2d 5h]
Seat 2: yuni80 folded on the Turn
Seat 3: KeithTurbo48 (button) folded on the Turn
Seat 4: SeaofLove (small blind) folded before Flop
Seat 5: PlayTheBlues4U (big blind) collected ($11.21)


*********** # 168 **************
PokerStars Hand #203945142579:  Hold'em No Limit ($0.05/$0.10 USD) - 2019/09/24 23:35:41 ET
Table 'Botein' 6-max Seat #3 is the button
Seat 1: trumpcaddy ($14 in chips)
Seat 2: KeithTurbo48 ($10.90 in chips)
Seat 3: PlayTheBlues4U ($8.13 in chips)
Seat 4: traderneal ($10.96 in chips)
Seat 5: NBoula ($20.81 in chips)
Seat 6: Aikido85 ($3.55 in chips)
traderneal: posts small blind $0.05
NBoula: posts big blind $0.10
KeithTurbo48: posts big blind $0.10
*** HOLE CARDS ***
Dealt to PlayTheBlues4U [2c 9d]
Aikido85: folds
trumpcaddy: folds
KeithTurbo48: checks
PlayTheBlues4U: folds
traderneal: calls $0.05
NBoula: checks
*** FLOP *** [Qh Tc 7s]
traderneal: checks
NBoula: bets $0.10
KeithTurbo48: calls $0.10
traderneal: folds
*** TURN *** [Qh Tc 7s] [Ad]
NBoula: checks
KeithTurbo48: checks
*** RIVER *** [Qh Tc 7s Ad] [As]
NBoula: checks
KeithTurbo48: checks
*** SHOW DOWN ***
NBoula: shows [4c Th] (two pair, Aces and Tens)
KeithTurbo48: mucks hand
NBoula collected $0.48 from pot
*** SUMMARY ***
Total pot $0.50 | Rake $0.02
Board [Qh Tc 7s Ad As]
Seat 1: trumpcaddy folded before Flop (didn't bet)
Seat 2: KeithTurbo48 mucked [6s 8h]
Seat 3: PlayTheBlues4U (button) folded before Flop (didn't bet)
Seat 4: traderneal (small blind) folded on the Flop
Seat 5: NBoula (big blind) showed [4c Th] and won ($0.48) with two pair, Aces and Tens
Seat 6: Aikido85 folded before Flop (didn't bet)


*********** # 169 **************
PokerStars Hand #203945142573:  Hold'em No Limit ($0.05/$0.10 USD) - 2019/09/24 23:35:40 ET
Table 'Camilla' 6-max Seat #2 is the button
Seat 2: yuni80 ($16.62 in chips)
Seat 3: KeithTurbo48 ($25.81 in chips)
Seat 4: SeaofLove ($20.22 in chips)
Seat 5: PlayTheBlues4U ($9.09 in chips)
KeithTurbo48: posts small blind $0.05
SeaofLove: posts big blind $0.10
*** HOLE CARDS ***
Dealt to PlayTheBlues4U [Jd 5d]
PlayTheBlues4U: folds
yuni80: calls $0.10
KeithTurbo48: calls $0.05
SeaofLove: checks
*** FLOP *** [4c 6h 2d]
KeithTurbo48: checks
SeaofLove: checks
yuni80: checks
*** TURN *** [4c 6h 2d] [Ks]
KeithTurbo48: checks
SeaofLove: checks
yuni80: checks
*** RIVER *** [4c 6h 2d Ks] [9s]
KeithTurbo48: checks
SeaofLove: checks
yuni80: checks
*** SHOW DOWN ***
KeithTurbo48: shows [9c 8h] (a pair of Nines)
SeaofLove: mucks hand
yuni80: mucks hand
KeithTurbo48 collected $0.28 from pot
*** SUMMARY ***
Total pot $0.30 | Rake $0.02
Board [4c 6h 2d Ks 9s]
Seat 2: yuni80 (button) mucked [6s Qc]
Seat 3: KeithTurbo48 (small blind) showed [9c 8h] and won ($0.28) with a pair of Nines
Seat 4: SeaofLove (big blind) mucked [7s 3c]
Seat 5: PlayTheBlues4U folded before Flop (didn't bet)


*********** # 170 **************
PokerStars Hand #203945142474:  Hold'em No Limit ($0.05/$0.10 USD) - 2019/09/24 23:35:06 ET
Table 'Camilla' 6-max Seat #5 is the button
Seat 2: yuni80 ($16.17 in chips)
Seat 3: KeithTurbo48 ($26.31 in chips)
Seat 4: SeaofLove ($20.22 in chips)
Seat 5: PlayTheBlues4U ($9.09 in chips)
yuni80: posts small blind $0.05
KeithTurbo48: posts big blind $0.10
*** HOLE CARDS ***
Dealt to PlayTheBlues4U [5s 8d]
SeaofLove: folds
PlayTheBlues4U: folds
yuni80: calls $0.05
KeithTurbo48: raises $0.20 to $0.30
yuni80: calls $0.20
*** FLOP *** [Td 5d As]
yuni80: checks
KeithTurbo48: checks
*** TURN *** [Td 5d As] [Ac]
yuni80: checks
KeithTurbo48: bets $0.20
yuni80: calls $0.20
*** RIVER *** [Td 5d As Ac] [8c]
yuni80: checks
KeithTurbo48: checks
*** SHOW DOWN ***
yuni80: shows [Ts 3s] (two pair, Aces and Tens)
KeithTurbo48: mucks hand
yuni80 collected $0.95 from pot
*** SUMMARY ***
Total pot $1 | Rake $0.05
Board [Td 5d As Ac 8c]
Seat 2: yuni80 (small blind) showed [Ts 3s] and won ($0.95) with two pair, Aces and Tens
Seat 3: KeithTurbo48 (big blind) mucked [9h Kd]
Seat 4: SeaofLove folded before Flop (didn't bet)
Seat 5: PlayTheBlues4U (button) folded before Flop (didn't bet)


*********** # 171 **************
PokerStars Hand #203945142454:  Hold'em No Limit ($0.05/$0.10 USD) - 2019/09/24 23:34:57 ET
Table 'Botein' 6-max Seat #1 is the button
Seat 1: trumpcaddy ($14 in chips)
Seat 3: PlayTheBlues4U ($8.18 in chips)
Seat 4: traderneal ($10 in chips)
Seat 5: NBoula ($21.51 in chips)
Seat 6: Aikido85 ($3.85 in chips)
KeithTurbo48 will be allowed to play after the button
PlayTheBlues4U: posts small blind $0.05
traderneal: posts big blind $0.10
*** HOLE CARDS ***
Dealt to PlayTheBlues4U [3s Qc]
NBoula: raises $0.20 to $0.30
Aikido85: calls $0.30
trumpcaddy: folds
PlayTheBlues4U: folds
traderneal: calls $0.20
*** FLOP *** [9s 8s 6h]
traderneal: checks
NBoula: bets $0.40
Aikido85: folds
traderneal: calls $0.40
*** TURN *** [9s 8s 6h] [Ad]
traderneal: checks
NBoula: checks
*** RIVER *** [9s 8s 6h Ad] [4h]
traderneal: bets $1.70
NBoula: folds
Uncalled bet ($1.70) returned to traderneal
traderneal collected $1.66 from pot
traderneal: doesn't show hand
*** SUMMARY ***
Total pot $1.75 | Rake $0.09
Board [9s 8s 6h Ad 4h]
Seat 1: trumpcaddy (button) folded before Flop (didn't bet)
Seat 3: PlayTheBlues4U (small blind) folded before Flop
Seat 4: traderneal (big blind) collected ($1.66)
Seat 5: NBoula folded on the River
Seat 6: Aikido85 folded on the Flop


*********** # 172 **************
PokerStars Hand #203945142408:  Hold'em No Limit ($0.05/$0.10 USD) - 2019/09/24 23:34:40 ET
Table 'Camilla' 6-max Seat #4 is the button
Seat 2: yuni80 ($16.42 in chips)
Seat 3: KeithTurbo48 ($26.31 in chips)
Seat 4: SeaofLove ($20.47 in chips)
Seat 5: PlayTheBlues4U ($8.63 in chips)
PlayTheBlues4U: posts small blind $0.05
yuni80: posts big blind $0.10
*** HOLE CARDS ***
Dealt to PlayTheBlues4U [2d 2s]
KeithTurbo48: folds
SeaofLove: raises $0.15 to $0.25
PlayTheBlues4U: calls $0.20
yuni80: calls $0.15
*** FLOP *** [3d 9h Qd]
PlayTheBlues4U: checks
yuni80: checks
SeaofLove: checks
*** TURN *** [3d 9h Qd] [9c]
PlayTheBlues4U: bets $0.40
yuni80: folds
SeaofLove: folds
Uncalled bet ($0.40) returned to PlayTheBlues4U
PlayTheBlues4U collected $0.71 from pot
PlayTheBlues4U: doesn't show hand
*** SUMMARY ***
Total pot $0.75 | Rake $0.04
Board [3d 9h Qd 9c]
Seat 2: yuni80 (big blind) folded on the Turn
Seat 3: KeithTurbo48 folded before Flop (didn't bet)
Seat 4: SeaofLove (button) folded on the Turn
Seat 5: PlayTheBlues4U (small blind) collected ($0.71)


*********** # 173 **************
PokerStars Hand #203945142347:  Hold'em No Limit ($0.05/$0.10 USD) - 2019/09/24 23:34:17 ET
Table 'Botein' 6-max Seat #6 is the button
Seat 1: trumpcaddy ($14.05 in chips)
Seat 3: PlayTheBlues4U ($8.04 in chips)
Seat 4: traderneal ($10 in chips)
Seat 5: NBoula ($21.51 in chips)
Seat 6: Aikido85 ($3.95 in chips)
trumpcaddy: posts small blind $0.05
Pezant: is sitting out
PlayTheBlues4U: posts big blind $0.10
*** HOLE CARDS ***
Dealt to PlayTheBlues4U [5h 8s]
traderneal: folds
Pezant leaves the table
NBoula: folds
KeithTurbo48 joins the table at seat #2
Aikido85: calls $0.10
trumpcaddy: folds
PlayTheBlues4U: checks
*** FLOP *** [5d Ts Tc]
PlayTheBlues4U: checks
Aikido85: checks
*** TURN *** [5d Ts Tc] [2s]
PlayTheBlues4U: bets $0.20
Aikido85: folds
Uncalled bet ($0.20) returned to PlayTheBlues4U
PlayTheBlues4U collected $0.24 from pot
PlayTheBlues4U: doesn't show hand
*** SUMMARY ***
Total pot $0.25 | Rake $0.01
Board [5d Ts Tc 2s]
Seat 1: trumpcaddy (small blind) folded before Flop
Seat 3: PlayTheBlues4U (big blind) collected ($0.24)
Seat 4: traderneal folded before Flop (didn't bet)
Seat 5: NBoula folded before Flop (didn't bet)
Seat 6: Aikido85 (button) folded on the Turn


*********** # 174 **************
PokerStars Hand #203945142290:  Hold'em No Limit ($0.05/$0.10 USD) - 2019/09/24 23:34:00 ET
Table 'Camilla' 6-max Seat #3 is the button
Seat 2: yuni80 ($16.42 in chips)
Seat 3: KeithTurbo48 ($26.31 in chips)
Seat 4: SeaofLove ($19.86 in chips)
Seat 5: PlayTheBlues4U ($9.31 in chips)
SeaofLove: posts small blind $0.05
PlayTheBlues4U: posts big blind $0.10
*** HOLE CARDS ***
Dealt to PlayTheBlues4U [7c Kh]
yuni80: folds
KeithTurbo48: folds
SeaofLove: raises $0.20 to $0.30
PlayTheBlues4U: calls $0.20
*** FLOP *** [2s 5c 7h]
SeaofLove: bets $0.38
PlayTheBlues4U: calls $0.38
*** TURN *** [2s 5c 7h] [As]
SeaofLove: bets $0.70
PlayTheBlues4U: folds
Uncalled bet ($0.70) returned to SeaofLove
SeaofLove collected $1.29 from pot
SeaofLove: doesn't show hand
*** SUMMARY ***
Total pot $1.36 | Rake $0.07
Board [2s 5c 7h As]
Seat 2: yuni80 folded before Flop (didn't bet)
Seat 3: KeithTurbo48 (button) folded before Flop (didn't bet)
Seat 4: SeaofLove (small blind) collected ($1.29)
Seat 5: PlayTheBlues4U (big blind) folded on the Turn


*********** # 175 **************
PokerStars Hand #203945142287:  Hold'em No Limit ($0.05/$0.10 USD) - 2019/09/24 23:34:00 ET
Table 'Botein' 6-max Seat #5 is the button
Seat 1: trumpcaddy ($14.15 in chips)
Seat 2: Pezant ($10.68 in chips)
Seat 3: PlayTheBlues4U ($8.04 in chips)
Seat 5: NBoula ($21.36 in chips)
Seat 6: Aikido85 ($4 in chips)
Aikido85: posts small blind $0.05
trumpcaddy: posts big blind $0.10
*** HOLE CARDS ***
Dealt to PlayTheBlues4U [6d 8h]
Pezant: folds
PlayTheBlues4U: folds
NBoula: raises $0.20 to $0.30
Aikido85: folds
trumpcaddy: folds
Uncalled bet ($0.20) returned to NBoula
NBoula collected $0.25 from pot
NBoula: doesn't show hand
*** SUMMARY ***
Total pot $0.25 | Rake $0
Seat 1: trumpcaddy (big blind) folded before Flop
Seat 2: Pezant folded before Flop (didn't bet)
Seat 3: PlayTheBlues4U folded before Flop (didn't bet)
Seat 5: NBoula (button) collected ($0.25)
Seat 6: Aikido85 (small blind) folded before Flop


*********** # 176 **************
PokerStars Hand #203945142228:  Hold'em No Limit ($0.05/$0.10 USD) - 2019/09/24 23:33:38 ET
Table 'Camilla' 6-max Seat #2 is the button
Seat 2: yuni80 ($16.72 in chips)
Seat 3: KeithTurbo48 ($26.36 in chips)
Seat 4: SeaofLove ($19.96 in chips)
Seat 5: PlayTheBlues4U ($8.90 in chips)
KeithTurbo48: posts small blind $0.05
SeaofLove: posts big blind $0.10
*** HOLE CARDS ***
Dealt to PlayTheBlues4U [Td 7d]
PlayTheBlues4U: raises $0.20 to $0.30
yuni80: calls $0.30
KeithTurbo48: folds
SeaofLove: folds
*** FLOP *** [8c 8h 3s]
PlayTheBlues4U: bets $0.40
yuni80: folds
Uncalled bet ($0.40) returned to PlayTheBlues4U
PlayTheBlues4U collected $0.71 from pot
PlayTheBlues4U: doesn't show hand
*** SUMMARY ***
Total pot $0.75 | Rake $0.04
Board [8c 8h 3s]
Seat 2: yuni80 (button) folded on the Flop
Seat 3: KeithTurbo48 (small blind) folded before Flop
Seat 4: SeaofLove (big blind) folded before Flop
Seat 5: PlayTheBlues4U collected ($0.71)


*********** # 177 **************
PokerStars Hand #203945142163:  Hold'em No Limit ($0.05/$0.10 USD) - 2019/09/24 23:33:10 ET
Table 'Botein' 6-max Seat #3 is the button
Seat 1: trumpcaddy ($14.15 in chips)
Seat 2: Pezant ($10.95 in chips)
Seat 3: PlayTheBlues4U ($8.04 in chips)
Seat 4: traderneal ($9.70 in chips)
Seat 5: NBoula ($12.37 in chips)
Seat 6: Aikido85 ($4 in chips)
traderneal: posts small blind $0.05
NBoula: posts big blind $0.10
*** HOLE CARDS ***
Dealt to PlayTheBlues4U [3d Js]
Aikido85: folds
trumpcaddy: folds
Pezant: raises $0.17 to $0.27
PlayTheBlues4U: folds
traderneal: raises $0.64 to $0.91
NBoula: calls $0.81
Pezant: folds
*** FLOP *** [Ks Kd 8c]
traderneal: checks
NBoula: bets $1
traderneal: calls $1
*** TURN *** [Ks Kd 8c] [Qc]
traderneal: bets $1.90
NBoula: calls $1.90
*** RIVER *** [Ks Kd 8c Qc] [Kh]
traderneal: bets $5.89 and is all-in
NBoula: calls $5.89
*** SHOW DOWN ***
traderneal: shows [Th Ts] (a full house, Kings full of Tens)
NBoula: shows [Ad Qd] (a full house, Kings full of Queens)
NBoula collected $18.69 from pot
*** SUMMARY ***
Total pot $19.67 | Rake $0.98
Board [Ks Kd 8c Qc Kh]
Seat 1: trumpcaddy folded before Flop (didn't bet)
Seat 2: Pezant folded before Flop
Seat 3: PlayTheBlues4U (button) folded before Flop (didn't bet)
Seat 4: traderneal (small blind) showed [Th Ts] and lost with a full house, Kings full of Tens
Seat 5: NBoula (big blind) showed [Ad Qd] and won ($18.69) with a full house, Kings full of Queens
Seat 6: Aikido85 folded before Flop (didn't bet)


*********** # 178 **************
PokerStars Hand #203945142103:  Hold'em No Limit ($0.05/$0.10 USD) - 2019/09/24 23:32:50 ET
Table 'Camilla' 6-max Seat #5 is the button
Seat 2: yuni80 ($15.90 in chips)
Seat 3: KeithTurbo48 ($27.06 in chips)
Seat 4: SeaofLove ($19.96 in chips)
Seat 5: PlayTheBlues4U ($9.10 in chips)
yuni80: posts small blind $0.05
KeithTurbo48: posts big blind $0.10
*** HOLE CARDS ***
Dealt to PlayTheBlues4U [Kd 6s]
SeaofLove: folds
PlayTheBlues4U: raises $0.10 to $0.20
yuni80: calls $0.15
KeithTurbo48: calls $0.10
*** FLOP *** [5d Qs 3d]
yuni80: checks
KeithTurbo48: checks
PlayTheBlues4U: checks
*** TURN *** [5d Qs 3d] [2c]
yuni80: bets $0.10
KeithTurbo48: raises $0.40 to $0.50
PlayTheBlues4U: folds
yuni80: calls $0.40
*** RIVER *** [5d Qs 3d 2c] [7c]
yuni80: checks
KeithTurbo48: checks
*** SHOW DOWN ***
yuni80: shows [Qh 6h] (a pair of Queens)
KeithTurbo48: mucks hand
yuni80 collected $1.52 from pot
*** SUMMARY ***
Total pot $1.60 | Rake $0.08
Board [5d Qs 3d 2c 7c]
Seat 2: yuni80 (small blind) showed [Qh 6h] and won ($1.52) with a pair of Queens
Seat 3: KeithTurbo48 (big blind) mucked [Qc 4c]
Seat 4: SeaofLove folded before Flop (didn't bet)
Seat 5: PlayTheBlues4U (button) folded on the Turn


*********** # 179 **************
PokerStars Hand #203942559939:  Hold'em No Limit ($0.05/$0.10 USD) - 2019/09/24 23:32:28 ET
Table 'Botein' 6-max Seat #2 is the button
Seat 1: trumpcaddy ($14.15 in chips)
Seat 2: Pezant ($10.95 in chips)
Seat 3: PlayTheBlues4U ($8.09 in chips)
Seat 4: traderneal ($10 in chips)
Seat 5: NBoula ($12.05 in chips)
Seat 6: Aikido85 ($4 in chips)
PlayTheBlues4U: posts small blind $0.05
traderneal: posts big blind $0.10
*** HOLE CARDS ***
Dealt to PlayTheBlues4U [8h Tc]
NBoula: raises $0.20 to $0.30
Aikido85: folds
trumpcaddy: folds
Pezant: folds
PlayTheBlues4U: folds
traderneal: calls $0.20
*** FLOP *** [As Qh 9h]
traderneal: checks
NBoula: checks
*** TURN *** [As Qh 9h] [8s]
traderneal: checks
NBoula: bets $0.30
traderneal: folds
Uncalled bet ($0.30) returned to NBoula
NBoula collected $0.62 from pot
NBoula: doesn't show hand
*** SUMMARY ***
Total pot $0.65 | Rake $0.03
Board [As Qh 9h 8s]
Seat 1: trumpcaddy folded before Flop (didn't bet)
Seat 2: Pezant (button) folded before Flop (didn't bet)
Seat 3: PlayTheBlues4U (small blind) folded before Flop
Seat 4: traderneal (big blind) folded on the Turn
Seat 5: NBoula collected ($0.62)
Seat 6: Aikido85 folded before Flop (didn't bet)


*********** # 180 **************
PokerStars Hand #203942559912:  Hold'em No Limit ($0.05/$0.10 USD) - 2019/09/24 23:32:19 ET
Table 'Camilla' 6-max Seat #4 is the button
Seat 2: yuni80 ($16.15 in chips)
Seat 3: KeithTurbo48 ($26.79 in chips)
Seat 4: SeaofLove ($19.96 in chips)
Seat 5: PlayTheBlues4U ($9.15 in chips)
PlayTheBlues4U: posts small blind $0.05
yuni80: posts big blind $0.10
*** HOLE CARDS ***
Dealt to PlayTheBlues4U [7d Qc]
KeithTurbo48: raises $0.15 to $0.25
SeaofLove: folds
PlayTheBlues4U: folds
yuni80: calls $0.15
*** FLOP *** [2h 3c As]
yuni80: checks
KeithTurbo48: checks
*** TURN *** [2h 3c As] [Qs]
yuni80: checks
KeithTurbo48: bets $0.30
yuni80: folds
Uncalled bet ($0.30) returned to KeithTurbo48
KeithTurbo48 collected $0.52 from pot
KeithTurbo48: doesn't show hand
*** SUMMARY ***
Total pot $0.55 | Rake $0.03
Board [2h 3c As Qs]
Seat 2: yuni80 (big blind) folded on the Turn
Seat 3: KeithTurbo48 collected ($0.52)
Seat 4: SeaofLove (button) folded before Flop (didn't bet)
Seat 5: PlayTheBlues4U (small blind) folded before Flop


*********** # 181 **************
PokerStars Hand #203942559800:  Hold'em No Limit ($0.05/$0.10 USD) - 2019/09/24 23:31:38 ET
Table 'Camilla' 6-max Seat #3 is the button
Seat 2: yuni80 ($16.55 in chips)
Seat 3: KeithTurbo48 ($26.29 in chips)
Seat 4: SeaofLove ($20.01 in chips)
Seat 5: PlayTheBlues4U ($9.25 in chips)
Seat 6: pokerfacerr5 ($24.11 in chips)
SeaofLove: posts small blind $0.05
PlayTheBlues4U: posts big blind $0.10
*** HOLE CARDS ***
Dealt to PlayTheBlues4U [4c 2h]
pokerfacerr5: folds
pokerfacerr5 leaves the table
yuni80: calls $0.10
KeithTurbo48: raises $0.30 to $0.40
SeaofLove: folds
PlayTheBlues4U: folds
yuni80: calls $0.30
*** FLOP *** [5s 5c 3s]
yuni80: checks
KeithTurbo48: checks
*** TURN *** [5s 5c 3s] [Ac]
yuni80: checks
KeithTurbo48: checks
*** RIVER *** [5s 5c 3s Ac] [Qd]
yuni80: checks
KeithTurbo48: bets $0.67
yuni80: folds
Uncalled bet ($0.67) returned to KeithTurbo48
KeithTurbo48 collected $0.90 from pot
KeithTurbo48: doesn't show hand
*** SUMMARY ***
Total pot $0.95 | Rake $0.05
Board [5s 5c 3s Ac Qd]
Seat 2: yuni80 folded on the River
Seat 3: KeithTurbo48 (button) collected ($0.90)
Seat 4: SeaofLove (small blind) folded before Flop
Seat 5: PlayTheBlues4U (big blind) folded before Flop
Seat 6: pokerfacerr5 folded before Flop (didn't bet)


*********** # 182 **************
PokerStars Hand #203942559750:  Hold'em No Limit ($0.05/$0.10 USD) - 2019/09/24 23:31:19 ET
Table 'Camilla' 6-max Seat #2 is the button
Seat 2: yuni80 ($16.55 in chips)
Seat 3: KeithTurbo48 ($26.34 in chips)
Seat 4: SeaofLove ($20.11 in chips)
Seat 5: PlayTheBlues4U ($9.55 in chips)
Seat 6: pokerfacerr5 ($23.66 in chips)
KeithTurbo48: posts small blind $0.05
SeaofLove: posts big blind $0.10
*** HOLE CARDS ***
Dealt to PlayTheBlues4U [Ts 9s]
PlayTheBlues4U: raises $0.20 to $0.30
pokerfacerr5: raises $3.80 to $4.10
yuni80: folds
KeithTurbo48: folds
SeaofLove: folds
PlayTheBlues4U: folds
Uncalled bet ($3.80) returned to pokerfacerr5
pokerfacerr5 collected $0.75 from pot
pokerfacerr5: doesn't show hand
*** SUMMARY ***
Total pot $0.75 | Rake $0
Seat 2: yuni80 (button) folded before Flop (didn't bet)
Seat 3: KeithTurbo48 (small blind) folded before Flop
Seat 4: SeaofLove (big blind) folded before Flop
Seat 5: PlayTheBlues4U folded before Flop
Seat 6: pokerfacerr5 collected ($0.75)


*********** # 183 **************
PokerStars Hand #203942559736:  Hold'em No Limit ($0.05/$0.10 USD) - 2019/09/24 23:31:14 ET
Table 'Botein' 6-max Seat #1 is the button
Seat 1: trumpcaddy ($19.01 in chips)
Seat 2: Pezant ($11 in chips)
Seat 3: PlayTheBlues4U ($8.19 in chips)
Seat 4: traderneal ($4.86 in chips)
Seat 5: NBoula ($12.05 in chips)
Seat 6: Aikido85 ($4 in chips)
Pezant: posts small blind $0.05
PlayTheBlues4U: posts big blind $0.10
*** HOLE CARDS ***
Dealt to PlayTheBlues4U [Jh 7c]
traderneal: calls $0.10
NBoula: folds
Aikido85: folds
trumpcaddy: raises $0.40 to $0.50
Pezant: folds
PlayTheBlues4U: folds
traderneal: calls $0.40
*** FLOP *** [4c Qh 4d]
traderneal: checks
trumpcaddy: bets $1
traderneal: calls $1
*** TURN *** [4c Qh 4d] [Td]
traderneal: checks
trumpcaddy: bets $3.40
traderneal: calls $3.36 and is all-in
Uncalled bet ($0.04) returned to trumpcaddy
*** RIVER *** [4c Qh 4d Td] [7s]
*** SHOW DOWN ***
traderneal: shows [4h 3d] (three of a kind, Fours)
trumpcaddy: shows [Ah Ad] (two pair, Aces and Fours)
traderneal collected $9.38 from pot
*** SUMMARY ***
Total pot $9.87 | Rake $0.49
Board [4c Qh 4d Td 7s]
Seat 1: trumpcaddy (button) showed [Ah Ad] and lost with two pair, Aces and Fours
Seat 2: Pezant (small blind) folded before Flop
Seat 3: PlayTheBlues4U (big blind) folded before Flop
Seat 4: traderneal showed [4h 3d] and won ($9.38) with three of a kind, Fours
Seat 5: NBoula folded before Flop (didn't bet)
Seat 6: Aikido85 folded before Flop (didn't bet)


*********** # 184 **************
PokerStars Hand #203942559646:  Hold'em No Limit ($0.05/$0.10 USD) - 2019/09/24 23:30:45 ET
Table 'Camilla' 6-max Seat #6 is the button
Seat 2: yuni80 ($8.56 in chips)
Seat 3: KeithTurbo48 ($26.64 in chips)
Seat 4: SeaofLove ($20.11 in chips)
Seat 5: PlayTheBlues4U ($9.55 in chips)
Seat 6: pokerfacerr5 ($32.22 in chips)
yuni80: posts small blind $0.05
KeithTurbo48: posts big blind $0.10
*** HOLE CARDS ***
Dealt to PlayTheBlues4U [5c 4h]
SeaofLove: folds
PlayTheBlues4U: folds
pokerfacerr5: raises $0.20 to $0.30
yuni80: calls $0.25
KeithTurbo48: calls $0.20
*** FLOP *** [8s 5s Js]
yuni80: checks
KeithTurbo48: checks
pokerfacerr5: bets $0.86
yuni80: raises $0.86 to $1.72
KeithTurbo48: folds
pokerfacerr5: raises $30.20 to $31.92 and is all-in
yuni80: calls $6.54 and is all-in
Uncalled bet ($23.66) returned to pokerfacerr5
*** TURN *** [8s 5s Js] [Qd]
*** RIVER *** [8s 5s Js Qd] [Jh]
*** SHOW DOWN ***
yuni80: shows [Qs 6s] (a flush, Queen high)
pokerfacerr5: shows [5d 8d] (two pair, Jacks and Eights)
yuni80 collected $16.55 from pot
*** SUMMARY ***
Total pot $17.42 | Rake $0.87
Board [8s 5s Js Qd Jh]
Seat 2: yuni80 (small blind) showed [Qs 6s] and won ($16.55) with a flush, Queen high
Seat 3: KeithTurbo48 (big blind) folded on the Flop
Seat 4: SeaofLove folded before Flop (didn't bet)
Seat 5: PlayTheBlues4U folded before Flop (didn't bet)
Seat 6: pokerfacerr5 (button) showed [5d 8d] and lost with two pair, Jacks and Eights


*********** # 185 **************
PokerStars Hand #203942559571:  Hold'em No Limit ($0.05/$0.10 USD) - 2019/09/24 23:30:23 ET
Table 'Botein' 6-max Seat #6 is the button
Seat 1: trumpcaddy ($19.36 in chips)
Seat 2: Pezant ($11.10 in chips)
Seat 3: PlayTheBlues4U ($8.19 in chips)
Seat 4: traderneal ($7.91 in chips)
Seat 5: NBoula ($8.88 in chips)
Seat 6: Aikido85 ($4 in chips)
trumpcaddy: posts small blind $0.05
Pezant: posts big blind $0.10
*** HOLE CARDS ***
Dealt to PlayTheBlues4U [Ah Ad]
PlayTheBlues4U: folds
traderneal: raises $0.25 to $0.35
NBoula: calls $0.35
Aikido85: folds
trumpcaddy: calls $0.30
Pezant: folds
*** FLOP *** [Kd 7c 3s]
trumpcaddy: checks
traderneal: bets $1.10
NBoula: calls $1.10
trumpcaddy: folds
*** TURN *** [Kd 7c 3s] [Kh]
traderneal: checks
NBoula: bets $1.60
traderneal: calls $1.60
*** RIVER *** [Kd 7c 3s Kh] [5h]
traderneal: checks
NBoula: bets $5.83 and is all-in
traderneal: folds
Uncalled bet ($5.83) returned to NBoula
NBoula collected $6.22 from pot
NBoula: doesn't show hand
*** SUMMARY ***
Total pot $6.55 | Rake $0.33
Board [Kd 7c 3s Kh 5h]
Seat 1: trumpcaddy (small blind) folded on the Flop
Seat 2: Pezant (big blind) folded before Flop
Seat 3: PlayTheBlues4U folded before Flop (didn't bet)
Seat 4: traderneal folded on the River
Seat 5: NBoula collected ($6.22)
Seat 6: Aikido85 (button) folded before Flop (didn't bet)


*********** # 186 **************
PokerStars Hand #203942559562:  Hold'em No Limit ($0.05/$0.10 USD) - 2019/09/24 23:30:18 ET
Table 'Camilla' 6-max Seat #5 is the button
Seat 2: yuni80 ($9.52 in chips)
Seat 3: KeithTurbo48 ($26.89 in chips)
Seat 4: SeaofLove ($20.11 in chips)
Seat 5: PlayTheBlues4U ($9.55 in chips)
Seat 6: pokerfacerr5 ($31.12 in chips)
pokerfacerr5: posts small blind $0.05
yuni80: posts big blind $0.10
*** HOLE CARDS ***
Dealt to PlayTheBlues4U [9h 7s]
KeithTurbo48: raises $0.15 to $0.25
SeaofLove: folds
PlayTheBlues4U: folds
pokerfacerr5: calls $0.20
yuni80: calls $0.15
*** FLOP *** [3c 9s 2s]
pokerfacerr5: bets $0.71
yuni80: calls $0.71
KeithTurbo48: folds
*** TURN *** [3c 9s 2s] [Ac]
pokerfacerr5: checks
yuni80: checks
*** RIVER *** [3c 9s 2s Ac] [8c]
pokerfacerr5: checks
yuni80: checks
*** SHOW DOWN ***
pokerfacerr5: shows [9d Jc] (a pair of Nines)
yuni80: mucks hand
pokerfacerr5 collected $2.06 from pot
*** SUMMARY ***
Total pot $2.17 | Rake $0.11
Board [3c 9s 2s Ac 8c]
Seat 2: yuni80 (big blind) mucked [Qc Ks]
Seat 3: KeithTurbo48 folded on the Flop
Seat 4: SeaofLove folded before Flop (didn't bet)
Seat 5: PlayTheBlues4U (button) folded before Flop (didn't bet)
Seat 6: pokerfacerr5 (small blind) showed [9d Jc] and won ($2.06) with a pair of Nines


*********** # 187 **************
PokerStars Hand #203942559528:  Hold'em No Limit ($0.05/$0.10 USD) - 2019/09/24 23:30:07 ET
Table 'Botein' 6-max Seat #5 is the button
Seat 1: trumpcaddy ($19.31 in chips)
Seat 2: Pezant ($11.10 in chips)
Seat 3: PlayTheBlues4U ($8.19 in chips)
Seat 4: traderneal ($7.91 in chips)
Seat 5: NBoula ($8.88 in chips)
Seat 6: Aikido85 ($4.05 in chips)
Aikido85: posts small blind $0.05
trumpcaddy: posts big blind $0.10
*** HOLE CARDS ***
Dealt to PlayTheBlues4U [6h 4h]
Pezant: folds
PlayTheBlues4U: folds
traderneal: folds
NBoula: folds
Aikido85: folds
Uncalled bet ($0.05) returned to trumpcaddy
trumpcaddy collected $0.10 from pot
trumpcaddy: doesn't show hand
*** SUMMARY ***
Total pot $0.10 | Rake $0
Seat 1: trumpcaddy (big blind) collected ($0.10)
Seat 2: Pezant folded before Flop (didn't bet)
Seat 3: PlayTheBlues4U folded before Flop (didn't bet)
Seat 4: traderneal folded before Flop (didn't bet)
Seat 5: NBoula (button) folded before Flop (didn't bet)
Seat 6: Aikido85 (small blind) folded before Flop


*********** # 188 **************
PokerStars Hand #203942559407:  Hold'em No Limit ($0.05/$0.10 USD) - 2019/09/24 23:29:26 ET
Table 'Camilla' 6-max Seat #4 is the button
Seat 2: yuni80 ($10.39 in chips)
Seat 3: KeithTurbo48 ($27.19 in chips)
Seat 4: SeaofLove ($20.11 in chips)
Seat 5: PlayTheBlues4U ($9.85 in chips)
Seat 6: pokerfacerr5 ($29.77 in chips)
PlayTheBlues4U: posts small blind $0.05
pokerfacerr5: posts big blind $0.10
*** HOLE CARDS ***
Dealt to PlayTheBlues4U [9h Ah]
yuni80: calls $0.10
KeithTurbo48: calls $0.10
SeaofLove: folds
PlayTheBlues4U: calls $0.05
pokerfacerr5: raises $0.20 to $0.30
yuni80: calls $0.20
KeithTurbo48: calls $0.20
PlayTheBlues4U: calls $0.20
*** FLOP *** [8d Qh 3c]
PlayTheBlues4U: checks
pokerfacerr5: bets $0.57
yuni80: calls $0.57
KeithTurbo48: folds
PlayTheBlues4U: folds
*** TURN *** [8d Qh 3c] [Ts]
pokerfacerr5: checks
yuni80: checks
*** RIVER *** [8d Qh 3c Ts] [6h]
pokerfacerr5: checks
yuni80: checks
*** SHOW DOWN ***
pokerfacerr5: shows [9s 8h] (a pair of Eights)
yuni80: mucks hand
pokerfacerr5 collected $2.22 from pot
*** SUMMARY ***
Total pot $2.34 | Rake $0.12
Board [8d Qh 3c Ts 6h]
Seat 2: yuni80 mucked [Ks Ac]
Seat 3: KeithTurbo48 folded on the Flop
Seat 4: SeaofLove (button) folded before Flop (didn't bet)
Seat 5: PlayTheBlues4U (small blind) folded on the Flop
Seat 6: pokerfacerr5 (big blind) showed [9s 8h] and won ($2.22) with a pair of Eights


*********** # 189 **************
PokerStars Hand #203942559380:  Hold'em No Limit ($0.05/$0.10 USD) - 2019/09/24 23:29:18 ET
Table 'Botein' 6-max Seat #4 is the button
Seat 1: trumpcaddy ($19.31 in chips)
Seat 2: Pezant ($11.37 in chips)
Seat 3: PlayTheBlues4U ($8.19 in chips)
Seat 4: traderneal ($7.52 in chips)
Seat 5: NBoula ($8.93 in chips)
Seat 6: Aikido85 ($4.15 in chips)
NBoula: posts small blind $0.05
Aikido85: posts big blind $0.10
*** HOLE CARDS ***
Dealt to PlayTheBlues4U [4s 7c]
trumpcaddy: folds
Pezant: raises $0.17 to $0.27
PlayTheBlues4U: folds
traderneal: calls $0.27
NBoula: folds
Aikido85: folds
*** FLOP *** [Kd 9c 7h]
Pezant: checks
traderneal: checks
*** TURN *** [Kd 9c 7h] [Js]
Pezant: checks
traderneal: bets $0.70
Pezant: folds
Uncalled bet ($0.70) returned to traderneal
traderneal collected $0.66 from pot
traderneal: doesn't show hand
*** SUMMARY ***
Total pot $0.69 | Rake $0.03
Board [Kd 9c 7h Js]
Seat 1: trumpcaddy folded before Flop (didn't bet)
Seat 2: Pezant folded on the Turn
Seat 3: PlayTheBlues4U folded before Flop (didn't bet)
Seat 4: traderneal (button) collected ($0.66)
Seat 5: NBoula (small blind) folded before Flop
Seat 6: Aikido85 (big blind) folded before Flop


*********** # 190 **************
PokerStars Hand #203942559333:  Hold'em No Limit ($0.05/$0.10 USD) - 2019/09/24 23:28:58 ET
Table 'Botein' 6-max Seat #3 is the button
Seat 1: trumpcaddy ($19.31 in chips)
Seat 2: Pezant ($11.37 in chips)
Seat 3: PlayTheBlues4U ($8.19 in chips)
Seat 4: traderneal ($7.43 in chips)
Seat 5: NBoula ($9.03 in chips)
Seat 6: Aikido85 ($4.15 in chips)
traderneal: posts small blind $0.05
NBoula: posts big blind $0.10
*** HOLE CARDS ***
Dealt to PlayTheBlues4U [6c Jh]
Aikido85: folds
trumpcaddy: folds
Pezant: folds
PlayTheBlues4U: folds
traderneal: calls $0.05
NBoula: checks
*** FLOP *** [Qd 5d 6h]
traderneal: checks
NBoula: checks
*** TURN *** [Qd 5d 6h] [3c]
traderneal: checks
NBoula: checks
*** RIVER *** [Qd 5d 6h 3c] [9c]
traderneal: checks
NBoula: checks
*** SHOW DOWN ***
traderneal: shows [5h Ac] (a pair of Fives)
NBoula: mucks hand
traderneal collected $0.19 from pot
*** SUMMARY ***
Total pot $0.20 | Rake $0.01
Board [Qd 5d 6h 3c 9c]
Seat 1: trumpcaddy folded before Flop (didn't bet)
Seat 2: Pezant folded before Flop (didn't bet)
Seat 3: PlayTheBlues4U (button) folded before Flop (didn't bet)
Seat 4: traderneal (small blind) showed [5h Ac] and won ($0.19) with a pair of Fives
Seat 5: NBoula (big blind) mucked [Kc 8h]
Seat 6: Aikido85 folded before Flop (didn't bet)


*********** # 191 **************
PokerStars Hand #203942559328:  Hold'em No Limit ($0.05/$0.10 USD) - 2019/09/24 23:28:57 ET
Table 'Camilla' 6-max Seat #3 is the button
Seat 2: yuni80 ($11.95 in chips)
Seat 3: KeithTurbo48 ($27.19 in chips)
Seat 4: SeaofLove ($20.16 in chips)
Seat 5: PlayTheBlues4U ($9.95 in chips)
Seat 6: pokerfacerr5 ($28.22 in chips)
SeaofLove: posts small blind $0.05
PlayTheBlues4U: posts big blind $0.10
*** HOLE CARDS ***
Dealt to PlayTheBlues4U [Qs 9h]
pokerfacerr5: raises $0.25 to $0.35
yuni80: calls $0.35
KeithTurbo48: folds
SeaofLove: folds
PlayTheBlues4U: folds
*** FLOP *** [Th 3d 2c]
pokerfacerr5: bets $0.41
yuni80: calls $0.41
*** TURN *** [Th 3d 2c] [Jd]
pokerfacerr5: bets $0.80
yuni80: calls $0.80
*** RIVER *** [Th 3d 2c Jd] [Ad]
pokerfacerr5: checks
yuni80: checks
*** SHOW DOWN ***
pokerfacerr5: shows [Jh 9d] (a pair of Jacks)
yuni80: mucks hand
pokerfacerr5 collected $3.11 from pot
*** SUMMARY ***
Total pot $3.27 | Rake $0.16
Board [Th 3d 2c Jd Ad]
Seat 2: yuni80 mucked [6h 4h]
Seat 3: KeithTurbo48 (button) folded before Flop (didn't bet)
Seat 4: SeaofLove (small blind) folded before Flop
Seat 5: PlayTheBlues4U (big blind) folded before Flop
Seat 6: pokerfacerr5 showed [Jh 9d] and won ($3.11) with a pair of Jacks


*********** # 192 **************
PokerStars Hand #203942559284:  Hold'em No Limit ($0.05/$0.10 USD) - 2019/09/24 23:28:42 ET
Table 'Camilla' 6-max Seat #2 is the button
Seat 2: yuni80 ($11.95 in chips)
Seat 3: KeithTurbo48 ($27.24 in chips)
Seat 4: SeaofLove ($20.26 in chips)
Seat 5: PlayTheBlues4U ($9.95 in chips)
Seat 6: pokerfacerr5 ($28.07 in chips)
KeithTurbo48: posts small blind $0.05
SeaofLove: posts big blind $0.10
*** HOLE CARDS ***
Dealt to PlayTheBlues4U [2s 8s]
PlayTheBlues4U: folds
pokerfacerr5: raises $0.25 to $0.35
yuni80: folds
KeithTurbo48: folds
SeaofLove: folds
Uncalled bet ($0.25) returned to pokerfacerr5
pokerfacerr5 collected $0.25 from pot
pokerfacerr5: doesn't show hand
*** SUMMARY ***
Total pot $0.25 | Rake $0
Seat 2: yuni80 (button) folded before Flop (didn't bet)
Seat 3: KeithTurbo48 (small blind) folded before Flop
Seat 4: SeaofLove (big blind) folded before Flop
Seat 5: PlayTheBlues4U folded before Flop (didn't bet)
Seat 6: pokerfacerr5 collected ($0.25)


*********** # 193 **************
PokerStars Hand #203942559233:  Hold'em No Limit ($0.05/$0.10 USD) - 2019/09/24 23:28:25 ET
Table 'Botein' 6-max Seat #2 is the button
Seat 1: trumpcaddy ($19.31 in chips)
Seat 2: Pezant ($11.37 in chips)
Seat 3: PlayTheBlues4U ($8.24 in chips)
Seat 4: traderneal ($7.28 in chips)
Seat 5: NBoula ($9.03 in chips)
Seat 6: Aikido85 ($4.25 in chips)
PlayTheBlues4U: posts small blind $0.05
traderneal: posts big blind $0.10
*** HOLE CARDS ***
Dealt to PlayTheBlues4U [Tc 8d]
NBoula: folds
Aikido85: calls $0.10
trumpcaddy: folds
Pezant: folds
PlayTheBlues4U: folds
traderneal: raises $0.50 to $0.60
Aikido85: folds
Uncalled bet ($0.50) returned to traderneal
traderneal collected $0.25 from pot
traderneal: doesn't show hand
*** SUMMARY ***
Total pot $0.25 | Rake $0
Seat 1: trumpcaddy folded before Flop (didn't bet)
Seat 2: Pezant (button) folded before Flop (didn't bet)
Seat 3: PlayTheBlues4U (small blind) folded before Flop
Seat 4: traderneal (big blind) collected ($0.25)
Seat 5: NBoula folded before Flop (didn't bet)
Seat 6: Aikido85 folded before Flop


*********** # 194 **************
PokerStars Hand #203942559177:  Hold'em No Limit ($0.05/$0.10 USD) - 2019/09/24 23:28:09 ET
Table 'Camilla' 6-max Seat #6 is the button
Seat 2: yuni80 ($12.05 in chips)
Seat 3: KeithTurbo48 ($27.15 in chips)
Seat 4: SeaofLove ($20.26 in chips)
Seat 5: PlayTheBlues4U ($9.95 in chips)
Seat 6: pokerfacerr5 ($28.07 in chips)
yuni80: posts small blind $0.05
KeithTurbo48: posts big blind $0.10
*** HOLE CARDS ***
Dealt to PlayTheBlues4U [Jc 4h]
SeaofLove: folds
PlayTheBlues4U: folds
pokerfacerr5: folds
yuni80: calls $0.05
KeithTurbo48: checks
*** FLOP *** [7d 7c 5c]
yuni80: checks
KeithTurbo48: checks
*** TURN *** [7d 7c 5c] [9d]
yuni80: checks
KeithTurbo48: checks
*** RIVER *** [7d 7c 5c 9d] [As]
yuni80: checks
KeithTurbo48: bets $0.10
yuni80: folds
Uncalled bet ($0.10) returned to KeithTurbo48
KeithTurbo48 collected $0.19 from pot
KeithTurbo48: doesn't show hand
*** SUMMARY ***
Total pot $0.20 | Rake $0.01
Board [7d 7c 5c 9d As]
Seat 2: yuni80 (small blind) folded on the River
Seat 3: KeithTurbo48 (big blind) collected ($0.19)
Seat 4: SeaofLove folded before Flop (didn't bet)
Seat 5: PlayTheBlues4U folded before Flop (didn't bet)
Seat 6: pokerfacerr5 (button) folded before Flop (didn't bet)


*********** # 195 **************
PokerStars Hand #203942559018:  Hold'em No Limit ($0.05/$0.10 USD) - 2019/09/24 23:27:20 ET
Table 'Camilla' 6-max Seat #5 is the button
Seat 2: yuni80 ($11.09 in chips)
Seat 3: KeithTurbo48 ($28.16 in chips)
Seat 4: SeaofLove ($20.26 in chips)
Seat 5: PlayTheBlues4U ($9.95 in chips)
Seat 6: pokerfacerr5 ($28.12 in chips)
pokerfacerr5: posts small blind $0.05
yuni80: posts big blind $0.10
*** HOLE CARDS ***
Dealt to PlayTheBlues4U [4d Tc]
KeithTurbo48: raises $0.15 to $0.25
SeaofLove: folds
PlayTheBlues4U: folds
pokerfacerr5: folds
yuni80: calls $0.15
*** FLOP *** [Kc Ac 7s]
yuni80: checks
KeithTurbo48: checks
*** TURN *** [Kc Ac 7s] [2h]
yuni80: checks
KeithTurbo48: bets $0.38
yuni80: raises $0.38 to $0.76
KeithTurbo48: calls $0.38
*** RIVER *** [Kc Ac 7s 2h] [9s]
yuni80: bets $3.80
KeithTurbo48: folds
Uncalled bet ($3.80) returned to yuni80
yuni80 collected $1.97 from pot
yuni80: doesn't show hand
*** SUMMARY ***
Total pot $2.07 | Rake $0.10
Board [Kc Ac 7s 2h 9s]
Seat 2: yuni80 (big blind) collected ($1.97)
Seat 3: KeithTurbo48 folded on the River
Seat 4: SeaofLove folded before Flop (didn't bet)
Seat 5: PlayTheBlues4U (button) folded before Flop (didn't bet)
Seat 6: pokerfacerr5 (small blind) folded before Flop


*********** # 196 **************
PokerStars Hand #203942558938:  Hold'em No Limit ($0.05/$0.10 USD) - 2019/09/24 23:26:57 ET
Table 'Botein' 6-max Seat #1 is the button
Seat 1: trumpcaddy ($19.41 in chips)
Seat 2: Pezant ($11.42 in chips)
Seat 3: PlayTheBlues4U ($8.34 in chips)
Seat 4: traderneal ($9.39 in chips)
Seat 5: NBoula ($9.03 in chips)
Seat 6: Aikido85 ($2.11 in chips)
Pezant: posts small blind $0.05
PlayTheBlues4U: posts big blind $0.10
*** HOLE CARDS ***
Dealt to PlayTheBlues4U [Qs Ts]
traderneal: calls $0.10
NBoula: folds
Aikido85: calls $0.10
trumpcaddy: calls $0.10
Pezant: folds
PlayTheBlues4U: checks
*** FLOP *** [Ah 2h 5s]
PlayTheBlues4U: checks
traderneal: checks
Aikido85: checks
trumpcaddy: checks
*** TURN *** [Ah 2h 5s] [6s]
PlayTheBlues4U: checks
traderneal: bets $0.50
Aikido85: calls $0.50
trumpcaddy: folds
PlayTheBlues4U: folds
*** RIVER *** [Ah 2h 5s 6s] [9c]
traderneal: bets $1.60
Aikido85: calls $1.51 and is all-in
Uncalled bet ($0.09) returned to traderneal
*** SHOW DOWN ***
traderneal: shows [6h 5c] (two pair, Sixes and Fives)
Aikido85: shows [5h 5d] (three of a kind, Fives)
Aikido85 collected $4.25 from pot
*** SUMMARY ***
Total pot $4.47 | Rake $0.22
Board [Ah 2h 5s 6s 9c]
Seat 1: trumpcaddy (button) folded on the Turn
Seat 2: Pezant (small blind) folded before Flop
Seat 3: PlayTheBlues4U (big blind) folded on the Turn
Seat 4: traderneal showed [6h 5c] and lost with two pair, Sixes and Fives
Seat 5: NBoula folded before Flop (didn't bet)
Seat 6: Aikido85 showed [5h 5d] and won ($4.25) with three of a kind, Fives


*********** # 197 **************
PokerStars Hand #203942558900:  Hold'em No Limit ($0.05/$0.10 USD) - 2019/09/24 23:26:44 ET
Table 'Camilla' 6-max Seat #4 is the button
Seat 2: yuni80 ($11.49 in chips)
Seat 3: KeithTurbo48 ($29.75 in chips)
Seat 4: SeaofLove ($20.26 in chips)
Seat 5: PlayTheBlues4U ($10 in chips)
Seat 6: pokerfacerr5 ($26.26 in chips)
PlayTheBlues4U: posts small blind $0.05
pokerfacerr5: posts big blind $0.10
*** HOLE CARDS ***
Dealt to PlayTheBlues4U [Qs 7c]
yuni80: calls $0.10
KeithTurbo48: raises $0.30 to $0.40
SeaofLove: folds
PlayTheBlues4U: folds
pokerfacerr5: calls $0.30
yuni80: calls $0.30
*** FLOP *** [6h 2d 8s]
pokerfacerr5: bets $1.19
yuni80: folds
KeithTurbo48: calls $1.19
*** TURN *** [6h 2d 8s] [4h]
pokerfacerr5: bets $1.73
KeithTurbo48: folds
Uncalled bet ($1.73) returned to pokerfacerr5
pokerfacerr5 collected $3.45 from pot
pokerfacerr5: doesn't show hand
*** SUMMARY ***
Total pot $3.63 | Rake $0.18
Board [6h 2d 8s 4h]
Seat 2: yuni80 folded on the Flop
Seat 3: KeithTurbo48 folded on the Turn
Seat 4: SeaofLove (button) folded before Flop (didn't bet)
Seat 5: PlayTheBlues4U (small blind) folded before Flop
Seat 6: pokerfacerr5 (big blind) collected ($3.45)


*********** # 198 **************
PokerStars Hand #203942558854:  Hold'em No Limit ($0.05/$0.10 USD) - 2019/09/24 23:26:28 ET
Table 'Botein' 6-max Seat #6 is the button
Seat 1: trumpcaddy ($19.46 in chips)
Seat 2: Pezant ($11.82 in chips)
Seat 3: PlayTheBlues4U ($8.34 in chips)
Seat 4: traderneal ($8.98 in chips)
Seat 5: NBoula ($9.03 in chips)
Seat 6: Aikido85 ($2.11 in chips)
trumpcaddy: posts small blind $0.05
Pezant: posts big blind $0.10
*** HOLE CARDS ***
Dealt to PlayTheBlues4U [4c 9s]
PlayTheBlues4U: folds
traderneal: raises $0.30 to $0.40
NBoula: folds
Aikido85: folds
trumpcaddy: folds
Pezant: calls $0.30
*** FLOP *** [4h Ts Kh]
Pezant: checks
traderneal: bets $0.80
Pezant: folds
Uncalled bet ($0.80) returned to traderneal
traderneal collected $0.81 from pot
traderneal: doesn't show hand
*** SUMMARY ***
Total pot $0.85 | Rake $0.04
Board [4h Ts Kh]
Seat 1: trumpcaddy (small blind) folded before Flop
Seat 2: Pezant (big blind) folded on the Flop
Seat 3: PlayTheBlues4U folded before Flop (didn't bet)
Seat 4: traderneal collected ($0.81)
Seat 5: NBoula folded before Flop (didn't bet)
Seat 6: Aikido85 (button) folded before Flop (didn't bet)


*********** # 199 **************
PokerStars Hand #203942558822:  Hold'em No Limit ($0.05/$0.10 USD) - 2019/09/24 23:26:16 ET
Table 'Camilla' 6-max Seat #3 is the button
Seat 2: yuni80 ($11.59 in chips)
Seat 3: KeithTurbo48 ($29.75 in chips)
Seat 4: SeaofLove ($20.31 in chips)
Seat 5: PlayTheBlues4U ($2.50 in chips)
Seat 6: pokerfacerr5 ($26.26 in chips)
SeaofLove: posts small blind $0.05
PlayTheBlues4U: posts big blind $0.10
*** HOLE CARDS ***
Dealt to PlayTheBlues4U [7h 4s]
pokerfacerr5: folds
yuni80: calls $0.10
KeithTurbo48: folds
SeaofLove: folds
PlayTheBlues4U: checks
*** FLOP *** [4h Ts Qd]
PlayTheBlues4U: checks
yuni80: checks
*** TURN *** [4h Ts Qd] [Js]
PlayTheBlues4U: checks
yuni80: checks
*** RIVER *** [4h Ts Qd Js] [6c]
PlayTheBlues4U: checks
yuni80: checks
*** SHOW DOWN ***
PlayTheBlues4U: shows [7h 4s] (a pair of Fours)
yuni80: mucks hand
PlayTheBlues4U collected $0.24 from pot
*** SUMMARY ***
Total pot $0.25 | Rake $0.01
Board [4h Ts Qd Js 6c]
Seat 2: yuni80 mucked [9d Ah]
Seat 3: KeithTurbo48 (button) folded before Flop (didn't bet)
Seat 4: SeaofLove (small blind) folded before Flop
Seat 5: PlayTheBlues4U (big blind) showed [7h 4s] and won ($0.24) with a pair of Fours
Seat 6: pokerfacerr5 folded before Flop (didn't bet)


*********** # 200 **************
PokerStars Hand #203942558775:  Hold'em No Limit ($0.05/$0.10 USD) - 2019/09/24 23:26:00 ET
Table 'Camilla' 6-max Seat #2 is the button
Seat 2: yuni80 ($11.59 in chips)
Seat 3: KeithTurbo48 ($29.65 in chips)
Seat 4: SeaofLove ($20.41 in chips)
Seat 5: PlayTheBlues4U ($2.50 in chips)
Seat 6: pokerfacerr5 ($26.26 in chips)
KeithTurbo48: posts small blind $0.05
SeaofLove: posts big blind $0.10
*** HOLE CARDS ***
Dealt to PlayTheBlues4U [6c Jc]
PlayTheBlues4U: folds
pokerfacerr5: folds
yuni80: folds
KeithTurbo48: raises $0.20 to $0.30
SeaofLove: folds
Uncalled bet ($0.20) returned to KeithTurbo48
KeithTurbo48 collected $0.20 from pot
KeithTurbo48: doesn't show hand
*** SUMMARY ***
Total pot $0.20 | Rake $0
Seat 2: yuni80 (button) folded before Flop (didn't bet)
Seat 3: KeithTurbo48 (small blind) collected ($0.20)
Seat 4: SeaofLove (big blind) folded before Flop
Seat 5: PlayTheBlues4U folded before Flop (didn't bet)
Seat 6: pokerfacerr5 folded before Flop (didn't bet)



If you have any questions, please contact us at "PokerStars Support" <support@pokerstarsnj.com>


You are receiving this email as a customer of The Stars Group (TSG), who operate brands that are accessed using a Stars Account.

For more information, please visit http://www.pokerstarsnj.com/starsaccount.

TSG Interactive US Services Limited, 1133 Boardwalk, Atlantic City, NJ 08401.



