PokerStars Hand #203492936567:  Hold'em No Limit ($0.02/$0.05 USD) - 2019/09/07 10:52:22 ET
Table 'Scorpius' 6-max Seat #4 is the button
Seat 2: Reignerrr ($5 in chips)
Seat 4: PlayTheBlues4U ($6 in chips)
Seat 5: zepped88 ($3.48 in chips)
zepped88: posts small blind $0.02
Reignerrr: posts big blind $0.05
*** HOLE CARDS ***
Dealt to PlayTheBlues4U [Jc 8s]
PlayTheBlues4U: folds
zepped88: folds
Uncalled bet ($0.03) returned to Reignerrr
Reignerrr collected $0.04 from pot
Reignerrr: doesn't show hand
*** SUMMARY ***
Total pot $0.04 | Rake $0
Seat 2: Reignerrr (big blind) collected ($0.04)
Seat 4: PlayTheBlues4U (button) folded before Flop (didn't bet)
Seat 5: zepped88 (small blind) folded before Flop


PokerStars Hand #203492936520:  Hold'em No Limit ($0.02/$0.05 USD) - 2019/09/07 10:51:48 ET
Table 'Scorpius' 6-max Seat #2 is the button
Seat 2: Reignerrr ($5 in chips)
Seat 4: PlayTheBlues4U ($6.40 in chips)
Seat 5: zepped88 ($3.12 in chips)
PlayTheBlues4U: posts small blind $0.02
zepped88: posts big blind $0.05
*** HOLE CARDS ***
Dealt to PlayTheBlues4U [4s As]
Reignerrr: folds
PlayTheBlues4U: raises $0.05 to $0.10
zepped88: calls $0.05
*** FLOP *** [5h Th 7h]
PlayTheBlues4U: bets $0.10
zepped88: calls $0.10
*** TURN *** [5h Th 7h] [3h]
PlayTheBlues4U: bets $0.20
zepped88: calls $0.20
*** RIVER *** [5h Th 7h 3h] [Ah]
PlayTheBlues4U: checks
zepped88: checks
*** SHOW DOWN ***
PlayTheBlues4U: shows [4s As] (a flush, Ace high)
zepped88: shows [9h Ac] (a flush, Ace high - Nine higher)
zepped88 collected $0.76 from pot
*** SUMMARY ***
Total pot $0.80 | Rake $0.04
Board [5h Th 7h 3h Ah]
Seat 2: Reignerrr (button) folded before Flop (didn't bet)
Seat 4: PlayTheBlues4U (small blind) showed [4s As] and lost with a flush, Ace high
Seat 5: zepped88 (big blind) showed [9h Ac] and won ($0.76) with a flush, Ace high


PokerStars Hand #203492936494:  Hold'em No Limit ($0.02/$0.05 USD) - 2019/09/07 10:51:23 ET
Table 'Scorpius' 6-max Seat #5 is the button
Seat 2: Reignerrr ($5 in chips)
Seat 4: PlayTheBlues4U ($6.45 in chips)
Seat 5: zepped88 ($3.06 in chips)
Reignerrr: posts small blind $0.02
PlayTheBlues4U: posts big blind $0.05
*** HOLE CARDS ***
Dealt to PlayTheBlues4U [6d Jc]
zepped88: calls $0.05
Reignerrr: folds
PlayTheBlues4U: checks
*** FLOP *** [7c 3c 4h]
PlayTheBlues4U: checks
zepped88: bets $0.05
PlayTheBlues4U: folds
Uncalled bet ($0.05) returned to zepped88
zepped88 collected $0.11 from pot
zepped88: doesn't show hand
*** SUMMARY ***
Total pot $0.12 | Rake $0.01
Board [7c 3c 4h]
Seat 2: Reignerrr (small blind) folded before Flop
Seat 4: PlayTheBlues4U (big blind) folded on the Flop
Seat 5: zepped88 (button) collected ($0.11)


PokerStars Hand #203492936422:  Hold'em No Limit ($0.02/$0.05 USD) - 2019/09/07 10:50:26 ET
Table 'Scorpius' 6-max Seat #4 is the button
Seat 2: Reignerrr ($5 in chips)
Seat 4: PlayTheBlues4U ($6.03 in chips)
Seat 5: zepped88 ($3.08 in chips)
Seat 6: marimba 104 ($5.70 in chips)
zepped88: posts small blind $0.02
marimba 104: posts big blind $0.05
*** HOLE CARDS ***
Dealt to PlayTheBlues4U [3s Ad]
Reignerrr: folds
PlayTheBlues4U: calls $0.05
zepped88: folds
marimba 104: checks
*** FLOP *** [6h 3d Ah]
marimba 104: checks
PlayTheBlues4U: bets $0.10
marimba 104: calls $0.10
*** TURN *** [6h 3d Ah] [5d]
marimba 104: checks
PlayTheBlues4U: bets $0.30
marimba 104: calls $0.30
*** RIVER *** [6h 3d Ah 5d] [Jd]
marimba 104: checks
PlayTheBlues4U: bets $0.50
marimba 104: folds
Uncalled bet ($0.50) returned to PlayTheBlues4U
marimba 104 leaves the table
PlayTheBlues4U collected $0.87 from pot
PlayTheBlues4U: doesn't show hand
*** SUMMARY ***
Total pot $0.92 | Rake $0.05
Board [6h 3d Ah 5d Jd]
Seat 2: Reignerrr folded before Flop (didn't bet)
Seat 4: PlayTheBlues4U (button) collected ($0.87)
Seat 5: zepped88 (small blind) folded before Flop
Seat 6: marimba 104 (big blind) folded on the River


PokerStars Hand #203492936350:  Hold'em No Limit ($0.02/$0.05 USD) - 2019/09/07 10:49:21 ET
Table 'Scorpius' 6-max Seat #2 is the button
Seat 2: Reignerrr ($5 in chips)
Seat 3: oldhippieVii ($5.35 in chips)
Seat 4: PlayTheBlues4U ($6.08 in chips)
Seat 5: zepped88 ($3.08 in chips)
Seat 6: marimba 104 ($6.05 in chips)
oldhippieVii: posts small blind $0.02
PlayTheBlues4U: posts big blind $0.05
*** HOLE CARDS ***
Dealt to PlayTheBlues4U [8d 3c]
zepped88: folds
marimba 104: calls $0.05
Reignerrr: folds
oldhippieVii: calls $0.03
PlayTheBlues4U: checks
*** FLOP *** [Ah Td Qs]
oldhippieVii: checks
PlayTheBlues4U: checks
marimba 104: bets $0.15
oldhippieVii: calls $0.15
PlayTheBlues4U: folds
*** TURN *** [Ah Td Qs] [3s]
oldhippieVii: checks
marimba 104: bets $0.15
oldhippieVii: calls $0.15
*** RIVER *** [Ah Td Qs 3s] [Kc]
oldhippieVii: checks
marimba 104: checks
*** SHOW DOWN ***
oldhippieVii: shows [Th Ks] (two pair, Kings and Tens)
marimba 104: mucks hand
oldhippieVii collected $0.71 from pot
*** SUMMARY ***
Total pot $0.75 | Rake $0.04
Board [Ah Td Qs 3s Kc]
Seat 2: Reignerrr (button) folded before Flop (didn't bet)
Seat 3: oldhippieVii (small blind) showed [Th Ks] and won ($0.71) with two pair, Kings and Tens
Seat 4: PlayTheBlues4U (big blind) folded on the Flop
Seat 5: zepped88 folded before Flop (didn't bet)
Seat 6: marimba 104 mucked [As 5d]


PokerStars Hand #203492936340:  Hold'em No Limit ($0.02/$0.05 USD) - 2019/09/07 10:49:13 ET
Table 'Scorpius' 6-max Seat #6 is the button
Seat 2: Reignerrr ($5 in chips)
Seat 3: oldhippieVii ($5.33 in chips)
Seat 4: PlayTheBlues4U ($6.08 in chips)
Seat 5: zepped88 ($3.08 in chips)
Seat 6: marimba 104 ($6.05 in chips)
Reignerrr: posts small blind $0.02
oldhippieVii: posts big blind $0.05
*** HOLE CARDS ***
Dealt to PlayTheBlues4U [3h 9c]
PlayTheBlues4U: folds
zepped88: folds
marimba 104: folds
Reignerrr: folds
Uncalled bet ($0.03) returned to oldhippieVii
oldhippieVii collected $0.04 from pot
oldhippieVii: doesn't show hand
*** SUMMARY ***
Total pot $0.04 | Rake $0
Seat 2: Reignerrr (small blind) folded before Flop
Seat 3: oldhippieVii (big blind) collected ($0.04)
Seat 4: PlayTheBlues4U folded before Flop (didn't bet)
Seat 5: zepped88 folded before Flop (didn't bet)
Seat 6: marimba 104 (button) folded before Flop (didn't bet)


PokerStars Hand #203492936289:  Hold'em No Limit ($0.02/$0.05 USD) - 2019/09/07 10:48:38 ET
Table 'Scorpius' 6-max Seat #5 is the button
Seat 2: Reignerrr ($5 in chips)
Seat 3: oldhippieVii ($5.27 in chips)
Seat 4: PlayTheBlues4U ($6.08 in chips)
Seat 5: zepped88 ($3.08 in chips)
Seat 6: marimba 104 ($6.07 in chips)
marimba 104: posts small blind $0.02
Reignerrr: posts big blind $0.05
*** HOLE CARDS ***
Dealt to PlayTheBlues4U [Kd 5h]
oldhippieVii: calls $0.05
PlayTheBlues4U: folds
zepped88: folds
marimba 104: folds
Reignerrr: checks
*** FLOP *** [5c 3c 2d]
Reignerrr: checks
oldhippieVii: bets $0.11
Reignerrr: folds
Uncalled bet ($0.11) returned to oldhippieVii
oldhippieVii collected $0.11 from pot
oldhippieVii: doesn't show hand
*** SUMMARY ***
Total pot $0.12 | Rake $0.01
Board [5c 3c 2d]
Seat 2: Reignerrr (big blind) folded on the Flop
Seat 3: oldhippieVii collected ($0.11)
Seat 4: PlayTheBlues4U folded before Flop (didn't bet)
Seat 5: zepped88 (button) folded before Flop (didn't bet)
Seat 6: marimba 104 (small blind) folded before Flop


PokerStars Hand #203492936272:  Hold'em No Limit ($0.02/$0.05 USD) - 2019/09/07 10:48:22 ET
Table 'Scorpius' 6-max Seat #4 is the button
Seat 2: Reignerrr ($5 in chips)
Seat 3: oldhippieVii ($5.27 in chips)
Seat 4: PlayTheBlues4U ($6.01 in chips)
Seat 5: zepped88 ($3.10 in chips)
Seat 6: marimba 104 ($6.12 in chips)
zepped88: posts small blind $0.02
marimba 104: posts big blind $0.05
*** HOLE CARDS ***
Dealt to PlayTheBlues4U [Qd Th]
Reignerrr: folds
oldhippieVii: folds
PlayTheBlues4U: raises $0.10 to $0.15
zepped88: folds
marimba 104: folds
Uncalled bet ($0.10) returned to PlayTheBlues4U
PlayTheBlues4U collected $0.12 from pot
PlayTheBlues4U: doesn't show hand
*** SUMMARY ***
Total pot $0.12 | Rake $0
Seat 2: Reignerrr folded before Flop (didn't bet)
Seat 3: oldhippieVii folded before Flop (didn't bet)
Seat 4: PlayTheBlues4U (button) collected ($0.12)
Seat 5: zepped88 (small blind) folded before Flop
Seat 6: marimba 104 (big blind) folded before Flop


PokerStars Hand #203492936247:  Hold'em No Limit ($0.02/$0.05 USD) - 2019/09/07 10:48:04 ET
Table 'Scorpius' 6-max Seat #3 is the button
Seat 2: Reignerrr ($5 in chips)
Seat 3: oldhippieVii ($5.27 in chips)
Seat 4: PlayTheBlues4U ($6.03 in chips)
Seat 5: zepped88 ($3.15 in chips)
Seat 6: marimba 104 ($6.06 in chips)
PlayTheBlues4U: posts small blind $0.02
zepped88: posts big blind $0.05
*** HOLE CARDS ***
Dealt to PlayTheBlues4U [7c 5h]
marimba 104: calls $0.05
Reignerrr: folds
oldhippieVii: folds
PlayTheBlues4U: folds
zepped88: checks
*** FLOP *** [9d Jh 6s]
zepped88: checks
marimba 104: bets $0.15
zepped88: folds
Uncalled bet ($0.15) returned to marimba 104
marimba 104 collected $0.11 from pot
marimba 104: doesn't show hand
*** SUMMARY ***
Total pot $0.12 | Rake $0.01
Board [9d Jh 6s]
Seat 2: Reignerrr folded before Flop (didn't bet)
Seat 3: oldhippieVii (button) folded before Flop (didn't bet)
Seat 4: PlayTheBlues4U (small blind) folded before Flop
Seat 5: zepped88 (big blind) folded on the Flop
Seat 6: marimba 104 collected ($0.11)


PokerStars Hand #203492936226:  Hold'em No Limit ($0.02/$0.05 USD) - 2019/09/07 10:47:50 ET
Table 'Scorpius' 6-max Seat #2 is the button
Seat 1: R@ngers94 ($4.45 in chips)
Seat 2: Reignerrr ($5 in chips)
Seat 3: oldhippieVii ($5.29 in chips)
Seat 4: PlayTheBlues4U ($6.08 in chips)
Seat 5: zepped88 ($3.08 in chips)
Seat 6: marimba 104 ($6.06 in chips)
oldhippieVii: posts small blind $0.02
PlayTheBlues4U: posts big blind $0.05
*** HOLE CARDS ***
Dealt to PlayTheBlues4U [4c Qh]
zepped88: raises $0.05 to $0.10
marimba 104: folds
R@ngers94: folds
Reignerrr: folds
oldhippieVii: folds
PlayTheBlues4U: folds
Uncalled bet ($0.05) returned to zepped88
R@ngers94 leaves the table
zepped88 collected $0.12 from pot
zepped88: doesn't show hand
*** SUMMARY ***
Total pot $0.12 | Rake $0
Seat 1: R@ngers94 folded before Flop (didn't bet)
Seat 2: Reignerrr (button) folded before Flop (didn't bet)
Seat 3: oldhippieVii (small blind) folded before Flop
Seat 4: PlayTheBlues4U (big blind) folded before Flop
Seat 5: zepped88 collected ($0.12)
Seat 6: marimba 104 folded before Flop (didn't bet)


PokerStars Hand #203492936153:  Hold'em No Limit ($0.02/$0.05 USD) - 2019/09/07 10:47:01 ET
Table 'Scorpius' 6-max Seat #1 is the button
Seat 1: R@ngers94 ($4.50 in chips)
Seat 2: Reignerrr ($5 in chips)
Seat 3: oldhippieVii ($5.34 in chips)
Seat 4: PlayTheBlues4U ($6.08 in chips)
Seat 5: zepped88 ($3.13 in chips)
Seat 6: marimba 104 ($5.90 in chips)
Reignerrr: posts small blind $0.02
oldhippieVii: posts big blind $0.05
*** HOLE CARDS ***
Dealt to PlayTheBlues4U [7s 2h]
PlayTheBlues4U: folds
zepped88: calls $0.05
marimba 104: calls $0.05
R@ngers94: calls $0.05
Reignerrr: folds
oldhippieVii: checks
*** FLOP *** [Kc Tc 9d]
oldhippieVii: checks
zepped88: checks
marimba 104: checks
R@ngers94: checks
*** TURN *** [Kc Tc 9d] [4s]
oldhippieVii: checks
zepped88: checks
marimba 104: bets $0.10
R@ngers94: folds
oldhippieVii: folds
zepped88: folds
Uncalled bet ($0.10) returned to marimba 104
marimba 104 collected $0.21 from pot
marimba 104: doesn't show hand
*** SUMMARY ***
Total pot $0.22 | Rake $0.01
Board [Kc Tc 9d 4s]
Seat 1: R@ngers94 (button) folded on the Turn
Seat 2: Reignerrr (small blind) folded before Flop
Seat 3: oldhippieVii (big blind) folded on the Turn
Seat 4: PlayTheBlues4U folded before Flop (didn't bet)
Seat 5: zepped88 folded on the Turn
Seat 6: marimba 104 collected ($0.21)


PokerStars Hand #203492936030:  Hold'em No Limit ($0.02/$0.05 USD) - 2019/09/07 10:45:24 ET
Table 'Scorpius' 6-max Seat #6 is the button
Seat 1: R@ngers94 ($4.55 in chips)
Seat 2: Reignerrr ($5 in chips)
Seat 3: oldhippieVii ($6.14 in chips)
Seat 4: PlayTheBlues4U ($6.08 in chips)
Seat 5: zepped88 ($3.18 in chips)
Seat 6: marimba 104 ($4.80 in chips)
R@ngers94: posts small blind $0.02
Reignerrr: posts big blind $0.05
*** HOLE CARDS ***
Dealt to PlayTheBlues4U [9s Td]
oldhippieVii: calls $0.05
PlayTheBlues4U has timed out
PlayTheBlues4U: folds
zepped88: calls $0.05
marimba 104: calls $0.05
R@ngers94: calls $0.03
Reignerrr: raises $0.25 to $0.30
oldhippieVii: calls $0.25
zepped88: folds
marimba 104: calls $0.25
R@ngers94: folds
*** FLOP *** [Qs Kh 3h]
Reignerrr: checks
oldhippieVii: checks
marimba 104: bets $0.25
Reignerrr: folds
oldhippieVii: calls $0.25
*** TURN *** [Qs Kh 3h] [Jd]
oldhippieVii: checks
marimba 104: bets $0.25
oldhippieVii: calls $0.25
*** RIVER *** [Qs Kh 3h Jd] [Kd]
oldhippieVii: checks
marimba 104: checks
*** SHOW DOWN ***
oldhippieVii: shows [As 2s] (a pair of Kings)
marimba 104: shows [9c Qc] (two pair, Kings and Queens)
marimba 104 collected $1.90 from pot
*** SUMMARY ***
Total pot $2 | Rake $0.10
Board [Qs Kh 3h Jd Kd]
Seat 1: R@ngers94 (small blind) folded before Flop
Seat 2: Reignerrr (big blind) folded on the Flop
Seat 3: oldhippieVii showed [As 2s] and lost with a pair of Kings
Seat 4: PlayTheBlues4U folded before Flop (didn't bet)
Seat 5: zepped88 folded before Flop
Seat 6: marimba 104 (button) showed [9c Qc] and won ($1.90) with two pair, Kings and Queens


PokerStars Hand #203492936010:  Hold'em No Limit ($0.02/$0.05 USD) - 2019/09/07 10:45:09 ET
Table 'Scorpius' 6-max Seat #5 is the button
Seat 1: R@ngers94 ($4.60 in chips)
Seat 2: Reignerrr ($5 in chips)
Seat 3: oldhippieVii ($6.07 in chips)
Seat 4: PlayTheBlues4U ($6.08 in chips)
Seat 5: zepped88 ($3.18 in chips)
Seat 6: marimba 104 ($4.82 in chips)
marimba 104: posts small blind $0.02
R@ngers94: posts big blind $0.05
*** HOLE CARDS ***
Dealt to PlayTheBlues4U [Ac 2s]
Reignerrr: folds
oldhippieVii: raises $0.10 to $0.15
PlayTheBlues4U: folds
zepped88: folds
marimba 104: folds
R@ngers94: folds
Uncalled bet ($0.10) returned to oldhippieVii
oldhippieVii collected $0.12 from pot
oldhippieVii: doesn't show hand
*** SUMMARY ***
Total pot $0.12 | Rake $0
Seat 1: R@ngers94 (big blind) folded before Flop
Seat 2: Reignerrr folded before Flop (didn't bet)
Seat 3: oldhippieVii collected ($0.12)
Seat 4: PlayTheBlues4U folded before Flop (didn't bet)
Seat 5: zepped88 (button) folded before Flop (didn't bet)
Seat 6: marimba 104 (small blind) folded before Flop


PokerStars Hand #203492935932:  Hold'em No Limit ($0.02/$0.05 USD) - 2019/09/07 10:44:15 ET
Table 'Scorpius' 6-max Seat #4 is the button
Seat 1: R@ngers94 ($4.31 in chips)
Seat 2: Reignerrr ($5 in chips)
Seat 3: oldhippieVii ($6.32 in chips)
Seat 4: PlayTheBlues4U ($6.08 in chips)
Seat 5: zepped88 ($3.20 in chips)
Seat 6: marimba 104 ($4.87 in chips)
zepped88: posts small blind $0.02
marimba 104: posts big blind $0.05
*** HOLE CARDS ***
Dealt to PlayTheBlues4U [5d 4d]
R@ngers94: raises $0.05 to $0.10
Reignerrr: folds
oldhippieVii: calls $0.10
PlayTheBlues4U: folds
zepped88: folds
marimba 104: folds
*** FLOP *** [6c 7c Td]
R@ngers94: bets $0.15
oldhippieVii: calls $0.15
*** TURN *** [6c 7c Td] [Jd]
R@ngers94: checks
oldhippieVii: checks
*** RIVER *** [6c 7c Td Jd] [Ks]
R@ngers94: bets $0.55
oldhippieVii: folds
Uncalled bet ($0.55) returned to R@ngers94
R@ngers94 collected $0.54 from pot
R@ngers94: doesn't show hand
*** SUMMARY ***
Total pot $0.57 | Rake $0.03
Board [6c 7c Td Jd Ks]
Seat 1: R@ngers94 collected ($0.54)
Seat 2: Reignerrr folded before Flop (didn't bet)
Seat 3: oldhippieVii folded on the River
Seat 4: PlayTheBlues4U (button) folded before Flop (didn't bet)
Seat 5: zepped88 (small blind) folded before Flop
Seat 6: marimba 104 (big blind) folded before Flop


PokerStars Hand #203492935871:  Hold'em No Limit ($0.02/$0.05 USD) - 2019/09/07 10:43:23 ET
Table 'Scorpius' 6-max Seat #3 is the button
Seat 1: R@ngers94 ($4.36 in chips)
Seat 2: Reignerrr ($5 in chips)
Seat 3: oldhippieVii ($6.47 in chips)
Seat 4: PlayTheBlues4U ($6.10 in chips)
Seat 5: zepped88 ($3 in chips)
Seat 6: marimba 104 ($4.87 in chips)
PlayTheBlues4U: posts small blind $0.02
zepped88: posts big blind $0.05
*** HOLE CARDS ***
Dealt to PlayTheBlues4U [8d 5h]
marimba 104: folds
R@ngers94: calls $0.05
Reignerrr: folds
oldhippieVii: calls $0.05
PlayTheBlues4U: folds
zepped88: raises $0.10 to $0.15
R@ngers94: folds
oldhippieVii: calls $0.10
*** FLOP *** [4s 3c Jd]
zepped88: checks
oldhippieVii: checks
*** TURN *** [4s 3c Jd] [9h]
zepped88: checks
oldhippieVii: checks
*** RIVER *** [4s 3c Jd 9h] [9d]
zepped88: checks
oldhippieVii: checks
*** SHOW DOWN ***
zepped88: shows [As Qh] (a pair of Nines)
oldhippieVii: mucks hand
zepped88 collected $0.35 from pot
*** SUMMARY ***
Total pot $0.37 | Rake $0.02
Board [4s 3c Jd 9h 9d]
Seat 1: R@ngers94 folded before Flop
Seat 2: Reignerrr folded before Flop (didn't bet)
Seat 3: oldhippieVii (button) mucked [Ac 6c]
Seat 4: PlayTheBlues4U (small blind) folded before Flop
Seat 5: zepped88 (big blind) showed [As Qh] and won ($0.35) with a pair of Nines
Seat 6: marimba 104 folded before Flop (didn't bet)


PokerStars Hand #203492935812:  Hold'em No Limit ($0.02/$0.05 USD) - 2019/09/07 10:42:31 ET
Table 'Scorpius' 6-max Seat #2 is the button
Seat 1: R@ngers94 ($4.41 in chips)
Seat 2: Reignerrr ($5 in chips)
Seat 3: oldhippieVii ($6.52 in chips)
Seat 4: PlayTheBlues4U ($6.01 in chips)
Seat 6: marimba 104 ($4.87 in chips)
oldhippieVii: posts small blind $0.02
PlayTheBlues4U: posts big blind $0.05
*** HOLE CARDS ***
Dealt to PlayTheBlues4U [7h Js]
marimba 104: folds
R@ngers94: calls $0.05
Reignerrr: folds
oldhippieVii: calls $0.03
PlayTheBlues4U: checks
*** FLOP *** [8c Ah Jd]
oldhippieVii: checks
PlayTheBlues4U: checks
R@ngers94: checks
*** TURN *** [8c Ah Jd] [2s]
oldhippieVii: checks
PlayTheBlues4U: bets $0.15
R@ngers94: folds
zepped88 joins the table at seat #5
oldhippieVii: folds
Uncalled bet ($0.15) returned to PlayTheBlues4U
PlayTheBlues4U collected $0.14 from pot
PlayTheBlues4U: doesn't show hand
*** SUMMARY ***
Total pot $0.15 | Rake $0.01
Board [8c Ah Jd 2s]
Seat 1: R@ngers94 folded on the Turn
Seat 2: Reignerrr (button) folded before Flop (didn't bet)
Seat 3: oldhippieVii (small blind) folded on the Turn
Seat 4: PlayTheBlues4U (big blind) collected ($0.14)
Seat 6: marimba 104 folded before Flop (didn't bet)


PokerStars Hand #203492935784:  Hold'em No Limit ($0.02/$0.05 USD) - 2019/09/07 10:42:01 ET
Table 'Scorpius' 6-max Seat #1 is the button
Seat 1: R@ngers94 ($4.58 in chips)
Seat 2: Reignerrr ($5 in chips)
Seat 3: oldhippieVii ($6.57 in chips)
Seat 4: PlayTheBlues4U ($5.79 in chips)
Seat 6: marimba 104 ($4.87 in chips)
Reignerrr: posts small blind $0.02
oldhippieVii: posts big blind $0.05
*** HOLE CARDS ***
Dealt to PlayTheBlues4U [Ac Kh]
PlayTheBlues4U: raises $0.12 to $0.17
marimba 104: folds
R@ngers94: calls $0.17
Reignerrr: folds
oldhippieVii: folds
*** FLOP *** [Qd 3d Kd]
PlayTheBlues4U: bets $0.30
R@ngers94: folds
Uncalled bet ($0.30) returned to PlayTheBlues4U
PlayTheBlues4U collected $0.39 from pot
PlayTheBlues4U: doesn't show hand
*** SUMMARY ***
Total pot $0.41 | Rake $0.02
Board [Qd 3d Kd]
Seat 1: R@ngers94 (button) folded on the Flop
Seat 2: Reignerrr (small blind) folded before Flop
Seat 3: oldhippieVii (big blind) folded before Flop
Seat 4: PlayTheBlues4U collected ($0.39)
Seat 6: marimba 104 folded before Flop (didn't bet)


PokerStars Hand #203492935741:  Hold'em No Limit ($0.02/$0.05 USD) - 2019/09/07 10:41:27 ET
Table 'Scorpius' 6-max Seat #6 is the button
Seat 1: R@ngers94 ($4.68 in chips)
Seat 2: Reignerrr ($5 in chips)
Seat 4: PlayTheBlues4U ($5.79 in chips)
Seat 6: marimba 104 ($4.69 in chips)
R@ngers94: posts small blind $0.02
Reignerrr: posts big blind $0.05
oldhippieVii: sits out
*** HOLE CARDS ***
Dealt to PlayTheBlues4U [4s Ad]
PlayTheBlues4U: folds
marimba 104: calls $0.05
R@ngers94: raises $0.05 to $0.10
Reignerrr: calls $0.05
marimba 104: calls $0.05
*** FLOP *** [9s 9h 9d]
R@ngers94: checks
Reignerrr: checks
marimba 104: checks
*** TURN *** [9s 9h 9d] [6d]
R@ngers94: checks
Reignerrr: checks
marimba 104: checks
*** RIVER *** [9s 9h 9d 6d] [8s]
R@ngers94: checks
Reignerrr: checks
marimba 104: bets $0.15
R@ngers94: folds
Reignerrr: folds
Uncalled bet ($0.15) returned to marimba 104
marimba 104 collected $0.28 from pot
marimba 104: doesn't show hand
*** SUMMARY ***
Total pot $0.30 | Rake $0.02
Board [9s 9h 9d 6d 8s]
Seat 1: R@ngers94 (small blind) folded on the River
Seat 2: Reignerrr (big blind) folded on the River
Seat 4: PlayTheBlues4U folded before Flop (didn't bet)
Seat 6: marimba 104 (button) collected ($0.28)


PokerStars Hand #203492935724:  Hold'em No Limit ($0.02/$0.05 USD) - 2019/09/07 10:41:09 ET
Table 'Scorpius' 6-max Seat #5 is the button
Seat 1: R@ngers94 ($4.73 in chips)
Seat 2: Reignerrr ($5 in chips)
Seat 4: PlayTheBlues4U ($5.72 in chips)
Seat 5: joemli3 ($2.76 in chips)
Seat 6: marimba 104 ($4.71 in chips)
marimba 104: posts small blind $0.02
R@ngers94: posts big blind $0.05
oldhippieVii: sits out
*** HOLE CARDS ***
Dealt to PlayTheBlues4U [Ac Qc]
Reignerrr: folds
PlayTheBlues4U: raises $0.15 to $0.20
joemli3: folds
joemli3 leaves the table
marimba 104: folds
R@ngers94: folds
Uncalled bet ($0.15) returned to PlayTheBlues4U
PlayTheBlues4U collected $0.12 from pot
PlayTheBlues4U: doesn't show hand
*** SUMMARY ***
Total pot $0.12 | Rake $0
Seat 1: R@ngers94 (big blind) folded before Flop
Seat 2: Reignerrr folded before Flop (didn't bet)
Seat 4: PlayTheBlues4U collected ($0.12)
Seat 5: joemli3 (button) folded before Flop (didn't bet)
Seat 6: marimba 104 (small blind) folded before Flop


PokerStars Hand #203492935673:  Hold'em No Limit ($0.02/$0.05 USD) - 2019/09/07 10:40:25 ET
Table 'Scorpius' 6-max Seat #4 is the button
Seat 1: R@ngers94 ($4.73 in chips)
Seat 2: Reignerrr ($5 in chips)
Seat 4: PlayTheBlues4U ($5.82 in chips)
Seat 5: joemli3 ($2.78 in chips)
Seat 6: marimba 104 ($4.60 in chips)
joemli3: posts small blind $0.02
marimba 104: posts big blind $0.05
oldhippieVii: sits out
*** HOLE CARDS ***
Dealt to PlayTheBlues4U [9d Tc]
R@ngers94: folds
Reignerrr: folds
PlayTheBlues4U: calls $0.05
joemli3: folds
marimba 104: checks
*** FLOP *** [6h Ad Jc]
marimba 104: checks
PlayTheBlues4U: bets $0.05
marimba 104: calls $0.05
*** TURN *** [6h Ad Jc] [Jd]
marimba 104: checks
PlayTheBlues4U: checks
*** RIVER *** [6h Ad Jc Jd] [3c]
marimba 104: bets $0.10
PlayTheBlues4U: folds
Uncalled bet ($0.10) returned to marimba 104
marimba 104 collected $0.21 from pot
marimba 104: doesn't show hand
*** SUMMARY ***
Total pot $0.22 | Rake $0.01
Board [6h Ad Jc Jd 3c]
Seat 1: R@ngers94 folded before Flop (didn't bet)
Seat 2: Reignerrr folded before Flop (didn't bet)
Seat 4: PlayTheBlues4U (button) folded on the River
Seat 5: joemli3 (small blind) folded before Flop
Seat 6: marimba 104 (big blind) collected ($0.21)


PokerStars Hand #203492935632:  Hold'em No Limit ($0.02/$0.05 USD) - 2019/09/07 10:39:47 ET
Table 'Scorpius' 6-max Seat #2 is the button
Seat 1: R@ngers94 ($5.03 in chips)
Seat 2: Reignerrr ($5 in chips)
Seat 4: PlayTheBlues4U ($5.84 in chips)
Seat 5: joemli3 ($2.83 in chips)
Seat 6: marimba 104 ($4.26 in chips)
PlayTheBlues4U: posts small blind $0.02
joemli3: posts big blind $0.05
*** HOLE CARDS ***
Dealt to PlayTheBlues4U [6s 4h]
AJalexanderAJ leaves the table
marimba 104: calls $0.05
oldhippieVii joins the table at seat #3
R@ngers94: raises $0.05 to $0.10
Reignerrr: folds
PlayTheBlues4U: folds
joemli3: folds
marimba 104: calls $0.05
*** FLOP *** [3s Ac 2h]
marimba 104: checks
R@ngers94: checks
*** TURN *** [3s Ac 2h] [Ts]
marimba 104: bets $0.10
R@ngers94: calls $0.10
*** RIVER *** [3s Ac 2h Ts] [5s]
marimba 104: bets $0.10
R@ngers94: calls $0.10
*** SHOW DOWN ***
marimba 104: shows [As Td] (two pair, Aces and Tens)
R@ngers94: mucks hand
marimba 104 collected $0.64 from pot
*** SUMMARY ***
Total pot $0.67 | Rake $0.03
Board [3s Ac 2h Ts 5s]
Seat 1: R@ngers94 mucked [Tc Kh]
Seat 2: Reignerrr (button) folded before Flop (didn't bet)
Seat 4: PlayTheBlues4U (small blind) folded before Flop
Seat 5: joemli3 (big blind) folded before Flop
Seat 6: marimba 104 showed [As Td] and won ($0.64) with two pair, Aces and Tens


PokerStars Hand #203492935593:  Hold'em No Limit ($0.02/$0.05 USD) - 2019/09/07 10:39:11 ET
Table 'Scorpius' 6-max Seat #1 is the button
Seat 1: R@ngers94 ($4.97 in chips)
Seat 2: Reignerrr ($5 in chips)
Seat 3: AJalexanderAJ ($8.54 in chips)
Seat 4: PlayTheBlues4U ($5.84 in chips)
Seat 5: joemli3 ($2.83 in chips)
Seat 6: marimba 104 ($4.26 in chips)
Reignerrr: posts small blind $0.02
AJalexanderAJ: posts big blind $0.05
*** HOLE CARDS ***
Dealt to PlayTheBlues4U [7s Tc]
PlayTheBlues4U: folds
joemli3: folds
marimba 104: folds
R@ngers94: calls $0.05
Reignerrr: folds
AJalexanderAJ: checks
*** FLOP *** [9s Jh 4c]
AJalexanderAJ: checks
R@ngers94: bets $0.05
AJalexanderAJ: folds
Uncalled bet ($0.05) returned to R@ngers94
R@ngers94 collected $0.11 from pot
R@ngers94: doesn't show hand
*** SUMMARY ***
Total pot $0.12 | Rake $0.01
Board [9s Jh 4c]
Seat 1: R@ngers94 (button) collected ($0.11)
Seat 2: Reignerrr (small blind) folded before Flop
Seat 3: AJalexanderAJ (big blind) folded on the Flop
Seat 4: PlayTheBlues4U folded before Flop (didn't bet)
Seat 5: joemli3 folded before Flop (didn't bet)
Seat 6: marimba 104 folded before Flop (didn't bet)


PokerStars Hand #203492935532:  Hold'em No Limit ($0.02/$0.05 USD) - 2019/09/07 10:38:18 ET
Table 'Scorpius' 6-max Seat #6 is the button
Seat 1: R@ngers94 ($5.02 in chips)
Seat 2: Reignerrr ($5 in chips)
Seat 3: AJalexanderAJ ($8.40 in chips)
Seat 4: PlayTheBlues4U ($5.84 in chips)
Seat 5: joemli3 ($2.88 in chips)
Seat 6: marimba 104 ($4.26 in chips)
R@ngers94: posts small blind $0.02
Reignerrr: posts big blind $0.05
*** HOLE CARDS ***
Dealt to PlayTheBlues4U [8d 6c]
AJalexanderAJ: calls $0.05
PlayTheBlues4U: folds
joemli3: calls $0.05
marimba 104: folds
R@ngers94: calls $0.03
Reignerrr: checks
*** FLOP *** [3h 2d 6s]
R@ngers94: checks
Reignerrr: checks
AJalexanderAJ: checks
joemli3: checks
*** TURN *** [3h 2d 6s] [Ad]
R@ngers94: checks
Reignerrr: checks
AJalexanderAJ: checks
joemli3: checks
*** RIVER *** [3h 2d 6s Ad] [5d]
R@ngers94: checks
Reignerrr: checks
AJalexanderAJ: checks
joemli3: checks
*** SHOW DOWN ***
R@ngers94: shows [5c 9c] (a pair of Fives)
Reignerrr: mucks hand
AJalexanderAJ: shows [5s Jh] (a pair of Fives - Ace+Jack kicker)
joemli3: mucks hand
AJalexanderAJ collected $0.19 from pot
*** SUMMARY ***
Total pot $0.20 | Rake $0.01
Board [3h 2d 6s Ad 5d]
Seat 1: R@ngers94 (small blind) showed [5c 9c] and lost with a pair of Fives
Seat 2: Reignerrr (big blind) mucked [7d Th]
Seat 3: AJalexanderAJ showed [5s Jh] and won ($0.19) with a pair of Fives
Seat 4: PlayTheBlues4U folded before Flop (didn't bet)
Seat 5: joemli3 mucked [9h Jc]
Seat 6: marimba 104 (button) folded before Flop (didn't bet)


PokerStars Hand #203492935466:  Hold'em No Limit ($0.02/$0.05 USD) - 2019/09/07 10:37:24 ET
Table 'Scorpius' 6-max Seat #5 is the button
Seat 1: R@ngers94 ($5.07 in chips)
Seat 2: Reignerrr ($5 in chips)
Seat 3: AJalexanderAJ ($8.60 in chips)
Seat 4: PlayTheBlues4U ($5.40 in chips)
Seat 5: joemli3 ($3.08 in chips)
Seat 6: marimba 104 ($4.28 in chips)
marimba 104: posts small blind $0.02
R@ngers94: posts big blind $0.05
*** HOLE CARDS ***
Dealt to PlayTheBlues4U [8s 9s]
Reignerrr: folds
AJalexanderAJ: calls $0.05
PlayTheBlues4U: raises $0.15 to $0.20
joemli3: calls $0.20
marimba 104: folds
R@ngers94: folds
AJalexanderAJ: calls $0.15
*** FLOP *** [Qd 3s 3h]
AJalexanderAJ: checks
PlayTheBlues4U: bets $0.35
joemli3: folds
AJalexanderAJ: folds
Uncalled bet ($0.35) returned to PlayTheBlues4U
PlayTheBlues4U collected $0.64 from pot
PlayTheBlues4U: doesn't show hand
*** SUMMARY ***
Total pot $0.67 | Rake $0.03
Board [Qd 3s 3h]
Seat 1: R@ngers94 (big blind) folded before Flop
Seat 2: Reignerrr folded before Flop (didn't bet)
Seat 3: AJalexanderAJ folded on the Flop
Seat 4: PlayTheBlues4U collected ($0.64)
Seat 5: joemli3 (button) folded on the Flop
Seat 6: marimba 104 (small blind) folded before Flop


PokerStars Hand #203492935406:  Hold'em No Limit ($0.02/$0.05 USD) - 2019/09/07 10:36:38 ET
Table 'Scorpius' 6-max Seat #4 is the button
Seat 1: R@ngers94 ($5.07 in chips)
Seat 2: Reignerrr ($5 in chips)
Seat 3: AJalexanderAJ ($9.85 in chips)
Seat 4: PlayTheBlues4U ($5.40 in chips)
Seat 5: joemli3 ($3.18 in chips)
Seat 6: marimba 104 ($3.06 in chips)
joemli3: posts small blind $0.02
marimba 104: posts big blind $0.05
*** HOLE CARDS ***
Dealt to PlayTheBlues4U [7c Kd]
R@ngers94: folds
Reignerrr: folds
AJalexanderAJ: calls $0.05
PlayTheBlues4U: folds
joemli3: calls $0.03
marimba 104: raises $0.05 to $0.10
AJalexanderAJ: calls $0.05
joemli3: calls $0.05
*** FLOP *** [7h Tc Ad]
joemli3: checks
marimba 104: checks
AJalexanderAJ: bets $0.40
joemli3: folds
marimba 104: calls $0.40
*** TURN *** [7h Tc Ad] [6h]
marimba 104: checks
AJalexanderAJ: bets $0.75
marimba 104: calls $0.75
*** RIVER *** [7h Tc Ad 6h] [3h]
marimba 104: checks
AJalexanderAJ: checks
*** SHOW DOWN ***
marimba 104: shows [5s As] (a pair of Aces)
AJalexanderAJ: mucks hand
marimba 104 collected $2.47 from pot
*** SUMMARY ***
Total pot $2.60 | Rake $0.13
Board [7h Tc Ad 6h 3h]
Seat 1: R@ngers94 folded before Flop (didn't bet)
Seat 2: Reignerrr folded before Flop (didn't bet)
Seat 3: AJalexanderAJ mucked [6s Jh]
Seat 4: PlayTheBlues4U (button) folded before Flop (didn't bet)
Seat 5: joemli3 (small blind) folded on the Flop
Seat 6: marimba 104 (big blind) showed [5s As] and won ($2.47) with a pair of Aces


PokerStars Hand #203492935355:  Hold'em No Limit ($0.02/$0.05 USD) - 2019/09/07 10:35:54 ET
Table 'Scorpius' 6-max Seat #3 is the button
Seat 1: R@ngers94 ($5.12 in chips)
Seat 2: Reignerrr ($5 in chips)
Seat 3: AJalexanderAJ ($9.74 in chips)
Seat 4: PlayTheBlues4U ($5.42 in chips)
Seat 5: joemli3 ($3.23 in chips)
Seat 6: marimba 104 ($3.06 in chips)
PlayTheBlues4U: posts small blind $0.02
joemli3: posts big blind $0.05
*** HOLE CARDS ***
Dealt to PlayTheBlues4U [Kh 4c]
marimba 104: folds
R@ngers94: calls $0.05
Reignerrr: folds
AJalexanderAJ: calls $0.05
PlayTheBlues4U: folds
joemli3: checks
*** FLOP *** [Qd 7s Kd]
joemli3: checks
R@ngers94: checks
AJalexanderAJ: checks
*** TURN *** [Qd 7s Kd] [8d]
joemli3: checks
R@ngers94: checks
AJalexanderAJ: bets $0.25
joemli3: folds
R@ngers94: folds
Uncalled bet ($0.25) returned to AJalexanderAJ
AJalexanderAJ collected $0.16 from pot
AJalexanderAJ: doesn't show hand
*** SUMMARY ***
Total pot $0.17 | Rake $0.01
Board [Qd 7s Kd 8d]
Seat 1: R@ngers94 folded on the Turn
Seat 2: Reignerrr folded before Flop (didn't bet)
Seat 3: AJalexanderAJ (button) collected ($0.16)
Seat 4: PlayTheBlues4U (small blind) folded before Flop
Seat 5: joemli3 (big blind) folded on the Turn
Seat 6: marimba 104 folded before Flop (didn't bet)


PokerStars Hand #203492935294:  Hold'em No Limit ($0.02/$0.05 USD) - 2019/09/07 10:35:02 ET
Table 'Scorpius' 6-max Seat #2 is the button
Seat 1: R@ngers94 ($5.12 in chips)
Seat 2: Reignerrr ($5 in chips)
Seat 3: AJalexanderAJ ($9.69 in chips)
Seat 4: PlayTheBlues4U ($5.47 in chips)
Seat 5: joemli3 ($3.23 in chips)
Seat 6: marimba 104 ($3.06 in chips)
AJalexanderAJ: posts small blind $0.02
PlayTheBlues4U: posts big blind $0.05
*** HOLE CARDS ***
Dealt to PlayTheBlues4U [4d Qc]
joemli3: folds
marimba 104: folds
R@ngers94: folds
Reignerrr: folds
AJalexanderAJ: calls $0.03
PlayTheBlues4U: checks
*** FLOP *** [Kc 2d Kh]
AJalexanderAJ: checks
PlayTheBlues4U: checks
*** TURN *** [Kc 2d Kh] [7h]
AJalexanderAJ: bets $0.10
PlayTheBlues4U: folds
Uncalled bet ($0.10) returned to AJalexanderAJ
AJalexanderAJ collected $0.10 from pot
AJalexanderAJ: doesn't show hand
*** SUMMARY ***
Total pot $0.10 | Rake $0
Board [Kc 2d Kh 7h]
Seat 1: R@ngers94 folded before Flop (didn't bet)
Seat 2: Reignerrr (button) folded before Flop (didn't bet)
Seat 3: AJalexanderAJ (small blind) collected ($0.10)
Seat 4: PlayTheBlues4U (big blind) folded on the Turn
Seat 5: joemli3 folded before Flop (didn't bet)
Seat 6: marimba 104 folded before Flop (didn't bet)


PokerStars Hand #203492935244:  Hold'em No Limit ($0.02/$0.05 USD) - 2019/09/07 10:34:22 ET
Table 'Scorpius' 6-max Seat #1 is the button
Seat 1: R@ngers94 ($5.12 in chips)
Seat 2: Reignerrr ($5 in chips)
Seat 3: AJalexanderAJ ($11.38 in chips)
Seat 4: PlayTheBlues4U ($5.47 in chips)
Seat 5: joemli3 ($1.69 in chips)
Seat 6: marimba 104 ($3.06 in chips)
Reignerrr: posts small blind $0.02
AJalexanderAJ: posts big blind $0.05
*** HOLE CARDS ***
Dealt to PlayTheBlues4U [2h 4d]
PlayTheBlues4U: folds
joemli3: raises $0.20 to $0.25
marimba 104: folds
R@ngers94: folds
Reignerrr: folds
AJalexanderAJ: raises $0.75 to $1
joemli3: raises $0.69 to $1.69 and is all-in
AJalexanderAJ: calls $0.69
*** FLOP *** [Js 2c 8c]
*** TURN *** [Js 2c 8c] [4c]
*** RIVER *** [Js 2c 8c 4c] [5d]
*** SHOW DOWN ***
AJalexanderAJ: shows [Tc Th] (a pair of Tens)
joemli3: shows [As Ah] (a pair of Aces)
joemli3 collected $3.23 from pot
*** SUMMARY ***
Total pot $3.40 | Rake $0.17
Board [Js 2c 8c 4c 5d]
Seat 1: R@ngers94 (button) folded before Flop (didn't bet)
Seat 2: Reignerrr (small blind) folded before Flop
Seat 3: AJalexanderAJ (big blind) showed [Tc Th] and lost with a pair of Tens
Seat 4: PlayTheBlues4U folded before Flop (didn't bet)
Seat 5: joemli3 showed [As Ah] and won ($3.23) with a pair of Aces
Seat 6: marimba 104 folded before Flop (didn't bet)


PokerStars Hand #203492935196:  Hold'em No Limit ($0.02/$0.05 USD) - 2019/09/07 10:33:38 ET
Table 'Scorpius' 6-max Seat #6 is the button
Seat 1: R@ngers94 ($5.17 in chips)
Seat 2: Reignerrr ($5 in chips)
Seat 3: AJalexanderAJ ($11.06 in chips)
Seat 4: PlayTheBlues4U ($5.47 in chips)
Seat 5: joemli3 ($1.94 in chips)
Seat 6: marimba 104 ($3.06 in chips)
R@ngers94: posts small blind $0.02
Reignerrr: posts big blind $0.05
*** HOLE CARDS ***
Dealt to PlayTheBlues4U [7h 4d]
AJalexanderAJ: calls $0.05
PlayTheBlues4U: folds
joemli3: calls $0.05
marimba 104: folds
R@ngers94: calls $0.03
Reignerrr: checks
*** FLOP *** [3h Ac 8d]
R@ngers94: checks
Reignerrr: checks
AJalexanderAJ: bets $0.20
joemli3: calls $0.20
R@ngers94: folds
Reignerrr: folds
*** TURN *** [3h Ac 8d] [Td]
AJalexanderAJ: bets $0.55
joemli3: folds
Uncalled bet ($0.55) returned to AJalexanderAJ
AJalexanderAJ collected $0.57 from pot
AJalexanderAJ: doesn't show hand
*** SUMMARY ***
Total pot $0.60 | Rake $0.03
Board [3h Ac 8d Td]
Seat 1: R@ngers94 (small blind) folded on the Flop
Seat 2: Reignerrr (big blind) folded on the Flop
Seat 3: AJalexanderAJ collected ($0.57)
Seat 4: PlayTheBlues4U folded before Flop (didn't bet)
Seat 5: joemli3 folded on the Turn
Seat 6: marimba 104 (button) folded before Flop (didn't bet)


PokerStars Hand #203492935154:  Hold'em No Limit ($0.02/$0.05 USD) - 2019/09/07 10:32:49 ET
Table 'Scorpius' 6-max Seat #5 is the button
Seat 1: R@ngers94 ($5.22 in chips)
Seat 2: Reignerrr ($5 in chips)
Seat 3: AJalexanderAJ ($10.74 in chips)
Seat 4: PlayTheBlues4U ($5.47 in chips)
Seat 5: joemli3 ($2.19 in chips)
Seat 6: marimba 104 ($3.11 in chips)
marimba 104: posts small blind $0.02
R@ngers94: posts big blind $0.05
*** HOLE CARDS ***
Dealt to PlayTheBlues4U [Qd 7c]
Reignerrr: folds
AJalexanderAJ: calls $0.05
PlayTheBlues4U: folds
joemli3: calls $0.05
marimba 104: calls $0.03
R@ngers94: checks
*** FLOP *** [9d 4h 2s]
marimba 104: checks
R@ngers94: checks
AJalexanderAJ: checks
joemli3: checks
*** TURN *** [9d 4h 2s] [2h]
marimba 104: checks
R@ngers94: checks
AJalexanderAJ: bets $0.20
joemli3: calls $0.20
marimba 104: folds
R@ngers94: folds
*** RIVER *** [9d 4h 2s 2h] [Kd]
AJalexanderAJ: checks
joemli3: checks
*** SHOW DOWN ***
AJalexanderAJ: shows [Tc 2d] (three of a kind, Deuces)
joemli3: mucks hand
AJalexanderAJ collected $0.57 from pot
*** SUMMARY ***
Total pot $0.60 | Rake $0.03
Board [9d 4h 2s 2h Kd]
Seat 1: R@ngers94 (big blind) folded on the Turn
Seat 2: Reignerrr folded before Flop (didn't bet)
Seat 3: AJalexanderAJ showed [Tc 2d] and won ($0.57) with three of a kind, Deuces
Seat 4: PlayTheBlues4U folded before Flop (didn't bet)
Seat 5: joemli3 (button) mucked [3h 5h]
Seat 6: marimba 104 (small blind) folded on the Turn


PokerStars Hand #203492935114:  Hold'em No Limit ($0.02/$0.05 USD) - 2019/09/07 10:32:08 ET
Table 'Scorpius' 6-max Seat #4 is the button
Seat 2: Reignerrr ($5 in chips)
Seat 3: AJalexanderAJ ($10.74 in chips)
Seat 4: PlayTheBlues4U ($4.93 in chips)
Seat 5: joemli3 ($2.74 in chips)
Seat 6: marimba 104 ($3.16 in chips)
joemli3: posts small blind $0.02
marimba 104: posts big blind $0.05
*** HOLE CARDS ***
Dealt to PlayTheBlues4U [5h 6s]
Reignerrr: folds
AJalexanderAJ: folds
PlayTheBlues4U: raises $0.10 to $0.15
joemli3: raises $0.25 to $0.40
marimba 104: folds
PlayTheBlues4U: calls $0.25
*** FLOP *** [7c Tc 6c]
joemli3: bets $0.15
PlayTheBlues4U: raises $0.45 to $0.60
joemli3: folds
Uncalled bet ($0.45) returned to PlayTheBlues4U
PlayTheBlues4U collected $1.09 from pot
PlayTheBlues4U: doesn't show hand
*** SUMMARY ***
Total pot $1.15 | Rake $0.06
Board [7c Tc 6c]
Seat 2: Reignerrr folded before Flop (didn't bet)
Seat 3: AJalexanderAJ folded before Flop (didn't bet)
Seat 4: PlayTheBlues4U (button) collected ($1.09)
Seat 5: joemli3 (small blind) folded on the Flop
Seat 6: marimba 104 (big blind) folded before Flop


PokerStars Hand #203490219978:  Hold'em No Limit ($0.02/$0.05 USD) - 2019/09/07 10:31:35 ET
Table 'Scorpius' 6-max Seat #3 is the button
Seat 1: R@ngers94 ($5.37 in chips)
Seat 2: Reignerrr ($5 in chips)
Seat 3: AJalexanderAJ ($10.30 in chips)
Seat 4: PlayTheBlues4U ($4.95 in chips)
Seat 5: joemli3 ($2.89 in chips)
Seat 6: marimba 104 ($3.16 in chips)
PlayTheBlues4U: posts small blind $0.02
joemli3: posts big blind $0.05
*** HOLE CARDS ***
Dealt to PlayTheBlues4U [2c 4d]
marimba 104: folds
R@ngers94: calls $0.05
Reignerrr: raises $0.10 to $0.15
AJalexanderAJ: calls $0.15
PlayTheBlues4U: folds
joemli3: calls $0.10
R@ngers94: calls $0.10
*** FLOP *** [Jc 2s 6d]
joemli3: checks
R@ngers94: checks
Reignerrr: checks
AJalexanderAJ: bets $0.60
joemli3: folds
R@ngers94: folds
Reignerrr: folds
Uncalled bet ($0.60) returned to AJalexanderAJ
AJalexanderAJ collected $0.59 from pot
AJalexanderAJ: doesn't show hand
*** SUMMARY ***
Total pot $0.62 | Rake $0.03
Board [Jc 2s 6d]
Seat 1: R@ngers94 folded on the Flop
Seat 2: Reignerrr folded on the Flop
Seat 3: AJalexanderAJ (button) collected ($0.59)
Seat 4: PlayTheBlues4U (small blind) folded before Flop
Seat 5: joemli3 (big blind) folded on the Flop
Seat 6: marimba 104 folded before Flop (didn't bet)


PokerStars Hand #203490219965:  Hold'em No Limit ($0.02/$0.05 USD) - 2019/09/07 10:31:16 ET
Table 'Scorpius' 6-max Seat #2 is the button
Seat 1: R@ngers94 ($5.30 in chips)
Seat 2: Reignerrr ($5 in chips)
Seat 3: AJalexanderAJ ($10.32 in chips)
Seat 4: PlayTheBlues4U ($5 in chips)
Seat 5: joemli3 ($2.89 in chips)
Seat 6: marimba 104 ($3.16 in chips)
AJalexanderAJ: posts small blind $0.02
PlayTheBlues4U: posts big blind $0.05
*** HOLE CARDS ***
Dealt to PlayTheBlues4U [8d 3d]
joemli3: folds
marimba 104: folds
R@ngers94: raises $0.10 to $0.15
Reignerrr: folds
AJalexanderAJ: folds
PlayTheBlues4U: folds
Uncalled bet ($0.10) returned to R@ngers94
R@ngers94 collected $0.12 from pot
R@ngers94: doesn't show hand
*** SUMMARY ***
Total pot $0.12 | Rake $0
Seat 1: R@ngers94 collected ($0.12)
Seat 2: Reignerrr (button) folded before Flop (didn't bet)
Seat 3: AJalexanderAJ (small blind) folded before Flop
Seat 4: PlayTheBlues4U (big blind) folded before Flop
Seat 5: joemli3 folded before Flop (didn't bet)
Seat 6: marimba 104 folded before Flop (didn't bet)


PokerStars Hand #203471893479:  Hold'em No Limit ($0.01/$0.02 USD) - 2019/09/06 21:48:00 ET
Table 'Pegasus' 6-max Seat #1 is the button
Seat 1: michelina44 ($0.42 in chips)
Seat 2: WillDuane ($2.03 in chips)
Seat 3: jjbenzky ($3.59 in chips)
Seat 4: PlayTheBlues4U ($4.41 in chips)
Seat 5: tsov252525 ($2.67 in chips)
Seat 6: TheWalrus435 ($2.57 in chips)
WillDuane: posts small blind $0.01
jjbenzky: posts big blind $0.02
*** HOLE CARDS ***
Dealt to PlayTheBlues4U [Kc 3h]
PlayTheBlues4U: folds
tsov252525: folds
TheWalrus435: calls $0.02
PlayTheBlues4U leaves the table
michelina44: folds
WillDuane: calls $0.01
jjbenzky: checks
*** FLOP *** [3d Td 2d]
WillDuane: checks
jjbenzky: checks
FaceIt00 joins the table at seat #4
TheWalrus435: checks
*** TURN *** [3d Td 2d] [4s]
WillDuane: checks
jjbenzky: checks
TheWalrus435: checks
*** RIVER *** [3d Td 2d 4s] [7d]
WillDuane: bets $0.02
jjbenzky: calls $0.02
TheWalrus435: folds
*** SHOW DOWN ***
WillDuane: shows [Qd 8d] (a flush, Queen high)
jjbenzky: mucks hand
WillDuane collected $0.10 from pot
*** SUMMARY ***
Total pot $0.10 | Rake $0
Board [3d Td 2d 4s 7d]
Seat 1: michelina44 (button) folded before Flop (didn't bet)
Seat 2: WillDuane (small blind) showed [Qd 8d] and won ($0.10) with a flush, Queen high
Seat 3: jjbenzky (big blind) mucked [7h Jh]
Seat 4: PlayTheBlues4U folded before Flop (didn't bet)
Seat 5: tsov252525 folded before Flop (didn't bet)
Seat 6: TheWalrus435 folded on the River


PokerStars Hand #203471893252:  Hold'em No Limit ($0.01/$0.02 USD) - 2019/09/06 21:46:45 ET
Table 'Pegasus' 6-max Seat #6 is the button
Seat 1: michelina44 ($0.43 in chips)
Seat 2: WillDuane ($2.07 in chips)
Seat 3: jjbenzky ($3.69 in chips)
Seat 4: PlayTheBlues4U ($4.41 in chips)
Seat 5: tsov252525 ($2.53 in chips)
Seat 6: TheWalrus435 ($2.57 in chips)
michelina44: posts small blind $0.01
WillDuane: posts big blind $0.02
*** HOLE CARDS ***
Dealt to PlayTheBlues4U [Qh 3c]
jjbenzky: raises $0.02 to $0.04
PlayTheBlues4U: folds
tsov252525: calls $0.04
TheWalrus435: folds
michelina44: folds
WillDuane: calls $0.02
*** FLOP *** [6d 6c 4c]
WillDuane: checks
jjbenzky: checks
tsov252525: bets $0.06
WillDuane: folds
jjbenzky: calls $0.06
*** TURN *** [6d 6c 4c] [3s]
jjbenzky: checks
tsov252525: bets $0.24
jjbenzky: folds
Uncalled bet ($0.24) returned to tsov252525
tsov252525 collected $0.24 from pot
tsov252525: doesn't show hand
*** SUMMARY ***
Total pot $0.25 | Rake $0.01
Board [6d 6c 4c 3s]
Seat 1: michelina44 (small blind) folded before Flop
Seat 2: WillDuane (big blind) folded on the Flop
Seat 3: jjbenzky folded on the Turn
Seat 4: PlayTheBlues4U folded before Flop (didn't bet)
Seat 5: tsov252525 collected ($0.24)
Seat 6: TheWalrus435 (button) folded before Flop (didn't bet)


PokerStars Hand #203471893149:  Hold'em No Limit ($0.01/$0.02 USD) - 2019/09/06 21:46:07 ET
Table 'Pegasus' 6-max Seat #5 is the button
Seat 1: michelina44 ($0.45 in chips)
Seat 2: WillDuane ($2.07 in chips)
Seat 3: jjbenzky ($3.81 in chips)
Seat 4: PlayTheBlues4U ($4.41 in chips)
Seat 5: tsov252525 ($2.53 in chips)
Seat 6: TheWalrus435 ($2.44 in chips)
TheWalrus435: posts small blind $0.01
michelina44: posts big blind $0.02
*** HOLE CARDS ***
Dealt to PlayTheBlues4U [3s 4c]
WillDuane: folds
jjbenzky: calls $0.02
PlayTheBlues4U: folds
tsov252525: folds
TheWalrus435: calls $0.01
michelina44: checks
*** FLOP *** [4d 2d 5h]
TheWalrus435: checks
michelina44: checks
jjbenzky: checks
*** TURN *** [4d 2d 5h] [7d]
TheWalrus435: bets $0.10
michelina44: folds
jjbenzky: calls $0.10
*** RIVER *** [4d 2d 5h 7d] [9h]
TheWalrus435: bets $0.25
jjbenzky: folds
Uncalled bet ($0.25) returned to TheWalrus435
TheWalrus435 collected $0.25 from pot
*** SUMMARY ***
Total pot $0.26 | Rake $0.01
Board [4d 2d 5h 7d 9h]
Seat 1: michelina44 (big blind) folded on the Turn
Seat 2: WillDuane folded before Flop (didn't bet)
Seat 3: jjbenzky folded on the River
Seat 4: PlayTheBlues4U folded before Flop (didn't bet)
Seat 5: tsov252525 (button) folded before Flop (didn't bet)
Seat 6: TheWalrus435 (small blind) collected ($0.25)


PokerStars Hand #203470999941:  Hold'em No Limit ($0.01/$0.02 USD) - 2019/09/06 21:44:53 ET
Table 'Pegasus' 6-max Seat #4 is the button
Seat 1: michelina44 ($0.45 in chips)
Seat 2: WillDuane ($2.17 in chips)
Seat 3: jjbenzky ($3.81 in chips)
Seat 4: PlayTheBlues4U ($4.47 in chips)
Seat 5: tsov252525 ($2.36 in chips)
Seat 6: TheWalrus435 ($2.46 in chips)
tsov252525: posts small blind $0.01
TheWalrus435: posts big blind $0.02
*** HOLE CARDS ***
Dealt to PlayTheBlues4U [Qc Ks]
michelina44: folds
WillDuane: raises $0.04 to $0.06
jjbenzky: folds
PlayTheBlues4U: calls $0.06
tsov252525: calls $0.05
TheWalrus435: folds
*** FLOP *** [8c Ad 4c]
tsov252525: checks
WillDuane: bets $0.02
PlayTheBlues4U: folds
tsov252525: calls $0.02
*** TURN *** [8c Ad 4c] [9h]
tsov252525: checks
WillDuane: bets $0.02
tsov252525: raises $0.14 to $0.16
WillDuane: folds
Uncalled bet ($0.14) returned to tsov252525
tsov252525 collected $0.27 from pot
tsov252525: doesn't show hand
*** SUMMARY ***
Total pot $0.28 | Rake $0.01
Board [8c Ad 4c 9h]
Seat 1: michelina44 folded before Flop (didn't bet)
Seat 2: WillDuane folded on the Turn
Seat 3: jjbenzky folded before Flop (didn't bet)
Seat 4: PlayTheBlues4U (button) folded on the Flop
Seat 5: tsov252525 (small blind) collected ($0.27)
Seat 6: TheWalrus435 (big blind) folded before Flop


PokerStars Hand #203470999721:  Hold'em No Limit ($0.01/$0.02 USD) - 2019/09/06 21:43:39 ET
Table 'Pegasus' 6-max Seat #3 is the button
Seat 1: michelina44 ($0.45 in chips)
Seat 2: WillDuane ($2.19 in chips)
Seat 3: jjbenzky ($3.39 in chips)
Seat 4: PlayTheBlues4U ($4.87 in chips)
Seat 5: tsov252525 ($2.38 in chips)
Seat 6: TheWalrus435 ($2.48 in chips)
PlayTheBlues4U: posts small blind $0.01
tsov252525: posts big blind $0.02
*** HOLE CARDS ***
Dealt to PlayTheBlues4U [2s Ac]
TheWalrus435: calls $0.02
michelina44: folds
WillDuane: calls $0.02
jjbenzky: calls $0.02
PlayTheBlues4U: calls $0.01
tsov252525: checks
*** FLOP *** [2c 3c Qd]
PlayTheBlues4U: checks
tsov252525: checks
TheWalrus435: checks
WillDuane: checks
jjbenzky: checks
*** TURN *** [2c 3c Qd] [2d]
PlayTheBlues4U: bets $0.10
tsov252525: folds
TheWalrus435: folds
WillDuane: folds
jjbenzky: calls $0.10
*** RIVER *** [2c 3c Qd 2d] [3h]
PlayTheBlues4U: bets $0.28
jjbenzky: calls $0.28
*** SHOW DOWN ***
PlayTheBlues4U: shows [2s Ac] (a full house, Deuces full of Threes)
jjbenzky: shows [9d 3d] (a full house, Threes full of Deuces)
jjbenzky collected $0.82 from pot
*** SUMMARY ***
Total pot $0.86 | Rake $0.04
Board [2c 3c Qd 2d 3h]
Seat 1: michelina44 folded before Flop (didn't bet)
Seat 2: WillDuane folded on the Turn
Seat 3: jjbenzky (button) showed [9d 3d] and won ($0.82) with a full house, Threes full of Deuces
Seat 4: PlayTheBlues4U (small blind) showed [2s Ac] and lost with a full house, Deuces full of Threes
Seat 5: tsov252525 (big blind) folded on the Turn
Seat 6: TheWalrus435 folded on the Turn


PokerStars Hand #203470999467:  Hold'em No Limit ($0.02/$0.05 USD) - 2019/09/06 21:42:09 ET
Table 'Icarus' 6-max Seat #3 is the button
Seat 1: bobca1944 ($2.61 in chips)
Seat 2: PlayTheBlues4U ($4.93 in chips)
Seat 3: FishyFlopp ($7.25 in chips)
Seat 6: DemolishIT ($10.08 in chips)
copierking35 will be allowed to play after the button
andreybhr will be allowed to play after the button
DemolishIT: posts small blind $0.02
bobca1944: posts big blind $0.05
*** HOLE CARDS ***
Dealt to PlayTheBlues4U [Js Qh]
PlayTheBlues4U: calls $0.05
FishyFlopp: folds
DemolishIT: calls $0.03
bobca1944: raises $0.15 to $0.20
PlayTheBlues4U: folds
DemolishIT: folds
Uncalled bet ($0.15) returned to bobca1944
bobca1944 collected $0.15 from pot
bobca1944: doesn't show hand
*** SUMMARY ***
Total pot $0.15 | Rake $0
Seat 1: bobca1944 (big blind) collected ($0.15)
Seat 2: PlayTheBlues4U folded before Flop
Seat 3: FishyFlopp (button) folded before Flop (didn't bet)
Seat 6: DemolishIT (small blind) folded before Flop


PokerStars Hand #203470999440:  Hold'em No Limit ($0.01/$0.02 USD) - 2019/09/06 21:41:59 ET
Table 'Pegasus' 6-max Seat #2 is the button
Seat 1: michelina44 ($0.45 in chips)
Seat 2: WillDuane ($1.91 in chips)
Seat 3: jjbenzky ($3.49 in chips)
Seat 4: PlayTheBlues4U ($4.97 in chips)
Seat 5: tsov252525 ($2.48 in chips)
Seat 6: TheWalrus435 ($2.48 in chips)
jjbenzky: posts small blind $0.01
PlayTheBlues4U: posts big blind $0.02
*** HOLE CARDS ***
Dealt to PlayTheBlues4U [Ts Ah]
tsov252525: raises $0.04 to $0.06
TheWalrus435: folds
michelina44: folds
WillDuane: calls $0.06
jjbenzky: calls $0.05
PlayTheBlues4U: calls $0.04
*** FLOP *** [2c 4s 5s]
jjbenzky: checks
PlayTheBlues4U: checks
tsov252525: checks
WillDuane: bets $0.02
jjbenzky: calls $0.02
PlayTheBlues4U: calls $0.02
tsov252525: calls $0.02
*** TURN *** [2c 4s 5s] [9c]
jjbenzky: checks
PlayTheBlues4U: checks
tsov252525: checks
WillDuane: bets $0.02
jjbenzky: calls $0.02
PlayTheBlues4U: calls $0.02
tsov252525: calls $0.02
*** RIVER *** [2c 4s 5s 9c] [Kh]
jjbenzky: checks
PlayTheBlues4U: checks
tsov252525: checks
WillDuane: bets $0.18
jjbenzky: folds
PlayTheBlues4U: folds
tsov252525: folds
Uncalled bet ($0.18) returned to WillDuane
WillDuane collected $0.38 from pot
WillDuane: doesn't show hand
*** SUMMARY ***
Total pot $0.40 | Rake $0.02
Board [2c 4s 5s 9c Kh]
Seat 1: michelina44 folded before Flop (didn't bet)
Seat 2: WillDuane (button) collected ($0.38)
Seat 3: jjbenzky (small blind) folded on the River
Seat 4: PlayTheBlues4U (big blind) folded on the River
Seat 5: tsov252525 folded on the River
Seat 6: TheWalrus435 folded before Flop (didn't bet)


PokerStars Hand #203470999405:  Hold'em No Limit ($0.02/$0.05 USD) - 2019/09/06 21:41:49 ET
Table 'Icarus' 6-max Seat #2 is the button
Seat 1: bobca1944 ($2.61 in chips)
Seat 2: PlayTheBlues4U ($4.93 in chips)
Seat 3: FishyFlopp ($7.20 in chips)
Seat 6: DemolishIT ($10.13 in chips)
FishyFlopp: posts small blind $0.02
DemolishIT: posts big blind $0.05
*** HOLE CARDS ***
Dealt to PlayTheBlues4U [3h Qc]
bobca1944: folds
PlayTheBlues4U: folds
copierking35 joins the table at seat #4
FishyFlopp: raises $0.17 to $0.22
andreybhr joins the table at seat #5
DemolishIT: folds
Uncalled bet ($0.17) returned to FishyFlopp
FishyFlopp collected $0.10 from pot
FishyFlopp: doesn't show hand
*** SUMMARY ***
Total pot $0.10 | Rake $0
Seat 1: bobca1944 folded before Flop (didn't bet)
Seat 2: PlayTheBlues4U (button) folded before Flop (didn't bet)
Seat 3: FishyFlopp (small blind) collected ($0.10)
Seat 6: DemolishIT (big blind) folded before Flop


PokerStars Hand #203470999283:  Hold'em No Limit ($0.02/$0.05 USD) - 2019/09/06 21:41:06 ET
Table 'Icarus' 6-max Seat #1 is the button
Seat 1: bobca1944 ($2.83 in chips)
Seat 2: PlayTheBlues4U ($4.95 in chips)
Seat 3: FishyFlopp ($6.77 in chips)
Seat 6: DemolishIT ($10.35 in chips)
PlayTheBlues4U: posts small blind $0.02
FishyFlopp: posts big blind $0.05
*** HOLE CARDS ***
Dealt to PlayTheBlues4U [Kc 2c]
DemolishIT: calls $0.05
bobca1944: calls $0.05
PlayTheBlues4U: folds
FishyFlopp: raises $0.17 to $0.22
DemolishIT: calls $0.17
bobca1944: calls $0.17
*** FLOP *** [Jc Ts 3h]
FishyFlopp: bets $0.52
DemolishIT: folds
bobca1944: folds
Uncalled bet ($0.52) returned to FishyFlopp
FishyFlopp collected $0.65 from pot
FishyFlopp: doesn't show hand
*** SUMMARY ***
Total pot $0.68 | Rake $0.03
Board [Jc Ts 3h]
Seat 1: bobca1944 (button) folded on the Flop
Seat 2: PlayTheBlues4U (small blind) folded before Flop
Seat 3: FishyFlopp (big blind) collected ($0.65)
Seat 6: DemolishIT folded on the Flop


PokerStars Hand #203470999246:  Hold'em No Limit ($0.02/$0.05 USD) - 2019/09/06 21:40:56 ET
Table 'Icarus' 6-max Seat #6 is the button
Seat 1: bobca1944 ($2.85 in chips)
Seat 2: PlayTheBlues4U ($4.93 in chips)
Seat 3: FishyFlopp ($6.77 in chips)
Seat 6: DemolishIT ($10.35 in chips)
bobca1944: posts small blind $0.02
PlayTheBlues4U: posts big blind $0.05
*** HOLE CARDS ***
Dealt to PlayTheBlues4U [9h 4h]
FishyFlopp: folds
DemolishIT: folds
bobca1944: folds
Uncalled bet ($0.03) returned to PlayTheBlues4U
rand60 leaves the table
PlayTheBlues4U collected $0.04 from pot
PlayTheBlues4U: doesn't show hand
*** SUMMARY ***
Total pot $0.04 | Rake $0
Seat 1: bobca1944 (small blind) folded before Flop
Seat 2: PlayTheBlues4U (big blind) collected ($0.04)
Seat 3: FishyFlopp folded before Flop (didn't bet)
Seat 6: DemolishIT (button) folded before Flop (didn't bet)


PokerStars Hand #203470999242:  Hold'em No Limit ($0.01/$0.02 USD) - 2019/09/06 21:40:56 ET
Table 'Pegasus' 6-max Seat #1 is the button
Seat 1: michelina44 ($0.45 in chips)
Seat 2: WillDuane ($1.92 in chips)
Seat 3: jjbenzky ($3.64 in chips)
Seat 4: PlayTheBlues4U ($4.97 in chips)
Seat 5: tsov252525 ($2.28 in chips)
Seat 6: TheWalrus435 ($2.54 in chips)
WillDuane: posts small blind $0.01
jjbenzky: posts big blind $0.02
*** HOLE CARDS ***
Dealt to PlayTheBlues4U [Td Qc]
PlayTheBlues4U: folds
tsov252525: raises $0.04 to $0.06
TheWalrus435: calls $0.06
michelina44: folds
WillDuane: folds
jjbenzky: calls $0.04
*** FLOP *** [4h Th 4c]
jjbenzky: checks
tsov252525: bets $0.09
TheWalrus435: folds
jjbenzky: calls $0.09
*** TURN *** [4h Th 4c] [9c]
jjbenzky: checks
tsov252525: checks
*** RIVER *** [4h Th 4c 9c] [3h]
jjbenzky: checks
tsov252525: bets $0.18
jjbenzky: folds
Uncalled bet ($0.18) returned to tsov252525
tsov252525 collected $0.35 from pot
tsov252525: doesn't show hand
*** SUMMARY ***
Total pot $0.37 | Rake $0.02
Board [4h Th 4c 9c 3h]
Seat 1: michelina44 (button) folded before Flop (didn't bet)
Seat 2: WillDuane (small blind) folded before Flop
Seat 3: jjbenzky (big blind) folded on the River
Seat 4: PlayTheBlues4U folded before Flop (didn't bet)
Seat 5: tsov252525 collected ($0.35)
Seat 6: TheWalrus435 folded on the Flop


PokerStars Hand #203470999182:  Hold'em No Limit ($0.01/$0.02 USD) - 2019/09/06 21:40:32 ET
Table 'Pegasus' 6-max Seat #6 is the button
Seat 1: michelina44 ($0.46 in chips)
Seat 2: WillDuane ($1.94 in chips)
Seat 3: jjbenzky ($3.66 in chips)
Seat 4: PlayTheBlues4U ($4.92 in chips)
Seat 5: tsov252525 ($2.28 in chips)
Seat 6: TheWalrus435 ($2.54 in chips)
michelina44: posts small blind $0.01
WillDuane: posts big blind $0.02
*** HOLE CARDS ***
Dealt to PlayTheBlues4U [9h 9c]
jjbenzky: calls $0.02
PlayTheBlues4U: raises $0.12 to $0.14
tsov252525: folds
TheWalrus435: folds
michelina44: folds
WillDuane: folds
jjbenzky: folds
Uncalled bet ($0.12) returned to PlayTheBlues4U
PlayTheBlues4U collected $0.07 from pot
PlayTheBlues4U: doesn't show hand
*** SUMMARY ***
Total pot $0.07 | Rake $0
Seat 1: michelina44 (small blind) folded before Flop
Seat 2: WillDuane (big blind) folded before Flop
Seat 3: jjbenzky folded before Flop
Seat 4: PlayTheBlues4U collected ($0.07)
Seat 5: tsov252525 folded before Flop (didn't bet)
Seat 6: TheWalrus435 (button) folded before Flop (didn't bet)


PokerStars Hand #203470999056:  Hold'em No Limit ($0.01/$0.02 USD) - 2019/09/06 21:39:53 ET
Table 'Pegasus' 6-max Seat #5 is the button
Seat 1: michelina44 ($0.48 in chips)
Seat 2: WillDuane ($1.94 in chips)
Seat 3: jjbenzky ($3.74 in chips)
Seat 4: PlayTheBlues4U ($4.82 in chips)
Seat 5: tsov252525 ($2.28 in chips)
Seat 6: TheWalrus435 ($2.55 in chips)
TheWalrus435: posts small blind $0.01
michelina44: posts big blind $0.02
*** HOLE CARDS ***
Dealt to PlayTheBlues4U [Jd Ah]
WillDuane: folds
jjbenzky: calls $0.02
PlayTheBlues4U: raises $0.06 to $0.08
tsov252525: folds
TheWalrus435: folds
michelina44: folds
jjbenzky: calls $0.06
*** FLOP *** [Th 7h 4d]
jjbenzky: checks
PlayTheBlues4U: bets $0.08
jjbenzky: folds
Uncalled bet ($0.08) returned to PlayTheBlues4U
PlayTheBlues4U collected $0.18 from pot
PlayTheBlues4U: doesn't show hand
*** SUMMARY ***
Total pot $0.19 | Rake $0.01
Board [Th 7h 4d]
Seat 1: michelina44 (big blind) folded before Flop
Seat 2: WillDuane folded before Flop (didn't bet)
Seat 3: jjbenzky folded on the Flop
Seat 4: PlayTheBlues4U collected ($0.18)
Seat 5: tsov252525 (button) folded before Flop (didn't bet)
Seat 6: TheWalrus435 (small blind) folded before Flop


PokerStars Hand #203470999030:  Hold'em No Limit ($0.02/$0.05 USD) - 2019/09/06 21:39:45 ET
Table 'Icarus' 6-max Seat #3 is the button
Seat 1: bobca1944 ($2.85 in chips)
Seat 2: PlayTheBlues4U ($4.93 in chips)
Seat 3: FishyFlopp ($6.96 in chips)
Seat 4: rand60 ($4.89 in chips)
Seat 6: DemolishIT ($10.54 in chips)
rand60: posts small blind $0.02
DemolishIT: posts big blind $0.05
*** HOLE CARDS ***
Dealt to PlayTheBlues4U [7h Tc]
bobca1944: folds
PlayTheBlues4U: folds
FishyFlopp: calls $0.05
rand60: calls $0.03
DemolishIT: checks
*** FLOP *** [6c 4h 5h]
rand60: checks
DemolishIT: checks
FishyFlopp: bets $0.14
rand60: calls $0.14
DemolishIT: calls $0.14
*** TURN *** [6c 4h 5h] [5d]
rand60: checks
DemolishIT: checks
FishyFlopp: checks
*** RIVER *** [6c 4h 5h 5d] [Th]
rand60: bets $0.54
DemolishIT: folds
FishyFlopp: folds
Uncalled bet ($0.54) returned to rand60
rand60 collected $0.54 from pot
rand60: doesn't show hand
*** SUMMARY ***
Total pot $0.57 | Rake $0.03
Board [6c 4h 5h 5d Th]
Seat 1: bobca1944 folded before Flop (didn't bet)
Seat 2: PlayTheBlues4U folded before Flop (didn't bet)
Seat 3: FishyFlopp (button) folded on the River
Seat 4: rand60 (small blind) collected ($0.54)
Seat 6: DemolishIT (big blind) folded on the River


PokerStars Hand #203470998913:  Hold'em No Limit ($0.02/$0.05 USD) - 2019/09/06 21:39:04 ET
Table 'Icarus' 6-max Seat #2 is the button
Seat 1: bobca1944 ($2.59 in chips)
Seat 2: PlayTheBlues4U ($4.93 in chips)
Seat 3: FishyFlopp ($6.98 in chips)
Seat 4: rand60 ($4.94 in chips)
Seat 5: DeccaDan ($12.15 in chips)
Seat 6: DemolishIT ($10.76 in chips)
FishyFlopp: posts small blind $0.02
rand60: posts big blind $0.05
*** HOLE CARDS ***
Dealt to PlayTheBlues4U [5c Th]
DeccaDan: folds
DemolishIT: calls $0.05
DeccaDan leaves the table
bobca1944: raises $0.17 to $0.22
PlayTheBlues4U: folds
FishyFlopp: folds
rand60: folds
DemolishIT: calls $0.17
*** FLOP *** [3d 8c 8s]
DemolishIT: checks
bobca1944: bets $0.24
DemolishIT: folds
Uncalled bet ($0.24) returned to bobca1944
bobca1944 collected $0.48 from pot
bobca1944: doesn't show hand
*** SUMMARY ***
Total pot $0.51 | Rake $0.03
Board [3d 8c 8s]
Seat 1: bobca1944 collected ($0.48)
Seat 2: PlayTheBlues4U (button) folded before Flop (didn't bet)
Seat 3: FishyFlopp (small blind) folded before Flop
Seat 4: rand60 (big blind) folded before Flop
Seat 5: DeccaDan folded before Flop (didn't bet)
Seat 6: DemolishIT folded on the Flop


PokerStars Hand #203470998829:  Hold'em No Limit ($0.01/$0.02 USD) - 2019/09/06 21:38:34 ET
Table 'Pegasus' 6-max Seat #4 is the button
Seat 1: michelina44 ($0.52 in chips)
Seat 2: WillDuane ($1.94 in chips)
Seat 3: jjbenzky ($3.66 in chips)
Seat 4: PlayTheBlues4U ($4.82 in chips)
Seat 5: tsov252525 ($2.29 in chips)
Seat 6: TheWalrus435 ($2.59 in chips)
tsov252525: posts small blind $0.01
TheWalrus435: posts big blind $0.02
*** HOLE CARDS ***
Dealt to PlayTheBlues4U [9s Qd]
michelina44: raises $0.02 to $0.04
WillDuane: folds
jjbenzky: calls $0.04
PlayTheBlues4U: folds
tsov252525: folds
TheWalrus435: calls $0.02
*** FLOP *** [2d 6d 8d]
TheWalrus435: checks
michelina44: checks
jjbenzky: checks
*** TURN *** [2d 6d 8d] [Tc]
TheWalrus435: checks
michelina44: checks
jjbenzky: checks
*** RIVER *** [2d 6d 8d Tc] [Jd]
TheWalrus435: checks
michelina44: checks
jjbenzky: bets $0.12
TheWalrus435: folds
michelina44: folds
Uncalled bet ($0.12) returned to jjbenzky
jjbenzky collected $0.12 from pot
jjbenzky: doesn't show hand
*** SUMMARY ***
Total pot $0.13 | Rake $0.01
Board [2d 6d 8d Tc Jd]
Seat 1: michelina44 folded on the River
Seat 2: WillDuane folded before Flop (didn't bet)
Seat 3: jjbenzky collected ($0.12)
Seat 4: PlayTheBlues4U (button) folded before Flop (didn't bet)
Seat 5: tsov252525 (small blind) folded before Flop
Seat 6: TheWalrus435 (big blind) folded on the River


PokerStars Hand #203470998714:  Hold'em No Limit ($0.02/$0.05 USD) - 2019/09/06 21:37:58 ET
Table 'Icarus' 6-max Seat #1 is the button
Seat 1: bobca1944 ($2.59 in chips)
Seat 2: PlayTheBlues4U ($4.95 in chips)
Seat 3: FishyFlopp ($7.08 in chips)
Seat 4: rand60 ($4.83 in chips)
Seat 5: DeccaDan ($12.15 in chips)
Seat 6: DemolishIT ($10.76 in chips)
PlayTheBlues4U: posts small blind $0.02
FishyFlopp: posts big blind $0.05
*** HOLE CARDS ***
Dealt to PlayTheBlues4U [2s Qd]
rand60: raises $0.05 to $0.10
DeccaDan: folds
DemolishIT: folds
bobca1944: folds
PlayTheBlues4U: folds
FishyFlopp: calls $0.05
*** FLOP *** [Kd 7s 3h]
FishyFlopp: checks
rand60: checks
*** TURN *** [Kd 7s 3h] [3c]
FishyFlopp: checks
rand60: checks
*** RIVER *** [Kd 7s 3h 3c] [Jd]
FishyFlopp: checks
rand60: bets $0.21
FishyFlopp: folds
Uncalled bet ($0.21) returned to rand60
rand60 collected $0.21 from pot
rand60: doesn't show hand
*** SUMMARY ***
Total pot $0.22 | Rake $0.01
Board [Kd 7s 3h 3c Jd]
Seat 1: bobca1944 (button) folded before Flop (didn't bet)
Seat 2: PlayTheBlues4U (small blind) folded before Flop
Seat 3: FishyFlopp (big blind) folded on the River
Seat 4: rand60 collected ($0.21)
Seat 5: DeccaDan folded before Flop (didn't bet)
Seat 6: DemolishIT folded before Flop (didn't bet)


PokerStars Hand #203470998702:  Hold'em No Limit ($0.01/$0.02 USD) - 2019/09/06 21:37:53 ET
Table 'Pegasus' 6-max Seat #3 is the button
Seat 1: michelina44 ($0.52 in chips)
Seat 2: WillDuane ($1.94 in chips)
Seat 3: jjbenzky ($3.68 in chips)
Seat 4: PlayTheBlues4U ($4.78 in chips)
Seat 5: tsov252525 ($2.31 in chips)
Seat 6: TheWalrus435 ($2.59 in chips)
PlayTheBlues4U: posts small blind $0.01
tsov252525: posts big blind $0.02
*** HOLE CARDS ***
Dealt to PlayTheBlues4U [Ad Kh]
TheWalrus435: folds
michelina44: folds
WillDuane: folds
jjbenzky: calls $0.02
PlayTheBlues4U: calls $0.01
tsov252525: checks
*** FLOP *** [9c 3h Ks]
PlayTheBlues4U: bets $0.08
tsov252525: folds
jjbenzky: folds
Uncalled bet ($0.08) returned to PlayTheBlues4U
PlayTheBlues4U collected $0.06 from pot
PlayTheBlues4U: doesn't show hand
*** SUMMARY ***
Total pot $0.06 | Rake $0
Board [9c 3h Ks]
Seat 1: michelina44 folded before Flop (didn't bet)
Seat 2: WillDuane folded before Flop (didn't bet)
Seat 3: jjbenzky (button) folded on the Flop
Seat 4: PlayTheBlues4U (small blind) collected ($0.06)
Seat 5: tsov252525 (big blind) folded on the Flop
Seat 6: TheWalrus435 folded before Flop (didn't bet)


PokerStars Hand #203470998557:  Hold'em No Limit ($0.02/$0.05 USD) - 2019/09/06 21:37:07 ET
Table 'Icarus' 6-max Seat #6 is the button
Seat 1: bobca1944 ($2.64 in chips)
Seat 2: PlayTheBlues4U ($5 in chips)
Seat 3: FishyFlopp ($7.08 in chips)
Seat 4: rand60 ($4.83 in chips)
Seat 5: DeccaDan ($12.15 in chips)
Seat 6: DemolishIT ($10.67 in chips)
bobca1944: posts small blind $0.02
PlayTheBlues4U: posts big blind $0.05
*** HOLE CARDS ***
Dealt to PlayTheBlues4U [3d Ks]
FishyFlopp: folds
rand60: folds
DeccaDan: folds
DemolishIT: calls $0.05
bobca1944: calls $0.03
PlayTheBlues4U: checks
*** FLOP *** [Kd As 8c]
bobca1944: checks
PlayTheBlues4U: checks
DemolishIT: bets $0.14
bobca1944: folds
PlayTheBlues4U: folds
Uncalled bet ($0.14) returned to DemolishIT
DemolishIT collected $0.14 from pot
*** SUMMARY ***
Total pot $0.15 | Rake $0.01
Board [Kd As 8c]
Seat 1: bobca1944 (small blind) folded on the Flop
Seat 2: PlayTheBlues4U (big blind) folded on the Flop
Seat 3: FishyFlopp folded before Flop (didn't bet)
Seat 4: rand60 folded before Flop (didn't bet)
Seat 5: DeccaDan folded before Flop (didn't bet)
Seat 6: DemolishIT (button) collected ($0.14)


PokerStars Hand #203470998469:  Hold'em No Limit ($0.02/$0.05 USD) - 2019/09/06 21:36:35 ET
Table 'Icarus' 6-max Seat #5 is the button
Seat 1: bobca1944 ($2.89 in chips)
Seat 2: PlayTheBlues4U ($5 in chips)
Seat 3: FishyFlopp ($7.08 in chips)
Seat 4: rand60 ($4.83 in chips)
Seat 5: DeccaDan ($12.15 in chips)
Seat 6: DemolishIT ($10.44 in chips)
DemolishIT: posts small blind $0.02
bobca1944: posts big blind $0.05
*** HOLE CARDS ***
Dealt to PlayTheBlues4U [4s 3s]
PlayTheBlues4U: folds
FishyFlopp: folds
rand60: folds
DeccaDan: folds
DemolishIT: raises $0.20 to $0.25
bobca1944: calls $0.20
*** FLOP *** [Ts 8c 2s]
DemolishIT: bets $0.48
bobca1944: folds
Uncalled bet ($0.48) returned to DemolishIT
DemolishIT collected $0.48 from pot
*** SUMMARY ***
Total pot $0.50 | Rake $0.02
Board [Ts 8c 2s]
Seat 1: bobca1944 (big blind) folded on the Flop
Seat 2: PlayTheBlues4U folded before Flop (didn't bet)
Seat 3: FishyFlopp folded before Flop (didn't bet)
Seat 4: rand60 folded before Flop (didn't bet)
Seat 5: DeccaDan (button) folded before Flop (didn't bet)
Seat 6: DemolishIT (small blind) collected ($0.48)


PokerStars Hand #203470998443:  Hold'em No Limit ($0.01/$0.02 USD) - 2019/09/06 21:36:27 ET
Table 'Pegasus' 6-max Seat #2 is the button
Seat 1: michelina44 ($0.52 in chips)
Seat 2: WillDuane ($1.96 in chips)
Seat 3: jjbenzky ($4 in chips)
Seat 4: PlayTheBlues4U ($4.45 in chips)
Seat 5: tsov252525 ($2.31 in chips)
Seat 6: TheWalrus435 ($2.61 in chips)
jjbenzky: posts small blind $0.01
PlayTheBlues4U: posts big blind $0.02
*** HOLE CARDS ***
Dealt to PlayTheBlues4U [2d Qd]
tsov252525: folds
TheWalrus435: calls $0.02
michelina44: folds
WillDuane: calls $0.02
jjbenzky: calls $0.01
PlayTheBlues4U: checks
*** FLOP *** [5d Jd 3d]
jjbenzky: checks
PlayTheBlues4U: bets $0.08
TheWalrus435: folds
WillDuane: folds
jjbenzky: calls $0.08
*** TURN *** [5d Jd 3d] [Ac]
jjbenzky: checks
PlayTheBlues4U: bets $0.22
jjbenzky: calls $0.22
*** RIVER *** [5d Jd 3d Ac] [Jh]
jjbenzky: checks
PlayTheBlues4U: bets $0.66
jjbenzky: folds
Uncalled bet ($0.66) returned to PlayTheBlues4U
PlayTheBlues4U collected $0.65 from pot
PlayTheBlues4U: doesn't show hand
*** SUMMARY ***
Total pot $0.68 | Rake $0.03
Board [5d Jd 3d Ac Jh]
Seat 1: michelina44 folded before Flop (didn't bet)
Seat 2: WillDuane (button) folded on the Flop
Seat 3: jjbenzky (small blind) folded on the River
Seat 4: PlayTheBlues4U (big blind) collected ($0.65)
Seat 5: tsov252525 folded before Flop (didn't bet)
Seat 6: TheWalrus435 folded on the Flop


PokerStars Hand #203470998337:  Hold'em No Limit ($0.02/$0.05 USD) - 2019/09/06 21:35:55 ET
Table 'Icarus' 6-max Seat #4 is the button
Seat 1: bobca1944 ($2.89 in chips)
Seat 2: PlayTheBlues4U ($5 in chips)
Seat 3: FishyFlopp ($7.13 in chips)
Seat 4: rand60 ($4.83 in chips)
Seat 5: DeccaDan ($12.20 in chips)
Seat 6: DemolishIT ($10.34 in chips)
DeccaDan: posts small blind $0.02
DemolishIT: posts big blind $0.05
*** HOLE CARDS ***
Dealt to PlayTheBlues4U [2d 9s]
bobca1944: folds
PlayTheBlues4U: folds
FishyFlopp: calls $0.05
rand60: folds
DeccaDan: calls $0.03
DemolishIT: raises $0.25 to $0.30
FishyFlopp: folds
DeccaDan: folds
Uncalled bet ($0.25) returned to DemolishIT
DemolishIT collected $0.15 from pot
*** SUMMARY ***
Total pot $0.15 | Rake $0
Seat 1: bobca1944 folded before Flop (didn't bet)
Seat 2: PlayTheBlues4U folded before Flop (didn't bet)
Seat 3: FishyFlopp folded before Flop
Seat 4: rand60 (button) folded before Flop (didn't bet)
Seat 5: DeccaDan (small blind) folded before Flop
Seat 6: DemolishIT (big blind) collected ($0.15)


PokerStars Hand #203470998292:  Hold'em No Limit ($0.01/$0.02 USD) - 2019/09/06 21:35:45 ET
Table 'Pegasus' 6-max Seat #1 is the button
Seat 1: michelina44 ($0.52 in chips)
Seat 2: WillDuane ($1.98 in chips)
Seat 3: jjbenzky ($3.98 in chips)
Seat 4: PlayTheBlues4U ($4.45 in chips)
Seat 5: tsov252525 ($2.31 in chips)
Seat 6: TheWalrus435 ($2.61 in chips)
WillDuane: posts small blind $0.01
jjbenzky: posts big blind $0.02
*** HOLE CARDS ***
Dealt to PlayTheBlues4U [Qd 8d]
PlayTheBlues4U: folds
tsov252525: folds
TheWalrus435: folds
michelina44: folds
WillDuane: calls $0.01
jjbenzky: checks
*** FLOP *** [Kh 4c 2c]
WillDuane: checks
jjbenzky: bets $0.04
WillDuane: folds
Uncalled bet ($0.04) returned to jjbenzky
jjbenzky collected $0.04 from pot
jjbenzky: doesn't show hand
*** SUMMARY ***
Total pot $0.04 | Rake $0
Board [Kh 4c 2c]
Seat 1: michelina44 (button) folded before Flop (didn't bet)
Seat 2: WillDuane (small blind) folded on the Flop
Seat 3: jjbenzky (big blind) collected ($0.04)
Seat 4: PlayTheBlues4U folded before Flop (didn't bet)
Seat 5: tsov252525 folded before Flop (didn't bet)
Seat 6: TheWalrus435 folded before Flop (didn't bet)


PokerStars Hand #203470998202:  Hold'em No Limit ($0.02/$0.05 USD) - 2019/09/06 21:35:17 ET
Table 'Icarus' 6-max Seat #3 is the button
Seat 1: bobca1944 ($3.54 in chips)
Seat 2: PlayTheBlues4U ($5 in chips)
Seat 3: FishyFlopp ($5.86 in chips)
Seat 4: rand60 ($4.85 in chips)
Seat 5: DeccaDan ($12.25 in chips)
Seat 6: DemolishIT ($10.99 in chips)
rand60: posts small blind $0.02
DeccaDan: posts big blind $0.05
*** HOLE CARDS ***
Dealt to PlayTheBlues4U [7d Qh]
DemolishIT: raises $0.20 to $0.25
bobca1944: calls $0.25
PlayTheBlues4U: folds
FishyFlopp: raises $0.40 to $0.65
rand60: folds
DeccaDan: folds
DemolishIT: calls $0.40
bobca1944: calls $0.40
*** FLOP *** [Qd 4d 7s]
DemolishIT: checks
bobca1944: checks
FishyFlopp: bets $1.92
DemolishIT: folds
bobca1944: folds
Uncalled bet ($1.92) returned to FishyFlopp
FishyFlopp collected $1.92 from pot
FishyFlopp: doesn't show hand
*** SUMMARY ***
Total pot $2.02 | Rake $0.10
Board [Qd 4d 7s]
Seat 1: bobca1944 folded on the Flop
Seat 2: PlayTheBlues4U folded before Flop (didn't bet)
Seat 3: FishyFlopp (button) collected ($1.92)
Seat 4: rand60 (small blind) folded before Flop
Seat 5: DeccaDan (big blind) folded before Flop
Seat 6: DemolishIT folded on the Flop


PokerStars Hand #203470998146:  Hold'em No Limit ($0.02/$0.05 USD) - 2019/09/06 21:34:59 ET
Table 'Icarus' 6-max Seat #2 is the button
Seat 1: bobca1944 ($3.54 in chips)
Seat 2: PlayTheBlues4U ($5 in chips)
Seat 3: FishyFlopp ($5.88 in chips)
Seat 4: rand60 ($4.90 in chips)
Seat 5: DeccaDan ($12.25 in chips)
Seat 6: DemolishIT ($10.92 in chips)
FishyFlopp: posts small blind $0.02
rand60: posts big blind $0.05
*** HOLE CARDS ***
Dealt to PlayTheBlues4U [6s 2d]
DeccaDan: folds
DemolishIT: raises $0.20 to $0.25
bobca1944: folds
PlayTheBlues4U: folds
FishyFlopp: folds
rand60: folds
Uncalled bet ($0.20) returned to DemolishIT
DemolishIT collected $0.12 from pot
*** SUMMARY ***
Total pot $0.12 | Rake $0
Seat 1: bobca1944 folded before Flop (didn't bet)
Seat 2: PlayTheBlues4U (button) folded before Flop (didn't bet)
Seat 3: FishyFlopp (small blind) folded before Flop
Seat 4: rand60 (big blind) folded before Flop
Seat 5: DeccaDan folded before Flop (didn't bet)
Seat 6: DemolishIT collected ($0.12)


PokerStars Hand #203470998057:  Hold'em No Limit ($0.01/$0.02 USD) - 2019/09/06 21:34:29 ET
Table 'Pegasus' 6-max Seat #6 is the button
Seat 1: michelina44 ($0.53 in chips)
Seat 2: WillDuane ($2 in chips)
Seat 3: jjbenzky ($2.07 in chips)
Seat 4: PlayTheBlues4U ($4.45 in chips)
Seat 5: tsov252525 ($4.38 in chips)
Seat 6: TheWalrus435 ($2.61 in chips)
michelina44: posts small blind $0.01
WillDuane: posts big blind $0.02
*** HOLE CARDS ***
Dealt to PlayTheBlues4U [2s Kc]
jjbenzky: calls $0.02
PlayTheBlues4U: folds
tsov252525: raises $0.07 to $0.09
TheWalrus435: folds
michelina44: folds
WillDuane: folds
jjbenzky: calls $0.07
*** FLOP *** [3h 5s 5c]
jjbenzky: checks
tsov252525: bets $0.10
jjbenzky: calls $0.10
*** TURN *** [3h 5s 5c] [As]
jjbenzky: checks
tsov252525: checks
*** RIVER *** [3h 5s 5c As] [5h]
jjbenzky: bets $0.27
tsov252525: raises $0.93 to $1.20
jjbenzky: raises $0.68 to $1.88 and is all-in
tsov252525: calls $0.68
*** SHOW DOWN ***
jjbenzky: shows [5d 6d] (four of a kind, Fives)
tsov252525: shows [Ah Ac] (a full house, Aces full of Fives)
jjbenzky collected $3.98 from pot
*** SUMMARY ***
Total pot $4.17 | Rake $0.19
Board [3h 5s 5c As 5h]
Seat 1: michelina44 (small blind) folded before Flop
Seat 2: WillDuane (big blind) folded before Flop
Seat 3: jjbenzky showed [5d 6d] and won ($3.98) with four of a kind, Fives
Seat 4: PlayTheBlues4U folded before Flop (didn't bet)
Seat 5: tsov252525 showed [Ah Ac] and lost with a full house, Aces full of Fives
Seat 6: TheWalrus435 (button) folded before Flop (didn't bet)


PokerStars Hand #203470998004:  Hold'em No Limit ($0.01/$0.02 USD) - 2019/09/06 21:34:10 ET
Table 'Pegasus' 6-max Seat #5 is the button
Seat 1: michelina44 ($0.55 in chips)
Seat 3: jjbenzky ($2.04 in chips)
Seat 4: PlayTheBlues4U ($4.45 in chips)
Seat 5: tsov252525 ($4.38 in chips)
Seat 6: TheWalrus435 ($2.62 in chips)
TheWalrus435: posts small blind $0.01
michelina44: posts big blind $0.02
WillDuane: sits out
*** HOLE CARDS ***
Dealt to PlayTheBlues4U [3h 6d]
jjbenzky: raises $0.03 to $0.05
PlayTheBlues4U: folds
tsov252525: folds
TheWalrus435: folds
michelina44: folds
Uncalled bet ($0.03) returned to jjbenzky
jjbenzky collected $0.05 from pot
jjbenzky: doesn't show hand
*** SUMMARY ***
Total pot $0.05 | Rake $0
Seat 1: michelina44 (big blind) folded before Flop
Seat 3: jjbenzky collected ($0.05)
Seat 4: PlayTheBlues4U folded before Flop (didn't bet)
Seat 5: tsov252525 (button) folded before Flop (didn't bet)
Seat 6: TheWalrus435 (small blind) folded before Flop


PokerStars Hand #203470997944:  Hold'em No Limit ($0.02/$0.05 USD) - 2019/09/06 21:33:53 ET
Table 'Icarus' 6-max Seat #1 is the button
Seat 1: bobca1944 ($3.54 in chips)
Seat 2: PlayTheBlues4U ($5.02 in chips)
Seat 3: FishyFlopp ($5.59 in chips)
Seat 5: DeccaDan ($12.55 in chips)
Seat 6: DemolishIT ($10.92 in chips)
PlayTheBlues4U: posts small blind $0.02
FishyFlopp: posts big blind $0.05
rand60: sits out
*** HOLE CARDS ***
Dealt to PlayTheBlues4U [3s Td]
DeccaDan: calls $0.05
DemolishIT: folds
bobca1944: folds
PlayTheBlues4U: folds
FishyFlopp: raises $0.05 to $0.10
DeccaDan: calls $0.05
*** FLOP *** [8d 6s 2s]
FishyFlopp: bets $0.10
DeccaDan: calls $0.10
*** TURN *** [8d 6s 2s] [Ah]
FishyFlopp: checks
DeccaDan: bets $0.10
FishyFlopp: calls $0.10
*** RIVER *** [8d 6s 2s Ah] [5s]
FishyFlopp: bets $0.59
DeccaDan: folds
Uncalled bet ($0.59) returned to FishyFlopp
FishyFlopp collected $0.59 from pot
FishyFlopp: doesn't show hand
*** SUMMARY ***
Total pot $0.62 | Rake $0.03
Board [8d 6s 2s Ah 5s]
Seat 1: bobca1944 (button) folded before Flop (didn't bet)
Seat 2: PlayTheBlues4U (small blind) folded before Flop
Seat 3: FishyFlopp (big blind) collected ($0.59)
Seat 5: DeccaDan folded on the River
Seat 6: DemolishIT folded before Flop (didn't bet)


PokerStars Hand #203470997850:  Hold'em No Limit ($0.02/$0.05 USD) - 2019/09/06 21:33:23 ET
Table 'Icarus' 6-max Seat #6 is the button
Seat 1: bobca1944 ($3.56 in chips)
Seat 2: PlayTheBlues4U ($5.07 in chips)
Seat 3: FishyFlopp ($5.59 in chips)
Seat 5: DeccaDan ($12.55 in chips)
Seat 6: DemolishIT ($10.85 in chips)
bobca1944: posts small blind $0.02
PlayTheBlues4U: posts big blind $0.05
rand60: sits out
*** HOLE CARDS ***
Dealt to PlayTheBlues4U [6c 4s]
FishyFlopp: folds
DeccaDan: folds
DemolishIT: raises $0.20 to $0.25
bobca1944: folds
PlayTheBlues4U: folds
Uncalled bet ($0.20) returned to DemolishIT
DemolishIT collected $0.12 from pot
*** SUMMARY ***
Total pot $0.12 | Rake $0
Seat 1: bobca1944 (small blind) folded before Flop
Seat 2: PlayTheBlues4U (big blind) folded before Flop
Seat 3: FishyFlopp folded before Flop (didn't bet)
Seat 5: DeccaDan folded before Flop (didn't bet)
Seat 6: DemolishIT (button) collected ($0.12)


PokerStars Hand #203470997834:  Hold'em No Limit ($0.01/$0.02 USD) - 2019/09/06 21:33:18 ET
Table 'Pegasus' 6-max Seat #4 is the button
Seat 1: michelina44 ($0.57 in chips)
Seat 3: jjbenzky ($1.99 in chips)
Seat 4: PlayTheBlues4U ($4.45 in chips)
Seat 5: tsov252525 ($4.39 in chips)
Seat 6: TheWalrus435 ($2.64 in chips)
tsov252525: posts small blind $0.01
TheWalrus435: posts big blind $0.02
WillDuane: sits out
*** HOLE CARDS ***
Dealt to PlayTheBlues4U [Jd 4d]
michelina44: calls $0.02
jjbenzky: calls $0.02
PlayTheBlues4U: folds
tsov252525: folds
TheWalrus435: checks
*** FLOP *** [9d 7h 4s]
TheWalrus435: checks
michelina44: checks
jjbenzky: checks
*** TURN *** [9d 7h 4s] [Qc]
TheWalrus435: checks
michelina44: checks
jjbenzky: checks
*** RIVER *** [9d 7h 4s Qc] [5d]
TheWalrus435: checks
michelina44: checks
jjbenzky: bets $0.02
TheWalrus435: folds
michelina44: folds
Uncalled bet ($0.02) returned to jjbenzky
jjbenzky collected $0.07 from pot
*** SUMMARY ***
Total pot $0.07 | Rake $0
Board [9d 7h 4s Qc 5d]
Seat 1: michelina44 folded on the River
Seat 3: jjbenzky collected ($0.07)
Seat 4: PlayTheBlues4U (button) folded before Flop (didn't bet)
Seat 5: tsov252525 (small blind) folded before Flop
Seat 6: TheWalrus435 (big blind) folded on the River


PokerStars Hand #203470997751:  Hold'em No Limit ($0.01/$0.02 USD) - 2019/09/06 21:32:51 ET
Table 'Pegasus' 6-max Seat #3 is the button
Seat 1: michelina44 ($0.57 in chips)
Seat 3: jjbenzky ($1.93 in chips)
Seat 4: PlayTheBlues4U ($4.49 in chips)
Seat 5: tsov252525 ($4.41 in chips)
Seat 6: TheWalrus435 ($2.64 in chips)
PlayTheBlues4U: posts small blind $0.01
tsov252525: posts big blind $0.02
WillDuane: sits out
*** HOLE CARDS ***
Dealt to PlayTheBlues4U [4c 6c]
TheWalrus435: folds
michelina44: folds
jjbenzky: raises $0.02 to $0.04
PlayTheBlues4U: calls $0.03
tsov252525: folds
*** FLOP *** [7s 8s Ks]
PlayTheBlues4U: checks
jjbenzky: bets $0.05
PlayTheBlues4U: folds
Uncalled bet ($0.05) returned to jjbenzky
jjbenzky collected $0.10 from pot
jjbenzky: doesn't show hand
*** SUMMARY ***
Total pot $0.10 | Rake $0
Board [7s 8s Ks]
Seat 1: michelina44 folded before Flop (didn't bet)
Seat 3: jjbenzky (button) collected ($0.10)
Seat 4: PlayTheBlues4U (small blind) folded on the Flop
Seat 5: tsov252525 (big blind) folded before Flop
Seat 6: TheWalrus435 folded before Flop (didn't bet)


PokerStars Hand #203470997689:  Hold'em No Limit ($0.02/$0.05 USD) - 2019/09/06 21:32:35 ET
Table 'Icarus' 6-max Seat #5 is the button
Seat 1: bobca1944 ($3.61 in chips)
Seat 2: PlayTheBlues4U ($5.07 in chips)
Seat 3: FishyFlopp ($5.59 in chips)
Seat 5: DeccaDan ($12.60 in chips)
Seat 6: DemolishIT ($10.76 in chips)
DemolishIT: posts small blind $0.02
bobca1944: posts big blind $0.05
rand60: sits out
*** HOLE CARDS ***
Dealt to PlayTheBlues4U [7s 5c]
PlayTheBlues4U: folds
FishyFlopp: folds
DeccaDan: calls $0.05
DemolishIT: calls $0.03
bobca1944: checks
*** FLOP *** [8h 3d 2h]
DemolishIT: checks
bobca1944: checks
DeccaDan: checks
*** TURN *** [8h 3d 2h] [7d]
DemolishIT: checks
bobca1944: checks
DeccaDan: checks
*** RIVER *** [8h 3d 2h 7d] [2c]
DemolishIT: checks
bobca1944: checks
DeccaDan: checks
*** SHOW DOWN ***
DemolishIT: shows [6s Qs] (a pair of Deuces)
bobca1944: mucks hand
DeccaDan: mucks hand
DemolishIT collected $0.14 from pot
*** SUMMARY ***
Total pot $0.15 | Rake $0.01
Board [8h 3d 2h 7d 2c]
Seat 1: bobca1944 (big blind) mucked [Js 9h]
Seat 2: PlayTheBlues4U folded before Flop (didn't bet)
Seat 3: FishyFlopp folded before Flop (didn't bet)
Seat 5: DeccaDan (button) mucked [5s Ts]
Seat 6: DemolishIT (small blind) showed [6s Qs] and won ($0.14) with a pair of Deuces


PokerStars Hand #203470997643:  Hold'em No Limit ($0.01/$0.02 USD) - 2019/09/06 21:32:21 ET
Table 'Pegasus' 6-max Seat #1 is the button
Seat 1: michelina44 ($0.57 in chips)
Seat 3: jjbenzky ($1.91 in chips)
Seat 4: PlayTheBlues4U ($4.51 in chips)
Seat 5: tsov252525 ($4.41 in chips)
Seat 6: TheWalrus435 ($2.64 in chips)
jjbenzky: posts small blind $0.01
PlayTheBlues4U: posts big blind $0.02
*** HOLE CARDS ***
Dealt to PlayTheBlues4U [2s 4h]
tsov252525: folds
TheWalrus435: folds
michelina44: folds
jjbenzky: calls $0.01
PlayTheBlues4U: checks
*** FLOP *** [9c Tc Qc]
jjbenzky: bets $0.04
PlayTheBlues4U: folds
Uncalled bet ($0.04) returned to jjbenzky
jjbenzky collected $0.04 from pot
*** SUMMARY ***
Total pot $0.04 | Rake $0
Board [9c Tc Qc]
Seat 1: michelina44 (button) folded before Flop (didn't bet)
Seat 3: jjbenzky (small blind) collected ($0.04)
Seat 4: PlayTheBlues4U (big blind) folded on the Flop
Seat 5: tsov252525 folded before Flop (didn't bet)
Seat 6: TheWalrus435 folded before Flop (didn't bet)


PokerStars Hand #203470997529:  Hold'em No Limit ($0.01/$0.02 USD) - 2019/09/06 21:31:44 ET
Table 'Pegasus' 6-max Seat #6 is the button
Seat 1: michelina44 ($0.53 in chips)
Seat 3: jjbenzky ($1.95 in chips)
Seat 4: PlayTheBlues4U ($4.51 in chips)
Seat 5: tsov252525 ($4.41 in chips)
Seat 6: TheWalrus435 ($2.64 in chips)
michelina44: posts small blind $0.01
jjbenzky: posts big blind $0.02
*** HOLE CARDS ***
Dealt to PlayTheBlues4U [6h Qd]
PlayTheBlues4U: folds
tsov252525: folds
TheWalrus435: folds
michelina44: raises $0.02 to $0.04
jjbenzky: calls $0.02
*** FLOP *** [3c 3d Qc]
michelina44: checks
jjbenzky: checks
*** TURN *** [3c 3d Qc] [4h]
michelina44: checks
jjbenzky: checks
*** RIVER *** [3c 3d Qc 4h] [3s]
michelina44: checks
jjbenzky: checks
*** SHOW DOWN ***
michelina44: shows [Kd Ad] (three of a kind, Threes)
jjbenzky: mucks hand
michelina44 collected $0.08 from pot
*** SUMMARY ***
Total pot $0.08 | Rake $0
Board [3c 3d Qc 4h 3s]
Seat 1: michelina44 (small blind) showed [Kd Ad] and won ($0.08) with three of a kind, Threes
Seat 3: jjbenzky (big blind) mucked [7h 2c]
Seat 4: PlayTheBlues4U folded before Flop (didn't bet)
Seat 5: tsov252525 folded before Flop (didn't bet)
Seat 6: TheWalrus435 (button) folded before Flop (didn't bet)


PokerStars Hand #203470997528:  Hold'em No Limit ($0.02/$0.05 USD) - 2019/09/06 21:31:43 ET
Table 'Icarus' 6-max Seat #3 is the button
Seat 1: bobca1944 ($3.61 in chips)
Seat 2: PlayTheBlues4U ($5.44 in chips)
Seat 3: FishyFlopp ($5.19 in chips)
Seat 5: DeccaDan ($12.62 in chips)
Seat 6: DemolishIT ($10.81 in chips)
rand60 will be allowed to play after the button
DeccaDan: posts small blind $0.02
DemolishIT: posts big blind $0.05
*** HOLE CARDS ***
Dealt to PlayTheBlues4U [9h 9c]
bobca1944: folds
PlayTheBlues4U: raises $0.12 to $0.17
FishyFlopp: calls $0.17
DeccaDan: folds
DemolishIT: folds
*** FLOP *** [Jh 4h Td]
PlayTheBlues4U: bets $0.20
FishyFlopp: calls $0.20
*** TURN *** [Jh 4h Td] [3c]
PlayTheBlues4U: checks
FishyFlopp: bets $0.25
PlayTheBlues4U: folds
Uncalled bet ($0.25) returned to FishyFlopp
FishyFlopp collected $0.77 from pot
FishyFlopp: doesn't show hand
*** SUMMARY ***
Total pot $0.81 | Rake $0.04
Board [Jh 4h Td 3c]
Seat 1: bobca1944 folded before Flop (didn't bet)
Seat 2: PlayTheBlues4U folded on the Turn
Seat 3: FishyFlopp (button) collected ($0.77)
Seat 5: DeccaDan (small blind) folded before Flop
Seat 6: DemolishIT (big blind) folded before Flop


PokerStars Hand #203470997465:  Hold'em No Limit ($0.01/$0.02 USD) - 2019/09/06 21:31:25 ET
Table 'Pegasus' 6-max Seat #5 is the button
Seat 1: michelina44 ($0.55 in chips)
Seat 3: jjbenzky ($1.95 in chips)
Seat 4: PlayTheBlues4U ($4.51 in chips)
Seat 5: tsov252525 ($4.38 in chips)
Seat 6: TheWalrus435 ($2.65 in chips)
TheWalrus435: posts small blind $0.01
michelina44: posts big blind $0.02
*** HOLE CARDS ***
Dealt to PlayTheBlues4U [Qc 4c]
jjbenzky: folds
PlayTheBlues4U: folds
tsov252525: raises $0.04 to $0.06
TheWalrus435: folds
michelina44: folds
Uncalled bet ($0.04) returned to tsov252525
tsov252525 collected $0.05 from pot
tsov252525: doesn't show hand
*** SUMMARY ***
Total pot $0.05 | Rake $0
Seat 1: michelina44 (big blind) folded before Flop
Seat 3: jjbenzky folded before Flop (didn't bet)
Seat 4: PlayTheBlues4U folded before Flop (didn't bet)
Seat 5: tsov252525 (button) collected ($0.05)
Seat 6: TheWalrus435 (small blind) folded before Flop


PokerStars Hand #203470997349:  Hold'em No Limit ($0.02/$0.05 USD) - 2019/09/06 21:30:48 ET
Table 'Icarus' 6-max Seat #2 is the button
Seat 1: bobca1944 ($3.61 in chips)
Seat 2: PlayTheBlues4U ($5.49 in chips)
Seat 3: FishyFlopp ($5.24 in chips)
Seat 5: DeccaDan ($12.48 in chips)
Seat 6: DemolishIT ($10.86 in chips)
FishyFlopp: posts small blind $0.02
DeccaDan: posts big blind $0.05
*** HOLE CARDS ***
Dealt to PlayTheBlues4U [5s 5c]
DemolishIT: calls $0.05
bobca1944: folds
PlayTheBlues4U: calls $0.05
FishyFlopp: calls $0.03
DeccaDan: checks
*** FLOP *** [8h Qh 2d]
FishyFlopp: checks
rand60 joins the table at seat #4
DeccaDan: checks
DemolishIT: checks
PlayTheBlues4U: checks
*** TURN *** [8h Qh 2d] [3c]
FishyFlopp: checks
DeccaDan: bets $0.20
DemolishIT: folds
PlayTheBlues4U: folds
FishyFlopp: folds
Uncalled bet ($0.20) returned to DeccaDan
DeccaDan collected $0.19 from pot
DeccaDan: doesn't show hand
*** SUMMARY ***
Total pot $0.20 | Rake $0.01
Board [8h Qh 2d 3c]
Seat 1: bobca1944 folded before Flop (didn't bet)
Seat 2: PlayTheBlues4U (button) folded on the Turn
Seat 3: FishyFlopp (small blind) folded on the Turn
Seat 5: DeccaDan (big blind) collected ($0.19)
Seat 6: DemolishIT folded on the Turn


PokerStars Hand #203470997225:  Hold'em No Limit ($0.02/$0.05 USD) - 2019/09/06 21:30:05 ET
Table 'Icarus' 6-max Seat #1 is the button
Seat 1: bobca1944 ($3.61 in chips)
Seat 2: PlayTheBlues4U ($4.86 in chips)
Seat 3: FishyFlopp ($5.94 in chips)
Seat 5: DeccaDan ($12.48 in chips)
Seat 6: DemolishIT ($10.86 in chips)
PlayTheBlues4U: posts small blind $0.02
FishyFlopp: posts big blind $0.05
*** HOLE CARDS ***
Dealt to PlayTheBlues4U [Qc Jd]
DeccaDan: folds
DemolishIT: folds
bobca1944: folds
PlayTheBlues4U: calls $0.03
FishyFlopp: raises $0.10 to $0.15
PlayTheBlues4U: calls $0.10
*** FLOP *** [Qd 4c 5c]
PlayTheBlues4U: checks
FishyFlopp: checks
*** TURN *** [Qd 4c 5c] [3d]
PlayTheBlues4U: bets $0.20
FishyFlopp: calls $0.20
*** RIVER *** [Qd 4c 5c 3d] [5s]
PlayTheBlues4U: bets $0.35
FishyFlopp: calls $0.35
*** SHOW DOWN ***
PlayTheBlues4U: shows [Qc Jd] (two pair, Queens and Fives)
FishyFlopp: mucks hand
PlayTheBlues4U collected $1.33 from pot
*** SUMMARY ***
Total pot $1.40 | Rake $0.07
Board [Qd 4c 5c 3d 5s]
Seat 1: bobca1944 (button) folded before Flop (didn't bet)
Seat 2: PlayTheBlues4U (small blind) showed [Qc Jd] and won ($1.33) with two pair, Queens and Fives
Seat 3: FishyFlopp (big blind) mucked [Ad Js]
Seat 5: DeccaDan folded before Flop (didn't bet)
Seat 6: DemolishIT folded before Flop (didn't bet)


PokerStars Hand #203470997133:  Hold'em No Limit ($0.01/$0.02 USD) - 2019/09/06 21:29:37 ET
Table 'Pegasus' 6-max Seat #4 is the button
Seat 1: michelina44 ($0.55 in chips)
Seat 2: WillDuane ($1.95 in chips)
Seat 3: jjbenzky ($1.99 in chips)
Seat 4: PlayTheBlues4U ($4.51 in chips)
Seat 5: tsov252525 ($2.55 in chips)
Seat 6: TheWalrus435 ($2.67 in chips)
tsov252525: posts small blind $0.01
TheWalrus435: posts big blind $0.02
*** HOLE CARDS ***
Dealt to PlayTheBlues4U [Qc 2d]
michelina44: folds
WillDuane: raises $0.02 to $0.04
jjbenzky: calls $0.04
PlayTheBlues4U: folds
tsov252525: calls $0.03
TheWalrus435: folds
*** FLOP *** [Qd 7s Th]
tsov252525: checks
WillDuane: bets $0.06
jjbenzky: folds
tsov252525: raises $0.06 to $0.12
WillDuane: calls $0.06
*** TURN *** [Qd 7s Th] [2c]
tsov252525: bets $0.22
WillDuane: calls $0.22
*** RIVER *** [Qd 7s Th 2c] [3s]
tsov252525: bets $2.17 and is all-in
WillDuane: calls $1.57 and is all-in
Uncalled bet ($0.60) returned to tsov252525
*** SHOW DOWN ***
tsov252525: shows [Tc Ts] (three of a kind, Tens)
WillDuane: shows [Qh Kc] (a pair of Queens)
tsov252525 collected $3.78 from pot
*** SUMMARY ***
Total pot $3.96 | Rake $0.18
Board [Qd 7s Th 2c 3s]
Seat 1: michelina44 folded before Flop (didn't bet)
Seat 2: WillDuane showed [Qh Kc] and lost with a pair of Queens
Seat 3: jjbenzky folded on the Flop
Seat 4: PlayTheBlues4U (button) folded before Flop (didn't bet)
Seat 5: tsov252525 (small blind) showed [Tc Ts] and won ($3.78) with three of a kind, Tens
Seat 6: TheWalrus435 (big blind) folded before Flop


PokerStars Hand #203470997016:  Hold'em No Limit ($0.02/$0.05 USD) - 2019/09/06 21:28:58 ET
Table 'Icarus' 6-max Seat #6 is the button
Seat 1: bobca1944 ($3.63 in chips)
Seat 2: PlayTheBlues4U ($4.91 in chips)
Seat 3: FishyFlopp ($6.48 in chips)
Seat 4: jjbenzky ($3.54 in chips)
Seat 5: DeccaDan ($11.93 in chips)
Seat 6: DemolishIT ($10.86 in chips)
bobca1944: posts small blind $0.02
PlayTheBlues4U: posts big blind $0.05
*** HOLE CARDS ***
Dealt to PlayTheBlues4U [Kh 3d]
FishyFlopp: raises $0.17 to $0.22
jjbenzky: folds
jjbenzky leaves the table
DeccaDan: calls $0.22
DemolishIT: folds
bobca1944: folds
PlayTheBlues4U: folds
*** FLOP *** [Jc 4c 7d]
FishyFlopp: checks
DeccaDan: checks
*** TURN *** [Jc 4c 7d] [6h]
FishyFlopp: bets $0.32
DeccaDan: calls $0.32
*** RIVER *** [Jc 4c 7d 6h] [9h]
FishyFlopp: checks
DeccaDan: bets $0.65
FishyFlopp: folds
Uncalled bet ($0.65) returned to DeccaDan
DeccaDan collected $1.09 from pot
DeccaDan: doesn't show hand
*** SUMMARY ***
Total pot $1.15 | Rake $0.06
Board [Jc 4c 7d 6h 9h]
Seat 1: bobca1944 (small blind) folded before Flop
Seat 2: PlayTheBlues4U (big blind) folded before Flop
Seat 3: FishyFlopp folded on the River
Seat 4: jjbenzky folded before Flop (didn't bet)
Seat 5: DeccaDan collected ($1.09)
Seat 6: DemolishIT (button) folded before Flop (didn't bet)


PokerStars Hand #203470996913:  Hold'em No Limit ($0.01/$0.02 USD) - 2019/09/06 21:28:27 ET
Table 'Pegasus' 6-max Seat #3 is the button
Seat 1: michelina44 ($0.55 in chips)
Seat 2: WillDuane ($1.97 in chips)
Seat 3: jjbenzky ($1.91 in chips)
Seat 4: PlayTheBlues4U ($4.53 in chips)
Seat 5: tsov252525 ($2.57 in chips)
Seat 6: TheWalrus435 ($2.69 in chips)
PlayTheBlues4U: posts small blind $0.01
tsov252525: posts big blind $0.02
*** HOLE CARDS ***
Dealt to PlayTheBlues4U [9c 6d]
TheWalrus435: calls $0.02
michelina44: folds
WillDuane: calls $0.02
jjbenzky: calls $0.02
PlayTheBlues4U: calls $0.01
tsov252525: checks
*** FLOP *** [7c Ah Jd]
PlayTheBlues4U: checks
tsov252525: checks
TheWalrus435: checks
WillDuane: checks
jjbenzky: bets $0.07
PlayTheBlues4U: folds
tsov252525: folds
TheWalrus435: folds
WillDuane: folds
Uncalled bet ($0.07) returned to jjbenzky
jjbenzky collected $0.10 from pot
jjbenzky: doesn't show hand
*** SUMMARY ***
Total pot $0.10 | Rake $0
Board [7c Ah Jd]
Seat 1: michelina44 folded before Flop (didn't bet)
Seat 2: WillDuane folded on the Flop
Seat 3: jjbenzky (button) collected ($0.10)
Seat 4: PlayTheBlues4U (small blind) folded on the Flop
Seat 5: tsov252525 (big blind) folded on the Flop
Seat 6: TheWalrus435 folded on the Flop


PokerStars Hand #203470996903:  Hold'em No Limit ($0.02/$0.05 USD) - 2019/09/06 21:28:23 ET
Table 'Icarus' 6-max Seat #5 is the button
Seat 1: bobca1944 ($3.68 in chips)
Seat 2: PlayTheBlues4U ($4.91 in chips)
Seat 3: FishyFlopp ($6.48 in chips)
Seat 4: jjbenzky ($3.31 in chips)
Seat 5: DeccaDan ($11.93 in chips)
Seat 6: DemolishIT ($11.06 in chips)
DemolishIT: posts small blind $0.02
bobca1944: posts big blind $0.05
*** HOLE CARDS ***
Dealt to PlayTheBlues4U [9d 8c]
PlayTheBlues4U: folds
FishyFlopp: folds
jjbenzky: calls $0.05
DeccaDan: folds
DemolishIT: raises $0.15 to $0.20
bobca1944: folds
jjbenzky: calls $0.15
*** FLOP *** [4d 5d 6c]
DemolishIT: checks
jjbenzky: checks
*** TURN *** [4d 5d 6c] [7s]
DemolishIT: checks
jjbenzky: checks
*** RIVER *** [4d 5d 6c 7s] [3h]
DemolishIT: checks
jjbenzky: bets $0.05
DemolishIT: folds
Uncalled bet ($0.05) returned to jjbenzky
jjbenzky collected $0.43 from pot
*** SUMMARY ***
Total pot $0.45 | Rake $0.02
Board [4d 5d 6c 7s 3h]
Seat 1: bobca1944 (big blind) folded before Flop
Seat 2: PlayTheBlues4U folded before Flop (didn't bet)
Seat 3: FishyFlopp folded before Flop (didn't bet)
Seat 4: jjbenzky collected ($0.43)
Seat 5: DeccaDan (button) folded before Flop (didn't bet)
Seat 6: DemolishIT (small blind) folded on the River


PokerStars Hand #203470996792:  Hold'em No Limit ($0.01/$0.02 USD) - 2019/09/06 21:27:48 ET
Table 'Pegasus' 6-max Seat #2 is the button
Seat 1: michelina44 ($0.58 in chips)
Seat 2: WillDuane ($1.97 in chips)
Seat 3: jjbenzky ($1.84 in chips)
Seat 4: PlayTheBlues4U ($4.55 in chips)
Seat 5: tsov252525 ($2.57 in chips)
Seat 6: TheWalrus435 ($2.71 in chips)
jjbenzky: posts small blind $0.01
PlayTheBlues4U: posts big blind $0.02
michelina44: posts small & big blinds $0.03
*** HOLE CARDS ***
Dealt to PlayTheBlues4U [5c 3d]
tsov252525: folds
TheWalrus435: calls $0.02
michelina44: checks
WillDuane: folds
jjbenzky: calls $0.01
PlayTheBlues4U: checks
*** FLOP *** [3s Jd 4c]
jjbenzky: bets $0.06
PlayTheBlues4U: folds
TheWalrus435: folds
michelina44: folds
Uncalled bet ($0.06) returned to jjbenzky
jjbenzky collected $0.09 from pot
*** SUMMARY ***
Total pot $0.09 | Rake $0
Board [3s Jd 4c]
Seat 1: michelina44 folded on the Flop (didn't bet)
Seat 2: WillDuane (button) folded before Flop (didn't bet)
Seat 3: jjbenzky (small blind) collected ($0.09)
Seat 4: PlayTheBlues4U (big blind) folded on the Flop
Seat 5: tsov252525 folded before Flop (didn't bet)
Seat 6: TheWalrus435 folded on the Flop


PokerStars Hand #203470996717:  Hold'em No Limit ($0.02/$0.05 USD) - 2019/09/06 21:27:22 ET
Table 'Icarus' 6-max Seat #4 is the button
Seat 1: bobca1944 ($3.68 in chips)
Seat 2: PlayTheBlues4U ($5.36 in chips)
Seat 3: FishyFlopp ($6.48 in chips)
Seat 4: jjbenzky ($2.62 in chips)
Seat 5: DeccaDan ($12.08 in chips)
Seat 6: DemolishIT ($11.21 in chips)
DeccaDan: posts small blind $0.02
DemolishIT: posts big blind $0.05
*** HOLE CARDS ***
Dealt to PlayTheBlues4U [7c 5c]
bobca1944: folds
PlayTheBlues4U: raises $0.10 to $0.15
FishyFlopp: folds
jjbenzky: calls $0.15
DeccaDan: calls $0.13
DemolishIT: calls $0.10
*** FLOP *** [5d Jh Jd]
DeccaDan: checks
DemolishIT: checks
PlayTheBlues4U: bets $0.30
jjbenzky: calls $0.30
DeccaDan: folds
DemolishIT: folds
*** TURN *** [5d Jh Jd] [9c]
PlayTheBlues4U: checks
jjbenzky: bets $0.80
PlayTheBlues4U: folds
Uncalled bet ($0.80) returned to jjbenzky
jjbenzky collected $1.14 from pot
jjbenzky: doesn't show hand
*** SUMMARY ***
Total pot $1.20 | Rake $0.06
Board [5d Jh Jd 9c]
Seat 1: bobca1944 folded before Flop (didn't bet)
Seat 2: PlayTheBlues4U folded on the Turn
Seat 3: FishyFlopp folded before Flop (didn't bet)
Seat 4: jjbenzky (button) collected ($1.14)
Seat 5: DeccaDan (small blind) folded on the Flop
Seat 6: DemolishIT (big blind) folded on the Flop


PokerStars Hand #203470996626:  Hold'em No Limit ($0.01/$0.02 USD) - 2019/09/06 21:26:55 ET
Table 'Pegasus' 6-max Seat #6 is the button
Seat 2: WillDuane ($1.99 in chips)
Seat 3: jjbenzky ($1.82 in chips)
Seat 4: PlayTheBlues4U ($4.55 in chips)
Seat 5: tsov252525 ($2.57 in chips)
Seat 6: TheWalrus435 ($2.71 in chips)
WillDuane: posts small blind $0.01
jjbenzky: posts big blind $0.02
*** HOLE CARDS ***
Dealt to PlayTheBlues4U [Td Ks]
PlayTheBlues4U: folds
tsov252525: folds
TheWalrus435: folds
WillDuane: calls $0.01
jjbenzky: checks
*** FLOP *** [8h Ac 3d]
WillDuane: checks
jjbenzky: bets $0.03
WillDuane: folds
Uncalled bet ($0.03) returned to jjbenzky
jjbenzky collected $0.04 from pot
*** SUMMARY ***
Total pot $0.04 | Rake $0
Board [8h Ac 3d]
Seat 2: WillDuane (small blind) folded on the Flop
Seat 3: jjbenzky (big blind) collected ($0.04)
Seat 4: PlayTheBlues4U folded before Flop (didn't bet)
Seat 5: tsov252525 folded before Flop (didn't bet)
Seat 6: TheWalrus435 (button) folded before Flop (didn't bet)


PokerStars Hand #203470996536:  Hold'em No Limit ($0.01/$0.02 USD) - 2019/09/06 21:26:30 ET
Table 'Pegasus' 6-max Seat #5 is the button
Seat 2: WillDuane ($2.01 in chips)
Seat 3: jjbenzky ($1.75 in chips)
Seat 4: PlayTheBlues4U ($4.59 in chips)
Seat 5: tsov252525 ($2.57 in chips)
Seat 6: TheWalrus435 ($2.72 in chips)
TheWalrus435: posts small blind $0.01
WillDuane: posts big blind $0.02
*** HOLE CARDS ***
Dealt to PlayTheBlues4U [Ad 5d]
jjbenzky: raises $0.02 to $0.04
PlayTheBlues4U: calls $0.04
tsov252525: folds
TheWalrus435: folds
WillDuane: folds
*** FLOP *** [9c Qd 9h]
jjbenzky: bets $0.11
PlayTheBlues4U: folds
Uncalled bet ($0.11) returned to jjbenzky
jjbenzky collected $0.11 from pot
*** SUMMARY ***
Total pot $0.11 | Rake $0
Board [9c Qd 9h]
Seat 2: WillDuane (big blind) folded before Flop
Seat 3: jjbenzky collected ($0.11)
Seat 4: PlayTheBlues4U folded on the Flop
Seat 5: tsov252525 (button) folded before Flop (didn't bet)
Seat 6: TheWalrus435 (small blind) folded before Flop


PokerStars Hand #203470996516:  Hold'em No Limit ($0.02/$0.05 USD) - 2019/09/06 21:26:24 ET
Table 'Icarus' 6-max Seat #3 is the button
Seat 1: bobca1944 ($3.68 in chips)
Seat 2: PlayTheBlues4U ($5.36 in chips)
Seat 3: FishyFlopp ($5.92 in chips)
Seat 4: jjbenzky ($3.19 in chips)
Seat 5: DeccaDan ($12.13 in chips)
Seat 6: DemolishIT ($11.21 in chips)
jjbenzky: posts small blind $0.02
DeccaDan: posts big blind $0.05
*** HOLE CARDS ***
Dealt to PlayTheBlues4U [3s Qc]
DemolishIT: folds
bobca1944: folds
PlayTheBlues4U: folds
FishyFlopp: raises $0.17 to $0.22
jjbenzky: calls $0.20
DeccaDan: folds
*** FLOP *** [8d 9d 3h]
jjbenzky: checks
FishyFlopp: bets $0.35
jjbenzky: calls $0.35
*** TURN *** [8d 9d 3h] [Ks]
jjbenzky: checks
FishyFlopp: bets $0.72
jjbenzky: folds
Uncalled bet ($0.72) returned to FishyFlopp
FishyFlopp collected $1.13 from pot
FishyFlopp: doesn't show hand
*** SUMMARY ***
Total pot $1.19 | Rake $0.06
Board [8d 9d 3h Ks]
Seat 1: bobca1944 folded before Flop (didn't bet)
Seat 2: PlayTheBlues4U folded before Flop (didn't bet)
Seat 3: FishyFlopp (button) collected ($1.13)
Seat 4: jjbenzky (small blind) folded on the Turn
Seat 5: DeccaDan (big blind) folded before Flop
Seat 6: DemolishIT folded before Flop (didn't bet)


PokerStars Hand #203470996361:  Hold'em No Limit ($0.02/$0.05 USD) - 2019/09/06 21:25:34 ET
Table 'Icarus' 6-max Seat #2 is the button
Seat 1: bobca1944 ($3.26 in chips)
Seat 2: PlayTheBlues4U ($5.36 in chips)
Seat 3: FishyFlopp ($6.12 in chips)
Seat 4: jjbenzky ($3.24 in chips)
Seat 5: DeccaDan ($12.13 in chips)
Seat 6: DemolishIT ($11.41 in chips)
FishyFlopp: posts small blind $0.02
jjbenzky: posts big blind $0.05
*** HOLE CARDS ***
Dealt to PlayTheBlues4U [Qd 5s]
DeccaDan: folds
DemolishIT: calls $0.05
bobca1944: calls $0.05
PlayTheBlues4U: folds
FishyFlopp: raises $0.15 to $0.20
jjbenzky: folds
DemolishIT: calls $0.15
bobca1944: calls $0.15
*** FLOP *** [7h 4s Ac]
FishyFlopp: checks
DemolishIT: checks
bobca1944: checks
*** TURN *** [7h 4s Ac] [6d]
FishyFlopp: checks
DemolishIT: checks
bobca1944: bets $0.62
FishyFlopp: folds
DemolishIT: folds
Uncalled bet ($0.62) returned to bobca1944
bobca1944 collected $0.62 from pot
bobca1944: doesn't show hand
*** SUMMARY ***
Total pot $0.65 | Rake $0.03
Board [7h 4s Ac 6d]
Seat 1: bobca1944 collected ($0.62)
Seat 2: PlayTheBlues4U (button) folded before Flop (didn't bet)
Seat 3: FishyFlopp (small blind) folded on the Turn
Seat 4: jjbenzky (big blind) folded before Flop
Seat 5: DeccaDan folded before Flop (didn't bet)
Seat 6: DemolishIT folded on the Turn


PokerStars Hand #203470996330:  Hold'em No Limit ($0.01/$0.02 USD) - 2019/09/06 21:25:25 ET
Table 'Pegasus' 6-max Seat #4 is the button
Seat 2: WillDuane ($2.01 in chips)
Seat 3: jjbenzky ($2 in chips)
Seat 4: PlayTheBlues4U ($4.59 in chips)
Seat 5: tsov252525 ($2.59 in chips)
Seat 6: TheWalrus435 ($2.47 in chips)
tsov252525: posts small blind $0.01
TheWalrus435: posts big blind $0.02
jjbenzky: posts big blind $0.02
*** HOLE CARDS ***
Dealt to PlayTheBlues4U [Tc 7d]
WillDuane: folds
jjbenzky: checks
PlayTheBlues4U: folds
tsov252525: calls $0.01
TheWalrus435: checks
*** FLOP *** [As 2c Ah]
tsov252525: checks
TheWalrus435: checks
jjbenzky: bets $0.06
tsov252525: folds
TheWalrus435: calls $0.06
*** TURN *** [As 2c Ah] [9h]
TheWalrus435: checks
jjbenzky: checks
*** RIVER *** [As 2c Ah 9h] [3h]
TheWalrus435: bets $0.17
jjbenzky: calls $0.17
*** SHOW DOWN ***
TheWalrus435: shows [Ad Qd] (three of a kind, Aces)
jjbenzky: mucks hand
TheWalrus435 collected $0.50 from pot
*** SUMMARY ***
Total pot $0.52 | Rake $0.02
Board [As 2c Ah 9h 3h]
Seat 2: WillDuane folded before Flop (didn't bet)
Seat 3: jjbenzky mucked [2s Td]
Seat 4: PlayTheBlues4U (button) folded before Flop (didn't bet)
Seat 5: tsov252525 (small blind) folded on the Flop
Seat 6: TheWalrus435 (big blind) showed [Ad Qd] and won ($0.50) with three of a kind, Aces


PokerStars Hand #203470996194:  Hold'em No Limit ($0.02/$0.05 USD) - 2019/09/06 21:24:45 ET
Table 'Icarus' 6-max Seat #1 is the button
Seat 1: bobca1944 ($3.26 in chips)
Seat 2: PlayTheBlues4U ($5.38 in chips)
Seat 3: FishyFlopp ($6.17 in chips)
Seat 4: jjbenzky ($3.24 in chips)
Seat 5: DeccaDan ($11.88 in chips)
Seat 6: DemolishIT ($11.61 in chips)
PlayTheBlues4U: posts small blind $0.02
FishyFlopp: posts big blind $0.05
*** HOLE CARDS ***
Dealt to PlayTheBlues4U [9d 8c]
jjbenzky: folds
DeccaDan: calls $0.05
DemolishIT: raises $0.15 to $0.20
bobca1944: folds
PlayTheBlues4U: folds
FishyFlopp: folds
DeccaDan: calls $0.15
*** FLOP *** [4d 4s Kc]
DeccaDan: checks
DemolishIT: checks
*** TURN *** [4d 4s Kc] [3c]
DeccaDan: checks
DemolishIT: checks
*** RIVER *** [4d 4s Kc 3c] [Kh]
DeccaDan: checks
DemolishIT: checks
*** SHOW DOWN ***
DeccaDan: shows [Js Qd] (two pair, Kings and Fours)
DemolishIT: mucks hand
DeccaDan collected $0.45 from pot
*** SUMMARY ***
Total pot $0.47 | Rake $0.02
Board [4d 4s Kc 3c Kh]
Seat 1: bobca1944 (button) folded before Flop (didn't bet)
Seat 2: PlayTheBlues4U (small blind) folded before Flop
Seat 3: FishyFlopp (big blind) folded before Flop
Seat 4: jjbenzky folded before Flop (didn't bet)
Seat 5: DeccaDan showed [Js Qd] and won ($0.45) with two pair, Kings and Fours
Seat 6: DemolishIT mucked [9c Td]


PokerStars Hand #203470996078:  Hold'em No Limit ($0.01/$0.02 USD) - 2019/09/06 21:24:09 ET
Table 'Pegasus' 6-max Seat #2 is the button
Seat 2: WillDuane ($2.01 in chips)
Seat 4: PlayTheBlues4U ($4.55 in chips)
Seat 5: tsov252525 ($2.61 in chips)
Seat 6: TheWalrus435 ($2.49 in chips)
PlayTheBlues4U: posts small blind $0.01
tsov252525: posts big blind $0.02
*** HOLE CARDS ***
Dealt to PlayTheBlues4U [9s 4h]
TheWalrus435: calls $0.02
michelina44 is disconnected
WillDuane: folds
PlayTheBlues4U: calls $0.01
tsov252525: checks
*** FLOP *** [5c 4d Kd]
PlayTheBlues4U: checks
jjbenzky joins the table at seat #3
tsov252525: checks
TheWalrus435: checks
*** TURN *** [5c 4d Kd] [3h]
PlayTheBlues4U: checks
tsov252525: checks
TheWalrus435: checks
*** RIVER *** [5c 4d Kd 3h] [Ks]
PlayTheBlues4U: checks
tsov252525: checks
TheWalrus435: checks
*** SHOW DOWN ***
PlayTheBlues4U: shows [9s 4h] (two pair, Kings and Fours)
tsov252525: mucks hand
TheWalrus435: mucks hand
PlayTheBlues4U collected $0.06 from pot
*** SUMMARY ***
Total pot $0.06 | Rake $0
Board [5c 4d Kd 3h Ks]
Seat 2: WillDuane (button) folded before Flop (didn't bet)
Seat 4: PlayTheBlues4U (small blind) showed [9s 4h] and won ($0.06) with two pair, Kings and Fours
Seat 5: tsov252525 (big blind) mucked [Tc 9d]
Seat 6: TheWalrus435 mucked [2s 7d]


PokerStars Hand #203470996069:  Hold'em No Limit ($0.02/$0.05 USD) - 2019/09/06 21:24:05 ET
Table 'Icarus' 6-max Seat #6 is the button
Seat 1: bobca1944 ($3.31 in chips)
Seat 2: PlayTheBlues4U ($5.23 in chips)
Seat 3: FishyFlopp ($6.22 in chips)
Seat 4: jjbenzky ($3.29 in chips)
Seat 5: DeccaDan ($11.88 in chips)
Seat 6: DemolishIT ($11.61 in chips)
bobca1944: posts small blind $0.02
PlayTheBlues4U: posts big blind $0.05
*** HOLE CARDS ***
Dealt to PlayTheBlues4U [As Qs]
FishyFlopp: calls $0.05
jjbenzky: calls $0.05
DeccaDan: folds
DemolishIT: folds
bobca1944: calls $0.03
PlayTheBlues4U: raises $0.30 to $0.35
FishyFlopp: folds
jjbenzky: folds
bobca1944: folds
Uncalled bet ($0.30) returned to PlayTheBlues4U
PlayTheBlues4U collected $0.20 from pot
PlayTheBlues4U: doesn't show hand
*** SUMMARY ***
Total pot $0.20 | Rake $0
Seat 1: bobca1944 (small blind) folded before Flop
Seat 2: PlayTheBlues4U (big blind) collected ($0.20)
Seat 3: FishyFlopp folded before Flop
Seat 4: jjbenzky folded before Flop
Seat 5: DeccaDan folded before Flop (didn't bet)
Seat 6: DemolishIT (button) folded before Flop (didn't bet)


PokerStars Hand #203470995940:  Hold'em No Limit ($0.02/$0.05 USD) - 2019/09/06 21:23:23 ET
Table 'Icarus' 6-max Seat #5 is the button
Seat 1: bobca1944 ($3.36 in chips)
Seat 2: PlayTheBlues4U ($5.23 in chips)
Seat 3: FishyFlopp ($4.93 in chips)
Seat 4: jjbenzky ($3.54 in chips)
Seat 5: DeccaDan ($12.98 in chips)
Seat 6: DemolishIT ($11.63 in chips)
DemolishIT: posts small blind $0.02
bobca1944: posts big blind $0.05
*** HOLE CARDS ***
Dealt to PlayTheBlues4U [6d 7s]
PlayTheBlues4U: folds
FishyFlopp: calls $0.05
jjbenzky: calls $0.05
DeccaDan: raises $0.20 to $0.25
DemolishIT: folds
bobca1944: folds
FishyFlopp: calls $0.20
jjbenzky: calls $0.20
*** FLOP *** [2h 4s Jh]
FishyFlopp: checks
jjbenzky: checks
DeccaDan: bets $0.30
FishyFlopp: calls $0.30
jjbenzky: folds
*** TURN *** [2h 4s Jh] [3d]
FishyFlopp: checks
DeccaDan: checks
*** RIVER *** [2h 4s Jh 3d] [Ah]
FishyFlopp: bets $0.55
DeccaDan: calls $0.55
*** SHOW DOWN ***
FishyFlopp: shows [8s 5s] (a straight, Ace to Five)
DeccaDan: mucks hand
FishyFlopp collected $2.39 from pot
*** SUMMARY ***
Total pot $2.52 | Rake $0.13
Board [2h 4s Jh 3d Ah]
Seat 1: bobca1944 (big blind) folded before Flop
Seat 2: PlayTheBlues4U folded before Flop (didn't bet)
Seat 3: FishyFlopp showed [8s 5s] and won ($2.39) with a straight, Ace to Five
Seat 4: jjbenzky folded on the Flop
Seat 5: DeccaDan (button) mucked [Ac Kc]
Seat 6: DemolishIT (small blind) folded before Flop


PokerStars Hand #203470995912:  Hold'em No Limit ($0.01/$0.02 USD) - 2019/09/06 21:23:16 ET
Table 'Pegasus' 6-max Seat #6 is the button
Seat 1: michelina44 ($0.59 in chips)
Seat 2: WillDuane ($2 in chips)
Seat 3: robcandy ($0.97 in chips)
Seat 4: PlayTheBlues4U ($4.55 in chips)
Seat 5: tsov252525 ($2.61 in chips)
Seat 6: TheWalrus435 ($2.49 in chips)
michelina44: posts small blind $0.01
WillDuane: posts big blind $0.02
*** HOLE CARDS ***
Dealt to PlayTheBlues4U [Ts 2c]
robcandy: folds
PlayTheBlues4U: folds
tsov252525: folds
TheWalrus435: folds
robcandy leaves the table
michelina44 has timed out
michelina44: folds
Uncalled bet ($0.01) returned to WillDuane
WillDuane collected $0.02 from pot
WillDuane: doesn't show hand
*** SUMMARY ***
Total pot $0.02 | Rake $0
Seat 1: michelina44 (small blind) folded before Flop
Seat 2: WillDuane (big blind) collected ($0.02)
Seat 3: robcandy folded before Flop (didn't bet)
Seat 4: PlayTheBlues4U folded before Flop (didn't bet)
Seat 5: tsov252525 folded before Flop (didn't bet)
Seat 6: TheWalrus435 (button) folded before Flop (didn't bet)


PokerStars Hand #203470995820:  Hold'em No Limit ($0.01/$0.02 USD) - 2019/09/06 21:22:41 ET
Table 'Pegasus' 6-max Seat #5 is the button
Seat 1: michelina44 ($0.61 in chips)
Seat 3: robcandy ($0.97 in chips)
Seat 4: PlayTheBlues4U ($4.55 in chips)
Seat 5: tsov252525 ($2.58 in chips)
Seat 6: TheWalrus435 ($2.50 in chips)
TheWalrus435: posts small blind $0.01
michelina44: posts big blind $0.02
WillDuane: sits out
*** HOLE CARDS ***
Dealt to PlayTheBlues4U [3c 2c]
robcandy: folds
PlayTheBlues4U: folds
tsov252525: raises $0.04 to $0.06
TheWalrus435: folds
michelina44: folds
Uncalled bet ($0.04) returned to tsov252525
tsov252525 collected $0.05 from pot
tsov252525: doesn't show hand
*** SUMMARY ***
Total pot $0.05 | Rake $0
Seat 1: michelina44 (big blind) folded before Flop
Seat 3: robcandy folded before Flop (didn't bet)
Seat 4: PlayTheBlues4U folded before Flop (didn't bet)
Seat 5: tsov252525 (button) collected ($0.05)
Seat 6: TheWalrus435 (small blind) folded before Flop


PokerStars Hand #203470995768:  Hold'em No Limit ($0.02/$0.05 USD) - 2019/09/06 21:22:27 ET
Table 'Icarus' 6-max Seat #4 is the button
Seat 1: bobca1944 ($3.93 in chips)
Seat 2: PlayTheBlues4U ($5.23 in chips)
Seat 3: FishyFlopp ($5 in chips)
Seat 4: jjbenzky ($3.59 in chips)
Seat 5: DeccaDan ($12.31 in chips)
Seat 6: DemolishIT ($11.68 in chips)
DeccaDan: posts small blind $0.02
DemolishIT: posts big blind $0.05
FishyFlopp: posts small & big blinds $0.07
*** HOLE CARDS ***
Dealt to PlayTheBlues4U [Jd 4s]
bobca1944: calls $0.05
PlayTheBlues4U: folds
FishyFlopp: checks
jjbenzky: calls $0.05
DeccaDan: raises $0.27 to $0.32
DemolishIT: folds
bobca1944: calls $0.27
FishyFlopp: folds
jjbenzky: folds
*** FLOP *** [8h 2c Kd]
DeccaDan: checks
bobca1944: checks
*** TURN *** [8h 2c Kd] [2d]
DeccaDan: bets $0.25
bobca1944: calls $0.25
*** RIVER *** [8h 2c Kd 2d] [Kc]
DeccaDan: checks
bobca1944: checks
*** SHOW DOWN ***
DeccaDan: shows [Jh Jc] (two pair, Kings and Jacks)
bobca1944: mucks hand
DeccaDan collected $1.24 from pot
*** SUMMARY ***
Total pot $1.31 | Rake $0.07
Board [8h 2c Kd 2d Kc]
Seat 1: bobca1944 mucked [6h 6c]
Seat 2: PlayTheBlues4U folded before Flop (didn't bet)
Seat 3: FishyFlopp folded before Flop (didn't bet)
Seat 4: jjbenzky (button) folded before Flop
Seat 5: DeccaDan (small blind) showed [Jh Jc] and won ($1.24) with two pair, Kings and Jacks
Seat 6: DemolishIT (big blind) folded before Flop


PokerStars Hand #203470995719:  Hold'em No Limit ($0.01/$0.02 USD) - 2019/09/06 21:22:11 ET
Table 'Pegasus' 6-max Seat #4 is the button
Seat 1: michelina44 ($0.63 in chips)
Seat 3: robcandy ($0.97 in chips)
Seat 4: PlayTheBlues4U ($4.50 in chips)
Seat 5: tsov252525 ($2.59 in chips)
Seat 6: TheWalrus435 ($2.52 in chips)
tsov252525: posts small blind $0.01
TheWalrus435: posts big blind $0.02
WillDuane: sits out
*** HOLE CARDS ***
Dealt to PlayTheBlues4U [9c 9s]
michelina44: calls $0.02
robcandy: folds
PlayTheBlues4U: raises $0.04 to $0.06
tsov252525: folds
TheWalrus435: folds
michelina44: folds
Uncalled bet ($0.04) returned to PlayTheBlues4U
PlayTheBlues4U collected $0.07 from pot
PlayTheBlues4U: doesn't show hand
*** SUMMARY ***
Total pot $0.07 | Rake $0
Seat 1: michelina44 folded before Flop
Seat 3: robcandy folded before Flop (didn't bet)
Seat 4: PlayTheBlues4U (button) collected ($0.07)
Seat 5: tsov252525 (small blind) folded before Flop
Seat 6: TheWalrus435 (big blind) folded before Flop


PokerStars Hand #203470995716:  Hold'em No Limit ($0.02/$0.05 USD) - 2019/09/06 21:22:10 ET
Table 'Icarus' 6-max Seat #2 is the button
Seat 1: bobca1944 ($3.93 in chips)
Seat 2: PlayTheBlues4U ($5.23 in chips)
Seat 4: jjbenzky ($3.61 in chips)
Seat 5: DeccaDan ($12.36 in chips)
Seat 6: DemolishIT ($11.61 in chips)
FishyFlopp will be allowed to play after the button
jjbenzky: posts small blind $0.02
DeccaDan: posts big blind $0.05
*** HOLE CARDS ***
Dealt to PlayTheBlues4U [4h Kd]
DemolishIT: raises $0.20 to $0.25
bobca1944: folds
PlayTheBlues4U: folds
jjbenzky: folds
DeccaDan: folds
Uncalled bet ($0.20) returned to DemolishIT
DemolishIT collected $0.12 from pot
*** SUMMARY ***
Total pot $0.12 | Rake $0
Seat 1: bobca1944 folded before Flop (didn't bet)
Seat 2: PlayTheBlues4U (button) folded before Flop (didn't bet)
Seat 4: jjbenzky (small blind) folded before Flop
Seat 5: DeccaDan (big blind) folded before Flop
Seat 6: DemolishIT collected ($0.12)


PokerStars Hand #203470995576:  Hold'em No Limit ($0.01/$0.02 USD) - 2019/09/06 21:21:31 ET
Table 'Pegasus' 6-max Seat #3 is the button
Seat 1: michelina44 ($0.57 in chips)
Seat 3: robcandy ($0.97 in chips)
Seat 4: PlayTheBlues4U ($4.54 in chips)
Seat 5: tsov252525 ($2.61 in chips)
Seat 6: TheWalrus435 ($2.52 in chips)
PlayTheBlues4U: posts small blind $0.01
tsov252525: posts big blind $0.02
michelina44: posts small blind $0.01
WillDuane: sits out
*** HOLE CARDS ***
Dealt to PlayTheBlues4U [Td 8d]
TheWalrus435: folds
michelina44: raises $0.02 to $0.04
robcandy: folds
PlayTheBlues4U: calls $0.03
tsov252525: folds
*** FLOP *** [5s 4s Ac]
PlayTheBlues4U: checks
michelina44: checks
*** TURN *** [5s 4s Ac] [Ad]
PlayTheBlues4U: checks
michelina44: bets $0.10
PlayTheBlues4U: folds
Uncalled bet ($0.10) returned to michelina44
michelina44 collected $0.11 from pot
michelina44: doesn't show hand
*** SUMMARY ***
Total pot $0.11 | Rake $0
Board [5s 4s Ac Ad]
Seat 1: michelina44 collected ($0.11)
Seat 3: robcandy (button) folded before Flop (didn't bet)
Seat 4: PlayTheBlues4U (small blind) folded on the Turn
Seat 5: tsov252525 (big blind) folded before Flop
Seat 6: TheWalrus435 folded before Flop (didn't bet)


PokerStars Hand #203470995541:  Hold'em No Limit ($0.02/$0.05 USD) - 2019/09/06 21:21:22 ET
Table 'Icarus' 6-max Seat #1 is the button
Seat 1: bobca1944 ($3.93 in chips)
Seat 2: PlayTheBlues4U ($5.25 in chips)
Seat 4: jjbenzky ($4.24 in chips)
Seat 5: DeccaDan ($11.73 in chips)
Seat 6: DemolishIT ($11.66 in chips)
PlayTheBlues4U: posts small blind $0.02
jjbenzky: posts big blind $0.05
*** HOLE CARDS ***
Dealt to PlayTheBlues4U [4d 8s]
DeccaDan: calls $0.05
DemolishIT: calls $0.05
bobca1944: folds
PlayTheBlues4U: folds
jjbenzky: checks
*** FLOP *** [Jh Qc Jd]
jjbenzky: checks
DeccaDan: bets $0.10
DemolishIT: folds
jjbenzky: calls $0.10
*** TURN *** [Jh Qc Jd] [Th]
jjbenzky: checks
DeccaDan: bets $0.10
jjbenzky: calls $0.10
*** RIVER *** [Jh Qc Jd Th] [5h]
jjbenzky: bets $0.38
DeccaDan: calls $0.38
*** SHOW DOWN ***
jjbenzky: shows [9c Ac] (a pair of Jacks)
DeccaDan: shows [Ks Qs] (two pair, Queens and Jacks)
DeccaDan collected $1.26 from pot
*** SUMMARY ***
Total pot $1.33 | Rake $0.07
Board [Jh Qc Jd Th 5h]
Seat 1: bobca1944 (button) folded before Flop (didn't bet)
Seat 2: PlayTheBlues4U (small blind) folded before Flop
Seat 4: jjbenzky (big blind) showed [9c Ac] and lost with a pair of Jacks
Seat 5: DeccaDan showed [Ks Qs] and won ($1.26) with two pair, Queens and Jacks
Seat 6: DemolishIT folded on the Flop


PokerStars Hand #203470995484:  Hold'em No Limit ($0.02/$0.05 USD) - 2019/09/06 21:21:07 ET
Table 'Icarus' 6-max Seat #6 is the button
Seat 1: bobca1944 ($3.95 in chips)
Seat 2: PlayTheBlues4U ($5.30 in chips)
Seat 4: jjbenzky ($4.17 in chips)
Seat 5: DeccaDan ($11.73 in chips)
Seat 6: DemolishIT ($11.66 in chips)
bobca1944: posts small blind $0.02
PlayTheBlues4U: posts big blind $0.05
*** HOLE CARDS ***
Dealt to PlayTheBlues4U [3d Qs]
jjbenzky: raises $0.09 to $0.14
DeccaDan: folds
DemolishIT: folds
bobca1944: folds
PlayTheBlues4U: folds
Uncalled bet ($0.09) returned to jjbenzky
jjbenzky collected $0.12 from pot
jjbenzky: doesn't show hand
*** SUMMARY ***
Total pot $0.12 | Rake $0
Seat 1: bobca1944 (small blind) folded before Flop
Seat 2: PlayTheBlues4U (big blind) folded before Flop
Seat 4: jjbenzky collected ($0.12)
Seat 5: DeccaDan folded before Flop (didn't bet)
Seat 6: DemolishIT (button) folded before Flop (didn't bet)


PokerStars Hand #203470995414:  Hold'em No Limit ($0.01/$0.02 USD) - 2019/09/06 21:20:46 ET
Table 'Pegasus' 6-max Seat #6 is the button
Seat 3: robcandy ($1.03 in chips)
Seat 4: PlayTheBlues4U ($4.49 in chips)
Seat 5: tsov252525 ($2.61 in chips)
Seat 6: TheWalrus435 ($2.52 in chips)
robcandy: posts small blind $0.01
PlayTheBlues4U: posts big blind $0.02
*** HOLE CARDS ***
Dealt to PlayTheBlues4U [Td Qc]
tsov252525: folds
TheWalrus435: folds
robcandy: calls $0.01
WillDuane joins the table at seat #2
PlayTheBlues4U: raises $0.04 to $0.06
robcandy: calls $0.04
*** FLOP *** [Qd 4h 3s]
robcandy: checks
PlayTheBlues4U: bets $0.10
robcandy: folds
Uncalled bet ($0.10) returned to PlayTheBlues4U
PlayTheBlues4U collected $0.11 from pot
PlayTheBlues4U: doesn't show hand
*** SUMMARY ***
Total pot $0.12 | Rake $0.01
Board [Qd 4h 3s]
Seat 3: robcandy (small blind) folded on the Flop
Seat 4: PlayTheBlues4U (big blind) collected ($0.11)
Seat 5: tsov252525 folded before Flop (didn't bet)
Seat 6: TheWalrus435 (button) folded before Flop (didn't bet)


PokerStars Hand #203470995298:  Hold'em No Limit ($0.02/$0.05 USD) - 2019/09/06 21:20:10 ET
Table 'Icarus' 6-max Seat #5 is the button
Seat 1: bobca1944 ($4 in chips)
Seat 2: PlayTheBlues4U ($5.30 in chips)
Seat 3: FishyFlopp ($3.53 in chips)
Seat 4: jjbenzky ($4.17 in chips)
Seat 5: DeccaDan ($11.73 in chips)
Seat 6: DemolishIT ($8.44 in chips)
DemolishIT: posts small blind $0.02
bobca1944: posts big blind $0.05
*** HOLE CARDS ***
Dealt to PlayTheBlues4U [6c Jh]
PlayTheBlues4U: folds
FishyFlopp: raises $0.25 to $0.30
jjbenzky: folds
DeccaDan: folds
DemolishIT: calls $0.28
bobca1944: folds
*** FLOP *** [7s 4c 4d]
DemolishIT: checks
FishyFlopp: bets $0.45
DemolishIT: calls $0.45
*** TURN *** [7s 4c 4d] [5s]
DemolishIT: checks
FishyFlopp: bets $0.55
DemolishIT: raises $7.14 to $7.69 and is all-in
FishyFlopp: calls $2.23 and is all-in
Uncalled bet ($4.91) returned to DemolishIT
*** RIVER *** [7s 4c 4d 5s] [Kd]
*** SHOW DOWN ***
DemolishIT: shows [Jc Js] (two pair, Jacks and Fours)
FishyFlopp: shows [Th Tc] (two pair, Tens and Fours)
DemolishIT collected $6.75 from pot
*** SUMMARY ***
Total pot $7.11 | Rake $0.36
Board [7s 4c 4d 5s Kd]
Seat 1: bobca1944 (big blind) folded before Flop
Seat 2: PlayTheBlues4U folded before Flop (didn't bet)
Seat 3: FishyFlopp showed [Th Tc] and lost with two pair, Tens and Fours
Seat 4: jjbenzky folded before Flop (didn't bet)
Seat 5: DeccaDan (button) folded before Flop (didn't bet)
Seat 6: DemolishIT (small blind) showed [Jc Js] and won ($6.75) with two pair, Jacks and Fours


PokerStars Hand #203470995275:  Hold'em No Limit ($0.01/$0.02 USD) - 2019/09/06 21:20:03 ET
Table 'Pegasus' 6-max Seat #5 is the button
Seat 1: michelina44 ($0.59 in chips)
Seat 3: robcandy ($1.03 in chips)
Seat 4: PlayTheBlues4U ($4.49 in chips)
Seat 5: tsov252525 ($2.58 in chips)
Seat 6: TheWalrus435 ($2.53 in chips)
TheWalrus435: posts small blind $0.01
michelina44: posts big blind $0.02
*** HOLE CARDS ***
Dealt to PlayTheBlues4U [Kh 5s]
robcandy: folds
PlayTheBlues4U: folds
tsov252525: raises $0.04 to $0.06
TheWalrus435: folds
michelina44 has timed out
michelina44: folds
Uncalled bet ($0.04) returned to tsov252525
tsov252525 collected $0.05 from pot
tsov252525: doesn't show hand
*** SUMMARY ***
Total pot $0.05 | Rake $0
Seat 1: michelina44 (big blind) folded before Flop
Seat 3: robcandy folded before Flop (didn't bet)
Seat 4: PlayTheBlues4U folded before Flop (didn't bet)
Seat 5: tsov252525 (button) collected ($0.05)
Seat 6: TheWalrus435 (small blind) folded before Flop


PokerStars Hand #203470995135:  Hold'em No Limit ($0.02/$0.05 USD) - 2019/09/06 21:19:23 ET
Table 'Icarus' 6-max Seat #4 is the button
Seat 2: PlayTheBlues4U ($5.30 in chips)
Seat 3: FishyFlopp ($2.61 in chips)
Seat 4: jjbenzky ($4.42 in chips)
Seat 5: DeccaDan ($11.78 in chips)
Seat 6: DemolishIT ($9.14 in chips)
DeccaDan: posts small blind $0.02
DemolishIT: posts big blind $0.05
bobca1944: sits out
*** HOLE CARDS ***
Dealt to PlayTheBlues4U [3d 7c]
PlayTheBlues4U: folds
FishyFlopp: calls $0.05
jjbenzky: calls $0.05
FishyFlopp said, "timely"
DeccaDan: calls $0.03
DemolishIT: raises $0.20 to $0.25
FishyFlopp: calls $0.20
jjbenzky: calls $0.20
DeccaDan: folds
*** FLOP *** [9s 8h Jc]
DemolishIT: checks
FishyFlopp: checks
jjbenzky: checks
*** TURN *** [9s 8h Jc] [6h]
DemolishIT: checks
FishyFlopp: bets $0.45
jjbenzky: folds
DemolishIT: calls $0.45
*** RIVER *** [9s 8h Jc 6h] [9c]
DemolishIT: checks
FishyFlopp: bets $0.70
DemolishIT: folds
Uncalled bet ($0.70) returned to FishyFlopp
FishyFlopp collected $1.62 from pot
FishyFlopp: doesn't show hand
*** SUMMARY ***
Total pot $1.70 | Rake $0.08
Board [9s 8h Jc 6h 9c]
Seat 2: PlayTheBlues4U folded before Flop (didn't bet)
Seat 3: FishyFlopp collected ($1.62)
Seat 4: jjbenzky (button) folded on the Turn
Seat 5: DeccaDan (small blind) folded before Flop
Seat 6: DemolishIT (big blind) folded on the River


PokerStars Hand #203470994983:  Hold'em No Limit ($0.01/$0.02 USD) - 2019/09/06 21:18:40 ET
Table 'Pegasus' 6-max Seat #4 is the button
Seat 1: michelina44 ($0.59 in chips)
Seat 3: robcandy ($1.63 in chips)
Seat 4: PlayTheBlues4U ($3.92 in chips)
Seat 5: tsov252525 ($2.59 in chips)
Seat 6: TheWalrus435 ($2.55 in chips)
tsov252525: posts small blind $0.01
TheWalrus435: posts big blind $0.02
*** HOLE CARDS ***
Dealt to PlayTheBlues4U [Js Qs]
michelina44: folds
robcandy: calls $0.02
PlayTheBlues4U: raises $0.04 to $0.06
tsov252525: folds
TheWalrus435: folds
robcandy: calls $0.04
*** FLOP *** [9s Kc Td]
robcandy: checks
PlayTheBlues4U: bets $0.14
robcandy: calls $0.14
*** TURN *** [9s Kc Td] [Ts]
robcandy: checks
PlayTheBlues4U: bets $0.40
robcandy: calls $0.40
*** RIVER *** [9s Kc Td Ts] [4h]
robcandy: checks
PlayTheBlues4U: bets $1.16
robcandy: folds
Uncalled bet ($1.16) returned to PlayTheBlues4U
PlayTheBlues4U collected $1.17 from pot
PlayTheBlues4U: doesn't show hand
*** SUMMARY ***
Total pot $1.23 | Rake $0.06
Board [9s Kc Td Ts 4h]
Seat 1: michelina44 folded before Flop (didn't bet)
Seat 3: robcandy folded on the River
Seat 4: PlayTheBlues4U (button) collected ($1.17)
Seat 5: tsov252525 (small blind) folded before Flop
Seat 6: TheWalrus435 (big blind) folded before Flop


PokerStars Hand #203470994910:  Hold'em No Limit ($0.02/$0.05 USD) - 2019/09/06 21:18:21 ET
Table 'Icarus' 6-max Seat #3 is the button
Seat 2: PlayTheBlues4U ($9.71 in chips)
Seat 3: FishyFlopp ($2.61 in chips)
Seat 4: jjbenzky ($5.17 in chips)
Seat 5: DeccaDan ($11.83 in chips)
Seat 6: DemolishIT ($4.41 in chips)
jjbenzky: posts small blind $0.02
DeccaDan: posts big blind $0.05
bobca1944: sits out
*** HOLE CARDS ***
Dealt to PlayTheBlues4U [Qd Qc]
DemolishIT: raises $0.20 to $0.25
PlayTheBlues4U: raises $0.50 to $0.75
FishyFlopp: folds
jjbenzky: calls $0.73
DeccaDan: folds
DemolishIT: raises $3.66 to $4.41 and is all-in
PlayTheBlues4U: calls $3.66
jjbenzky: folds
*** FLOP *** [4d Td 5c]
*** TURN *** [4d Td 5c] [7s]
*** RIVER *** [4d Td 5c 7s] [Kc]
*** SHOW DOWN ***
DemolishIT: shows [Ks Kd] (three of a kind, Kings)
PlayTheBlues4U: shows [Qd Qc] (a pair of Queens)
DemolishIT collected $9.14 from pot
*** SUMMARY ***
Total pot $9.62 | Rake $0.48
Board [4d Td 5c 7s Kc]
Seat 2: PlayTheBlues4U showed [Qd Qc] and lost with a pair of Queens
Seat 3: FishyFlopp (button) folded before Flop (didn't bet)
Seat 4: jjbenzky (small blind) folded before Flop
Seat 5: DeccaDan (big blind) folded before Flop
Seat 6: DemolishIT showed [Ks Kd] and won ($9.14) with three of a kind, Kings


PokerStars Hand #203470994812:  Hold'em No Limit ($0.01/$0.02 USD) - 2019/09/06 21:17:52 ET
Table 'Pegasus' 6-max Seat #3 is the button
Seat 1: michelina44 ($0.59 in chips)
Seat 3: robcandy ($1.49 in chips)
Seat 4: PlayTheBlues4U ($3.93 in chips)
Seat 5: tsov252525 ($2.73 in chips)
Seat 6: TheWalrus435 ($2.55 in chips)
PlayTheBlues4U: posts small blind $0.01
tsov252525: posts big blind $0.02
*** HOLE CARDS ***
Dealt to PlayTheBlues4U [Jh 3d]
TheWalrus435: folds
michelina44: folds
robcandy: calls $0.02
PlayTheBlues4U: folds
tsov252525: checks
*** FLOP *** [6d Tc 9h]
tsov252525: bets $0.05
robcandy: calls $0.05
*** TURN *** [6d Tc 9h] [Ks]
tsov252525: bets $0.07
robcandy: raises $0.07 to $0.14
tsov252525: folds
Uncalled bet ($0.07) returned to robcandy
robcandy collected $0.28 from pot
*** SUMMARY ***
Total pot $0.29 | Rake $0.01
Board [6d Tc 9h Ks]
Seat 1: michelina44 folded before Flop (didn't bet)
Seat 3: robcandy (button) collected ($0.28)
Seat 4: PlayTheBlues4U (small blind) folded before Flop
Seat 5: tsov252525 (big blind) folded on the Turn
Seat 6: TheWalrus435 folded before Flop (didn't bet)


PokerStars Hand #203470994735:  Hold'em No Limit ($0.01/$0.02 USD) - 2019/09/06 21:17:27 ET
Table 'Pegasus' 6-max Seat #1 is the button
Seat 1: michelina44 ($0.61 in chips)
Seat 3: robcandy ($1.51 in chips)
Seat 4: PlayTheBlues4U ($3.89 in chips)
Seat 5: tsov252525 ($2.73 in chips)
Seat 6: TheWalrus435 ($2.55 in chips)
robcandy: posts small blind $0.01
PlayTheBlues4U: posts big blind $0.02
*** HOLE CARDS ***
Dealt to PlayTheBlues4U [Tc Ks]
tsov252525: folds
TheWalrus435: folds
michelina44: calls $0.02
robcandy: calls $0.01
PlayTheBlues4U: checks
*** FLOP *** [6c Kh 6d]
robcandy: checks
PlayTheBlues4U: bets $0.06
michelina44: folds
robcandy: folds
Uncalled bet ($0.06) returned to PlayTheBlues4U
PlayTheBlues4U collected $0.06 from pot
PlayTheBlues4U: doesn't show hand
*** SUMMARY ***
Total pot $0.06 | Rake $0
Board [6c Kh 6d]
Seat 1: michelina44 (button) folded on the Flop
Seat 3: robcandy (small blind) folded on the Flop
Seat 4: PlayTheBlues4U (big blind) collected ($0.06)
Seat 5: tsov252525 folded before Flop (didn't bet)
Seat 6: TheWalrus435 folded before Flop (didn't bet)


PokerStars Hand #203470994714:  Hold'em No Limit ($0.02/$0.05 USD) - 2019/09/06 21:17:20 ET
Table 'Icarus' 6-max Seat #2 is the button
Seat 2: PlayTheBlues4U ($9.71 in chips)
Seat 3: FishyFlopp ($2.66 in chips)
Seat 4: jjbenzky ($5.37 in chips)
Seat 5: DeccaDan ($11.51 in chips)
Seat 6: DemolishIT ($4.51 in chips)
FishyFlopp: posts small blind $0.02
jjbenzky: posts big blind $0.05
bobca1944: sits out
*** HOLE CARDS ***
Dealt to PlayTheBlues4U [4c 2s]
DeccaDan: calls $0.05
DemolishIT: calls $0.05
PlayTheBlues4U: folds
FishyFlopp: calls $0.03
jjbenzky: checks
*** FLOP *** [6c Jc Ac]
FishyFlopp: checks
jjbenzky: bets $0.05
DeccaDan: calls $0.05
DemolishIT: calls $0.05
FishyFlopp: folds
*** TURN *** [6c Jc Ac] [Qs]
jjbenzky: checks
DeccaDan: bets $0.10
DemolishIT: folds
jjbenzky: calls $0.10
*** RIVER *** [6c Jc Ac Qs] [Js]
jjbenzky: checks
DeccaDan: bets $0.10
jjbenzky: folds
Uncalled bet ($0.10) returned to DeccaDan
DeccaDan collected $0.52 from pot
DeccaDan: doesn't show hand
*** SUMMARY ***
Total pot $0.55 | Rake $0.03
Board [6c Jc Ac Qs Js]
Seat 2: PlayTheBlues4U (button) folded before Flop (didn't bet)
Seat 3: FishyFlopp (small blind) folded on the Flop
Seat 4: jjbenzky (big blind) folded on the River
Seat 5: DeccaDan collected ($0.52)
Seat 6: DemolishIT folded on the Turn


PokerStars Hand #203470994653:  Hold'em No Limit ($0.01/$0.02 USD) - 2019/09/06 21:17:01 ET
Table 'Pegasus' 6-max Seat #6 is the button
Seat 1: michelina44 ($0.63 in chips)
Seat 3: robcandy ($1.53 in chips)
Seat 4: PlayTheBlues4U ($3.89 in chips)
Seat 5: tsov252525 ($2.73 in chips)
Seat 6: TheWalrus435 ($2.51 in chips)
michelina44: posts small blind $0.01
robcandy: posts big blind $0.02
*** HOLE CARDS ***
Dealt to PlayTheBlues4U [3h 4s]
PlayTheBlues4U: folds
tsov252525: folds
TheWalrus435: calls $0.02
michelina44: calls $0.01
robcandy: checks
*** FLOP *** [5h 5d Jc]
michelina44: checks
robcandy: checks
TheWalrus435: bets $0.06
michelina44: folds
robcandy: folds
Uncalled bet ($0.06) returned to TheWalrus435
TheWalrus435 collected $0.06 from pot
*** SUMMARY ***
Total pot $0.06 | Rake $0
Board [5h 5d Jc]
Seat 1: michelina44 (small blind) folded on the Flop
Seat 3: robcandy (big blind) folded on the Flop
Seat 4: PlayTheBlues4U folded before Flop (didn't bet)
Seat 5: tsov252525 folded before Flop (didn't bet)
Seat 6: TheWalrus435 (button) collected ($0.06)


PokerStars Hand #203470994607:  Hold'em No Limit ($0.01/$0.02 USD) - 2019/09/06 21:16:45 ET
Table 'Pegasus' 6-max Seat #5 is the button
Seat 1: michelina44 ($0.65 in chips)
Seat 3: robcandy ($1.53 in chips)
Seat 4: PlayTheBlues4U ($3.89 in chips)
Seat 5: tsov252525 ($2.70 in chips)
Seat 6: TheWalrus435 ($2.52 in chips)
TheWalrus435: posts small blind $0.01
michelina44: posts big blind $0.02
*** HOLE CARDS ***
Dealt to PlayTheBlues4U [Jd 3s]
robcandy: folds
PlayTheBlues4U: folds
tsov252525: raises $0.06 to $0.08
TheWalrus435: folds
michelina44: folds
Uncalled bet ($0.06) returned to tsov252525
tsov252525 collected $0.05 from pot
tsov252525: doesn't show hand
*** SUMMARY ***
Total pot $0.05 | Rake $0
Seat 1: michelina44 (big blind) folded before Flop
Seat 3: robcandy folded before Flop (didn't bet)
Seat 4: PlayTheBlues4U folded before Flop (didn't bet)
Seat 5: tsov252525 (button) collected ($0.05)
Seat 6: TheWalrus435 (small blind) folded before Flop


PokerStars Hand #203470994600:  Hold'em No Limit ($0.02/$0.05 USD) - 2019/09/06 21:16:42 ET
Table 'Icarus' 6-max Seat #6 is the button
Seat 2: PlayTheBlues4U ($9.73 in chips)
Seat 3: FishyFlopp ($2.71 in chips)
Seat 4: jjbenzky ($5.72 in chips)
Seat 5: DeccaDan ($11.51 in chips)
Seat 6: DemolishIT ($4.13 in chips)
bobca1944 will be allowed to play after the button
PlayTheBlues4U: posts small blind $0.02
FishyFlopp: posts big blind $0.05
*** HOLE CARDS ***
Dealt to PlayTheBlues4U [Ad 4s]
jjbenzky: raises $0.05 to $0.10
DeccaDan: folds
DemolishIT: raises $0.25 to $0.35
PlayTheBlues4U: folds
FishyFlopp: folds
jjbenzky: calls $0.25
*** FLOP *** [2c 5s 2h]
jjbenzky: checks
DemolishIT: bets $0.95
jjbenzky: folds
Uncalled bet ($0.95) returned to DemolishIT
DemolishIT collected $0.73 from pot
DemolishIT: doesn't show hand
*** SUMMARY ***
Total pot $0.77 | Rake $0.04
Board [2c 5s 2h]
Seat 2: PlayTheBlues4U (small blind) folded before Flop
Seat 3: FishyFlopp (big blind) folded before Flop
Seat 4: jjbenzky folded on the Flop
Seat 5: DeccaDan folded before Flop (didn't bet)
Seat 6: DemolishIT (button) collected ($0.73)


PokerStars Hand #203470994404:  Hold'em No Limit ($0.01/$0.02 USD) - 2019/09/06 21:15:46 ET
Table 'Pegasus' 6-max Seat #4 is the button
Seat 1: michelina44 ($0.65 in chips)
Seat 3: robcandy ($1.36 in chips)
Seat 4: PlayTheBlues4U ($3.89 in chips)
Seat 5: tsov252525 ($2.87 in chips)
Seat 6: TheWalrus435 ($2.54 in chips)
tsov252525: posts small blind $0.01
TheWalrus435: posts big blind $0.02
*** HOLE CARDS ***
Dealt to PlayTheBlues4U [3c Qc]
michelina44: folds
robcandy: calls $0.02
PlayTheBlues4U: folds
tsov252525: raises $0.06 to $0.08
TheWalrus435: folds
robcandy: calls $0.06
*** FLOP *** [5d 8s 3d]
tsov252525: checks
robcandy: checks
*** TURN *** [5d 8s 3d] [7h]
tsov252525: checks
robcandy: checks
*** RIVER *** [5d 8s 3d 7h] [Ad]
tsov252525: bets $0.09
robcandy: calls $0.09
*** SHOW DOWN ***
tsov252525: shows [Ah Tc] (a pair of Aces)
robcandy: shows [Jd Ac] (a pair of Aces - Jack kicker)
robcandy collected $0.34 from pot
*** SUMMARY ***
Total pot $0.36 | Rake $0.02
Board [5d 8s 3d 7h Ad]
Seat 1: michelina44 folded before Flop (didn't bet)
Seat 3: robcandy showed [Jd Ac] and won ($0.34) with a pair of Aces
Seat 4: PlayTheBlues4U (button) folded before Flop (didn't bet)
Seat 5: tsov252525 (small blind) showed [Ah Tc] and lost with a pair of Aces
Seat 6: TheWalrus435 (big blind) folded before Flop


PokerStars Hand #203470994374:  Hold'em No Limit ($0.02/$0.05 USD) - 2019/09/06 21:15:38 ET
Table 'Icarus' 6-max Seat #5 is the button
Seat 2: PlayTheBlues4U ($9.78 in chips)
Seat 3: FishyFlopp ($2.71 in chips)
Seat 4: jjbenzky ($6.92 in chips)
Seat 5: DeccaDan ($11.51 in chips)
Seat 6: DemolishIT ($3 in chips)
DemolishIT: posts small blind $0.02
Yockit: is sitting out
PlayTheBlues4U: posts big blind $0.05
*** HOLE CARDS ***
Dealt to PlayTheBlues4U [Tc 3s]
FishyFlopp: folds
jjbenzky: calls $0.05
Yockit leaves the table
DeccaDan: folds
bobca1944 joins the table at seat #1
DemolishIT: calls $0.03
PlayTheBlues4U: checks
*** FLOP *** [4h 4c 9h]
DemolishIT: checks
PlayTheBlues4U: checks
jjbenzky: bets $0.14
DemolishIT: calls $0.14
PlayTheBlues4U: folds
*** TURN *** [4h 4c 9h] [8d]
DemolishIT: checks
jjbenzky: bets $0.20
DemolishIT: raises $0.81 to $1.01
jjbenzky: calls $0.81
*** RIVER *** [4h 4c 9h 8d] [7d]
DemolishIT: bets $1.80 and is all-in
jjbenzky: folds
Uncalled bet ($1.80) returned to DemolishIT
DemolishIT collected $2.33 from pot
DemolishIT: doesn't show hand
*** SUMMARY ***
Total pot $2.45 | Rake $0.12
Board [4h 4c 9h 8d 7d]
Seat 2: PlayTheBlues4U (big blind) folded on the Flop
Seat 3: FishyFlopp folded before Flop (didn't bet)
Seat 4: jjbenzky folded on the River
Seat 5: DeccaDan (button) folded before Flop (didn't bet)
Seat 6: DemolishIT (small blind) collected ($2.33)


PokerStars Hand #203470994240:  Hold'em No Limit ($0.01/$0.02 USD) - 2019/09/06 21:14:55 ET
Table 'Pegasus' 6-max Seat #3 is the button
Seat 1: michelina44 ($0.65 in chips)
Seat 3: robcandy ($1.38 in chips)
Seat 4: PlayTheBlues4U ($3.91 in chips)
Seat 5: tsov252525 ($2.81 in chips)
Seat 6: TheWalrus435 ($2.56 in chips)
PlayTheBlues4U: posts small blind $0.01
tsov252525: posts big blind $0.02
*** HOLE CARDS ***
Dealt to PlayTheBlues4U [7c 5s]
TheWalrus435: calls $0.02
michelina44: folds
robcandy: calls $0.02
PlayTheBlues4U: calls $0.01
tsov252525: checks
*** FLOP *** [3h Qc 2h]
PlayTheBlues4U: checks
tsov252525: checks
TheWalrus435: checks
robcandy: checks
*** TURN *** [3h Qc 2h] [Jd]
PlayTheBlues4U: checks
tsov252525: checks
TheWalrus435: checks
robcandy: checks
*** RIVER *** [3h Qc 2h Jd] [Tc]
PlayTheBlues4U: checks
tsov252525: checks
TheWalrus435: checks
robcandy: checks
*** SHOW DOWN ***
PlayTheBlues4U: shows [7c 5s] (high card Queen)
tsov252525: shows [Td 8h] (a pair of Tens)
TheWalrus435: mucks hand
robcandy: mucks hand
tsov252525 collected $0.08 from pot
*** SUMMARY ***
Total pot $0.08 | Rake $0
Board [3h Qc 2h Jd Tc]
Seat 1: michelina44 folded before Flop (didn't bet)
Seat 3: robcandy (button) mucked [7h As]
Seat 4: PlayTheBlues4U (small blind) showed [7c 5s] and lost with high card Queen
Seat 5: tsov252525 (big blind) showed [Td 8h] and won ($0.08) with a pair of Tens
Seat 6: TheWalrus435 mucked [Ac 4c]


PokerStars Hand #203470994169:  Hold'em No Limit ($0.01/$0.02 USD) - 2019/09/06 21:14:33 ET
Table 'Pegasus' 6-max Seat #1 is the button
Seat 1: michelina44 ($0.65 in chips)
Seat 3: robcandy ($1.36 in chips)
Seat 4: PlayTheBlues4U ($3.93 in chips)
Seat 5: tsov252525 ($2.81 in chips)
Seat 6: TheWalrus435 ($2.56 in chips)
robcandy: posts small blind $0.01
PlayTheBlues4U: posts big blind $0.02
*** HOLE CARDS ***
Dealt to PlayTheBlues4U [8s 3s]
tsov252525: folds
TheWalrus435: folds
michelina44: folds
robcandy: calls $0.01
PlayTheBlues4U: checks
*** FLOP *** [6s Ah 9h]
robcandy: bets $0.02
PlayTheBlues4U: folds
Uncalled bet ($0.02) returned to robcandy
robcandy collected $0.04 from pot
*** SUMMARY ***
Total pot $0.04 | Rake $0
Board [6s Ah 9h]
Seat 1: michelina44 (button) folded before Flop (didn't bet)
Seat 3: robcandy (small blind) collected ($0.04)
Seat 4: PlayTheBlues4U (big blind) folded on the Flop
Seat 5: tsov252525 folded before Flop (didn't bet)
Seat 6: TheWalrus435 folded before Flop (didn't bet)


PokerStars Hand #203470994159:  Hold'em No Limit ($0.02/$0.05 USD) - 2019/09/06 21:14:28 ET
Table 'Icarus' 6-max Seat #4 is the button
Seat 1: Yockit ($7.85 in chips)
Seat 2: PlayTheBlues4U ($9.78 in chips)
Seat 3: FishyFlopp ($2.71 in chips)
Seat 4: jjbenzky ($6.97 in chips)
Seat 5: DeccaDan ($11.56 in chips)
Seat 6: DemolishIT ($5.05 in chips)
DeccaDan: posts small blind $0.02
DemolishIT: posts big blind $0.05
*** HOLE CARDS ***
Dealt to PlayTheBlues4U [Js 6h]
Yockit: calls $0.05
PlayTheBlues4U: folds
FishyFlopp: folds
jjbenzky: calls $0.05
DeccaDan: calls $0.03
DemolishIT: raises $0.35 to $0.40
Yockit: calls $0.35
jjbenzky: folds
DeccaDan: folds
*** FLOP *** [Kc Ad Ks]
DemolishIT: checks
Yockit: bets $0.65
DemolishIT: raises $1 to $1.65
Yockit: calls $1
*** TURN *** [Kc Ad Ks] [8c]
DemolishIT: checks
Yockit: bets $1.10
DemolishIT: folds
Uncalled bet ($1.10) returned to Yockit
Yockit collected $3.99 from pot
Yockit: doesn't show hand
*** SUMMARY ***
Total pot $4.20 | Rake $0.21
Board [Kc Ad Ks 8c]
Seat 1: Yockit collected ($3.99)
Seat 2: PlayTheBlues4U folded before Flop (didn't bet)
Seat 3: FishyFlopp folded before Flop (didn't bet)
Seat 4: jjbenzky (button) folded before Flop
Seat 5: DeccaDan (small blind) folded before Flop
Seat 6: DemolishIT (big blind) folded on the Turn


PokerStars Hand #203470994142:  Hold'em No Limit ($0.01/$0.02 USD) - 2019/09/06 21:14:24 ET
Table 'Pegasus' 6-max Seat #6 is the button
Seat 1: michelina44 ($0.66 in chips)
Seat 3: robcandy ($1.35 in chips)
Seat 4: PlayTheBlues4U ($3.93 in chips)
Seat 5: tsov252525 ($2.81 in chips)
Seat 6: TheWalrus435 ($2.56 in chips)
michelina44: posts small blind $0.01
robcandy: posts big blind $0.02
*** HOLE CARDS ***
Dealt to PlayTheBlues4U [8s 9d]
PlayTheBlues4U: folds
tsov252525: folds
TheWalrus435: folds
michelina44: folds
Uncalled bet ($0.01) returned to robcandy
robcandy collected $0.02 from pot
*** SUMMARY ***
Total pot $0.02 | Rake $0
Seat 1: michelina44 (small blind) folded before Flop
Seat 3: robcandy (big blind) collected ($0.02)
Seat 4: PlayTheBlues4U folded before Flop (didn't bet)
Seat 5: tsov252525 folded before Flop (didn't bet)
Seat 6: TheWalrus435 (button) folded before Flop (didn't bet)


PokerStars Hand #203470994099:  Hold'em No Limit ($0.01/$0.02 USD) - 2019/09/06 21:14:11 ET
Table 'Pegasus' 6-max Seat #5 is the button
Seat 1: michelina44 ($0.65 in chips)
Seat 3: robcandy ($1.35 in chips)
Seat 4: PlayTheBlues4U ($3.93 in chips)
Seat 5: tsov252525 ($2.81 in chips)
Seat 6: TheWalrus435 ($2.57 in chips)
TheWalrus435: posts small blind $0.01
michelina44: posts big blind $0.02
*** HOLE CARDS ***
Dealt to PlayTheBlues4U [9d 2c]
robcandy: folds
PlayTheBlues4U: folds
tsov252525: folds
TheWalrus435: folds
Uncalled bet ($0.01) returned to michelina44
michelina44 collected $0.02 from pot
michelina44: doesn't show hand
*** SUMMARY ***
Total pot $0.02 | Rake $0
Seat 1: michelina44 (big blind) collected ($0.02)
Seat 3: robcandy folded before Flop (didn't bet)
Seat 4: PlayTheBlues4U folded before Flop (didn't bet)
Seat 5: tsov252525 (button) folded before Flop (didn't bet)
Seat 6: TheWalrus435 (small blind) folded before Flop


PokerStars Hand #203470994073:  Hold'em No Limit ($0.02/$0.05 USD) - 2019/09/06 21:14:03 ET
Table 'Icarus' 6-max Seat #3 is the button
Seat 1: Yockit ($8.10 in chips)
Seat 2: PlayTheBlues4U ($9.78 in chips)
Seat 3: FishyFlopp ($2.71 in chips)
Seat 4: jjbenzky ($6.99 in chips)
Seat 5: DeccaDan ($11.61 in chips)
Seat 6: DemolishIT ($4.76 in chips)
jjbenzky: posts small blind $0.02
DeccaDan: posts big blind $0.05
*** HOLE CARDS ***
Dealt to PlayTheBlues4U [6d 3s]
DemolishIT: raises $0.20 to $0.25
Yockit: calls $0.25
PlayTheBlues4U: folds
FishyFlopp: folds
jjbenzky: folds
DeccaDan: folds
*** FLOP *** [7s 8s Ac]
DemolishIT: bets $0.54
Yockit: folds
Uncalled bet ($0.54) returned to DemolishIT
DemolishIT collected $0.54 from pot
DemolishIT: doesn't show hand
*** SUMMARY ***
Total pot $0.57 | Rake $0.03
Board [7s 8s Ac]
Seat 1: Yockit folded on the Flop
Seat 2: PlayTheBlues4U folded before Flop (didn't bet)
Seat 3: FishyFlopp (button) folded before Flop (didn't bet)
Seat 4: jjbenzky (small blind) folded before Flop
Seat 5: DeccaDan (big blind) folded before Flop
Seat 6: DemolishIT collected ($0.54)


PokerStars Hand #203470993945:  Hold'em No Limit ($0.02/$0.05 USD) - 2019/09/06 21:13:25 ET
Table 'Icarus' 6-max Seat #2 is the button
Seat 1: Yockit ($8.10 in chips)
Seat 2: PlayTheBlues4U ($9.78 in chips)
Seat 3: FishyFlopp ($2.73 in chips)
Seat 4: jjbenzky ($6.70 in chips)
Seat 5: DeccaDan ($11.61 in chips)
Seat 6: DemolishIT ($5.06 in chips)
FishyFlopp: posts small blind $0.02
jjbenzky: posts big blind $0.05
*** HOLE CARDS ***
Dealt to PlayTheBlues4U [8s 6s]
DeccaDan: folds
DemolishIT: raises $0.25 to $0.30
Yockit: folds
PlayTheBlues4U: folds
FishyFlopp: folds
jjbenzky: calls $0.25
*** FLOP *** [9d Js 5h]
jjbenzky: checks
DemolishIT: checks
*** TURN *** [9d Js 5h] [8h]
jjbenzky: checks
DemolishIT: checks
*** RIVER *** [9d Js 5h 8h] [Td]
jjbenzky: bets $0.28
DemolishIT: folds
Uncalled bet ($0.28) returned to jjbenzky
jjbenzky collected $0.59 from pot
jjbenzky: doesn't show hand
*** SUMMARY ***
Total pot $0.62 | Rake $0.03
Board [9d Js 5h 8h Td]
Seat 1: Yockit folded before Flop (didn't bet)
Seat 2: PlayTheBlues4U (button) folded before Flop (didn't bet)
Seat 3: FishyFlopp (small blind) folded before Flop
Seat 4: jjbenzky (big blind) collected ($0.59)
Seat 5: DeccaDan folded before Flop (didn't bet)
Seat 6: DemolishIT folded on the River


PokerStars Hand #203470993933:  Hold'em No Limit ($0.01/$0.02 USD) - 2019/09/06 21:13:20 ET
Table 'Pegasus' 6-max Seat #4 is the button
Seat 1: michelina44 ($0.65 in chips)
Seat 3: robcandy ($1.30 in chips)
Seat 4: PlayTheBlues4U ($3.95 in chips)
Seat 5: tsov252525 ($2.82 in chips)
Seat 6: TheWalrus435 ($2.59 in chips)
tsov252525: posts small blind $0.01
TheWalrus435: posts big blind $0.02
*** HOLE CARDS ***
Dealt to PlayTheBlues4U [9c 4c]
michelina44: folds
robcandy: calls $0.02
doc112ocean leaves the table
PlayTheBlues4U: calls $0.02
tsov252525: folds
TheWalrus435: checks
*** FLOP *** [Ah 5h Ac]
TheWalrus435: checks
robcandy: checks
PlayTheBlues4U: checks
*** TURN *** [Ah 5h Ac] [8h]
TheWalrus435: checks
robcandy: checks
PlayTheBlues4U: checks
*** RIVER *** [Ah 5h Ac 8h] [3c]
TheWalrus435: checks
robcandy: checks
PlayTheBlues4U: checks
*** SHOW DOWN ***
TheWalrus435: shows [Th 7d] (a pair of Aces)
robcandy: shows [Ks 9h] (a pair of Aces - King kicker)
PlayTheBlues4U: mucks hand
robcandy collected $0.07 from pot
*** SUMMARY ***
Total pot $0.07 | Rake $0
Board [Ah 5h Ac 8h 3c]
Seat 1: michelina44 folded before Flop (didn't bet)
Seat 3: robcandy showed [Ks 9h] and won ($0.07) with a pair of Aces
Seat 4: PlayTheBlues4U (button) mucked [9c 4c]
Seat 5: tsov252525 (small blind) folded before Flop
Seat 6: TheWalrus435 (big blind) showed [Th 7d] and lost with a pair of Aces


PokerStars Hand #203470993796:  Hold'em No Limit ($0.02/$0.05 USD) - 2019/09/06 21:12:35 ET
Table 'Icarus' 6-max Seat #1 is the button
Seat 1: Yockit ($8.10 in chips)
Seat 2: PlayTheBlues4U ($9.80 in chips)
Seat 3: FishyFlopp ($3.48 in chips)
Seat 4: jjbenzky ($6.01 in chips)
Seat 5: DeccaDan ($11.61 in chips)
Seat 6: DemolishIT ($5.06 in chips)
PlayTheBlues4U: posts small blind $0.02
FishyFlopp: posts big blind $0.05
*** HOLE CARDS ***
Dealt to PlayTheBlues4U [7c 6s]
jjbenzky: calls $0.05
DeccaDan: folds
DemolishIT: folds
Yockit: folds
PlayTheBlues4U: folds
FishyFlopp: raises $0.10 to $0.15
jjbenzky: calls $0.10
*** FLOP *** [8h 6c 3d]
FishyFlopp: bets $0.30
jjbenzky: calls $0.30
*** TURN *** [8h 6c 3d] [7h]
FishyFlopp: bets $0.30
jjbenzky: calls $0.30
*** RIVER *** [8h 6c 3d 7h] [3c]
FishyFlopp: checks
jjbenzky: checks
*** SHOW DOWN ***
FishyFlopp: shows [Tc Ah] (a pair of Threes)
jjbenzky: shows [9h 7s] (two pair, Sevens and Threes)
jjbenzky collected $1.44 from pot
*** SUMMARY ***
Total pot $1.52 | Rake $0.08
Board [8h 6c 3d 7h 3c]
Seat 1: Yockit (button) folded before Flop (didn't bet)
Seat 2: PlayTheBlues4U (small blind) folded before Flop
Seat 3: FishyFlopp (big blind) showed [Tc Ah] and lost with a pair of Threes
Seat 4: jjbenzky showed [9h 7s] and won ($1.44) with two pair, Sevens and Threes
Seat 5: DeccaDan folded before Flop (didn't bet)
Seat 6: DemolishIT folded before Flop (didn't bet)


PokerStars Hand #203470993750:  Hold'em No Limit ($0.01/$0.02 USD) - 2019/09/06 21:12:21 ET
Table 'Pegasus' 6-max Seat #3 is the button
Seat 1: michelina44 ($0.65 in chips)
Seat 2: doc112ocean ($0.21 in chips)
Seat 3: robcandy ($1.51 in chips)
Seat 4: PlayTheBlues4U ($3.52 in chips)
Seat 5: tsov252525 ($2.84 in chips)
Seat 6: TheWalrus435 ($2.61 in chips)
PlayTheBlues4U: posts small blind $0.01
tsov252525: posts big blind $0.02
*** HOLE CARDS ***
Dealt to PlayTheBlues4U [Kd Ad]
TheWalrus435: calls $0.02
michelina44: folds
doc112ocean: raises $0.19 to $0.21 and is all-in
robcandy: calls $0.21
PlayTheBlues4U: raises $1.09 to $1.30
tsov252525: folds
TheWalrus435: folds
robcandy: folds
Uncalled bet ($1.09) returned to PlayTheBlues4U
*** FLOP *** [Js Jc 3d]
*** TURN *** [Js Jc 3d] [Ks]
*** RIVER *** [Js Jc 3d Ks] [Td]
*** SHOW DOWN ***
PlayTheBlues4U: shows [Kd Ad] (two pair, Kings and Jacks)
doc112ocean: shows [Qh Tc] (two pair, Jacks and Tens)
PlayTheBlues4U collected $0.64 from pot
*** SUMMARY ***
Total pot $0.67 | Rake $0.03
Board [Js Jc 3d Ks Td]
Seat 1: michelina44 folded before Flop (didn't bet)
Seat 2: doc112ocean showed [Qh Tc] and lost with two pair, Jacks and Tens
Seat 3: robcandy (button) folded before Flop
Seat 4: PlayTheBlues4U (small blind) showed [Kd Ad] and won ($0.64) with two pair, Kings and Jacks
Seat 5: tsov252525 (big blind) folded before Flop
Seat 6: TheWalrus435 folded before Flop


PokerStars Hand #203470993644:  Hold'em No Limit ($0.02/$0.05 USD) - 2019/09/06 21:11:46 ET
Table 'Icarus' 6-max Seat #6 is the button
Seat 1: Yockit ($8.12 in chips)
Seat 2: PlayTheBlues4U ($9.85 in chips)
Seat 3: FishyFlopp ($3.48 in chips)
Seat 4: jjbenzky ($5.48 in chips)
Seat 5: DeccaDan ($12.13 in chips)
Seat 6: DemolishIT ($5.06 in chips)
Yockit: posts small blind $0.02
PlayTheBlues4U: posts big blind $0.05
*** HOLE CARDS ***
Dealt to PlayTheBlues4U [Qc 8d]
FishyFlopp: folds
jjbenzky: calls $0.05
DeccaDan: calls $0.05
DemolishIT: folds
Yockit: folds
PlayTheBlues4U: checks
*** FLOP *** [3h 5d 5s]
PlayTheBlues4U: checks
jjbenzky: checks
DeccaDan: bets $0.05
PlayTheBlues4U: folds
jjbenzky: calls $0.05
*** TURN *** [3h 5d 5s] [9h]
jjbenzky: checks
DeccaDan: bets $0.10
jjbenzky: calls $0.10
*** RIVER *** [3h 5d 5s 9h] [9s]
jjbenzky: bets $0.32
DeccaDan: calls $0.32
*** SHOW DOWN ***
jjbenzky: shows [8s 9c] (a full house, Nines full of Fives)
DeccaDan: mucks hand
jjbenzky collected $1.05 from pot
*** SUMMARY ***
Total pot $1.11 | Rake $0.06
Board [3h 5d 5s 9h 9s]
Seat 1: Yockit (small blind) folded before Flop
Seat 2: PlayTheBlues4U (big blind) folded on the Flop
Seat 3: FishyFlopp folded before Flop (didn't bet)
Seat 4: jjbenzky showed [8s 9c] and won ($1.05) with a full house, Nines full of Fives
Seat 5: DeccaDan mucked [Jh Jc]
Seat 6: DemolishIT (button) folded before Flop (didn't bet)


PokerStars Hand #203470993614:  Hold'em No Limit ($0.01/$0.02 USD) - 2019/09/06 21:11:35 ET
Table 'Pegasus' 6-max Seat #2 is the button
Seat 1: michelina44 ($0.76 in chips)
Seat 2: doc112ocean ($0.23 in chips)
Seat 3: robcandy ($1.52 in chips)
Seat 4: PlayTheBlues4U ($3.37 in chips)
Seat 5: tsov252525 ($2.84 in chips)
Seat 6: TheWalrus435 ($2.63 in chips)
robcandy: posts small blind $0.01
PlayTheBlues4U: posts big blind $0.02
michelina44: posts small & big blinds $0.03
*** HOLE CARDS ***
Dealt to PlayTheBlues4U [Kc Th]
tsov252525: folds
TheWalrus435: calls $0.02
michelina44: checks
doc112ocean: calls $0.02
robcandy: folds
PlayTheBlues4U: checks
*** FLOP *** [5h Ks 6h]
PlayTheBlues4U: bets $0.08
TheWalrus435: folds
michelina44: calls $0.08
doc112ocean: folds
*** TURN *** [5h Ks 6h] [Tc]
PlayTheBlues4U: bets $0.22
michelina44: folds
Uncalled bet ($0.22) returned to PlayTheBlues4U
PlayTheBlues4U collected $0.25 from pot
PlayTheBlues4U: doesn't show hand
*** SUMMARY ***
Total pot $0.26 | Rake $0.01
Board [5h Ks 6h Tc]
Seat 1: michelina44 folded on the Turn
Seat 2: doc112ocean (button) folded on the Flop
Seat 3: robcandy (small blind) folded before Flop
Seat 4: PlayTheBlues4U (big blind) collected ($0.25)
Seat 5: tsov252525 folded before Flop (didn't bet)
Seat 6: TheWalrus435 folded on the Flop


PokerStars Hand #203470993517:  Hold'em No Limit ($0.02/$0.05 USD) - 2019/09/06 21:11:02 ET
Table 'Icarus' 6-max Seat #5 is the button
Seat 1: Yockit ($8.17 in chips)
Seat 2: PlayTheBlues4U ($9.90 in chips)
Seat 3: FishyFlopp ($3.48 in chips)
Seat 4: jjbenzky ($5.37 in chips)
Seat 5: DeccaDan ($12.13 in chips)
Seat 6: DemolishIT ($5.08 in chips)
DemolishIT: posts small blind $0.02
Yockit: posts big blind $0.05
*** HOLE CARDS ***
Dealt to PlayTheBlues4U [8h Kh]
PlayTheBlues4U: calls $0.05
FishyFlopp: folds
jjbenzky: calls $0.05
DeccaDan: folds
DemolishIT: folds
Yockit: checks
*** FLOP *** [Ts Ah Jd]
Yockit: checks
PlayTheBlues4U: checks
jjbenzky: bets $0.16
Yockit: folds
PlayTheBlues4U: folds
Uncalled bet ($0.16) returned to jjbenzky
jjbenzky collected $0.16 from pot
jjbenzky: doesn't show hand
*** SUMMARY ***
Total pot $0.17 | Rake $0.01
Board [Ts Ah Jd]
Seat 1: Yockit (big blind) folded on the Flop
Seat 2: PlayTheBlues4U folded on the Flop
Seat 3: FishyFlopp folded before Flop (didn't bet)
Seat 4: jjbenzky collected ($0.16)
Seat 5: DeccaDan (button) folded before Flop (didn't bet)
Seat 6: DemolishIT (small blind) folded before Flop


PokerStars Hand #203470993422:  Hold'em No Limit ($0.01/$0.02 USD) - 2019/09/06 21:10:34 ET
Table 'Pegasus' 6-max Seat #6 is the button
Seat 2: doc112ocean ($0.71 in chips)
Seat 3: robcandy ($1.54 in chips)
Seat 4: PlayTheBlues4U ($3.49 in chips)
Seat 5: tsov252525 ($2.84 in chips)
Seat 6: TheWalrus435 ($2.06 in chips)
michelina44 will be allowed to play after the button
doc112ocean: posts small blind $0.01
robcandy: posts big blind $0.02
*** HOLE CARDS ***
Dealt to PlayTheBlues4U [Ks Jh]
PlayTheBlues4U: calls $0.02
tsov252525: folds
TheWalrus435: calls $0.02
doc112ocean: calls $0.01
robcandy: checks
*** FLOP *** [4c Jd Ad]
doc112ocean: checks
robcandy: checks
PlayTheBlues4U: checks
TheWalrus435: checks
*** TURN *** [4c Jd Ad] [2s]
doc112ocean: bets $0.10
robcandy: folds
PlayTheBlues4U: calls $0.10
TheWalrus435: calls $0.10
*** RIVER *** [4c Jd Ad 2s] [6h]
doc112ocean: checks
PlayTheBlues4U: checks
TheWalrus435: bets $0.36
doc112ocean: calls $0.36
PlayTheBlues4U: folds
*** SHOW DOWN ***
TheWalrus435: shows [5d 3d] (a straight, Deuce to Six)
doc112ocean: mucks hand
TheWalrus435 collected $1.05 from pot
*** SUMMARY ***
Total pot $1.10 | Rake $0.05
Board [4c Jd Ad 2s 6h]
Seat 2: doc112ocean (small blind) mucked [Ac Qd]
Seat 3: robcandy (big blind) folded on the Turn
Seat 4: PlayTheBlues4U folded on the River
Seat 5: tsov252525 folded before Flop (didn't bet)
Seat 6: TheWalrus435 (button) showed [5d 3d] and won ($1.05) with a straight, Deuce to Six


PokerStars Hand #203470993272:  Hold'em No Limit ($0.02/$0.05 USD) - 2019/09/06 21:09:47 ET
Table 'Icarus' 6-max Seat #4 is the button
Seat 1: Yockit ($7.85 in chips)
Seat 2: PlayTheBlues4U ($9.90 in chips)
Seat 3: FishyFlopp ($3.68 in chips)
Seat 4: jjbenzky ($5.42 in chips)
Seat 5: DeccaDan ($12.18 in chips)
Seat 6: DemolishIT ($5.13 in chips)
DeccaDan: posts small blind $0.02
DemolishIT: posts big blind $0.05
*** HOLE CARDS ***
Dealt to PlayTheBlues4U [8h Tc]
Yockit: calls $0.05
PlayTheBlues4U: folds
FishyFlopp: calls $0.05
jjbenzky: calls $0.05
DeccaDan: calls $0.03
DemolishIT: checks
*** FLOP *** [5h 8c Th]
DeccaDan: checks
DemolishIT: checks
Yockit: bets $0.15
FishyFlopp: calls $0.15
jjbenzky: folds
DeccaDan: folds
DemolishIT: folds
*** TURN *** [5h 8c Th] [Ks]
Yockit: checks
FishyFlopp: checks
*** RIVER *** [5h 8c Th Ks] [7h]
Yockit: bets $0.55
FishyFlopp: folds
Uncalled bet ($0.55) returned to Yockit
Yockit collected $0.52 from pot
*** SUMMARY ***
Total pot $0.55 | Rake $0.03
Board [5h 8c Th Ks 7h]
Seat 1: Yockit collected ($0.52)
Seat 2: PlayTheBlues4U folded before Flop (didn't bet)
Seat 3: FishyFlopp folded on the River
Seat 4: jjbenzky (button) folded on the Flop
Seat 5: DeccaDan (small blind) folded on the Flop
Seat 6: DemolishIT (big blind) folded on the Flop


PokerStars Hand #203470993260:  Hold'em No Limit ($0.01/$0.02 USD) - 2019/09/06 21:09:43 ET
Table 'Pegasus' 6-max Seat #5 is the button
Seat 2: doc112ocean ($0.87 in chips)
Seat 3: robcandy ($1.70 in chips)
Seat 4: PlayTheBlues4U ($3.49 in chips)
Seat 5: tsov252525 ($2.84 in chips)
Seat 6: TheWalrus435 ($1.76 in chips)
TheWalrus435: posts small blind $0.01
doc112ocean: posts big blind $0.02
*** HOLE CARDS ***
Dealt to PlayTheBlues4U [5h 2s]
robcandy: calls $0.02
PlayTheBlues4U: folds
tsov252525: folds
TheWalrus435: calls $0.01
doc112ocean: checks
*** FLOP *** [Ks 3h 4c]
TheWalrus435: checks
doc112ocean: checks
robcandy: bets $0.02
TheWalrus435: calls $0.02
doc112ocean: calls $0.02
*** TURN *** [Ks 3h 4c] [Th]
TheWalrus435: checks
doc112ocean: checks
robcandy: checks
*** RIVER *** [Ks 3h 4c Th] [Ac]
TheWalrus435: bets $0.12
doc112ocean: calls $0.12
robcandy: calls $0.12
*** SHOW DOWN ***
TheWalrus435: shows [4s 4h] (three of a kind, Fours)
doc112ocean: mucks hand
robcandy: mucks hand
TheWalrus435 collected $0.46 from pot
*** SUMMARY ***
Total pot $0.48 | Rake $0.02
Board [Ks 3h 4c Th Ac]
Seat 2: doc112ocean (big blind) mucked [Ah Qc]
Seat 3: robcandy mucked [3c Ad]
Seat 4: PlayTheBlues4U folded before Flop (didn't bet)
Seat 5: tsov252525 (button) folded before Flop (didn't bet)
Seat 6: TheWalrus435 (small blind) showed [4s 4h] and won ($0.46) with three of a kind, Fours


PokerStars Hand #203470993166:  Hold'em No Limit ($0.01/$0.02 USD) - 2019/09/06 21:09:10 ET
Table 'Pegasus' 6-max Seat #4 is the button
Seat 2: doc112ocean ($0.84 in chips)
Seat 3: robcandy ($1.70 in chips)
Seat 4: PlayTheBlues4U ($3.49 in chips)
Seat 5: tsov252525 ($2.85 in chips)
Seat 6: TheWalrus435 ($1.78 in chips)
tsov252525: posts small blind $0.01
TheWalrus435: posts big blind $0.02
*** HOLE CARDS ***
Dealt to PlayTheBlues4U [7s 5c]
doc112ocean: calls $0.02
robcandy: folds
PlayTheBlues4U: folds
tsov252525: folds
TheWalrus435: checks
*** FLOP *** [Kc 2c 3h]
TheWalrus435: checks
doc112ocean: bets $0.08
TheWalrus435: folds
Uncalled bet ($0.08) returned to doc112ocean
doc112ocean collected $0.05 from pot
*** SUMMARY ***
Total pot $0.05 | Rake $0
Board [Kc 2c 3h]
Seat 2: doc112ocean collected ($0.05)
Seat 3: robcandy folded before Flop (didn't bet)
Seat 4: PlayTheBlues4U (button) folded before Flop (didn't bet)
Seat 5: tsov252525 (small blind) folded before Flop
Seat 6: TheWalrus435 (big blind) folded on the Flop


PokerStars Hand #203470993103:  Hold'em No Limit ($0.02/$0.05 USD) - 2019/09/06 21:08:48 ET
Table 'Icarus' 6-max Seat #3 is the button
Seat 1: Yockit ($7.95 in chips)
Seat 2: PlayTheBlues4U ($9.90 in chips)
Seat 3: FishyFlopp ($3.78 in chips)
Seat 4: jjbenzky ($5.09 in chips)
Seat 5: DeccaDan ($12.28 in chips)
Seat 6: DemolishIT ($5.18 in chips)
jjbenzky: posts small blind $0.02
DeccaDan: posts big blind $0.05
*** HOLE CARDS ***
Dealt to PlayTheBlues4U [8h Ks]
DemolishIT: calls $0.05
Yockit: calls $0.05
PlayTheBlues4U: folds
FishyFlopp: calls $0.05
jjbenzky: calls $0.03
DeccaDan: checks
*** FLOP *** [6c Kd 8d]
jjbenzky: checks
DeccaDan: checks
DemolishIT: checks
Yockit: checks
FishyFlopp: checks
*** TURN *** [6c Kd 8d] [3s]
jjbenzky: bets $0.05
DeccaDan: calls $0.05
DemolishIT: folds
Yockit: calls $0.05
FishyFlopp: calls $0.05
*** RIVER *** [6c Kd 8d 3s] [Tc]
jjbenzky: checks
DeccaDan: checks
Yockit: checks
FishyFlopp: checks
*** SHOW DOWN ***
jjbenzky: shows [4d 8s] (a pair of Eights)
DeccaDan: mucks hand
Yockit: mucks hand
FishyFlopp: mucks hand
jjbenzky collected $0.43 from pot
*** SUMMARY ***
Total pot $0.45 | Rake $0.02
Board [6c Kd 8d 3s Tc]
Seat 1: Yockit mucked [3h Ad]
Seat 2: PlayTheBlues4U folded before Flop (didn't bet)
Seat 3: FishyFlopp (button) mucked [Qd 9c]
Seat 4: jjbenzky (small blind) showed [4d 8s] and won ($0.43) with a pair of Eights
Seat 5: DeccaDan (big blind) mucked [2s 6h]
Seat 6: DemolishIT folded on the Turn


PokerStars Hand #203470993047:  Hold'em No Limit ($0.01/$0.02 USD) - 2019/09/06 21:08:31 ET
Table 'Pegasus' 6-max Seat #3 is the button
Seat 2: doc112ocean ($0.90 in chips)
Seat 3: robcandy ($1.57 in chips)
Seat 4: PlayTheBlues4U ($3.55 in chips)
Seat 5: tsov252525 ($2.87 in chips)
Seat 6: TheWalrus435 ($1.78 in chips)
PlayTheBlues4U: posts small blind $0.01
tsov252525: posts big blind $0.02
*** HOLE CARDS ***
Dealt to PlayTheBlues4U [Ac 2c]
TheWalrus435: folds
doc112ocean: calls $0.02
robcandy: calls $0.02
PlayTheBlues4U: raises $0.04 to $0.06
tsov252525: folds
doc112ocean: calls $0.04
robcandy: calls $0.04
*** FLOP *** [Jh 5d Qs]
PlayTheBlues4U: checks
doc112ocean: checks
robcandy: checks
*** TURN *** [Jh 5d Qs] [Kc]
PlayTheBlues4U: checks
doc112ocean: checks
robcandy: bets $0.10
PlayTheBlues4U: folds
doc112ocean: folds
Uncalled bet ($0.10) returned to robcandy
robcandy collected $0.19 from pot
*** SUMMARY ***
Total pot $0.20 | Rake $0.01
Board [Jh 5d Qs Kc]
Seat 2: doc112ocean folded on the Turn
Seat 3: robcandy (button) collected ($0.19)
Seat 4: PlayTheBlues4U (small blind) folded on the Turn
Seat 5: tsov252525 (big blind) folded before Flop
Seat 6: TheWalrus435 folded before Flop (didn't bet)


PokerStars Hand #203470992959:  Hold'em No Limit ($0.02/$0.05 USD) - 2019/09/06 21:08:02 ET
Table 'Icarus' 6-max Seat #2 is the button
Seat 1: Yockit ($8.10 in chips)
Seat 2: PlayTheBlues4U ($9.90 in chips)
Seat 3: FishyFlopp ($3.83 in chips)
Seat 4: jjbenzky ($4.91 in chips)
Seat 5: DeccaDan ($12.28 in chips)
Seat 6: DemolishIT ($5.18 in chips)
FishyFlopp: posts small blind $0.02
jjbenzky: posts big blind $0.05
*** HOLE CARDS ***
Dealt to PlayTheBlues4U [Js 6c]
DeccaDan: folds
DemolishIT: folds
Yockit: calls $0.05
PlayTheBlues4U: folds
FishyFlopp: calls $0.03
jjbenzky: checks
*** FLOP *** [Kc Ah 9h]
FishyFlopp: checks
jjbenzky: bets $0.10
Yockit: calls $0.10
FishyFlopp: folds
*** TURN *** [Kc Ah 9h] [Kd]
jjbenzky: checks
Yockit: checks
*** RIVER *** [Kc Ah 9h Kd] [5d]
jjbenzky: bets $0.16
Yockit: folds
Uncalled bet ($0.16) returned to jjbenzky
jjbenzky collected $0.33 from pot
jjbenzky: doesn't show hand
*** SUMMARY ***
Total pot $0.35 | Rake $0.02
Board [Kc Ah 9h Kd 5d]
Seat 1: Yockit folded on the River
Seat 2: PlayTheBlues4U (button) folded before Flop (didn't bet)
Seat 3: FishyFlopp (small blind) folded on the Flop
Seat 4: jjbenzky (big blind) collected ($0.33)
Seat 5: DeccaDan folded before Flop (didn't bet)
Seat 6: DemolishIT folded before Flop (didn't bet)


PokerStars Hand #203470992940:  Hold'em No Limit ($0.01/$0.02 USD) - 2019/09/06 21:07:59 ET
Table 'Pegasus' 6-max Seat #2 is the button
Seat 2: doc112ocean ($0.85 in chips)
Seat 3: robcandy ($1.58 in chips)
Seat 4: PlayTheBlues4U ($3.57 in chips)
Seat 5: tsov252525 ($2.87 in chips)
Seat 6: TheWalrus435 ($1.80 in chips)
robcandy: posts small blind $0.01
PlayTheBlues4U: posts big blind $0.02
*** HOLE CARDS ***
Dealt to PlayTheBlues4U [7d Qd]
tsov252525: folds
TheWalrus435: calls $0.02
doc112ocean: calls $0.02
robcandy: folds
PlayTheBlues4U: checks
*** FLOP *** [9s 7h Kd]
PlayTheBlues4U: checks
TheWalrus435: checks
doc112ocean: bets $0.10
PlayTheBlues4U: folds
TheWalrus435: folds
Uncalled bet ($0.10) returned to doc112ocean
doc112ocean collected $0.07 from pot
*** SUMMARY ***
Total pot $0.07 | Rake $0
Board [9s 7h Kd]
Seat 2: doc112ocean (button) collected ($0.07)
Seat 3: robcandy (small blind) folded before Flop
Seat 4: PlayTheBlues4U (big blind) folded on the Flop
Seat 5: tsov252525 folded before Flop (didn't bet)
Seat 6: TheWalrus435 folded on the Flop


PokerStars Hand #203470992866:  Hold'em No Limit ($0.01/$0.02 USD) - 2019/09/06 21:07:33 ET
Table 'Pegasus' 6-max Seat #6 is the button
Seat 2: doc112ocean ($0.86 in chips)
Seat 3: robcandy ($1.66 in chips)
Seat 4: PlayTheBlues4U ($3.57 in chips)
Seat 5: tsov252525 ($2.79 in chips)
Seat 6: TheWalrus435 ($1.80 in chips)
doc112ocean: posts small blind $0.01
robcandy: posts big blind $0.02
*** HOLE CARDS ***
Dealt to PlayTheBlues4U [Jd 7s]
PlayTheBlues4U: folds
tsov252525: raises $0.06 to $0.08
TheWalrus435: folds
doc112ocean: folds
robcandy: calls $0.06
*** FLOP *** [5d Qd Th]
robcandy: checks
tsov252525: bets $0.12
robcandy: folds
Uncalled bet ($0.12) returned to tsov252525
tsov252525 collected $0.16 from pot
tsov252525: doesn't show hand
*** SUMMARY ***
Total pot $0.17 | Rake $0.01
Board [5d Qd Th]
Seat 2: doc112ocean (small blind) folded before Flop
Seat 3: robcandy (big blind) folded on the Flop
Seat 4: PlayTheBlues4U folded before Flop (didn't bet)
Seat 5: tsov252525 collected ($0.16)
Seat 6: TheWalrus435 (button) folded before Flop (didn't bet)


PokerStars Hand #203470992732:  Hold'em No Limit ($0.02/$0.05 USD) - 2019/09/06 21:06:43 ET
Table 'Icarus' 6-max Seat #1 is the button
Seat 1: Yockit ($8.20 in chips)
Seat 2: PlayTheBlues4U ($9.92 in chips)
Seat 3: FishyFlopp ($3.58 in chips)
Seat 4: jjbenzky ($5.01 in chips)
Seat 5: DeccaDan ($12.33 in chips)
Seat 6: DemolishIT ($5.18 in chips)
PlayTheBlues4U: posts small blind $0.02
FishyFlopp: posts big blind $0.05
*** HOLE CARDS ***
Dealt to PlayTheBlues4U [2c 7s]
jjbenzky: calls $0.05
DeccaDan: calls $0.05
DemolishIT: folds
Yockit: calls $0.05
PlayTheBlues4U: folds
FishyFlopp: checks
*** FLOP *** [2d 9s 9h]
FishyFlopp: checks
jjbenzky: checks
DeccaDan: checks
Yockit: bets $0.05
FishyFlopp: calls $0.05
jjbenzky: calls $0.05
DeccaDan: folds
*** TURN *** [2d 9s 9h] [4h]
FishyFlopp: checks
jjbenzky: checks
Yockit: checks
*** RIVER *** [2d 9s 9h 4h] [Ac]
FishyFlopp: checks
jjbenzky: checks
Yockit: checks
*** SHOW DOWN ***
FishyFlopp: shows [7d 7c] (two pair, Nines and Sevens)
jjbenzky: mucks hand
Yockit: mucks hand
FishyFlopp collected $0.35 from pot
*** SUMMARY ***
Total pot $0.37 | Rake $0.02
Board [2d 9s 9h 4h Ac]
Seat 1: Yockit (button) mucked [2s 6s]
Seat 2: PlayTheBlues4U (small blind) folded before Flop
Seat 3: FishyFlopp (big blind) showed [7d 7c] and won ($0.35) with two pair, Nines and Sevens
Seat 4: jjbenzky mucked [8d Qs]
Seat 5: DeccaDan folded on the Flop
Seat 6: DemolishIT folded before Flop (didn't bet)


PokerStars Hand #203470992684:  Hold'em No Limit ($0.01/$0.02 USD) - 2019/09/06 21:06:27 ET
Table 'Pegasus' 6-max Seat #5 is the button
Seat 2: doc112ocean ($0.88 in chips)
Seat 3: robcandy ($1.98 in chips)
Seat 4: PlayTheBlues4U ($3.25 in chips)
Seat 5: tsov252525 ($2.79 in chips)
Seat 6: TheWalrus435 ($1.81 in chips)
TheWalrus435: posts small blind $0.01
doc112ocean: posts big blind $0.02
*** HOLE CARDS ***
Dealt to PlayTheBlues4U [Kh Jc]
robcandy: calls $0.02
PlayTheBlues4U: raises $0.06 to $0.08
tsov252525: folds
TheWalrus435: folds
doc112ocean: folds
robcandy: calls $0.06
*** FLOP *** [4d 9h 9d]
robcandy: bets $0.08
PlayTheBlues4U: calls $0.08
*** TURN *** [4d 9h 9d] [Th]
robcandy: checks
PlayTheBlues4U: bets $0.16
robcandy: calls $0.16
*** RIVER *** [4d 9h 9d Th] [Qd]
robcandy: checks
PlayTheBlues4U: bets $0.52
robcandy: folds
Uncalled bet ($0.52) returned to PlayTheBlues4U
PlayTheBlues4U collected $0.64 from pot
PlayTheBlues4U: doesn't show hand
*** SUMMARY ***
Total pot $0.67 | Rake $0.03
Board [4d 9h 9d Th Qd]
Seat 2: doc112ocean (big blind) folded before Flop
Seat 3: robcandy folded on the River
Seat 4: PlayTheBlues4U collected ($0.64)
Seat 5: tsov252525 (button) folded before Flop (didn't bet)
Seat 6: TheWalrus435 (small blind) folded before Flop


PokerStars Hand #203470992611:  Hold'em No Limit ($0.02/$0.05 USD) - 2019/09/06 21:06:04 ET
Table 'Icarus' 6-max Seat #6 is the button
Seat 1: Yockit ($8.22 in chips)
Seat 2: PlayTheBlues4U ($9.97 in chips)
Seat 3: FishyFlopp ($3.58 in chips)
Seat 4: jjbenzky ($5.06 in chips)
Seat 5: DeccaDan ($12.33 in chips)
Seat 6: DemolishIT ($5.07 in chips)
Yockit: posts small blind $0.02
PlayTheBlues4U: posts big blind $0.05
*** HOLE CARDS ***
Dealt to PlayTheBlues4U [7s Tc]
FishyFlopp: folds
jjbenzky: calls $0.05
DeccaDan: folds
DemolishIT: calls $0.05
Yockit: folds
PlayTheBlues4U: checks
*** FLOP *** [Kc 6h 3d]
PlayTheBlues4U: checks
jjbenzky: checks
DemolishIT: bets $0.25
PlayTheBlues4U: folds
jjbenzky: folds
Uncalled bet ($0.25) returned to DemolishIT
DemolishIT collected $0.16 from pot
*** SUMMARY ***
Total pot $0.17 | Rake $0.01
Board [Kc 6h 3d]
Seat 1: Yockit (small blind) folded before Flop
Seat 2: PlayTheBlues4U (big blind) folded on the Flop
Seat 3: FishyFlopp folded before Flop (didn't bet)
Seat 4: jjbenzky folded on the Flop
Seat 5: DeccaDan folded before Flop (didn't bet)
Seat 6: DemolishIT (button) collected ($0.16)


PokerStars Hand #203470992556:  Hold'em No Limit ($0.01/$0.02 USD) - 2019/09/06 21:05:41 ET
Table 'Pegasus' 6-max Seat #4 is the button
Seat 2: doc112ocean ($0.90 in chips)
Seat 3: robcandy ($1.91 in chips)
Seat 4: PlayTheBlues4U ($3.25 in chips)
Seat 5: tsov252525 ($2.80 in chips)
Seat 6: TheWalrus435 ($1.85 in chips)
tsov252525: posts small blind $0.01
TheWalrus435: posts big blind $0.02
*** HOLE CARDS ***
Dealt to PlayTheBlues4U [2d Js]
doc112ocean: calls $0.02
robcandy: calls $0.02
PlayTheBlues4U: folds
tsov252525: folds
TheWalrus435: checks
*** FLOP *** [4c 8c Ts]
TheWalrus435: checks
doc112ocean: checks
robcandy: bets $0.02
TheWalrus435: calls $0.02
doc112ocean: folds
*** TURN *** [4c 8c Ts] [2s]
TheWalrus435: checks
robcandy: bets $0.10
TheWalrus435: folds
Uncalled bet ($0.10) returned to robcandy
robcandy collected $0.11 from pot
*** SUMMARY ***
Total pot $0.11 | Rake $0
Board [4c 8c Ts 2s]
Seat 2: doc112ocean folded on the Flop
Seat 3: robcandy collected ($0.11)
Seat 4: PlayTheBlues4U (button) folded before Flop (didn't bet)
Seat 5: tsov252525 (small blind) folded before Flop
Seat 6: TheWalrus435 (big blind) folded on the Turn


PokerStars Hand #203470992500:  Hold'em No Limit ($0.02/$0.05 USD) - 2019/09/06 21:05:24 ET
Table 'Icarus' 6-max Seat #5 is the button
Seat 1: Yockit ($8.27 in chips)
Seat 2: PlayTheBlues4U ($9.97 in chips)
Seat 3: FishyFlopp ($3.58 in chips)
Seat 4: jjbenzky ($5 in chips)
Seat 5: DeccaDan ($12.33 in chips)
Seat 6: DemolishIT ($5.09 in chips)
DemolishIT: posts small blind $0.02
Yockit: posts big blind $0.05
jjbenzky: posts big blind $0.05
*** HOLE CARDS ***
Dealt to PlayTheBlues4U [Th Ac]
PlayTheBlues4U: folds
FishyFlopp: folds
jjbenzky: checks
DeccaDan: folds
DemolishIT: folds
Yockit: checks
*** FLOP *** [Kh 3s 8s]
Yockit: checks
jjbenzky: checks
*** TURN *** [Kh 3s 8s] [Jh]
Yockit: checks
jjbenzky: checks
*** RIVER *** [Kh 3s 8s Jh] [Td]
Yockit: checks
jjbenzky: checks
*** SHOW DOWN ***
Yockit: shows [2s 9d] (high card King)
jjbenzky: shows [Qd 4h] (high card King - Queen kicker)
jjbenzky collected $0.11 from pot
*** SUMMARY ***
Total pot $0.12 | Rake $0.01
Board [Kh 3s 8s Jh Td]
Seat 1: Yockit (big blind) showed [2s 9d] and lost with high card King
Seat 2: PlayTheBlues4U folded before Flop (didn't bet)
Seat 3: FishyFlopp folded before Flop (didn't bet)
Seat 4: jjbenzky showed [Qd 4h] and won ($0.11) with high card King
Seat 5: DeccaDan (button) folded before Flop (didn't bet)
Seat 6: DemolishIT (small blind) folded before Flop


PokerStars Hand #203470992399:  Hold'em No Limit ($0.01/$0.02 USD) - 2019/09/06 21:04:47 ET
Table 'Pegasus' 6-max Seat #3 is the button
Seat 2: doc112ocean ($0.90 in chips)
Seat 3: robcandy ($1.91 in chips)
Seat 4: PlayTheBlues4U ($3.09 in chips)
Seat 5: tsov252525 ($2.82 in chips)
Seat 6: TheWalrus435 ($2.01 in chips)
PlayTheBlues4U: posts small blind $0.01
tsov252525: posts big blind $0.02
*** HOLE CARDS ***
Dealt to PlayTheBlues4U [As 6c]
TheWalrus435: calls $0.02
doc112ocean: folds
robcandy: folds
PlayTheBlues4U: raises $0.06 to $0.08
tsov252525: folds
TheWalrus435: calls $0.06
*** FLOP *** [6s Ks 4h]
PlayTheBlues4U: bets $0.08
TheWalrus435: calls $0.08
*** TURN *** [6s Ks 4h] [5s]
PlayTheBlues4U: checks
TheWalrus435: checks
*** RIVER *** [6s Ks 4h 5s] [9d]
PlayTheBlues4U: checks
TheWalrus435: checks
*** SHOW DOWN ***
PlayTheBlues4U: shows [As 6c] (a pair of Sixes)
TheWalrus435: mucks hand
PlayTheBlues4U collected $0.32 from pot
*** SUMMARY ***
Total pot $0.34 | Rake $0.02
Board [6s Ks 4h 5s 9d]
Seat 2: doc112ocean folded before Flop (didn't bet)
Seat 3: robcandy (button) folded before Flop (didn't bet)
Seat 4: PlayTheBlues4U (small blind) showed [As 6c] and won ($0.32) with a pair of Sixes
Seat 5: tsov252525 (big blind) folded before Flop
Seat 6: TheWalrus435 mucked [6h 7h]


PokerStars Hand #203470992322:  Hold'em No Limit ($0.02/$0.05 USD) - 2019/09/06 21:04:20 ET
Table 'Icarus' 6-max Seat #3 is the button
Seat 1: Yockit ($8.27 in chips)
Seat 2: PlayTheBlues4U ($9.97 in chips)
Seat 3: FishyFlopp ($3.68 in chips)
Seat 5: DeccaDan ($12.01 in chips)
Seat 6: DemolishIT ($5.34 in chips)
jjbenzky will be allowed to play after the button
DeccaDan: posts small blind $0.02
DemolishIT: posts big blind $0.05
*** HOLE CARDS ***
Dealt to PlayTheBlues4U [Qh Td]
Yockit: folds
PlayTheBlues4U: folds
FishyFlopp: calls $0.05
DeccaDan: raises $0.05 to $0.10
DemolishIT: calls $0.05
FishyFlopp: calls $0.05
*** FLOP *** [6c Qs Js]
DeccaDan: bets $0.15
DemolishIT: calls $0.15
FishyFlopp: folds
*** TURN *** [6c Qs Js] [Kd]
DeccaDan: checks
DemolishIT: checks
*** RIVER *** [6c Qs Js Kd] [Jh]
DeccaDan: bets $0.15
DemolishIT: folds
Uncalled bet ($0.15) returned to DeccaDan
DeccaDan collected $0.57 from pot
DeccaDan: doesn't show hand
*** SUMMARY ***
Total pot $0.60 | Rake $0.03
Board [6c Qs Js Kd Jh]
Seat 1: Yockit folded before Flop (didn't bet)
Seat 2: PlayTheBlues4U folded before Flop (didn't bet)
Seat 3: FishyFlopp (button) folded on the Flop
Seat 5: DeccaDan (small blind) collected ($0.57)
Seat 6: DemolishIT (big blind) folded on the River


PokerStars Hand #203470992273:  Hold'em No Limit ($0.01/$0.02 USD) - 2019/09/06 21:04:06 ET
Table 'Pegasus' 6-max Seat #2 is the button
Seat 2: doc112ocean ($0.90 in chips)
Seat 3: robcandy ($1.87 in chips)
Seat 4: PlayTheBlues4U ($3.13 in chips)
Seat 5: tsov252525 ($2.82 in chips)
Seat 6: TheWalrus435 ($2.01 in chips)
robcandy: posts small blind $0.01
PlayTheBlues4U: posts big blind $0.02
*** HOLE CARDS ***
Dealt to PlayTheBlues4U [9d 8c]
tsov252525: folds
TheWalrus435: folds
doc112ocean: folds
robcandy: calls $0.01
PlayTheBlues4U: checks
*** FLOP *** [6h Jd 7c]
robcandy: checks
PlayTheBlues4U: bets $0.02
robcandy: calls $0.02
*** TURN *** [6h Jd 7c] [4s]
robcandy: checks
PlayTheBlues4U: checks
*** RIVER *** [6h Jd 7c 4s] [4h]
robcandy: checks
PlayTheBlues4U: checks
*** SHOW DOWN ***
robcandy: shows [Ac 2h] (a pair of Fours)
PlayTheBlues4U: mucks hand
robcandy collected $0.08 from pot
*** SUMMARY ***
Total pot $0.08 | Rake $0
Board [6h Jd 7c 4s 4h]
Seat 2: doc112ocean (button) folded before Flop (didn't bet)
Seat 3: robcandy (small blind) showed [Ac 2h] and won ($0.08) with a pair of Fours
Seat 4: PlayTheBlues4U (big blind) mucked [9d 8c]
Seat 5: tsov252525 folded before Flop (didn't bet)
Seat 6: TheWalrus435 folded before Flop (didn't bet)


PokerStars Hand #203470992088:  Hold'em No Limit ($0.02/$0.05 USD) - 2019/09/06 21:03:06 ET
Table 'Icarus' 6-max Seat #2 is the button
Seat 1: Yockit ($8.27 in chips)
Seat 2: PlayTheBlues4U ($9.97 in chips)
Seat 3: FishyFlopp ($3.50 in chips)
Seat 5: DeccaDan ($12.11 in chips)
Seat 6: DemolishIT ($5.44 in chips)
FishyFlopp: posts small blind $0.02
DeccaDan: posts big blind $0.05
*** HOLE CARDS ***
Dealt to PlayTheBlues4U [8s 3c]
FishyFlopp said, "had AQ"
DemolishIT: calls $0.05
richy5742 leaves the table
Yockit: folds
jjbenzky joins the table at seat #4
PlayTheBlues4U: folds
FishyFlopp: calls $0.03
DeccaDan: checks
*** FLOP *** [5c 7d 8d]
FishyFlopp: checks
DeccaDan: bets $0.05
DemolishIT: calls $0.05
FishyFlopp: calls $0.05
*** TURN *** [5c 7d 8d] [Ah]
FishyFlopp: checks
DeccaDan: checks
DemolishIT: checks
*** RIVER *** [5c 7d 8d Ah] [3h]
FishyFlopp: bets $0.28
DeccaDan: folds
DemolishIT: folds
Uncalled bet ($0.28) returned to FishyFlopp
FishyFlopp collected $0.28 from pot
FishyFlopp: doesn't show hand
*** SUMMARY ***
Total pot $0.30 | Rake $0.02
Board [5c 7d 8d Ah 3h]
Seat 1: Yockit folded before Flop (didn't bet)
Seat 2: PlayTheBlues4U (button) folded before Flop (didn't bet)
Seat 3: FishyFlopp (small blind) collected ($0.28)
Seat 5: DeccaDan (big blind) folded on the River
Seat 6: DemolishIT folded on the River


PokerStars Hand #203470992018:  Hold'em No Limit ($0.01/$0.02 USD) - 2019/09/06 21:02:42 ET
Table 'Pegasus' 6-max Seat #6 is the button
Seat 2: doc112ocean ($0.96 in chips)
Seat 3: robcandy ($1.74 in chips)
Seat 4: PlayTheBlues4U ($3.13 in chips)
Seat 5: tsov252525 ($2.82 in chips)
Seat 6: TheWalrus435 ($2.09 in chips)
doc112ocean: posts small blind $0.01
robcandy: posts big blind $0.02
*** HOLE CARDS ***
Dealt to PlayTheBlues4U [Ts 5d]
PlayTheBlues4U: folds
tsov252525 has timed out
tsov252525: folds
TheWalrus435: calls $0.02
doc112ocean: calls $0.01
robcandy: checks
*** FLOP *** [7h 4c 7c]
doc112ocean: checks
robcandy: bets $0.02
TheWalrus435: calls $0.02
doc112ocean: calls $0.02
*** TURN *** [7h 4c 7c] [6h]
doc112ocean: bets $0.02
robcandy: calls $0.02
TheWalrus435: calls $0.02
*** RIVER *** [7h 4c 7c 6h] [2c]
doc112ocean: checks
robcandy: bets $0.02
TheWalrus435: calls $0.02
doc112ocean: folds
*** SHOW DOWN ***
robcandy: shows [6d 5c] (two pair, Sevens and Sixes)
TheWalrus435: mucks hand
robcandy collected $0.21 from pot
*** SUMMARY ***
Total pot $0.22 | Rake $0.01
Board [7h 4c 7c 6h 2c]
Seat 2: doc112ocean (small blind) folded on the River
Seat 3: robcandy (big blind) showed [6d 5c] and won ($0.21) with two pair, Sevens and Sixes
Seat 4: PlayTheBlues4U folded before Flop (didn't bet)
Seat 5: tsov252525 folded before Flop (didn't bet)
Seat 6: TheWalrus435 (button) mucked [Kc As]


PokerStars Hand #203470991853:  Hold'em No Limit ($0.02/$0.05 USD) - 2019/09/06 21:01:42 ET
Table 'Icarus' 6-max Seat #1 is the button
Seat 1: Yockit ($8.27 in chips)
Seat 2: PlayTheBlues4U ($5.75 in chips)
Seat 3: FishyFlopp ($4 in chips)
Seat 4: richy5742 ($4.16 in chips)
Seat 5: DeccaDan ($12.11 in chips)
Seat 6: DemolishIT ($5.44 in chips)
PlayTheBlues4U: posts small blind $0.02
FishyFlopp: posts big blind $0.05
*** HOLE CARDS ***
Dealt to PlayTheBlues4U [Ks As]
richy5742: raises $0.05 to $0.10
DeccaDan: folds
DemolishIT: folds
Yockit: folds
PlayTheBlues4U: calls $0.08
FishyFlopp: raises $0.05 to $0.15
richy5742: calls $0.05
PlayTheBlues4U: raises $0.35 to $0.50
FishyFlopp: calls $0.35
richy5742: raises $3.66 to $4.16 and is all-in
PlayTheBlues4U: raises $1.59 to $5.75 and is all-in
FishyFlopp: folds
Uncalled bet ($1.59) returned to PlayTheBlues4U
*** FLOP *** [8d 7s 6c]
*** TURN *** [8d 7s 6c] [2s]
FishyFlopp said, "lol"
*** RIVER *** [8d 7s 6c 2s] [3d]
*** SHOW DOWN ***
PlayTheBlues4U: shows [Ks As] (high card Ace)
richy5742: shows [Ah Js] (high card Ace - lower kicker)
PlayTheBlues4U collected $8.38 from pot
*** SUMMARY ***
Total pot $8.82 | Rake $0.44
Board [8d 7s 6c 2s 3d]
Seat 1: Yockit (button) folded before Flop (didn't bet)
Seat 2: PlayTheBlues4U (small blind) showed [Ks As] and won ($8.38) with high card Ace
Seat 3: FishyFlopp (big blind) folded before Flop
Seat 4: richy5742 showed [Ah Js] and lost with high card Ace
Seat 5: DeccaDan folded before Flop (didn't bet)
Seat 6: DemolishIT folded before Flop (didn't bet)


PokerStars Hand #203470991799:  Hold'em No Limit ($0.02/$0.05 USD) - 2019/09/06 21:01:19 ET
Table 'Icarus' 6-max Seat #6 is the button
Seat 1: Yockit ($8.29 in chips)
Seat 2: PlayTheBlues4U ($5.80 in chips)
Seat 4: richy5742 ($4.10 in chips)
Seat 5: DeccaDan ($12.11 in chips)
Seat 6: DemolishIT ($5.44 in chips)
Yockit: posts small blind $0.02
PlayTheBlues4U: posts big blind $0.05
FishyFlopp: sits out
*** HOLE CARDS ***
Dealt to PlayTheBlues4U [Qc 9s]
richy5742: calls $0.05
DeccaDan: folds
DemolishIT: folds
Yockit: folds
PlayTheBlues4U: checks
*** FLOP *** [4d 6d 5s]
PlayTheBlues4U: checks
richy5742: bets $0.10
PlayTheBlues4U: folds
Uncalled bet ($0.10) returned to richy5742
richy5742 collected $0.11 from pot
richy5742: doesn't show hand
*** SUMMARY ***
Total pot $0.12 | Rake $0.01
Board [4d 6d 5s]
Seat 1: Yockit (small blind) folded before Flop
Seat 2: PlayTheBlues4U (big blind) folded on the Flop
Seat 4: richy5742 collected ($0.11)
Seat 5: DeccaDan folded before Flop (didn't bet)
Seat 6: DemolishIT (button) folded before Flop (didn't bet)


PokerStars Hand #203470991715:  Hold'em No Limit ($0.01/$0.02 USD) - 2019/09/06 21:00:55 ET
Table 'Pegasus' 6-max Seat #5 is the button
Seat 1: michelina44 ($0.78 in chips)
Seat 2: doc112ocean ($0.96 in chips)
Seat 3: robcandy ($1.88 in chips)
Seat 4: PlayTheBlues4U ($3.21 in chips)
Seat 5: tsov252525 ($2.46 in chips)
Seat 6: TheWalrus435 ($2.23 in chips)
TheWalrus435: posts small blind $0.01
michelina44: posts big blind $0.02
*** HOLE CARDS ***
Dealt to PlayTheBlues4U [Jd 8d]
doc112ocean: folds
robcandy: calls $0.02
PlayTheBlues4U: calls $0.02
tsov252525: raises $0.06 to $0.08
TheWalrus435: calls $0.07
michelina44 has timed out
michelina44: folds
robcandy: calls $0.06
PlayTheBlues4U: calls $0.06
*** FLOP *** [6c Td 3h]
TheWalrus435: bets $0.06
robcandy: calls $0.06
PlayTheBlues4U: folds
tsov252525: raises $0.50 to $0.56
TheWalrus435: folds
robcandy: folds
Uncalled bet ($0.50) returned to tsov252525
tsov252525 collected $0.50 from pot
tsov252525: doesn't show hand
*** SUMMARY ***
Total pot $0.52 | Rake $0.02
Board [6c Td 3h]
Seat 1: michelina44 (big blind) folded before Flop
Seat 2: doc112ocean folded before Flop (didn't bet)
Seat 3: robcandy folded on the Flop
Seat 4: PlayTheBlues4U folded on the Flop
Seat 5: tsov252525 (button) collected ($0.50)
Seat 6: TheWalrus435 (small blind) folded on the Flop


PokerStars Hand #203470991676:  Hold'em No Limit ($0.02/$0.05 USD) - 2019/09/06 21:00:42 ET
Table 'Icarus' 6-max Seat #5 is the button
Seat 1: Yockit ($8.39 in chips)
Seat 2: PlayTheBlues4U ($5.80 in chips)
Seat 4: richy5742 ($3.99 in chips)
Seat 5: DeccaDan ($12.11 in chips)
Seat 6: DemolishIT ($5.46 in chips)
DemolishIT: posts small blind $0.02
Yockit: posts big blind $0.05
FishyFlopp: sits out
*** HOLE CARDS ***
Dealt to PlayTheBlues4U [4d Tc]
PlayTheBlues4U: folds
richy5742: raises $0.05 to $0.10
DeccaDan: folds
DemolishIT: folds
Yockit: calls $0.05
*** FLOP *** [7d 6c Ah]
Yockit: checks
richy5742: bets $0.10
Yockit: folds
Uncalled bet ($0.10) returned to richy5742
richy5742 collected $0.21 from pot
richy5742: doesn't show hand
*** SUMMARY ***
Total pot $0.22 | Rake $0.01
Board [7d 6c Ah]
Seat 1: Yockit (big blind) folded on the Flop
Seat 2: PlayTheBlues4U folded before Flop (didn't bet)
Seat 4: richy5742 collected ($0.21)
Seat 5: DeccaDan (button) folded before Flop (didn't bet)
Seat 6: DemolishIT (small blind) folded before Flop


PokerStars Hand #203470991555:  Hold'em No Limit ($0.01/$0.02 USD) - 2019/09/06 20:59:51 ET
Table 'Pegasus' 6-max Seat #4 is the button
Seat 1: michelina44 ($0.78 in chips)
Seat 2: doc112ocean ($1.08 in chips)
Seat 3: robcandy ($2 in chips)
Seat 4: PlayTheBlues4U ($3.21 in chips)
Seat 5: tsov252525 ($2.47 in chips)
Seat 6: TheWalrus435 ($2 in chips)
tsov252525: posts small blind $0.01
TheWalrus435: posts big blind $0.02
robcandy: posts big blind $0.02
*** HOLE CARDS ***
Dealt to PlayTheBlues4U [Js 8h]
michelina44: folds
doc112ocean: calls $0.02
robcandy: checks
PlayTheBlues4U: folds
tsov252525: folds
TheWalrus435: checks
*** FLOP *** [9s Td Th]
TheWalrus435: checks
doc112ocean: checks
robcandy: checks
*** TURN *** [9s Td Th] [9h]
TheWalrus435: checks
doc112ocean: checks
robcandy: checks
*** RIVER *** [9s Td Th 9h] [Tc]
TheWalrus435: bets $0.10
doc112ocean: calls $0.10
robcandy: calls $0.10
*** SHOW DOWN ***
TheWalrus435: shows [Ts 6c] (four of a kind, Tens)
doc112ocean: mucks hand
robcandy: mucks hand
TheWalrus435 collected $0.35 from pot
*** SUMMARY ***
Total pot $0.37 | Rake $0.02
Board [9s Td Th 9h Tc]
Seat 1: michelina44 folded before Flop (didn't bet)
Seat 2: doc112ocean mucked [Jc Qs]
Seat 3: robcandy mucked [Kc 2c]
Seat 4: PlayTheBlues4U (button) folded before Flop (didn't bet)
Seat 5: tsov252525 (small blind) folded before Flop
Seat 6: TheWalrus435 (big blind) showed [Ts 6c] and won ($0.35) with four of a kind, Tens


PokerStars Hand #203470991538:  Hold'em No Limit ($0.02/$0.05 USD) - 2019/09/06 20:59:45 ET
Table 'Icarus' 6-max Seat #4 is the button
Seat 1: Yockit ($8.39 in chips)
Seat 2: PlayTheBlues4U ($5.80 in chips)
Seat 4: richy5742 ($3.63 in chips)
Seat 5: DeccaDan ($12.46 in chips)
Seat 6: DemolishIT ($5.51 in chips)
DeccaDan: posts small blind $0.02
DemolishIT: posts big blind $0.05
*** HOLE CARDS ***
Dealt to PlayTheBlues4U [3s Qd]
FishyFlopp joins the table at seat #3
Yockit: folds
PlayTheBlues4U: folds
richy5742: calls $0.05
DeccaDan: calls $0.03
DemolishIT: checks
*** FLOP *** [6s 4c Kh]
DeccaDan: checks
DemolishIT: checks
richy5742: bets $0.10
DeccaDan: calls $0.10
DemolishIT: folds
*** TURN *** [6s 4c Kh] [As]
DeccaDan: checks
richy5742: checks
*** RIVER *** [6s 4c Kh As] [7c]
DeccaDan: bets $0.20
richy5742: calls $0.20
*** SHOW DOWN ***
DeccaDan: shows [5d 7h] (a pair of Sevens)
richy5742: shows [2d Kd] (a pair of Kings)
richy5742 collected $0.71 from pot
*** SUMMARY ***
Total pot $0.75 | Rake $0.04
Board [6s 4c Kh As 7c]
Seat 1: Yockit folded before Flop (didn't bet)
Seat 2: PlayTheBlues4U folded before Flop (didn't bet)
Seat 4: richy5742 (button) showed [2d Kd] and won ($0.71) with a pair of Kings
Seat 5: DeccaDan (small blind) showed [5d 7h] and lost with a pair of Sevens
Seat 6: DemolishIT (big blind) folded on the Flop


PokerStars Hand #203470991436:  Hold'em No Limit ($0.02/$0.05 USD) - 2019/09/06 20:58:59 ET
Table 'Icarus' 6-max Seat #2 is the button
Seat 1: Yockit ($8.39 in chips)
Seat 2: PlayTheBlues4U ($5.80 in chips)
Seat 3: 47xx47 ($4.80 in chips)
Seat 4: richy5742 ($3.68 in chips)
Seat 5: DeccaDan ($12.46 in chips)
Seat 6: DemolishIT ($5.45 in chips)
47xx47: posts small blind $0.02
richy5742: posts big blind $0.05
*** HOLE CARDS ***
Dealt to PlayTheBlues4U [8c 2d]
DeccaDan: folds
DemolishIT: calls $0.05
Yockit: folds
PlayTheBlues4U: folds
47xx47: folds
richy5742: checks
*** FLOP *** [6h 8d Th]
richy5742: checks
DemolishIT: bets $0.20
47xx47 leaves the table
richy5742: folds
Uncalled bet ($0.20) returned to DemolishIT
DemolishIT collected $0.11 from pot
*** SUMMARY ***
Total pot $0.12 | Rake $0.01
Board [6h 8d Th]
Seat 1: Yockit folded before Flop (didn't bet)
Seat 2: PlayTheBlues4U (button) folded before Flop (didn't bet)
Seat 3: 47xx47 (small blind) folded before Flop
Seat 4: richy5742 (big blind) folded on the Flop
Seat 5: DeccaDan folded before Flop (didn't bet)
Seat 6: DemolishIT collected ($0.11)


PokerStars Hand #203470991428:  Hold'em No Limit ($0.01/$0.02 USD) - 2019/09/06 20:58:54 ET
Table 'Pegasus' 6-max Seat #2 is the button
Seat 1: michelina44 ($0.80 in chips)
Seat 2: doc112ocean ($1.10 in chips)
Seat 4: PlayTheBlues4U ($3.22 in chips)
Seat 5: tsov252525 ($2.42 in chips)
PlayTheBlues4U: posts small blind $0.01
tsov252525: posts big blind $0.02
michelina44: posts big blind $0.02
*** HOLE CARDS ***
Dealt to PlayTheBlues4U [Kc 2d]
michelina44: checks
doc112ocean: calls $0.02
robcandy joins the table at seat #3
PlayTheBlues4U: folds
tsov252525: checks
*** FLOP *** [3d 4s 2h]
TheWalrus435 joins the table at seat #6
tsov252525: checks
michelina44: checks
doc112ocean: checks
*** TURN *** [3d 4s 2h] [6d]
tsov252525: checks
michelina44: checks
doc112ocean: checks
*** RIVER *** [3d 4s 2h 6d] [8s]
tsov252525: checks
michelina44: checks
doc112ocean: checks
*** SHOW DOWN ***
tsov252525: shows [Jc 8c] (a pair of Eights)
michelina44: mucks hand
doc112ocean: mucks hand
tsov252525 collected $0.07 from pot
*** SUMMARY ***
Total pot $0.07 | Rake $0
Board [3d 4s 2h 6d 8s]
Seat 1: michelina44 mucked [Qs Js]
Seat 2: doc112ocean (button) mucked [Ts 9c]
Seat 4: PlayTheBlues4U (small blind) folded before Flop
Seat 5: tsov252525 (big blind) showed [Jc 8c] and won ($0.07) with a pair of Eights


PokerStars Hand #203470991367:  Hold'em No Limit ($0.01/$0.02 USD) - 2019/09/06 20:58:23 ET
Table 'Pegasus' 6-max Seat #5 is the button
Seat 2: doc112ocean ($1.12 in chips)
Seat 4: PlayTheBlues4U ($3.20 in chips)
Seat 5: tsov252525 ($2.42 in chips)
michelina44 will be allowed to play after the button
doc112ocean: posts small blind $0.01
PlayTheBlues4U: posts big blind $0.02
*** HOLE CARDS ***
Dealt to PlayTheBlues4U [8d 4d]
tsov252525: folds
doc112ocean: calls $0.01
PlayTheBlues4U: checks
*** FLOP *** [5s Tc 2h]
doc112ocean: checks
PlayTheBlues4U: checks
*** TURN *** [5s Tc 2h] [8c]
doc112ocean: checks
PlayTheBlues4U: bets $0.04
doc112ocean: folds
Uncalled bet ($0.04) returned to PlayTheBlues4U
PlayTheBlues4U collected $0.04 from pot
PlayTheBlues4U: doesn't show hand
*** SUMMARY ***
Total pot $0.04 | Rake $0
Board [5s Tc 2h 8c]
Seat 2: doc112ocean (small blind) folded on the Turn
Seat 4: PlayTheBlues4U (big blind) collected ($0.04)
Seat 5: tsov252525 (button) folded before Flop (didn't bet)


PokerStars Hand #203470991339:  Hold'em No Limit ($0.02/$0.05 USD) - 2019/09/06 20:58:11 ET
Table 'Icarus' 6-max Seat #1 is the button
Seat 1: Yockit ($8.30 in chips)
Seat 2: PlayTheBlues4U ($5.85 in chips)
Seat 3: 47xx47 ($4.85 in chips)
Seat 4: richy5742 ($3.68 in chips)
Seat 5: DeccaDan ($12.46 in chips)
Seat 6: DemolishIT ($5.45 in chips)
PlayTheBlues4U: posts small blind $0.02
47xx47: posts big blind $0.05
*** HOLE CARDS ***
Dealt to PlayTheBlues4U [6h Tc]
richy5742: folds
DeccaDan: folds
DemolishIT: folds
Yockit: calls $0.05
PlayTheBlues4U: calls $0.03
47xx47: checks
*** FLOP *** [Jd 4h 2c]
PlayTheBlues4U: checks
47xx47: checks
Yockit: checks
*** TURN *** [Jd 4h 2c] [5h]
PlayTheBlues4U: checks
47xx47: checks
Yockit: checks
*** RIVER *** [Jd 4h 2c 5h] [8s]
PlayTheBlues4U: checks
47xx47: checks
Yockit: checks
*** SHOW DOWN ***
PlayTheBlues4U: shows [6h Tc] (high card Jack)
47xx47: shows [7c Kh] (high card King)
Yockit: shows [Ks Qh] (high card King - Queen kicker)
Yockit collected $0.14 from pot
*** SUMMARY ***
Total pot $0.15 | Rake $0.01
Board [Jd 4h 2c 5h 8s]
Seat 1: Yockit (button) showed [Ks Qh] and won ($0.14) with high card King
Seat 2: PlayTheBlues4U (small blind) showed [6h Tc] and lost with high card Jack
Seat 3: 47xx47 (big blind) showed [7c Kh] and lost with high card King
Seat 4: richy5742 folded before Flop (didn't bet)
Seat 5: DeccaDan folded before Flop (didn't bet)
Seat 6: DemolishIT folded before Flop (didn't bet)


PokerStars Hand #203470991314:  Hold'em No Limit ($0.01/$0.02 USD) - 2019/09/06 20:57:59 ET
Table 'Pegasus' 6-max Seat #4 is the button
Seat 2: doc112ocean ($1.20 in chips)
Seat 4: PlayTheBlues4U ($3.20 in chips)
Seat 5: tsov252525 ($2.35 in chips)
tsov252525: posts small blind $0.01
doc112ocean: posts big blind $0.02
*** HOLE CARDS ***
Dealt to PlayTheBlues4U [7c 5h]
PlayTheBlues4U: folds
tsov252525: raises $0.06 to $0.08
doc112ocean: calls $0.06
*** FLOP *** [Qh 7h 9s]
michelina44 joins the table at seat #1
tsov252525: bets $0.10
doc112ocean: folds
Uncalled bet ($0.10) returned to tsov252525
tsov252525 collected $0.15 from pot
tsov252525: doesn't show hand
*** SUMMARY ***
Total pot $0.16 | Rake $0.01
Board [Qh 7h 9s]
Seat 2: doc112ocean (big blind) folded on the Flop
Seat 4: PlayTheBlues4U (button) folded before Flop (didn't bet)
Seat 5: tsov252525 (small blind) collected ($0.15)


PokerStars Hand #203470991248:  Hold'em No Limit ($0.01/$0.02 USD) - 2019/09/06 20:57:28 ET
Table 'Pegasus' 6-max Seat #2 is the button
Seat 1: Zeos179 ($3.90 in chips)
Seat 2: doc112ocean ($1.20 in chips)
Seat 4: PlayTheBlues4U ($3.18 in chips)
Seat 5: tsov252525 ($2.37 in chips)
PlayTheBlues4U: posts small blind $0.01
tsov252525: posts big blind $0.02
*** HOLE CARDS ***
Dealt to PlayTheBlues4U [6s Js]
Zeos179: folds
doc112ocean: folds
Zeos179 leaves the table
PlayTheBlues4U: calls $0.01
JPcaked joins the table at seat #1
tsov252525: checks
*** FLOP *** [3s Ah 6h]
PlayTheBlues4U: bets $0.04
JPcaked leaves the table
tsov252525: folds
Uncalled bet ($0.04) returned to PlayTheBlues4U
PlayTheBlues4U collected $0.04 from pot
PlayTheBlues4U: doesn't show hand
*** SUMMARY ***
Total pot $0.04 | Rake $0
Board [3s Ah 6h]
Seat 1: Zeos179 folded before Flop (didn't bet)
Seat 2: doc112ocean (button) folded before Flop (didn't bet)
Seat 4: PlayTheBlues4U (small blind) collected ($0.04)
Seat 5: tsov252525 (big blind) folded on the Flop


PokerStars Hand #203470991233:  Hold'em No Limit ($0.02/$0.05 USD) - 2019/09/06 20:57:23 ET
Table 'Icarus' 6-max Seat #6 is the button
Seat 1: Yockit ($8.12 in chips)
Seat 2: PlayTheBlues4U ($5.90 in chips)
Seat 3: 47xx47 ($4.85 in chips)
Seat 4: richy5742 ($3.78 in chips)
Seat 5: DeccaDan ($12.46 in chips)
Seat 6: DemolishIT ($5.50 in chips)
Yockit: posts small blind $0.02
PlayTheBlues4U: posts big blind $0.05
*** HOLE CARDS ***
Dealt to PlayTheBlues4U [Ks 8s]
47xx47: folds
richy5742: calls $0.05
DeccaDan: folds
DemolishIT: calls $0.05
Yockit: calls $0.03
PlayTheBlues4U: checks
*** FLOP *** [Qc 6h 2d]
Yockit: bets $0.05
PlayTheBlues4U: folds
richy5742: calls $0.05
DemolishIT: folds
*** TURN *** [Qc 6h 2d] [5h]
Yockit: checks
richy5742: checks
*** RIVER *** [Qc 6h 2d 5h] [6d]
Yockit: checks
richy5742: checks
*** SHOW DOWN ***
Yockit: shows [Js Jc] (two pair, Jacks and Sixes)
richy5742: mucks hand
Yockit collected $0.28 from pot
*** SUMMARY ***
Total pot $0.30 | Rake $0.02
Board [Qc 6h 2d 5h 6d]
Seat 1: Yockit (small blind) showed [Js Jc] and won ($0.28) with two pair, Jacks and Sixes
Seat 2: PlayTheBlues4U (big blind) folded on the Flop
Seat 3: 47xx47 folded before Flop (didn't bet)
Seat 4: richy5742 mucked [7c 7h]
Seat 5: DeccaDan folded before Flop (didn't bet)
Seat 6: DemolishIT (button) folded on the Flop


PokerStars Hand #203470991180:  Hold'em No Limit ($0.01/$0.02 USD) - 2019/09/06 20:57:00 ET
Table 'Pegasus' 6-max Seat #1 is the button
Seat 1: Zeos179 ($3.90 in chips)
Seat 2: doc112ocean ($1.18 in chips)
Seat 4: PlayTheBlues4U ($3.20 in chips)
Seat 5: tsov252525 ($2.37 in chips)
doc112ocean: posts small blind $0.01
PlayTheBlues4U: posts big blind $0.02
*** HOLE CARDS ***
Dealt to PlayTheBlues4U [6c 4h]
tsov252525: folds
Zeos179: folds
doc112ocean: calls $0.01
PlayTheBlues4U: checks
*** FLOP *** [Ks 9d Jh]
doc112ocean: checks
PlayTheBlues4U: checks
*** TURN *** [Ks 9d Jh] [Kh]
doc112ocean: checks
PlayTheBlues4U: checks
*** RIVER *** [Ks 9d Jh Kh] [Kc]
doc112ocean: checks
PlayTheBlues4U: checks
*** SHOW DOWN ***
doc112ocean: shows [4c As] (three of a kind, Kings)
PlayTheBlues4U: mucks hand
doc112ocean collected $0.04 from pot
*** SUMMARY ***
Total pot $0.04 | Rake $0
Board [Ks 9d Jh Kh Kc]
Seat 1: Zeos179 (button) folded before Flop (didn't bet)
Seat 2: doc112ocean (small blind) showed [4c As] and won ($0.04) with three of a kind, Kings
Seat 4: PlayTheBlues4U (big blind) mucked [6c 4h]
Seat 5: tsov252525 folded before Flop (didn't bet)


PokerStars Hand #203470991166:  Hold'em No Limit ($0.02/$0.05 USD) - 2019/09/06 20:56:54 ET
Table 'Icarus' 6-max Seat #5 is the button
Seat 1: Yockit ($8.17 in chips)
Seat 2: PlayTheBlues4U ($5.90 in chips)
Seat 3: 47xx47 ($2.90 in chips)
Seat 4: richy5742 ($3.78 in chips)
Seat 5: DeccaDan ($12.46 in chips)
Seat 6: DemolishIT ($5.30 in chips)
DemolishIT: posts small blind $0.02
Yockit: posts big blind $0.05
*** HOLE CARDS ***
Dealt to PlayTheBlues4U [5h 8h]
PlayTheBlues4U: folds
47xx47: raises $0.10 to $0.15
richy5742: folds
DeccaDan: folds
DemolishIT: raises $0.60 to $0.75
Yockit: folds
47xx47: folds
Uncalled bet ($0.60) returned to DemolishIT
DemolishIT collected $0.35 from pot
DemolishIT: doesn't show hand
*** SUMMARY ***
Total pot $0.35 | Rake $0
Seat 1: Yockit (big blind) folded before Flop
Seat 2: PlayTheBlues4U folded before Flop (didn't bet)
Seat 3: 47xx47 folded before Flop
Seat 4: richy5742 folded before Flop (didn't bet)
Seat 5: DeccaDan (button) folded before Flop (didn't bet)
Seat 6: DemolishIT (small blind) collected ($0.35)


PokerStars Hand #203470991148:  Hold'em No Limit ($0.01/$0.02 USD) - 2019/09/06 20:56:48 ET
Table 'Pegasus' 6-max Seat #5 is the button
Seat 1: Zeos179 ($3.91 in chips)
Seat 2: doc112ocean ($1.20 in chips)
Seat 4: PlayTheBlues4U ($3.17 in chips)
Seat 5: tsov252525 ($2.37 in chips)
Zeos179: posts small blind $0.01
doc112ocean: posts big blind $0.02
*** HOLE CARDS ***
Dealt to PlayTheBlues4U [Kd Qd]
PlayTheBlues4U: raises $0.06 to $0.08
tsov252525: folds
Zeos179: folds
doc112ocean: folds
Uncalled bet ($0.06) returned to PlayTheBlues4U
PlayTheBlues4U collected $0.05 from pot
PlayTheBlues4U: doesn't show hand
*** SUMMARY ***
Total pot $0.05 | Rake $0
Seat 1: Zeos179 (small blind) folded before Flop
Seat 2: doc112ocean (big blind) folded before Flop
Seat 4: PlayTheBlues4U collected ($0.05)
Seat 5: tsov252525 (button) folded before Flop (didn't bet)


PokerStars Hand #203470699983:  Hold'em No Limit ($0.01/$0.02 USD) - 2019/09/06 20:56:18 ET
Table 'Pegasus' 6-max Seat #4 is the button
Seat 1: Zeos179 ($3.79 in chips)
Seat 2: doc112ocean ($1.32 in chips)
Seat 4: PlayTheBlues4U ($3.17 in chips)
Seat 5: tsov252525 ($2.38 in chips)
tsov252525: posts small blind $0.01
Zeos179: posts big blind $0.02
*** HOLE CARDS ***
Dealt to PlayTheBlues4U [7d 3c]
doc112ocean: calls $0.02
PlayTheBlues4U: folds
tsov252525: folds
Zeos179: checks
*** FLOP *** [6c 4s 5c]
Zeos179: checks
doc112ocean: bets $0.10
Zeos179: calls $0.10
*** TURN *** [6c 4s 5c] [6d]
Zeos179: checks
doc112ocean: checks
*** RIVER *** [6c 4s 5c 6d] [Tc]
Zeos179: checks
doc112ocean: checks
*** SHOW DOWN ***
Zeos179: shows [4h 7c] (two pair, Sixes and Fours)
doc112ocean: mucks hand
Zeos179 collected $0.24 from pot
*** SUMMARY ***
Total pot $0.25 | Rake $0.01
Board [6c 4s 5c 6d Tc]
Seat 1: Zeos179 (big blind) showed [4h 7c] and won ($0.24) with two pair, Sixes and Fours
Seat 2: doc112ocean mucked [Ad Ks]
Seat 4: PlayTheBlues4U (button) folded before Flop (didn't bet)
Seat 5: tsov252525 (small blind) folded before Flop


PokerStars Hand #203470699931:  Hold'em No Limit ($0.01/$0.02 USD) - 2019/09/06 20:55:52 ET
Table 'Pegasus' 6-max Seat #2 is the button
Seat 1: Zeos179 ($3.81 in chips)
Seat 2: doc112ocean ($1.32 in chips)
Seat 4: PlayTheBlues4U ($3.18 in chips)
Seat 5: tsov252525 ($2.35 in chips)
PlayTheBlues4U: posts small blind $0.01
tsov252525: posts big blind $0.02
*** HOLE CARDS ***
Dealt to PlayTheBlues4U [Jd 7h]
Zeos179: calls $0.02
doc112ocean: folds
PlayTheBlues4U: folds
tsov252525: checks
*** FLOP *** [9c 5c 9d]
tsov252525: checks
Zeos179: checks
*** TURN *** [9c 5c 9d] [6s]
tsov252525: bets $0.05
Zeos179: folds
Uncalled bet ($0.05) returned to tsov252525
tsov252525 collected $0.05 from pot
tsov252525: doesn't show hand
*** SUMMARY ***
Total pot $0.05 | Rake $0
Board [9c 5c 9d 6s]
Seat 1: Zeos179 folded on the Turn
Seat 2: doc112ocean (button) folded before Flop (didn't bet)
Seat 4: PlayTheBlues4U (small blind) folded before Flop
Seat 5: tsov252525 (big blind) collected ($0.05)


PokerStars Hand #203470699899:  Hold'em No Limit ($0.01/$0.02 USD) - 2019/09/06 20:55:36 ET
Table 'Pegasus' 6-max Seat #1 is the button
Seat 1: Zeos179 ($3.78 in chips)
Seat 2: doc112ocean ($1.33 in chips)
Seat 4: PlayTheBlues4U ($3.20 in chips)
Seat 5: tsov252525 ($2.35 in chips)
doc112ocean: posts small blind $0.01
PlayTheBlues4U: posts big blind $0.02
*** HOLE CARDS ***
Dealt to PlayTheBlues4U [Kc Jd]
tsov252525: folds
Zeos179: raises $0.16 to $0.18
doc112ocean: folds
PlayTheBlues4U: folds
Uncalled bet ($0.16) returned to Zeos179
Zeos179 collected $0.05 from pot
Zeos179: doesn't show hand
*** SUMMARY ***
Total pot $0.05 | Rake $0
Seat 1: Zeos179 (button) collected ($0.05)
Seat 2: doc112ocean (small blind) folded before Flop
Seat 4: PlayTheBlues4U (big blind) folded before Flop
Seat 5: tsov252525 folded before Flop (didn't bet)


PokerStars Hand #203470699894:  Hold'em No Limit ($0.02/$0.05 USD) - 2019/09/06 20:55:34 ET
Table 'Icarus' 6-max Seat #4 is the button
Seat 1: Yockit ($6.54 in chips)
Seat 2: PlayTheBlues4U ($5.90 in chips)
Seat 3: 47xx47 ($2.95 in chips)
Seat 4: richy5742 ($5.43 in chips)
Seat 5: DeccaDan ($12.51 in chips)
Seat 6: DemolishIT ($5.35 in chips)
DeccaDan: posts small blind $0.02
DemolishIT: posts big blind $0.05
*** HOLE CARDS ***
Dealt to PlayTheBlues4U [5d 4h]
Yockit: calls $0.05
PlayTheBlues4U: folds
47xx47: calls $0.05
richy5742: calls $0.05
DeccaDan: calls $0.03
DemolishIT: checks
*** FLOP *** [Ac Ad Jc]
DeccaDan: checks
DemolishIT: checks
Yockit: checks
47xx47: checks
richy5742: bets $0.15
DeccaDan: folds
DemolishIT: folds
Yockit: calls $0.15
47xx47: folds
*** TURN *** [Ac Ad Jc] [Qh]
Yockit: checks
richy5742: bets $0.10
Yockit: raises $0.35 to $0.45
richy5742: calls $0.35
*** RIVER *** [Ac Ad Jc Qh] [7h]
Yockit: bets $1
richy5742: calls $1
*** SHOW DOWN ***
Yockit: shows [Ts Kh] (a straight, Ten to Ace)
richy5742: mucks hand
Yockit collected $3.28 from pot
*** SUMMARY ***
Total pot $3.45 | Rake $0.17
Board [Ac Ad Jc Qh 7h]
Seat 1: Yockit showed [Ts Kh] and won ($3.28) with a straight, Ten to Ace
Seat 2: PlayTheBlues4U folded before Flop (didn't bet)
Seat 3: 47xx47 folded on the Flop
Seat 4: richy5742 (button) mucked [9c Qd]
Seat 5: DeccaDan (small blind) folded on the Flop
Seat 6: DemolishIT (big blind) folded on the Flop


PokerStars Hand #203470699868:  Hold'em No Limit ($0.01/$0.02 USD) - 2019/09/06 20:55:22 ET
Table 'Pegasus' 6-max Seat #5 is the button
Seat 1: Zeos179 ($3.79 in chips)
Seat 2: doc112ocean ($1.32 in chips)
Seat 4: PlayTheBlues4U ($3.20 in chips)
Seat 5: tsov252525 ($2.35 in chips)
Zeos179: posts small blind $0.01
doc112ocean: posts big blind $0.02
*** HOLE CARDS ***
Dealt to PlayTheBlues4U [Kc 4d]
PlayTheBlues4U: folds
tsov252525: folds
Zeos179: folds
Uncalled bet ($0.01) returned to doc112ocean
doc112ocean collected $0.02 from pot
*** SUMMARY ***
Total pot $0.02 | Rake $0
Seat 1: Zeos179 (small blind) folded before Flop
Seat 2: doc112ocean (big blind) collected ($0.02)
Seat 4: PlayTheBlues4U folded before Flop (didn't bet)
Seat 5: tsov252525 (button) folded before Flop (didn't bet)


PokerStars Hand #203470699799:  Hold'em No Limit ($0.01/$0.02 USD) - 2019/09/06 20:54:57 ET
Table 'Pegasus' 6-max Seat #4 is the button
Seat 1: Zeos179 ($3.81 in chips)
Seat 2: doc112ocean ($1.32 in chips)
Seat 4: PlayTheBlues4U ($3.17 in chips)
Seat 5: tsov252525 ($2.36 in chips)
tsov252525: posts small blind $0.01
Zeos179: posts big blind $0.02
*** HOLE CARDS ***
Dealt to PlayTheBlues4U [Kd 5h]
doc112ocean: folds
PlayTheBlues4U: raises $0.04 to $0.06
tsov252525: folds
Zeos179: folds
Uncalled bet ($0.04) returned to PlayTheBlues4U
PlayTheBlues4U collected $0.05 from pot
PlayTheBlues4U: doesn't show hand
*** SUMMARY ***
Total pot $0.05 | Rake $0
Seat 1: Zeos179 (big blind) folded before Flop
Seat 2: doc112ocean folded before Flop (didn't bet)
Seat 4: PlayTheBlues4U (button) collected ($0.05)
Seat 5: tsov252525 (small blind) folded before Flop


PokerStars Hand #203470699695:  Hold'em No Limit ($0.01/$0.02 USD) - 2019/09/06 20:54:21 ET
Table 'Pegasus' 6-max Seat #2 is the button
Seat 1: Zeos179 ($3.81 in chips)
Seat 2: doc112ocean ($1.37 in chips)
Seat 4: PlayTheBlues4U ($3.18 in chips)
Seat 5: tsov252525 ($2.30 in chips)
PlayTheBlues4U: posts small blind $0.01
tsov252525: posts big blind $0.02
*** HOLE CARDS ***
Dealt to PlayTheBlues4U [8s 5d]
Zeos179: folds
doc112ocean: calls $0.02
PlayTheBlues4U: folds
tsov252525: checks
*** FLOP *** [3c 7c Tc]
tsov252525: checks
doc112ocean: checks
*** TURN *** [3c 7c Tc] [2h]
tsov252525: bets $0.03
doc112ocean: calls $0.03
*** RIVER *** [3c 7c Tc 2h] [4s]
tsov252525: bets $0.06
doc112ocean: folds
Uncalled bet ($0.06) returned to tsov252525
tsov252525 collected $0.11 from pot
tsov252525: doesn't show hand
*** SUMMARY ***
Total pot $0.11 | Rake $0
Board [3c 7c Tc 2h 4s]
Seat 1: Zeos179 folded before Flop (didn't bet)
Seat 2: doc112ocean (button) folded on the River
Seat 4: PlayTheBlues4U (small blind) folded before Flop
Seat 5: tsov252525 (big blind) collected ($0.11)


PokerStars Hand #203470699685:  Hold'em No Limit ($0.02/$0.05 USD) - 2019/09/06 20:54:18 ET
Table 'Icarus' 6-max Seat #3 is the button
Seat 1: Yockit ($6.59 in chips)
Seat 2: PlayTheBlues4U ($5.90 in chips)
Seat 3: 47xx47 ($3 in chips)
Seat 4: richy5742 ($5.78 in chips)
Seat 5: DeccaDan ($12.10 in chips)
Seat 6: DemolishIT ($5.35 in chips)
richy5742: posts small blind $0.02
DeccaDan: posts big blind $0.05
*** HOLE CARDS ***
Dealt to PlayTheBlues4U [5s 2d]
DemolishIT: folds
Yockit: calls $0.05
PlayTheBlues4U: folds
47xx47: calls $0.05
richy5742: calls $0.03
DeccaDan: checks
*** FLOP *** [9d 8c 6h]
richy5742: checks
DeccaDan: bets $0.10
Yockit: folds
47xx47: folds
richy5742: calls $0.10
*** TURN *** [9d 8c 6h] [Ad]
richy5742: checks
DeccaDan: checks
*** RIVER *** [9d 8c 6h Ad] [Js]
richy5742: bets $0.10
DeccaDan: raises $0.10 to $0.20
richy5742: calls $0.10
*** SHOW DOWN ***
DeccaDan: shows [Jh 8s] (two pair, Jacks and Eights)
richy5742: mucks hand
DeccaDan collected $0.76 from pot
*** SUMMARY ***
Total pot $0.80 | Rake $0.04
Board [9d 8c 6h Ad Js]
Seat 1: Yockit folded on the Flop
Seat 2: PlayTheBlues4U folded before Flop (didn't bet)
Seat 3: 47xx47 (button) folded on the Flop
Seat 4: richy5742 (small blind) mucked [6c Kc]
Seat 5: DeccaDan (big blind) showed [Jh 8s] and won ($0.76) with two pair, Jacks and Eights
Seat 6: DemolishIT folded before Flop (didn't bet)


PokerStars Hand #203470699580:  Hold'em No Limit ($0.01/$0.02 USD) - 2019/09/06 20:53:47 ET
Table 'Pegasus' 6-max Seat #1 is the button
Seat 1: Zeos179 ($3.81 in chips)
Seat 2: doc112ocean ($1.28 in chips)
Seat 4: PlayTheBlues4U ($3.28 in chips)
Seat 5: tsov252525 ($2.30 in chips)
doc112ocean: posts small blind $0.01
PlayTheBlues4U: posts big blind $0.02
*** HOLE CARDS ***
Dealt to PlayTheBlues4U [8c Jh]
tsov252525: folds
Zeos179: folds
doc112ocean: calls $0.01
PlayTheBlues4U: checks
*** FLOP *** [Kc 3d 4s]
doc112ocean: checks
PlayTheBlues4U: bets $0.02
doc112ocean: calls $0.02
*** TURN *** [Kc 3d 4s] [Ah]
doc112ocean: checks
PlayTheBlues4U: checks
*** RIVER *** [Kc 3d 4s Ah] [6d]
doc112ocean: checks
PlayTheBlues4U: bets $0.06
doc112ocean: calls $0.06
*** SHOW DOWN ***
PlayTheBlues4U: shows [8c Jh] (high card Ace)
doc112ocean: shows [4d 5d] (a pair of Fours)
doc112ocean collected $0.19 from pot
*** SUMMARY ***
Total pot $0.20 | Rake $0.01
Board [Kc 3d 4s Ah 6d]
Seat 1: Zeos179 (button) folded before Flop (didn't bet)
Seat 2: doc112ocean (small blind) showed [4d 5d] and won ($0.19) with a pair of Fours
Seat 4: PlayTheBlues4U (big blind) showed [8c Jh] and lost with high card Ace
Seat 5: tsov252525 folded before Flop (didn't bet)


PokerStars Hand #203470699483:  Hold'em No Limit ($0.02/$0.05 USD) - 2019/09/06 20:53:17 ET
Table 'Icarus' 6-max Seat #2 is the button
Seat 1: Yockit ($6.45 in chips)
Seat 2: PlayTheBlues4U ($5.90 in chips)
Seat 3: 47xx47 ($3.05 in chips)
Seat 4: richy5742 ($5.83 in chips)
Seat 5: DeccaDan ($12.15 in chips)
Seat 6: DemolishIT ($5.35 in chips)
47xx47: posts small blind $0.02
richy5742: posts big blind $0.05
*** HOLE CARDS ***
Dealt to PlayTheBlues4U [2c 9c]
DeccaDan: calls $0.05
DemolishIT: folds
Yockit: calls $0.05
PlayTheBlues4U: folds
47xx47: calls $0.03
richy5742: checks
*** FLOP *** [6s 8s Qc]
47xx47: checks
richy5742: checks
DeccaDan: checks
Yockit: checks
*** TURN *** [6s 8s Qc] [Tc]
47xx47: checks
richy5742: checks
DeccaDan: checks
Yockit: bets $0.15
47xx47: folds
richy5742: folds
DeccaDan: folds
Uncalled bet ($0.15) returned to Yockit
Yockit collected $0.19 from pot
Yockit: doesn't show hand
*** SUMMARY ***
Total pot $0.20 | Rake $0.01
Board [6s 8s Qc Tc]
Seat 1: Yockit collected ($0.19)
Seat 2: PlayTheBlues4U (button) folded before Flop (didn't bet)
Seat 3: 47xx47 (small blind) folded on the Turn
Seat 4: richy5742 (big blind) folded on the Turn
Seat 5: DeccaDan folded on the Turn
Seat 6: DemolishIT folded before Flop (didn't bet)


PokerStars Hand #203470699407:  Hold'em No Limit ($0.01/$0.02 USD) - 2019/09/06 20:52:52 ET
Table 'Pegasus' 6-max Seat #5 is the button
Seat 1: Zeos179 ($3.46 in chips)
Seat 2: doc112ocean ($1.54 in chips)
Seat 4: PlayTheBlues4U ($3.34 in chips)
Seat 5: tsov252525 ($2.36 in chips)
Zeos179: posts small blind $0.01
doc112ocean: posts big blind $0.02
*** HOLE CARDS ***
Dealt to PlayTheBlues4U [Ad 6c]
PlayTheBlues4U: raises $0.04 to $0.06
tsov252525: calls $0.06
Zeos179: calls $0.05
doc112ocean: calls $0.04
*** FLOP *** [9s 4s Qd]
Zeos179: checks
doc112ocean: bets $0.10
PlayTheBlues4U: folds
tsov252525: folds
Zeos179: calls $0.10
*** TURN *** [9s 4s Qd] [7s]
Zeos179: checks
doc112ocean: bets $0.10
Zeos179: calls $0.10
*** RIVER *** [9s 4s Qd 7s] [Js]
Zeos179: checks
doc112ocean: checks
*** SHOW DOWN ***
Zeos179: shows [Ts Jc] (a flush, Jack high)
doc112ocean: mucks hand
Zeos179 collected $0.61 from pot
*** SUMMARY ***
Total pot $0.64 | Rake $0.03
Board [9s 4s Qd 7s Js]
Seat 1: Zeos179 (small blind) showed [Ts Jc] and won ($0.61) with a flush, Jack high
Seat 2: doc112ocean (big blind) mucked [Qh Td]
Seat 4: PlayTheBlues4U folded on the Flop
Seat 5: tsov252525 (button) folded on the Flop


PokerStars Hand #203470699358:  Hold'em No Limit ($0.02/$0.05 USD) - 2019/09/06 20:52:36 ET
Table 'Icarus' 6-max Seat #1 is the button
Seat 1: Yockit ($6.34 in chips)
Seat 2: PlayTheBlues4U ($5.92 in chips)
Seat 3: 47xx47 ($3.10 in chips)
Seat 4: richy5742 ($5.83 in chips)
Seat 5: DeccaDan ($12.20 in chips)
Seat 6: DemolishIT ($5.35 in chips)
PlayTheBlues4U: posts small blind $0.02
47xx47: posts big blind $0.05
*** HOLE CARDS ***
Dealt to PlayTheBlues4U [Qd 3h]
richy5742: folds
DeccaDan: calls $0.05
DemolishIT: folds
Yockit: calls $0.05
PlayTheBlues4U: folds
47xx47: checks
*** FLOP *** [3s Kc Ah]
47xx47: checks
DeccaDan: checks
Yockit: bets $0.10
47xx47: folds
DeccaDan: folds
Uncalled bet ($0.10) returned to Yockit
Yockit collected $0.16 from pot
Yockit: doesn't show hand
*** SUMMARY ***
Total pot $0.17 | Rake $0.01
Board [3s Kc Ah]
Seat 1: Yockit (button) collected ($0.16)
Seat 2: PlayTheBlues4U (small blind) folded before Flop
Seat 3: 47xx47 (big blind) folded on the Flop
Seat 4: richy5742 folded before Flop (didn't bet)
Seat 5: DeccaDan folded on the Flop
Seat 6: DemolishIT folded before Flop (didn't bet)


PokerStars Hand #203470699285:  Hold'em No Limit ($0.01/$0.02 USD) - 2019/09/06 20:52:16 ET
Table 'Pegasus' 6-max Seat #4 is the button
Seat 1: Zeos179 ($3.50 in chips)
Seat 2: doc112ocean ($1.49 in chips)
Seat 4: PlayTheBlues4U ($3.34 in chips)
Seat 5: tsov252525 ($2.37 in chips)
tsov252525: posts small blind $0.01
Zeos179: posts big blind $0.02
*** HOLE CARDS ***
Dealt to PlayTheBlues4U [Qd 6d]
doc112ocean: calls $0.02
PlayTheBlues4U: folds
tsov252525: folds
Zeos179: checks
*** FLOP *** [2h 5h 9d]
Zeos179: bets $0.02
doc112ocean: calls $0.02
*** TURN *** [2h 5h 9d] [Jh]
Zeos179: checks
doc112ocean: bets $0.10
Zeos179: folds
Uncalled bet ($0.10) returned to doc112ocean
doc112ocean collected $0.09 from pot
*** SUMMARY ***
Total pot $0.09 | Rake $0
Board [2h 5h 9d Jh]
Seat 1: Zeos179 (big blind) folded on the Turn
Seat 2: doc112ocean collected ($0.09)
Seat 4: PlayTheBlues4U (button) folded before Flop (didn't bet)
Seat 5: tsov252525 (small blind) folded before Flop


PokerStars Hand #203470699222:  Hold'em No Limit ($0.01/$0.02 USD) - 2019/09/06 20:51:59 ET
Table 'Pegasus' 6-max Seat #2 is the button
Seat 1: Zeos179 ($3.50 in chips)
Seat 2: doc112ocean ($1.49 in chips)
Seat 4: PlayTheBlues4U ($3.35 in chips)
Seat 5: tsov252525 ($2.36 in chips)
PlayTheBlues4U: posts small blind $0.01
tsov252525: posts big blind $0.02
*** HOLE CARDS ***
Dealt to PlayTheBlues4U [5h 3s]
Zeos179: folds
doc112ocean: folds
PlayTheBlues4U: folds
Uncalled bet ($0.01) returned to tsov252525
tsov252525 collected $0.02 from pot
tsov252525: doesn't show hand
*** SUMMARY ***
Total pot $0.02 | Rake $0
Seat 1: Zeos179 folded before Flop (didn't bet)
Seat 2: doc112ocean (button) folded before Flop (didn't bet)
Seat 4: PlayTheBlues4U (small blind) folded before Flop
Seat 5: tsov252525 (big blind) collected ($0.02)


PokerStars Hand #203470699189:  Hold'em No Limit ($0.02/$0.05 USD) - 2019/09/06 20:51:49 ET
Table 'Icarus' 6-max Seat #6 is the button
Seat 1: Yockit ($6.36 in chips)
Seat 2: PlayTheBlues4U ($5.97 in chips)
Seat 3: 47xx47 ($3.10 in chips)
Seat 4: richy5742 ($5.83 in chips)
Seat 5: DeccaDan ($12.55 in chips)
Seat 6: DemolishIT ($4.97 in chips)
Yockit: posts small blind $0.02
PlayTheBlues4U: posts big blind $0.05
*** HOLE CARDS ***
Dealt to PlayTheBlues4U [Qs 3h]
47xx47: folds
richy5742: folds
DeccaDan: calls $0.05
DemolishIT: raises $0.30 to $0.35
Yockit: folds
PlayTheBlues4U: folds
DeccaDan: calls $0.30
*** FLOP *** [2c Qd 8d]
DeccaDan: checks
DemolishIT: checks
*** TURN *** [2c Qd 8d] [3s]
DeccaDan: checks
DemolishIT: checks
*** RIVER *** [2c Qd 8d 3s] [Jc]
DeccaDan: checks
DemolishIT: checks
*** SHOW DOWN ***
DeccaDan: shows [4s 5s] (high card Queen)
DemolishIT: shows [Ad Td] (high card Ace)
DemolishIT collected $0.73 from pot
*** SUMMARY ***
Total pot $0.77 | Rake $0.04
Board [2c Qd 8d 3s Jc]
Seat 1: Yockit (small blind) folded before Flop
Seat 2: PlayTheBlues4U (big blind) folded before Flop
Seat 3: 47xx47 folded before Flop (didn't bet)
Seat 4: richy5742 folded before Flop (didn't bet)
Seat 5: DeccaDan showed [4s 5s] and lost with high card Queen
Seat 6: DemolishIT (button) showed [Ad Td] and won ($0.73) with high card Ace


PokerStars Hand #203470699088:  Hold'em No Limit ($0.02/$0.05 USD) - 2019/09/06 20:51:21 ET
Table 'Icarus' 6-max Seat #5 is the button
Seat 1: Yockit ($6.34 in chips)
Seat 2: PlayTheBlues4U ($5.97 in chips)
Seat 3: 47xx47 ($3.10 in chips)
Seat 4: richy5742 ($5.83 in chips)
Seat 5: DeccaDan ($12.55 in chips)
Seat 6: DemolishIT ($4.99 in chips)
DemolishIT: posts small blind $0.02
Yockit: posts big blind $0.05
*** HOLE CARDS ***
Dealt to PlayTheBlues4U [Tc 4s]
PlayTheBlues4U: folds
47xx47: folds
richy5742: folds
DeccaDan: folds
DemolishIT: folds
Uncalled bet ($0.03) returned to Yockit
Yockit collected $0.04 from pot
*** SUMMARY ***
Total pot $0.04 | Rake $0
Seat 1: Yockit (big blind) collected ($0.04)
Seat 2: PlayTheBlues4U folded before Flop (didn't bet)
Seat 3: 47xx47 folded before Flop (didn't bet)
Seat 4: richy5742 folded before Flop (didn't bet)
Seat 5: DeccaDan (button) folded before Flop (didn't bet)
Seat 6: DemolishIT (small blind) folded before Flop


PokerStars Hand #203470699063:  Hold'em No Limit ($0.01/$0.02 USD) - 2019/09/06 20:51:13 ET
Table 'Pegasus' 6-max Seat #1 is the button
Seat 1: Zeos179 ($3.81 in chips)
Seat 2: doc112ocean ($1.50 in chips)
Seat 4: PlayTheBlues4U ($3.37 in chips)
Seat 5: tsov252525 ($2.05 in chips)
doc112ocean: posts small blind $0.01
MAAE88: is sitting out
PlayTheBlues4U: posts big blind $0.02
*** HOLE CARDS ***
Dealt to PlayTheBlues4U [4d 3s]
MAAE88 leaves the table
tsov252525: raises $0.04 to $0.06
Zeos179: calls $0.06
doc112ocean: folds
PlayTheBlues4U: folds
*** FLOP *** [Js Jd 3h]
tsov252525: checks
Zeos179: checks
*** TURN *** [Js Jd 3h] [Kh]
tsov252525: bets $0.07
Zeos179: calls $0.07
*** RIVER *** [Js Jd 3h Kh] [Jh]
tsov252525: bets $0.18
Zeos179: calls $0.18
*** SHOW DOWN ***
tsov252525: shows [Jc Tc] (four of a kind, Jacks)
Zeos179: mucks hand
tsov252525 collected $0.62 from pot
*** SUMMARY ***
Total pot $0.65 | Rake $0.03
Board [Js Jd 3h Kh Jh]
Seat 1: Zeos179 (button) mucked [Ac 4h]
Seat 2: doc112ocean (small blind) folded before Flop
Seat 4: PlayTheBlues4U (big blind) folded before Flop
Seat 5: tsov252525 showed [Jc Tc] and won ($0.62) with four of a kind, Jacks


PokerStars Hand #203470698918:  Hold'em No Limit ($0.02/$0.05 USD) - 2019/09/06 20:50:32 ET
Table 'Icarus' 6-max Seat #4 is the button
Seat 1: Yockit ($6.34 in chips)
Seat 2: PlayTheBlues4U ($5.97 in chips)
Seat 3: 47xx47 ($3.10 in chips)
Seat 4: richy5742 ($5.93 in chips)
Seat 5: DeccaDan ($12.70 in chips)
Seat 6: DemolishIT ($4.76 in chips)
DeccaDan: posts small blind $0.02
DemolishIT: posts big blind $0.05
*** HOLE CARDS ***
Dealt to PlayTheBlues4U [2c Jd]
Yockit: folds
PlayTheBlues4U: folds
47xx47: folds
richy5742: raises $0.05 to $0.10
DeccaDan: calls $0.08
DemolishIT: calls $0.05
*** FLOP *** [As 9d Td]
DeccaDan: checks
DemolishIT: checks
richy5742: checks
*** TURN *** [As 9d Td] [6h]
DeccaDan: bets $0.05
DemolishIT: raises $0.25 to $0.30
richy5742: folds
DeccaDan: folds
Uncalled bet ($0.25) returned to DemolishIT
DemolishIT collected $0.38 from pot
DemolishIT: doesn't show hand
*** SUMMARY ***
Total pot $0.40 | Rake $0.02
Board [As 9d Td 6h]
Seat 1: Yockit folded before Flop (didn't bet)
Seat 2: PlayTheBlues4U folded before Flop (didn't bet)
Seat 3: 47xx47 folded before Flop (didn't bet)
Seat 4: richy5742 (button) folded on the Turn
Seat 5: DeccaDan (small blind) folded on the Turn
Seat 6: DemolishIT (big blind) collected ($0.38)


PokerStars Hand #203470698879:  Hold'em No Limit ($0.01/$0.02 USD) - 2019/09/06 20:50:19 ET
Table 'Pegasus' 6-max Seat #5 is the button
Seat 1: Zeos179 ($3.82 in chips)
Seat 2: doc112ocean ($1.52 in chips)
Seat 3: MAAE88 ($4.14 in chips)
Seat 4: PlayTheBlues4U ($3.43 in chips)
Seat 5: tsov252525 ($1.97 in chips)
Zeos179: posts small blind $0.01
doc112ocean: posts big blind $0.02
*** HOLE CARDS ***
Dealt to PlayTheBlues4U [Kd Jh]
MAAE88: folds
PlayTheBlues4U: raises $0.04 to $0.06
tsov252525: calls $0.06
Zeos179: folds
doc112ocean: folds
*** FLOP *** [9c 8h 6s]
PlayTheBlues4U: checks
tsov252525: bets $0.08
PlayTheBlues4U: folds
Uncalled bet ($0.08) returned to tsov252525
tsov252525 collected $0.14 from pot
tsov252525: doesn't show hand
*** SUMMARY ***
Total pot $0.15 | Rake $0.01
Board [9c 8h 6s]
Seat 1: Zeos179 (small blind) folded before Flop
Seat 2: doc112ocean (big blind) folded before Flop
Seat 3: MAAE88 folded before Flop (didn't bet)
Seat 4: PlayTheBlues4U folded on the Flop
Seat 5: tsov252525 (button) collected ($0.14)


PokerStars Hand #203470698700:  Hold'em No Limit ($0.02/$0.05 USD) - 2019/09/06 20:49:28 ET
Table 'Icarus' 6-max Seat #3 is the button
Seat 1: Yockit ($6.34 in chips)
Seat 2: PlayTheBlues4U ($5.97 in chips)
Seat 3: 47xx47 ($4 in chips)
Seat 4: richy5742 ($5.95 in chips)
Seat 5: DeccaDan ($12.75 in chips)
Seat 6: DemolishIT ($3.88 in chips)
richy5742: posts small blind $0.02
DeccaDan: posts big blind $0.05
*** HOLE CARDS ***
Dealt to PlayTheBlues4U [Jd 4s]
DemolishIT: raises $0.20 to $0.25
Yockit: folds
PlayTheBlues4U: folds
47xx47: calls $0.25
richy5742: folds
DeccaDan: folds
*** FLOP *** [8h 9s 2h]
DemolishIT: checks
47xx47: checks
*** TURN *** [8h 9s 2h] [Qc]
DemolishIT: bets $0.65
47xx47: calls $0.65
*** RIVER *** [8h 9s 2h Qc] [Ad]
DemolishIT: bets $1.95
47xx47: folds
Uncalled bet ($1.95) returned to DemolishIT
DemolishIT collected $1.78 from pot
*** SUMMARY ***
Total pot $1.87 | Rake $0.09
Board [8h 9s 2h Qc Ad]
Seat 1: Yockit folded before Flop (didn't bet)
Seat 2: PlayTheBlues4U folded before Flop (didn't bet)
Seat 3: 47xx47 (button) folded on the River
Seat 4: richy5742 (small blind) folded before Flop
Seat 5: DeccaDan (big blind) folded before Flop
Seat 6: DemolishIT collected ($1.78)


PokerStars Hand #203470698566:  Hold'em No Limit ($0.01/$0.02 USD) - 2019/09/06 20:48:45 ET
Table 'Pegasus' 6-max Seat #4 is the button
Seat 1: Zeos179 ($4.58 in chips)
Seat 2: doc112ocean ($1.60 in chips)
Seat 3: MAAE88 ($4.14 in chips)
Seat 4: PlayTheBlues4U ($2.65 in chips)
Seat 5: tsov252525 ($1.98 in chips)
tsov252525: posts small blind $0.01
Zeos179: posts big blind $0.02
doc112ocean: posts big blind $0.02
*** HOLE CARDS ***
Dealt to PlayTheBlues4U [Kc Kd]
doc112ocean: checks
MAAE88: folds
PlayTheBlues4U: raises $0.06 to $0.08
tsov252525: folds
Zeos179: calls $0.06
doc112ocean: calls $0.06
*** FLOP *** [4c 6c 7d]
Zeos179: checks
doc112ocean: checks
PlayTheBlues4U: bets $0.22
Zeos179: calls $0.22
doc112ocean: folds
*** TURN *** [4c 6c 7d] [9d]
Zeos179: checks
PlayTheBlues4U: bets $0.46
Zeos179: calls $0.46
*** RIVER *** [4c 6c 7d 9d] [Qs]
Zeos179: checks
PlayTheBlues4U: bets $1
Zeos179: folds
Uncalled bet ($1) returned to PlayTheBlues4U
PlayTheBlues4U collected $1.54 from pot
PlayTheBlues4U: doesn't show hand
*** SUMMARY ***
Total pot $1.61 | Rake $0.07
Board [4c 6c 7d 9d Qs]
Seat 1: Zeos179 (big blind) folded on the River
Seat 2: doc112ocean folded on the Flop
Seat 3: MAAE88 folded before Flop (didn't bet)
Seat 4: PlayTheBlues4U (button) collected ($1.54)
Seat 5: tsov252525 (small blind) folded before Flop


PokerStars Hand #203470698552:  Hold'em No Limit ($0.02/$0.05 USD) - 2019/09/06 20:48:40 ET
Table 'Icarus' 6-max Seat #2 is the button
Seat 1: Yockit ($6.34 in chips)
Seat 2: PlayTheBlues4U ($5.58 in chips)
Seat 3: 47xx47 ($4.02 in chips)
Seat 4: richy5742 ($6.15 in chips)
Seat 5: DeccaDan ($12.75 in chips)
Seat 6: DemolishIT ($4.08 in chips)
47xx47: posts small blind $0.02
richy5742: posts big blind $0.05
*** HOLE CARDS ***
Dealt to PlayTheBlues4U [Qc As]
DeccaDan: folds
DemolishIT: calls $0.05
Yockit: folds
PlayTheBlues4U: raises $0.15 to $0.20
47xx47: folds
richy5742: calls $0.15
DemolishIT: calls $0.15
*** FLOP *** [7d Ad 5d]
richy5742: checks
DemolishIT: checks
PlayTheBlues4U: bets $0.45
richy5742: folds
DemolishIT: folds
Uncalled bet ($0.45) returned to PlayTheBlues4U
PlayTheBlues4U collected $0.59 from pot
PlayTheBlues4U: doesn't show hand
*** SUMMARY ***
Total pot $0.62 | Rake $0.03
Board [7d Ad 5d]
Seat 1: Yockit folded before Flop (didn't bet)
Seat 2: PlayTheBlues4U (button) collected ($0.59)
Seat 3: 47xx47 (small blind) folded before Flop
Seat 4: richy5742 (big blind) folded on the Flop
Seat 5: DeccaDan folded before Flop (didn't bet)
Seat 6: DemolishIT folded on the Flop


PokerStars Hand #203470698427:  Hold'em No Limit ($0.01/$0.02 USD) - 2019/09/06 20:48:04 ET
Table 'Pegasus' 6-max Seat #3 is the button
Seat 1: Zeos179 ($4.58 in chips)
Seat 3: MAAE88 ($4.14 in chips)
Seat 4: PlayTheBlues4U ($2.63 in chips)
Seat 5: tsov252525 ($2 in chips)
PlayTheBlues4U: posts small blind $0.01
tsov252525: posts big blind $0.02
*** HOLE CARDS ***
Dealt to PlayTheBlues4U [Qs Tc]
Zeos179: folds
MAAE88: folds
PlayTheBlues4U: calls $0.01
tsov252525: checks
*** FLOP *** [6c 3c 9d]
PlayTheBlues4U: checks
tsov252525: checks
*** TURN *** [6c 3c 9d] [2c]
PlayTheBlues4U: checks
doc112ocean joins the table at seat #2
tsov252525: checks
*** RIVER *** [6c 3c 9d 2c] [Td]
PlayTheBlues4U: bets $0.04
tsov252525: folds
Uncalled bet ($0.04) returned to PlayTheBlues4U
PlayTheBlues4U collected $0.04 from pot
PlayTheBlues4U: doesn't show hand
*** SUMMARY ***
Total pot $0.04 | Rake $0
Board [6c 3c 9d 2c Td]
Seat 1: Zeos179 folded before Flop (didn't bet)
Seat 3: MAAE88 (button) folded before Flop (didn't bet)
Seat 4: PlayTheBlues4U (small blind) collected ($0.04)
Seat 5: tsov252525 (big blind) folded on the River


PokerStars Hand #203470698322:  Hold'em No Limit ($0.01/$0.02 USD) - 2019/09/06 20:47:35 ET
Table 'Pegasus' 6-max Seat #1 is the button
Seat 1: Zeos179 ($4.66 in chips)
Seat 3: MAAE88 ($3.99 in chips)
Seat 4: PlayTheBlues4U ($2.71 in chips)
MAAE88: posts small blind $0.01
PlayTheBlues4U: posts big blind $0.02
tsov252525: sits out
*** HOLE CARDS ***
Dealt to PlayTheBlues4U [Jd Ah]
Zeos179: calls $0.02
MAAE88: raises $0.06 to $0.08
PlayTheBlues4U: calls $0.06
Zeos179: calls $0.06
*** FLOP *** [5h 4h 8s]
MAAE88: bets $0.17
PlayTheBlues4U: folds
Zeos179: folds
Uncalled bet ($0.17) returned to MAAE88
MAAE88 collected $0.23 from pot
MAAE88: doesn't show hand
*** SUMMARY ***
Total pot $0.24 | Rake $0.01
Board [5h 4h 8s]
Seat 1: Zeos179 (button) folded on the Flop
Seat 3: MAAE88 (small blind) collected ($0.23)
Seat 4: PlayTheBlues4U (big blind) folded on the Flop


PokerStars Hand #203470698306:  Hold'em No Limit ($0.02/$0.05 USD) - 2019/09/06 20:47:32 ET
Table 'Icarus' 6-max Seat #1 is the button
Seat 1: Yockit ($6.49 in chips)
Seat 2: PlayTheBlues4U ($5.60 in chips)
Seat 3: 47xx47 ($3.87 in chips)
Seat 4: richy5742 ($6.15 in chips)
Seat 5: DeccaDan ($12.75 in chips)
Seat 6: DemolishIT ($4.08 in chips)
PlayTheBlues4U: posts small blind $0.02
47xx47: posts big blind $0.05
*** HOLE CARDS ***
Dealt to PlayTheBlues4U [5d 4c]
richy5742 is disconnected
richy5742 has timed out
richy5742: folds
DeccaDan: folds
DemolishIT: folds
Yockit: calls $0.05
PlayTheBlues4U: folds
47xx47: checks
*** FLOP *** [2s Ts Qs]
47xx47: bets $0.10
Yockit: calls $0.10
*** TURN *** [2s Ts Qs] [3s]
47xx47: checks
Yockit: checks
*** RIVER *** [2s Ts Qs 3s] [4d]
47xx47: bets $0.10
Yockit: folds
Uncalled bet ($0.10) returned to 47xx47
47xx47 collected $0.30 from pot
47xx47: doesn't show hand
*** SUMMARY ***
Total pot $0.32 | Rake $0.02
Board [2s Ts Qs 3s 4d]
Seat 1: Yockit (button) folded on the River
Seat 2: PlayTheBlues4U (small blind) folded before Flop
Seat 3: 47xx47 (big blind) collected ($0.30)
Seat 4: richy5742 folded before Flop (didn't bet)
Seat 5: DeccaDan folded before Flop (didn't bet)
Seat 6: DemolishIT folded before Flop (didn't bet)


PokerStars Hand #203470698188:  Hold'em No Limit ($0.02/$0.05 USD) - 2019/09/06 20:46:59 ET
Table 'Icarus' 6-max Seat #6 is the button
Seat 1: Yockit ($6.51 in chips)
Seat 2: PlayTheBlues4U ($5.65 in chips)
Seat 3: 47xx47 ($3.81 in chips)
Seat 4: richy5742 ($6.15 in chips)
Seat 5: DeccaDan ($12.75 in chips)
Seat 6: DemolishIT ($4.08 in chips)
Yockit: posts small blind $0.02
PlayTheBlues4U: posts big blind $0.05
*** HOLE CARDS ***
Dealt to PlayTheBlues4U [6c Jh]
47xx47: calls $0.05
richy5742: folds
DeccaDan: folds
DemolishIT: folds
Yockit: folds
PlayTheBlues4U: checks
*** FLOP *** [9d 7d 3h]
PlayTheBlues4U: checks
47xx47: bets $0.10
PlayTheBlues4U: folds
Uncalled bet ($0.10) returned to 47xx47
47xx47 collected $0.11 from pot
47xx47: doesn't show hand
*** SUMMARY ***
Total pot $0.12 | Rake $0.01
Board [9d 7d 3h]
Seat 1: Yockit (small blind) folded before Flop
Seat 2: PlayTheBlues4U (big blind) folded on the Flop
Seat 3: 47xx47 collected ($0.11)
Seat 4: richy5742 folded before Flop (didn't bet)
Seat 5: DeccaDan folded before Flop (didn't bet)
Seat 6: DemolishIT (button) folded before Flop (didn't bet)


PokerStars Hand #203470698166:  Hold'em No Limit ($0.01/$0.02 USD) - 2019/09/06 20:46:52 ET
Table 'Pegasus' 6-max Seat #4 is the button
Seat 1: Zeos179 ($4.67 in chips)
Seat 3: MAAE88 ($3.76 in chips)
Seat 4: PlayTheBlues4U ($2.95 in chips)
Zeos179: posts small blind $0.01
MAAE88: posts big blind $0.02
*** HOLE CARDS ***
Dealt to PlayTheBlues4U [8h 6s]
PlayTheBlues4U: raises $0.04 to $0.06
Zeos179: folds
MAAE88: calls $0.04
*** FLOP *** [Ac 4c 8d]
MAAE88: checks
PlayTheBlues4U: bets $0.06
MAAE88: calls $0.06
*** TURN *** [Ac 4c 8d] [9d]
MAAE88: bets $0.12
tsov252525 joins the table at seat #5
PlayTheBlues4U: calls $0.12
*** RIVER *** [Ac 4c 8d 9d] [9s]
MAAE88: checks
PlayTheBlues4U: checks
*** SHOW DOWN ***
MAAE88: shows [Jc Ad] (two pair, Aces and Nines)
PlayTheBlues4U: mucks hand
MAAE88 collected $0.47 from pot
*** SUMMARY ***
Total pot $0.49 | Rake $0.02
Board [Ac 4c 8d 9d 9s]
Seat 1: Zeos179 (small blind) folded before Flop
Seat 3: MAAE88 (big blind) showed [Jc Ad] and won ($0.47) with two pair, Aces and Nines
Seat 4: PlayTheBlues4U (button) mucked [8h 6s]


PokerStars Hand #203470698140:  Hold'em No Limit ($0.01/$0.02 USD) - 2019/09/06 20:46:46 ET
Table 'Pegasus' 6-max Seat #3 is the button
Seat 1: Zeos179 ($4.66 in chips)
Seat 3: MAAE88 ($3.76 in chips)
Seat 4: PlayTheBlues4U ($2.96 in chips)
PlayTheBlues4U: posts small blind $0.01
Zeos179: posts big blind $0.02
*** HOLE CARDS ***
Dealt to PlayTheBlues4U [Kc 9s]
AAJMU leaves the table
MAAE88: folds
PlayTheBlues4U: folds
Uncalled bet ($0.01) returned to Zeos179
Zeos179 collected $0.02 from pot
Zeos179: doesn't show hand
*** SUMMARY ***
Total pot $0.02 | Rake $0
Seat 1: Zeos179 (big blind) collected ($0.02)
Seat 3: MAAE88 (button) folded before Flop (didn't bet)
Seat 4: PlayTheBlues4U (small blind) folded before Flop


PokerStars Hand #203470698029:  Hold'em No Limit ($0.01/$0.02 USD) - 2019/09/06 20:46:09 ET
Table 'Pegasus' 6-max Seat #2 is the button
Seat 1: Zeos179 ($4.54 in chips)
Seat 2: AAJMU ($2.61 in chips)
Seat 3: MAAE88 ($3.77 in chips)
Seat 4: PlayTheBlues4U ($3.02 in chips)
MAAE88: posts small blind $0.01
PlayTheBlues4U: posts big blind $0.02
*** HOLE CARDS ***
Dealt to PlayTheBlues4U [5s 5h]
Zeos179: calls $0.02
AAJMU: calls $0.02
MAAE88: folds
PlayTheBlues4U: checks
*** FLOP *** [8s 3c 6h]
PlayTheBlues4U: checks
Zeos179: checks
AAJMU: checks
*** TURN *** [8s 3c 6h] [8d]
PlayTheBlues4U: bets $0.04
Zeos179: calls $0.04
AAJMU: calls $0.04
*** RIVER *** [8s 3c 6h 8d] [3h]
PlayTheBlues4U: checks
Zeos179: bets $0.18
AAJMU: folds
PlayTheBlues4U: folds
Uncalled bet ($0.18) returned to Zeos179
Zeos179 collected $0.18 from pot
Zeos179: doesn't show hand
*** SUMMARY ***
Total pot $0.19 | Rake $0.01
Board [8s 3c 6h 8d 3h]
Seat 1: Zeos179 collected ($0.18)
Seat 2: AAJMU (button) folded on the River
Seat 3: MAAE88 (small blind) folded before Flop
Seat 4: PlayTheBlues4U (big blind) folded on the River


PokerStars Hand #203470697988:  Hold'em No Limit ($0.01/$0.02 USD) - 2019/09/06 20:45:58 ET
Table 'Pegasus' 6-max Seat #1 is the button
Seat 1: Zeos179 ($4.54 in chips)
Seat 2: AAJMU ($2.62 in chips)
Seat 3: MAAE88 ($3.76 in chips)
Seat 4: PlayTheBlues4U ($3.02 in chips)
AAJMU: posts small blind $0.01
MAAE88: posts big blind $0.02
*** HOLE CARDS ***
Dealt to PlayTheBlues4U [Kc 4d]
PlayTheBlues4U: folds
Zeos179: folds
AAJMU: folds
Uncalled bet ($0.01) returned to MAAE88
MAAE88 collected $0.02 from pot
MAAE88: doesn't show hand
*** SUMMARY ***
Total pot $0.02 | Rake $0
Seat 1: Zeos179 (button) folded before Flop (didn't bet)
Seat 2: AAJMU (small blind) folded before Flop
Seat 3: MAAE88 (big blind) collected ($0.02)
Seat 4: PlayTheBlues4U folded before Flop (didn't bet)


PokerStars Hand #203470697943:  Hold'em No Limit ($0.01/$0.02 USD) - 2019/09/06 20:45:44 ET
Table 'Pegasus' 6-max Seat #4 is the button
Seat 1: Zeos179 ($4.52 in chips)
Seat 2: AAJMU ($2.64 in chips)
Seat 3: MAAE88 ($3.76 in chips)
Seat 4: PlayTheBlues4U ($3.02 in chips)
Zeos179: posts small blind $0.01
AAJMU: posts big blind $0.02
*** HOLE CARDS ***
Dealt to PlayTheBlues4U [3c 5h]
MAAE88: folds
PlayTheBlues4U: folds
Zeos179: calls $0.01
AAJMU: checks
*** FLOP *** [6h 5c 8d]
Zeos179: bets $0.04
AAJMU: folds
Uncalled bet ($0.04) returned to Zeos179
Zeos179 collected $0.04 from pot
Zeos179: doesn't show hand
*** SUMMARY ***
Total pot $0.04 | Rake $0
Board [6h 5c 8d]
Seat 1: Zeos179 (small blind) collected ($0.04)
Seat 2: AAJMU (big blind) folded on the Flop
Seat 3: MAAE88 folded before Flop (didn't bet)
Seat 4: PlayTheBlues4U (button) folded before Flop (didn't bet)


PokerStars Hand #203470697902:  Hold'em No Limit ($0.02/$0.05 USD) - 2019/09/06 20:45:34 ET
Table 'Icarus' 6-max Seat #5 is the button
Seat 1: Yockit ($6.56 in chips)
Seat 2: PlayTheBlues4U ($5.65 in chips)
Seat 3: 47xx47 ($3.86 in chips)
Seat 4: richy5742 ($6.15 in chips)
Seat 5: DeccaDan ($12.34 in chips)
Seat 6: DemolishIT ($4.43 in chips)
DemolishIT: posts small blind $0.02
Yockit: posts big blind $0.05
*** HOLE CARDS ***
Dealt to PlayTheBlues4U [5d 3h]
PlayTheBlues4U: folds
47xx47: calls $0.05
richy5742: folds
DeccaDan: calls $0.05
DemolishIT: calls $0.03
Yockit: checks
*** FLOP *** [4c Kd Jc]
DemolishIT: checks
Yockit: checks
47xx47: checks
DeccaDan: bets $0.10
DemolishIT: calls $0.10
Yockit: folds
47xx47: folds
*** TURN *** [4c Kd Jc] [3c]
DemolishIT: checks
DeccaDan: bets $0.20
DemolishIT: calls $0.20
*** RIVER *** [4c Kd Jc 3c] [6h]
DemolishIT: checks
DeccaDan: bets $0.40
DemolishIT: folds
Uncalled bet ($0.40) returned to DeccaDan
DeccaDan collected $0.76 from pot
DeccaDan: doesn't show hand
*** SUMMARY ***
Total pot $0.80 | Rake $0.04
Board [4c Kd Jc 3c 6h]
Seat 1: Yockit (big blind) folded on the Flop
Seat 2: PlayTheBlues4U folded before Flop (didn't bet)
Seat 3: 47xx47 folded on the Flop
Seat 4: richy5742 folded before Flop (didn't bet)
Seat 5: DeccaDan (button) collected ($0.76)
Seat 6: DemolishIT (small blind) folded on the River


PokerStars Hand #203470697835:  Hold'em No Limit ($0.01/$0.02 USD) - 2019/09/06 20:45:11 ET
Table 'Pegasus' 6-max Seat #3 is the button
Seat 1: Zeos179 ($4.54 in chips)
Seat 2: AAJMU ($2.60 in chips)
Seat 3: MAAE88 ($3.76 in chips)
Seat 4: PlayTheBlues4U ($3.04 in chips)
PlayTheBlues4U: posts small blind $0.01
Zeos179: posts big blind $0.02
*** HOLE CARDS ***
Dealt to PlayTheBlues4U [5c 5h]
AAJMU: calls $0.02
MAAE88: folds
PlayTheBlues4U: calls $0.01
Zeos179: checks
*** FLOP *** [7c As 2s]
PlayTheBlues4U: checks
Zeos179: checks
AAJMU: checks
*** TURN *** [7c As 2s] [Ks]
PlayTheBlues4U: checks
Zeos179: checks
AAJMU: bets $0.06
PlayTheBlues4U: folds
Zeos179: folds
Uncalled bet ($0.06) returned to AAJMU
AAJMU collected $0.06 from pot
AAJMU: doesn't show hand
*** SUMMARY ***
Total pot $0.06 | Rake $0
Board [7c As 2s Ks]
Seat 1: Zeos179 (big blind) folded on the Turn
Seat 2: AAJMU collected ($0.06)
Seat 3: MAAE88 (button) folded before Flop (didn't bet)
Seat 4: PlayTheBlues4U (small blind) folded on the Turn


PokerStars Hand #203470697747:  Hold'em No Limit ($0.01/$0.02 USD) - 2019/09/06 20:44:43 ET
Table 'Pegasus' 6-max Seat #2 is the button
Seat 1: Zeos179 ($4.54 in chips)
Seat 2: AAJMU ($3 in chips)
Seat 3: MAAE88 ($3.34 in chips)
Seat 4: PlayTheBlues4U ($3.10 in chips)
MAAE88: posts small blind $0.01
PlayTheBlues4U: posts big blind $0.02
*** HOLE CARDS ***
Dealt to PlayTheBlues4U [6s Jc]
Zeos179: folds
AAJMU: raises $0.04 to $0.06
MAAE88: calls $0.05
PlayTheBlues4U: calls $0.04
*** FLOP *** [4h 4c Ah]
MAAE88: bets $0.13
PlayTheBlues4U: folds
AAJMU: calls $0.13
*** TURN *** [4h 4c Ah] [7s]
MAAE88: bets $0.21
AAJMU: calls $0.21
*** RIVER *** [4h 4c Ah 7s] [5s]
MAAE88: checks
AAJMU: checks
*** SHOW DOWN ***
MAAE88: shows [Kc As] (two pair, Aces and Fours)
AAJMU: mucks hand
MAAE88 collected $0.82 from pot
*** SUMMARY ***
Total pot $0.86 | Rake $0.04
Board [4h 4c Ah 7s 5s]
Seat 1: Zeos179 folded before Flop (didn't bet)
Seat 2: AAJMU (button) mucked [Jd Ad]
Seat 3: MAAE88 (small blind) showed [Kc As] and won ($0.82) with two pair, Aces and Fours
Seat 4: PlayTheBlues4U (big blind) folded on the Flop


PokerStars Hand #203470697716:  Hold'em No Limit ($0.02/$0.05 USD) - 2019/09/06 20:44:34 ET
Table 'Icarus' 6-max Seat #4 is the button
Seat 1: Yockit ($6.54 in chips)
Seat 2: PlayTheBlues4U ($5.65 in chips)
Seat 3: 47xx47 ($3.86 in chips)
Seat 4: richy5742 ($6.15 in chips)
Seat 5: DeccaDan ($12.39 in chips)
Seat 6: DemolishIT ($4.41 in chips)
DeccaDan: posts small blind $0.02
DemolishIT: posts big blind $0.05
*** HOLE CARDS ***
Dealt to PlayTheBlues4U [Tc Ks]
Yockit: calls $0.05
PlayTheBlues4U: folds
47xx47: folds
richy5742: folds
DeccaDan: calls $0.03
DemolishIT: checks
*** FLOP *** [8h 8c Qd]
DeccaDan: checks
DemolishIT: checks
Yockit: checks
*** TURN *** [8h 8c Qd] [Qs]
DeccaDan: checks
DemolishIT: checks
Yockit: checks
*** RIVER *** [8h 8c Qd Qs] [7d]
DeccaDan: checks
DemolishIT: checks
Yockit: checks
*** SHOW DOWN ***
DeccaDan: shows [4c 4d] (two pair, Queens and Eights)
DemolishIT: shows [Js 4h] (two pair, Queens and Eights - Jack kicker)
Yockit: shows [Jd 9d] (two pair, Queens and Eights)
DemolishIT collected $0.07 from pot
Yockit collected $0.07 from pot
*** SUMMARY ***
Total pot $0.15 | Rake $0.01
Board [8h 8c Qd Qs 7d]
Seat 1: Yockit showed [Jd 9d] and won ($0.07) with two pair, Queens and Eights
Seat 2: PlayTheBlues4U folded before Flop (didn't bet)
Seat 3: 47xx47 folded before Flop (didn't bet)
Seat 4: richy5742 (button) folded before Flop (didn't bet)
Seat 5: DeccaDan (small blind) showed [4c 4d] and lost with two pair, Queens and Eights
Seat 6: DemolishIT (big blind) showed [Js 4h] and won ($0.07) with two pair, Queens and Eights


PokerStars Hand #203470697622:  Hold'em No Limit ($0.01/$0.02 USD) - 2019/09/06 20:44:07 ET
Table 'Pegasus' 6-max Seat #1 is the button
Seat 1: Zeos179 ($4.54 in chips)
Seat 2: AAJMU ($3.02 in chips)
Seat 3: MAAE88 ($3.32 in chips)
Seat 4: PlayTheBlues4U ($3.10 in chips)
AAJMU: posts small blind $0.01
MAAE88: posts big blind $0.02
*** HOLE CARDS ***
Dealt to PlayTheBlues4U [3d Ts]
PlayTheBlues4U: folds
Zeos179: folds
AAJMU: calls $0.01
MAAE88: checks
*** FLOP *** [Td Ks 5c]
AAJMU: checks
MAAE88: checks
*** TURN *** [Td Ks 5c] [9h]
AAJMU: checks
MAAE88: checks
*** RIVER *** [Td Ks 5c 9h] [Qs]
AAJMU: checks
MAAE88: checks
*** SHOW DOWN ***
AAJMU: shows [6s 3s] (high card King)
MAAE88: shows [Qh 4c] (a pair of Queens)
MAAE88 collected $0.04 from pot
*** SUMMARY ***
Total pot $0.04 | Rake $0
Board [Td Ks 5c 9h Qs]
Seat 1: Zeos179 (button) folded before Flop (didn't bet)
Seat 2: AAJMU (small blind) showed [6s 3s] and lost with high card King
Seat 3: MAAE88 (big blind) showed [Qh 4c] and won ($0.04) with a pair of Queens
Seat 4: PlayTheBlues4U folded before Flop (didn't bet)


PokerStars Hand #203470697541:  Hold'em No Limit ($0.01/$0.02 USD) - 2019/09/06 20:43:41 ET
Table 'Pegasus' 6-max Seat #4 is the button
Seat 1: Zeos179 ($4.50 in chips)
Seat 2: AAJMU ($3.06 in chips)
Seat 3: MAAE88 ($3.32 in chips)
Seat 4: PlayTheBlues4U ($3.10 in chips)
Zeos179: posts small blind $0.01
AAJMU: posts big blind $0.02
*** HOLE CARDS ***
Dealt to PlayTheBlues4U [2d 9c]
MAAE88: folds
PlayTheBlues4U: folds
Zeos179: calls $0.01
AAJMU: checks
*** FLOP *** [3d 7c 2h]
Zeos179: bets $0.02
AAJMU: calls $0.02
*** TURN *** [3d 7c 2h] [8d]
Zeos179: checks
AAJMU: checks
*** RIVER *** [3d 7c 2h 8d] [9d]
Zeos179: checks
AAJMU: checks
*** SHOW DOWN ***
Zeos179: shows [4d 4s] (a pair of Fours)
AAJMU: mucks hand
Zeos179 collected $0.08 from pot
*** SUMMARY ***
Total pot $0.08 | Rake $0
Board [3d 7c 2h 8d 9d]
Seat 1: Zeos179 (small blind) showed [4d 4s] and won ($0.08) with a pair of Fours
Seat 2: AAJMU (big blind) mucked [3h Ad]
Seat 3: MAAE88 folded before Flop (didn't bet)
Seat 4: PlayTheBlues4U (button) folded before Flop (didn't bet)


PokerStars Hand #203470697511:  Hold'em No Limit ($0.02/$0.05 USD) - 2019/09/06 20:43:31 ET
Table 'Icarus' 6-max Seat #3 is the button
Seat 1: Yockit ($6.54 in chips)
Seat 2: PlayTheBlues4U ($5.65 in chips)
Seat 3: 47xx47 ($3.88 in chips)
Seat 4: richy5742 ($6.17 in chips)
Seat 5: DeccaDan ($12.40 in chips)
Seat 6: DemolishIT ($4.41 in chips)
richy5742: posts small blind $0.02
DeccaDan: posts big blind $0.05
*** HOLE CARDS ***
Dealt to PlayTheBlues4U [3h Jc]
DemolishIT: folds
Yockit: folds
PlayTheBlues4U: folds
47xx47: raises $0.10 to $0.15
richy5742: folds
DeccaDan: calls $0.10
*** FLOP *** [Kc Ts Td]
DeccaDan: checks
47xx47: bets $0.10
DeccaDan: calls $0.10
*** TURN *** [Kc Ts Td] [Kh]
DeccaDan: checks
47xx47: checks
*** RIVER *** [Kc Ts Td Kh] [Jh]
DeccaDan: bets $0.20
47xx47: calls $0.20
*** SHOW DOWN ***
DeccaDan: shows [2d As] (two pair, Kings and Tens)
47xx47: shows [Ac 4d] (two pair, Kings and Tens)
DeccaDan collected $0.44 from pot
47xx47 collected $0.43 from pot
*** SUMMARY ***
Total pot $0.92 | Rake $0.05
Board [Kc Ts Td Kh Jh]
Seat 1: Yockit folded before Flop (didn't bet)
Seat 2: PlayTheBlues4U folded before Flop (didn't bet)
Seat 3: 47xx47 (button) showed [Ac 4d] and won ($0.43) with two pair, Kings and Tens
Seat 4: richy5742 (small blind) folded before Flop
Seat 5: DeccaDan (big blind) showed [2d As] and won ($0.44) with two pair, Kings and Tens
Seat 6: DemolishIT folded before Flop (didn't bet)


PokerStars Hand #203470697457:  Hold'em No Limit ($0.01/$0.02 USD) - 2019/09/06 20:43:15 ET
Table 'Pegasus' 6-max Seat #3 is the button
Seat 1: Zeos179 ($4.52 in chips)
Seat 2: AAJMU ($3.06 in chips)
Seat 3: MAAE88 ($3.32 in chips)
Seat 4: PlayTheBlues4U ($3.08 in chips)
PlayTheBlues4U: posts small blind $0.01
Zeos179: posts big blind $0.02
*** HOLE CARDS ***
Dealt to PlayTheBlues4U [3h 3d]
AAJMU: folds
MAAE88: folds
PlayTheBlues4U: calls $0.01
Zeos179: checks
*** FLOP *** [3c 4d 6d]
PlayTheBlues4U: bets $0.06
Zeos179: folds
Uncalled bet ($0.06) returned to PlayTheBlues4U
PlayTheBlues4U collected $0.04 from pot
PlayTheBlues4U: doesn't show hand
*** SUMMARY ***
Total pot $0.04 | Rake $0
Board [3c 4d 6d]
Seat 1: Zeos179 (big blind) folded on the Flop
Seat 2: AAJMU folded before Flop (didn't bet)
Seat 3: MAAE88 (button) folded before Flop (didn't bet)
Seat 4: PlayTheBlues4U (small blind) collected ($0.04)


PokerStars Hand #203470697315:  Hold'em No Limit ($0.01/$0.02 USD) - 2019/09/06 20:42:29 ET
Table 'Pegasus' 6-max Seat #2 is the button
Seat 1: Zeos179 ($4.52 in chips)
Seat 2: AAJMU ($3.06 in chips)
Seat 3: MAAE88 ($3.46 in chips)
Seat 4: PlayTheBlues4U ($2.95 in chips)
MAAE88: posts small blind $0.01
PlayTheBlues4U: posts big blind $0.02
*** HOLE CARDS ***
Dealt to PlayTheBlues4U [Ad Jc]
Zeos179: folds
AAJMU: folds
MAAE88: raises $0.04 to $0.06
PlayTheBlues4U: raises $0.08 to $0.14
MAAE88: calls $0.08
*** FLOP *** [4h 7c Tc]
MAAE88: checks
PlayTheBlues4U: checks
*** TURN *** [4h 7c Tc] [Qh]
MAAE88: checks
PlayTheBlues4U: bets $0.16
MAAE88: folds
Uncalled bet ($0.16) returned to PlayTheBlues4U
PlayTheBlues4U collected $0.27 from pot
PlayTheBlues4U: doesn't show hand
*** SUMMARY ***
Total pot $0.28 | Rake $0.01
Board [4h 7c Tc Qh]
Seat 1: Zeos179 folded before Flop (didn't bet)
Seat 2: AAJMU (button) folded before Flop (didn't bet)
Seat 3: MAAE88 (small blind) folded on the Turn
Seat 4: PlayTheBlues4U (big blind) collected ($0.27)


PokerStars Hand #203470697296:  Hold'em No Limit ($0.01/$0.02 USD) - 2019/09/06 20:42:24 ET
Table 'Pegasus' 6-max Seat #1 is the button
Seat 1: Zeos179 ($4.52 in chips)
Seat 2: AAJMU ($3.07 in chips)
Seat 3: MAAE88 ($3.45 in chips)
Seat 4: PlayTheBlues4U ($2.95 in chips)
AAJMU: posts small blind $0.01
MAAE88: posts big blind $0.02
*** HOLE CARDS ***
Dealt to PlayTheBlues4U [Jh 5s]
PlayTheBlues4U: folds
Zeos179: folds
AAJMU: folds
Uncalled bet ($0.01) returned to MAAE88
MAAE88 collected $0.02 from pot
MAAE88: doesn't show hand
*** SUMMARY ***
Total pot $0.02 | Rake $0
Seat 1: Zeos179 (button) folded before Flop (didn't bet)
Seat 2: AAJMU (small blind) folded before Flop
Seat 3: MAAE88 (big blind) collected ($0.02)
Seat 4: PlayTheBlues4U folded before Flop (didn't bet)


PokerStars Hand #203470697261:  Hold'em No Limit ($0.02/$0.05 USD) - 2019/09/06 20:42:12 ET
Table 'Icarus' 6-max Seat #2 is the button
Seat 1: Yockit ($6.79 in chips)
Seat 2: PlayTheBlues4U ($5.70 in chips)
Seat 3: 47xx47 ($3.90 in chips)
Seat 4: richy5742 ($5.88 in chips)
Seat 5: DeccaDan ($12.40 in chips)
Seat 6: DemolishIT ($4.41 in chips)
47xx47: posts small blind $0.02
richy5742: posts big blind $0.05
*** HOLE CARDS ***
Dealt to PlayTheBlues4U [2s 6s]
DeccaDan: folds
DemolishIT: folds
Yockit: calls $0.05
PlayTheBlues4U: calls $0.05
47xx47: folds
richy5742: checks
*** FLOP *** [Qc Ks 5h]
richy5742: bets $0.10
Yockit: calls $0.10
PlayTheBlues4U: folds
*** TURN *** [Qc Ks 5h] [5c]
richy5742: checks
Yockit: checks
*** RIVER *** [Qc Ks 5h 5c] [Jc]
richy5742: bets $0.10
Yockit: calls $0.10
*** SHOW DOWN ***
richy5742: shows [Kh 9c] (two pair, Kings and Fives)
Yockit: mucks hand
richy5742 collected $0.54 from pot
*** SUMMARY ***
Total pot $0.57 | Rake $0.03
Board [Qc Ks 5h 5c Jc]
Seat 1: Yockit mucked [Ah Js]
Seat 2: PlayTheBlues4U (button) folded on the Flop
Seat 3: 47xx47 (small blind) folded before Flop
Seat 4: richy5742 (big blind) showed [Kh 9c] and won ($0.54) with two pair, Kings and Fives
Seat 5: DeccaDan folded before Flop (didn't bet)
Seat 6: DemolishIT folded before Flop (didn't bet)


PokerStars Hand #203470697257:  Hold'em No Limit ($0.01/$0.02 USD) - 2019/09/06 20:42:10 ET
Table 'Pegasus' 6-max Seat #4 is the button
Seat 1: Zeos179 ($4.53 in chips)
Seat 2: AAJMU ($3.09 in chips)
Seat 3: MAAE88 ($3.45 in chips)
Seat 4: PlayTheBlues4U ($2.92 in chips)
Zeos179: posts small blind $0.01
AAJMU: posts big blind $0.02
*** HOLE CARDS ***
Dealt to PlayTheBlues4U [Jh Ks]
MAAE88: folds
PlayTheBlues4U: raises $0.06 to $0.08
Zeos179: folds
AAJMU: folds
Uncalled bet ($0.06) returned to PlayTheBlues4U
PlayTheBlues4U collected $0.05 from pot
PlayTheBlues4U: doesn't show hand
*** SUMMARY ***
Total pot $0.05 | Rake $0
Seat 1: Zeos179 (small blind) folded before Flop
Seat 2: AAJMU (big blind) folded before Flop
Seat 3: MAAE88 folded before Flop (didn't bet)
Seat 4: PlayTheBlues4U (button) collected ($0.05)


PokerStars Hand #203589434317:  Hold'em No Limit ($0.01/$0.02 USD) - 2019/09/10 23:08:33 ET
Table 'Rana' 6-max Seat #2 is the button
Seat 1: PlayTheBlues4U ($2.73 in chips)
Seat 2: xxzuluzuluxx ($0.72 in chips)
Seat 4: michelina44 ($0.75 in chips)
Seat 5: catgotmytongue ($2.32 in chips)
michelina44: posts small blind $0.01
catgotmytongue: posts big blind $0.02
*** HOLE CARDS ***
Dealt to PlayTheBlues4U [3c 4s]
PlayTheBlues4U: folds
xxzuluzuluxx: raises $0.05 to $0.07
michelina44: folds
catgotmytongue: folds
Uncalled bet ($0.05) returned to xxzuluzuluxx
xxzuluzuluxx collected $0.05 from pot
xxzuluzuluxx: doesn't show hand
*** SUMMARY ***
Total pot $0.05 | Rake $0
Seat 1: PlayTheBlues4U folded before Flop (didn't bet)
Seat 2: xxzuluzuluxx (button) collected ($0.05)
Seat 4: michelina44 (small blind) folded before Flop
Seat 5: catgotmytongue (big blind) folded before Flop


PokerStars Hand #203589434258:  Hold'em No Limit ($0.01/$0.02 USD) - 2019/09/10 23:08:12 ET
Table 'Rana' 6-max Seat #1 is the button
Seat 1: PlayTheBlues4U ($2.73 in chips)
Seat 2: xxzuluzuluxx ($0.78 in chips)
Seat 4: michelina44 ($0.77 in chips)
Seat 5: catgotmytongue ($2.25 in chips)
xxzuluzuluxx: posts small blind $0.01
michelina44: posts big blind $0.02
*** HOLE CARDS ***
Dealt to PlayTheBlues4U [2s 6c]
catgotmytongue: raises $0.04 to $0.06
PlayTheBlues4U: folds
xxzuluzuluxx: calls $0.05
michelina44: folds
*** FLOP *** [9c 7h 2h]
xxzuluzuluxx: checks
catgotmytongue: bets $0.13
xxzuluzuluxx: folds [5s]
Uncalled bet ($0.13) returned to catgotmytongue
catgotmytongue collected $0.13 from pot
catgotmytongue: doesn't show hand
*** SUMMARY ***
Total pot $0.14 | Rake $0.01
Board [9c 7h 2h]
Seat 1: PlayTheBlues4U (button) folded before Flop (didn't bet)
Seat 2: xxzuluzuluxx (small blind) folded on the Flop
Seat 4: michelina44 (big blind) folded before Flop
Seat 5: catgotmytongue collected ($0.13)


PokerStars Hand #203589434196:  Hold'em No Limit ($0.01/$0.02 USD) - 2019/09/10 23:07:51 ET
Table 'Jabbah' 6-max Seat #6 is the button
Seat 2: TomT87 ($0.77 in chips)
Seat 4: TroyBoy3912 ($2.86 in chips)
Seat 5: PlayTheBlues4U ($2.18 in chips)
Seat 6: Redkin20 ($1.46 in chips)
TomT87: posts small blind $0.01
TroyBoy3912: posts big blind $0.02
*** HOLE CARDS ***
Dealt to PlayTheBlues4U [2c 8c]
PlayTheBlues4U: folds
Redkin20: calls $0.02
TomT87: folds
TroyBoy3912: checks
*** FLOP *** [Jd 2d Ks]
TroyBoy3912: checks
Redkin20: checks
*** TURN *** [Jd 2d Ks] [Qc]
TroyBoy3912: checks
Redkin20: bets $0.04
TroyBoy3912: folds
Uncalled bet ($0.04) returned to Redkin20
Redkin20 collected $0.05 from pot
Redkin20: doesn't show hand
*** SUMMARY ***
Total pot $0.05 | Rake $0
Board [Jd 2d Ks Qc]
Seat 2: TomT87 (small blind) folded before Flop
Seat 4: TroyBoy3912 (big blind) folded on the Turn
Seat 5: PlayTheBlues4U folded before Flop (didn't bet)
Seat 6: Redkin20 (button) collected ($0.05)


PokerStars Hand #203589434177:  Hold'em No Limit ($0.01/$0.02 USD) - 2019/09/10 23:07:46 ET
Table 'Rana' 6-max Seat #6 is the button
Seat 1: PlayTheBlues4U ($2.74 in chips)
Seat 2: xxzuluzuluxx ($0.80 in chips)
Seat 4: michelina44 ($0.77 in chips)
Seat 5: catgotmytongue ($2.22 in chips)
Seat 6: DruMoney201 ($3.12 in chips)
PlayTheBlues4U: posts small blind $0.01
xxzuluzuluxx: posts big blind $0.02
*** HOLE CARDS ***
Dealt to PlayTheBlues4U [5d Qd]
michelina44: folds
catgotmytongue: calls $0.02
DruMoney201: folds
PlayTheBlues4U: folds
xxzuluzuluxx: checks
*** FLOP *** [Ac Kh 2h]
DruMoney201 leaves the table
xxzuluzuluxx: checks
catgotmytongue: checks
*** TURN *** [Ac Kh 2h] [4s]
xxzuluzuluxx: checks
catgotmytongue: checks
*** RIVER *** [Ac Kh 2h 4s] [Kd]
xxzuluzuluxx: checks
catgotmytongue: checks
*** SHOW DOWN ***
xxzuluzuluxx: shows [3d 8c] (a pair of Kings)
catgotmytongue: shows [Qs 9s] (a pair of Kings - Ace+Queen kicker)
catgotmytongue collected $0.05 from pot
*** SUMMARY ***
Total pot $0.05 | Rake $0
Board [Ac Kh 2h 4s Kd]
Seat 1: PlayTheBlues4U (small blind) folded before Flop
Seat 2: xxzuluzuluxx (big blind) showed [3d 8c] and lost with a pair of Kings
Seat 4: michelina44 folded before Flop (didn't bet)
Seat 5: catgotmytongue showed [Qs 9s] and won ($0.05) with a pair of Kings
Seat 6: DruMoney201 (button) folded before Flop (didn't bet)


PokerStars Hand #203589434070:  Hold'em No Limit ($0.01/$0.02 USD) - 2019/09/10 23:07:11 ET
Table 'Rana' 6-max Seat #5 is the button
Seat 1: PlayTheBlues4U ($2.74 in chips)
Seat 4: michelina44 ($0.77 in chips)
Seat 5: catgotmytongue ($2.22 in chips)
Seat 6: DruMoney201 ($3.12 in chips)
DruMoney201: posts small blind $0.01
PlayTheBlues4U: posts big blind $0.02
*** HOLE CARDS ***
Dealt to PlayTheBlues4U [Qc 2c]
michelina44: folds
catgotmytongue: folds
DruMoney201: calls $0.01
PlayTheBlues4U: checks
*** FLOP *** [Jd Ac 9d]
DruMoney201: checks
PlayTheBlues4U: checks
*** TURN *** [Jd Ac 9d] [9h]
DruMoney201: checks
PlayTheBlues4U: checks
*** RIVER *** [Jd Ac 9d 9h] [6h]
DruMoney201: checks
PlayTheBlues4U: checks
*** SHOW DOWN ***
DruMoney201: shows [3d Qh] (a pair of Nines)
PlayTheBlues4U: shows [Qc 2c] (a pair of Nines)
DruMoney201 collected $0.02 from pot
PlayTheBlues4U collected $0.02 from pot
*** SUMMARY ***
Total pot $0.04 | Rake $0
Board [Jd Ac 9d 9h 6h]
Seat 1: PlayTheBlues4U (big blind) showed [Qc 2c] and won ($0.02) with a pair of Nines
Seat 4: michelina44 folded before Flop (didn't bet)
Seat 5: catgotmytongue (button) folded before Flop (didn't bet)
Seat 6: DruMoney201 (small blind) showed [3d Qh] and won ($0.02) with a pair of Nines


PokerStars Hand #203589433997:  Hold'em No Limit ($0.01/$0.02 USD) - 2019/09/10 23:06:48 ET
Table 'Jabbah' 6-max Seat #5 is the button
Seat 2: TomT87 ($0.89 in chips)
Seat 4: TroyBoy3912 ($2.86 in chips)
Seat 5: PlayTheBlues4U ($1.96 in chips)
Seat 6: Redkin20 ($1.58 in chips)
Redkin20: posts small blind $0.01
TomT87: posts big blind $0.02
*** HOLE CARDS ***
Dealt to PlayTheBlues4U [Ac 6s]
TroyBoy3912: folds
PlayTheBlues4U: raises $0.04 to $0.06
Redkin20: calls $0.05
TomT87: calls $0.04
*** FLOP *** [4c 9h Ts]
Redkin20: checks
TomT87: checks
PlayTheBlues4U: bets $0.06
Redkin20: calls $0.06
TomT87: calls $0.06
*** TURN *** [4c 9h Ts] [2s]
Redkin20: checks
TomT87: checks
PlayTheBlues4U: checks
*** RIVER *** [4c 9h Ts 2s] [5d]
Redkin20: checks
TomT87: checks
PlayTheBlues4U: checks
*** SHOW DOWN ***
Redkin20: shows [7c Jc] (high card Jack)
TomT87: shows [Qc 8c] (high card Queen)
PlayTheBlues4U: shows [Ac 6s] (high card Ace)
PlayTheBlues4U collected $0.34 from pot
*** SUMMARY ***
Total pot $0.36 | Rake $0.02
Board [4c 9h Ts 2s 5d]
Seat 2: TomT87 (big blind) showed [Qc 8c] and lost with high card Queen
Seat 4: TroyBoy3912 folded before Flop (didn't bet)
Seat 5: PlayTheBlues4U (button) showed [Ac 6s] and won ($0.34) with high card Ace
Seat 6: Redkin20 (small blind) showed [7c Jc] and lost with high card Jack


PokerStars Hand #203589433955:  Hold'em No Limit ($0.01/$0.02 USD) - 2019/09/10 23:06:37 ET
Table 'Rana' 6-max Seat #4 is the button
Seat 1: PlayTheBlues4U ($2.74 in chips)
Seat 4: michelina44 ($0.77 in chips)
Seat 5: catgotmytongue ($2.20 in chips)
Seat 6: DruMoney201 ($3.14 in chips)
catgotmytongue: posts small blind $0.01
DruMoney201: posts big blind $0.02
*** HOLE CARDS ***
Dealt to PlayTheBlues4U [Qd 8d]
PlayTheBlues4U: folds
michelina44: folds
catgotmytongue: raises $0.04 to $0.06
DruMoney201: folds
Uncalled bet ($0.04) returned to catgotmytongue
catgotmytongue collected $0.04 from pot
catgotmytongue: doesn't show hand
*** SUMMARY ***
Total pot $0.04 | Rake $0
Seat 1: PlayTheBlues4U folded before Flop (didn't bet)
Seat 4: michelina44 (button) folded before Flop (didn't bet)
Seat 5: catgotmytongue (small blind) collected ($0.04)
Seat 6: DruMoney201 (big blind) folded before Flop


PokerStars Hand #203589433871:  Hold'em No Limit ($0.01/$0.02 USD) - 2019/09/10 23:06:07 ET
Table 'Rana' 6-max Seat #2 is the button
Seat 1: PlayTheBlues4U ($2.74 in chips)
Seat 2: xxzuluzuluxx ($0.34 in chips)
Seat 4: michelina44 ($0.78 in chips)
Seat 5: catgotmytongue ($1.88 in chips)
Seat 6: DruMoney201 ($3.14 in chips)
michelina44: posts small blind $0.01
catgotmytongue: posts big blind $0.02
*** HOLE CARDS ***
Dealt to PlayTheBlues4U [2h Th]
DruMoney201: folds
PlayTheBlues4U: folds
xxzuluzuluxx: calls $0.02
michelina44: folds
catgotmytongue: checks
*** FLOP *** [Jd Ad 4c]
catgotmytongue: checks
xxzuluzuluxx: bets $0.04
catgotmytongue: raises $0.13 to $0.17
xxzuluzuluxx: raises $0.13 to $0.30
catgotmytongue: calls $0.13
*** TURN *** [Jd Ad 4c] [9c]
catgotmytongue: bets $0.02
xxzuluzuluxx: calls $0.02 and is all-in
*** RIVER *** [Jd Ad 4c 9c] [5h]
*** SHOW DOWN ***
catgotmytongue: shows [Ac 7s] (a pair of Aces)
xxzuluzuluxx: shows [As 3c] (a pair of Aces - lower kicker)
catgotmytongue collected $0.66 from pot
*** SUMMARY ***
Total pot $0.69 | Rake $0.03
Board [Jd Ad 4c 9c 5h]
Seat 1: PlayTheBlues4U folded before Flop (didn't bet)
Seat 2: xxzuluzuluxx (button) showed [As 3c] and lost with a pair of Aces
Seat 4: michelina44 (small blind) folded before Flop
Seat 5: catgotmytongue (big blind) showed [Ac 7s] and won ($0.66) with a pair of Aces
Seat 6: DruMoney201 folded before Flop (didn't bet)


PokerStars Hand #203589433835:  Hold'em No Limit ($0.01/$0.02 USD) - 2019/09/10 23:05:57 ET
Table 'Rana' 6-max Seat #1 is the button
Seat 1: PlayTheBlues4U ($2.74 in chips)
Seat 2: xxzuluzuluxx ($0.35 in chips)
Seat 4: michelina44 ($0.77 in chips)
Seat 5: catgotmytongue ($1.88 in chips)
Seat 6: DruMoney201 ($3.14 in chips)
xxzuluzuluxx: posts small blind $0.01
michelina44: posts big blind $0.02
*** HOLE CARDS ***
Dealt to PlayTheBlues4U [9c Kd]
catgotmytongue: folds
DruMoney201: folds
PlayTheBlues4U: folds
xxzuluzuluxx: folds
Uncalled bet ($0.01) returned to michelina44
michelina44 collected $0.02 from pot
michelina44: doesn't show hand
*** SUMMARY ***
Total pot $0.02 | Rake $0
Seat 1: PlayTheBlues4U (button) folded before Flop (didn't bet)
Seat 2: xxzuluzuluxx (small blind) folded before Flop
Seat 4: michelina44 (big blind) collected ($0.02)
Seat 5: catgotmytongue folded before Flop (didn't bet)
Seat 6: DruMoney201 folded before Flop (didn't bet)


PokerStars Hand #203589433807:  Hold'em No Limit ($0.01/$0.02 USD) - 2019/09/10 23:05:48 ET
Table 'Jabbah' 6-max Seat #4 is the button
Seat 2: TomT87 ($1.25 in chips)
Seat 4: TroyBoy3912 ($2.88 in chips)
Seat 5: PlayTheBlues4U ($1.98 in chips)
Seat 6: Redkin20 ($1.21 in chips)
PlayTheBlues4U: posts small blind $0.01
Redkin20: posts big blind $0.02
*** HOLE CARDS ***
Dealt to PlayTheBlues4U [7h Qd]
TomT87: calls $0.02
TroyBoy3912: calls $0.02
PlayTheBlues4U: calls $0.01
Redkin20: checks
*** FLOP *** [3h 8h 3s]
PlayTheBlues4U: checks
Redkin20: bets $0.08
TomT87: calls $0.08
TroyBoy3912: folds
PlayTheBlues4U: folds
*** TURN *** [3h 8h 3s] [8d]
Redkin20: checks
TomT87: checks
*** RIVER *** [3h 8h 3s 8d] [Ac]
Redkin20: bets $0.26
TomT87: calls $0.26
*** SHOW DOWN ***
Redkin20: shows [8c 4h] (a full house, Eights full of Threes)
TomT87: mucks hand
Redkin20 collected $0.73 from pot
*** SUMMARY ***
Total pot $0.76 | Rake $0.03
Board [3h 8h 3s 8d Ac]
Seat 2: TomT87 mucked [Jc Jh]
Seat 4: TroyBoy3912 (button) folded on the Flop
Seat 5: PlayTheBlues4U (small blind) folded on the Flop
Seat 6: Redkin20 (big blind) showed [8c 4h] and won ($0.73) with a full house, Eights full of Threes


PokerStars Hand #203589433697:  Hold'em No Limit ($0.01/$0.02 USD) - 2019/09/10 23:05:10 ET
Table 'Jabbah' 6-max Seat #2 is the button
Seat 2: TomT87 ($1.31 in chips)
Seat 4: TroyBoy3912 ($2.89 in chips)
Seat 5: PlayTheBlues4U ($1.92 in chips)
Seat 6: Redkin20 ($1.21 in chips)
TroyBoy3912: posts small blind $0.01
PlayTheBlues4U: posts big blind $0.02
*** HOLE CARDS ***
Dealt to PlayTheBlues4U [3c Ac]
Redkin20: folds
TomT87: calls $0.02
TroyBoy3912: folds
PlayTheBlues4U: raises $0.04 to $0.06
TomT87: calls $0.04
*** FLOP *** [2d Tc Ks]
PlayTheBlues4U: bets $0.06
TomT87: folds
Uncalled bet ($0.06) returned to PlayTheBlues4U
PlayTheBlues4U collected $0.12 from pot
PlayTheBlues4U: doesn't show hand
*** SUMMARY ***
Total pot $0.13 | Rake $0.01
Board [2d Tc Ks]
Seat 2: TomT87 (button) folded on the Flop
Seat 4: TroyBoy3912 (small blind) folded before Flop
Seat 5: PlayTheBlues4U (big blind) collected ($0.12)
Seat 6: Redkin20 folded before Flop (didn't bet)


PokerStars Hand #203589433669:  Hold'em No Limit ($0.01/$0.02 USD) - 2019/09/10 23:05:01 ET
Table 'Rana' 6-max Seat #6 is the button
Seat 1: PlayTheBlues4U ($2.43 in chips)
Seat 2: xxzuluzuluxx ($0.57 in chips)
Seat 4: michelina44 ($0.77 in chips)
Seat 5: catgotmytongue ($1.94 in chips)
Seat 6: DruMoney201 ($3.20 in chips)
PlayTheBlues4U: posts small blind $0.01
xxzuluzuluxx: posts big blind $0.02
*** HOLE CARDS ***
Dealt to PlayTheBlues4U [Kc Ac]
michelina44: folds
catgotmytongue: raises $0.04 to $0.06
DruMoney201: calls $0.06
PlayTheBlues4U: raises $0.16 to $0.22
xxzuluzuluxx: calls $0.20
catgotmytongue: folds
DruMoney201: folds
*** FLOP *** [Ah 4s 9h]
PlayTheBlues4U: bets $0.36
xxzuluzuluxx: folds
Uncalled bet ($0.36) returned to PlayTheBlues4U
PlayTheBlues4U collected $0.53 from pot
PlayTheBlues4U: doesn't show hand
*** SUMMARY ***
Total pot $0.56 | Rake $0.03
Board [Ah 4s 9h]
Seat 1: PlayTheBlues4U (small blind) collected ($0.53)
Seat 2: xxzuluzuluxx (big blind) folded on the Flop
Seat 4: michelina44 folded before Flop (didn't bet)
Seat 5: catgotmytongue folded before Flop
Seat 6: DruMoney201 (button) folded before Flop


PokerStars Hand #203589433517:  Hold'em No Limit ($0.01/$0.02 USD) - 2019/09/10 23:04:11 ET
Table 'Rana' 6-max Seat #5 is the button
Seat 1: PlayTheBlues4U ($2.47 in chips)
Seat 2: xxzuluzuluxx ($0.47 in chips)
Seat 4: michelina44 ($0.80 in chips)
Seat 5: catgotmytongue ($1.94 in chips)
Seat 6: DruMoney201 ($3.24 in chips)
DruMoney201: posts small blind $0.01
PlayTheBlues4U: posts big blind $0.02
michelina44: posts small & big blinds $0.03
*** HOLE CARDS ***
Dealt to PlayTheBlues4U [9c Tc]
xxzuluzuluxx: raises $0.02 to $0.04
michelina44: folds
catgotmytongue: folds
DruMoney201: calls $0.03
PlayTheBlues4U: calls $0.02
*** FLOP *** [Kh 3s 8d]
DruMoney201: checks
PlayTheBlues4U: checks
xxzuluzuluxx: bets $0.14
DruMoney201: folds
PlayTheBlues4U: folds
Uncalled bet ($0.14) returned to xxzuluzuluxx
xxzuluzuluxx collected $0.14 from pot
xxzuluzuluxx: doesn't show hand
*** SUMMARY ***
Total pot $0.15 | Rake $0.01
Board [Kh 3s 8d]
Seat 1: PlayTheBlues4U (big blind) folded on the Flop
Seat 2: xxzuluzuluxx collected ($0.14)
Seat 4: michelina44 folded before Flop (didn't bet)
Seat 5: catgotmytongue (button) folded before Flop (didn't bet)
Seat 6: DruMoney201 (small blind) folded on the Flop


PokerStars Hand #203589433443:  Hold'em No Limit ($0.01/$0.02 USD) - 2019/09/10 23:03:46 ET
Table 'Jabbah' 6-max Seat #1 is the button
Seat 1: DigBickBlad ($1.58 in chips)
Seat 2: TomT87 ($1.14 in chips)
Seat 3: PTuck626 ($2.40 in chips)
Seat 4: TroyBoy3912 ($2.89 in chips)
Seat 5: PlayTheBlues4U ($1.92 in chips)
Seat 6: Redkin20 ($1.29 in chips)
TomT87: posts small blind $0.01
PTuck626: posts big blind $0.02
*** HOLE CARDS ***
Dealt to PlayTheBlues4U [6s 5d]
TroyBoy3912: folds
PlayTheBlues4U: folds
Redkin20: calls $0.02
DigBickBlad: raises $0.02 to $0.04
TomT87: calls $0.03
PTuck626: calls $0.02
Redkin20: calls $0.02
*** FLOP *** [7c 5c 7d]
TomT87: bets $0.02
PTuck626: folds
Redkin20: calls $0.02
DigBickBlad: calls $0.02
*** TURN *** [7c 5c 7d] [9c]
TomT87: bets $0.02
Redkin20: calls $0.02
DigBickBlad: folds
*** RIVER *** [7c 5c 7d 9c] [8s]
DigBickBlad leaves the table
TomT87: bets $0.12
Redkin20: folds
Uncalled bet ($0.12) returned to TomT87
TomT87 collected $0.25 from pot
TomT87: doesn't show hand
*** SUMMARY ***
Total pot $0.26 | Rake $0.01
Board [7c 5c 7d 9c 8s]
Seat 1: DigBickBlad (button) folded on the Turn
Seat 2: TomT87 (small blind) collected ($0.25)
Seat 3: PTuck626 (big blind) folded on the Flop
Seat 4: TroyBoy3912 folded before Flop (didn't bet)
Seat 5: PlayTheBlues4U folded before Flop (didn't bet)
Seat 6: Redkin20 folded on the River


PokerStars Hand #203589433296:  Hold'em No Limit ($0.01/$0.02 USD) - 2019/09/10 23:03:01 ET
Table 'Rana' 6-max Seat #2 is the button
Seat 1: PlayTheBlues4U ($2.47 in chips)
Seat 2: xxzuluzuluxx ($0.49 in chips)
Seat 5: catgotmytongue ($1.96 in chips)
Seat 6: DruMoney201 ($3.20 in chips)
catgotmytongue: posts small blind $0.01
DruMoney201: posts big blind $0.02
*** HOLE CARDS ***
Dealt to PlayTheBlues4U [Jh 3s]
PlayTheBlues4U: folds
xxzuluzuluxx: calls $0.02
catgotmytongue: calls $0.01
DruMoney201: checks
*** FLOP *** [3h Js 9c]
catgotmytongue: checks
DruMoney201: checks
xxzuluzuluxx: checks
*** TURN *** [3h Js 9c] [3d]
catgotmytongue: checks
DruMoney201: checks
xxzuluzuluxx: checks
*** RIVER *** [3h Js 9c 3d] [5s]
catgotmytongue: checks
DruMoney201: checks
xxzuluzuluxx: checks
*** SHOW DOWN ***
catgotmytongue: shows [4h Ks] (a pair of Threes)
DruMoney201: shows [2c Ac] (a pair of Threes - Ace kicker)
xxzuluzuluxx: mucks hand
DruMoney201 collected $0.06 from pot
*** SUMMARY ***
Total pot $0.06 | Rake $0
Board [3h Js 9c 3d 5s]
Seat 1: PlayTheBlues4U folded before Flop (didn't bet)
Seat 2: xxzuluzuluxx (button) mucked [7h 8s]
Seat 5: catgotmytongue (small blind) showed [4h Ks] and lost with a pair of Threes
Seat 6: DruMoney201 (big blind) showed [2c Ac] and won ($0.06) with a pair of Threes


PokerStars Hand #203589433249:  Hold'em No Limit ($0.01/$0.02 USD) - 2019/09/10 23:02:46 ET
Table 'Jabbah' 6-max Seat #6 is the button
Seat 1: DigBickBlad ($1.72 in chips)
Seat 2: TomT87 ($0.97 in chips)
Seat 3: PTuck626 ($2.40 in chips)
Seat 4: TroyBoy3912 ($2.89 in chips)
Seat 5: PlayTheBlues4U ($1.92 in chips)
Seat 6: Redkin20 ($1.33 in chips)
DigBickBlad: posts small blind $0.01
TomT87: posts big blind $0.02
*** HOLE CARDS ***
Dealt to PlayTheBlues4U [Jh 2c]
PTuck626: folds
TroyBoy3912: folds
PlayTheBlues4U: folds
Redkin20: calls $0.02
DigBickBlad: calls $0.01
TomT87: checks
*** FLOP *** [4d Ah 2s]
DigBickBlad: checks
TomT87: bets $0.02
Redkin20: calls $0.02
DigBickBlad: calls $0.02
*** TURN *** [4d Ah 2s] [Kc]
DigBickBlad: checks
TomT87: checks
Redkin20: checks
*** RIVER *** [4d Ah 2s Kc] [2d]
DigBickBlad: bets $0.02
TomT87: raises $0.08 to $0.10
Redkin20: folds
DigBickBlad: calls $0.08
*** SHOW DOWN ***
TomT87: shows [Ac Qs] (two pair, Aces and Deuces)
DigBickBlad: mucks hand
TomT87 collected $0.31 from pot
*** SUMMARY ***
Total pot $0.32 | Rake $0.01
Board [4d Ah 2s Kc 2d]
Seat 1: DigBickBlad (small blind) mucked [3h 3d]
Seat 2: TomT87 (big blind) showed [Ac Qs] and won ($0.31) with two pair, Aces and Deuces
Seat 3: PTuck626 folded before Flop (didn't bet)
Seat 4: TroyBoy3912 folded before Flop (didn't bet)
Seat 5: PlayTheBlues4U folded before Flop (didn't bet)
Seat 6: Redkin20 (button) folded on the River


PokerStars Hand #203589433165:  Hold'em No Limit ($0.01/$0.02 USD) - 2019/09/10 23:02:17 ET
Table 'Rana' 6-max Seat #1 is the button
Seat 1: PlayTheBlues4U ($2.49 in chips)
Seat 2: xxzuluzuluxx ($0.51 in chips)
Seat 5: catgotmytongue ($1.92 in chips)
Seat 6: DruMoney201 ($3.20 in chips)
xxzuluzuluxx: posts small blind $0.01
catgotmytongue: posts big blind $0.02
*** HOLE CARDS ***
Dealt to PlayTheBlues4U [7d 6d]
DruMoney201: folds
PlayTheBlues4U: calls $0.02
xxzuluzuluxx: calls $0.01
catgotmytongue: checks
*** FLOP *** [2h Kc Ts]
xxzuluzuluxx: checks
catgotmytongue: checks
PlayTheBlues4U: checks
*** TURN *** [2h Kc Ts] [3h]
xxzuluzuluxx: checks
catgotmytongue: bets $0.03
PlayTheBlues4U: folds
xxzuluzuluxx: folds
Uncalled bet ($0.03) returned to catgotmytongue
catgotmytongue collected $0.06 from pot
catgotmytongue: doesn't show hand
*** SUMMARY ***
Total pot $0.06 | Rake $0
Board [2h Kc Ts 3h]
Seat 1: PlayTheBlues4U (button) folded on the Turn
Seat 2: xxzuluzuluxx (small blind) folded on the Turn
Seat 5: catgotmytongue (big blind) collected ($0.06)
Seat 6: DruMoney201 folded before Flop (didn't bet)


PokerStars Hand #203589433064:  Hold'em No Limit ($0.01/$0.02 USD) - 2019/09/10 23:01:44 ET
Table 'Rana' 6-max Seat #6 is the button
Seat 1: PlayTheBlues4U ($2.42 in chips)
Seat 2: xxzuluzuluxx ($0.59 in chips)
Seat 5: catgotmytongue ($1.92 in chips)
Seat 6: DruMoney201 ($3.20 in chips)
PlayTheBlues4U: posts small blind $0.01
xxzuluzuluxx: posts big blind $0.02
*** HOLE CARDS ***
Dealt to PlayTheBlues4U [8d 8h]
catgotmytongue: folds
DruMoney201: folds
PlayTheBlues4U: raises $0.02 to $0.04
xxzuluzuluxx: calls $0.02
*** FLOP *** [Kc 6s Ah]
PlayTheBlues4U: bets $0.04
xxzuluzuluxx: calls $0.04
*** TURN *** [Kc 6s Ah] [5h]
PlayTheBlues4U: checks
xxzuluzuluxx: checks
*** RIVER *** [Kc 6s Ah 5h] [Qc]
PlayTheBlues4U: checks
xxzuluzuluxx: checks
*** SHOW DOWN ***
PlayTheBlues4U: shows [8d 8h] (a pair of Eights)
xxzuluzuluxx: mucks hand
PlayTheBlues4U collected $0.15 from pot
*** SUMMARY ***
Total pot $0.16 | Rake $0.01
Board [Kc 6s Ah 5h Qc]
Seat 1: PlayTheBlues4U (small blind) showed [8d 8h] and won ($0.15) with a pair of Eights
Seat 2: xxzuluzuluxx (big blind) mucked [Js 9h]
Seat 5: catgotmytongue folded before Flop (didn't bet)
Seat 6: DruMoney201 (button) folded before Flop (didn't bet)


PokerStars Hand #203589432957:  Hold'em No Limit ($0.01/$0.02 USD) - 2019/09/10 23:01:05 ET
Table 'Jabbah' 6-max Seat #5 is the button
Seat 1: DigBickBlad ($1.78 in chips)
Seat 2: TomT87 ($1.13 in chips)
Seat 3: PTuck626 ($2.40 in chips)
Seat 4: TroyBoy3912 ($2.63 in chips)
Seat 5: PlayTheBlues4U ($1.92 in chips)
Seat 6: Redkin20 ($1.39 in chips)
Redkin20: posts small blind $0.01
DigBickBlad: posts big blind $0.02
*** HOLE CARDS ***
Dealt to PlayTheBlues4U [Td 8c]
TomT87: calls $0.02
PTuck626: folds
TroyBoy3912: calls $0.02
PlayTheBlues4U: folds
Redkin20: calls $0.01
DigBickBlad: checks
*** FLOP *** [4c Ts Qc]
Redkin20: checks
DigBickBlad: checks
TomT87: checks
TroyBoy3912: bets $0.04
Redkin20: calls $0.04
DigBickBlad: calls $0.04
TomT87: calls $0.04
*** TURN *** [4c Ts Qc] [8s]
Redkin20: checks
DigBickBlad: checks
TomT87: checks
TroyBoy3912: bets $0.10
Redkin20: folds
DigBickBlad: folds
TomT87: calls $0.10
*** RIVER *** [4c Ts Qc 8s] [7d]
TomT87: checks
TroyBoy3912: checks
*** SHOW DOWN ***
TomT87: shows [Js 4s] (a pair of Fours)
TroyBoy3912: shows [Jc Qs] (a pair of Queens)
TroyBoy3912 collected $0.42 from pot
*** SUMMARY ***
Total pot $0.44 | Rake $0.02
Board [4c Ts Qc 8s 7d]
Seat 1: DigBickBlad (big blind) folded on the Turn
Seat 2: TomT87 showed [Js 4s] and lost with a pair of Fours
Seat 3: PTuck626 folded before Flop (didn't bet)
Seat 4: TroyBoy3912 showed [Jc Qs] and won ($0.42) with a pair of Queens
Seat 5: PlayTheBlues4U (button) folded before Flop (didn't bet)
Seat 6: Redkin20 (small blind) folded on the Turn


PokerStars Hand #203589432914:  Hold'em No Limit ($0.01/$0.02 USD) - 2019/09/10 23:00:51 ET
Table 'Rana' 6-max Seat #5 is the button
Seat 1: PlayTheBlues4U ($2.54 in chips)
Seat 2: xxzuluzuluxx ($0.47 in chips)
Seat 5: catgotmytongue ($1.92 in chips)
Seat 6: DruMoney201 ($3.21 in chips)
DruMoney201: posts small blind $0.01
PlayTheBlues4U: posts big blind $0.02
*** HOLE CARDS ***
Dealt to PlayTheBlues4U [Jh Ac]
xxzuluzuluxx: calls $0.02
catgotmytongue: folds
DruMoney201: folds
PlayTheBlues4U: raises $0.04 to $0.06
xxzuluzuluxx: calls $0.04
*** FLOP *** [Ks 6s 9s]
PlayTheBlues4U: bets $0.06
xxzuluzuluxx: calls $0.06
*** TURN *** [Ks 6s 9s] [2c]
PlayTheBlues4U: checks
xxzuluzuluxx: bets $0.12
PlayTheBlues4U: folds
Uncalled bet ($0.12) returned to xxzuluzuluxx
xxzuluzuluxx collected $0.24 from pot
xxzuluzuluxx: doesn't show hand
*** SUMMARY ***
Total pot $0.25 | Rake $0.01
Board [Ks 6s 9s 2c]
Seat 1: PlayTheBlues4U (big blind) folded on the Turn
Seat 2: xxzuluzuluxx collected ($0.24)
Seat 5: catgotmytongue (button) folded before Flop (didn't bet)
Seat 6: DruMoney201 (small blind) folded before Flop


PokerStars Hand #203589432790:  Hold'em No Limit ($0.01/$0.02 USD) - 2019/09/10 23:00:08 ET
Table 'Rana' 6-max Seat #2 is the button
Seat 1: PlayTheBlues4U ($2.22 in chips)
Seat 2: xxzuluzuluxx ($0.79 in chips)
Seat 5: catgotmytongue ($1.93 in chips)
Seat 6: DruMoney201 ($3.23 in chips)
catgotmytongue: posts small blind $0.01
DruMoney201: posts big blind $0.02
*** HOLE CARDS ***
Dealt to PlayTheBlues4U [Td As]
PlayTheBlues4U: raises $0.04 to $0.06
xxzuluzuluxx: calls $0.06
catgotmytongue: folds
DruMoney201: folds
*** FLOP *** [5h Ts 3d]
PlayTheBlues4U: bets $0.08
xxzuluzuluxx: calls $0.08
*** TURN *** [5h Ts 3d] [Th]
PlayTheBlues4U: bets $0.18
xxzuluzuluxx: calls $0.18
*** RIVER *** [5h Ts 3d Th] [7d]
PlayTheBlues4U: bets $0.64
xxzuluzuluxx: folds [7s]
Uncalled bet ($0.64) returned to PlayTheBlues4U
PlayTheBlues4U collected $0.64 from pot
PlayTheBlues4U: doesn't show hand
*** SUMMARY ***
Total pot $0.67 | Rake $0.03
Board [5h Ts 3d Th 7d]
Seat 1: PlayTheBlues4U collected ($0.64)
Seat 2: xxzuluzuluxx (button) folded on the River
Seat 5: catgotmytongue (small blind) folded before Flop
Seat 6: DruMoney201 (big blind) folded before Flop


PokerStars Hand #203589432768:  Hold'em No Limit ($0.01/$0.02 USD) - 2019/09/10 23:00:01 ET
Table 'Jabbah' 6-max Seat #4 is the button
Seat 1: DigBickBlad ($1.78 in chips)
Seat 2: TomT87 ($1.13 in chips)
Seat 3: PTuck626 ($1.96 in chips)
Seat 4: TroyBoy3912 ($2.63 in chips)
Seat 5: PlayTheBlues4U ($1.94 in chips)
Seat 6: Redkin20 ($1.85 in chips)
PlayTheBlues4U: posts small blind $0.01
Redkin20: posts big blind $0.02
*** HOLE CARDS ***
Dealt to PlayTheBlues4U [3c 3h]
DigBickBlad: folds
TomT87: folds
PTuck626: calls $0.02
TroyBoy3912: folds
PlayTheBlues4U: calls $0.01
Redkin20: checks
*** FLOP *** [6c 7s 9d]
PlayTheBlues4U: checks
Redkin20: checks
PTuck626: bets $0.03
PlayTheBlues4U: folds
Redkin20: calls $0.03
*** TURN *** [6c 7s 9d] [7c]
Redkin20: checks
PTuck626: bets $0.06
Redkin20: calls $0.06
*** RIVER *** [6c 7s 9d 7c] [9s]
Redkin20: checks
PTuck626: bets $0.35
Redkin20: calls $0.35
*** SHOW DOWN ***
PTuck626: shows [Kc 8d] (two pair, Nines and Sevens)
Redkin20: mucks hand
PTuck626 collected $0.90 from pot
*** SUMMARY ***
Total pot $0.94 | Rake $0.04
Board [6c 7s 9d 7c 9s]
Seat 1: DigBickBlad folded before Flop (didn't bet)
Seat 2: TomT87 folded before Flop (didn't bet)
Seat 3: PTuck626 showed [Kc 8d] and won ($0.90) with two pair, Nines and Sevens
Seat 4: TroyBoy3912 (button) folded before Flop (didn't bet)
Seat 5: PlayTheBlues4U (small blind) folded on the Flop
Seat 6: Redkin20 (big blind) mucked [8c Qd]


PokerStars Hand #203589432695:  Hold'em No Limit ($0.01/$0.02 USD) - 2019/09/10 22:59:26 ET
Table 'Jabbah' 6-max Seat #3 is the button
Seat 1: DigBickBlad ($1.80 in chips)
Seat 2: TomT87 ($1.13 in chips)
Seat 3: PTuck626 ($1.96 in chips)
Seat 4: TroyBoy3912 ($2.64 in chips)
Seat 5: PlayTheBlues4U ($1.96 in chips)
Seat 6: Redkin20 ($1.80 in chips)
TroyBoy3912: posts small blind $0.01
PlayTheBlues4U: posts big blind $0.02
*** HOLE CARDS ***
Dealt to PlayTheBlues4U [7d 2c]
Redkin20: calls $0.02
DigBickBlad: calls $0.02
TomT87: folds
PTuck626: folds
TroyBoy3912: folds
PlayTheBlues4U: checks
*** FLOP *** [2s Qh 4c]
PlayTheBlues4U: checks
Redkin20: bets $0.02
DigBickBlad: folds
PlayTheBlues4U: folds
Uncalled bet ($0.02) returned to Redkin20
Redkin20 collected $0.07 from pot
Redkin20: doesn't show hand
*** SUMMARY ***
Total pot $0.07 | Rake $0
Board [2s Qh 4c]
Seat 1: DigBickBlad folded on the Flop
Seat 2: TomT87 folded before Flop (didn't bet)
Seat 3: PTuck626 (button) folded before Flop (didn't bet)
Seat 4: TroyBoy3912 (small blind) folded before Flop
Seat 5: PlayTheBlues4U (big blind) folded on the Flop
Seat 6: Redkin20 collected ($0.07)


PokerStars Hand #203589432687:  Hold'em No Limit ($0.01/$0.02 USD) - 2019/09/10 22:59:22 ET
Table 'Rana' 6-max Seat #1 is the button
Seat 1: PlayTheBlues4U ($2.36 in chips)
Seat 2: xxzuluzuluxx ($0.64 in chips)
Seat 5: catgotmytongue ($1.95 in chips)
Seat 6: DruMoney201 ($3.23 in chips)
xxzuluzuluxx: posts small blind $0.01
michelina44 has timed out while disconnected
michelina44: is sitting out
catgotmytongue: posts big blind $0.02
*** HOLE CARDS ***
Dealt to PlayTheBlues4U [Ah 3h]
DruMoney201: folds
PlayTheBlues4U: raises $0.04 to $0.06
xxzuluzuluxx: calls $0.05
catgotmytongue: folds
*** FLOP *** [4h 2s 6d]
xxzuluzuluxx: checks
michelina44 is disconnected
PlayTheBlues4U: bets $0.08
xxzuluzuluxx: calls $0.08
*** TURN *** [4h 2s 6d] [4s]
xxzuluzuluxx: checks
PlayTheBlues4U: checks
*** RIVER *** [4h 2s 6d 4s] [Qh]
xxzuluzuluxx: checks
PlayTheBlues4U: checks
*** SHOW DOWN ***
xxzuluzuluxx: shows [Ac 7c] (a pair of Fours)
PlayTheBlues4U: mucks hand
xxzuluzuluxx collected $0.29 from pot
*** SUMMARY ***
Total pot $0.30 | Rake $0.01
Board [4h 2s 6d 4s Qh]
Seat 1: PlayTheBlues4U (button) mucked [Ah 3h]
Seat 2: xxzuluzuluxx (small blind) showed [Ac 7c] and won ($0.29) with a pair of Fours
Seat 5: catgotmytongue (big blind) folded before Flop
Seat 6: DruMoney201 folded before Flop (didn't bet)


PokerStars Hand #203589432606:  Hold'em No Limit ($0.01/$0.02 USD) - 2019/09/10 22:58:41 ET
Table 'Rana' 6-max Seat #6 is the button
Seat 1: PlayTheBlues4U ($2.29 in chips)
Seat 2: xxzuluzuluxx ($0.70 in chips)
Seat 4: michelina44 ($0.80 in chips)
Seat 5: catgotmytongue ($1.97 in chips)
Seat 6: DruMoney201 ($3.23 in chips)
PlayTheBlues4U: posts small blind $0.01
xxzuluzuluxx: posts big blind $0.02
*** HOLE CARDS ***
Dealt to PlayTheBlues4U [8h Jh]
michelina44: folds
catgotmytongue: calls $0.02
DruMoney201: folds
PlayTheBlues4U: calls $0.01
xxzuluzuluxx: checks
*** FLOP *** [5c 8c Qd]
PlayTheBlues4U: bets $0.04
xxzuluzuluxx: calls $0.04
catgotmytongue: folds
*** TURN *** [5c 8c Qd] [8d]
PlayTheBlues4U: bets $0.10
xxzuluzuluxx: folds
Uncalled bet ($0.10) returned to PlayTheBlues4U
PlayTheBlues4U collected $0.13 from pot
PlayTheBlues4U: doesn't show hand
*** SUMMARY ***
Total pot $0.14 | Rake $0.01
Board [5c 8c Qd 8d]
Seat 1: PlayTheBlues4U (small blind) collected ($0.13)
Seat 2: xxzuluzuluxx (big blind) folded on the Turn
Seat 4: michelina44 folded before Flop (didn't bet)
Seat 5: catgotmytongue folded on the Flop
Seat 6: DruMoney201 (button) folded before Flop (didn't bet)


PokerStars Hand #203589432547:  Hold'em No Limit ($0.01/$0.02 USD) - 2019/09/10 22:58:14 ET
Table 'Rana' 6-max Seat #5 is the button
Seat 1: PlayTheBlues4U ($2.24 in chips)
Seat 2: xxzuluzuluxx ($0.70 in chips)
Seat 4: michelina44 ($0.84 in chips)
Seat 5: catgotmytongue ($1.97 in chips)
Seat 6: DruMoney201 ($3.24 in chips)
DruMoney201: posts small blind $0.01
PlayTheBlues4U: posts big blind $0.02
*** HOLE CARDS ***
Dealt to PlayTheBlues4U [2h Qd]
xxzuluzuluxx: folds
michelina44: raises $0.02 to $0.04
catgotmytongue: folds
DruMoney201: folds
PlayTheBlues4U: calls $0.02
*** FLOP *** [4c Qc 3s]
PlayTheBlues4U: checks
michelina44: checks
*** TURN *** [4c Qc 3s] [9h]
PlayTheBlues4U: bets $0.06
michelina44: folds
Uncalled bet ($0.06) returned to PlayTheBlues4U
PlayTheBlues4U collected $0.09 from pot
PlayTheBlues4U: doesn't show hand
*** SUMMARY ***
Total pot $0.09 | Rake $0
Board [4c Qc 3s 9h]
Seat 1: PlayTheBlues4U (big blind) collected ($0.09)
Seat 2: xxzuluzuluxx folded before Flop (didn't bet)
Seat 4: michelina44 folded on the Turn
Seat 5: catgotmytongue (button) folded before Flop (didn't bet)
Seat 6: DruMoney201 (small blind) folded before Flop


PokerStars Hand #203589432521:  Hold'em No Limit ($0.01/$0.02 USD) - 2019/09/10 22:57:59 ET
Table 'Rana' 6-max Seat #4 is the button
Seat 1: PlayTheBlues4U ($2.24 in chips)
Seat 2: xxzuluzuluxx ($0.70 in chips)
Seat 4: michelina44 ($0.84 in chips)
Seat 5: catgotmytongue ($1.95 in chips)
Seat 6: DruMoney201 ($3.26 in chips)
catgotmytongue: posts small blind $0.01
DruMoney201: posts big blind $0.02
*** HOLE CARDS ***
Dealt to PlayTheBlues4U [2s 9s]
PlayTheBlues4U: folds
xxzuluzuluxx: folds
michelina44: folds
catgotmytongue: raises $0.06 to $0.08
DruMoney201: folds
Uncalled bet ($0.06) returned to catgotmytongue
catgotmytongue collected $0.04 from pot
catgotmytongue: doesn't show hand
*** SUMMARY ***
Total pot $0.04 | Rake $0
Seat 1: PlayTheBlues4U folded before Flop (didn't bet)
Seat 2: xxzuluzuluxx folded before Flop (didn't bet)
Seat 4: michelina44 (button) folded before Flop (didn't bet)
Seat 5: catgotmytongue (small blind) collected ($0.04)
Seat 6: DruMoney201 (big blind) folded before Flop


PokerStars Hand #203589432457:  Hold'em No Limit ($0.01/$0.02 USD) - 2019/09/10 22:57:29 ET
Table 'Rana' 6-max Seat #2 is the button
Seat 1: PlayTheBlues4U ($2.24 in chips)
Seat 2: xxzuluzuluxx ($0.70 in chips)
Seat 4: michelina44 ($0.85 in chips)
Seat 5: catgotmytongue ($1.92 in chips)
Seat 6: DruMoney201 ($3.28 in chips)
michelina44: posts small blind $0.01
catgotmytongue: posts big blind $0.02
*** HOLE CARDS ***
Dealt to PlayTheBlues4U [3s 7c]
DruMoney201: calls $0.02
PlayTheBlues4U: folds
xxzuluzuluxx: folds
michelina44: folds
catgotmytongue: checks
*** FLOP *** [4s Th Jh]
catgotmytongue: checks
DruMoney201: checks
*** TURN *** [4s Th Jh] [6c]
catgotmytongue: checks
DruMoney201: checks
*** RIVER *** [4s Th Jh 6c] [5s]
catgotmytongue: checks
DruMoney201: checks
*** SHOW DOWN ***
catgotmytongue: shows [Kc 5c] (a pair of Fives)
DruMoney201: mucks hand
catgotmytongue collected $0.05 from pot
*** SUMMARY ***
Total pot $0.05 | Rake $0
Board [4s Th Jh 6c 5s]
Seat 1: PlayTheBlues4U folded before Flop (didn't bet)
Seat 2: xxzuluzuluxx (button) folded before Flop (didn't bet)
Seat 4: michelina44 (small blind) folded before Flop
Seat 5: catgotmytongue (big blind) showed [Kc 5c] and won ($0.05) with a pair of Fives
Seat 6: DruMoney201 mucked [9h Kd]


PokerStars Hand #203589432441:  Hold'em No Limit ($0.01/$0.02 USD) - 2019/09/10 22:57:21 ET
Table 'Jabbah' 6-max Seat #2 is the button
Seat 1: DigBickBlad ($2 in chips)
Seat 2: TomT87 ($1.33 in chips)
Seat 3: PTuck626 ($1.98 in chips)
Seat 4: TroyBoy3912 ($2.66 in chips)
Seat 5: PlayTheBlues4U ($1.96 in chips)
Seat 6: Redkin20 ($1.39 in chips)
PTuck626: posts small blind $0.01
TroyBoy3912: posts big blind $0.02
DigBickBlad: posts big blind $0.02
*** HOLE CARDS ***
Dealt to PlayTheBlues4U [2s 9c]
PlayTheBlues4U: folds
Redkin20: calls $0.02
DigBickBlad: checks
TomT87: calls $0.02
PTuck626: calls $0.01
TroyBoy3912: checks
*** FLOP *** [7d Ah Qh]
PTuck626: checks
TroyBoy3912: checks
Redkin20: checks
DigBickBlad: checks
TomT87: checks
*** TURN *** [7d Ah Qh] [Qd]
PTuck626: checks
TroyBoy3912: checks
Redkin20: checks
DigBickBlad: checks
TomT87: checks
*** RIVER *** [7d Ah Qh Qd] [3d]
PTuck626: checks
TroyBoy3912: checks
Redkin20: bets $0.18
DigBickBlad: calls $0.18
TomT87: calls $0.18
PTuck626: folds
TroyBoy3912: folds
*** SHOW DOWN ***
Redkin20: shows [6d 5d] (a flush, Queen high)
DigBickBlad: mucks hand
TomT87: mucks hand
Redkin20 collected $0.61 from pot
*** SUMMARY ***
Total pot $0.64 | Rake $0.03
Board [7d Ah Qh Qd 3d]
Seat 1: DigBickBlad mucked [7c 2d]
Seat 2: TomT87 (button) mucked [4s Qs]
Seat 3: PTuck626 (small blind) folded on the River
Seat 4: TroyBoy3912 (big blind) folded on the River
Seat 5: PlayTheBlues4U folded before Flop (didn't bet)
Seat 6: Redkin20 showed [6d 5d] and won ($0.61) with a flush, Queen high


PokerStars Hand #203589432398:  Hold'em No Limit ($0.01/$0.02 USD) - 2019/09/10 22:57:01 ET
Table 'Rana' 6-max Seat #1 is the button
Seat 1: PlayTheBlues4U ($2.24 in chips)
Seat 2: xxzuluzuluxx ($0.72 in chips)
Seat 4: michelina44 ($0.78 in chips)
Seat 5: catgotmytongue ($1.92 in chips)
Seat 6: DruMoney201 ($3.34 in chips)
xxzuluzuluxx: posts small blind $0.01
michelina44: posts big blind $0.02
*** HOLE CARDS ***
Dealt to PlayTheBlues4U [4d Qh]
catgotmytongue: folds
DruMoney201: calls $0.02
PlayTheBlues4U: folds
xxzuluzuluxx: calls $0.01
michelina44: checks
*** FLOP *** [2h Js 3c]
xxzuluzuluxx: checks
michelina44: bets $0.02
DruMoney201: calls $0.02
xxzuluzuluxx: folds
*** TURN *** [2h Js 3c] [3h]
michelina44: bets $0.02
DruMoney201: calls $0.02
*** RIVER *** [2h Js 3c 3h] [4s]
michelina44: bets $0.06
DruMoney201: folds
Uncalled bet ($0.06) returned to michelina44
michelina44 collected $0.13 from pot
michelina44: doesn't show hand
*** SUMMARY ***
Total pot $0.14 | Rake $0.01
Board [2h Js 3c 3h 4s]
Seat 1: PlayTheBlues4U (button) folded before Flop (didn't bet)
Seat 2: xxzuluzuluxx (small blind) folded on the Flop
Seat 4: michelina44 (big blind) collected ($0.13)
Seat 5: catgotmytongue folded before Flop (didn't bet)
Seat 6: DruMoney201 folded on the River


PokerStars Hand #203589432261:  Hold'em No Limit ($0.01/$0.02 USD) - 2019/09/10 22:55:59 ET
Table 'Orion' 6-max Seat #1 is the button
Seat 1: jford9099 ($1.81 in chips)
Seat 6: PlayTheBlues4U ($2.07 in chips)
jford9099: posts small blind $0.01
PlayTheBlues4U: posts big blind $0.02
*** HOLE CARDS ***
Dealt to PlayTheBlues4U [6h 5c]
jford9099: raises $0.06 to $0.08
PlayTheBlues4U: folds
Uncalled bet ($0.06) returned to jford9099
PlayTheBlues4U leaves the table
jford9099 collected $0.04 from pot
pepperman5757 joins the table at seat #4
jford9099: doesn't show hand
*** SUMMARY ***
Total pot $0.04 | Rake $0
Seat 1: jford9099 (button) (small blind) collected ($0.04)
Seat 6: PlayTheBlues4U (big blind) folded before Flop


PokerStars Hand #203589432244:  Hold'em No Limit ($0.01/$0.02 USD) - 2019/09/10 22:55:51 ET
Table 'Rana' 6-max Seat #6 is the button
Seat 1: PlayTheBlues4U ($2.51 in chips)
Seat 2: xxzuluzuluxx ($0.79 in chips)
Seat 4: michelina44 ($0.80 in chips)
Seat 5: catgotmytongue ($1.94 in chips)
Seat 6: DruMoney201 ($2.99 in chips)
PlayTheBlues4U: posts small blind $0.01
xxzuluzuluxx: posts big blind $0.02
michelina44: posts big blind $0.02
*** HOLE CARDS ***
Dealt to PlayTheBlues4U [Qd 4c]
michelina44: checks
catgotmytongue: calls $0.02
DruMoney201: calls $0.02
PlayTheBlues4U: calls $0.01
xxzuluzuluxx: checks
*** FLOP *** [2s 3s Qh]
PlayTheBlues4U: bets $0.05
xxzuluzuluxx: calls $0.05
michelina44: folds
catgotmytongue: folds
DruMoney201: calls $0.05
*** TURN *** [2s 3s Qh] [5s]
PlayTheBlues4U: bets $0.20
xxzuluzuluxx: folds
DruMoney201: calls $0.20
*** RIVER *** [2s 3s Qh 5s] [8h]
PlayTheBlues4U: checks
DruMoney201: checks
*** SHOW DOWN ***
PlayTheBlues4U: shows [Qd 4c] (a pair of Queens)
DruMoney201: shows [7s 8s] (a flush, Eight high)
DruMoney201 collected $0.62 from pot
*** SUMMARY ***
Total pot $0.65 | Rake $0.03
Board [2s 3s Qh 5s 8h]
Seat 1: PlayTheBlues4U (small blind) showed [Qd 4c] and lost with a pair of Queens
Seat 2: xxzuluzuluxx (big blind) folded on the Turn
Seat 4: michelina44 folded on the Flop (didn't bet)
Seat 5: catgotmytongue folded on the Flop
Seat 6: DruMoney201 (button) showed [7s 8s] and won ($0.62) with a flush, Eight high


PokerStars Hand #203589432230:  Hold'em No Limit ($0.01/$0.02 USD) - 2019/09/10 22:55:48 ET
Table 'Jabbah' 6-max Seat #6 is the button
Seat 2: TomT87 ($1.39 in chips)
Seat 3: PTuck626 ($1.91 in chips)
Seat 4: TroyBoy3912 ($2.66 in chips)
Seat 5: PlayTheBlues4U ($1.96 in chips)
Seat 6: Redkin20 ($1.41 in chips)
TomT87: posts small blind $0.01
PTuck626: posts big blind $0.02
*** HOLE CARDS ***
Dealt to PlayTheBlues4U [5h 3d]
TroyBoy3912: folds
PlayTheBlues4U: folds
Redkin20: calls $0.02
TomT87: calls $0.01
PTuck626: checks
*** FLOP *** [Jd 9s 7s]
TomT87: checks
DigBickBlad joins the table at seat #1
PTuck626: bets $0.04
Redkin20: folds
TomT87: calls $0.04
*** TURN *** [Jd 9s 7s] [Ad]
TomT87: checks
PTuck626: checks
*** RIVER *** [Jd 9s 7s Ad] [Th]
TomT87: checks
PTuck626: bets $0.15
TomT87: folds
Uncalled bet ($0.15) returned to PTuck626
PTuck626 collected $0.13 from pot
PTuck626: doesn't show hand
*** SUMMARY ***
Total pot $0.14 | Rake $0.01
Board [Jd 9s 7s Ad Th]
Seat 2: TomT87 (small blind) folded on the River
Seat 3: PTuck626 (big blind) collected ($0.13)
Seat 4: TroyBoy3912 folded before Flop (didn't bet)
Seat 5: PlayTheBlues4U folded before Flop (didn't bet)
Seat 6: Redkin20 (button) folded on the Flop


PokerStars Hand #203589432147:  Hold'em No Limit ($0.01/$0.02 USD) - 2019/09/10 22:55:07 ET
Table 'Orion' 6-max Seat #6 is the button
Seat 1: jford9099 ($1.89 in chips)
Seat 4: Smuggler1991 ($5.95 in chips)
Seat 6: PlayTheBlues4U ($1.98 in chips)
jford9099: posts small blind $0.01
Smuggler1991: posts big blind $0.02
*** HOLE CARDS ***
Dealt to PlayTheBlues4U [4s 3c]
PlayTheBlues4U: calls $0.02
jford9099: raises $0.04 to $0.06
Smuggler1991: folds
PlayTheBlues4U: calls $0.04
*** FLOP *** [Kh 4c 9c]
jford9099: checks
PlayTheBlues4U: checks
*** TURN *** [Kh 4c 9c] [3d]
jford9099: bets $0.02
PlayTheBlues4U: raises $0.08 to $0.10
Smuggler1991 leaves the table
jford9099: folds
Uncalled bet ($0.08) returned to PlayTheBlues4U
PlayTheBlues4U collected $0.17 from pot
PlayTheBlues4U: doesn't show hand
*** SUMMARY ***
Total pot $0.18 | Rake $0.01
Board [Kh 4c 9c 3d]
Seat 1: jford9099 (small blind) folded on the Turn
Seat 4: Smuggler1991 (big blind) folded before Flop
Seat 6: PlayTheBlues4U (button) collected ($0.17)


PokerStars Hand #203589432121:  Hold'em No Limit ($0.01/$0.02 USD) - 2019/09/10 22:54:55 ET
Table 'Rana' 6-max Seat #5 is the button
Seat 1: PlayTheBlues4U ($2.51 in chips)
Seat 2: xxzuluzuluxx ($0.79 in chips)
Seat 3: bigbluerodeo ($1.85 in chips)
Seat 5: catgotmytongue ($1.94 in chips)
Seat 6: DruMoney201 ($2.99 in chips)
DruMoney201: posts small blind $0.01
PlayTheBlues4U: posts big blind $0.02
*** HOLE CARDS ***
Dealt to PlayTheBlues4U [2c Qc]
xxzuluzuluxx: folds
michelina44 joins the table at seat #4
bigbluerodeo has timed out
bigbluerodeo: folds
catgotmytongue: folds
DruMoney201: calls $0.01
PlayTheBlues4U: checks
*** FLOP *** [8s 4d Jh]
DruMoney201: checks
PlayTheBlues4U: checks
*** TURN *** [8s 4d Jh] [Jc]
DruMoney201: checks
PlayTheBlues4U: checks
*** RIVER *** [8s 4d Jh Jc] [Tc]
DruMoney201: checks
PlayTheBlues4U: checks
*** SHOW DOWN ***
DruMoney201: shows [3c Qd] (a pair of Jacks)
PlayTheBlues4U: shows [2c Qc] (a pair of Jacks)
DruMoney201 collected $0.02 from pot
PlayTheBlues4U collected $0.02 from pot
*** SUMMARY ***
Total pot $0.04 | Rake $0
Board [8s 4d Jh Jc Tc]
Seat 1: PlayTheBlues4U (big blind) showed [2c Qc] and won ($0.02) with a pair of Jacks
Seat 2: xxzuluzuluxx folded before Flop (didn't bet)
Seat 3: bigbluerodeo folded before Flop (didn't bet)
Seat 5: catgotmytongue (button) folded before Flop (didn't bet)
Seat 6: DruMoney201 (small blind) showed [3c Qd] and won ($0.02) with a pair of Jacks


PokerStars Hand #203589432017:  Hold'em No Limit ($0.01/$0.02 USD) - 2019/09/10 22:54:21 ET
Table 'Rana' 6-max Seat #3 is the button
Seat 1: PlayTheBlues4U ($2.38 in chips)
Seat 2: xxzuluzuluxx ($0.80 in chips)
Seat 3: bigbluerodeo ($1.91 in chips)
Seat 4: LonLonMilk8 ($1.99 in chips)
Seat 5: catgotmytongue ($2 in chips)
Seat 6: DruMoney201 ($2.99 in chips)
LonLonMilk8: posts small blind $0.01
catgotmytongue: posts big blind $0.02
xxzuluzuluxx: posts small blind $0.01
*** HOLE CARDS ***
Dealt to PlayTheBlues4U [Ah As]
DruMoney201: folds
PlayTheBlues4U: raises $0.04 to $0.06
xxzuluzuluxx: folds
bigbluerodeo: calls $0.06
LonLonMilk8: folds
catgotmytongue: calls $0.04
*** FLOP *** [2s Ac 3d]
catgotmytongue: checks
PlayTheBlues4U: checks
LonLonMilk8 leaves the table
bigbluerodeo: checks
*** TURN *** [2s Ac 3d] [Kd]
catgotmytongue: checks
PlayTheBlues4U: bets $0.14
bigbluerodeo: folds
catgotmytongue: folds
Uncalled bet ($0.14) returned to PlayTheBlues4U
PlayTheBlues4U collected $0.19 from pot
PlayTheBlues4U: doesn't show hand
*** SUMMARY ***
Total pot $0.20 | Rake $0.01
Board [2s Ac 3d Kd]
Seat 1: PlayTheBlues4U collected ($0.19)
Seat 2: xxzuluzuluxx folded before Flop (didn't bet)
Seat 3: bigbluerodeo (button) folded on the Turn
Seat 4: LonLonMilk8 (small blind) folded before Flop
Seat 5: catgotmytongue (big blind) folded on the Turn
Seat 6: DruMoney201 folded before Flop (didn't bet)


PokerStars Hand #203588679918:  Hold'em No Limit ($0.01/$0.02 USD) - 2019/09/10 22:53:48 ET
Table 'Orion' 6-max Seat #4 is the button
Seat 1: jford9099 ($1.91 in chips)
Seat 2: maarketeer ($2.14 in chips)
Seat 4: Smuggler1991 ($5.88 in chips)
Seat 5: LonLonMilk8 ($1.53 in chips)
Seat 6: PlayTheBlues4U ($2 in chips)
LonLonMilk8: posts small blind $0.01
PlayTheBlues4U: posts big blind $0.02
*** HOLE CARDS ***
Dealt to PlayTheBlues4U [5c 2d]
jford9099: calls $0.02
maarketeer: calls $0.02
Smuggler1991: raises $0.09 to $0.11
LonLonMilk8: folds
PlayTheBlues4U: folds
jford9099: folds
maarketeer is disconnected
maarketeer has timed out while disconnected
maarketeer: folds
Uncalled bet ($0.09) returned to Smuggler1991
LonLonMilk8 leaves the table
Smuggler1991 collected $0.09 from pot
Smuggler1991: doesn't show hand
*** SUMMARY ***
Total pot $0.09 | Rake $0
Seat 1: jford9099 folded before Flop
Seat 2: maarketeer folded before Flop
Seat 4: Smuggler1991 (button) collected ($0.09)
Seat 5: LonLonMilk8 (small blind) folded before Flop
Seat 6: PlayTheBlues4U (big blind) folded before Flop


PokerStars Hand #203588679909:  Hold'em No Limit ($0.01/$0.02 USD) - 2019/09/10 22:53:46 ET
Table 'Rana' 6-max Seat #1 is the button
Seat 1: PlayTheBlues4U ($2.38 in chips)
Seat 3: bigbluerodeo ($1.92 in chips)
Seat 4: LonLonMilk8 ($2.01 in chips)
Seat 6: DruMoney201 ($2.96 in chips)
bigbluerodeo: posts small blind $0.01
LonLonMilk8: posts big blind $0.02
catgotmytongue: sits out
*** HOLE CARDS ***
Dealt to PlayTheBlues4U [4c 5d]
DruMoney201: calls $0.02
PlayTheBlues4U: folds
bigbluerodeo: folds
LonLonMilk8: checks
*** FLOP *** [Td 8c Th]
LonLonMilk8: checks
DruMoney201: bets $0.04
LonLonMilk8: folds
Uncalled bet ($0.04) returned to DruMoney201
DruMoney201 collected $0.05 from pot
DruMoney201: doesn't show hand
*** SUMMARY ***
Total pot $0.05 | Rake $0
Board [Td 8c Th]
Seat 1: PlayTheBlues4U (button) folded before Flop (didn't bet)
Seat 3: bigbluerodeo (small blind) folded before Flop
Seat 4: LonLonMilk8 (big blind) folded on the Flop
Seat 6: DruMoney201 collected ($0.05)


PokerStars Hand #203588679896:  Hold'em No Limit ($0.01/$0.02 USD) - 2019/09/10 22:53:42 ET
Table 'Jabbah' 6-max Seat #5 is the button
Seat 1: bigbluerodeo ($2.59 in chips)
Seat 2: TomT87 ($1.39 in chips)
Seat 3: PTuck626 ($1.82 in chips)
Seat 4: TroyBoy3912 ($2.66 in chips)
Seat 5: PlayTheBlues4U ($1.96 in chips)
Seat 6: Redkin20 ($1.49 in chips)
Redkin20: posts small blind $0.01
bigbluerodeo: posts big blind $0.02
*** HOLE CARDS ***
Dealt to PlayTheBlues4U [3s Jd]
TomT87: folds
PTuck626: calls $0.02
TroyBoy3912: folds
PlayTheBlues4U: folds
Redkin20: calls $0.01
bigbluerodeo: checks
*** FLOP *** [Ah 3h 8h]
Redkin20: checks
bigbluerodeo: checks
PTuck626: checks
*** TURN *** [Ah 3h 8h] [Td]
Redkin20: checks
bigbluerodeo: checks
PTuck626: bets $0.06
Redkin20: calls $0.06
bigbluerodeo: folds
*** RIVER *** [Ah 3h 8h Td] [5d]
bigbluerodeo leaves the table
Redkin20: checks
PTuck626: bets $0.20
Redkin20: folds
Uncalled bet ($0.20) returned to PTuck626
PTuck626 collected $0.17 from pot
PTuck626: doesn't show hand
*** SUMMARY ***
Total pot $0.18 | Rake $0.01
Board [Ah 3h 8h Td 5d]
Seat 1: bigbluerodeo (big blind) folded on the Turn
Seat 2: TomT87 folded before Flop (didn't bet)
Seat 3: PTuck626 collected ($0.17)
Seat 4: TroyBoy3912 folded before Flop (didn't bet)
Seat 5: PlayTheBlues4U (button) folded before Flop (didn't bet)
Seat 6: Redkin20 (small blind) folded on the River


PokerStars Hand #203588679712:  Hold'em No Limit ($0.01/$0.02 USD) - 2019/09/10 22:52:39 ET
Table 'Rana' 6-max Seat #6 is the button
Seat 1: PlayTheBlues4U ($2.40 in chips)
Seat 2: xxzuluzuluxx ($0.51 in chips)
Seat 3: bigbluerodeo ($1.92 in chips)
Seat 4: LonLonMilk8 ($2.04 in chips)
Seat 6: DruMoney201 ($2.45 in chips)
PlayTheBlues4U: posts small blind $0.01
xxzuluzuluxx: posts big blind $0.02
LonLonMilk8: posts small & big blinds $0.03
*** HOLE CARDS ***
Dealt to PlayTheBlues4U [Qc 3c]
catgotmytongue joins the table at seat #5
bigbluerodeo: folds
LonLonMilk8: checks
DruMoney201: calls $0.02
PlayTheBlues4U: calls $0.01
xxzuluzuluxx: checks
*** FLOP *** [5d Td 7s]
PlayTheBlues4U: checks
xxzuluzuluxx: bets $0.08
LonLonMilk8: folds
DruMoney201: calls $0.08
PlayTheBlues4U: folds
*** TURN *** [5d Td 7s] [9d]
xxzuluzuluxx: bets $0.12
DruMoney201: calls $0.12
*** RIVER *** [5d Td 7s 9d] [Th]
xxzuluzuluxx: bets $0.04
DruMoney201: raises $0.28 to $0.32
xxzuluzuluxx: calls $0.25 and is all-in
Uncalled bet ($0.03) returned to DruMoney201
*** SHOW DOWN ***
DruMoney201: shows [Ad 6d] (a flush, Ace high)
xxzuluzuluxx: shows [Tc 8c] (three of a kind, Tens)
DruMoney201 collected $1.02 from pot
*** SUMMARY ***
Total pot $1.07 | Rake $0.05
Board [5d Td 7s 9d Th]
Seat 1: PlayTheBlues4U (small blind) folded on the Flop
Seat 2: xxzuluzuluxx (big blind) showed [Tc 8c] and lost with three of a kind, Tens
Seat 3: bigbluerodeo folded before Flop (didn't bet)
Seat 4: LonLonMilk8 folded on the Flop (didn't bet)
Seat 6: DruMoney201 (button) showed [Ad 6d] and won ($1.02) with a flush, Ace high


PokerStars Hand #203588679630:  Hold'em No Limit ($0.01/$0.02 USD) - 2019/09/10 22:52:13 ET
Table 'Jabbah' 6-max Seat #4 is the button
Seat 1: bigbluerodeo ($2.65 in chips)
Seat 2: TomT87 ($1.39 in chips)
Seat 3: PTuck626 ($1.82 in chips)
Seat 4: TroyBoy3912 ($2.68 in chips)
Seat 5: PlayTheBlues4U ($1.98 in chips)
Seat 6: Redkin20 ($1.40 in chips)
PlayTheBlues4U: posts small blind $0.01
Redkin20: posts big blind $0.02
*** HOLE CARDS ***
Dealt to PlayTheBlues4U [2d 3c]
bigbluerodeo: calls $0.02
TomT87: folds
PTuck626: folds
TroyBoy3912: calls $0.02
PlayTheBlues4U: calls $0.01
Redkin20: raises $0.04 to $0.06
bigbluerodeo: calls $0.04
TroyBoy3912: folds
PlayTheBlues4U: folds
*** FLOP *** [3s Td 2h]
Redkin20: checks
bigbluerodeo: checks
*** TURN *** [3s Td 2h] [3h]
Redkin20: checks
bigbluerodeo: checks
*** RIVER *** [3s Td 2h 3h] [4h]
Redkin20: checks
bigbluerodeo: checks
*** SHOW DOWN ***
Redkin20: shows [Jc Kc] (a pair of Threes)
bigbluerodeo: mucks hand
Redkin20 collected $0.15 from pot
*** SUMMARY ***
Total pot $0.16 | Rake $0.01
Board [3s Td 2h 3h 4h]
Seat 1: bigbluerodeo mucked [Ks 8s]
Seat 2: TomT87 folded before Flop (didn't bet)
Seat 3: PTuck626 folded before Flop (didn't bet)
Seat 4: TroyBoy3912 (button) folded before Flop
Seat 5: PlayTheBlues4U (small blind) folded before Flop
Seat 6: Redkin20 (big blind) showed [Jc Kc] and won ($0.15) with a pair of Threes


PokerStars Hand #203588679535:  Hold'em No Limit ($0.01/$0.02 USD) - 2019/09/10 22:51:41 ET
Table 'Rana' 6-max Seat #3 is the button
Seat 1: PlayTheBlues4U ($2.38 in chips)
Seat 2: xxzuluzuluxx ($0.51 in chips)
Seat 3: bigbluerodeo ($1.92 in chips)
Seat 6: DruMoney201 ($2.47 in chips)
DruMoney201: posts small blind $0.01
PlayTheBlues4U: posts big blind $0.02
*** HOLE CARDS ***
Dealt to PlayTheBlues4U [7s Jc]
xxzuluzuluxx: folds
bigbluerodeo: folds
DruMoney201: calls $0.01
PlayTheBlues4U: checks
*** FLOP *** [2h Qc 4c]
DruMoney201: checks
PlayTheBlues4U: checks
*** TURN *** [2h Qc 4c] [Th]
DruMoney201: checks
PlayTheBlues4U: checks
*** RIVER *** [2h Qc 4c Th] [8d]
DruMoney201: checks
PlayTheBlues4U: checks
*** SHOW DOWN ***
DruMoney201: shows [6c 9s] (high card Queen)
PlayTheBlues4U: shows [7s Jc] (high card Queen - Jack kicker)
PlayTheBlues4U collected $0.04 from pot
*** SUMMARY ***
Total pot $0.04 | Rake $0
Board [2h Qc 4c Th 8d]
Seat 1: PlayTheBlues4U (big blind) showed [7s Jc] and won ($0.04) with high card Queen
Seat 2: xxzuluzuluxx folded before Flop (didn't bet)
Seat 3: bigbluerodeo (button) folded before Flop (didn't bet)
Seat 6: DruMoney201 (small blind) showed [6c 9s] and lost with high card Queen


PokerStars Hand #203588679378:  Hold'em No Limit ($0.01/$0.02 USD) - 2019/09/10 22:50:53 ET
Table 'Jabbah' 6-max Seat #3 is the button
Seat 1: bigbluerodeo ($2.65 in chips)
Seat 2: TomT87 ($1.28 in chips)
Seat 3: PTuck626 ($1.84 in chips)
Seat 4: TroyBoy3912 ($2.70 in chips)
Seat 5: PlayTheBlues4U ($2 in chips)
Seat 6: Redkin20 ($1.46 in chips)
TroyBoy3912: posts small blind $0.01
PlayTheBlues4U: posts big blind $0.02
*** HOLE CARDS ***
Dealt to PlayTheBlues4U [Kd 8d]
Redkin20: calls $0.02
bigbluerodeo: folds
TomT87: calls $0.02
PTuck626: calls $0.02
TroyBoy3912: calls $0.01
PlayTheBlues4U: checks
*** FLOP *** [5h 9d 9c]
TroyBoy3912: checks
PlayTheBlues4U: checks
Redkin20: checks
TomT87: bets $0.04
PTuck626: folds
TroyBoy3912: folds
PlayTheBlues4U: folds
Redkin20: calls $0.04
*** TURN *** [5h 9d 9c] [4h]
Redkin20: checks
TomT87: bets $0.08
Redkin20: folds
Uncalled bet ($0.08) returned to TomT87
TomT87 collected $0.17 from pot
TomT87: doesn't show hand
*** SUMMARY ***
Total pot $0.18 | Rake $0.01
Board [5h 9d 9c 4h]
Seat 1: bigbluerodeo folded before Flop (didn't bet)
Seat 2: TomT87 collected ($0.17)
Seat 3: PTuck626 (button) folded on the Flop
Seat 4: TroyBoy3912 (small blind) folded on the Flop
Seat 5: PlayTheBlues4U (big blind) folded on the Flop
Seat 6: Redkin20 folded on the Turn


PokerStars Hand #203588679172:  Hold'em No Limit ($0.01/$0.02 USD) - 2019/09/10 22:49:51 ET
Table 'Rana' 6-max Seat #5 is the button
Seat 2: xxzuluzuluxx ($0.55 in chips)
Seat 3: bigbluerodeo ($1.90 in chips)
Seat 4: LonLonMilk8 ($2.04 in chips)
Seat 5: PlayTheBlues4U ($2.38 in chips)
Seat 6: DruMoney201 ($2.46 in chips)
DruMoney201: posts small blind $0.01
xxzuluzuluxx: posts big blind $0.02
*** HOLE CARDS ***
Dealt to PlayTheBlues4U [4s Qs]
bigbluerodeo: folds
LonLonMilk8 has timed out
LonLonMilk8: folds
PlayTheBlues4U: folds
PlayTheBlues4U leaves the table
DruMoney201: calls $0.01
xxzuluzuluxx: checks
*** FLOP *** [2s 5s 6s]
DruMoney201: checks
xxzuluzuluxx: checks
*** TURN *** [2s 5s 6s] [6h]
DruMoney201: bets $0.02
xxzuluzuluxx: calls $0.02
*** RIVER *** [2s 5s 6s 6h] [2c]
DruMoney201: bets $0.02
xxzuluzuluxx: calls $0.02
*** SHOW DOWN ***
DruMoney201: shows [5h 3h] (two pair, Sixes and Fives)
xxzuluzuluxx: mucks hand
DruMoney201 collected $0.11 from pot
*** SUMMARY ***
Total pot $0.12 | Rake $0.01
Board [2s 5s 6s 6h 2c]
Seat 2: xxzuluzuluxx (big blind) mucked [7d Kh]
Seat 3: bigbluerodeo folded before Flop (didn't bet)
Seat 4: LonLonMilk8 folded before Flop (didn't bet)
Seat 5: PlayTheBlues4U (button) folded before Flop (didn't bet)
Seat 6: DruMoney201 (small blind) showed [5h 3h] and won ($0.11) with two pair, Sixes and Fives


PokerStars Hand #203588679071:  Hold'em No Limit ($0.01/$0.02 USD) - 2019/09/10 22:49:20 ET
Table 'Orion' 6-max Seat #3 is the button
Seat 1: jford9099 ($1.63 in chips)
Seat 2: maarketeer ($1.67 in chips)
Seat 3: bigbluerodeo ($2.80 in chips)
Seat 4: Smuggler1991 ($4.20 in chips)
Seat 5: LonLonMilk8 ($1.58 in chips)
Seat 6: PlayTheBlues4U ($1.91 in chips)
Smuggler1991: posts small blind $0.01
LonLonMilk8: posts big blind $0.02
*** HOLE CARDS ***
Dealt to PlayTheBlues4U [Jh Ks]
PlayTheBlues4U: folds
jford9099: raises $0.02 to $0.04
maarketeer: calls $0.04
bigbluerodeo: folds
Smuggler1991: folds
LonLonMilk8: folds
*** FLOP *** [8c 6h 6c]
jford9099: checks
maarketeer: bets $0.06
jford9099: calls $0.06
*** TURN *** [8c 6h 6c] [8s]
PlayTheBlues4U leaves the table
jford9099: checks
maarketeer: bets $0.22
jford9099: calls $0.22
*** RIVER *** [8c 6h 6c 8s] [9s]
jford9099: bets $0.32
maarketeer: raises $1.03 to $1.35 and is all-in
jford9099: folds
Uncalled bet ($1.03) returned to maarketeer
maarketeer collected $1.25 from pot
maarketeer: doesn't show hand
*** SUMMARY ***
Total pot $1.31 | Rake $0.06
Board [8c 6h 6c 8s 9s]
Seat 1: jford9099 folded on the River
Seat 2: maarketeer collected ($1.25)
Seat 3: bigbluerodeo (button) folded before Flop (didn't bet)
Seat 4: Smuggler1991 (small blind) folded before Flop
Seat 5: LonLonMilk8 (big blind) folded before Flop
Seat 6: PlayTheBlues4U folded before Flop (didn't bet)


PokerStars Hand #203588679042:  Hold'em No Limit ($0.01/$0.02 USD) - 2019/09/10 22:49:10 ET
Table 'Rana' 6-max Seat #4 is the button
Seat 1: delm44 ($1.82 in chips)
Seat 2: xxzuluzuluxx ($0.77 in chips)
Seat 3: bigbluerodeo ($1.90 in chips)
Seat 4: LonLonMilk8 ($2.04 in chips)
Seat 5: PlayTheBlues4U ($2.39 in chips)
Seat 6: DruMoney201 ($2.23 in chips)
PlayTheBlues4U: posts small blind $0.01
DruMoney201: posts big blind $0.02
*** HOLE CARDS ***
Dealt to PlayTheBlues4U [4c 8d]
delm44: calls $0.02
xxzuluzuluxx: calls $0.02
bigbluerodeo: folds
LonLonMilk8: folds
PlayTheBlues4U: folds
DruMoney201: checks
*** FLOP *** [2d 4s Jd]
DruMoney201: bets $0.20
delm44: folds
xxzuluzuluxx: calls $0.20
*** TURN *** [2d 4s Jd] [As]
delm44 leaves the table
DruMoney201: bets $0.44
xxzuluzuluxx: folds
Uncalled bet ($0.44) returned to DruMoney201
DruMoney201 collected $0.45 from pot
DruMoney201: doesn't show hand
*** SUMMARY ***
Total pot $0.47 | Rake $0.02
Board [2d 4s Jd As]
Seat 1: delm44 folded on the Flop
Seat 2: xxzuluzuluxx folded on the Turn
Seat 3: bigbluerodeo folded before Flop (didn't bet)
Seat 4: LonLonMilk8 (button) folded before Flop (didn't bet)
Seat 5: PlayTheBlues4U (small blind) folded before Flop
Seat 6: DruMoney201 (big blind) collected ($0.45)


PokerStars Hand #203588678966:  Hold'em No Limit ($0.01/$0.02 USD) - 2019/09/10 22:48:48 ET
Table 'Orion' 6-max Seat #2 is the button
Seat 1: jford9099 ($1.63 in chips)
Seat 2: maarketeer ($1.75 in chips)
Seat 3: bigbluerodeo ($2.82 in chips)
Seat 4: Smuggler1991 ($4.11 in chips)
Seat 5: LonLonMilk8 ($1.58 in chips)
Seat 6: PlayTheBlues4U ($1.91 in chips)
bigbluerodeo: posts small blind $0.01
Smuggler1991: posts big blind $0.02
*** HOLE CARDS ***
Dealt to PlayTheBlues4U [2s Jc]
LonLonMilk8: folds
PlayTheBlues4U: folds
jford9099: folds
maarketeer: calls $0.02
bigbluerodeo: calls $0.01
Smuggler1991: raises $0.06 to $0.08
maarketeer: calls $0.06
bigbluerodeo: folds
*** FLOP *** [4d 4h 3d]
Smuggler1991: bets $0.08
maarketeer: folds
Uncalled bet ($0.08) returned to Smuggler1991
Smuggler1991 collected $0.17 from pot
Smuggler1991: doesn't show hand
*** SUMMARY ***
Total pot $0.18 | Rake $0.01
Board [4d 4h 3d]
Seat 1: jford9099 folded before Flop (didn't bet)
Seat 2: maarketeer (button) folded on the Flop
Seat 3: bigbluerodeo (small blind) folded before Flop
Seat 4: Smuggler1991 (big blind) collected ($0.17)
Seat 5: LonLonMilk8 folded before Flop (didn't bet)
Seat 6: PlayTheBlues4U folded before Flop (didn't bet)


PokerStars Hand #203588678895:  Hold'em No Limit ($0.01/$0.02 USD) - 2019/09/10 22:48:23 ET
Table 'Rana' 6-max Seat #3 is the button
Seat 1: delm44 ($1.86 in chips)
Seat 2: xxzuluzuluxx ($0.77 in chips)
Seat 3: bigbluerodeo ($1.90 in chips)
Seat 4: LonLonMilk8 ($2.05 in chips)
Seat 5: PlayTheBlues4U ($2.34 in chips)
Seat 6: DruMoney201 ($2.23 in chips)
LonLonMilk8: posts small blind $0.01
PlayTheBlues4U: posts big blind $0.02
*** HOLE CARDS ***
Dealt to PlayTheBlues4U [4s Qs]
DruMoney201: folds
delm44: calls $0.02
xxzuluzuluxx: folds
bigbluerodeo: folds
LonLonMilk8: folds
PlayTheBlues4U: checks
*** FLOP *** [Qh Ks 8h]
PlayTheBlues4U: checks
delm44: checks
*** TURN *** [Qh Ks 8h] [6d]
PlayTheBlues4U: bets $0.02
delm44: calls $0.02
*** RIVER *** [Qh Ks 8h 6d] [9d]
PlayTheBlues4U: checks
delm44: checks
*** SHOW DOWN ***
PlayTheBlues4U: shows [4s Qs] (a pair of Queens)
delm44: mucks hand
PlayTheBlues4U collected $0.09 from pot
*** SUMMARY ***
Total pot $0.09 | Rake $0
Board [Qh Ks 8h 6d 9d]
Seat 1: delm44 mucked [6c Ad]
Seat 2: xxzuluzuluxx folded before Flop (didn't bet)
Seat 3: bigbluerodeo (button) folded before Flop (didn't bet)
Seat 4: LonLonMilk8 (small blind) folded before Flop
Seat 5: PlayTheBlues4U (big blind) showed [4s Qs] and won ($0.09) with a pair of Queens
Seat 6: DruMoney201 folded before Flop (didn't bet)


PokerStars Hand #203588678849:  Hold'em No Limit ($0.01/$0.02 USD) - 2019/09/10 22:48:08 ET
Table 'Orion' 6-max Seat #1 is the button
Seat 1: jford9099 ($1.65 in chips)
Seat 2: maarketeer ($1.69 in chips)
Seat 3: bigbluerodeo ($2.84 in chips)
Seat 4: Smuggler1991 ($4.11 in chips)
Seat 5: LonLonMilk8 ($1.60 in chips)
Seat 6: PlayTheBlues4U ($1.91 in chips)
maarketeer: posts small blind $0.01
bigbluerodeo: posts big blind $0.02
LonLonMilk8: posts big blind $0.02
*** HOLE CARDS ***
Dealt to PlayTheBlues4U [7d 9h]
Smuggler1991: folds
LonLonMilk8: checks
PlayTheBlues4U: folds
jford9099: calls $0.02
maarketeer: raises $0.08 to $0.10
bigbluerodeo: folds
LonLonMilk8: folds
jford9099: folds
Uncalled bet ($0.08) returned to maarketeer
maarketeer collected $0.08 from pot
maarketeer: doesn't show hand
*** SUMMARY ***
Total pot $0.08 | Rake $0
Seat 1: jford9099 (button) folded before Flop
Seat 2: maarketeer (small blind) collected ($0.08)
Seat 3: bigbluerodeo (big blind) folded before Flop
Seat 4: Smuggler1991 folded before Flop (didn't bet)
Seat 5: LonLonMilk8 folded before Flop (didn't bet)
Seat 6: PlayTheBlues4U folded before Flop (didn't bet)


PokerStars Hand #203588678758:  Hold'em No Limit ($0.01/$0.02 USD) - 2019/09/10 22:47:39 ET
Table 'Orion' 6-max Seat #6 is the button
Seat 1: jford9099 ($1.66 in chips)
Seat 2: maarketeer ($1.64 in chips)
Seat 3: bigbluerodeo ($2.84 in chips)
Seat 4: Smuggler1991 ($4.11 in chips)
Seat 6: PlayTheBlues4U ($1.95 in chips)
jford9099: posts small blind $0.01
maarketeer: posts big blind $0.02
LonLonMilk8: sits out
*** HOLE CARDS ***
Dealt to PlayTheBlues4U [9h 4s]
bigbluerodeo: folds
Smuggler1991: folds
PlayTheBlues4U: raises $0.02 to $0.04
jford9099: folds
maarketeer: calls $0.02
*** FLOP *** [Th Kc 3c]
maarketeer: bets $0.04
PlayTheBlues4U: folds
Uncalled bet ($0.04) returned to maarketeer
maarketeer collected $0.09 from pot
maarketeer: doesn't show hand
*** SUMMARY ***
Total pot $0.09 | Rake $0
Board [Th Kc 3c]
Seat 1: jford9099 (small blind) folded before Flop
Seat 2: maarketeer (big blind) collected ($0.09)
Seat 3: bigbluerodeo folded before Flop (didn't bet)
Seat 4: Smuggler1991 folded before Flop (didn't bet)
Seat 6: PlayTheBlues4U (button) folded on the Flop


PokerStars Hand #203588678708:  Hold'em No Limit ($0.01/$0.02 USD) - 2019/09/10 22:47:23 ET
Table 'Rana' 6-max Seat #2 is the button
Seat 1: delm44 ($1.64 in chips)
Seat 2: xxzuluzuluxx ($0.77 in chips)
Seat 3: bigbluerodeo ($1.91 in chips)
Seat 4: LonLonMilk8 ($2.07 in chips)
Seat 5: PlayTheBlues4U ($2.55 in chips)
Seat 6: DruMoney201 ($2.23 in chips)
bigbluerodeo: posts small blind $0.01
LonLonMilk8: posts big blind $0.02
*** HOLE CARDS ***
Dealt to PlayTheBlues4U [6h 5h]
PlayTheBlues4U: raises $0.04 to $0.06
DruMoney201: folds
delm44: raises $0.15 to $0.21
xxzuluzuluxx: folds
bigbluerodeo: folds
LonLonMilk8: folds
PlayTheBlues4U: calls $0.15
*** FLOP *** [Qh 8d 2c]
PlayTheBlues4U: checks
delm44: bets $0.22
PlayTheBlues4U: folds
Uncalled bet ($0.22) returned to delm44
delm44 collected $0.43 from pot
delm44: doesn't show hand
*** SUMMARY ***
Total pot $0.45 | Rake $0.02
Board [Qh 8d 2c]
Seat 1: delm44 collected ($0.43)
Seat 2: xxzuluzuluxx (button) folded before Flop (didn't bet)
Seat 3: bigbluerodeo (small blind) folded before Flop
Seat 4: LonLonMilk8 (big blind) folded before Flop
Seat 5: PlayTheBlues4U folded on the Flop
Seat 6: DruMoney201 folded before Flop (didn't bet)


PokerStars Hand #203588678554:  Hold'em No Limit ($0.01/$0.02 USD) - 2019/09/10 22:46:36 ET
Table 'Rana' 6-max Seat #1 is the button
Seat 1: delm44 ($1.71 in chips)
Seat 2: xxzuluzuluxx ($0.78 in chips)
Seat 3: bigbluerodeo ($1.93 in chips)
Seat 4: LonLonMilk8 ($1.98 in chips)
Seat 5: PlayTheBlues4U ($2.55 in chips)
Seat 6: DruMoney201 ($2.23 in chips)
xxzuluzuluxx: posts small blind $0.01
bigbluerodeo: posts big blind $0.02
*** HOLE CARDS ***
Dealt to PlayTheBlues4U [Ac 2s]
LonLonMilk8: raises $0.05 to $0.07
PlayTheBlues4U: folds
DruMoney201: folds
delm44: calls $0.07
xxzuluzuluxx: folds
bigbluerodeo: folds
*** FLOP *** [3d Ad Ts]
LonLonMilk8: bets $0.12
delm44: folds
Uncalled bet ($0.12) returned to LonLonMilk8
LonLonMilk8 collected $0.16 from pot
LonLonMilk8: doesn't show hand
*** SUMMARY ***
Total pot $0.17 | Rake $0.01
Board [3d Ad Ts]
Seat 1: delm44 (button) folded on the Flop
Seat 2: xxzuluzuluxx (small blind) folded before Flop
Seat 3: bigbluerodeo (big blind) folded before Flop
Seat 4: LonLonMilk8 collected ($0.16)
Seat 5: PlayTheBlues4U folded before Flop (didn't bet)
Seat 6: DruMoney201 folded before Flop (didn't bet)


PokerStars Hand #203588678474:  Hold'em No Limit ($0.01/$0.02 USD) - 2019/09/10 22:46:11 ET
Table 'Orion' 6-max Seat #4 is the button
Seat 1: jford9099 ($1.66 in chips)
Seat 2: maarketeer ($1.44 in chips)
Seat 3: bigbluerodeo ($2.84 in chips)
Seat 4: Smuggler1991 ($4.30 in chips)
Seat 5: GrowSomeNutz ($2.48 in chips)
Seat 6: PlayTheBlues4U ($1.97 in chips)
GrowSomeNutz: posts small blind $0.01
PlayTheBlues4U: posts big blind $0.02
*** HOLE CARDS ***
Dealt to PlayTheBlues4U [Td Qs]
jford9099 has timed out
jford9099: folds
maarketeer: calls $0.02
bigbluerodeo: folds
Smuggler1991: raises $0.07 to $0.09
GrowSomeNutz: folds
PlayTheBlues4U: folds
maarketeer: calls $0.07
*** FLOP *** [8s 9d 2h]
GrowSomeNutz leaves the table
LonLonMilk8 joins the table at seat #5
maarketeer: checks
Smuggler1991: bets $0.10
maarketeer: calls $0.10
*** TURN *** [8s 9d 2h] [Ts]
maarketeer: checks
Smuggler1991: checks
*** RIVER *** [8s 9d 2h Ts] [3s]
maarketeer: bets $0.20
Smuggler1991: folds
Uncalled bet ($0.20) returned to maarketeer
maarketeer collected $0.39 from pot
maarketeer: doesn't show hand
*** SUMMARY ***
Total pot $0.41 | Rake $0.02
Board [8s 9d 2h Ts 3s]
Seat 1: jford9099 folded before Flop (didn't bet)
Seat 2: maarketeer collected ($0.39)
Seat 3: bigbluerodeo folded before Flop (didn't bet)
Seat 4: Smuggler1991 (button) folded on the River
Seat 5: GrowSomeNutz (small blind) folded before Flop
Seat 6: PlayTheBlues4U (big blind) folded before Flop


PokerStars Hand #203588678444:  Hold'em No Limit ($0.01/$0.02 USD) - 2019/09/10 22:46:03 ET
Table 'Rana' 6-max Seat #6 is the button
Seat 1: delm44 ($1.72 in chips)
Seat 2: xxzuluzuluxx ($0.80 in chips)
Seat 3: bigbluerodeo ($1.93 in chips)
Seat 4: LonLonMilk8 ($2 in chips)
Seat 5: PlayTheBlues4U ($2.55 in chips)
Seat 6: DruMoney201 ($2.18 in chips)
delm44: posts small blind $0.01
xxzuluzuluxx: posts big blind $0.02
LonLonMilk8: posts big blind $0.02
*** HOLE CARDS ***
Dealt to PlayTheBlues4U [3d 2s]
bigbluerodeo: folds
LonLonMilk8: checks
PlayTheBlues4U: folds
DruMoney201: raises $0.07 to $0.09
delm44: folds
xxzuluzuluxx: folds
LonLonMilk8: folds
Uncalled bet ($0.07) returned to DruMoney201
DruMoney201 collected $0.07 from pot
DruMoney201: doesn't show hand
*** SUMMARY ***
Total pot $0.07 | Rake $0
Seat 1: delm44 (small blind) folded before Flop
Seat 2: xxzuluzuluxx (big blind) folded before Flop
Seat 3: bigbluerodeo folded before Flop (didn't bet)
Seat 4: LonLonMilk8 folded before Flop (didn't bet)
Seat 5: PlayTheBlues4U folded before Flop (didn't bet)
Seat 6: DruMoney201 (button) collected ($0.07)


PokerStars Hand #203588678251:  Hold'em No Limit ($0.01/$0.02 USD) - 2019/09/10 22:45:05 ET
Table 'Orion' 6-max Seat #3 is the button
Seat 1: jford9099 ($1.66 in chips)
Seat 2: maarketeer ($1.54 in chips)
Seat 3: bigbluerodeo ($3.24 in chips)
Seat 4: Smuggler1991 ($4.32 in chips)
Seat 5: GrowSomeNutz ($2 in chips)
Seat 6: PlayTheBlues4U ($1.97 in chips)
Smuggler1991: posts small blind $0.01
GrowSomeNutz: posts big blind $0.02
*** HOLE CARDS ***
Dealt to PlayTheBlues4U [4d 8d]
PlayTheBlues4U: folds
jford9099: folds
maarketeer: calls $0.02
bigbluerodeo: calls $0.02
Smuggler1991: calls $0.01
GrowSomeNutz: checks
*** FLOP *** [Qc 4h 3c]
Smuggler1991: checks
GrowSomeNutz: bets $0.08
maarketeer: calls $0.08
bigbluerodeo: calls $0.08
Smuggler1991: folds
*** TURN *** [Qc 4h 3c] [Jd]
GrowSomeNutz: bets $0.30
maarketeer: folds
bigbluerodeo: calls $0.30
*** RIVER *** [Qc 4h 3c Jd] [5d]
GrowSomeNutz: checks
bigbluerodeo: checks
*** SHOW DOWN ***
GrowSomeNutz: shows [Qh 8h] (a pair of Queens)
bigbluerodeo: mucks hand
GrowSomeNutz collected $0.88 from pot
*** SUMMARY ***
Total pot $0.92 | Rake $0.04
Board [Qc 4h 3c Jd 5d]
Seat 1: jford9099 folded before Flop (didn't bet)
Seat 2: maarketeer folded on the Turn
Seat 3: bigbluerodeo (button) mucked [5c 9c]
Seat 4: Smuggler1991 (small blind) folded on the Flop
Seat 5: GrowSomeNutz (big blind) showed [Qh 8h] and won ($0.88) with a pair of Queens
Seat 6: PlayTheBlues4U folded before Flop (didn't bet)


PokerStars Hand #203588678208:  Hold'em No Limit ($0.01/$0.02 USD) - 2019/09/10 22:44:53 ET
Table 'Rana' 6-max Seat #5 is the button
Seat 1: delm44 ($1.71 in chips)
Seat 3: bigbluerodeo ($1.95 in chips)
Seat 5: PlayTheBlues4U ($2.55 in chips)
Seat 6: DruMoney201 ($2.17 in chips)
DruMoney201: posts small blind $0.01
delm44: posts big blind $0.02
LonLonMilk8: sits out
*** HOLE CARDS ***
Dealt to PlayTheBlues4U [9d 4c]
bigbluerodeo: calls $0.02
PlayTheBlues4U: folds
DruMoney201: calls $0.01
delm44: checks
*** FLOP *** [Jc Jd Ac]
DruMoney201: checks
delm44: checks
bigbluerodeo: checks
*** TURN *** [Jc Jd Ac] [8h]
DruMoney201: checks
delm44: checks
bigbluerodeo: checks
*** RIVER *** [Jc Jd Ac 8h] [2h]
DruMoney201: checks
delm44: checks
bigbluerodeo: checks
*** SHOW DOWN ***
DruMoney201: shows [Ts 8c] (two pair, Jacks and Eights)
delm44: shows [Kd 8d] (two pair, Jacks and Eights)
bigbluerodeo: mucks hand
DruMoney201 collected $0.03 from pot
delm44 collected $0.03 from pot
xxzuluzuluxx joins the table at seat #2
*** SUMMARY ***
Total pot $0.06 | Rake $0
Board [Jc Jd Ac 8h 2h]
Seat 1: delm44 (big blind) showed [Kd 8d] and won ($0.03) with two pair, Jacks and Eights
Seat 3: bigbluerodeo mucked [7s 4s]
Seat 5: PlayTheBlues4U (button) folded before Flop (didn't bet)
Seat 6: DruMoney201 (small blind) showed [Ts 8c] and won ($0.03) with two pair, Jacks and Eights


PokerStars Hand #203588678154:  Hold'em No Limit ($0.01/$0.02 USD) - 2019/09/10 22:44:34 ET
Table 'Rana' 6-max Seat #3 is the button
Seat 1: delm44 ($1.71 in chips)
Seat 3: bigbluerodeo ($1.95 in chips)
Seat 5: PlayTheBlues4U ($2.53 in chips)
Seat 6: DruMoney201 ($2.19 in chips)
LonLonMilk8 will be allowed to play after the button
PlayTheBlues4U: posts small blind $0.01
DruMoney201: posts big blind $0.02
*** HOLE CARDS ***
Dealt to PlayTheBlues4U [4h 5s]
delm44: folds
bigbluerodeo: folds
PlayTheBlues4U: calls $0.01
vgctmg leaves the table
DruMoney201: checks
*** FLOP *** [Ac Jh 5h]
PlayTheBlues4U: bets $0.02
DruMoney201: folds
Uncalled bet ($0.02) returned to PlayTheBlues4U
PlayTheBlues4U collected $0.04 from pot
PlayTheBlues4U: doesn't show hand
*** SUMMARY ***
Total pot $0.04 | Rake $0
Board [Ac Jh 5h]
Seat 1: delm44 folded before Flop (didn't bet)
Seat 3: bigbluerodeo (button) folded before Flop (didn't bet)
Seat 5: PlayTheBlues4U (small blind) collected ($0.04)
Seat 6: DruMoney201 (big blind) folded on the Flop


PokerStars Hand #203588678070:  Hold'em No Limit ($0.01/$0.02 USD) - 2019/09/10 22:44:11 ET
Table 'Orion' 6-max Seat #2 is the button
Seat 1: jford9099 ($1.66 in chips)
Seat 2: maarketeer ($1.62 in chips)
Seat 3: bigbluerodeo ($3.15 in chips)
Seat 4: Smuggler1991 ($4.34 in chips)
Seat 6: PlayTheBlues4U ($1.97 in chips)
bigbluerodeo: posts small blind $0.01
Smuggler1991: posts big blind $0.02
GrowSomeNutz: sits out
*** HOLE CARDS ***
Dealt to PlayTheBlues4U [4c 3d]
PlayTheBlues4U: folds
jford9099: folds
maarketeer: calls $0.02
bigbluerodeo: calls $0.01
Smuggler1991: checks
*** FLOP *** [Ad Td 3h]
bigbluerodeo: bets $0.06
Smuggler1991: folds
maarketeer: calls $0.06
*** TURN *** [Ad Td 3h] [Qc]
bigbluerodeo: checks
maarketeer: checks
*** RIVER *** [Ad Td 3h Qc] [Ah]
bigbluerodeo: checks
maarketeer: checks
*** SHOW DOWN ***
bigbluerodeo: shows [Tc 2c] (two pair, Aces and Tens)
maarketeer: mucks hand
bigbluerodeo collected $0.17 from pot
*** SUMMARY ***
Total pot $0.18 | Rake $0.01
Board [Ad Td 3h Qc Ah]
Seat 1: jford9099 folded before Flop (didn't bet)
Seat 2: maarketeer (button) mucked [5d 9d]
Seat 3: bigbluerodeo (small blind) showed [Tc 2c] and won ($0.17) with two pair, Aces and Tens
Seat 4: Smuggler1991 (big blind) folded on the Flop
Seat 6: PlayTheBlues4U folded before Flop (didn't bet)


PokerStars Hand #203588677956:  Hold'em No Limit ($0.01/$0.02 USD) - 2019/09/10 22:43:35 ET
Table 'Orion' 6-max Seat #1 is the button
Seat 1: jford9099 ($1.62 in chips)
Seat 2: maarketeer ($1.64 in chips)
Seat 3: bigbluerodeo ($3.17 in chips)
Seat 4: Smuggler1991 ($4.34 in chips)
Seat 6: PlayTheBlues4U ($1.97 in chips)
maarketeer: posts small blind $0.01
bigbluerodeo: posts big blind $0.02
GrowSomeNutz: sits out
*** HOLE CARDS ***
Dealt to PlayTheBlues4U [4h 7s]
Smuggler1991: folds
PlayTheBlues4U: folds
jford9099: calls $0.02
maarketeer: calls $0.01
bigbluerodeo: checks
*** FLOP *** [Kd 5c Ah]
maarketeer: checks
bigbluerodeo: checks
jford9099: bets $0.04
maarketeer: folds
bigbluerodeo: folds
Uncalled bet ($0.04) returned to jford9099
jford9099 collected $0.06 from pot
jford9099: doesn't show hand
*** SUMMARY ***
Total pot $0.06 | Rake $0
Board [Kd 5c Ah]
Seat 1: jford9099 (button) collected ($0.06)
Seat 2: maarketeer (small blind) folded on the Flop
Seat 3: bigbluerodeo (big blind) folded on the Flop
Seat 4: Smuggler1991 folded before Flop (didn't bet)
Seat 6: PlayTheBlues4U folded before Flop (didn't bet)


PokerStars Hand #203588677928:  Hold'em No Limit ($0.01/$0.02 USD) - 2019/09/10 22:43:27 ET
Table 'Rana' 6-max Seat #2 is the button
Seat 1: delm44 ($1.63 in chips)
Seat 2: vgctmg ($0.69 in chips)
Seat 3: bigbluerodeo ($1.97 in chips)
Seat 5: PlayTheBlues4U ($2.55 in chips)
Seat 6: DruMoney201 ($2.21 in chips)
bigbluerodeo: posts small blind $0.01
PlayTheBlues4U: posts big blind $0.02
*** HOLE CARDS ***
Dealt to PlayTheBlues4U [6s 5c]
DruMoney201: calls $0.02
delm44: calls $0.02
vgctmg: calls $0.02
bigbluerodeo: calls $0.01
PlayTheBlues4U: checks
*** FLOP *** [Jc 4s As]
bigbluerodeo: checks
PlayTheBlues4U: checks
DruMoney201: checks
delm44: checks
vgctmg: checks
*** TURN *** [Jc 4s As] [Qs]
bigbluerodeo: checks
PlayTheBlues4U: checks
DruMoney201: checks
delm44: checks
vgctmg: checks
*** RIVER *** [Jc 4s As Qs] [2h]
bigbluerodeo: checks
PlayTheBlues4U: checks
DruMoney201: checks
delm44: checks
vgctmg: checks
*** SHOW DOWN ***
bigbluerodeo: shows [4c 3d] (a pair of Fours)
PlayTheBlues4U: mucks hand
DruMoney201: mucks hand
delm44: shows [8s 8h] (a pair of Eights)
vgctmg: mucks hand
delm44 collected $0.10 from pot
LonLonMilk8 joins the table at seat #4
*** SUMMARY ***
Total pot $0.10 | Rake $0
Board [Jc 4s As Qs 2h]
Seat 1: delm44 showed [8s 8h] and won ($0.10) with a pair of Eights
Seat 2: vgctmg (button) mucked [Kc 7s]
Seat 3: bigbluerodeo (small blind) showed [4c 3d] and lost with a pair of Fours
Seat 5: PlayTheBlues4U (big blind) mucked [6s 5c]
Seat 6: DruMoney201 mucked [7c 6c]


PokerStars Hand #203588677788:  Hold'em No Limit ($0.01/$0.02 USD) - 2019/09/10 22:42:44 ET
Table 'Rana' 6-max Seat #1 is the button
Seat 1: delm44 ($1.63 in chips)
Seat 2: vgctmg ($0.71 in chips)
Seat 3: bigbluerodeo ($1.99 in chips)
Seat 4: Sparseeye ($1.49 in chips)
Seat 5: PlayTheBlues4U ($2.55 in chips)
Seat 6: DruMoney201 ($2.17 in chips)
vgctmg: posts small blind $0.01
bigbluerodeo: posts big blind $0.02
*** HOLE CARDS ***
Dealt to PlayTheBlues4U [4c 8d]
Sparseeye: folds
PlayTheBlues4U: folds
DruMoney201: calls $0.02
delm44: folds
vgctmg: calls $0.01
bigbluerodeo: checks
*** FLOP *** [Jc 6c Jd]
vgctmg: checks
bigbluerodeo: checks
Sparseeye leaves the table
DruMoney201: bets $0.06
vgctmg: folds
bigbluerodeo: folds
Uncalled bet ($0.06) returned to DruMoney201
DruMoney201 collected $0.06 from pot
DruMoney201: doesn't show hand
*** SUMMARY ***
Total pot $0.06 | Rake $0
Board [Jc 6c Jd]
Seat 1: delm44 (button) folded before Flop (didn't bet)
Seat 2: vgctmg (small blind) folded on the Flop
Seat 3: bigbluerodeo (big blind) folded on the Flop
Seat 4: Sparseeye folded before Flop (didn't bet)
Seat 5: PlayTheBlues4U folded before Flop (didn't bet)
Seat 6: DruMoney201 collected ($0.06)


PokerStars Hand #203588677781:  Hold'em No Limit ($0.01/$0.02 USD) - 2019/09/10 22:42:41 ET
Table 'Orion' 6-max Seat #6 is the button
Seat 1: jford9099 ($1.79 in chips)
Seat 2: maarketeer ($1.42 in chips)
Seat 3: bigbluerodeo ($3.17 in chips)
Seat 4: Smuggler1991 ($4.41 in chips)
Seat 6: PlayTheBlues4U ($1.97 in chips)
jford9099: posts small blind $0.01
maarketeer: posts big blind $0.02
GrowSomeNutz: sits out
*** HOLE CARDS ***
Dealt to PlayTheBlues4U [Kc 6d]
bigbluerodeo: folds
Smuggler1991: raises $0.05 to $0.07
PlayTheBlues4U: folds
jford9099: calls $0.06
maarketeer: calls $0.05
*** FLOP *** [7d Qs Ts]
jford9099: bets $0.10
maarketeer: raises $0.20 to $0.30
Smuggler1991: folds
jford9099: folds
Uncalled bet ($0.20) returned to maarketeer
maarketeer collected $0.39 from pot
maarketeer: doesn't show hand
*** SUMMARY ***
Total pot $0.41 | Rake $0.02
Board [7d Qs Ts]
Seat 1: jford9099 (small blind) folded on the Flop
Seat 2: maarketeer (big blind) collected ($0.39)
Seat 3: bigbluerodeo folded before Flop (didn't bet)
Seat 4: Smuggler1991 folded on the Flop
Seat 6: PlayTheBlues4U (button) folded before Flop (didn't bet)


PokerStars Hand #203588677614:  Hold'em No Limit ($0.01/$0.02 USD) - 2019/09/10 22:41:43 ET
Table 'Rana' 6-max Seat #6 is the button
Seat 1: delm44 ($1.64 in chips)
Seat 2: vgctmg ($0.77 in chips)
Seat 3: bigbluerodeo ($1.78 in chips)
Seat 4: Sparseeye ($1.49 in chips)
Seat 5: PlayTheBlues4U ($2.71 in chips)
Seat 6: DruMoney201 ($2.17 in chips)
delm44: posts small blind $0.01
vgctmg: posts big blind $0.02
*** HOLE CARDS ***
Dealt to PlayTheBlues4U [Td Kd]
bigbluerodeo: calls $0.02
vgctmg said, "ugh"
Sparseeye: folds
PlayTheBlues4U: raises $0.04 to $0.06
DruMoney201: folds
delm44: folds
vgctmg: calls $0.04
bigbluerodeo: calls $0.04
*** FLOP *** [Qc 6c 5s]
vgctmg: checks
bigbluerodeo: checks
PlayTheBlues4U: checks
*** TURN *** [Qc 6c 5s] [5h]
vgctmg: checks
bigbluerodeo: checks
PlayTheBlues4U: checks
*** RIVER *** [Qc 6c 5s 5h] [5c]
vgctmg: checks
bigbluerodeo: bets $0.10
PlayTheBlues4U: calls $0.10
vgctmg: folds
*** SHOW DOWN ***
bigbluerodeo: shows [Ac 2c] (a flush, Ace high)
PlayTheBlues4U: mucks hand
bigbluerodeo collected $0.37 from pot
*** SUMMARY ***
Total pot $0.39 | Rake $0.02
Board [Qc 6c 5s 5h 5c]
Seat 1: delm44 (small blind) folded before Flop
Seat 2: vgctmg (big blind) folded on the River
Seat 3: bigbluerodeo showed [Ac 2c] and won ($0.37) with a flush, Ace high
Seat 4: Sparseeye folded before Flop (didn't bet)
Seat 5: PlayTheBlues4U mucked [Td Kd]
Seat 6: DruMoney201 (button) folded before Flop (didn't bet)


PokerStars Hand #203588677564:  Hold'em No Limit ($0.01/$0.02 USD) - 2019/09/10 22:41:29 ET
Table 'Orion' 6-max Seat #4 is the button
Seat 1: jford9099 ($1.81 in chips)
Seat 2: maarketeer ($1.99 in chips)
Seat 3: bigbluerodeo ($2.62 in chips)
Seat 4: Smuggler1991 ($4.41 in chips)
Seat 6: PlayTheBlues4U ($1.98 in chips)
PlayTheBlues4U: posts small blind $0.01
jford9099: posts big blind $0.02
*** HOLE CARDS ***
Dealt to PlayTheBlues4U [3d Ks]
maarketeer: calls $0.02
bigbluerodeo: raises $0.07 to $0.09
erickcoelho22 leaves the table
Smuggler1991: folds
PlayTheBlues4U: folds
GrowSomeNutz joins the table at seat #5
jford9099: folds
maarketeer: calls $0.07
*** FLOP *** [Ts Kd As]
maarketeer: checks
bigbluerodeo: bets $0.20
maarketeer: calls $0.20
*** TURN *** [Ts Kd As] [4c]
maarketeer: bets $0.28
bigbluerodeo: calls $0.28
*** RIVER *** [Ts Kd As 4c] [4h]
maarketeer: checks
bigbluerodeo: checks
*** SHOW DOWN ***
maarketeer: shows [5c 5d] (two pair, Fives and Fours)
bigbluerodeo: shows [Ac Qd] (two pair, Aces and Fours)
bigbluerodeo collected $1.12 from pot
*** SUMMARY ***
Total pot $1.17 | Rake $0.05
Board [Ts Kd As 4c 4h]
Seat 1: jford9099 (big blind) folded before Flop
Seat 2: maarketeer showed [5c 5d] and lost with two pair, Fives and Fours
Seat 3: bigbluerodeo showed [Ac Qd] and won ($1.12) with two pair, Aces and Fours
Seat 4: Smuggler1991 (button) folded before Flop (didn't bet)
Seat 6: PlayTheBlues4U (small blind) folded before Flop


PokerStars Hand #203588677373:  Hold'em No Limit ($0.01/$0.02 USD) - 2019/09/10 22:40:24 ET
Table 'Orion' 6-max Seat #3 is the button
Seat 1: jford9099 ($1.83 in chips)
Seat 2: maarketeer ($2.15 in chips)
Seat 3: bigbluerodeo ($2.62 in chips)
Seat 4: Smuggler1991 ($2.42 in chips)
Seat 5: erickcoelho22 ($2 in chips)
Seat 6: PlayTheBlues4U ($1.98 in chips)
Smuggler1991: posts small blind $0.01
erickcoelho22: posts big blind $0.02
*** HOLE CARDS ***
Dealt to PlayTheBlues4U [2s Ts]
PlayTheBlues4U: folds
jford9099: calls $0.02
maarketeer: raises $0.02 to $0.04
bigbluerodeo: folds
Smuggler1991: raises $0.12 to $0.16
erickcoelho22: calls $0.14
jford9099: folds
maarketeer: calls $0.12
*** FLOP *** [5c 2c 7c]
Smuggler1991: bets $0.24
erickcoelho22: calls $0.24
maarketeer: folds
*** TURN *** [5c 2c 7c] [2d]
Smuggler1991: checks
erickcoelho22: checks
*** RIVER *** [5c 2c 7c 2d] [6c]
Smuggler1991: bets $0.46
erickcoelho22: raises $1.14 to $1.60 and is all-in
Smuggler1991: calls $1.14
*** SHOW DOWN ***
erickcoelho22: shows [6s 7s] (two pair, Sevens and Sixes)
Smuggler1991: shows [Jc Kh] (a flush, Jack high)
Smuggler1991 collected $3.99 from pot
*** SUMMARY ***
Total pot $4.18 | Rake $0.19
Board [5c 2c 7c 2d 6c]
Seat 1: jford9099 folded before Flop
Seat 2: maarketeer folded on the Flop
Seat 3: bigbluerodeo (button) folded before Flop (didn't bet)
Seat 4: Smuggler1991 (small blind) showed [Jc Kh] and won ($3.99) with a flush, Jack high
Seat 5: erickcoelho22 (big blind) showed [6s 7s] and lost with two pair, Sevens and Sixes
Seat 6: PlayTheBlues4U folded before Flop (didn't bet)


PokerStars Hand #203588677237:  Hold'em No Limit ($0.01/$0.02 USD) - 2019/09/10 22:39:40 ET
Table 'Orion' 6-max Seat #2 is the button
Seat 1: jford9099 ($1.85 in chips)
Seat 2: maarketeer ($2.15 in chips)
Seat 3: bigbluerodeo ($2.64 in chips)
Seat 4: Smuggler1991 ($2.38 in chips)
Seat 6: PlayTheBlues4U ($1.98 in chips)
bigbluerodeo: posts small blind $0.01
Smuggler1991: posts big blind $0.02
*** HOLE CARDS ***
Dealt to PlayTheBlues4U [Jc 4s]
PlayTheBlues4U: folds
jford9099: calls $0.02
maarketeer: folds
bigbluerodeo: calls $0.01
erickcoelho22 joins the table at seat #5
Smuggler1991: checks
*** FLOP *** [Jh 6c Th]
bigbluerodeo: checks
Smuggler1991: bets $0.06
jford9099: folds
bigbluerodeo: folds
Uncalled bet ($0.06) returned to Smuggler1991
Smuggler1991 collected $0.06 from pot
Smuggler1991: doesn't show hand
*** SUMMARY ***
Total pot $0.06 | Rake $0
Board [Jh 6c Th]
Seat 1: jford9099 folded on the Flop
Seat 2: maarketeer (button) folded before Flop (didn't bet)
Seat 3: bigbluerodeo (small blind) folded on the Flop
Seat 4: Smuggler1991 (big blind) collected ($0.06)
Seat 6: PlayTheBlues4U folded before Flop (didn't bet)


PokerStars Hand #203588677227:  Hold'em No Limit ($0.01/$0.02 USD) - 2019/09/10 22:39:37 ET
Table 'Rana' 6-max Seat #5 is the button
Seat 1: delm44 ($1.76 in chips)
Seat 2: vgctmg ($1.43 in chips)
Seat 3: bigbluerodeo ($1.78 in chips)
Seat 4: Sparseeye ($1.49 in chips)
Seat 5: PlayTheBlues4U ($1.99 in chips)
Seat 6: DruMoney201 ($2.18 in chips)
DruMoney201: posts small blind $0.01
delm44: posts big blind $0.02
*** HOLE CARDS ***
Dealt to PlayTheBlues4U [Ac Ad]
vgctmg: calls $0.02
bigbluerodeo: folds
Sparseeye: folds
PlayTheBlues4U: raises $0.04 to $0.06
DruMoney201: folds
delm44: calls $0.04
vgctmg: raises $0.06 to $0.12
PlayTheBlues4U: calls $0.06
delm44: calls $0.06
*** FLOP *** [Qd 6c 3h]
delm44: checks
vgctmg: bets $0.18
PlayTheBlues4U: calls $0.18
delm44: folds
*** TURN *** [Qd 6c 3h] [4c]
vgctmg: bets $0.18
PlayTheBlues4U: raises $0.18 to $0.36
vgctmg: calls $0.18
*** RIVER *** [Qd 6c 3h 4c] [9s]
vgctmg: checks
PlayTheBlues4U: bets $1.33 and is all-in
vgctmg: folds
Uncalled bet ($1.33) returned to PlayTheBlues4U
PlayTheBlues4U collected $1.38 from pot
PlayTheBlues4U: doesn't show hand
*** SUMMARY ***
Total pot $1.45 | Rake $0.07
Board [Qd 6c 3h 4c 9s]
Seat 1: delm44 (big blind) folded on the Flop
Seat 2: vgctmg folded on the River
Seat 3: bigbluerodeo folded before Flop (didn't bet)
Seat 4: Sparseeye folded before Flop (didn't bet)
Seat 5: PlayTheBlues4U (button) collected ($1.38)
Seat 6: DruMoney201 (small blind) folded before Flop


PokerStars Hand #203588677061:  Hold'em No Limit ($0.01/$0.02 USD) - 2019/09/10 22:38:46 ET
Table 'Orion' 6-max Seat #1 is the button
Seat 1: jford9099 ($1.81 in chips)
Seat 2: maarketeer ($2.17 in chips)
Seat 3: bigbluerodeo ($2.66 in chips)
Seat 4: Smuggler1991 ($2.38 in chips)
Seat 6: PlayTheBlues4U ($1.98 in chips)
maarketeer: posts small blind $0.01
bigbluerodeo: posts big blind $0.02
*** HOLE CARDS ***
Dealt to PlayTheBlues4U [9c 6s]
Smuggler1991: folds
PlayTheBlues4U: folds
jford9099: calls $0.02
maarketeer: calls $0.01
bigbluerodeo: checks
*** FLOP *** [8c 9d 4s]
maarketeer: checks
bigbluerodeo: checks
jford9099: bets $0.06
maarketeer: folds
bigbluerodeo: folds
Uncalled bet ($0.06) returned to jford9099
jford9099 collected $0.06 from pot
jford9099: doesn't show hand
*** SUMMARY ***
Total pot $0.06 | Rake $0
Board [8c 9d 4s]
Seat 1: jford9099 (button) collected ($0.06)
Seat 2: maarketeer (small blind) folded on the Flop
Seat 3: bigbluerodeo (big blind) folded on the Flop
Seat 4: Smuggler1991 folded before Flop (didn't bet)
Seat 6: PlayTheBlues4U folded before Flop (didn't bet)


PokerStars Hand #203588677041:  Hold'em No Limit ($0.01/$0.02 USD) - 2019/09/10 22:38:40 ET
Table 'Rana' 6-max Seat #4 is the button
Seat 1: delm44 ($1.69 in chips)
Seat 2: vgctmg ($1.47 in chips)
Seat 3: bigbluerodeo ($1.78 in chips)
Seat 4: Sparseeye ($1.49 in chips)
Seat 5: PlayTheBlues4U ($1.75 in chips)
Seat 6: DruMoney201 ($2.20 in chips)
PlayTheBlues4U: posts small blind $0.01
DruMoney201: posts big blind $0.02
*** HOLE CARDS ***
Dealt to PlayTheBlues4U [2c Qd]
delm44: calls $0.02
vgctmg: calls $0.02
bigbluerodeo: folds
Sparseeye: folds
PlayTheBlues4U: folds
DruMoney201: checks
*** FLOP *** [Th 4c 6s]
DruMoney201: checks
delm44: checks
vgctmg: checks
*** TURN *** [Th 4c 6s] [Kd]
DruMoney201: checks
delm44: bets $0.02
vgctmg: calls $0.02
DruMoney201: folds
*** RIVER *** [Th 4c 6s Kd] [6h]
delm44: checks
vgctmg: checks
*** SHOW DOWN ***
delm44: shows [Js Jc] (two pair, Jacks and Sixes)
vgctmg: mucks hand
delm44 collected $0.11 from pot
*** SUMMARY ***
Total pot $0.11 | Rake $0
Board [Th 4c 6s Kd 6h]
Seat 1: delm44 showed [Js Jc] and won ($0.11) with two pair, Jacks and Sixes
Seat 2: vgctmg mucked [7c Tc]
Seat 3: bigbluerodeo folded before Flop (didn't bet)
Seat 4: Sparseeye (button) folded before Flop (didn't bet)
Seat 5: PlayTheBlues4U (small blind) folded before Flop
Seat 6: DruMoney201 (big blind) folded on the Turn


PokerStars Hand #203588676924:  Hold'em No Limit ($0.01/$0.02 USD) - 2019/09/10 22:37:59 ET
Table 'Rana' 6-max Seat #3 is the button
Seat 1: delm44 ($1.85 in chips)
Seat 2: vgctmg ($1.47 in chips)
Seat 3: bigbluerodeo ($1.78 in chips)
Seat 4: Sparseeye ($1.50 in chips)
Seat 5: PlayTheBlues4U ($1.59 in chips)
Seat 6: DruMoney201 ($2.20 in chips)
Sparseeye: posts small blind $0.01
PlayTheBlues4U: posts big blind $0.02
*** HOLE CARDS ***
Dealt to PlayTheBlues4U [Kc Jc]
DruMoney201: folds
delm44: calls $0.02
vgctmg: folds
bigbluerodeo: folds
Sparseeye: folds
PlayTheBlues4U: raises $0.04 to $0.06
delm44: calls $0.04
*** FLOP *** [Kh Jd Ad]
PlayTheBlues4U: bets $0.10
delm44: calls $0.10
*** TURN *** [Kh Jd Ad] [Qh]
PlayTheBlues4U: bets $0.16
delm44: folds
Uncalled bet ($0.16) returned to PlayTheBlues4U
PlayTheBlues4U collected $0.32 from pot
PlayTheBlues4U: doesn't show hand
*** SUMMARY ***
Total pot $0.33 | Rake $0.01
Board [Kh Jd Ad Qh]
Seat 1: delm44 folded on the Turn
Seat 2: vgctmg folded before Flop (didn't bet)
Seat 3: bigbluerodeo (button) folded before Flop (didn't bet)
Seat 4: Sparseeye (small blind) folded before Flop
Seat 5: PlayTheBlues4U (big blind) collected ($0.32)
Seat 6: DruMoney201 folded before Flop (didn't bet)


PokerStars Hand #203588676816:  Hold'em No Limit ($0.01/$0.02 USD) - 2019/09/10 22:37:30 ET
Table 'Orion' 6-max Seat #6 is the button
Seat 1: jford9099 ($1.96 in chips)
Seat 2: maarketeer ($2.19 in chips)
Seat 3: bigbluerodeo ($2.81 in chips)
Seat 4: Smuggler1991 ($2.08 in chips)
Seat 6: PlayTheBlues4U ($1.98 in chips)
jford9099: posts small blind $0.01
maarketeer: posts big blind $0.02
*** HOLE CARDS ***
Dealt to PlayTheBlues4U [Th 5d]
bigbluerodeo: calls $0.02
Smuggler1991: raises $0.07 to $0.09
PlayTheBlues4U: folds
jford9099: calls $0.08
maarketeer: folds
bigbluerodeo: calls $0.07
*** FLOP *** [Kh 6c 2s]
jford9099: checks
bigbluerodeo: checks
Smuggler1991: checks
*** TURN *** [Kh 6c 2s] [6h]
jford9099: bets $0.06
bigbluerodeo: calls $0.06
Smuggler1991: raises $0.22 to $0.28
jford9099: folds
bigbluerodeo: folds
Uncalled bet ($0.22) returned to Smuggler1991
Smuggler1991 collected $0.45 from pot
Smuggler1991: doesn't show hand
*** SUMMARY ***
Total pot $0.47 | Rake $0.02
Board [Kh 6c 2s 6h]
Seat 1: jford9099 (small blind) folded on the Turn
Seat 2: maarketeer (big blind) folded before Flop
Seat 3: bigbluerodeo folded on the Turn
Seat 4: Smuggler1991 collected ($0.45)
Seat 6: PlayTheBlues4U (button) folded before Flop (didn't bet)


PokerStars Hand #203588676794:  Hold'em No Limit ($0.01/$0.02 USD) - 2019/09/10 22:37:21 ET
Table 'Rana' 6-max Seat #2 is the button
Seat 1: delm44 ($1.85 in chips)
Seat 2: vgctmg ($1.43 in chips)
Seat 3: bigbluerodeo ($1.80 in chips)
Seat 4: Sparseeye ($1.52 in chips)
Seat 5: PlayTheBlues4U ($1.59 in chips)
Seat 6: DruMoney201 ($2.20 in chips)
bigbluerodeo: posts small blind $0.01
Sparseeye: posts big blind $0.02
*** HOLE CARDS ***
Dealt to PlayTheBlues4U [4h Qs]
PlayTheBlues4U: folds
DruMoney201: folds
delm44: folds
vgctmg: calls $0.02
bigbluerodeo: calls $0.01
Sparseeye: checks
*** FLOP *** [2s Qc 9h]
bigbluerodeo: checks
Sparseeye: checks
vgctmg: bets $0.02
bigbluerodeo: folds
Sparseeye: folds
Uncalled bet ($0.02) returned to vgctmg
vgctmg collected $0.06 from pot
vgctmg: doesn't show hand
*** SUMMARY ***
Total pot $0.06 | Rake $0
Board [2s Qc 9h]
Seat 1: delm44 folded before Flop (didn't bet)
Seat 2: vgctmg (button) collected ($0.06)
Seat 3: bigbluerodeo (small blind) folded on the Flop
Seat 4: Sparseeye (big blind) folded on the Flop
Seat 5: PlayTheBlues4U folded before Flop (didn't bet)
Seat 6: DruMoney201 folded before Flop (didn't bet)


PokerStars Hand #203588676728:  Hold'em No Limit ($0.01/$0.02 USD) - 2019/09/10 22:37:01 ET
Table 'Rana' 6-max Seat #1 is the button
Seat 1: delm44 ($1.85 in chips)
Seat 2: vgctmg ($1.44 in chips)
Seat 3: bigbluerodeo ($1.82 in chips)
Seat 4: Sparseeye ($1.52 in chips)
Seat 5: PlayTheBlues4U ($1.56 in chips)
Seat 6: DruMoney201 ($2.20 in chips)
vgctmg: posts small blind $0.01
bigbluerodeo: posts big blind $0.02
*** HOLE CARDS ***
Dealt to PlayTheBlues4U [Qd Ks]
Sparseeye: folds
PlayTheBlues4U: raises $0.04 to $0.06
DruMoney201: folds
delm44: folds
vgctmg: folds
bigbluerodeo: folds
Uncalled bet ($0.04) returned to PlayTheBlues4U
PlayTheBlues4U collected $0.05 from pot
PlayTheBlues4U: doesn't show hand
*** SUMMARY ***
Total pot $0.05 | Rake $0
Seat 1: delm44 (button) folded before Flop (didn't bet)
Seat 2: vgctmg (small blind) folded before Flop
Seat 3: bigbluerodeo (big blind) folded before Flop
Seat 4: Sparseeye folded before Flop (didn't bet)
Seat 5: PlayTheBlues4U collected ($0.05)
Seat 6: DruMoney201 folded before Flop (didn't bet)


PokerStars Hand #203588676617:  Hold'em No Limit ($0.01/$0.02 USD) - 2019/09/10 22:36:26 ET
Table 'Rana' 6-max Seat #6 is the button
Seat 1: delm44 ($1.87 in chips)
Seat 2: vgctmg ($1.42 in chips)
Seat 3: bigbluerodeo ($1.82 in chips)
Seat 5: PlayTheBlues4U ($1.56 in chips)
Seat 6: DruMoney201 ($2.20 in chips)
delm44: posts small blind $0.01
vgctmg: posts big blind $0.02
*** HOLE CARDS ***
Dealt to PlayTheBlues4U [4s Ad]
bigbluerodeo: folds
PlayTheBlues4U: folds
DruMoney201: folds
delm44: calls $0.01
vgctmg: checks
*** FLOP *** [4d Ah Ts]
delm44: checks
vgctmg: checks
*** TURN *** [4d Ah Ts] [5d]
delm44: checks
vgctmg: bets $0.02
delm44: folds
Uncalled bet ($0.02) returned to vgctmg
vgctmg collected $0.04 from pot
vgctmg: doesn't show hand
*** SUMMARY ***
Total pot $0.04 | Rake $0
Board [4d Ah Ts 5d]
Seat 1: delm44 (small blind) folded on the Turn
Seat 2: vgctmg (big blind) collected ($0.04)
Seat 3: bigbluerodeo folded before Flop (didn't bet)
Seat 5: PlayTheBlues4U folded before Flop (didn't bet)
Seat 6: DruMoney201 (button) folded before Flop (didn't bet)


PokerStars Hand #203588676596:  Hold'em No Limit ($0.01/$0.02 USD) - 2019/09/10 22:36:20 ET
Table 'Orion' 6-max Seat #4 is the button
Seat 1: jford9099 ($2 in chips)
Seat 2: maarketeer ($2.10 in chips)
Seat 3: bigbluerodeo ($2.85 in chips)
Seat 4: Smuggler1991 ($2.08 in chips)
Seat 6: PlayTheBlues4U ($1.60 in chips)
PlayTheBlues4U: posts small blind $0.01
jford9099: posts big blind $0.02
*** HOLE CARDS ***
Dealt to PlayTheBlues4U [9d 5h]
maarketeer: calls $0.02
bigbluerodeo: calls $0.02
Smuggler1991 is disconnected
Smuggler1991 is connected
Smuggler1991: folds
PlayTheBlues4U: calls $0.01
jford9099: checks
*** FLOP *** [Jh 6d Kh]
PlayTheBlues4U: checks
jford9099: bets $0.02
maarketeer: calls $0.02
bigbluerodeo: calls $0.02
PlayTheBlues4U: folds
*** TURN *** [Jh 6d Kh] [9c]
jford9099: checks
maarketeer: bets $0.12
bigbluerodeo: folds
jford9099: folds
Uncalled bet ($0.12) returned to maarketeer
maarketeer collected $0.13 from pot
maarketeer: doesn't show hand
*** SUMMARY ***
Total pot $0.14 | Rake $0.01
Board [Jh 6d Kh 9c]
Seat 1: jford9099 (big blind) folded on the Turn
Seat 2: maarketeer collected ($0.13)
Seat 3: bigbluerodeo folded on the Turn
Seat 4: Smuggler1991 (button) folded before Flop (didn't bet)
Seat 6: PlayTheBlues4U (small blind) folded on the Flop


PokerStars Hand #203588676527:  Hold'em No Limit ($0.01/$0.02 USD) - 2019/09/10 22:35:59 ET
Table 'Orion' 6-max Seat #3 is the button
Seat 1: jford9099 ($2.02 in chips)
Seat 2: maarketeer ($2 in chips)
Seat 3: bigbluerodeo ($2.91 in chips)
Seat 4: Smuggler1991 ($2.09 in chips)
Seat 6: PlayTheBlues4U ($1.62 in chips)
Smuggler1991: posts small blind $0.01
PlayTheBlues4U: posts big blind $0.02
maarketeer: posts big blind $0.02
*** HOLE CARDS ***
Dealt to PlayTheBlues4U [6h Kc]
jford9099: calls $0.02
maarketeer: raises $0.04 to $0.06
bigbluerodeo: calls $0.06
Smuggler1991: folds
PlayTheBlues4U: folds
jford9099: folds
*** FLOP *** [5h 2s 9c]
maarketeer: bets $0.08
bigbluerodeo: folds
Uncalled bet ($0.08) returned to maarketeer
maarketeer collected $0.16 from pot
maarketeer: doesn't show hand
*** SUMMARY ***
Total pot $0.17 | Rake $0.01
Board [5h 2s 9c]
Seat 1: jford9099 folded before Flop
Seat 2: maarketeer collected ($0.16)
Seat 3: bigbluerodeo (button) folded on the Flop
Seat 4: Smuggler1991 (small blind) folded before Flop
Seat 6: PlayTheBlues4U (big blind) folded before Flop


PokerStars Hand #203588676466:  Hold'em No Limit ($0.01/$0.02 USD) - 2019/09/10 22:35:38 ET
Table 'Rana' 6-max Seat #5 is the button
Seat 1: delm44 ($1.89 in chips)
Seat 2: vgctmg ($1.42 in chips)
Seat 3: bigbluerodeo ($1.88 in chips)
Seat 5: PlayTheBlues4U ($1.62 in chips)
Seat 6: DruMoney201 ($2.07 in chips)
DruMoney201: posts small blind $0.01
delm44: posts big blind $0.02
*** HOLE CARDS ***
Dealt to PlayTheBlues4U [Jd Qh]
vgctmg: folds
bigbluerodeo: calls $0.02
PlayTheBlues4U: raises $0.04 to $0.06
DruMoney201: calls $0.05
delm44: folds
bigbluerodeo: calls $0.04
*** FLOP *** [8d 3h 8h]
DruMoney201: checks
bigbluerodeo: checks
PlayTheBlues4U: checks
*** TURN *** [8d 3h 8h] [5d]
DruMoney201: bets $0.10
bigbluerodeo: folds
PlayTheBlues4U: folds
Uncalled bet ($0.10) returned to DruMoney201
DruMoney201 collected $0.19 from pot
DruMoney201: doesn't show hand
*** SUMMARY ***
Total pot $0.20 | Rake $0.01
Board [8d 3h 8h 5d]
Seat 1: delm44 (big blind) folded before Flop
Seat 2: vgctmg folded before Flop (didn't bet)
Seat 3: bigbluerodeo folded on the Turn
Seat 5: PlayTheBlues4U (button) folded on the Turn
Seat 6: DruMoney201 (small blind) collected ($0.19)


PokerStars Hand #203588676403:  Hold'em No Limit ($0.01/$0.02 USD) - 2019/09/10 22:35:15 ET
Table 'Orion' 6-max Seat #1 is the button
Seat 1: jford9099 ($2.02 in chips)
Seat 3: bigbluerodeo ($2.97 in chips)
Seat 4: Smuggler1991 ($2.04 in chips)
Seat 6: PlayTheBlues4U ($1.62 in chips)
maarketeer will be allowed to play after the button
bigbluerodeo: posts small blind $0.01
Smuggler1991: posts big blind $0.02
*** HOLE CARDS ***
Dealt to PlayTheBlues4U [4c 9s]
PlayTheBlues4U: folds
jford9099: folds
bigbluerodeo: calls $0.01
Smuggler1991: raises $0.04 to $0.06
bigbluerodeo: calls $0.04
*** FLOP *** [2d 4s Kc]
bigbluerodeo: checks
Smuggler1991: bets $0.06
bigbluerodeo: folds
Uncalled bet ($0.06) returned to Smuggler1991
Smuggler1991 collected $0.11 from pot
Smuggler1991: doesn't show hand
*** SUMMARY ***
Total pot $0.12 | Rake $0.01
Board [2d 4s Kc]
Seat 1: jford9099 (button) folded before Flop (didn't bet)
Seat 3: bigbluerodeo (small blind) folded on the Flop
Seat 4: Smuggler1991 (big blind) collected ($0.11)
Seat 6: PlayTheBlues4U folded before Flop (didn't bet)


PokerStars Hand #203588676220:  Hold'em No Limit ($0.01/$0.02 USD) - 2019/09/10 22:34:28 ET
Table 'Orion' 6-max Seat #6 is the button
Seat 1: jford9099 ($2.04 in chips)
Seat 3: bigbluerodeo ($2.99 in chips)
Seat 4: Smuggler1991 ($2 in chips)
Seat 6: PlayTheBlues4U ($1.62 in chips)
jford9099: posts small blind $0.01
bigbluerodeo: posts big blind $0.02
Smuggler1991: posts big blind $0.02
*** HOLE CARDS ***
Dealt to PlayTheBlues4U [Jc 5h]
Smuggler1991: checks
PlayTheBlues4U: folds
jford9099: calls $0.01
bigbluerodeo: checks
*** FLOP *** [Ad 2c 9h]
jford9099: checks
bigbluerodeo: checks
Smuggler1991: bets $0.02
jford9099: folds
maarketeer joins the table at seat #2
bigbluerodeo: folds
Uncalled bet ($0.02) returned to Smuggler1991
Smuggler1991 collected $0.06 from pot
Smuggler1991: doesn't show hand
*** SUMMARY ***
Total pot $0.06 | Rake $0
Board [Ad 2c 9h]
Seat 1: jford9099 (small blind) folded on the Flop
Seat 3: bigbluerodeo (big blind) folded on the Flop
Seat 4: Smuggler1991 collected ($0.06)
Seat 6: PlayTheBlues4U (button) folded before Flop (didn't bet)


PokerStars Hand #203588676159:  Hold'em No Limit ($0.01/$0.02 USD) - 2019/09/10 22:34:06 ET
Table 'Orion' 6-max Seat #3 is the button
Seat 1: jford9099 ($2.06 in chips)
Seat 3: bigbluerodeo ($2.99 in chips)
Seat 6: PlayTheBlues4U ($1.60 in chips)
PlayTheBlues4U: posts small blind $0.01
jford9099: posts big blind $0.02
*** HOLE CARDS ***
Dealt to PlayTheBlues4U [7c 9c]
bigbluerodeo: folds
Smuggler1991 joins the table at seat #4
PlayTheBlues4U: calls $0.01
jford9099: checks
*** FLOP *** [Qs 2h 2d]
PlayTheBlues4U: checks
jford9099: checks
*** TURN *** [Qs 2h 2d] [Ts]
PlayTheBlues4U: checks
jford9099: checks
*** RIVER *** [Qs 2h 2d Ts] [3s]
PlayTheBlues4U: checks
jford9099: checks
falkon28 leaves the table
*** SHOW DOWN ***
PlayTheBlues4U: shows [7c 9c] (a pair of Deuces)
jford9099: mucks hand
PlayTheBlues4U collected $0.04 from pot
*** SUMMARY ***
Total pot $0.04 | Rake $0
Board [Qs 2h 2d Ts 3s]
Seat 1: jford9099 (big blind) mucked [4d 6s]
Seat 3: bigbluerodeo (button) folded before Flop (didn't bet)
Seat 6: PlayTheBlues4U (small blind) showed [7c 9c] and won ($0.04) with a pair of Deuces


PokerStars Hand #203588675956:  Hold'em No Limit ($0.01/$0.02 USD) - 2019/09/10 22:33:04 ET
Table 'Rana' 6-max Seat #3 is the button
Seat 1: delm44 ($1.58 in chips)
Seat 2: vgctmg ($1.50 in chips)
Seat 3: bigbluerodeo ($1.88 in chips)
Seat 4: Sparseeye ($1.54 in chips)
Seat 5: PlayTheBlues4U ($1.84 in chips)
Seat 6: DruMoney201 ($2.09 in chips)
Sparseeye: posts small blind $0.01
PlayTheBlues4U: posts big blind $0.02
*** HOLE CARDS ***
Dealt to PlayTheBlues4U [Th Js]
DruMoney201: calls $0.02
delm44: calls $0.02
vgctmg: calls $0.02
bigbluerodeo: folds
Sparseeye: calls $0.01
PlayTheBlues4U: checks
*** FLOP *** [4c Jh 7c]
Sparseeye has timed out
Sparseeye: checks
PlayTheBlues4U: bets $0.06
DruMoney201: folds
delm44: calls $0.06
vgctmg: calls $0.06
vgctmg said, "omg"
Sparseeye has timed out
Sparseeye: folds
*** TURN *** [4c Jh 7c] [7d]
PlayTheBlues4U: bets $0.14
delm44: calls $0.14
vgctmg: folds
*** RIVER *** [4c Jh 7c 7d] [9h]
PlayTheBlues4U: checks
delm44: checks
*** SHOW DOWN ***
PlayTheBlues4U: shows [Th Js] (two pair, Jacks and Sevens)
delm44: shows [Kd Jd] (two pair, Jacks and Sevens - King kicker)
delm44 collected $0.53 from pot
*** SUMMARY ***
Total pot $0.56 | Rake $0.03
Board [4c Jh 7c 7d 9h]
Seat 1: delm44 showed [Kd Jd] and won ($0.53) with two pair, Jacks and Sevens
Seat 2: vgctmg folded on the Turn
Seat 3: bigbluerodeo (button) folded before Flop (didn't bet)
Seat 4: Sparseeye (small blind) folded on the Flop
Seat 5: PlayTheBlues4U (big blind) showed [Th Js] and lost with two pair, Jacks and Sevens
Seat 6: DruMoney201 folded on the Flop


PokerStars Hand #203588675914:  Hold'em No Limit ($0.01/$0.02 USD) - 2019/09/10 22:32:52 ET
Table 'Orion' 6-max Seat #2 is the button
Seat 1: jford9099 ($2.06 in chips)
Seat 2: falkon28 ($2.28 in chips)
Seat 3: bigbluerodeo ($3 in chips)
Seat 6: PlayTheBlues4U ($2 in chips)
bigbluerodeo: posts small blind $0.01
PlayTheBlues4U: posts big blind $0.02
*** HOLE CARDS ***
Dealt to PlayTheBlues4U [Qd 2h]
jford9099: folds
falkon28: raises $0.04 to $0.06
bigbluerodeo: folds
PlayTheBlues4U: calls $0.04
*** FLOP *** [9h 7d As]
PlayTheBlues4U: checks
falkon28: bets $0.04
PlayTheBlues4U: calls $0.04
*** TURN *** [9h 7d As] [4d]
PlayTheBlues4U: bets $0.12
falkon28: calls $0.12
*** RIVER *** [9h 7d As 4d] [Qc]
PlayTheBlues4U: checks
falkon28: bets $0.18
PlayTheBlues4U: calls $0.18
*** SHOW DOWN ***
falkon28: shows [Kd Ad] (a pair of Aces)
PlayTheBlues4U: mucks hand
falkon28 collected $0.77 from pot
*** SUMMARY ***
Total pot $0.81 | Rake $0.04
Board [9h 7d As 4d Qc]
Seat 1: jford9099 folded before Flop (didn't bet)
Seat 2: falkon28 (button) showed [Kd Ad] and won ($0.77) with a pair of Aces
Seat 3: bigbluerodeo (small blind) folded before Flop
Seat 6: PlayTheBlues4U (big blind) mucked [Qd 2h]


PokerStars Hand #203588675848:  Hold'em No Limit ($0.01/$0.02 USD) - 2019/09/10 22:32:32 ET
Table 'Orion' 6-max Seat #1 is the button
Seat 1: jford9099 ($2.08 in chips)
Seat 2: falkon28 ($2.29 in chips)
Seat 3: bigbluerodeo ($2.97 in chips)
Seat 6: PlayTheBlues4U ($2 in chips)
falkon28: posts small blind $0.01
bigbluerodeo: posts big blind $0.02
*** HOLE CARDS ***
Dealt to PlayTheBlues4U [Ks 6d]
PlayTheBlues4U: folds
jford9099: calls $0.02
falkon28: folds
bigbluerodeo: checks
*** FLOP *** [Jh Ts Kh]
bigbluerodeo: bets $0.05
jford9099: folds
Uncalled bet ($0.05) returned to bigbluerodeo
bigbluerodeo collected $0.05 from pot
bigbluerodeo: doesn't show hand
*** SUMMARY ***
Total pot $0.05 | Rake $0
Board [Jh Ts Kh]
Seat 1: jford9099 (button) folded on the Flop
Seat 2: falkon28 (small blind) folded before Flop
Seat 3: bigbluerodeo (big blind) collected ($0.05)
Seat 6: PlayTheBlues4U folded before Flop (didn't bet)


PokerStars Hand #203588675760:  Hold'em No Limit ($0.01/$0.02 USD) - 2019/09/10 22:32:03 ET
Table 'Orion' 6-max Seat #6 is the button
Seat 1: jford9099 ($2.10 in chips)
Seat 2: falkon28 ($2.25 in chips)
Seat 3: bigbluerodeo ($2.99 in chips)
Seat 6: PlayTheBlues4U ($2 in chips)
jford9099: posts small blind $0.01
falkon28: posts big blind $0.02
*** HOLE CARDS ***
Dealt to PlayTheBlues4U [Td 4s]
bigbluerodeo: calls $0.02
PlayTheBlues4U: folds
jford9099: calls $0.01
falkon28: raises $0.08 to $0.10
bigbluerodeo: folds
jford9099: folds
Uncalled bet ($0.08) returned to falkon28
falkon28 collected $0.06 from pot
falkon28: doesn't show hand
*** SUMMARY ***
Total pot $0.06 | Rake $0
Seat 1: jford9099 (small blind) folded before Flop
Seat 2: falkon28 (big blind) collected ($0.06)
Seat 3: bigbluerodeo folded before Flop
Seat 6: PlayTheBlues4U (button) folded before Flop (didn't bet)


PokerStars Hand #203588675739:  Hold'em No Limit ($0.01/$0.02 USD) - 2019/09/10 22:31:53 ET
Table 'Orion' 6-max Seat #3 is the button
Seat 1: jford9099 ($2.09 in chips)
Seat 2: falkon28 ($2.25 in chips)
Seat 3: bigbluerodeo ($2.99 in chips)
Seat 6: PlayTheBlues4U ($2.01 in chips)
PlayTheBlues4U: posts small blind $0.01
jford9099: posts big blind $0.02
*** HOLE CARDS ***
Dealt to PlayTheBlues4U [2c Jh]
falkon28: folds
bigbluerodeo: folds
PlayTheBlues4U: folds
Uncalled bet ($0.01) returned to jford9099
jford9099 collected $0.02 from pot
jford9099: doesn't show hand
*** SUMMARY ***
Total pot $0.02 | Rake $0
Seat 1: jford9099 (big blind) collected ($0.02)
Seat 2: falkon28 folded before Flop (didn't bet)
Seat 3: bigbluerodeo (button) folded before Flop (didn't bet)
Seat 6: PlayTheBlues4U (small blind) folded before Flop


PokerStars Hand #203588675671:  Hold'em No Limit ($0.01/$0.02 USD) - 2019/09/10 22:31:31 ET
Table 'Rana' 6-max Seat #2 is the button
Seat 1: delm44 ($1.60 in chips)
Seat 2: vgctmg ($1.52 in chips)
Seat 3: bigbluerodeo ($1.94 in chips)
Seat 4: Sparseeye ($1.60 in chips)
Seat 5: PlayTheBlues4U ($1.84 in chips)
Seat 6: DruMoney201 ($1.94 in chips)
bigbluerodeo: posts small blind $0.01
Sparseeye: posts big blind $0.02
*** HOLE CARDS ***
Dealt to PlayTheBlues4U [4d 3s]
PlayTheBlues4U: folds
DruMoney201: calls $0.02
delm44: calls $0.02
vgctmg: calls $0.02
bigbluerodeo: calls $0.01
Sparseeye: checks
*** FLOP *** [7s 5s 9s]
bigbluerodeo: checks
Sparseeye: checks
DruMoney201: checks
delm44: checks
vgctmg: checks
*** TURN *** [7s 5s 9s] [9d]
bigbluerodeo: checks
Sparseeye: checks
DruMoney201: bets $0.04
delm44: folds
vgctmg: folds
bigbluerodeo: calls $0.04
Sparseeye: calls $0.04
*** RIVER *** [7s 5s 9s 9d] [6h]
bigbluerodeo: checks
Sparseeye: checks
DruMoney201: bets $0.10
bigbluerodeo: folds
Sparseeye: folds
Uncalled bet ($0.10) returned to DruMoney201
DruMoney201 collected $0.21 from pot
DruMoney201: doesn't show hand
*** SUMMARY ***
Total pot $0.22 | Rake $0.01
Board [7s 5s 9s 9d 6h]
Seat 1: delm44 folded on the Turn
Seat 2: vgctmg (button) folded on the Turn
Seat 3: bigbluerodeo (small blind) folded on the River
Seat 4: Sparseeye (big blind) folded on the River
Seat 5: PlayTheBlues4U folded before Flop (didn't bet)
Seat 6: DruMoney201 collected ($0.21)


PokerStars Hand #203588675618:  Hold'em No Limit ($0.01/$0.02 USD) - 2019/09/10 22:31:15 ET
Table 'Orion' 6-max Seat #2 is the button
Seat 1: jford9099 ($2.11 in chips)
Seat 2: falkon28 ($2.25 in chips)
Seat 3: bigbluerodeo ($3.01 in chips)
Seat 6: PlayTheBlues4U ($1.97 in chips)
bigbluerodeo: posts small blind $0.01
PlayTheBlues4U: posts big blind $0.02
*** HOLE CARDS ***
Dealt to PlayTheBlues4U [9c Qh]
xxzuluzuluxx leaves the table
jford9099: calls $0.02
falkon28: folds
bigbluerodeo: calls $0.01
PlayTheBlues4U: checks
*** FLOP *** [8c 6c 2s]
bigbluerodeo: checks
PlayTheBlues4U: checks
jford9099: checks
*** TURN *** [8c 6c 2s] [Qd]
bigbluerodeo: checks
PlayTheBlues4U: bets $0.06
jford9099: folds
bigbluerodeo: folds
Uncalled bet ($0.06) returned to PlayTheBlues4U
PlayTheBlues4U collected $0.06 from pot
PlayTheBlues4U: doesn't show hand
*** SUMMARY ***
Total pot $0.06 | Rake $0
Board [8c 6c 2s Qd]
Seat 1: jford9099 folded on the Turn
Seat 2: falkon28 (button) folded before Flop (didn't bet)
Seat 3: bigbluerodeo (small blind) folded on the Turn
Seat 6: PlayTheBlues4U (big blind) collected ($0.06)


PokerStars Hand #203588675531:  Hold'em No Limit ($0.01/$0.02 USD) - 2019/09/10 22:30:45 ET
Table 'Orion' 6-max Seat #1 is the button
Seat 1: jford9099 ($2.11 in chips)
Seat 2: falkon28 ($2.26 in chips)
Seat 3: bigbluerodeo ($3.03 in chips)
Seat 5: xxzuluzuluxx ($6.58 in chips)
Seat 6: PlayTheBlues4U ($1.97 in chips)
falkon28: posts small blind $0.01
bigbluerodeo: posts big blind $0.02
*** HOLE CARDS ***
Dealt to PlayTheBlues4U [9s Kd]
xxzuluzuluxx: raises $0.05 to $0.07
PlayTheBlues4U: folds
jford9099: folds
falkon28: folds
bigbluerodeo: folds
Uncalled bet ($0.05) returned to xxzuluzuluxx
xxzuluzuluxx collected $0.05 from pot
xxzuluzuluxx: doesn't show hand
*** SUMMARY ***
Total pot $0.05 | Rake $0
Seat 1: jford9099 (button) folded before Flop (didn't bet)
Seat 2: falkon28 (small blind) folded before Flop
Seat 3: bigbluerodeo (big blind) folded before Flop
Seat 5: xxzuluzuluxx collected ($0.05)
Seat 6: PlayTheBlues4U folded before Flop (didn't bet)


PokerStars Hand #203588675489:  Hold'em No Limit ($0.01/$0.02 USD) - 2019/09/10 22:30:35 ET
Table 'Rana' 6-max Seat #1 is the button
Seat 1: delm44 ($1.60 in chips)
Seat 2: vgctmg ($1.47 in chips)
Seat 3: bigbluerodeo ($2 in chips)
Seat 5: PlayTheBlues4U ($1.84 in chips)
Seat 6: DruMoney201 ($1.94 in chips)
vgctmg: posts small blind $0.01
bigbluerodeo: posts big blind $0.02
*** HOLE CARDS ***
Dealt to PlayTheBlues4U [Th As]
Sparseeye joins the table at seat #4
PlayTheBlues4U: folds
DruMoney201: folds
delm44: folds
vgctmg: calls $0.01
bigbluerodeo: checks
*** FLOP *** [Ts 3d 7s]
vgctmg: checks
bigbluerodeo: checks
*** TURN *** [Ts 3d 7s] [2d]
vgctmg: bets $0.04
bigbluerodeo: calls $0.04
*** RIVER *** [Ts 3d 7s 2d] [Kd]
vgctmg: bets $0.08
bigbluerodeo: folds
Uncalled bet ($0.08) returned to vgctmg
vgctmg collected $0.11 from pot
vgctmg: doesn't show hand
*** SUMMARY ***
Total pot $0.12 | Rake $0.01
Board [Ts 3d 7s 2d Kd]
Seat 1: delm44 (button) folded before Flop (didn't bet)
Seat 2: vgctmg (small blind) collected ($0.11)
Seat 3: bigbluerodeo (big blind) folded on the River
Seat 5: PlayTheBlues4U folded before Flop (didn't bet)
Seat 6: DruMoney201 folded before Flop (didn't bet)


PokerStars Hand #203588675415:  Hold'em No Limit ($0.01/$0.02 USD) - 2019/09/10 22:30:10 ET
Table 'Orion' 6-max Seat #6 is the button
Seat 1: jford9099 ($2.04 in chips)
Seat 2: falkon28 ($2.28 in chips)
Seat 3: bigbluerodeo ($3.09 in chips)
Seat 5: xxzuluzuluxx ($6.58 in chips)
Seat 6: PlayTheBlues4U ($1.97 in chips)
jford9099: posts small blind $0.01
falkon28: posts big blind $0.02
*** HOLE CARDS ***
Dealt to PlayTheBlues4U [2s 4d]
bigbluerodeo: calls $0.02
xxzuluzuluxx: folds
seags21 leaves the table
PlayTheBlues4U: folds
jford9099: raises $0.04 to $0.06
falkon28: folds
bigbluerodeo: calls $0.04
*** FLOP *** [Jd Qs 6s]
jford9099: bets $0.06
bigbluerodeo: folds
Uncalled bet ($0.06) returned to jford9099
jford9099 collected $0.13 from pot
jford9099: doesn't show hand
*** SUMMARY ***
Total pot $0.14 | Rake $0.01
Board [Jd Qs 6s]
Seat 1: jford9099 (small blind) collected ($0.13)
Seat 2: falkon28 (big blind) folded before Flop
Seat 3: bigbluerodeo folded on the Flop
Seat 5: xxzuluzuluxx folded before Flop (didn't bet)
Seat 6: PlayTheBlues4U (button) folded before Flop (didn't bet)


PokerStars Hand #203588675383:  Hold'em No Limit ($0.01/$0.02 USD) - 2019/09/10 22:30:00 ET
Table 'Rana' 6-max Seat #6 is the button
Seat 1: delm44 ($1.62 in chips)
Seat 2: vgctmg ($1.49 in chips)
Seat 3: ArtOfWar440 ($4.72 in chips)
Seat 4: seags21 ($2.42 in chips)
Seat 5: PlayTheBlues4U ($1.84 in chips)
Seat 6: DruMoney201 ($1.90 in chips)
delm44: posts small blind $0.01
vgctmg: posts big blind $0.02
*** HOLE CARDS ***
Dealt to PlayTheBlues4U [Kh 7c]
ArtOfWar440: folds
seags21: folds
PlayTheBlues4U: folds
DruMoney201: calls $0.02
delm44: calls $0.01
vgctmg: checks
*** FLOP *** [6h 8c 6s]
delm44: checks
vgctmg: checks
DruMoney201: checks
*** TURN *** [6h 8c 6s] [As]
ArtOfWar440 leaves the table
delm44: checks
seags21 leaves the table
vgctmg: checks
DruMoney201: bets $0.06
bigbluerodeo joins the table at seat #3
delm44: folds
vgctmg: folds
Uncalled bet ($0.06) returned to DruMoney201
DruMoney201 collected $0.06 from pot
DruMoney201: doesn't show hand
*** SUMMARY ***
Total pot $0.06 | Rake $0
Board [6h 8c 6s As]
Seat 1: delm44 (small blind) folded on the Turn
Seat 2: vgctmg (big blind) folded on the Turn
Seat 3: ArtOfWar440 folded before Flop (didn't bet)
Seat 4: seags21 folded before Flop (didn't bet)
Seat 5: PlayTheBlues4U folded before Flop (didn't bet)
Seat 6: DruMoney201 (button) collected ($0.06)


PokerStars Hand #203588675369:  Hold'em No Limit ($0.01/$0.02 USD) - 2019/09/10 22:29:56 ET
Table 'Orion' 6-max Seat #5 is the button
Seat 1: jford9099 ($2.03 in chips)
Seat 2: falkon28 ($2.28 in chips)
Seat 3: bigbluerodeo ($3.09 in chips)
Seat 5: xxzuluzuluxx ($6.58 in chips)
Seat 6: PlayTheBlues4U ($1.98 in chips)
PlayTheBlues4U: posts small blind $0.01
jford9099: posts big blind $0.02
*** HOLE CARDS ***
Dealt to PlayTheBlues4U [Kh 6d]
falkon28: folds
bigbluerodeo: folds
xxzuluzuluxx: folds
PlayTheBlues4U: folds
Uncalled bet ($0.01) returned to jford9099
jford9099 collected $0.02 from pot
jford9099: doesn't show hand
*** SUMMARY ***
Total pot $0.02 | Rake $0
Seat 1: jford9099 (big blind) collected ($0.02)
Seat 2: falkon28 folded before Flop (didn't bet)
Seat 3: bigbluerodeo folded before Flop (didn't bet)
Seat 5: xxzuluzuluxx (button) folded before Flop (didn't bet)
Seat 6: PlayTheBlues4U (small blind) folded before Flop


PokerStars Hand #203588675319:  Hold'em No Limit ($0.01/$0.02 USD) - 2019/09/10 22:29:41 ET
Table 'Orion' 6-max Seat #3 is the button
Seat 1: jford9099 ($2 in chips)
Seat 2: falkon28 ($2.28 in chips)
Seat 3: bigbluerodeo ($3.09 in chips)
Seat 5: xxzuluzuluxx ($6.59 in chips)
Seat 6: PlayTheBlues4U ($2 in chips)
xxzuluzuluxx: posts small blind $0.01
PlayTheBlues4U: posts big blind $0.02
jford9099: posts big blind $0.02
*** HOLE CARDS ***
Dealt to PlayTheBlues4U [Qc 3h]
jford9099: raises $0.08 to $0.10
falkon28: folds
bigbluerodeo: folds
xxzuluzuluxx: folds
PlayTheBlues4U: folds
Uncalled bet ($0.08) returned to jford9099
jford9099 collected $0.05 from pot
jford9099: doesn't show hand
*** SUMMARY ***
Total pot $0.05 | Rake $0
Seat 1: jford9099 collected ($0.05)
Seat 2: falkon28 folded before Flop (didn't bet)
Seat 3: bigbluerodeo (button) folded before Flop (didn't bet)
Seat 5: xxzuluzuluxx (small blind) folded before Flop
Seat 6: PlayTheBlues4U (big blind) folded before Flop


PokerStars Hand #203588675222:  Hold'em No Limit ($0.01/$0.02 USD) - 2019/09/10 22:29:15 ET
Table 'Rana' 6-max Seat #5 is the button
Seat 1: delm44 ($1.64 in chips)
Seat 2: vgctmg ($1.49 in chips)
Seat 3: ArtOfWar440 ($4.64 in chips)
Seat 4: seags21 ($2.42 in chips)
Seat 5: PlayTheBlues4U ($1.90 in chips)
Seat 6: DruMoney201 ($1.91 in chips)
DruMoney201: posts small blind $0.01
delm44: posts big blind $0.02
*** HOLE CARDS ***
Dealt to PlayTheBlues4U [Qd Jh]
vgctmg: folds
ArtOfWar440: raises $0.04 to $0.06
seags21: folds
PlayTheBlues4U: calls $0.06
DruMoney201: folds
delm44: folds
*** FLOP *** [Ac Td 8c]
ArtOfWar440: bets $0.11
PlayTheBlues4U: folds
Uncalled bet ($0.11) returned to ArtOfWar440
ArtOfWar440 collected $0.14 from pot
ArtOfWar440: doesn't show hand
*** SUMMARY ***
Total pot $0.15 | Rake $0.01
Board [Ac Td 8c]
Seat 1: delm44 (big blind) folded before Flop
Seat 2: vgctmg folded before Flop (didn't bet)
Seat 3: ArtOfWar440 collected ($0.14)
Seat 4: seags21 folded before Flop (didn't bet)
Seat 5: PlayTheBlues4U (button) folded on the Flop
Seat 6: DruMoney201 (small blind) folded before Flop


PokerStars Hand #203588675092:  Hold'em No Limit ($0.01/$0.02 USD) - 2019/09/10 22:28:28 ET
Table 'Rana' 6-max Seat #4 is the button
Seat 1: delm44 ($1.64 in chips)
Seat 2: vgctmg ($1.57 in chips)
Seat 3: ArtOfWar440 ($4.64 in chips)
Seat 4: seags21 ($2.42 in chips)
Seat 5: PlayTheBlues4U ($1.92 in chips)
Seat 6: DruMoney201 ($1.82 in chips)
PlayTheBlues4U: posts small blind $0.01
DruMoney201: posts big blind $0.02
*** HOLE CARDS ***
Dealt to PlayTheBlues4U [Qc Td]
delm44: folds
vgctmg: calls $0.02
ArtOfWar440: folds
seags21: folds
PlayTheBlues4U: calls $0.01
DruMoney201: checks
*** FLOP *** [7c 6h 4d]
PlayTheBlues4U: checks
DruMoney201: bets $0.06
vgctmg: calls $0.06
PlayTheBlues4U: folds
*** TURN *** [7c 6h 4d] [Jc]
DruMoney201: bets $0.08
vgctmg: folds
Uncalled bet ($0.08) returned to DruMoney201
DruMoney201 collected $0.17 from pot
DruMoney201: doesn't show hand
*** SUMMARY ***
Total pot $0.18 | Rake $0.01
Board [7c 6h 4d Jc]
Seat 1: delm44 folded before Flop (didn't bet)
Seat 2: vgctmg folded on the Turn
Seat 3: ArtOfWar440 folded before Flop (didn't bet)
Seat 4: seags21 (button) folded before Flop (didn't bet)
Seat 5: PlayTheBlues4U (small blind) folded on the Flop
Seat 6: DruMoney201 (big blind) collected ($0.17)


PokerStars Hand #203588674891:  Hold'em No Limit ($0.01/$0.02 USD) - 2019/09/10 22:27:18 ET
Table 'Rana' 6-max Seat #3 is the button
Seat 1: delm44 ($1.68 in chips)
Seat 2: vgctmg ($1.57 in chips)
Seat 3: ArtOfWar440 ($4.64 in chips)
Seat 4: seags21 ($2.43 in chips)
Seat 5: PlayTheBlues4U ($1.94 in chips)
Seat 6: DruMoney201 ($1.75 in chips)
seags21: posts small blind $0.01
PlayTheBlues4U: posts big blind $0.02
*** HOLE CARDS ***
Dealt to PlayTheBlues4U [4h 3h]
DruMoney201: calls $0.02
delm44: calls $0.02
vgctmg: folds
ArtOfWar440: folds
seags21: folds
PlayTheBlues4U: checks
*** FLOP *** [Ad 9s 7s]
PlayTheBlues4U: checks
DruMoney201: checks
delm44: bets $0.02
PlayTheBlues4U: folds
DruMoney201: calls $0.02
*** TURN *** [Ad 9s 7s] [Ts]
DruMoney201: checks
delm44: checks
*** RIVER *** [Ad 9s 7s Ts] [8d]
DruMoney201: bets $0.06
delm44: folds
Uncalled bet ($0.06) returned to DruMoney201
DruMoney201 collected $0.11 from pot
DruMoney201: doesn't show hand
*** SUMMARY ***
Total pot $0.11 | Rake $0
Board [Ad 9s 7s Ts 8d]
Seat 1: delm44 folded on the River
Seat 2: vgctmg folded before Flop (didn't bet)
Seat 3: ArtOfWar440 (button) folded before Flop (didn't bet)
Seat 4: seags21 (small blind) folded before Flop
Seat 5: PlayTheBlues4U (big blind) folded on the Flop
Seat 6: DruMoney201 collected ($0.11)


PokerStars Hand #203588674785:  Hold'em No Limit ($0.01/$0.02 USD) - 2019/09/10 22:26:46 ET
Table 'Rana' 6-max Seat #2 is the button
Seat 1: delm44 ($1.68 in chips)
Seat 2: vgctmg ($1.57 in chips)
Seat 3: ArtOfWar440 ($4.65 in chips)
Seat 4: seags21 ($2.45 in chips)
Seat 5: PlayTheBlues4U ($1.86 in chips)
Seat 6: DruMoney201 ($1.81 in chips)
ArtOfWar440: posts small blind $0.01
seags21: posts big blind $0.02
*** HOLE CARDS ***
Dealt to PlayTheBlues4U [Th Ts]
PlayTheBlues4U: raises $0.04 to $0.06
DruMoney201: calls $0.06
delm44: folds
vgctmg: folds
ArtOfWar440: folds
seags21: folds
*** FLOP *** [5s Qd Qc]
PlayTheBlues4U: bets $0.06
DruMoney201: folds
Uncalled bet ($0.06) returned to PlayTheBlues4U
PlayTheBlues4U collected $0.14 from pot
PlayTheBlues4U: doesn't show hand
*** SUMMARY ***
Total pot $0.15 | Rake $0.01
Board [5s Qd Qc]
Seat 1: delm44 folded before Flop (didn't bet)
Seat 2: vgctmg (button) folded before Flop (didn't bet)
Seat 3: ArtOfWar440 (small blind) folded before Flop
Seat 4: seags21 (big blind) folded before Flop
Seat 5: PlayTheBlues4U collected ($0.14)
Seat 6: DruMoney201 folded on the Flop


PokerStars Hand #203588674614:  Hold'em No Limit ($0.01/$0.02 USD) - 2019/09/10 22:25:55 ET
Table 'Rana' 6-max Seat #1 is the button
Seat 1: delm44 ($1.60 in chips)
Seat 2: vgctmg ($1.59 in chips)
Seat 3: ArtOfWar440 ($4.67 in chips)
Seat 4: seags21 ($2.45 in chips)
Seat 5: PlayTheBlues4U ($1.88 in chips)
Seat 6: DruMoney201 ($1.83 in chips)
vgctmg: posts small blind $0.01
ArtOfWar440: posts big blind $0.02
*** HOLE CARDS ***
Dealt to PlayTheBlues4U [3c 3h]
seags21: folds
PlayTheBlues4U: calls $0.02
DruMoney201: calls $0.02
delm44: calls $0.02
vgctmg: calls $0.01
ArtOfWar440: checks
*** FLOP *** [6s Ah 8d]
vgctmg: checks
ArtOfWar440: checks
PlayTheBlues4U: checks
DruMoney201: checks
delm44: bets $0.10
vgctmg: folds
ArtOfWar440: folds
PlayTheBlues4U: folds
DruMoney201: folds
Uncalled bet ($0.10) returned to delm44
delm44 collected $0.10 from pot
delm44: doesn't show hand
*** SUMMARY ***
Total pot $0.10 | Rake $0
Board [6s Ah 8d]
Seat 1: delm44 (button) collected ($0.10)
Seat 2: vgctmg (small blind) folded on the Flop
Seat 3: ArtOfWar440 (big blind) folded on the Flop
Seat 4: seags21 folded before Flop (didn't bet)
Seat 5: PlayTheBlues4U folded on the Flop
Seat 6: DruMoney201 folded on the Flop


PokerStars Hand #203588674425:  Hold'em No Limit ($0.01/$0.02 USD) - 2019/09/10 22:24:49 ET
Table 'Rana' 6-max Seat #6 is the button
Seat 1: delm44 ($1.61 in chips)
Seat 2: vgctmg ($1.68 in chips)
Seat 3: ArtOfWar440 ($4.67 in chips)
Seat 4: seags21 ($1.90 in chips)
Seat 5: PlayTheBlues4U ($2.38 in chips)
Seat 6: DruMoney201 ($1.83 in chips)
delm44: posts small blind $0.01
vgctmg: posts big blind $0.02
*** HOLE CARDS ***
Dealt to PlayTheBlues4U [6c 7c]
ArtOfWar440: folds
PlayTheBlues4U said, "srsly"
seags21: raises $0.07 to $0.09
PlayTheBlues4U: calls $0.09
DruMoney201: folds
delm44: folds
vgctmg: calls $0.07
*** FLOP *** [4c As 8c]
vgctmg: checks
seags21: bets $0.14
PlayTheBlues4U: calls $0.14
vgctmg: folds
*** TURN *** [4c As 8c] [4h]
seags21: bets $0.27
PlayTheBlues4U: calls $0.27
*** RIVER *** [4c As 8c 4h] [8s]
seags21: bets $0.50
PlayTheBlues4U: folds
Uncalled bet ($0.50) returned to seags21
seags21 collected $1.05 from pot
seags21: doesn't show hand
*** SUMMARY ***
Total pot $1.10 | Rake $0.05
Board [4c As 8c 4h 8s]
Seat 1: delm44 (small blind) folded before Flop
Seat 2: vgctmg (big blind) folded on the Flop
Seat 3: ArtOfWar440 folded before Flop (didn't bet)
Seat 4: seags21 collected ($1.05)
Seat 5: PlayTheBlues4U folded on the River
Seat 6: DruMoney201 (button) folded before Flop (didn't bet)


PokerStars Hand #203588674265:  Hold'em No Limit ($0.01/$0.02 USD) - 2019/09/10 22:23:57 ET
Table 'Rana' 6-max Seat #5 is the button
Seat 1: delm44 ($1.63 in chips)
Seat 2: vgctmg ($1.68 in chips)
Seat 3: ArtOfWar440 ($4.67 in chips)
Seat 4: seags21 ($1.90 in chips)
Seat 5: PlayTheBlues4U ($2.38 in chips)
Seat 6: DruMoney201 ($1.81 in chips)
DruMoney201: posts small blind $0.01
delm44: posts big blind $0.02
*** HOLE CARDS ***
Dealt to PlayTheBlues4U [5c 7h]
vgctmg: folds
ArtOfWar440: folds
seags21: folds
PlayTheBlues4U: folds
vgctmg said, "seriously"
DruMoney201: calls $0.01
delm44: checks
*** FLOP *** [Jh 8c Ac]
DruMoney201: checks
delm44: checks
*** TURN *** [Jh 8c Ac] [6h]
DruMoney201: bets $0.04
delm44: folds
Uncalled bet ($0.04) returned to DruMoney201
DruMoney201 collected $0.04 from pot
DruMoney201: doesn't show hand
*** SUMMARY ***
Total pot $0.04 | Rake $0
Board [Jh 8c Ac 6h]
Seat 1: delm44 (big blind) folded on the Turn
Seat 2: vgctmg folded before Flop (didn't bet)
Seat 3: ArtOfWar440 folded before Flop (didn't bet)
Seat 4: seags21 folded before Flop (didn't bet)
Seat 5: PlayTheBlues4U (button) folded before Flop (didn't bet)
Seat 6: DruMoney201 (small blind) collected ($0.04)


PokerStars Hand #203588674186:  Hold'em No Limit ($0.01/$0.02 USD) - 2019/09/10 22:23:25 ET
Table 'Rana' 6-max Seat #4 is the button
Seat 1: delm44 ($1.63 in chips)
Seat 2: vgctmg ($1.65 in chips)
Seat 3: ArtOfWar440 ($4.67 in chips)
Seat 4: seags21 ($1.90 in chips)
Seat 5: PlayTheBlues4U ($2.39 in chips)
Seat 6: DruMoney201 ($1.83 in chips)
PlayTheBlues4U: posts small blind $0.01
DruMoney201: posts big blind $0.02
*** HOLE CARDS ***
Dealt to PlayTheBlues4U [4s Jh]
delm44: folds
vgctmg: calls $0.02
ArtOfWar440: folds
seags21: folds
PlayTheBlues4U: folds
DruMoney201: checks
*** FLOP *** [Tc 5c Jd]
DruMoney201: checks
vgctmg: bets $0.06
DruMoney201: folds
Uncalled bet ($0.06) returned to vgctmg
vgctmg collected $0.05 from pot
vgctmg: doesn't show hand
*** SUMMARY ***
Total pot $0.05 | Rake $0
Board [Tc 5c Jd]
Seat 1: delm44 folded before Flop (didn't bet)
Seat 2: vgctmg collected ($0.05)
Seat 3: ArtOfWar440 folded before Flop (didn't bet)
Seat 4: seags21 (button) folded before Flop (didn't bet)
Seat 5: PlayTheBlues4U (small blind) folded before Flop
Seat 6: DruMoney201 (big blind) folded on the Flop


PokerStars Hand #203588674055:  Hold'em No Limit ($0.01/$0.02 USD) - 2019/09/10 22:22:38 ET
Table 'Rana' 6-max Seat #3 is the button
Seat 1: delm44 ($1.63 in chips)
Seat 2: vgctmg ($1.67 in chips)
Seat 3: ArtOfWar440 ($4.85 in chips)
Seat 4: seags21 ($1.91 in chips)
Seat 5: PlayTheBlues4U ($2.20 in chips)
Seat 6: DruMoney201 ($1.83 in chips)
seags21: posts small blind $0.01
PlayTheBlues4U: posts big blind $0.02
*** HOLE CARDS ***
Dealt to PlayTheBlues4U [4c Ad]
DruMoney201: folds
delm44: folds
vgctmg: calls $0.02
ArtOfWar440: raises $0.06 to $0.08
seags21: folds
PlayTheBlues4U: calls $0.06
vgctmg: folds
*** FLOP *** [4d 3h 6d]
PlayTheBlues4U: checks
ArtOfWar440: bets $0.10
PlayTheBlues4U: calls $0.10
*** TURN *** [4d 3h 6d] [Jd]
PlayTheBlues4U: checks
ArtOfWar440: checks
*** RIVER *** [4d 3h 6d Jd] [Kd]
PlayTheBlues4U: bets $0.36
ArtOfWar440: folds
Uncalled bet ($0.36) returned to PlayTheBlues4U
PlayTheBlues4U collected $0.37 from pot
PlayTheBlues4U: doesn't show hand
*** SUMMARY ***
Total pot $0.39 | Rake $0.02
Board [4d 3h 6d Jd Kd]
Seat 1: delm44 folded before Flop (didn't bet)
Seat 2: vgctmg folded before Flop
Seat 3: ArtOfWar440 (button) folded on the River
Seat 4: seags21 (small blind) folded before Flop
Seat 5: PlayTheBlues4U (big blind) collected ($0.37)
Seat 6: DruMoney201 folded before Flop (didn't bet)


PokerStars Hand #203588674009:  Hold'em No Limit ($0.01/$0.02 USD) - 2019/09/10 22:22:20 ET
Table 'Rana' 6-max Seat #2 is the button
Seat 1: delm44 ($1.63 in chips)
Seat 2: vgctmg ($1.67 in chips)
Seat 3: ArtOfWar440 ($4.83 in chips)
Seat 4: seags21 ($1.93 in chips)
Seat 5: PlayTheBlues4U ($2.20 in chips)
Seat 6: DruMoney201 ($1.83 in chips)
ArtOfWar440: posts small blind $0.01
seags21: posts big blind $0.02
*** HOLE CARDS ***
Dealt to PlayTheBlues4U [4s Td]
PlayTheBlues4U: folds
DruMoney201: folds
delm44: folds
vgctmg: folds
ArtOfWar440: raises $0.04 to $0.06
seags21: folds
Uncalled bet ($0.04) returned to ArtOfWar440
ArtOfWar440 collected $0.04 from pot
ArtOfWar440: doesn't show hand
*** SUMMARY ***
Total pot $0.04 | Rake $0
Seat 1: delm44 folded before Flop (didn't bet)
Seat 2: vgctmg (button) folded before Flop (didn't bet)
Seat 3: ArtOfWar440 (small blind) collected ($0.04)
Seat 4: seags21 (big blind) folded before Flop
Seat 5: PlayTheBlues4U folded before Flop (didn't bet)
Seat 6: DruMoney201 folded before Flop (didn't bet)


PokerStars Hand #203588673892:  Hold'em No Limit ($0.01/$0.02 USD) - 2019/09/10 22:21:39 ET
Table 'Rana' 6-max Seat #1 is the button
Seat 1: delm44 ($1.57 in chips)
Seat 2: vgctmg ($1.69 in chips)
Seat 3: ArtOfWar440 ($4.85 in chips)
Seat 4: seags21 ($1.93 in chips)
Seat 5: PlayTheBlues4U ($2.20 in chips)
Seat 6: DruMoney201 ($1.85 in chips)
vgctmg: posts small blind $0.01
ArtOfWar440: posts big blind $0.02
*** HOLE CARDS ***
Dealt to PlayTheBlues4U [8h 7h]
seags21: folds
PlayTheBlues4U: folds
DruMoney201: calls $0.02
delm44: calls $0.02
vgctmg: calls $0.01
ArtOfWar440: checks
*** FLOP *** [6c Ah 4d]
vgctmg: checks
ArtOfWar440: checks
DruMoney201: checks
delm44: bets $0.10
vgctmg: folds
ArtOfWar440: folds
DruMoney201: folds
Uncalled bet ($0.10) returned to delm44
delm44 collected $0.08 from pot
delm44: doesn't show hand
*** SUMMARY ***
Total pot $0.08 | Rake $0
Board [6c Ah 4d]
Seat 1: delm44 (button) collected ($0.08)
Seat 2: vgctmg (small blind) folded on the Flop
Seat 3: ArtOfWar440 (big blind) folded on the Flop
Seat 4: seags21 folded before Flop (didn't bet)
Seat 5: PlayTheBlues4U folded before Flop (didn't bet)
Seat 6: DruMoney201 folded on the Flop


PokerStars Hand #203588673790:  Hold'em No Limit ($0.01/$0.02 USD) - 2019/09/10 22:21:06 ET
Table 'Rana' 6-max Seat #6 is the button
Seat 1: delm44 ($1.58 in chips)
Seat 2: vgctmg ($1.71 in chips)
Seat 3: ArtOfWar440 ($4.91 in chips)
Seat 4: seags21 ($1.93 in chips)
Seat 5: PlayTheBlues4U ($2.11 in chips)
Seat 6: DruMoney201 ($1.85 in chips)
delm44: posts small blind $0.01
vgctmg: posts big blind $0.02
*** HOLE CARDS ***
Dealt to PlayTheBlues4U [Jd Jh]
ArtOfWar440: raises $0.04 to $0.06
seags21: folds
PlayTheBlues4U: raises $0.10 to $0.16
DruMoney201: folds
delm44: folds
vgctmg: folds
ArtOfWar440: folds
Uncalled bet ($0.10) returned to PlayTheBlues4U
PlayTheBlues4U collected $0.15 from pot
PlayTheBlues4U: doesn't show hand
*** SUMMARY ***
Total pot $0.15 | Rake $0
Seat 1: delm44 (small blind) folded before Flop
Seat 2: vgctmg (big blind) folded before Flop
Seat 3: ArtOfWar440 folded before Flop
Seat 4: seags21 folded before Flop (didn't bet)
Seat 5: PlayTheBlues4U collected ($0.15)
Seat 6: DruMoney201 (button) folded before Flop (didn't bet)


PokerStars Hand #203588673690:  Hold'em No Limit ($0.01/$0.02 USD) - 2019/09/10 22:20:32 ET
Table 'Rana' 6-max Seat #5 is the button
Seat 1: delm44 ($1.60 in chips)
Seat 2: vgctmg ($1.71 in chips)
Seat 3: ArtOfWar440 ($4.91 in chips)
Seat 4: seags21 ($1.90 in chips)
Seat 5: PlayTheBlues4U ($2.11 in chips)
Seat 6: DruMoney201 ($1.86 in chips)
DruMoney201: posts small blind $0.01
delm44: posts big blind $0.02
*** HOLE CARDS ***
Dealt to PlayTheBlues4U [Qc 3c]
vgctmg: folds
ArtOfWar440: folds
seags21: raises $0.06 to $0.08
PlayTheBlues4U: folds
DruMoney201: folds
delm44: folds
Uncalled bet ($0.06) returned to seags21
seags21 collected $0.05 from pot
seags21: doesn't show hand
*** SUMMARY ***
Total pot $0.05 | Rake $0
Seat 1: delm44 (big blind) folded before Flop
Seat 2: vgctmg folded before Flop (didn't bet)
Seat 3: ArtOfWar440 folded before Flop (didn't bet)
Seat 4: seags21 collected ($0.05)
Seat 5: PlayTheBlues4U (button) folded before Flop (didn't bet)
Seat 6: DruMoney201 (small blind) folded before Flop


PokerStars Hand #203588673552:  Hold'em No Limit ($0.01/$0.02 USD) - 2019/09/10 22:19:41 ET
Table 'Rana' 6-max Seat #4 is the button
Seat 2: vgctmg ($1.68 in chips)
Seat 3: ArtOfWar440 ($4.91 in chips)
Seat 4: seags21 ($1.90 in chips)
Seat 5: PlayTheBlues4U ($2.12 in chips)
Seat 6: DruMoney201 ($1.88 in chips)
PlayTheBlues4U: posts small blind $0.01
DruMoney201: posts big blind $0.02
delm44: sits out
*** HOLE CARDS ***
Dealt to PlayTheBlues4U [5d 3s]
vgctmg: calls $0.02
ArtOfWar440: folds
seags21: folds
PlayTheBlues4U: folds
DruMoney201: checks
*** FLOP *** [Kc Js Jh]
DruMoney201: checks
vgctmg: bets $0.04
DruMoney201: folds
Uncalled bet ($0.04) returned to vgctmg
vgctmg collected $0.05 from pot
vgctmg: doesn't show hand
*** SUMMARY ***
Total pot $0.05 | Rake $0
Board [Kc Js Jh]
Seat 2: vgctmg collected ($0.05)
Seat 3: ArtOfWar440 folded before Flop (didn't bet)
Seat 4: seags21 (button) folded before Flop (didn't bet)
Seat 5: PlayTheBlues4U (small blind) folded before Flop
Seat 6: DruMoney201 (big blind) folded on the Flop


PokerStars Hand #203588673386:  Hold'em No Limit ($0.01/$0.02 USD) - 2019/09/10 22:18:42 ET
Table 'Rana' 6-max Seat #3 is the button
Seat 2: vgctmg ($1.68 in chips)
Seat 3: ArtOfWar440 ($4.91 in chips)
Seat 4: seags21 ($2.03 in chips)
Seat 5: PlayTheBlues4U ($2 in chips)
Seat 6: DruMoney201 ($1.88 in chips)
seags21: posts small blind $0.01
PlayTheBlues4U: posts big blind $0.02
delm44: sits out
*** HOLE CARDS ***
Dealt to PlayTheBlues4U [Ts Js]
DruMoney201: folds
vgctmg: folds
ArtOfWar440: folds
seags21: raises $0.03 to $0.05
PlayTheBlues4U: calls $0.03
*** FLOP *** [6c 8d 9s]
seags21: bets $0.04
PlayTheBlues4U: calls $0.04
*** TURN *** [6c 8d 9s] [4c]
seags21: checks
PlayTheBlues4U: checks
*** RIVER *** [6c 8d 9s 4c] [Jh]
seags21: bets $0.04
PlayTheBlues4U: raises $0.10 to $0.14
seags21: folds
Uncalled bet ($0.10) returned to PlayTheBlues4U
PlayTheBlues4U collected $0.25 from pot
PlayTheBlues4U: doesn't show hand
*** SUMMARY ***
Total pot $0.26 | Rake $0.01
Board [6c 8d 9s 4c Jh]
Seat 2: vgctmg folded before Flop (didn't bet)
Seat 3: ArtOfWar440 (button) folded before Flop (didn't bet)
Seat 4: seags21 (small blind) folded on the River
Seat 5: PlayTheBlues4U (big blind) collected ($0.25)
Seat 6: DruMoney201 folded before Flop (didn't bet)


PokerStars Hand #203588673368:  Hold'em No Limit ($0.01/$0.02 USD) - 2019/09/10 22:18:36 ET
Table 'Fides' 6-max Seat #5 is the button
Seat 1: Sparseeye ($1.62 in chips)
Seat 5: PlayTheBlues4U ($2 in chips)
PlayTheBlues4U: posts small blind $0.01
Sparseeye: posts big blind $0.02
*** HOLE CARDS ***
Dealt to PlayTheBlues4U [3h 9s]
PlayTheBlues4U: folds
Uncalled bet ($0.01) returned to Sparseeye
Sparseeye collected $0.02 from pot
*** SUMMARY ***
Total pot $0.02 | Rake $0
Seat 1: Sparseeye (big blind) collected ($0.02)
Seat 5: PlayTheBlues4U (button) (small blind) folded before Flop


PokerStars Hand #203587647734:  Hold'em No Limit ($0.05/$0.10 USD) - 2019/09/10 21:08:21 ET
Table 'Corvus' 6-max Seat #5 is the button
Seat 1: nando_abarca ($10 in chips)
Seat 2: PlayTheBlues4U ($21.22 in chips)
Seat 3: 123tiger711a ($13.40 in chips)
Seat 4: jmc926 ($12.59 in chips)
Seat 5: F3ign ($16.17 in chips)
Seat 6: BigBlue ($9.86 in chips)
BigBlue: posts small blind $0.05
nando_abarca: posts big blind $0.10
*** HOLE CARDS ***
Dealt to PlayTheBlues4U [7s 7d]
PlayTheBlues4U: raises $0.10 to $0.20
123tiger711a: folds
jmc926: folds
F3ign: folds
BigBlue: folds
nando_abarca: calls $0.10
*** FLOP *** [Tc 4c 9s]
nando_abarca: checks
PlayTheBlues4U: checks
*** TURN *** [Tc 4c 9s] [Ah]
nando_abarca: bets $0.22
PlayTheBlues4U: folds
Uncalled bet ($0.22) returned to nando_abarca
nando_abarca collected $0.43 from pot
nando_abarca: doesn't show hand
*** SUMMARY ***
Total pot $0.45 | Rake $0.02
Board [Tc 4c 9s Ah]
Seat 1: nando_abarca (big blind) collected ($0.43)
Seat 2: PlayTheBlues4U folded on the Turn
Seat 3: 123tiger711a folded before Flop (didn't bet)
Seat 4: jmc926 folded before Flop (didn't bet)
Seat 5: F3ign (button) folded before Flop (didn't bet)
Seat 6: BigBlue (small blind) folded before Flop


PokerStars Hand #203587647648:  Hold'em No Limit ($0.05/$0.10 USD) - 2019/09/10 21:07:57 ET
Table 'Iphigenia' 6-max Seat #2 is the button
Seat 1: kid delaw731 ($8.77 in chips)
Seat 2: nando_abarca ($8.36 in chips)
Seat 3: Nessman355 ($5.81 in chips)
Seat 4: F3ign ($22.42 in chips)
Seat 5: PlayTheBlues4U ($14.59 in chips)
Seat 6: RNixon'sHead ($19.88 in chips)
Nessman355: posts small blind $0.05
F3ign: posts big blind $0.10
*** HOLE CARDS ***
Dealt to PlayTheBlues4U [6d 9s]
PlayTheBlues4U: folds
RNixon'sHead: raises $0.15 to $0.25
kid delaw731: folds
nando_abarca: folds
Nessman355: folds
F3ign: folds
Uncalled bet ($0.15) returned to RNixon'sHead
RNixon'sHead collected $0.25 from pot
RNixon'sHead: doesn't show hand
*** SUMMARY ***
Total pot $0.25 | Rake $0
Seat 1: kid delaw731 folded before Flop (didn't bet)
Seat 2: nando_abarca (button) folded before Flop (didn't bet)
Seat 3: Nessman355 (small blind) folded before Flop
Seat 4: F3ign (big blind) folded before Flop
Seat 5: PlayTheBlues4U folded before Flop (didn't bet)
Seat 6: RNixon'sHead collected ($0.25)


PokerStars Hand #203587647639:  Hold'em No Limit ($0.05/$0.10 USD) - 2019/09/10 21:07:54 ET
Table 'Corvus' 6-max Seat #4 is the button
Seat 1: nando_abarca ($10 in chips)
Seat 2: PlayTheBlues4U ($21.07 in chips)
Seat 3: 123tiger711a ($13.40 in chips)
Seat 4: jmc926 ($12.59 in chips)
Seat 5: F3ign ($16.22 in chips)
Seat 6: BigBlue ($9.96 in chips)
F3ign: posts small blind $0.05
BigBlue: posts big blind $0.10
*** HOLE CARDS ***
Dealt to PlayTheBlues4U [Ah Ad]
nando_abarca: folds
PlayTheBlues4U: raises $0.20 to $0.30
123tiger711a: folds
jmc926: folds
F3ign: folds
BigBlue: folds
Uncalled bet ($0.20) returned to PlayTheBlues4U
PlayTheBlues4U collected $0.25 from pot
PlayTheBlues4U: doesn't show hand
*** SUMMARY ***
Total pot $0.25 | Rake $0
Seat 1: nando_abarca folded before Flop (didn't bet)
Seat 2: PlayTheBlues4U collected ($0.25)
Seat 3: 123tiger711a folded before Flop (didn't bet)
Seat 4: jmc926 (button) folded before Flop (didn't bet)
Seat 5: F3ign (small blind) folded before Flop
Seat 6: BigBlue (big blind) folded before Flop


PokerStars Hand #203587647559:  Hold'em No Limit ($0.05/$0.10 USD) - 2019/09/10 21:07:28 ET
Table 'Corvus' 6-max Seat #3 is the button
Seat 1: nando_abarca ($6.58 in chips)
Seat 2: PlayTheBlues4U ($21.07 in chips)
Seat 3: 123tiger711a ($13.25 in chips)
Seat 4: jmc926 ($12.64 in chips)
Seat 5: F3ign ($16.32 in chips)
Seat 6: BigBlue ($9.96 in chips)
jmc926: posts small blind $0.05
F3ign: posts big blind $0.10
*** HOLE CARDS ***
Dealt to PlayTheBlues4U [2d Ts]
BigBlue: folds
nando_abarca: folds
PlayTheBlues4U: folds
123tiger711a: raises $0.40 to $0.50
jmc926: folds
F3ign: folds
Uncalled bet ($0.40) returned to 123tiger711a
123tiger711a collected $0.25 from pot
*** SUMMARY ***
Total pot $0.25 | Rake $0
Seat 1: nando_abarca folded before Flop (didn't bet)
Seat 2: PlayTheBlues4U folded before Flop (didn't bet)
Seat 3: 123tiger711a (button) collected ($0.25)
Seat 4: jmc926 (small blind) folded before Flop
Seat 5: F3ign (big blind) folded before Flop
Seat 6: BigBlue folded before Flop (didn't bet)


PokerStars Hand #203587647532:  Hold'em No Limit ($0.05/$0.10 USD) - 2019/09/10 21:07:21 ET
Table 'Iphigenia' 6-max Seat #1 is the button
Seat 1: kid delaw731 ($8.77 in chips)
Seat 2: nando_abarca ($8.41 in chips)
Seat 3: Nessman355 ($7.45 in chips)
Seat 4: F3ign ($22.42 in chips)
Seat 5: PlayTheBlues4U ($14.59 in chips)
Seat 6: RNixon'sHead ($18.36 in chips)
nando_abarca: posts small blind $0.05
Nessman355: posts big blind $0.10
*** HOLE CARDS ***
Dealt to PlayTheBlues4U [5h Qs]
F3ign: folds
PlayTheBlues4U: folds
RNixon'sHead: raises $0.15 to $0.25
kid delaw731: folds
nando_abarca: folds
Nessman355: calls $0.15
*** FLOP *** [Ad 4s 6c]
Nessman355: checks
RNixon'sHead: checks
*** TURN *** [Ad 4s 6c] [Jc]
Nessman355: checks
RNixon'sHead: bets $0.40
Nessman355: calls $0.40
*** RIVER *** [Ad 4s 6c Jc] [2h]
Nessman355: checks
RNixon'sHead: bets $0.99
Nessman355: calls $0.99
*** SHOW DOWN ***
RNixon'sHead: shows [8h Ac] (a pair of Aces)
Nessman355: mucks hand
RNixon'sHead collected $3.16 from pot
*** SUMMARY ***
Total pot $3.33 | Rake $0.17
Board [Ad 4s 6c Jc 2h]
Seat 1: kid delaw731 (button) folded before Flop (didn't bet)
Seat 2: nando_abarca (small blind) folded before Flop
Seat 3: Nessman355 (big blind) mucked [Jh 3h]
Seat 4: F3ign folded before Flop (didn't bet)
Seat 5: PlayTheBlues4U folded before Flop (didn't bet)
Seat 6: RNixon'sHead showed [8h Ac] and won ($3.16) with a pair of Aces


PokerStars Hand #203587647467:  Hold'em No Limit ($0.05/$0.10 USD) - 2019/09/10 21:07:01 ET
Table 'Corvus' 6-max Seat #2 is the button
Seat 1: nando_abarca ($6.58 in chips)
Seat 2: PlayTheBlues4U ($21.07 in chips)
Seat 3: 123tiger711a ($13.55 in chips)
Seat 4: jmc926 ($12.37 in chips)
Seat 5: F3ign ($16.32 in chips)
Seat 6: BigBlue ($9.96 in chips)
123tiger711a: posts small blind $0.05
jmc926: posts big blind $0.10
*** HOLE CARDS ***
Dealt to PlayTheBlues4U [8h 2d]
F3ign: folds
BigBlue: folds
nando_abarca: folds
PlayTheBlues4U: folds
123tiger711a: calls $0.05
jmc926: raises $0.20 to $0.30
123tiger711a: calls $0.20
*** FLOP *** [Ts Th Qc]
123tiger711a: checks
jmc926: bets $0.29
123tiger711a: folds
Uncalled bet ($0.29) returned to jmc926
jmc926 collected $0.57 from pot
*** SUMMARY ***
Total pot $0.60 | Rake $0.03
Board [Ts Th Qc]
Seat 1: nando_abarca folded before Flop (didn't bet)
Seat 2: PlayTheBlues4U (button) folded before Flop (didn't bet)
Seat 3: 123tiger711a (small blind) folded on the Flop
Seat 4: jmc926 (big blind) collected ($0.57)
Seat 5: F3ign folded before Flop (didn't bet)
Seat 6: BigBlue folded before Flop (didn't bet)


PokerStars Hand #203587647335:  Hold'em No Limit ($0.05/$0.10 USD) - 2019/09/10 21:06:16 ET
Table 'Iphigenia' 6-max Seat #6 is the button
Seat 1: kid delaw731 ($8.82 in chips)
Seat 2: nando_abarca ($8 in chips)
Seat 3: Nessman355 ($7.85 in chips)
Seat 4: F3ign ($22.42 in chips)
Seat 5: PlayTheBlues4U ($14.59 in chips)
Seat 6: RNixon'sHead ($18.36 in chips)
kid delaw731: posts small blind $0.05
nando_abarca: posts big blind $0.10
*** HOLE CARDS ***
Dealt to PlayTheBlues4U [5c Qc]
Nessman355: calls $0.10
F3ign: folds
PlayTheBlues4U: folds
RNixon'sHead: folds
kid delaw731: folds
nando_abarca: checks
*** FLOP *** [4c 3h 5s]
nando_abarca: checks
Nessman355: bets $0.30
nando_abarca: calls $0.30
*** TURN *** [4c 3h 5s] [Ad]
nando_abarca: checks
Nessman355: checks
*** RIVER *** [4c 3h 5s Ad] [Ah]
nando_abarca: bets $0.41
Nessman355: folds
Uncalled bet ($0.41) returned to nando_abarca
nando_abarca collected $0.81 from pot
nando_abarca: doesn't show hand
*** SUMMARY ***
Total pot $0.85 | Rake $0.04
Board [4c 3h 5s Ad Ah]
Seat 1: kid delaw731 (small blind) folded before Flop
Seat 2: nando_abarca (big blind) collected ($0.81)
Seat 3: Nessman355 folded on the River
Seat 4: F3ign folded before Flop (didn't bet)
Seat 5: PlayTheBlues4U folded before Flop (didn't bet)
Seat 6: RNixon'sHead (button) folded before Flop (didn't bet)


PokerStars Hand #203587647188:  Hold'em No Limit ($0.05/$0.10 USD) - 2019/09/10 21:05:26 ET
Table 'Iphigenia' 6-max Seat #5 is the button
Seat 1: kid delaw731 ($8.92 in chips)
Seat 2: nando_abarca ($8 in chips)
Seat 3: Nessman355 ($7.85 in chips)
Seat 4: F3ign ($22.01 in chips)
Seat 5: PlayTheBlues4U ($14.89 in chips)
Seat 6: RNixon'sHead ($18.41 in chips)
RNixon'sHead: posts small blind $0.05
kid delaw731: posts big blind $0.10
*** HOLE CARDS ***
Dealt to PlayTheBlues4U [Qh Th]
nando_abarca: folds
Nessman355: folds
F3ign: raises $0.20 to $0.30
PlayTheBlues4U: calls $0.30
RNixon'sHead: folds
kid delaw731: folds
*** FLOP *** [5d Kd 5s]
F3ign: bets $0.36
PlayTheBlues4U: folds
Uncalled bet ($0.36) returned to F3ign
F3ign collected $0.71 from pot
F3ign: doesn't show hand
*** SUMMARY ***
Total pot $0.75 | Rake $0.04
Board [5d Kd 5s]
Seat 1: kid delaw731 (big blind) folded before Flop
Seat 2: nando_abarca folded before Flop (didn't bet)
Seat 3: Nessman355 folded before Flop (didn't bet)
Seat 4: F3ign collected ($0.71)
Seat 5: PlayTheBlues4U (button) folded on the Flop
Seat 6: RNixon'sHead (small blind) folded before Flop


PokerStars Hand #203587647156:  Hold'em No Limit ($0.05/$0.10 USD) - 2019/09/10 21:05:14 ET
Table 'Corvus' 6-max Seat #1 is the button
Seat 1: nando_abarca ($8.63 in chips)
Seat 2: PlayTheBlues4U ($21.12 in chips)
Seat 3: 123tiger711a ($13.65 in chips)
Seat 4: jmc926 ($10.38 in chips)
Seat 5: F3ign ($16.32 in chips)
Seat 6: BigBlue ($9.96 in chips)
PlayTheBlues4U: posts small blind $0.05
123tiger711a: posts big blind $0.10
*** HOLE CARDS ***
Dealt to PlayTheBlues4U [7s 8h]
jmc926: calls $0.10
F3ign has timed out
F3ign: folds
BigBlue: folds
nando_abarca: raises $0.35 to $0.45
PlayTheBlues4U: folds
123tiger711a: folds
jmc926: calls $0.35
*** FLOP *** [6c 8s Js]
jmc926: checks
nando_abarca: checks
*** TURN *** [6c 8s Js] [Td]
jmc926: checks
nando_abarca: bets $0.60
jmc926: calls $0.60
*** RIVER *** [6c 8s Js Td] [4h]
jmc926: checks
nando_abarca: bets $1
jmc926: calls $1
*** SHOW DOWN ***
nando_abarca: shows [Qd Kc] (high card King)
jmc926: shows [4s 4d] (three of a kind, Fours)
jmc926 collected $4.04 from pot
*** SUMMARY ***
Total pot $4.25 | Rake $0.21
Board [6c 8s Js Td 4h]
Seat 1: nando_abarca (button) showed [Qd Kc] and lost with high card King
Seat 2: PlayTheBlues4U (small blind) folded before Flop
Seat 3: 123tiger711a (big blind) folded before Flop
Seat 4: jmc926 showed [4s 4d] and won ($4.04) with three of a kind, Fours
Seat 5: F3ign folded before Flop (didn't bet)
Seat 6: BigBlue folded before Flop (didn't bet)


PokerStars Hand #203587647073:  Hold'em No Limit ($0.05/$0.10 USD) - 2019/09/10 21:04:49 ET
Table 'Iphigenia' 6-max Seat #4 is the button
Seat 2: nando_abarca ($8 in chips)
Seat 3: Nessman355 ($7.85 in chips)
Seat 4: F3ign ($22.01 in chips)
Seat 5: PlayTheBlues4U ($14.23 in chips)
Seat 6: RNixon'sHead ($19.14 in chips)
PlayTheBlues4U: posts small blind $0.05
RNixon'sHead: posts big blind $0.10
kid delaw731: sits out
*** HOLE CARDS ***
Dealt to PlayTheBlues4U [Qd Jh]
nando_abarca: folds
Nessman355: folds
F3ign: folds
PlayTheBlues4U: calls $0.05
RNixon'sHead: raises $0.30 to $0.40
PlayTheBlues4U: calls $0.30
*** FLOP *** [4d 6h 9s]
PlayTheBlues4U: checks
RNixon'sHead: bets $0.33
PlayTheBlues4U: calls $0.33
*** TURN *** [4d 6h 9s] [5c]
PlayTheBlues4U: checks
RNixon'sHead: checks
*** RIVER *** [4d 6h 9s 5c] [8d]
PlayTheBlues4U: bets $1
RNixon'sHead: folds
Uncalled bet ($1) returned to PlayTheBlues4U
PlayTheBlues4U collected $1.39 from pot
PlayTheBlues4U: doesn't show hand
*** SUMMARY ***
Total pot $1.46 | Rake $0.07
Board [4d 6h 9s 5c 8d]
Seat 2: nando_abarca folded before Flop (didn't bet)
Seat 3: Nessman355 folded before Flop (didn't bet)
Seat 4: F3ign (button) folded before Flop (didn't bet)
Seat 5: PlayTheBlues4U (small blind) collected ($1.39)
Seat 6: RNixon'sHead (big blind) folded on the River


PokerStars Hand #203587647047:  Hold'em No Limit ($0.05/$0.10 USD) - 2019/09/10 21:04:42 ET
Table 'Iphigenia' 6-max Seat #3 is the button
Seat 2: nando_abarca ($8 in chips)
Seat 3: Nessman355 ($7.85 in chips)
Seat 4: F3ign ($22.06 in chips)
Seat 5: PlayTheBlues4U ($14.18 in chips)
Seat 6: RNixon'sHead ($19.14 in chips)
F3ign: posts small blind $0.05
PlayTheBlues4U: posts big blind $0.10
kid delaw731: sits out
*** HOLE CARDS ***
Dealt to PlayTheBlues4U [7d 2h]
RNixon'sHead: folds
nando_abarca: folds
Nessman355: folds
F3ign: folds
Uncalled bet ($0.05) returned to PlayTheBlues4U
PlayTheBlues4U collected $0.10 from pot
PlayTheBlues4U: doesn't show hand
*** SUMMARY ***
Total pot $0.10 | Rake $0
Seat 2: nando_abarca folded before Flop (didn't bet)
Seat 3: Nessman355 (button) folded before Flop (didn't bet)
Seat 4: F3ign (small blind) folded before Flop
Seat 5: PlayTheBlues4U (big blind) collected ($0.10)
Seat 6: RNixon'sHead folded before Flop (didn't bet)


PokerStars Hand #203587647040:  Hold'em No Limit ($0.05/$0.10 USD) - 2019/09/10 21:04:40 ET
Table 'Corvus' 6-max Seat #6 is the button
Seat 1: nando_abarca ($8.68 in chips)
Seat 2: PlayTheBlues4U ($21.22 in chips)
Seat 3: 123tiger711a ($14.35 in chips)
Seat 4: jmc926 ($10.38 in chips)
Seat 5: F3ign ($16.32 in chips)
Seat 6: BigBlue ($9.19 in chips)
nando_abarca: posts small blind $0.05
PlayTheBlues4U: posts big blind $0.10
*** HOLE CARDS ***
Dealt to PlayTheBlues4U [4s Td]
123tiger711a: calls $0.10
jmc926: folds
F3ign: folds
BigBlue: raises $0.20 to $0.30
nando_abarca: folds
PlayTheBlues4U: folds
123tiger711a: calls $0.20
*** FLOP *** [9d 3s 8h]
123tiger711a: checks
BigBlue: checks
*** TURN *** [9d 3s 8h] [3c]
123tiger711a: checks
BigBlue: checks
*** RIVER *** [9d 3s 8h 3c] [7d]
123tiger711a: checks
BigBlue: bets $0.40
123tiger711a: calls $0.40
*** SHOW DOWN ***
BigBlue: shows [7h Ad] (two pair, Sevens and Threes)
123tiger711a: mucks hand
BigBlue collected $1.47 from pot
*** SUMMARY ***
Total pot $1.55 | Rake $0.08
Board [9d 3s 8h 3c 7d]
Seat 1: nando_abarca (small blind) folded before Flop
Seat 2: PlayTheBlues4U (big blind) folded before Flop
Seat 3: 123tiger711a mucked [Kd 5d]
Seat 4: jmc926 folded before Flop (didn't bet)
Seat 5: F3ign folded before Flop (didn't bet)
Seat 6: BigBlue (button) showed [7h Ad] and won ($1.47) with two pair, Sevens and Threes


PokerStars Hand #203587646988:  Hold'em No Limit ($0.05/$0.10 USD) - 2019/09/10 21:04:25 ET
Table 'Iphigenia' 6-max Seat #2 is the button
Seat 2: nando_abarca ($8 in chips)
Seat 3: Nessman355 ($7.90 in chips)
Seat 4: F3ign ($22.16 in chips)
Seat 5: PlayTheBlues4U ($14.18 in chips)
Seat 6: RNixon'sHead ($18.99 in chips)
Nessman355: posts small blind $0.05
F3ign: posts big blind $0.10
kid delaw731: sits out
*** HOLE CARDS ***
Dealt to PlayTheBlues4U [4s 9s]
PlayTheBlues4U: folds
RNixon'sHead: raises $0.15 to $0.25
nando_abarca: folds
Nessman355: folds
F3ign: folds
Uncalled bet ($0.15) returned to RNixon'sHead
RNixon'sHead collected $0.25 from pot
RNixon'sHead: doesn't show hand
*** SUMMARY ***
Total pot $0.25 | Rake $0
Seat 2: nando_abarca (button) folded before Flop (didn't bet)
Seat 3: Nessman355 (small blind) folded before Flop
Seat 4: F3ign (big blind) folded before Flop
Seat 5: PlayTheBlues4U folded before Flop (didn't bet)
Seat 6: RNixon'sHead collected ($0.25)


PokerStars Hand #203587646968:  Hold'em No Limit ($0.05/$0.10 USD) - 2019/09/10 21:04:19 ET
Table 'Corvus' 6-max Seat #5 is the button
Seat 1: nando_abarca ($8.78 in chips)
Seat 2: PlayTheBlues4U ($21.22 in chips)
Seat 3: 123tiger711a ($14.35 in chips)
Seat 4: jmc926 ($10.23 in chips)
Seat 5: F3ign ($16.32 in chips)
Seat 6: BigBlue ($9.24 in chips)
BigBlue: posts small blind $0.05
nando_abarca: posts big blind $0.10
*** HOLE CARDS ***
Dealt to PlayTheBlues4U [Td 3s]
PlayTheBlues4U: folds
123tiger711a: folds
jmc926: raises $0.20 to $0.30
F3ign: folds
BigBlue: folds
nando_abarca: folds
Uncalled bet ($0.20) returned to jmc926
jmc926 collected $0.25 from pot
*** SUMMARY ***
Total pot $0.25 | Rake $0
Seat 1: nando_abarca (big blind) folded before Flop
Seat 2: PlayTheBlues4U folded before Flop (didn't bet)
Seat 3: 123tiger711a folded before Flop (didn't bet)
Seat 4: jmc926 collected ($0.25)
Seat 5: F3ign (button) folded before Flop (didn't bet)
Seat 6: BigBlue (small blind) folded before Flop


PokerStars Hand #203587646887:  Hold'em No Limit ($0.05/$0.10 USD) - 2019/09/10 21:03:54 ET
Table 'Iphigenia' 6-max Seat #6 is the button
Seat 2: nando_abarca ($8.05 in chips)
Seat 3: Nessman355 ($8 in chips)
Seat 4: F3ign ($22.16 in chips)
Seat 5: PlayTheBlues4U ($14.18 in chips)
Seat 6: RNixon'sHead ($18.84 in chips)
kid delaw731 will be allowed to play after the button
nando_abarca: posts small blind $0.05
Nessman355: posts big blind $0.10
*** HOLE CARDS ***
Dealt to PlayTheBlues4U [4s Kc]
F3ign: folds
PlayTheBlues4U: folds
RNixon'sHead: raises $0.15 to $0.25
nando_abarca: folds
Nessman355: folds
Uncalled bet ($0.15) returned to RNixon'sHead
RNixon'sHead collected $0.25 from pot
RNixon'sHead: doesn't show hand
*** SUMMARY ***
Total pot $0.25 | Rake $0
Seat 2: nando_abarca (small blind) folded before Flop
Seat 3: Nessman355 (big blind) folded before Flop
Seat 4: F3ign folded before Flop (didn't bet)
Seat 5: PlayTheBlues4U folded before Flop (didn't bet)
Seat 6: RNixon'sHead (button) collected ($0.25)


PokerStars Hand #203587646616:  Hold'em No Limit ($0.05/$0.10 USD) - 2019/09/10 21:02:31 ET
Table 'Corvus' 6-max Seat #4 is the button
Seat 1: nando_abarca ($9.18 in chips)
Seat 2: PlayTheBlues4U ($17.86 in chips)
Seat 3: 123tiger711a ($14.35 in chips)
Seat 4: jmc926 ($10.23 in chips)
Seat 5: F3ign ($19.52 in chips)
Seat 6: BigBlue ($9.34 in chips)
F3ign: posts small blind $0.05
BigBlue: posts big blind $0.10
*** HOLE CARDS ***
Dealt to PlayTheBlues4U [Kc Kd]
nando_abarca: calls $0.10
PlayTheBlues4U: raises $0.30 to $0.40
123tiger711a: folds
jmc926: folds
F3ign: calls $0.35
BigBlue: folds
nando_abarca: calls $0.30
*** FLOP *** [7s Qh Jd]
F3ign: checks
nando_abarca: checks
PlayTheBlues4U: bets $1
F3ign: calls $1
nando_abarca: folds
*** TURN *** [7s Qh Jd] [6s]
F3ign: checks
PlayTheBlues4U: bets $1.80
F3ign: calls $1.80
*** RIVER *** [7s Qh Jd 6s] [2s]
F3ign: checks
PlayTheBlues4U: bets $3.40
F3ign: folds
Uncalled bet ($3.40) returned to PlayTheBlues4U
PlayTheBlues4U collected $6.56 from pot
PlayTheBlues4U: doesn't show hand
*** SUMMARY ***
Total pot $6.90 | Rake $0.34
Board [7s Qh Jd 6s 2s]
Seat 1: nando_abarca folded on the Flop
Seat 2: PlayTheBlues4U collected ($6.56)
Seat 3: 123tiger711a folded before Flop (didn't bet)
Seat 4: jmc926 (button) folded before Flop (didn't bet)
Seat 5: F3ign (small blind) folded on the River
Seat 6: BigBlue (big blind) folded before Flop


PokerStars Hand #203587646600:  Hold'em No Limit ($0.05/$0.10 USD) - 2019/09/10 21:02:28 ET
Table 'Iphigenia' 6-max Seat #5 is the button
Seat 2: nando_abarca ($9.85 in chips)
Seat 4: F3ign ($22.16 in chips)
Seat 5: PlayTheBlues4U ($14.38 in chips)
Seat 6: RNixon'sHead ($17.03 in chips)
RNixon'sHead: posts small blind $0.05
nando_abarca: posts big blind $0.10
*** HOLE CARDS ***
Dealt to PlayTheBlues4U [As 6s]
F3ign: folds
PlayTheBlues4U: raises $0.10 to $0.20
RNixon'sHead: calls $0.15
nando_abarca: raises $0.60 to $0.80
PlayTheBlues4U: folds
RNixon'sHead: calls $0.60
*** FLOP *** [7h Ks 4d]
RNixon'sHead: checks
nando_abarca: bets $1
RNixon'sHead: calls $1
*** TURN *** [7h Ks 4d] [2d]
Nessman355 joins the table at seat #3
RNixon'sHead: checks
nando_abarca: checks
*** RIVER *** [7h Ks 4d 2d] [5d]
RNixon'sHead: bets $2.91
nando_abarca: folds
Uncalled bet ($2.91) returned to RNixon'sHead
RNixon'sHead collected $3.61 from pot
RNixon'sHead: doesn't show hand
*** SUMMARY ***
Total pot $3.80 | Rake $0.19
Board [7h Ks 4d 2d 5d]
Seat 2: nando_abarca (big blind) folded on the River
Seat 4: F3ign folded before Flop (didn't bet)
Seat 5: PlayTheBlues4U (button) folded before Flop
Seat 6: RNixon'sHead (small blind) collected ($3.61)


PokerStars Hand #203587646554:  Hold'em No Limit ($0.05/$0.10 USD) - 2019/09/10 21:02:14 ET
Table 'Iphigenia' 6-max Seat #4 is the button
Seat 2: nando_abarca ($9.85 in chips)
Seat 4: F3ign ($22.01 in chips)
Seat 5: PlayTheBlues4U ($14.43 in chips)
Seat 6: RNixon'sHead ($17.13 in chips)
PlayTheBlues4U: posts small blind $0.05
RNixon'sHead: posts big blind $0.10
*** HOLE CARDS ***
Dealt to PlayTheBlues4U [8d Js]
nando_abarca: folds
F3ign: raises $0.20 to $0.30
PlayTheBlues4U: folds
RNixon'sHead: folds
Uncalled bet ($0.20) returned to F3ign
F3ign collected $0.25 from pot
F3ign: doesn't show hand
*** SUMMARY ***
Total pot $0.25 | Rake $0
Seat 2: nando_abarca folded before Flop (didn't bet)
Seat 4: F3ign (button) collected ($0.25)
Seat 5: PlayTheBlues4U (small blind) folded before Flop
Seat 6: RNixon'sHead (big blind) folded before Flop


PokerStars Hand #203587646515:  Hold'em No Limit ($0.05/$0.10 USD) - 2019/09/10 21:02:06 ET
Table 'Iphigenia' 6-max Seat #2 is the button
Seat 2: nando_abarca ($9.85 in chips)
Seat 4: F3ign ($22.06 in chips)
Seat 5: PlayTheBlues4U ($14.53 in chips)
Seat 6: RNixon'sHead ($16.98 in chips)
F3ign: posts small blind $0.05
PlayTheBlues4U: posts big blind $0.10
*** HOLE CARDS ***
Dealt to PlayTheBlues4U [Kh 6c]
RNixon'sHead: raises $0.15 to $0.25
nando_abarca: folds
F3ign: folds
PlayTheBlues4U: folds
Uncalled bet ($0.15) returned to RNixon'sHead
RNixon'sHead collected $0.25 from pot
RNixon'sHead: doesn't show hand
*** SUMMARY ***
Total pot $0.25 | Rake $0
Seat 2: nando_abarca (button) folded before Flop (didn't bet)
Seat 4: F3ign (small blind) folded before Flop
Seat 5: PlayTheBlues4U (big blind) folded before Flop
Seat 6: RNixon'sHead collected ($0.25)


PokerStars Hand #203587646514:  Hold'em No Limit ($0.05/$0.10 USD) - 2019/09/10 21:02:06 ET
Table 'Corvus' 6-max Seat #3 is the button
Seat 1: nando_abarca ($9.18 in chips)
Seat 2: PlayTheBlues4U ($17.86 in chips)
Seat 3: 123tiger711a ($14.21 in chips)
Seat 4: jmc926 ($10.28 in chips)
Seat 5: F3ign ($19.62 in chips)
Seat 6: BigBlue ($9.34 in chips)
jmc926: posts small blind $0.05
F3ign: posts big blind $0.10
*** HOLE CARDS ***
Dealt to PlayTheBlues4U [6s 3h]
BigBlue: folds
nando_abarca: folds
PlayTheBlues4U: folds
123tiger711a: calls $0.10
jmc926: folds
F3ign: checks
*** FLOP *** [6d Kd 6h]
F3ign: checks
123tiger711a: bets $0.12
F3ign: folds
Uncalled bet ($0.12) returned to 123tiger711a
123tiger711a collected $0.24 from pot
*** SUMMARY ***
Total pot $0.25 | Rake $0.01
Board [6d Kd 6h]
Seat 1: nando_abarca folded before Flop (didn't bet)
Seat 2: PlayTheBlues4U folded before Flop (didn't bet)
Seat 3: 123tiger711a (button) collected ($0.24)
Seat 4: jmc926 (small blind) folded before Flop
Seat 5: F3ign (big blind) folded on the Flop
Seat 6: BigBlue folded before Flop (didn't bet)


PokerStars Hand #203587646442:  Hold'em No Limit ($0.05/$0.10 USD) - 2019/09/10 21:01:44 ET
Table 'Iphigenia' 6-max Seat #6 is the button
Seat 2: nando_abarca ($9.90 in chips)
Seat 4: F3ign ($22.16 in chips)
Seat 5: PlayTheBlues4U ($14.53 in chips)
Seat 6: RNixon'sHead ($16.83 in chips)
nando_abarca: posts small blind $0.05
F3ign: posts big blind $0.10
*** HOLE CARDS ***
Dealt to PlayTheBlues4U [As Tc]
PlayTheBlues4U: folds
BigBlue leaves the table
RNixon'sHead: raises $0.15 to $0.25
nando_abarca: folds
F3ign: folds
Uncalled bet ($0.15) returned to RNixon'sHead
RNixon'sHead collected $0.25 from pot
RNixon'sHead: doesn't show hand
*** SUMMARY ***
Total pot $0.25 | Rake $0
Seat 2: nando_abarca (small blind) folded before Flop
Seat 4: F3ign (big blind) folded before Flop
Seat 5: PlayTheBlues4U folded before Flop (didn't bet)
Seat 6: RNixon'sHead (button) collected ($0.25)


PokerStars Hand #203587646335:  Hold'em No Limit ($0.05/$0.10 USD) - 2019/09/10 21:01:13 ET
Table 'Corvus' 6-max Seat #2 is the button
Seat 1: nando_abarca ($9 in chips)
Seat 2: PlayTheBlues4U ($17.86 in chips)
Seat 3: 123tiger711a ($14.31 in chips)
Seat 4: jmc926 ($10.38 in chips)
Seat 5: F3ign ($19.62 in chips)
Seat 6: BigBlue ($9.34 in chips)
123tiger711a: posts small blind $0.05
jmc926: posts big blind $0.10
*** HOLE CARDS ***
Dealt to PlayTheBlues4U [Tc Jh]
F3ign: folds
BigBlue: folds
nando_abarca: calls $0.10
PlayTheBlues4U: folds
123tiger711a: calls $0.05
jmc926: checks
*** FLOP *** [Js Ah Kh]
123tiger711a: checks
jmc926: checks
nando_abarca: bets $0.20
123tiger711a: folds
jmc926: folds
Uncalled bet ($0.20) returned to nando_abarca
nando_abarca collected $0.28 from pot
nando_abarca: doesn't show hand
*** SUMMARY ***
Total pot $0.30 | Rake $0.02
Board [Js Ah Kh]
Seat 1: nando_abarca collected ($0.28)
Seat 2: PlayTheBlues4U (button) folded before Flop (didn't bet)
Seat 3: 123tiger711a (small blind) folded on the Flop
Seat 4: jmc926 (big blind) folded on the Flop
Seat 5: F3ign folded before Flop (didn't bet)
Seat 6: BigBlue folded before Flop (didn't bet)


PokerStars Hand #203587646214:  Hold'em No Limit ($0.05/$0.10 USD) - 2019/09/10 21:00:43 ET
Table 'Corvus' 6-max Seat #1 is the button
Seat 1: nando_abarca ($9 in chips)
Seat 2: PlayTheBlues4U ($17.91 in chips)
Seat 3: 123tiger711a ($13.89 in chips)
Seat 4: jmc926 ($10.58 in chips)
Seat 5: F3ign ($19.82 in chips)
Seat 6: BigBlue ($9.34 in chips)
PlayTheBlues4U: posts small blind $0.05
123tiger711a: posts big blind $0.10
*** HOLE CARDS ***
Dealt to PlayTheBlues4U [5d Tc]
jmc926: raises $0.10 to $0.20
F3ign: calls $0.20
BigBlue: folds
nando_abarca: folds
PlayTheBlues4U: folds
123tiger711a: calls $0.10
*** FLOP *** [Qc 3d 7h]
123tiger711a: checks
jmc926: checks
F3ign: checks
*** TURN *** [Qc 3d 7h] [4d]
123tiger711a: bets $0.62
jmc926: folds
F3ign: folds
Uncalled bet ($0.62) returned to 123tiger711a
123tiger711a collected $0.62 from pot
*** SUMMARY ***
Total pot $0.65 | Rake $0.03
Board [Qc 3d 7h 4d]
Seat 1: nando_abarca (button) folded before Flop (didn't bet)
Seat 2: PlayTheBlues4U (small blind) folded before Flop
Seat 3: 123tiger711a (big blind) collected ($0.62)
Seat 4: jmc926 folded on the Turn
Seat 5: F3ign folded on the Turn
Seat 6: BigBlue folded before Flop (didn't bet)


PokerStars Hand #203587646204:  Hold'em No Limit ($0.05/$0.10 USD) - 2019/09/10 21:00:40 ET
Table 'Iphigenia' 6-max Seat #5 is the button
Seat 2: nando_abarca ($10 in chips)
Seat 3: BigBlue ($3.21 in chips)
Seat 4: F3ign ($22.16 in chips)
Seat 5: PlayTheBlues4U ($11.50 in chips)
Seat 6: RNixon'sHead ($16.88 in chips)
RNixon'sHead: posts small blind $0.05
nando_abarca: posts big blind $0.10
*** HOLE CARDS ***
Dealt to PlayTheBlues4U [Qc Kh]
BigBlue: calls $0.10
F3ign: folds
PlayTheBlues4U: raises $0.30 to $0.40
RNixon'sHead: folds
nando_abarca: folds
BigBlue: calls $0.30
*** FLOP *** [Qd 9c 6c]
BigBlue: checks
PlayTheBlues4U: bets $0.60
BigBlue: calls $0.60
*** TURN *** [Qd 9c 6c] [8h]
BigBlue: checks
PlayTheBlues4U: bets $10.50 and is all-in
BigBlue: calls $2.21 and is all-in
Uncalled bet ($8.29) returned to PlayTheBlues4U
*** RIVER *** [Qd 9c 6c 8h] [5h]
*** SHOW DOWN ***
BigBlue: shows [Js Qs] (a pair of Queens)
PlayTheBlues4U: shows [Qc Kh] (a pair of Queens - King kicker)
PlayTheBlues4U collected $6.24 from pot
*** SUMMARY ***
Total pot $6.57 | Rake $0.33
Board [Qd 9c 6c 8h 5h]
Seat 2: nando_abarca (big blind) folded before Flop
Seat 3: BigBlue showed [Js Qs] and lost with a pair of Queens
Seat 4: F3ign folded before Flop (didn't bet)
Seat 5: PlayTheBlues4U (button) showed [Qc Kh] and won ($6.24) with a pair of Queens
Seat 6: RNixon'sHead (small blind) folded before Flop


PokerStars Hand #203587646158:  Hold'em No Limit ($0.05/$0.10 USD) - 2019/09/10 21:00:23 ET
Table 'Iphigenia' 6-max Seat #4 is the button
Seat 2: nando_abarca ($10 in chips)
Seat 3: BigBlue ($3.21 in chips)
Seat 4: F3ign ($22.01 in chips)
Seat 5: PlayTheBlues4U ($11.55 in chips)
Seat 6: RNixon'sHead ($16.98 in chips)
PlayTheBlues4U: posts small blind $0.05
RNixon'sHead: posts big blind $0.10
*** HOLE CARDS ***
Dealt to PlayTheBlues4U [3d 5c]
nando_abarca: folds
BigBlue: folds
F3ign: raises $0.20 to $0.30
PlayTheBlues4U: folds
RNixon'sHead: folds
Uncalled bet ($0.20) returned to F3ign
F3ign collected $0.25 from pot
F3ign: doesn't show hand
*** SUMMARY ***
Total pot $0.25 | Rake $0
Seat 2: nando_abarca folded before Flop (didn't bet)
Seat 3: BigBlue folded before Flop (didn't bet)
Seat 4: F3ign (button) collected ($0.25)
Seat 5: PlayTheBlues4U (small blind) folded before Flop
Seat 6: RNixon'sHead (big blind) folded before Flop


PokerStars Hand #203587646082:  Hold'em No Limit ($0.05/$0.10 USD) - 2019/09/10 20:59:59 ET
Table 'Corvus' 6-max Seat #6 is the button
Seat 1: nando_abarca ($9.10 in chips)
Seat 2: PlayTheBlues4U ($17.73 in chips)
Seat 3: 123tiger711a ($13.89 in chips)
Seat 4: jmc926 ($10.68 in chips)
Seat 5: F3ign ($19.82 in chips)
Seat 6: BigBlue ($9.34 in chips)
nando_abarca: posts small blind $0.05
PlayTheBlues4U: posts big blind $0.10
*** HOLE CARDS ***
Dealt to PlayTheBlues4U [3c 4h]
123tiger711a: folds
jmc926: calls $0.10
F3ign: folds
BigBlue: folds
nando_abarca: calls $0.05
PlayTheBlues4U: checks
*** FLOP *** [7c 9d 4s]
nando_abarca: checks
PlayTheBlues4U: checks
jmc926: checks
*** TURN *** [7c 9d 4s] [7h]
nando_abarca: checks
PlayTheBlues4U: checks
jmc926: checks
*** RIVER *** [7c 9d 4s 7h] [7d]
nando_abarca: checks
PlayTheBlues4U: checks
jmc926: checks
*** SHOW DOWN ***
nando_abarca: shows [Ac Js] (three of a kind, Sevens)
PlayTheBlues4U: shows [3c 4h] (a full house, Sevens full of Fours)
jmc926: mucks hand
PlayTheBlues4U collected $0.28 from pot
*** SUMMARY ***
Total pot $0.30 | Rake $0.02
Board [7c 9d 4s 7h 7d]
Seat 1: nando_abarca (small blind) showed [Ac Js] and lost with three of a kind, Sevens
Seat 2: PlayTheBlues4U (big blind) showed [3c 4h] and won ($0.28) with a full house, Sevens full of Fours
Seat 3: 123tiger711a folded before Flop (didn't bet)
Seat 4: jmc926 mucked [Th Qs]
Seat 5: F3ign folded before Flop (didn't bet)
Seat 6: BigBlue (button) folded before Flop (didn't bet)


PokerStars Hand #203587646055:  Hold'em No Limit ($0.05/$0.10 USD) - 2019/09/10 20:59:49 ET
Table 'Iphigenia' 6-max Seat #3 is the button
Seat 2: nando_abarca ($5.67 in chips)
Seat 3: BigBlue ($3.21 in chips)
Seat 4: F3ign ($21.91 in chips)
Seat 5: PlayTheBlues4U ($11.65 in chips)
Seat 6: RNixon'sHead ($16.98 in chips)
F3ign: posts small blind $0.05
PlayTheBlues4U: posts big blind $0.10
*** HOLE CARDS ***
Dealt to PlayTheBlues4U [9c Qh]
RNixon'sHead: folds
nando_abarca: folds
BigBlue: folds
F3ign: raises $0.20 to $0.30
PlayTheBlues4U: folds
Uncalled bet ($0.20) returned to F3ign
F3ign collected $0.20 from pot
F3ign: doesn't show hand
*** SUMMARY ***
Total pot $0.20 | Rake $0
Seat 2: nando_abarca folded before Flop (didn't bet)
Seat 3: BigBlue (button) folded before Flop (didn't bet)
Seat 4: F3ign (small blind) collected ($0.20)
Seat 5: PlayTheBlues4U (big blind) folded before Flop
Seat 6: RNixon'sHead folded before Flop (didn't bet)


PokerStars Hand #203587646032:  Hold'em No Limit ($0.05/$0.10 USD) - 2019/09/10 20:59:39 ET
Table 'Corvus' 6-max Seat #5 is the button
Seat 1: nando_abarca ($9.20 in chips)
Seat 2: PlayTheBlues4U ($17.73 in chips)
Seat 3: 123tiger711a ($13.89 in chips)
Seat 4: jmc926 ($10.53 in chips)
Seat 5: F3ign ($19.82 in chips)
Seat 6: BigBlue ($9.39 in chips)
BigBlue: posts small blind $0.05
nando_abarca: posts big blind $0.10
*** HOLE CARDS ***
Dealt to PlayTheBlues4U [6c 7h]
PlayTheBlues4U: folds
123tiger711a: folds
jmc926: raises $0.20 to $0.30
F3ign: folds
BigBlue: folds
nando_abarca: folds
Uncalled bet ($0.20) returned to jmc926
jmc926 collected $0.25 from pot
*** SUMMARY ***
Total pot $0.25 | Rake $0
Seat 1: nando_abarca (big blind) folded before Flop
Seat 2: PlayTheBlues4U folded before Flop (didn't bet)
Seat 3: 123tiger711a folded before Flop (didn't bet)
Seat 4: jmc926 collected ($0.25)
Seat 5: F3ign (button) folded before Flop (didn't bet)
Seat 6: BigBlue (small blind) folded before Flop


PokerStars Hand #203587646028:  Hold'em No Limit ($0.05/$0.10 USD) - 2019/09/10 20:59:36 ET
Table 'Iphigenia' 6-max Seat #2 is the button
Seat 2: nando_abarca ($5.67 in chips)
Seat 3: BigBlue ($3.26 in chips)
Seat 4: F3ign ($22.01 in chips)
Seat 5: PlayTheBlues4U ($11.50 in chips)
Seat 6: RNixon'sHead ($16.98 in chips)
BigBlue: posts small blind $0.05
F3ign: posts big blind $0.10
*** HOLE CARDS ***
Dealt to PlayTheBlues4U [Qs Ks]
PlayTheBlues4U: raises $0.20 to $0.30
RNixon'sHead: folds
nando_abarca: folds
BigBlue: folds
F3ign: folds
Uncalled bet ($0.20) returned to PlayTheBlues4U
PlayTheBlues4U collected $0.25 from pot
PlayTheBlues4U: doesn't show hand
*** SUMMARY ***
Total pot $0.25 | Rake $0
Seat 2: nando_abarca (button) folded before Flop (didn't bet)
Seat 3: BigBlue (small blind) folded before Flop
Seat 4: F3ign (big blind) folded before Flop
Seat 5: PlayTheBlues4U collected ($0.25)
Seat 6: RNixon'sHead folded before Flop (didn't bet)


PokerStars Hand #203587645922:  Hold'em No Limit ($0.05/$0.10 USD) - 2019/09/10 20:59:01 ET
Table 'Corvus' 6-max Seat #4 is the button
Seat 1: nando_abarca ($9.20 in chips)
Seat 2: PlayTheBlues4U ($17.73 in chips)
Seat 3: 123tiger711a ($13.89 in chips)
Seat 4: jmc926 ($9.99 in chips)
Seat 5: F3ign ($20.32 in chips)
Seat 6: BigBlue ($9.49 in chips)
F3ign: posts small blind $0.05
BigBlue: posts big blind $0.10
*** HOLE CARDS ***
Dealt to PlayTheBlues4U [As Td]
nando_abarca: folds
PlayTheBlues4U: folds
123tiger711a: folds
jmc926: raises $0.40 to $0.50
F3ign: calls $0.45
BigBlue: folds
*** FLOP *** [2c 7s 6c]
F3ign: checks
jmc926: bets $0.90
F3ign: folds
Uncalled bet ($0.90) returned to jmc926
jmc926 collected $1.04 from pot
*** SUMMARY ***
Total pot $1.10 | Rake $0.06
Board [2c 7s 6c]
Seat 1: nando_abarca folded before Flop (didn't bet)
Seat 2: PlayTheBlues4U folded before Flop (didn't bet)
Seat 3: 123tiger711a folded before Flop (didn't bet)
Seat 4: jmc926 (button) collected ($1.04)
Seat 5: F3ign (small blind) folded on the Flop
Seat 6: BigBlue (big blind) folded before Flop


PokerStars Hand #203587645883:  Hold'em No Limit ($0.05/$0.10 USD) - 2019/09/10 20:58:47 ET
Table 'Corvus' 6-max Seat #3 is the button
Seat 1: nando_abarca ($9.20 in chips)
Seat 2: PlayTheBlues4U ($17.73 in chips)
Seat 3: 123tiger711a ($13.89 in chips)
Seat 4: jmc926 ($10.04 in chips)
Seat 5: F3ign ($20.42 in chips)
Seat 6: BigBlue ($9.34 in chips)
jmc926: posts small blind $0.05
F3ign: posts big blind $0.10
*** HOLE CARDS ***
Dealt to PlayTheBlues4U [3h 9s]
BigBlue: raises $0.20 to $0.30
nando_abarca: folds
PlayTheBlues4U: folds
123tiger711a: folds
jmc926: folds
F3ign: folds
Uncalled bet ($0.20) returned to BigBlue
BigBlue collected $0.25 from pot
BigBlue: doesn't show hand
*** SUMMARY ***
Total pot $0.25 | Rake $0
Seat 1: nando_abarca folded before Flop (didn't bet)
Seat 2: PlayTheBlues4U folded before Flop (didn't bet)
Seat 3: 123tiger711a (button) folded before Flop (didn't bet)
Seat 4: jmc926 (small blind) folded before Flop
Seat 5: F3ign (big blind) folded before Flop
Seat 6: BigBlue collected ($0.25)


PokerStars Hand #203587645828:  Hold'em No Limit ($0.05/$0.10 USD) - 2019/09/10 20:58:28 ET
Table 'Iphigenia' 6-max Seat #6 is the button
Seat 2: nando_abarca ($10.11 in chips)
Seat 3: BigBlue ($3.36 in chips)
Seat 4: F3ign ($22.01 in chips)
Seat 5: PlayTheBlues4U ($11.50 in chips)
Seat 6: RNixon'sHead ($12.89 in chips)
nando_abarca: posts small blind $0.05
BigBlue: posts big blind $0.10
*** HOLE CARDS ***
Dealt to PlayTheBlues4U [2d As]
F3ign: folds
PlayTheBlues4U: folds
RNixon'sHead: raises $0.15 to $0.25
nando_abarca: calls $0.20
BigBlue: folds
*** FLOP *** [3s 7h 3h]
nando_abarca: checks
RNixon'sHead: bets $0.25
nando_abarca: calls $0.25
*** TURN *** [3s 7h 3h] [6d]
nando_abarca: checks
RNixon'sHead: bets $0.71
nando_abarca: raises $1.23 to $1.94
RNixon'sHead: calls $1.23
*** RIVER *** [3s 7h 3h 6d] [Jd]
nando_abarca: bets $2
RNixon'sHead: calls $2
*** SHOW DOWN ***
nando_abarca: shows [Td Th] (two pair, Tens and Threes)
RNixon'sHead: shows [Qs Qd] (two pair, Queens and Threes)
RNixon'sHead collected $8.53 from pot
*** SUMMARY ***
Total pot $8.98 | Rake $0.45
Board [3s 7h 3h 6d Jd]
Seat 2: nando_abarca (small blind) showed [Td Th] and lost with two pair, Tens and Threes
Seat 3: BigBlue (big blind) folded before Flop
Seat 4: F3ign folded before Flop (didn't bet)
Seat 5: PlayTheBlues4U folded before Flop (didn't bet)
Seat 6: RNixon'sHead (button) showed [Qs Qd] and won ($8.53) with two pair, Queens and Threes


PokerStars Hand #203587645765:  Hold'em No Limit ($0.05/$0.10 USD) - 2019/09/10 20:58:05 ET
Table 'Corvus' 6-max Seat #2 is the button
Seat 1: nando_abarca ($9.30 in chips)
Seat 2: PlayTheBlues4U ($17.73 in chips)
Seat 3: 123tiger711a ($13.71 in chips)
Seat 4: jmc926 ($10.14 in chips)
Seat 5: F3ign ($20.42 in chips)
Seat 6: BigBlue ($9.34 in chips)
123tiger711a: posts small blind $0.05
jmc926: posts big blind $0.10
*** HOLE CARDS ***
Dealt to PlayTheBlues4U [6s 4h]
F3ign: folds
BigBlue: folds
nando_abarca: calls $0.10
PlayTheBlues4U: folds
123tiger711a: calls $0.05
jmc926: checks
*** FLOP *** [Kh Ts Ac]
123tiger711a: checks
jmc926: checks
nando_abarca: checks
*** TURN *** [Kh Ts Ac] [Kd]
123tiger711a: checks
jmc926: checks
nando_abarca: checks
*** RIVER *** [Kh Ts Ac Kd] [3c]
123tiger711a: checks
jmc926: checks
nando_abarca: checks
*** SHOW DOWN ***
123tiger711a: shows [5c 5h] (two pair, Kings and Fives)
jmc926: mucks hand
nando_abarca: mucks hand
123tiger711a collected $0.28 from pot
*** SUMMARY ***
Total pot $0.30 | Rake $0.02
Board [Kh Ts Ac Kd 3c]
Seat 1: nando_abarca mucked [6c 4c]
Seat 2: PlayTheBlues4U (button) folded before Flop (didn't bet)
Seat 3: 123tiger711a (small blind) showed [5c 5h] and won ($0.28) with two pair, Kings and Fives
Seat 4: jmc926 (big blind) mucked [7d Qd]
Seat 5: F3ign folded before Flop (didn't bet)
Seat 6: BigBlue folded before Flop (didn't bet)


PokerStars Hand #203587645706:  Hold'em No Limit ($0.05/$0.10 USD) - 2019/09/10 20:57:42 ET
Table 'Iphigenia' 6-max Seat #5 is the button
Seat 2: nando_abarca ($10.21 in chips)
Seat 3: BigBlue ($3.66 in chips)
Seat 4: F3ign ($22.01 in chips)
Seat 5: PlayTheBlues4U ($11.09 in chips)
Seat 6: RNixon'sHead ($12.94 in chips)
RNixon'sHead: posts small blind $0.05
nando_abarca: posts big blind $0.10
*** HOLE CARDS ***
Dealt to PlayTheBlues4U [Td Jh]
PlayTheBlues4U said, "Arrroooo"
BigBlue: calls $0.10
F3ign: folds
PlayTheBlues4U: raises $0.20 to $0.30
RNixon'sHead: folds
nando_abarca: folds
BigBlue: calls $0.20
*** FLOP *** [6s Jc Ad]
BigBlue: checks
PlayTheBlues4U: bets $0.50
BigBlue: folds
Uncalled bet ($0.50) returned to PlayTheBlues4U
PlayTheBlues4U collected $0.71 from pot
PlayTheBlues4U: doesn't show hand
*** SUMMARY ***
Total pot $0.75 | Rake $0.04
Board [6s Jc Ad]
Seat 2: nando_abarca (big blind) folded before Flop
Seat 3: BigBlue folded on the Flop
Seat 4: F3ign folded before Flop (didn't bet)
Seat 5: PlayTheBlues4U (button) collected ($0.71)
Seat 6: RNixon'sHead (small blind) folded before Flop


PokerStars Hand #203587645651:  Hold'em No Limit ($0.05/$0.10 USD) - 2019/09/10 20:57:24 ET
Table 'Corvus' 6-max Seat #1 is the button
Seat 1: nando_abarca ($9.30 in chips)
Seat 2: PlayTheBlues4U ($17.78 in chips)
Seat 3: 123tiger711a ($13.81 in chips)
Seat 4: jmc926 ($10 in chips)
Seat 5: F3ign ($20.42 in chips)
Seat 6: BigBlue ($9.34 in chips)
PlayTheBlues4U: posts small blind $0.05
123tiger711a: posts big blind $0.10
*** HOLE CARDS ***
Dealt to PlayTheBlues4U [Ts 4s]
jmc926: calls $0.10
F3ign: folds
BigBlue: folds
nando_abarca: folds
PlayTheBlues4U: folds
123tiger711a: checks
*** FLOP *** [Ad 7h 5c]
123tiger711a: checks
jmc926: checks
*** TURN *** [Ad 7h 5c] [Kd]
123tiger711a: checks
jmc926: checks
*** RIVER *** [Ad 7h 5c Kd] [7d]
123tiger711a: checks
jmc926: checks
*** SHOW DOWN ***
123tiger711a: shows [3h Js] (a pair of Sevens)
jmc926: shows [8c Qd] (a pair of Sevens - Ace+King+Queen kicker)
jmc926 collected $0.24 from pot
*** SUMMARY ***
Total pot $0.25 | Rake $0.01
Board [Ad 7h 5c Kd 7d]
Seat 1: nando_abarca (button) folded before Flop (didn't bet)
Seat 2: PlayTheBlues4U (small blind) folded before Flop
Seat 3: 123tiger711a (big blind) showed [3h Js] and lost with a pair of Sevens
Seat 4: jmc926 showed [8c Qd] and won ($0.24) with a pair of Sevens
Seat 5: F3ign folded before Flop (didn't bet)
Seat 6: BigBlue folded before Flop (didn't bet)


PokerStars Hand #203587645638:  Hold'em No Limit ($0.05/$0.10 USD) - 2019/09/10 20:57:20 ET
Table 'Iphigenia' 6-max Seat #4 is the button
Seat 2: nando_abarca ($10.21 in chips)
Seat 3: BigBlue ($3.66 in chips)
Seat 4: F3ign ($22.01 in chips)
Seat 5: PlayTheBlues4U ($11.14 in chips)
Seat 6: RNixon'sHead ($12.89 in chips)
PlayTheBlues4U: posts small blind $0.05
RNixon'sHead: posts big blind $0.10
*** HOLE CARDS ***
Dealt to PlayTheBlues4U [Jc 4s]
nando_abarca: folds
BigBlue: folds
F3ign: folds
PlayTheBlues4U: folds
Uncalled bet ($0.05) returned to RNixon'sHead
RNixon'sHead collected $0.10 from pot
RNixon'sHead: doesn't show hand
*** SUMMARY ***
Total pot $0.10 | Rake $0
Seat 2: nando_abarca folded before Flop (didn't bet)
Seat 3: BigBlue folded before Flop (didn't bet)
Seat 4: F3ign (button) folded before Flop (didn't bet)
Seat 5: PlayTheBlues4U (small blind) folded before Flop
Seat 6: RNixon'sHead (big blind) collected ($0.10)


PokerStars Hand #203587645585:  Hold'em No Limit ($0.05/$0.10 USD) - 2019/09/10 20:57:04 ET
Table 'Iphigenia' 6-max Seat #3 is the button
Seat 2: nando_abarca ($10.21 in chips)
Seat 3: BigBlue ($3.66 in chips)
Seat 4: F3ign ($22.06 in chips)
Seat 5: PlayTheBlues4U ($11.24 in chips)
Seat 6: RNixon'sHead ($12.74 in chips)
F3ign: posts small blind $0.05
PlayTheBlues4U: posts big blind $0.10
*** HOLE CARDS ***
Dealt to PlayTheBlues4U [2s 3s]
RNixon'sHead: raises $0.15 to $0.25
nando_abarca: folds
BigBlue: folds
F3ign: folds
PlayTheBlues4U: folds
Uncalled bet ($0.15) returned to RNixon'sHead
RNixon'sHead collected $0.25 from pot
RNixon'sHead: doesn't show hand
*** SUMMARY ***
Total pot $0.25 | Rake $0
Seat 2: nando_abarca folded before Flop (didn't bet)
Seat 3: BigBlue (button) folded before Flop (didn't bet)
Seat 4: F3ign (small blind) folded before Flop
Seat 5: PlayTheBlues4U (big blind) folded before Flop
Seat 6: RNixon'sHead collected ($0.25)


PokerStars Hand #203587645540:  Hold'em No Limit ($0.05/$0.10 USD) - 2019/09/10 20:56:47 ET
Table 'Iphigenia' 6-max Seat #2 is the button
Seat 2: nando_abarca ($10.21 in chips)
Seat 3: BigBlue ($3.71 in chips)
Seat 4: F3ign ($22.01 in chips)
Seat 5: PlayTheBlues4U ($11.24 in chips)
Seat 6: RNixon'sHead ($12.74 in chips)
BigBlue: posts small blind $0.05
F3ign: posts big blind $0.10
*** HOLE CARDS ***
Dealt to PlayTheBlues4U [Ac 4d]
PlayTheBlues4U: folds
RNixon'sHead: folds
nando_abarca: folds
BigBlue: folds
Uncalled bet ($0.05) returned to F3ign
F3ign collected $0.10 from pot
F3ign: doesn't show hand
*** SUMMARY ***
Total pot $0.10 | Rake $0
Seat 2: nando_abarca (button) folded before Flop (didn't bet)
Seat 3: BigBlue (small blind) folded before Flop
Seat 4: F3ign (big blind) collected ($0.10)
Seat 5: PlayTheBlues4U folded before Flop (didn't bet)
Seat 6: RNixon'sHead folded before Flop (didn't bet)


PokerStars Hand #203587645476:  Hold'em No Limit ($0.05/$0.10 USD) - 2019/09/10 20:56:28 ET
Table 'Corvus' 6-max Seat #6 is the button
Seat 1: nando_abarca ($9.40 in chips)
Seat 2: PlayTheBlues4U ($17.69 in chips)
Seat 3: 123tiger711a ($13.81 in chips)
Seat 4: jmc926 ($3.39 in chips)
Seat 5: F3ign ($20.42 in chips)
Seat 6: BigBlue ($9.34 in chips)
nando_abarca: posts small blind $0.05
PlayTheBlues4U: posts big blind $0.10
*** HOLE CARDS ***
Dealt to PlayTheBlues4U [4h Kc]
jmc926 said, "omg lol"
123tiger711a: folds
jmc926 said, "what a joke"
PlayTheBlues4U said, "oof"
jmc926: folds
F3ign: folds
BigBlue: folds
nando_abarca: calls $0.05
PlayTheBlues4U: checks
*** FLOP *** [3s 5c 9s]
nando_abarca: checks
PlayTheBlues4U: checks
*** TURN *** [3s 5c 9s] [9c]
nando_abarca: checks
PlayTheBlues4U: checks
*** RIVER *** [3s 5c 9s 9c] [9d]
jmc926 said, "glad I didn't raise the river lol"
nando_abarca: checks
PlayTheBlues4U: checks
*** SHOW DOWN ***
nando_abarca: shows [7d 6s] (three of a kind, Nines)
PlayTheBlues4U: shows [4h Kc] (three of a kind, Nines - King kicker)
PlayTheBlues4U collected $0.19 from pot
*** SUMMARY ***
Total pot $0.20 | Rake $0.01
Board [3s 5c 9s 9c 9d]
Seat 1: nando_abarca (small blind) showed [7d 6s] and lost with three of a kind, Nines
Seat 2: PlayTheBlues4U (big blind) showed [4h Kc] and won ($0.19) with three of a kind, Nines
Seat 3: 123tiger711a folded before Flop (didn't bet)
Seat 4: jmc926 folded before Flop (didn't bet)
Seat 5: F3ign folded before Flop (didn't bet)
Seat 6: BigBlue (button) folded before Flop (didn't bet)


PokerStars Hand #203587645379:  Hold'em No Limit ($0.05/$0.10 USD) - 2019/09/10 20:55:53 ET
Table 'Iphigenia' 6-max Seat #6 is the button
Seat 2: nando_abarca ($10.46 in chips)
Seat 3: BigBlue ($3.25 in chips)
Seat 4: F3ign ($22.01 in chips)
Seat 5: PlayTheBlues4U ($11.24 in chips)
Seat 6: RNixon'sHead ($12.99 in chips)
nando_abarca: posts small blind $0.05
BigBlue: posts big blind $0.10
*** HOLE CARDS ***
Dealt to PlayTheBlues4U [4c Ac]
F3ign: folds
PlayTheBlues4U: folds
RNixon'sHead: raises $0.15 to $0.25
nando_abarca: calls $0.20
BigBlue: calls $0.15
*** FLOP *** [Qs 5h 9c]
nando_abarca: checks
BigBlue: checks
RNixon'sHead: checks
*** TURN *** [Qs 5h 9c] [9s]
nando_abarca: checks
BigBlue: bets $0.50
RNixon'sHead: folds
nando_abarca: folds
Uncalled bet ($0.50) returned to BigBlue
BigBlue collected $0.71 from pot
BigBlue: doesn't show hand
*** SUMMARY ***
Total pot $0.75 | Rake $0.04
Board [Qs 5h 9c 9s]
Seat 2: nando_abarca (small blind) folded on the Turn
Seat 3: BigBlue (big blind) collected ($0.71)
Seat 4: F3ign folded before Flop (didn't bet)
Seat 5: PlayTheBlues4U folded before Flop (didn't bet)
Seat 6: RNixon'sHead (button) folded on the Turn


PokerStars Hand #203587645255:  Hold'em No Limit ($0.05/$0.10 USD) - 2019/09/10 20:55:07 ET
Table 'Corvus' 6-max Seat #5 is the button
Seat 1: nando_abarca ($9.50 in chips)
Seat 2: PlayTheBlues4U ($13.41 in chips)
Seat 3: 123tiger711a ($13.81 in chips)
Seat 4: jmc926 ($7.99 in chips)
Seat 5: F3ign ($20.42 in chips)
Seat 6: BigBlue ($9.39 in chips)
BigBlue: posts small blind $0.05
nando_abarca: posts big blind $0.10
*** HOLE CARDS ***
Dealt to PlayTheBlues4U [Jd Jc]
PlayTheBlues4U: raises $0.20 to $0.30
123tiger711a: folds
jmc926: calls $0.30
F3ign: folds
BigBlue: folds
nando_abarca: folds
*** FLOP *** [Js 2c 4h]
PlayTheBlues4U: bets $0.50
jmc926: calls $0.50
*** TURN *** [Js 2c 4h] [8h]
PlayTheBlues4U: bets $1.10
jmc926: calls $1.10
*** RIVER *** [Js 2c 4h 8h] [7c]
PlayTheBlues4U: bets $2.70
jmc926: calls $2.70
*** SHOW DOWN ***
PlayTheBlues4U: shows [Jd Jc] (three of a kind, Jacks)
jmc926: mucks hand
PlayTheBlues4U collected $8.88 from pot
*** SUMMARY ***
Total pot $9.35 | Rake $0.47
Board [Js 2c 4h 8h 7c]
Seat 1: nando_abarca (big blind) folded before Flop
Seat 2: PlayTheBlues4U showed [Jd Jc] and won ($8.88) with three of a kind, Jacks
Seat 3: 123tiger711a folded before Flop (didn't bet)
Seat 4: jmc926 mucked [4s 4d]
Seat 5: F3ign (button) folded before Flop (didn't bet)
Seat 6: BigBlue (small blind) folded before Flop


PokerStars Hand #203587645208:  Hold'em No Limit ($0.05/$0.10 USD) - 2019/09/10 20:54:54 ET
Table 'Corvus' 6-max Seat #4 is the button
Seat 1: nando_abarca ($9.50 in chips)
Seat 2: PlayTheBlues4U ($13.41 in chips)
Seat 3: 123tiger711a ($13.81 in chips)
Seat 4: jmc926 ($7.99 in chips)
Seat 5: F3ign ($20.32 in chips)
Seat 6: BigBlue ($9.49 in chips)
F3ign: posts small blind $0.05
BigBlue: posts big blind $0.10
*** HOLE CARDS ***
Dealt to PlayTheBlues4U [8s Ad]
nando_abarca: folds
PlayTheBlues4U: folds
123tiger711a: folds
jmc926: folds
F3ign: raises $0.20 to $0.30
BigBlue: folds
Uncalled bet ($0.20) returned to F3ign
F3ign collected $0.20 from pot
F3ign: doesn't show hand
*** SUMMARY ***
Total pot $0.20 | Rake $0
Seat 1: nando_abarca folded before Flop (didn't bet)
Seat 2: PlayTheBlues4U folded before Flop (didn't bet)
Seat 3: 123tiger711a folded before Flop (didn't bet)
Seat 4: jmc926 (button) folded before Flop (didn't bet)
Seat 5: F3ign (small blind) collected ($0.20)
Seat 6: BigBlue (big blind) folded before Flop


PokerStars Hand #203587645206:  Hold'em No Limit ($0.05/$0.10 USD) - 2019/09/10 20:54:54 ET
Table 'Iphigenia' 6-max Seat #5 is the button
Seat 2: nando_abarca ($10.56 in chips)
Seat 3: BigBlue ($3.25 in chips)
Seat 4: F3ign ($24.35 in chips)
Seat 5: PlayTheBlues4U ($11.24 in chips)
Seat 6: RNixon'sHead ($10.79 in chips)
RNixon'sHead: posts small blind $0.05
nando_abarca: posts big blind $0.10
*** HOLE CARDS ***
Dealt to PlayTheBlues4U [5c Ts]
BigBlue: folds
F3ign: raises $0.20 to $0.30
PlayTheBlues4U: folds
RNixon'sHead: raises $0.85 to $1.15
nando_abarca: folds
F3ign: calls $0.85
*** FLOP *** [7c 8c Jd]
PlayTheBlues4U said, "Arrooooo"
RNixon'sHead: bets $1.19
F3ign: calls $1.19
*** TURN *** [7c 8c Jd] [4h]
RNixon'sHead: bets $3.95
F3ign: folds
Uncalled bet ($3.95) returned to RNixon'sHead
RNixon'sHead collected $4.54 from pot
RNixon'sHead: doesn't show hand
*** SUMMARY ***
Total pot $4.78 | Rake $0.24
Board [7c 8c Jd 4h]
Seat 2: nando_abarca (big blind) folded before Flop
Seat 3: BigBlue folded before Flop (didn't bet)
Seat 4: F3ign folded on the Turn
Seat 5: PlayTheBlues4U (button) folded before Flop (didn't bet)
Seat 6: RNixon'sHead (small blind) collected ($4.54)


PokerStars Hand #203587645112:  Hold'em No Limit ($0.05/$0.10 USD) - 2019/09/10 20:54:28 ET
Table 'Corvus' 6-max Seat #3 is the button
Seat 1: nando_abarca ($9.50 in chips)
Seat 2: PlayTheBlues4U ($13.41 in chips)
Seat 3: 123tiger711a ($13.81 in chips)
Seat 4: jmc926 ($7.81 in chips)
Seat 5: F3ign ($20.52 in chips)
Seat 6: BigBlue ($9.49 in chips)
jmc926: posts small blind $0.05
F3ign: posts big blind $0.10
*** HOLE CARDS ***
Dealt to PlayTheBlues4U [Tc 3h]
BigBlue: folds
nando_abarca: folds
PlayTheBlues4U: folds
123tiger711a: folds
jmc926: raises $0.10 to $0.20
F3ign: calls $0.10
*** FLOP *** [Jd Qh 9h]
jmc926: bets $0.30
F3ign: folds
Uncalled bet ($0.30) returned to jmc926
jmc926 collected $0.38 from pot
*** SUMMARY ***
Total pot $0.40 | Rake $0.02
Board [Jd Qh 9h]
Seat 1: nando_abarca folded before Flop (didn't bet)
Seat 2: PlayTheBlues4U folded before Flop (didn't bet)
Seat 3: 123tiger711a (button) folded before Flop (didn't bet)
Seat 4: jmc926 (small blind) collected ($0.38)
Seat 5: F3ign (big blind) folded on the Flop
Seat 6: BigBlue folded before Flop (didn't bet)


PokerStars Hand #203587645030:  Hold'em No Limit ($0.05/$0.10 USD) - 2019/09/10 20:54:08 ET
Table 'Iphigenia' 6-max Seat #4 is the button
Seat 2: nando_abarca ($11.16 in chips)
Seat 3: BigBlue ($3.25 in chips)
Seat 4: F3ign ($24.35 in chips)
Seat 5: PlayTheBlues4U ($11.34 in chips)
Seat 6: RNixon'sHead ($10.15 in chips)
PlayTheBlues4U: posts small blind $0.05
RNixon'sHead: posts big blind $0.10
*** HOLE CARDS ***
Dealt to PlayTheBlues4U [4h 6h]
nando_abarca: calls $0.10
BigBlue: folds
F3ign: folds
PlayTheBlues4U: calls $0.05
RNixon'sHead: raises $0.50 to $0.60
nando_abarca: calls $0.50
PlayTheBlues4U: folds
*** FLOP *** [6d Tc 6c]
RNixon'sHead: bets $0.53
nando_abarca: folds
Uncalled bet ($0.53) returned to RNixon'sHead
RNixon'sHead collected $1.24 from pot
RNixon'sHead: doesn't show hand
*** SUMMARY ***
Total pot $1.30 | Rake $0.06
Board [6d Tc 6c]
Seat 2: nando_abarca folded on the Flop
Seat 3: BigBlue folded before Flop (didn't bet)
Seat 4: F3ign (button) folded before Flop (didn't bet)
Seat 5: PlayTheBlues4U (small blind) folded before Flop
Seat 6: RNixon'sHead (big blind) collected ($1.24)


PokerStars Hand #203587644994:  Hold'em No Limit ($0.05/$0.10 USD) - 2019/09/10 20:53:57 ET
Table 'Corvus' 6-max Seat #2 is the button
Seat 1: nando_abarca ($9.60 in chips)
Seat 2: PlayTheBlues4U ($13.16 in chips)
Seat 3: 123tiger711a ($13.86 in chips)
Seat 4: jmc926 ($7.91 in chips)
Seat 5: F3ign ($20.52 in chips)
Seat 6: BigBlue ($9.49 in chips)
123tiger711a: posts small blind $0.05
jmc926: posts big blind $0.10
*** HOLE CARDS ***
Dealt to PlayTheBlues4U [Qc Kd]
F3ign: folds
BigBlue: folds
nando_abarca: calls $0.10
PlayTheBlues4U: raises $0.30 to $0.40
123tiger711a: folds
jmc926: folds
nando_abarca: folds
Uncalled bet ($0.30) returned to PlayTheBlues4U
PlayTheBlues4U collected $0.35 from pot
PlayTheBlues4U: doesn't show hand
*** SUMMARY ***
Total pot $0.35 | Rake $0
Seat 1: nando_abarca folded before Flop
Seat 2: PlayTheBlues4U (button) collected ($0.35)
Seat 3: 123tiger711a (small blind) folded before Flop
Seat 4: jmc926 (big blind) folded before Flop
Seat 5: F3ign folded before Flop (didn't bet)
Seat 6: BigBlue folded before Flop (didn't bet)


PokerStars Hand #203587644993:  Hold'em No Limit ($0.05/$0.10 USD) - 2019/09/10 20:53:57 ET
Table 'Iphigenia' 6-max Seat #3 is the button
Seat 2: nando_abarca ($11.16 in chips)
Seat 3: BigBlue ($3.25 in chips)
Seat 4: F3ign ($24.40 in chips)
Seat 5: PlayTheBlues4U ($11.29 in chips)
Seat 6: RNixon'sHead ($10.15 in chips)
F3ign: posts small blind $0.05
PlayTheBlues4U: posts big blind $0.10
*** HOLE CARDS ***
Dealt to PlayTheBlues4U [Kc 5s]
RNixon'sHead: folds
nando_abarca: folds
BigBlue: folds
F3ign: folds
Uncalled bet ($0.05) returned to PlayTheBlues4U
PlayTheBlues4U collected $0.10 from pot
PlayTheBlues4U: doesn't show hand
*** SUMMARY ***
Total pot $0.10 | Rake $0
Seat 2: nando_abarca folded before Flop (didn't bet)
Seat 3: BigBlue (button) folded before Flop (didn't bet)
Seat 4: F3ign (small blind) folded before Flop
Seat 5: PlayTheBlues4U (big blind) collected ($0.10)
Seat 6: RNixon'sHead folded before Flop (didn't bet)


PokerStars Hand #203587644922:  Hold'em No Limit ($0.05/$0.10 USD) - 2019/09/10 20:53:38 ET
Table 'Iphigenia' 6-max Seat #2 is the button
Seat 2: nando_abarca ($11.16 in chips)
Seat 3: BigBlue ($3.30 in chips)
Seat 4: F3ign ($24.35 in chips)
Seat 5: PlayTheBlues4U ($11.29 in chips)
Seat 6: RNixon'sHead ($10.15 in chips)
BigBlue: posts small blind $0.05
F3ign: posts big blind $0.10
*** HOLE CARDS ***
Dealt to PlayTheBlues4U [6c 3h]
PlayTheBlues4U: folds
RNixon'sHead: folds
nando_abarca: folds
BigBlue: folds
Uncalled bet ($0.05) returned to F3ign
F3ign collected $0.10 from pot
F3ign: doesn't show hand
*** SUMMARY ***
Total pot $0.10 | Rake $0
Seat 2: nando_abarca (button) folded before Flop (didn't bet)
Seat 3: BigBlue (small blind) folded before Flop
Seat 4: F3ign (big blind) collected ($0.10)
Seat 5: PlayTheBlues4U folded before Flop (didn't bet)
Seat 6: RNixon'sHead folded before Flop (didn't bet)


PokerStars Hand #203587644827:  Hold'em No Limit ($0.05/$0.10 USD) - 2019/09/10 20:53:12 ET
Table 'Iphigenia' 6-max Seat #6 is the button
Seat 2: nando_abarca ($11.21 in chips)
Seat 3: BigBlue ($3.40 in chips)
Seat 4: F3ign ($24.35 in chips)
Seat 5: PlayTheBlues4U ($11.29 in chips)
Seat 6: RNixon'sHead ($10 in chips)
nando_abarca: posts small blind $0.05
BigBlue: posts big blind $0.10
*** HOLE CARDS ***
Dealt to PlayTheBlues4U [6s Qh]
F3ign: folds
PlayTheBlues4U: folds
RNixon'sHead: raises $0.15 to $0.25
nando_abarca: folds
BigBlue: folds
Uncalled bet ($0.15) returned to RNixon'sHead
RNixon'sHead collected $0.25 from pot
RNixon'sHead: doesn't show hand
*** SUMMARY ***
Total pot $0.25 | Rake $0
Seat 2: nando_abarca (small blind) folded before Flop
Seat 3: BigBlue (big blind) folded before Flop
Seat 4: F3ign folded before Flop (didn't bet)
Seat 5: PlayTheBlues4U folded before Flop (didn't bet)
Seat 6: RNixon'sHead (button) collected ($0.25)


PokerStars Hand #203587644744:  Hold'em No Limit ($0.05/$0.10 USD) - 2019/09/10 20:52:49 ET
Table 'Corvus' 6-max Seat #1 is the button
Seat 1: nando_abarca ($9.70 in chips)
Seat 2: PlayTheBlues4U ($13.26 in chips)
Seat 3: 123tiger711a ($13.96 in chips)
Seat 4: jmc926 ($8.01 in chips)
Seat 5: F3ign ($20.52 in chips)
Seat 6: BigBlue ($9.11 in chips)
PlayTheBlues4U: posts small blind $0.05
123tiger711a: posts big blind $0.10
*** HOLE CARDS ***
Dealt to PlayTheBlues4U [Tc 4h]
jmc926: calls $0.10
F3ign: folds
BigBlue: calls $0.10
nando_abarca: calls $0.10
PlayTheBlues4U: calls $0.05
123tiger711a: checks
*** FLOP *** [8c 4d 9s]
PlayTheBlues4U: checks
123tiger711a: checks
jmc926: checks
BigBlue: checks
nando_abarca: checks
*** TURN *** [8c 4d 9s] [3c]
PlayTheBlues4U: checks
123tiger711a: checks
jmc926: checks
BigBlue: bets $0.50
nando_abarca: folds
PlayTheBlues4U: folds
123tiger711a: folds
jmc926: folds
Uncalled bet ($0.50) returned to BigBlue
BigBlue collected $0.48 from pot
BigBlue: doesn't show hand
*** SUMMARY ***
Total pot $0.50 | Rake $0.02
Board [8c 4d 9s 3c]
Seat 1: nando_abarca (button) folded on the Turn
Seat 2: PlayTheBlues4U (small blind) folded on the Turn
Seat 3: 123tiger711a (big blind) folded on the Turn
Seat 4: jmc926 folded on the Turn
Seat 5: F3ign folded before Flop (didn't bet)
Seat 6: BigBlue collected ($0.48)


PokerStars Hand #203587529960:  Hold'em No Limit ($0.05/$0.10 USD) - 2019/09/10 20:52:25 ET
Table 'Iphigenia' 6-max Seat #5 is the button
Seat 2: nando_abarca ($10.14 in chips)
Seat 3: BigBlue ($3.40 in chips)
Seat 4: F3ign ($24.35 in chips)
Seat 5: PlayTheBlues4U ($11.29 in chips)
Seat 6: RNixon'sHead ($10.32 in chips)
RNixon'sHead: posts small blind $0.05
kid delaw731: is sitting out
nando_abarca: posts big blind $0.10
*** HOLE CARDS ***
Dealt to PlayTheBlues4U [Qh 6c]
BigBlue: folds
F3ign: folds
PlayTheBlues4U: folds
RNixon'sHead: raises $0.20 to $0.30
nando_abarca: calls $0.20
*** FLOP *** [2h Js Th]
RNixon'sHead: bets $0.30
nando_abarca: calls $0.30
*** TURN *** [2h Js Th] [9c]
RNixon'sHead: bets $0.59
nando_abarca: raises $1.16 to $1.75
RNixon'sHead: folds
Uncalled bet ($1.16) returned to nando_abarca
nando_abarca collected $2.26 from pot
nando_abarca: doesn't show hand
*** SUMMARY ***
Total pot $2.38 | Rake $0.12
Board [2h Js Th 9c]
Seat 2: nando_abarca (big blind) collected ($2.26)
Seat 3: BigBlue folded before Flop (didn't bet)
Seat 4: F3ign folded before Flop (didn't bet)
Seat 5: PlayTheBlues4U (button) folded before Flop (didn't bet)
Seat 6: RNixon'sHead (small blind) folded on the Turn


PokerStars Hand #203587529908:  Hold'em No Limit ($0.05/$0.10 USD) - 2019/09/10 20:52:10 ET
Table 'Iphigenia' 6-max Seat #4 is the button
Seat 1: kid delaw731 ($8.92 in chips)
Seat 2: nando_abarca ($10.14 in chips)
Seat 3: BigBlue ($3.40 in chips)
Seat 4: F3ign ($24.35 in chips)
Seat 5: PlayTheBlues4U ($11.34 in chips)
Seat 6: RNixon'sHead ($10.27 in chips)
PlayTheBlues4U: posts small blind $0.05
RNixon'sHead: posts big blind $0.10
*** HOLE CARDS ***
Dealt to PlayTheBlues4U [Kc 4d]
kid delaw731: folds
nando_abarca: folds
BigBlue: folds
F3ign: folds
PlayTheBlues4U: folds
Uncalled bet ($0.05) returned to RNixon'sHead
RNixon'sHead collected $0.10 from pot
RNixon'sHead: doesn't show hand
*** SUMMARY ***
Total pot $0.10 | Rake $0
Seat 1: kid delaw731 folded before Flop (didn't bet)
Seat 2: nando_abarca folded before Flop (didn't bet)
Seat 3: BigBlue folded before Flop (didn't bet)
Seat 4: F3ign (button) folded before Flop (didn't bet)
Seat 5: PlayTheBlues4U (small blind) folded before Flop
Seat 6: RNixon'sHead (big blind) collected ($0.10)


PokerStars Hand #203587529906:  Hold'em No Limit ($0.05/$0.10 USD) - 2019/09/10 20:52:10 ET
Table 'Corvus' 6-max Seat #6 is the button
Seat 1: nando_abarca ($9.75 in chips)
Seat 2: PlayTheBlues4U ($13.36 in chips)
Seat 3: 123tiger711a ($14.41 in chips)
Seat 4: jmc926 ($8.01 in chips)
Seat 5: F3ign ($20.52 in chips)
Seat 6: BigBlue ($8.56 in chips)
nando_abarca: posts small blind $0.05
PlayTheBlues4U: posts big blind $0.10
*** HOLE CARDS ***
Dealt to PlayTheBlues4U [7d Ts]
123tiger711a: calls $0.10
jmc926: folds
F3ign: folds
BigBlue: raises $0.35 to $0.45
nando_abarca: folds
PlayTheBlues4U: folds
123tiger711a: calls $0.35
*** FLOP *** [As Ah Jh]
123tiger711a: checks
BigBlue: checks
*** TURN *** [As Ah Jh] [Kc]
123tiger711a: checks
BigBlue: bets $0.70
123tiger711a: folds
Uncalled bet ($0.70) returned to BigBlue
BigBlue collected $1 from pot
BigBlue: doesn't show hand
*** SUMMARY ***
Total pot $1.05 | Rake $0.05
Board [As Ah Jh Kc]
Seat 1: nando_abarca (small blind) folded before Flop
Seat 2: PlayTheBlues4U (big blind) folded before Flop
Seat 3: 123tiger711a folded on the Turn
Seat 4: jmc926 folded before Flop (didn't bet)
Seat 5: F3ign folded before Flop (didn't bet)
Seat 6: BigBlue (button) collected ($1)


PokerStars Hand #203587529790:  Hold'em No Limit ($0.05/$0.10 USD) - 2019/09/10 20:51:39 ET
Table 'Iphigenia' 6-max Seat #3 is the button
Seat 1: kid delaw731 ($8.92 in chips)
Seat 2: nando_abarca ($10 in chips)
Seat 3: BigBlue ($3.40 in chips)
Seat 4: F3ign ($24.40 in chips)
Seat 5: PlayTheBlues4U ($11.44 in chips)
F3ign: posts small blind $0.05
PlayTheBlues4U: posts big blind $0.10
RNixon'sHead: sits out
*** HOLE CARDS ***
Dealt to PlayTheBlues4U [2d 2h]
kid delaw731: folds
nando_abarca: calls $0.10
BigBlue: folds
F3ign: folds
PlayTheBlues4U: checks
*** FLOP *** [7h 6s Th]
PlayTheBlues4U: checks
nando_abarca: bets $0.24
PlayTheBlues4U: folds
Uncalled bet ($0.24) returned to nando_abarca
nando_abarca collected $0.24 from pot
nando_abarca: doesn't show hand
*** SUMMARY ***
Total pot $0.25 | Rake $0.01
Board [7h 6s Th]
Seat 1: kid delaw731 folded before Flop (didn't bet)
Seat 2: nando_abarca collected ($0.24)
Seat 3: BigBlue (button) folded before Flop (didn't bet)
Seat 4: F3ign (small blind) folded before Flop
Seat 5: PlayTheBlues4U (big blind) folded on the Flop


PokerStars Hand #203587529692:  Hold'em No Limit ($0.05/$0.10 USD) - 2019/09/10 20:51:10 ET
Table 'Corvus' 6-max Seat #5 is the button
Seat 1: nando_abarca ($9.85 in chips)
Seat 2: PlayTheBlues4U ($11.75 in chips)
Seat 3: 123tiger711a ($14.41 in chips)
Seat 4: jmc926 ($9.64 in chips)
Seat 5: F3ign ($20.52 in chips)
Seat 6: BigBlue ($8.61 in chips)
BigBlue: posts small blind $0.05
nando_abarca: posts big blind $0.10
*** HOLE CARDS ***
Dealt to PlayTheBlues4U [Js Jh]
PlayTheBlues4U: raises $0.20 to $0.30
123tiger711a: folds
jmc926: calls $0.30
F3ign: folds
BigBlue: folds
nando_abarca: folds
*** FLOP *** [Tc 8d 6h]
PlayTheBlues4U: bets $0.50
jmc926: calls $0.50
*** TURN *** [Tc 8d 6h] [5c]
PlayTheBlues4U: checks
jmc926: bets $0.83
PlayTheBlues4U: calls $0.83
*** RIVER *** [Tc 8d 6h 5c] [3s]
PlayTheBlues4U: checks
jmc926: checks
*** SHOW DOWN ***
PlayTheBlues4U: shows [Js Jh] (a pair of Jacks)
jmc926: mucks hand
PlayTheBlues4U collected $3.24 from pot
*** SUMMARY ***
Total pot $3.41 | Rake $0.17
Board [Tc 8d 6h 5c 3s]
Seat 1: nando_abarca (big blind) folded before Flop
Seat 2: PlayTheBlues4U showed [Js Jh] and won ($3.24) with a pair of Jacks
Seat 3: 123tiger711a folded before Flop (didn't bet)
Seat 4: jmc926 mucked [Ts Ac]
Seat 5: F3ign (button) folded before Flop (didn't bet)
Seat 6: BigBlue (small blind) folded before Flop


PokerStars Hand #203587529577:  Hold'em No Limit ($0.05/$0.10 USD) - 2019/09/10 20:50:41 ET
Table 'Corvus' 6-max Seat #4 is the button
Seat 1: nando_abarca ($9.95 in chips)
Seat 2: PlayTheBlues4U ($11.50 in chips)
Seat 3: 123tiger711a ($14.41 in chips)
Seat 4: jmc926 ($9.64 in chips)
Seat 5: F3ign ($20.57 in chips)
Seat 6: BigBlue ($8.71 in chips)
F3ign: posts small blind $0.05
BigBlue: posts big blind $0.10
*** HOLE CARDS ***
Dealt to PlayTheBlues4U [Qs Qc]
nando_abarca: calls $0.10
PlayTheBlues4U: raises $0.30 to $0.40
123tiger711a: folds
jmc926: folds
F3ign: folds
BigBlue: folds
nando_abarca: folds
Uncalled bet ($0.30) returned to PlayTheBlues4U
PlayTheBlues4U collected $0.35 from pot
PlayTheBlues4U: doesn't show hand
*** SUMMARY ***
Total pot $0.35 | Rake $0
Seat 1: nando_abarca folded before Flop
Seat 2: PlayTheBlues4U collected ($0.35)
Seat 3: 123tiger711a folded before Flop (didn't bet)
Seat 4: jmc926 (button) folded before Flop (didn't bet)
Seat 5: F3ign (small blind) folded before Flop
Seat 6: BigBlue (big blind) folded before Flop


PokerStars Hand #203587529430:  Hold'em No Limit ($0.05/$0.10 USD) - 2019/09/10 20:49:57 ET
Table 'Iphigenia' 6-max Seat #2 is the button
Seat 1: kid delaw731 ($9.02 in chips)
Seat 2: nando_abarca ($6.61 in chips)
Seat 3: BigBlue ($3.45 in chips)
Seat 4: F3ign ($24.17 in chips)
Seat 5: PlayTheBlues4U ($11.44 in chips)
BigBlue: posts small blind $0.05
F3ign: posts big blind $0.10
RNixon'sHead: sits out
*** HOLE CARDS ***
Dealt to PlayTheBlues4U [6c As]
PlayTheBlues4U: folds
kid delaw731: calls $0.10
nando_abarca: calls $0.10
BigBlue: folds
F3ign: checks
*** FLOP *** [5d 9s 6s]
F3ign: checks
kid delaw731: checks
nando_abarca: checks
*** TURN *** [5d 9s 6s] [5h]
F3ign: checks
kid delaw731: checks
nando_abarca: checks
*** RIVER *** [5d 9s 6s 5h] [2s]
F3ign: checks
kid delaw731: checks
nando_abarca: checks
*** SHOW DOWN ***
F3ign: shows [Td 2c] (two pair, Fives and Deuces)
kid delaw731: mucks hand
nando_abarca: mucks hand
F3ign collected $0.33 from pot
*** SUMMARY ***
Total pot $0.35 | Rake $0.02
Board [5d 9s 6s 5h 2s]
Seat 1: kid delaw731 mucked [7h Ac]
Seat 2: nando_abarca (button) mucked [Ad 7s]
Seat 3: BigBlue (small blind) folded before Flop
Seat 4: F3ign (big blind) showed [Td 2c] and won ($0.33) with two pair, Fives and Deuces
Seat 5: PlayTheBlues4U folded before Flop (didn't bet)


PokerStars Hand #203587529370:  Hold'em No Limit ($0.05/$0.10 USD) - 2019/09/10 20:49:42 ET
Table 'Corvus' 6-max Seat #3 is the button
Seat 1: nando_abarca ($10.25 in chips)
Seat 2: PlayTheBlues4U ($11.50 in chips)
Seat 3: 123tiger711a ($14.41 in chips)
Seat 4: jmc926 ($9.08 in chips)
Seat 5: F3ign ($20.87 in chips)
Seat 6: BigBlue ($8.71 in chips)
jmc926: posts small blind $0.05
F3ign: posts big blind $0.10
*** HOLE CARDS ***
Dealt to PlayTheBlues4U [3c 8c]
BigBlue: folds
nando_abarca: calls $0.10
PlayTheBlues4U: folds
123tiger711a: folds
jmc926: calls $0.05
F3ign: raises $0.20 to $0.30
nando_abarca: calls $0.20
jmc926: calls $0.20
*** FLOP *** [5h 4c 8s]
jmc926: checks
F3ign: checks
nando_abarca: checks
*** TURN *** [5h 4c 8s] [7s]
jmc926: bets $0.43
F3ign: folds
nando_abarca: folds
Uncalled bet ($0.43) returned to jmc926
jmc926 collected $0.86 from pot
*** SUMMARY ***
Total pot $0.90 | Rake $0.04
Board [5h 4c 8s 7s]
Seat 1: nando_abarca folded on the Turn
Seat 2: PlayTheBlues4U folded before Flop (didn't bet)
Seat 3: 123tiger711a (button) folded before Flop (didn't bet)
Seat 4: jmc926 (small blind) collected ($0.86)
Seat 5: F3ign (big blind) folded on the Turn
Seat 6: BigBlue folded before Flop (didn't bet)


PokerStars Hand #203587529321:  Hold'em No Limit ($0.05/$0.10 USD) - 2019/09/10 20:49:31 ET
Table 'Iphigenia' 6-max Seat #1 is the button
Seat 1: kid delaw731 ($9.02 in chips)
Seat 2: nando_abarca ($6.71 in chips)
Seat 3: BigBlue ($3.36 in chips)
Seat 4: F3ign ($24.17 in chips)
Seat 5: PlayTheBlues4U ($11.44 in chips)
nando_abarca: posts small blind $0.05
BigBlue: posts big blind $0.10
*** HOLE CARDS ***
Dealt to PlayTheBlues4U [Qh 2s]
F3ign: folds
PlayTheBlues4U: folds
kid delaw731: folds
yn21 leaves the table
nando_abarca: calls $0.05
RNixon'sHead joins the table at seat #6
BigBlue: checks
*** FLOP *** [8c As 2d]
nando_abarca: checks
BigBlue: checks
*** TURN *** [8c As 2d] [Jd]
nando_abarca: checks
BigBlue: checks
*** RIVER *** [8c As 2d Jd] [Th]
nando_abarca: checks
BigBlue: checks
*** SHOW DOWN ***
nando_abarca: shows [Ks 3s] (high card Ace)
BigBlue: shows [Qd 2h] (a pair of Deuces)
BigBlue collected $0.19 from pot
*** SUMMARY ***
Total pot $0.20 | Rake $0.01
Board [8c As 2d Jd Th]
Seat 1: kid delaw731 (button) folded before Flop (didn't bet)
Seat 2: nando_abarca (small blind) showed [Ks 3s] and lost with high card Ace
Seat 3: BigBlue (big blind) showed [Qd 2h] and won ($0.19) with a pair of Deuces
Seat 4: F3ign folded before Flop (didn't bet)
Seat 5: PlayTheBlues4U folded before Flop (didn't bet)


PokerStars Hand #203587529264:  Hold'em No Limit ($0.05/$0.10 USD) - 2019/09/10 20:49:15 ET
Table 'Corvus' 6-max Seat #2 is the button
Seat 1: nando_abarca ($10.25 in chips)
Seat 2: PlayTheBlues4U ($11.50 in chips)
Seat 3: 123tiger711a ($14.32 in chips)
Seat 4: jmc926 ($9.18 in chips)
Seat 5: F3ign ($20.87 in chips)
Seat 6: BigBlue ($8.71 in chips)
123tiger711a: posts small blind $0.05
jmc926: posts big blind $0.10
*** HOLE CARDS ***
Dealt to PlayTheBlues4U [Qh 4d]
F3ign: folds
BigBlue: folds
nando_abarca: folds
PlayTheBlues4U: folds
123tiger711a: calls $0.05
jmc926: checks
*** FLOP *** [Jd Ac Ad]
123tiger711a: checks
jmc926: checks
*** TURN *** [Jd Ac Ad] [Qd]
123tiger711a: bets $0.10
jmc926: folds
Uncalled bet ($0.10) returned to 123tiger711a
123tiger711a collected $0.19 from pot
*** SUMMARY ***
Total pot $0.20 | Rake $0.01
Board [Jd Ac Ad Qd]
Seat 1: nando_abarca folded before Flop (didn't bet)
Seat 2: PlayTheBlues4U (button) folded before Flop (didn't bet)
Seat 3: 123tiger711a (small blind) collected ($0.19)
Seat 4: jmc926 (big blind) folded on the Turn
Seat 5: F3ign folded before Flop (didn't bet)
Seat 6: BigBlue folded before Flop (didn't bet)


PokerStars Hand #203587529125:  Hold'em No Limit ($0.05/$0.10 USD) - 2019/09/10 20:48:40 ET
Table 'Corvus' 6-max Seat #1 is the button
Seat 1: nando_abarca ($10.25 in chips)
Seat 2: PlayTheBlues4U ($11.55 in chips)
Seat 3: 123tiger711a ($14.62 in chips)
Seat 4: jmc926 ($9.18 in chips)
Seat 5: F3ign ($20.87 in chips)
Seat 6: BigBlue ($8.39 in chips)
PlayTheBlues4U: posts small blind $0.05
123tiger711a: posts big blind $0.10
*** HOLE CARDS ***
Dealt to PlayTheBlues4U [7c 5c]
jmc926: folds
F3ign: folds
BigBlue: raises $0.20 to $0.30
nando_abarca: folds
PlayTheBlues4U: folds
123tiger711a: calls $0.20
*** FLOP *** [9c 2d Qd]
123tiger711a: checks
BigBlue: checks
*** TURN *** [9c 2d Qd] [7h]
123tiger711a: checks
BigBlue: checks
*** RIVER *** [9c 2d Qd 7h] [8c]
123tiger711a: checks
BigBlue: bets $1
123tiger711a: folds
Uncalled bet ($1) returned to BigBlue
BigBlue collected $0.62 from pot
BigBlue: doesn't show hand
*** SUMMARY ***
Total pot $0.65 | Rake $0.03
Board [9c 2d Qd 7h 8c]
Seat 1: nando_abarca (button) folded before Flop (didn't bet)
Seat 2: PlayTheBlues4U (small blind) folded before Flop
Seat 3: 123tiger711a (big blind) folded on the River
Seat 4: jmc926 folded before Flop (didn't bet)
Seat 5: F3ign folded before Flop (didn't bet)
Seat 6: BigBlue collected ($0.62)


PokerStars Hand #203587528977:  Hold'em No Limit ($0.05/$0.10 USD) - 2019/09/10 20:48:00 ET
Table 'Corvus' 6-max Seat #6 is the button
Seat 1: nando_abarca ($10.30 in chips)
Seat 2: PlayTheBlues4U ($11.65 in chips)
Seat 3: 123tiger711a ($14.62 in chips)
Seat 4: jmc926 ($8.48 in chips)
Seat 5: F3ign ($21.17 in chips)
Seat 6: BigBlue ($8.69 in chips)
nando_abarca: posts small blind $0.05
PlayTheBlues4U: posts big blind $0.10
*** HOLE CARDS ***
Dealt to PlayTheBlues4U [Ah 4c]
123tiger711a: folds
jmc926: calls $0.10
F3ign: raises $0.20 to $0.30
BigBlue: calls $0.30
nando_abarca: folds
PlayTheBlues4U: folds
jmc926: calls $0.20
*** FLOP *** [7d 3c 6d]
jmc926: bets $0.50
F3ign: folds
BigBlue: folds
Uncalled bet ($0.50) returned to jmc926
jmc926 collected $1 from pot
*** SUMMARY ***
Total pot $1.05 | Rake $0.05
Board [7d 3c 6d]
Seat 1: nando_abarca (small blind) folded before Flop
Seat 2: PlayTheBlues4U (big blind) folded before Flop
Seat 3: 123tiger711a folded before Flop (didn't bet)
Seat 4: jmc926 collected ($1)
Seat 5: F3ign folded on the Flop
Seat 6: BigBlue (button) folded on the Flop


PokerStars Hand #203587528914:  Hold'em No Limit ($0.05/$0.10 USD) - 2019/09/10 20:47:45 ET
Table 'Corvus' 6-max Seat #5 is the button
Seat 1: nando_abarca ($10.40 in chips)
Seat 2: PlayTheBlues4U ($11.65 in chips)
Seat 3: 123tiger711a ($14.62 in chips)
Seat 4: jmc926 ($8.33 in chips)
Seat 5: F3ign ($21.17 in chips)
Seat 6: BigBlue ($8.74 in chips)
BigBlue: posts small blind $0.05
nando_abarca: posts big blind $0.10
*** HOLE CARDS ***
Dealt to PlayTheBlues4U [Kc 6c]
PlayTheBlues4U: folds
123tiger711a: folds
jmc926: raises $0.25 to $0.35
F3ign: folds
BigBlue: folds
nando_abarca: folds
Uncalled bet ($0.25) returned to jmc926
jmc926 collected $0.25 from pot
*** SUMMARY ***
Total pot $0.25 | Rake $0
Seat 1: nando_abarca (big blind) folded before Flop
Seat 2: PlayTheBlues4U folded before Flop (didn't bet)
Seat 3: 123tiger711a folded before Flop (didn't bet)
Seat 4: jmc926 collected ($0.25)
Seat 5: F3ign (button) folded before Flop (didn't bet)
Seat 6: BigBlue (small blind) folded before Flop


PokerStars Hand #203587528874:  Hold'em No Limit ($0.05/$0.10 USD) - 2019/09/10 20:47:35 ET
Table 'Iphigenia' 6-max Seat #5 is the button
Seat 1: kid delaw731 ($9.12 in chips)
Seat 2: nando_abarca ($6.81 in chips)
Seat 3: BigBlue ($3.36 in chips)
Seat 4: F3ign ($19.81 in chips)
Seat 5: PlayTheBlues4U ($12.14 in chips)
Seat 6: yn21 ($3.90 in chips)
yn21: posts small blind $0.05
kid delaw731: posts big blind $0.10
*** HOLE CARDS ***
Dealt to PlayTheBlues4U [5s 4s]
nando_abarca: calls $0.10
BigBlue: folds
F3ign: raises $0.20 to $0.30
PlayTheBlues4U: raises $0.40 to $0.70
yn21: calls $0.65
kid delaw731: folds
nando_abarca: folds
F3ign: calls $0.40
*** FLOP *** [9d Th Tc]
yn21: bets $1.09
F3ign: calls $1.09
PlayTheBlues4U: folds
*** TURN *** [9d Th Tc] [4d]
yn21: checks
F3ign: checks
*** RIVER *** [9d Th Tc 4d] [3d]
yn21: bets $2.11 and is all-in
F3ign: calls $2.11
*** SHOW DOWN ***
yn21: shows [Qc Qd] (two pair, Queens and Tens)
F3ign: shows [Td Kd] (a flush, King high)
F3ign collected $8.26 from pot
*** SUMMARY ***
Total pot $8.70 | Rake $0.44
Board [9d Th Tc 4d 3d]
Seat 1: kid delaw731 (big blind) folded before Flop
Seat 2: nando_abarca folded before Flop
Seat 3: BigBlue folded before Flop (didn't bet)
Seat 4: F3ign showed [Td Kd] and won ($8.26) with a flush, King high
Seat 5: PlayTheBlues4U (button) folded on the Flop
Seat 6: yn21 (small blind) showed [Qc Qd] and lost with two pair, Queens and Tens


PokerStars Hand #203587528638:  Hold'em No Limit ($0.05/$0.10 USD) - 2019/09/10 20:46:37 ET
Table 'Corvus' 6-max Seat #4 is the button
Seat 1: nando_abarca ($10.70 in chips)
Seat 2: PlayTheBlues4U ($11.65 in chips)
Seat 3: 123tiger711a ($14.62 in chips)
Seat 4: jmc926 ($7.92 in chips)
Seat 5: F3ign ($21.22 in chips)
Seat 6: BigBlue ($8.84 in chips)
F3ign: posts small blind $0.05
BigBlue: posts big blind $0.10
*** HOLE CARDS ***
Dealt to PlayTheBlues4U [5h 8s]
nando_abarca: calls $0.10
PlayTheBlues4U: folds
123tiger711a: folds
jmc926: calls $0.10
F3ign: folds
BigBlue: checks
*** FLOP *** [4c 8c 7d]
BigBlue: checks
nando_abarca: checks
jmc926: checks
*** TURN *** [4c 8c 7d] [6h]
BigBlue: checks
nando_abarca: checks
jmc926: checks
*** RIVER *** [4c 8c 7d 6h] [Th]
BigBlue: checks
nando_abarca: checks
jmc926: bets $0.20
BigBlue: folds
nando_abarca: calls $0.20
*** SHOW DOWN ***
jmc926: shows [Kd 9h] (a straight, Six to Ten)
nando_abarca: mucks hand
jmc926 collected $0.71 from pot
*** SUMMARY ***
Total pot $0.75 | Rake $0.04
Board [4c 8c 7d 6h Th]
Seat 1: nando_abarca mucked [Td Qd]
Seat 2: PlayTheBlues4U folded before Flop (didn't bet)
Seat 3: 123tiger711a folded before Flop (didn't bet)
Seat 4: jmc926 (button) showed [Kd 9h] and won ($0.71) with a straight, Six to Ten
Seat 5: F3ign (small blind) folded before Flop
Seat 6: BigBlue (big blind) folded on the River


PokerStars Hand #203587528614:  Hold'em No Limit ($0.05/$0.10 USD) - 2019/09/10 20:46:32 ET
Table 'Iphigenia' 6-max Seat #4 is the button
Seat 1: kid delaw731 ($9.12 in chips)
Seat 2: nando_abarca ($6.63 in chips)
Seat 3: BigBlue ($3.36 in chips)
Seat 4: F3ign ($19.81 in chips)
Seat 5: PlayTheBlues4U ($12.24 in chips)
Seat 6: yn21 ($4 in chips)
PlayTheBlues4U: posts small blind $0.05
yn21: posts big blind $0.10
*** HOLE CARDS ***
Dealt to PlayTheBlues4U [Th 7d]
kid delaw731: folds
nando_abarca: calls $0.10
BigBlue: folds
F3ign: folds
PlayTheBlues4U: calls $0.05
yn21: checks
*** FLOP *** [3s 6h Jc]
PlayTheBlues4U: checks
yn21: checks
nando_abarca: checks
*** TURN *** [3s 6h Jc] [Qh]
PlayTheBlues4U: checks
yn21: checks
nando_abarca: checks
*** RIVER *** [3s 6h Jc Qh] [2h]
PlayTheBlues4U: checks
yn21: checks
nando_abarca: checks
*** SHOW DOWN ***
PlayTheBlues4U: shows [Th 7d] (high card Queen)
yn21: shows [3d 5s] (a pair of Threes)
nando_abarca: shows [7h 7c] (a pair of Sevens)
nando_abarca collected $0.28 from pot
*** SUMMARY ***
Total pot $0.30 | Rake $0.02
Board [3s 6h Jc Qh 2h]
Seat 1: kid delaw731 folded before Flop (didn't bet)
Seat 2: nando_abarca showed [7h 7c] and won ($0.28) with a pair of Sevens
Seat 3: BigBlue folded before Flop (didn't bet)
Seat 4: F3ign (button) folded before Flop (didn't bet)
Seat 5: PlayTheBlues4U (small blind) showed [Th 7d] and lost with high card Queen
Seat 6: yn21 (big blind) showed [3d 5s] and lost with a pair of Threes


PokerStars Hand #203587528508:  Hold'em No Limit ($0.05/$0.10 USD) - 2019/09/10 20:46:02 ET
Table 'Corvus' 6-max Seat #3 is the button
Seat 1: nando_abarca ($10.70 in chips)
Seat 2: PlayTheBlues4U ($11.65 in chips)
Seat 3: 123tiger711a ($14.62 in chips)
Seat 4: jmc926 ($7.83 in chips)
Seat 5: F3ign ($21.32 in chips)
Seat 6: BigBlue ($8.84 in chips)
jmc926: posts small blind $0.05
F3ign: posts big blind $0.10
*** HOLE CARDS ***
Dealt to PlayTheBlues4U [Qh Ts]
BigBlue: folds
nando_abarca: folds
PlayTheBlues4U: folds
123tiger711a: folds
jmc926: calls $0.05
F3ign: checks
*** FLOP *** [Js 4h 6s]
jmc926: bets $0.20
F3ign: folds
Uncalled bet ($0.20) returned to jmc926
jmc926 collected $0.19 from pot
*** SUMMARY ***
Total pot $0.20 | Rake $0.01
Board [Js 4h 6s]
Seat 1: nando_abarca folded before Flop (didn't bet)
Seat 2: PlayTheBlues4U folded before Flop (didn't bet)
Seat 3: 123tiger711a (button) folded before Flop (didn't bet)
Seat 4: jmc926 (small blind) collected ($0.19)
Seat 5: F3ign (big blind) folded on the Flop
Seat 6: BigBlue folded before Flop (didn't bet)


PokerStars Hand #203587528471:  Hold'em No Limit ($0.05/$0.10 USD) - 2019/09/10 20:45:53 ET
Table 'Iphigenia' 6-max Seat #3 is the button
Seat 1: kid delaw731 ($9.12 in chips)
Seat 2: nando_abarca ($7.08 in chips)
Seat 3: BigBlue ($2.81 in chips)
Seat 4: F3ign ($19.86 in chips)
Seat 5: PlayTheBlues4U ($12.34 in chips)
F3ign: posts small blind $0.05
PlayTheBlues4U: posts big blind $0.10
yn21: sits out
*** HOLE CARDS ***
Dealt to PlayTheBlues4U [7c Qh]
kid delaw731: folds
nando_abarca: calls $0.10
BigBlue: raises $0.35 to $0.45
F3ign: folds
PlayTheBlues4U: folds
nando_abarca: calls $0.35
*** FLOP *** [2d 9d Td]
nando_abarca: checks
BigBlue: checks
*** TURN *** [2d 9d Td] [Ah]
nando_abarca: checks
BigBlue: bets $0.60
nando_abarca: folds
Uncalled bet ($0.60) returned to BigBlue
BigBlue collected $1 from pot
BigBlue: doesn't show hand
*** SUMMARY ***
Total pot $1.05 | Rake $0.05
Board [2d 9d Td Ah]
Seat 1: kid delaw731 folded before Flop (didn't bet)
Seat 2: nando_abarca folded on the Turn
Seat 3: BigBlue (button) collected ($1)
Seat 4: F3ign (small blind) folded before Flop
Seat 5: PlayTheBlues4U (big blind) folded before Flop


PokerStars Hand #203586999885:  Hold'em No Limit ($0.05/$0.10 USD) - 2019/09/10 20:45:04 ET
Table 'Corvus' 6-max Seat #2 is the button
Seat 1: nando_abarca ($10.70 in chips)
Seat 2: PlayTheBlues4U ($11.65 in chips)
Seat 3: 123tiger711a ($14.06 in chips)
Seat 4: jmc926 ($8.13 in chips)
Seat 5: F3ign ($21.62 in chips)
Seat 6: BigBlue ($8.84 in chips)
123tiger711a: posts small blind $0.05
jmc926: posts big blind $0.10
*** HOLE CARDS ***
Dealt to PlayTheBlues4U [Jh 8s]
F3ign: raises $0.20 to $0.30
BigBlue: folds
nando_abarca: folds
PlayTheBlues4U: folds
123tiger711a: calls $0.25
jmc926: calls $0.20
*** FLOP *** [6h 2h 6s]
123tiger711a: checks
jmc926: checks
F3ign: checks
*** TURN *** [6h 2h 6s] [3d]
123tiger711a: bets $0.86
jmc926: folds
F3ign: folds
Uncalled bet ($0.86) returned to 123tiger711a
123tiger711a collected $0.86 from pot
*** SUMMARY ***
Total pot $0.90 | Rake $0.04
Board [6h 2h 6s 3d]
Seat 1: nando_abarca folded before Flop (didn't bet)
Seat 2: PlayTheBlues4U (button) folded before Flop (didn't bet)
Seat 3: 123tiger711a (small blind) collected ($0.86)
Seat 4: jmc926 (big blind) folded on the Turn
Seat 5: F3ign folded on the Turn
Seat 6: BigBlue folded before Flop (didn't bet)


PokerStars Hand #203586999812:  Hold'em No Limit ($0.05/$0.10 USD) - 2019/09/10 20:44:42 ET
Table 'Iphigenia' 6-max Seat #2 is the button
Seat 1: kid delaw731 ($6.89 in chips)
Seat 2: nando_abarca ($9.40 in chips)
Seat 3: BigBlue ($2.86 in chips)
Seat 4: F3ign ($19.96 in chips)
Seat 5: PlayTheBlues4U ($12.34 in chips)
BigBlue: posts small blind $0.05
F3ign: posts big blind $0.10
yn21: sits out
*** HOLE CARDS ***
Dealt to PlayTheBlues4U [8s 4s]
PlayTheBlues4U: folds
kid delaw731: calls $0.10
nando_abarca: calls $0.10
BigBlue: folds
F3ign: checks
*** FLOP *** [2d Ks 3c]
F3ign: checks
kid delaw731: checks
nando_abarca: bets $0.20
F3ign: folds
kid delaw731: calls $0.20
*** TURN *** [2d Ks 3c] [5c]
kid delaw731: checks
nando_abarca: bets $0.45
kid delaw731: calls $0.45
*** RIVER *** [2d Ks 3c 5c] [Jh]
kid delaw731: bets $1.57
nando_abarca: calls $1.57
*** SHOW DOWN ***
kid delaw731: shows [2c 2s] (three of a kind, Deuces)
nando_abarca: mucks hand
kid delaw731 collected $4.55 from pot
*** SUMMARY ***
Total pot $4.79 | Rake $0.24
Board [2d Ks 3c 5c Jh]
Seat 1: kid delaw731 showed [2c 2s] and won ($4.55) with three of a kind, Deuces
Seat 2: nando_abarca (button) mucked [Jd Kh]
Seat 3: BigBlue (small blind) folded before Flop
Seat 4: F3ign (big blind) folded on the Flop
Seat 5: PlayTheBlues4U folded before Flop (didn't bet)


PokerStars Hand #203586999759:  Hold'em No Limit ($0.05/$0.10 USD) - 2019/09/10 20:44:25 ET
Table 'Corvus' 6-max Seat #1 is the button
Seat 1: nando_abarca ($9.96 in chips)
Seat 2: PlayTheBlues4U ($11.70 in chips)
Seat 3: 123tiger711a ($14.16 in chips)
Seat 4: jmc926 ($8.79 in chips)
Seat 5: F3ign ($21.62 in chips)
Seat 6: BigBlue ($8.84 in chips)
PlayTheBlues4U: posts small blind $0.05
123tiger711a: posts big blind $0.10
*** HOLE CARDS ***
Dealt to PlayTheBlues4U [Ks 4s]
jmc926: raises $0.20 to $0.30
F3ign: folds
BigBlue: folds
nando_abarca: calls $0.30
PlayTheBlues4U: folds
123tiger711a: folds
*** FLOP *** [3d Qh 9d]
jmc926: bets $0.36
nando_abarca: calls $0.36
*** TURN *** [3d Qh 9d] [9h]
jmc926: checks
nando_abarca: bets $1
jmc926: folds
Uncalled bet ($1) returned to nando_abarca
nando_abarca collected $1.40 from pot
nando_abarca: doesn't show hand
*** SUMMARY ***
Total pot $1.47 | Rake $0.07
Board [3d Qh 9d 9h]
Seat 1: nando_abarca (button) collected ($1.40)
Seat 2: PlayTheBlues4U (small blind) folded before Flop
Seat 3: 123tiger711a (big blind) folded before Flop
Seat 4: jmc926 folded on the Turn
Seat 5: F3ign folded before Flop (didn't bet)
Seat 6: BigBlue folded before Flop (didn't bet)


PokerStars Hand #203586999654:  Hold'em No Limit ($0.05/$0.10 USD) - 2019/09/10 20:43:56 ET
Table 'Iphigenia' 6-max Seat #1 is the button
Seat 1: kid delaw731 ($6.89 in chips)
Seat 2: nando_abarca ($9.50 in chips)
Seat 3: BigBlue ($3.16 in chips)
Seat 4: F3ign ($19.96 in chips)
Seat 5: PlayTheBlues4U ($11.98 in chips)
nando_abarca: posts small blind $0.05
BigBlue: posts big blind $0.10
*** HOLE CARDS ***
Dealt to PlayTheBlues4U [7c 7s]
F3ign: folds
PlayTheBlues4U: calls $0.10
kid delaw731: folds
nando_abarca: calls $0.05
BigBlue: checks
*** FLOP *** [Kh 6s 9c]
nando_abarca: checks
yn21 joins the table at seat #6
BigBlue: bets $0.20
PlayTheBlues4U: calls $0.20
nando_abarca: folds
*** TURN *** [Kh 6s 9c] [8s]
BigBlue: checks
PlayTheBlues4U: bets $0.40
BigBlue: folds
Uncalled bet ($0.40) returned to PlayTheBlues4U
PlayTheBlues4U collected $0.66 from pot
PlayTheBlues4U: doesn't show hand
*** SUMMARY ***
Total pot $0.70 | Rake $0.04
Board [Kh 6s 9c 8s]
Seat 1: kid delaw731 (button) folded before Flop (didn't bet)
Seat 2: nando_abarca (small blind) folded on the Flop
Seat 3: BigBlue (big blind) folded on the Turn
Seat 4: F3ign folded before Flop (didn't bet)
Seat 5: PlayTheBlues4U collected ($0.66)


PokerStars Hand #203586999596:  Hold'em No Limit ($0.05/$0.10 USD) - 2019/09/10 20:43:38 ET
Table 'Corvus' 6-max Seat #6 is the button
Seat 1: nando_abarca ($10.01 in chips)
Seat 2: PlayTheBlues4U ($12.15 in chips)
Seat 3: 123tiger711a ($14.61 in chips)
Seat 4: jmc926 ($8.79 in chips)
Seat 5: F3ign ($21.62 in chips)
Seat 6: BigBlue ($7.96 in chips)
nando_abarca: posts small blind $0.05
PlayTheBlues4U: posts big blind $0.10
*** HOLE CARDS ***
Dealt to PlayTheBlues4U [Kc Qh]
123tiger711a: calls $0.10
jmc926: folds
F3ign: folds
BigBlue: raises $0.35 to $0.45
nando_abarca: folds
PlayTheBlues4U: calls $0.35
123tiger711a: calls $0.35
*** FLOP *** [8d Jh 7h]
PlayTheBlues4U: checks
123tiger711a: checks
BigBlue: bets $0.80
PlayTheBlues4U: folds
123tiger711a: folds
Uncalled bet ($0.80) returned to BigBlue
BigBlue collected $1.33 from pot
BigBlue: doesn't show hand
*** SUMMARY ***
Total pot $1.40 | Rake $0.07
Board [8d Jh 7h]
Seat 1: nando_abarca (small blind) folded before Flop
Seat 2: PlayTheBlues4U (big blind) folded on the Flop
Seat 3: 123tiger711a folded on the Flop
Seat 4: jmc926 folded before Flop (didn't bet)
Seat 5: F3ign folded before Flop (didn't bet)
Seat 6: BigBlue (button) collected ($1.33)


PokerStars Hand #203586999542:  Hold'em No Limit ($0.05/$0.10 USD) - 2019/09/10 20:43:21 ET
Table 'Iphigenia' 6-max Seat #5 is the button
Seat 1: kid delaw731 ($6.94 in chips)
Seat 2: nando_abarca ($9.60 in chips)
Seat 3: BigBlue ($3.16 in chips)
Seat 4: F3ign ($19.96 in chips)
Seat 5: PlayTheBlues4U ($11.83 in chips)
kid delaw731: posts small blind $0.05
nando_abarca: posts big blind $0.10
*** HOLE CARDS ***
Dealt to PlayTheBlues4U [Jc 9c]
BigBlue: folds
F3ign: folds
PlayTheBlues4U: raises $0.10 to $0.20
kid delaw731: folds
nando_abarca: folds
Uncalled bet ($0.10) returned to PlayTheBlues4U
PlayTheBlues4U collected $0.25 from pot
PlayTheBlues4U: doesn't show hand
*** SUMMARY ***
Total pot $0.25 | Rake $0
Seat 1: kid delaw731 (small blind) folded before Flop
Seat 2: nando_abarca (big blind) folded before Flop
Seat 3: BigBlue folded before Flop (didn't bet)
Seat 4: F3ign folded before Flop (didn't bet)
Seat 5: PlayTheBlues4U (button) collected ($0.25)


PokerStars Hand #203586999448:  Hold'em No Limit ($0.05/$0.10 USD) - 2019/09/10 20:42:58 ET
Table 'Corvus' 6-max Seat #5 is the button
Seat 1: nando_abarca ($9.87 in chips)
Seat 2: PlayTheBlues4U ($12.15 in chips)
Seat 3: 123tiger711a ($14.61 in chips)
Seat 4: jmc926 ($8.89 in chips)
Seat 5: F3ign ($21.62 in chips)
Seat 6: BigBlue ($8.01 in chips)
BigBlue: posts small blind $0.05
nando_abarca: posts big blind $0.10
*** HOLE CARDS ***
Dealt to PlayTheBlues4U [7s 8h]
PlayTheBlues4U: folds
123tiger711a: folds
jmc926: calls $0.10
F3ign: folds
BigBlue: folds
nando_abarca: checks
*** FLOP *** [4s 6s 4h]
nando_abarca: checks
jmc926: checks
*** TURN *** [4s 6s 4h] [Kh]
nando_abarca: checks
jmc926: checks
*** RIVER *** [4s 6s 4h Kh] [Jh]
nando_abarca: checks
jmc926: checks
*** SHOW DOWN ***
nando_abarca: shows [8c 8s] (two pair, Eights and Fours)
jmc926: mucks hand
nando_abarca collected $0.24 from pot
*** SUMMARY ***
Total pot $0.25 | Rake $0.01
Board [4s 6s 4h Kh Jh]
Seat 1: nando_abarca (big blind) showed [8c 8s] and won ($0.24) with two pair, Eights and Fours
Seat 2: PlayTheBlues4U folded before Flop (didn't bet)
Seat 3: 123tiger711a folded before Flop (didn't bet)
Seat 4: jmc926 mucked [Qd 8d]
Seat 5: F3ign (button) folded before Flop (didn't bet)
Seat 6: BigBlue (small blind) folded before Flop


PokerStars Hand #203586999396:  Hold'em No Limit ($0.05/$0.10 USD) - 2019/09/10 20:42:44 ET
Table 'Corvus' 6-max Seat #4 is the button
Seat 1: nando_abarca ($9.87 in chips)
Seat 2: PlayTheBlues4U ($12.15 in chips)
Seat 3: 123tiger711a ($14.61 in chips)
Seat 4: jmc926 ($8.89 in chips)
Seat 5: F3ign ($21.67 in chips)
Seat 6: BigBlue ($7.96 in chips)
F3ign: posts small blind $0.05
BigBlue: posts big blind $0.10
*** HOLE CARDS ***
Dealt to PlayTheBlues4U [Qh 5c]
nando_abarca: folds
PlayTheBlues4U: folds
123tiger711a: folds
jmc926: folds
F3ign: folds
Uncalled bet ($0.05) returned to BigBlue
BigBlue collected $0.10 from pot
BigBlue: doesn't show hand
*** SUMMARY ***
Total pot $0.10 | Rake $0
Seat 1: nando_abarca folded before Flop (didn't bet)
Seat 2: PlayTheBlues4U folded before Flop (didn't bet)
Seat 3: 123tiger711a folded before Flop (didn't bet)
Seat 4: jmc926 (button) folded before Flop (didn't bet)
Seat 5: F3ign (small blind) folded before Flop
Seat 6: BigBlue (big blind) collected ($0.10)


PokerStars Hand #203586999334:  Hold'em No Limit ($0.05/$0.10 USD) - 2019/09/10 20:42:28 ET
Table 'Iphigenia' 6-max Seat #4 is the button
Seat 1: kid delaw731 ($6.53 in chips)
Seat 2: nando_abarca ($9.60 in chips)
Seat 3: BigBlue ($3.46 in chips)
Seat 4: F3ign ($19.96 in chips)
Seat 5: PlayTheBlues4U ($11.88 in chips)
Seat 6: mikimax2.1 ($9.70 in chips)
PlayTheBlues4U: posts small blind $0.05
mikimax2.1: posts big blind $0.10
*** HOLE CARDS ***
Dealt to PlayTheBlues4U [4c Qd]
kid delaw731: raises $0.20 to $0.30
nando_abarca: folds
BigBlue: calls $0.30
F3ign: folds
PlayTheBlues4U: folds
mikimax2.1: folds
*** FLOP *** [7s 8h Ah]
mikimax2.1 leaves the table
kid delaw731: bets $0.38
BigBlue: folds
Uncalled bet ($0.38) returned to kid delaw731
kid delaw731 collected $0.71 from pot
kid delaw731: doesn't show hand
*** SUMMARY ***
Total pot $0.75 | Rake $0.04
Board [7s 8h Ah]
Seat 1: kid delaw731 collected ($0.71)
Seat 2: nando_abarca folded before Flop (didn't bet)
Seat 3: BigBlue folded on the Flop
Seat 4: F3ign (button) folded before Flop (didn't bet)
Seat 5: PlayTheBlues4U (small blind) folded before Flop
Seat 6: mikimax2.1 (big blind) folded before Flop


PokerStars Hand #203586999207:  Hold'em No Limit ($0.05/$0.10 USD) - 2019/09/10 20:41:50 ET
Table 'Corvus' 6-max Seat #3 is the button
Seat 1: nando_abarca ($9.87 in chips)
Seat 2: PlayTheBlues4U ($12.15 in chips)
Seat 3: 123tiger711a ($15.11 in chips)
Seat 4: jmc926 ($7.87 in chips)
Seat 5: F3ign ($22.17 in chips)
Seat 6: BigBlue ($8.06 in chips)
jmc926: posts small blind $0.05
F3ign: posts big blind $0.10
*** HOLE CARDS ***
Dealt to PlayTheBlues4U [Qd 9d]
BigBlue: calls $0.10
nando_abarca: folds
PlayTheBlues4U: folds
123tiger711a: calls $0.10
jmc926: calls $0.05
F3ign: raises $0.40 to $0.50
BigBlue: folds
123tiger711a: calls $0.40
jmc926: calls $0.40
*** FLOP *** [5h 6c Th]
jmc926: bets $0.76
F3ign: folds
123tiger711a: folds
Uncalled bet ($0.76) returned to jmc926
jmc926 collected $1.52 from pot
*** SUMMARY ***
Total pot $1.60 | Rake $0.08
Board [5h 6c Th]
Seat 1: nando_abarca folded before Flop (didn't bet)
Seat 2: PlayTheBlues4U folded before Flop (didn't bet)
Seat 3: 123tiger711a (button) folded on the Flop
Seat 4: jmc926 (small blind) collected ($1.52)
Seat 5: F3ign (big blind) folded on the Flop
Seat 6: BigBlue folded before Flop


PokerStars Hand #203586999144:  Hold'em No Limit ($0.05/$0.10 USD) - 2019/09/10 20:41:32 ET
Table 'Corvus' 6-max Seat #2 is the button
Seat 1: nando_abarca ($9.87 in chips)
Seat 2: PlayTheBlues4U ($12 in chips)
Seat 3: 123tiger711a ($15.16 in chips)
Seat 4: jmc926 ($7.97 in chips)
Seat 6: BigBlue ($8.06 in chips)
123tiger711a: posts small blind $0.05
jmc926: posts big blind $0.10
F3ign: sits out
*** HOLE CARDS ***
Dealt to PlayTheBlues4U [Kh Ks]
BigBlue: folds
nando_abarca: folds
PlayTheBlues4U: raises $0.20 to $0.30
123tiger711a: folds
jmc926: folds
Uncalled bet ($0.20) returned to PlayTheBlues4U
PlayTheBlues4U collected $0.25 from pot
PlayTheBlues4U: doesn't show hand
*** SUMMARY ***
Total pot $0.25 | Rake $0
Seat 1: nando_abarca folded before Flop (didn't bet)
Seat 2: PlayTheBlues4U (button) collected ($0.25)
Seat 3: 123tiger711a (small blind) folded before Flop
Seat 4: jmc926 (big blind) folded before Flop
Seat 6: BigBlue folded before Flop (didn't bet)


PokerStars Hand #203586999128:  Hold'em No Limit ($0.05/$0.10 USD) - 2019/09/10 20:41:27 ET
Table 'Iphigenia' 6-max Seat #3 is the button
Seat 1: kid delaw731 ($6.53 in chips)
Seat 2: nando_abarca ($9.70 in chips)
Seat 3: BigBlue ($3.46 in chips)
Seat 4: F3ign ($20.01 in chips)
Seat 5: PlayTheBlues4U ($11.47 in chips)
Seat 6: mikimax2.1 ($10 in chips)
F3ign: posts small blind $0.05
PlayTheBlues4U: posts big blind $0.10
*** HOLE CARDS ***
Dealt to PlayTheBlues4U [5s Kh]
mikimax2.1: calls $0.10
kid delaw731: folds
nando_abarca: calls $0.10
BigBlue: folds
F3ign: folds
PlayTheBlues4U: checks
*** FLOP *** [Ts 5c Jd]
PlayTheBlues4U: checks
mikimax2.1: checks
nando_abarca: checks
*** TURN *** [Ts 5c Jd] [3h]
PlayTheBlues4U: bets $0.20
mikimax2.1: calls $0.20
nando_abarca: folds
*** RIVER *** [Ts 5c Jd 3h] [2c]
PlayTheBlues4U: checks
mikimax2.1: checks
*** SHOW DOWN ***
PlayTheBlues4U: shows [5s Kh] (a pair of Fives)
mikimax2.1: mucks hand
PlayTheBlues4U collected $0.71 from pot
*** SUMMARY ***
Total pot $0.75 | Rake $0.04
Board [Ts 5c Jd 3h 2c]
Seat 1: kid delaw731 folded before Flop (didn't bet)
Seat 2: nando_abarca folded on the Turn
Seat 3: BigBlue (button) folded before Flop (didn't bet)
Seat 4: F3ign (small blind) folded before Flop
Seat 5: PlayTheBlues4U (big blind) showed [5s Kh] and won ($0.71) with a pair of Fives
Seat 6: mikimax2.1 mucked [Ks Qs]


PokerStars Hand #203586999011:  Hold'em No Limit ($0.05/$0.10 USD) - 2019/09/10 20:40:52 ET
Table 'Corvus' 6-max Seat #1 is the button
Seat 1: nando_abarca ($9.87 in chips)
Seat 2: PlayTheBlues4U ($12.05 in chips)
Seat 3: 123tiger711a ($11.46 in chips)
Seat 4: jmc926 ($8.07 in chips)
Seat 6: BigBlue ($12.01 in chips)
PlayTheBlues4U: posts small blind $0.05
123tiger711a: posts big blind $0.10
F3ign: sits out
*** HOLE CARDS ***
Dealt to PlayTheBlues4U [Jd 8d]
jmc926: calls $0.10
BigBlue: raises $0.35 to $0.45
nando_abarca: folds
PlayTheBlues4U: folds
123tiger711a: calls $0.35
jmc926: folds
*** FLOP *** [8s 7s 7c]
123tiger711a: checks
BigBlue: checks
*** TURN *** [8s 7s 7c] [Kd]
123tiger711a: bets $0.50
BigBlue: raises $1 to $1.50
123tiger711a: calls $1
*** RIVER *** [8s 7s 7c Kd] [4d]
123tiger711a: checks
BigBlue: bets $2
123tiger711a: calls $2
*** SHOW DOWN ***
BigBlue: shows [3c 5c] (a pair of Sevens)
123tiger711a: shows [Kc Ah] (two pair, Kings and Sevens)
123tiger711a collected $7.65 from pot
*** SUMMARY ***
Total pot $8.05 | Rake $0.40
Board [8s 7s 7c Kd 4d]
Seat 1: nando_abarca (button) folded before Flop (didn't bet)
Seat 2: PlayTheBlues4U (small blind) folded before Flop
Seat 3: 123tiger711a (big blind) showed [Kc Ah] and won ($7.65) with two pair, Kings and Sevens
Seat 4: jmc926 folded before Flop
Seat 6: BigBlue showed [3c 5c] and lost with a pair of Sevens


PokerStars Hand #203586998965:  Hold'em No Limit ($0.05/$0.10 USD) - 2019/09/10 20:40:39 ET
Table 'Iphigenia' 6-max Seat #2 is the button
Seat 1: kid delaw731 ($6.53 in chips)
Seat 2: nando_abarca ($9.80 in chips)
Seat 3: BigBlue ($3.51 in chips)
Seat 4: F3ign ($20.11 in chips)
Seat 5: PlayTheBlues4U ($11.47 in chips)
Seat 6: mikimax2.1 ($9.77 in chips)
BigBlue: posts small blind $0.05
F3ign: posts big blind $0.10
mikimax2.1: posts small & big blinds $0.15
*** HOLE CARDS ***
Dealt to PlayTheBlues4U [7c 4h]
PlayTheBlues4U: folds
mikimax2.1: checks
kid delaw731: folds
nando_abarca: calls $0.10
BigBlue: folds
F3ign: checks
*** FLOP *** [3s 6d 2h]
F3ign: checks
mikimax2.1: bets $0.40
nando_abarca: folds
F3ign: folds
Uncalled bet ($0.40) returned to mikimax2.1
mikimax2.1 collected $0.38 from pot
mikimax2.1: doesn't show hand
*** SUMMARY ***
Total pot $0.40 | Rake $0.02
Board [3s 6d 2h]
Seat 1: kid delaw731 folded before Flop (didn't bet)
Seat 2: nando_abarca (button) folded on the Flop
Seat 3: BigBlue (small blind) folded before Flop
Seat 4: F3ign (big blind) folded on the Flop
Seat 5: PlayTheBlues4U folded before Flop (didn't bet)
Seat 6: mikimax2.1 collected ($0.38)


PokerStars Hand #203586998816:  Hold'em No Limit ($0.05/$0.10 USD) - 2019/09/10 20:39:58 ET
Table 'Iphigenia' 6-max Seat #1 is the button
Seat 1: kid delaw731 ($6.53 in chips)
Seat 2: nando_abarca ($9.90 in chips)
Seat 3: BigBlue ($3.42 in chips)
Seat 5: PlayTheBlues4U ($11.47 in chips)
nando_abarca: posts small blind $0.05
BigBlue: posts big blind $0.10
F3ign: sits out
mikimax2.1 has timed out
mikimax2.1: is sitting out
*** HOLE CARDS ***
Dealt to PlayTheBlues4U [Qd 7d]
PlayTheBlues4U: folds
kid delaw731: folds
nando_abarca: calls $0.05
BigBlue: checks
*** FLOP *** [2c Kd 6d]
nando_abarca: checks
BigBlue: bets $0.10
nando_abarca: folds
Uncalled bet ($0.10) returned to BigBlue
BigBlue collected $0.19 from pot
BigBlue: doesn't show hand
*** SUMMARY ***
Total pot $0.20 | Rake $0.01
Board [2c Kd 6d]
Seat 1: kid delaw731 (button) folded before Flop (didn't bet)
Seat 2: nando_abarca (small blind) folded on the Flop
Seat 3: BigBlue (big blind) collected ($0.19)
Seat 5: PlayTheBlues4U folded before Flop (didn't bet)


PokerStars Hand #203586998813:  Hold'em No Limit ($0.05/$0.10 USD) - 2019/09/10 20:39:57 ET
Table 'Corvus' 6-max Seat #6 is the button
Seat 1: nando_abarca ($9.92 in chips)
Seat 2: PlayTheBlues4U ($10.49 in chips)
Seat 3: 123tiger711a ($11.46 in chips)
Seat 4: jmc926 ($9.75 in chips)
Seat 6: BigBlue ($12.01 in chips)
nando_abarca: posts small blind $0.05
PlayTheBlues4U: posts big blind $0.10
F3ign: sits out
*** HOLE CARDS ***
Dealt to PlayTheBlues4U [Kc 2c]
123tiger711a: folds
jmc926: raises $0.10 to $0.20
BigBlue: folds
nando_abarca: folds
PlayTheBlues4U: calls $0.10
*** FLOP *** [2s Ts Kh]
PlayTheBlues4U: checks
jmc926: bets $0.22
PlayTheBlues4U: calls $0.22
*** TURN *** [2s Ts Kh] [5h]
PlayTheBlues4U: checks
jmc926: bets $0.43
PlayTheBlues4U: raises $0.83 to $1.26
jmc926: calls $0.83
*** RIVER *** [2s Ts Kh 5h] [8d]
PlayTheBlues4U: checks
jmc926: checks
*** SHOW DOWN ***
PlayTheBlues4U: shows [Kc 2c] (two pair, Kings and Deuces)
jmc926: mucks hand
PlayTheBlues4U collected $3.24 from pot
*** SUMMARY ***
Total pot $3.41 | Rake $0.17
Board [2s Ts Kh 5h 8d]
Seat 1: nando_abarca (small blind) folded before Flop
Seat 2: PlayTheBlues4U (big blind) showed [Kc 2c] and won ($3.24) with two pair, Kings and Deuces
Seat 3: 123tiger711a folded before Flop (didn't bet)
Seat 4: jmc926 mucked [Th Qs]
Seat 6: BigBlue (button) folded before Flop (didn't bet)


PokerStars Hand #203586998747:  Hold'em No Limit ($0.05/$0.10 USD) - 2019/09/10 20:39:38 ET
Table 'Iphigenia' 6-max Seat #5 is the button
Seat 1: kid delaw731 ($6.44 in chips)
Seat 2: nando_abarca ($10 in chips)
Seat 3: BigBlue ($3.42 in chips)
Seat 5: PlayTheBlues4U ($11.47 in chips)
mikimax2.1 will be allowed to play after the button
kid delaw731: posts small blind $0.05
nando_abarca: posts big blind $0.10
F3ign: sits out
*** HOLE CARDS ***
Dealt to PlayTheBlues4U [4s Kd]
BigBlue: folds
PlayTheBlues4U: folds
kid delaw731: calls $0.05
nando_abarca: checks
*** FLOP *** [5c Ah 3d]
kid delaw731: bets $0.14
nando_abarca: folds
Uncalled bet ($0.14) returned to kid delaw731
kid delaw731 collected $0.19 from pot
kid delaw731: doesn't show hand
*** SUMMARY ***
Total pot $0.20 | Rake $0.01
Board [5c Ah 3d]
Seat 1: kid delaw731 (small blind) collected ($0.19)
Seat 2: nando_abarca (big blind) folded on the Flop
Seat 3: BigBlue folded before Flop (didn't bet)
Seat 5: PlayTheBlues4U (button) folded before Flop (didn't bet)


PokerStars Hand #203586998657:  Hold'em No Limit ($0.05/$0.10 USD) - 2019/09/10 20:39:13 ET
Table 'Corvus' 6-max Seat #4 is the button
Seat 1: nando_abarca ($9.78 in chips)
Seat 2: PlayTheBlues4U ($10.49 in chips)
Seat 3: 123tiger711a ($11.46 in chips)
Seat 4: jmc926 ($9.85 in chips)
Seat 6: BigBlue ($12.06 in chips)
BigBlue: posts small blind $0.05
nando_abarca: posts big blind $0.10
*** HOLE CARDS ***
Dealt to PlayTheBlues4U [Td 7c]
PlayTheBlues4U: folds
123tiger711a: folds
jmc926: calls $0.10
BigBlue: folds
nando_abarca: checks
*** FLOP *** [9s Ts 8h]
nando_abarca: checks
jmc926: checks
*** TURN *** [9s Ts 8h] [8d]
nando_abarca: checks
jmc926: checks
*** RIVER *** [9s Ts 8h 8d] [Js]
nando_abarca: checks
jmc926: checks
*** SHOW DOWN ***
nando_abarca: shows [4c 7s] (a straight, Seven to Jack)
jmc926: mucks hand
nando_abarca collected $0.24 from pot
*** SUMMARY ***
Total pot $0.25 | Rake $0.01
Board [9s Ts 8h 8d Js]
Seat 1: nando_abarca (big blind) showed [4c 7s] and won ($0.24) with a straight, Seven to Jack
Seat 2: PlayTheBlues4U folded before Flop (didn't bet)
Seat 3: 123tiger711a folded before Flop (didn't bet)
Seat 4: jmc926 (button) mucked [8s 6h]
Seat 6: BigBlue (small blind) folded before Flop


PokerStars Hand #203586998525:  Hold'em No Limit ($0.05/$0.10 USD) - 2019/09/10 20:38:36 ET
Table 'Iphigenia' 6-max Seat #3 is the button
Seat 1: kid delaw731 ($7.14 in chips)
Seat 2: walttm ($10.73 in chips)
Seat 3: BigBlue ($3.42 in chips)
Seat 5: PlayTheBlues4U ($10.84 in chips)
PlayTheBlues4U: posts small blind $0.05
mikimax2.1 is disconnected
mikimax2.1 has timed out
mikimax2.1: is sitting out
kid delaw731: posts big blind $0.10
*** HOLE CARDS ***
Dealt to PlayTheBlues4U [Ah Ks]
walttm: folds
BigBlue: folds
PlayTheBlues4U: raises $0.20 to $0.30
kid delaw731: calls $0.20
*** FLOP *** [Kd Kc 6s]
walttm leaves the table
nando_abarca joins the table at seat #2
PlayTheBlues4U: bets $0.40
kid delaw731: calls $0.40
*** TURN *** [Kd Kc 6s] [Ac]
PlayTheBlues4U: bets $1
kid delaw731: folds
Uncalled bet ($1) returned to PlayTheBlues4U
PlayTheBlues4U collected $1.33 from pot
PlayTheBlues4U: doesn't show hand
*** SUMMARY ***
Total pot $1.40 | Rake $0.07
Board [Kd Kc 6s Ac]
Seat 1: kid delaw731 (big blind) folded on the Turn
Seat 2: walttm folded before Flop (didn't bet)
Seat 3: BigBlue (button) folded before Flop (didn't bet)
Seat 5: PlayTheBlues4U (small blind) collected ($1.33)


PokerStars Hand #203586998403:  Hold'em No Limit ($0.05/$0.10 USD) - 2019/09/10 20:37:59 ET
Table 'Corvus' 6-max Seat #3 is the button
Seat 1: nando_abarca ($10.08 in chips)
Seat 2: PlayTheBlues4U ($9.35 in chips)
Seat 3: 123tiger711a ($11.46 in chips)
Seat 4: jmc926 ($9.90 in chips)
Seat 6: BigBlue ($12.96 in chips)
jmc926: posts small blind $0.05
BigBlue: posts big blind $0.10
*** HOLE CARDS ***
Dealt to PlayTheBlues4U [Ah Qc]
nando_abarca: calls $0.10
PlayTheBlues4U: raises $0.20 to $0.30
123tiger711a: folds
jmc926: folds
BigBlue: calls $0.20
nando_abarca: calls $0.20
*** FLOP *** [Jd 6h 9s]
BigBlue: checks
nando_abarca: checks
PlayTheBlues4U: bets $0.60
BigBlue: calls $0.60
nando_abarca: folds
*** TURN *** [Jd 6h 9s] [5d]
BigBlue: checks
PlayTheBlues4U: checks
*** RIVER *** [Jd 6h 9s 5d] [Kc]
BigBlue: checks
PlayTheBlues4U: bets $1.30
BigBlue: folds
Uncalled bet ($1.30) returned to PlayTheBlues4U
PlayTheBlues4U collected $2.04 from pot
PlayTheBlues4U: doesn't show hand
*** SUMMARY ***
Total pot $2.15 | Rake $0.11
Board [Jd 6h 9s 5d Kc]
Seat 1: nando_abarca folded on the Flop
Seat 2: PlayTheBlues4U collected ($2.04)
Seat 3: 123tiger711a (button) folded before Flop (didn't bet)
Seat 4: jmc926 (small blind) folded before Flop
Seat 6: BigBlue (big blind) folded on the River


PokerStars Hand #203586998332:  Hold'em No Limit ($0.05/$0.10 USD) - 2019/09/10 20:37:36 ET
Table 'Corvus' 6-max Seat #2 is the button
Seat 1: nando_abarca ($10.08 in chips)
Seat 2: PlayTheBlues4U ($9.20 in chips)
Seat 3: 123tiger711a ($11.51 in chips)
Seat 4: jmc926 ($10 in chips)
Seat 6: BigBlue ($12.96 in chips)
123tiger711a: posts small blind $0.05
jmc926: posts big blind $0.10
*** HOLE CARDS ***
Dealt to PlayTheBlues4U [8s 8c]
BigBlue: folds
nando_abarca: folds
PlayTheBlues4U: raises $0.20 to $0.30
123tiger711a: folds
jmc926: folds
Uncalled bet ($0.20) returned to PlayTheBlues4U
PlayTheBlues4U collected $0.25 from pot
PlayTheBlues4U: doesn't show hand
*** SUMMARY ***
Total pot $0.25 | Rake $0
Seat 1: nando_abarca folded before Flop (didn't bet)
Seat 2: PlayTheBlues4U (button) collected ($0.25)
Seat 3: 123tiger711a (small blind) folded before Flop
Seat 4: jmc926 (big blind) folded before Flop
Seat 6: BigBlue folded before Flop (didn't bet)


PokerStars Hand #203586998243:  Hold'em No Limit ($0.05/$0.10 USD) - 2019/09/10 20:37:11 ET
Table 'Corvus' 6-max Seat #1 is the button
Seat 1: nando_abarca ($10.08 in chips)
Seat 2: PlayTheBlues4U ($9.30 in chips)
Seat 3: 123tiger711a ($11.33 in chips)
Seat 6: BigBlue ($13.06 in chips)
PlayTheBlues4U: posts small blind $0.05
123tiger711a: posts big blind $0.10
jmc926: sits out
*** HOLE CARDS ***
Dealt to PlayTheBlues4U [3h 5d]
BigBlue: calls $0.10
nando_abarca: folds
PlayTheBlues4U: calls $0.05
123tiger711a: checks
*** FLOP *** [Ac 9c 6c]
PlayTheBlues4U: checks
123tiger711a: bets $0.14
BigBlue: folds
PlayTheBlues4U: folds
Uncalled bet ($0.14) returned to 123tiger711a
123tiger711a collected $0.28 from pot
*** SUMMARY ***
Total pot $0.30 | Rake $0.02
Board [Ac 9c 6c]
Seat 1: nando_abarca (button) folded before Flop (didn't bet)
Seat 2: PlayTheBlues4U (small blind) folded on the Flop
Seat 3: 123tiger711a (big blind) collected ($0.28)
Seat 6: BigBlue folded on the Flop


PokerStars Hand #203844275770:  Hold'em No Limit ($0.05/$0.10 USD) - 2019/09/20 20:06:48 ET
Table 'Lacerta' 6-max Seat #4 is the button
Seat 2: PlayTheBlues4U ($14.02 in chips)
Seat 3: RNixon'sHead ($14.85 in chips)
Seat 4: EddieMoney9 ($10.98 in chips)
Seat 5: pairofdz ($9.45 in chips)
Seat 6: JDM0226 ($7.30 in chips)
pairofdz: posts small blind $0.05
JDM0226: posts big blind $0.10
*** HOLE CARDS ***
Dealt to PlayTheBlues4U [Ad 6c]
PlayTheBlues4U: folds
RNixon'sHead: raises $0.15 to $0.25
EddieMoney9: folds
pairofdz: folds
JDM0226: folds
Uncalled bet ($0.15) returned to RNixon'sHead
RNixon'sHead collected $0.25 from pot
RNixon'sHead: doesn't show hand
*** SUMMARY ***
Total pot $0.25 | Rake $0
Seat 2: PlayTheBlues4U folded before Flop (didn't bet)
Seat 3: RNixon'sHead collected ($0.25)
Seat 4: EddieMoney9 (button) folded before Flop (didn't bet)
Seat 5: pairofdz (small blind) folded before Flop
Seat 6: JDM0226 (big blind) folded before Flop


PokerStars Hand #203844275710:  Hold'em No Limit ($0.02/$0.05 USD) - 2019/09/20 20:06:22 ET
Table 'Anser' 6-max Seat #4 is the button
Seat 1: CMc172 ($3.12 in chips)
Seat 3: seags21 ($4.14 in chips)
Seat 4: PlayTheBlues4U ($8.66 in chips)
CMc172: posts small blind $0.02
seags21: posts big blind $0.05
*** HOLE CARDS ***
Dealt to PlayTheBlues4U [Ah 3c]
PlayTheBlues4U: raises $0.10 to $0.15
CMc172: folds
seags21: folds
Uncalled bet ($0.10) returned to PlayTheBlues4U
PlayTheBlues4U collected $0.12 from pot
PlayTheBlues4U: doesn't show hand
*** SUMMARY ***
Total pot $0.12 | Rake $0
Seat 1: CMc172 (small blind) folded before Flop
Seat 3: seags21 (big blind) folded before Flop
Seat 4: PlayTheBlues4U (button) collected ($0.12)


PokerStars Hand #203844275690:  Hold'em No Limit ($0.02/$0.05 USD) - 2019/09/20 20:06:14 ET
Table 'Anser' 6-max Seat #3 is the button
Seat 1: CMc172 ($3.10 in chips)
Seat 3: seags21 ($4.14 in chips)
Seat 4: PlayTheBlues4U ($8.68 in chips)
PlayTheBlues4U: posts small blind $0.02
CMc172: posts big blind $0.05
*** HOLE CARDS ***
Dealt to PlayTheBlues4U [4c Ad]
seags21: folds
PlayTheBlues4U: folds
Uncalled bet ($0.03) returned to CMc172
CMc172 collected $0.04 from pot
CMc172: doesn't show hand
*** SUMMARY ***
Total pot $0.04 | Rake $0
Seat 1: CMc172 (big blind) collected ($0.04)
Seat 3: seags21 (button) folded before Flop (didn't bet)
Seat 4: PlayTheBlues4U (small blind) folded before Flop


PokerStars Hand #203844275668:  Hold'em No Limit ($0.02/$0.05 USD) - 2019/09/20 20:06:05 ET
Table 'Anser' 6-max Seat #1 is the button
Seat 1: CMc172 ($3.10 in chips)
Seat 2: clovvnfiesta ($4.14 in chips)
Seat 3: seags21 ($4.12 in chips)
Seat 4: PlayTheBlues4U ($8.68 in chips)
clovvnfiesta: posts small blind $0.02
seags21: posts big blind $0.05
*** HOLE CARDS ***
Dealt to PlayTheBlues4U [3s Ah]
PlayTheBlues4U: folds
CMc172: folds
clovvnfiesta: folds
Uncalled bet ($0.03) returned to seags21
clovvnfiesta leaves the table
seags21 collected $0.04 from pot
seags21: doesn't show hand
*** SUMMARY ***
Total pot $0.04 | Rake $0
Seat 1: CMc172 (button) folded before Flop (didn't bet)
Seat 2: clovvnfiesta (small blind) folded before Flop
Seat 3: seags21 (big blind) collected ($0.04)
Seat 4: PlayTheBlues4U folded before Flop (didn't bet)


PokerStars Hand #203844275547:  Hold'em No Limit ($0.02/$0.05 USD) - 2019/09/20 20:05:11 ET
Table 'Anser' 6-max Seat #4 is the button
Seat 1: CMc172 ($2.57 in chips)
Seat 2: clovvnfiesta ($4.73 in chips)
Seat 3: seags21 ($4.12 in chips)
Seat 4: PlayTheBlues4U ($8.68 in chips)
CMc172: posts small blind $0.02
clovvnfiesta: posts big blind $0.05
*** HOLE CARDS ***
Dealt to PlayTheBlues4U [4h 2s]
seags21: folds
PlayTheBlues4U: folds
CMc172: calls $0.03
clovvnfiesta: raises $0.05 to $0.10
CMc172: raises $0.20 to $0.30
clovvnfiesta: calls $0.20
*** FLOP *** [9d Td Ac]
CMc172: checks
clovvnfiesta: checks
*** TURN *** [9d Td Ac] [2c]
CMc172: checks
clovvnfiesta: checks
*** RIVER *** [9d Td Ac 2c] [Jh]
CMc172: checks
clovvnfiesta: bets $0.29
CMc172: calls $0.29
*** SHOW DOWN ***
clovvnfiesta: shows [Js Qs] (a pair of Jacks)
CMc172: shows [Kd Ks] (a pair of Kings)
CMc172 collected $1.12 from pot
*** SUMMARY ***
Total pot $1.18 | Rake $0.06
Board [9d Td Ac 2c Jh]
Seat 1: CMc172 (small blind) showed [Kd Ks] and won ($1.12) with a pair of Kings
Seat 2: clovvnfiesta (big blind) showed [Js Qs] and lost with a pair of Jacks
Seat 3: seags21 folded before Flop (didn't bet)
Seat 4: PlayTheBlues4U (button) folded before Flop (didn't bet)


PokerStars Hand #203844275536:  Hold'em No Limit ($0.05/$0.10 USD) - 2019/09/20 20:05:05 ET
Table 'Lacerta' 6-max Seat #3 is the button
Seat 2: PlayTheBlues4U ($12.35 in chips)
Seat 3: RNixon'sHead ($14.85 in chips)
Seat 4: EddieMoney9 ($11.03 in chips)
Seat 5: pairofdz ($11.25 in chips)
Seat 6: JDM0226 ($7.30 in chips)
EddieMoney9: posts small blind $0.05
pairofdz: posts big blind $0.10
clovvnfiesta: sits out
*** HOLE CARDS ***
Dealt to PlayTheBlues4U [5h 8h]
JDM0226: folds
PlayTheBlues4U: raises $0.20 to $0.30
RNixon'sHead: folds
EddieMoney9 has timed out
EddieMoney9: folds
pairofdz: raises $0.80 to $1.10
PlayTheBlues4U: calls $0.80
*** FLOP *** [3c 6c 2d]
pairofdz: bets $0.70
clovvnfiesta leaves the table
PlayTheBlues4U: calls $0.70
*** TURN *** [3c 6c 2d] [2c]
pairofdz: checks
PlayTheBlues4U: bets $1.90
pairofdz: folds
Uncalled bet ($1.90) returned to PlayTheBlues4U
PlayTheBlues4U collected $3.47 from pot
PlayTheBlues4U: doesn't show hand
*** SUMMARY ***
Total pot $3.65 | Rake $0.18
Board [3c 6c 2d 2c]
Seat 2: PlayTheBlues4U collected ($3.47)
Seat 3: RNixon'sHead (button) folded before Flop (didn't bet)
Seat 4: EddieMoney9 (small blind) folded before Flop
Seat 5: pairofdz (big blind) folded on the Turn
Seat 6: JDM0226 folded before Flop (didn't bet)


PokerStars Hand #203844275447:  Hold'em No Limit ($0.05/$0.10 USD) - 2019/09/20 20:04:31 ET
Table 'Lacerta' 6-max Seat #2 is the button
Seat 2: PlayTheBlues4U ($11.94 in chips)
Seat 3: RNixon'sHead ($14.90 in chips)
Seat 4: EddieMoney9 ($11.13 in chips)
Seat 5: pairofdz ($11.55 in chips)
Seat 6: JDM0226 ($7.30 in chips)
RNixon'sHead: posts small blind $0.05
EddieMoney9: posts big blind $0.10
*** HOLE CARDS ***
Dealt to PlayTheBlues4U [3d 5d]
pairofdz: calls $0.10
JDM0226: folds
PlayTheBlues4U: raises $0.20 to $0.30
RNixon'sHead: folds
EddieMoney9: folds
clovvnfiesta joins the table at seat #1
pairofdz: calls $0.20
*** FLOP *** [Qc 7s Js]
pairofdz: checks
PlayTheBlues4U: bets $0.40
pairofdz: folds
Uncalled bet ($0.40) returned to PlayTheBlues4U
PlayTheBlues4U collected $0.71 from pot
PlayTheBlues4U: doesn't show hand
*** SUMMARY ***
Total pot $0.75 | Rake $0.04
Board [Qc 7s Js]
Seat 2: PlayTheBlues4U (button) collected ($0.71)
Seat 3: RNixon'sHead (small blind) folded before Flop
Seat 4: EddieMoney9 (big blind) folded before Flop
Seat 5: pairofdz folded on the Flop
Seat 6: JDM0226 folded before Flop (didn't bet)


PokerStars Hand #203844275284:  Hold'em No Limit ($0.02/$0.05 USD) - 2019/09/20 20:03:27 ET
Table 'Anser' 6-max Seat #3 is the button
Seat 1: CMc172 ($2.48 in chips)
Seat 2: clovvnfiesta ($4.73 in chips)
Seat 3: seags21 ($4.12 in chips)
Seat 4: PlayTheBlues4U ($8.73 in chips)
Seat 5: MozenMo ($4.37 in chips)
PlayTheBlues4U: posts small blind $0.02
MozenMo: posts big blind $0.05
*** HOLE CARDS ***
Dealt to PlayTheBlues4U [8s Kc]
CMc172: calls $0.05
clovvnfiesta: folds
seags21: folds
PlayTheBlues4U: calls $0.03
MozenMo: checks
*** FLOP *** [7s Ac 5d]
PlayTheBlues4U: checks
MozenMo: checks
CMc172: checks
*** TURN *** [7s Ac 5d] [7c]
PlayTheBlues4U: checks
MozenMo: checks
CMc172: checks
*** RIVER *** [7s Ac 5d 7c] [Td]
PlayTheBlues4U: checks
MozenMo: checks
CMc172: bets $0.05
PlayTheBlues4U: folds
MozenMo: folds
Uncalled bet ($0.05) returned to CMc172
CMc172 collected $0.14 from pot
CMc172: doesn't show hand
*** SUMMARY ***
Total pot $0.15 | Rake $0.01
Board [7s Ac 5d 7c Td]
Seat 1: CMc172 collected ($0.14)
Seat 2: clovvnfiesta folded before Flop (didn't bet)
Seat 3: seags21 (button) folded before Flop (didn't bet)
Seat 4: PlayTheBlues4U (small blind) folded on the River
Seat 5: MozenMo (big blind) folded on the River


PokerStars Hand #203844275274:  Hold'em No Limit ($0.05/$0.10 USD) - 2019/09/20 20:03:24 ET
Table 'Lacerta' 6-max Seat #6 is the button
Seat 2: PlayTheBlues4U ($11.99 in chips)
Seat 3: RNixon'sHead ($13.67 in chips)
Seat 4: EddieMoney9 ($11.13 in chips)
Seat 5: pairofdz ($12.65 in chips)
Seat 6: JDM0226 ($7.50 in chips)
PlayTheBlues4U: posts small blind $0.05
RNixon'sHead: posts big blind $0.10
*** HOLE CARDS ***
Dealt to PlayTheBlues4U [Kd 4h]
EddieMoney9: folds
pairofdz: raises $0.10 to $0.20
JDM0226: calls $0.20
PlayTheBlues4U: folds
RNixon'sHead: calls $0.10
*** FLOP *** [Kc 8s 5c]
RNixon'sHead: checks
pairofdz: bets $0.30
JDM0226: folds
RNixon'sHead: calls $0.30
*** TURN *** [Kc 8s 5c] [2d]
RNixon'sHead: checks
pairofdz: bets $0.60
RNixon'sHead: calls $0.60
*** RIVER *** [Kc 8s 5c 2d] [Tc]
RNixon'sHead: bets $1.43
pairofdz: folds
Uncalled bet ($1.43) returned to RNixon'sHead
RNixon'sHead collected $2.33 from pot
RNixon'sHead: doesn't show hand
*** SUMMARY ***
Total pot $2.45 | Rake $0.12
Board [Kc 8s 5c 2d Tc]
Seat 2: PlayTheBlues4U (small blind) folded before Flop
Seat 3: RNixon'sHead (big blind) collected ($2.33)
Seat 4: EddieMoney9 folded before Flop (didn't bet)
Seat 5: pairofdz folded on the River
Seat 6: JDM0226 (button) folded on the Flop


PokerStars Hand #203844275216:  Hold'em No Limit ($0.05/$0.10 USD) - 2019/09/20 20:03:05 ET
Table 'Lacerta' 6-max Seat #5 is the button
Seat 2: PlayTheBlues4U ($12.09 in chips)
Seat 3: RNixon'sHead ($13.52 in chips)
Seat 4: EddieMoney9 ($11.13 in chips)
Seat 5: pairofdz ($12.65 in chips)
Seat 6: JDM0226 ($7.55 in chips)
JDM0226: posts small blind $0.05
PlayTheBlues4U: posts big blind $0.10
*** HOLE CARDS ***
Dealt to PlayTheBlues4U [6d Qd]
RNixon'sHead: raises $0.15 to $0.25
EddieMoney9: folds
pairofdz: folds
JDM0226: folds
PlayTheBlues4U: folds
Uncalled bet ($0.15) returned to RNixon'sHead
RNixon'sHead collected $0.25 from pot
turk1120 was removed from the table for failing to post
turk1120 leaves the table
RNixon'sHead: doesn't show hand
*** SUMMARY ***
Total pot $0.25 | Rake $0
Seat 2: PlayTheBlues4U (big blind) folded before Flop
Seat 3: RNixon'sHead collected ($0.25)
Seat 4: EddieMoney9 folded before Flop (didn't bet)
Seat 5: pairofdz (button) folded before Flop (didn't bet)
Seat 6: JDM0226 (small blind) folded before Flop


PokerStars Hand #203844275169:  Hold'em No Limit ($0.02/$0.05 USD) - 2019/09/20 20:02:49 ET
Table 'Anser' 6-max Seat #2 is the button
Seat 1: CMc172 ($2.48 in chips)
Seat 2: clovvnfiesta ($4.88 in chips)
Seat 3: seags21 ($4.14 in chips)
Seat 4: PlayTheBlues4U ($8.88 in chips)
Seat 5: MozenMo ($4.07 in chips)
seags21: posts small blind $0.02
PlayTheBlues4U: posts big blind $0.05
*** HOLE CARDS ***
Dealt to PlayTheBlues4U [3s 5h]
MozenMo: raises $0.10 to $0.15
CMc172: folds
clovvnfiesta: calls $0.15
seags21: folds
PlayTheBlues4U: calls $0.10
*** FLOP *** [Qh 5c Td]
PlayTheBlues4U: checks
MozenMo: bets $0.25
clovvnfiesta: folds
PlayTheBlues4U: folds
Uncalled bet ($0.25) returned to MozenMo
MozenMo collected $0.45 from pot
MozenMo: doesn't show hand
*** SUMMARY ***
Total pot $0.47 | Rake $0.02
Board [Qh 5c Td]
Seat 1: CMc172 folded before Flop (didn't bet)
Seat 2: clovvnfiesta (button) folded on the Flop
Seat 3: seags21 (small blind) folded before Flop
Seat 4: PlayTheBlues4U (big blind) folded on the Flop
Seat 5: MozenMo collected ($0.45)


PokerStars Hand #203844275098:  Hold'em No Limit ($0.05/$0.10 USD) - 2019/09/20 20:02:18 ET
Table 'Lacerta' 6-max Seat #4 is the button
Seat 2: PlayTheBlues4U ($12.09 in chips)
Seat 3: RNixon'sHead ($13.77 in chips)
Seat 4: EddieMoney9 ($11.38 in chips)
Seat 5: pairofdz ($12.09 in chips)
Seat 6: JDM0226 ($7.65 in chips)
pairofdz: posts small blind $0.05
JDM0226: posts big blind $0.10
*** HOLE CARDS ***
Dealt to PlayTheBlues4U [5h 2c]
PlayTheBlues4U: folds
RNixon'sHead: raises $0.15 to $0.25
EddieMoney9: calls $0.25
pairofdz: calls $0.20
JDM0226: folds
*** FLOP *** [3h Tc Td]
pairofdz: checks
RNixon'sHead: checks
EddieMoney9: checks
*** TURN *** [3h Tc Td] [4d]
pairofdz: bets $0.40
RNixon'sHead: folds
EddieMoney9: folds
Uncalled bet ($0.40) returned to pairofdz
pairofdz collected $0.81 from pot
pairofdz: doesn't show hand
*** SUMMARY ***
Total pot $0.85 | Rake $0.04
Board [3h Tc Td 4d]
Seat 2: PlayTheBlues4U folded before Flop (didn't bet)
Seat 3: RNixon'sHead folded on the Turn
Seat 4: EddieMoney9 (button) folded on the Turn
Seat 5: pairofdz (small blind) collected ($0.81)
Seat 6: JDM0226 (big blind) folded before Flop


PokerStars Hand #203844275050:  Hold'em No Limit ($0.05/$0.10 USD) - 2019/09/20 20:01:58 ET
Table 'Lacerta' 6-max Seat #3 is the button
Seat 2: PlayTheBlues4U ($12.09 in chips)
Seat 3: RNixon'sHead ($13.77 in chips)
Seat 4: EddieMoney9 ($11.43 in chips)
Seat 5: pairofdz ($12.04 in chips)
Seat 6: JDM0226 ($7.65 in chips)
EddieMoney9: posts small blind $0.05
pairofdz: posts big blind $0.10
*** HOLE CARDS ***
Dealt to PlayTheBlues4U [5c 3h]
JDM0226: folds
PlayTheBlues4U: folds
RNixon'sHead: folds
EddieMoney9: folds
Uncalled bet ($0.05) returned to pairofdz
pairofdz collected $0.10 from pot
pairofdz: doesn't show hand
*** SUMMARY ***
Total pot $0.10 | Rake $0
Seat 2: PlayTheBlues4U folded before Flop (didn't bet)
Seat 3: RNixon'sHead (button) folded before Flop (didn't bet)
Seat 4: EddieMoney9 (small blind) folded before Flop
Seat 5: pairofdz (big blind) collected ($0.10)
Seat 6: JDM0226 folded before Flop (didn't bet)


PokerStars Hand #203844275000:  Hold'em No Limit ($0.02/$0.05 USD) - 2019/09/20 20:01:38 ET
Table 'Anser' 6-max Seat #1 is the button
Seat 1: CMc172 ($2.53 in chips)
Seat 2: clovvnfiesta ($4.90 in chips)
Seat 3: seags21 ($4.03 in chips)
Seat 4: PlayTheBlues4U ($8.88 in chips)
Seat 5: MozenMo ($4.12 in chips)
clovvnfiesta: posts small blind $0.02
seags21: posts big blind $0.05
*** HOLE CARDS ***
Dealt to PlayTheBlues4U [Kh 8h]
PlayTheBlues4U: folds
MozenMo: calls $0.05
CMc172: calls $0.05
clovvnfiesta: folds
seags21: checks
*** FLOP *** [As 6c 5c]
seags21: checks
MozenMo: checks
CMc172: checks
*** TURN *** [As 6c 5c] [Tc]
seags21: checks
MozenMo: checks
CMc172: checks
*** RIVER *** [As 6c 5c Tc] [Ad]
seags21: bets $0.06
MozenMo: folds
CMc172: folds
Uncalled bet ($0.06) returned to seags21
seags21 collected $0.16 from pot
seags21: doesn't show hand
*** SUMMARY ***
Total pot $0.17 | Rake $0.01
Board [As 6c 5c Tc Ad]
Seat 1: CMc172 (button) folded on the River
Seat 2: clovvnfiesta (small blind) folded before Flop
Seat 3: seags21 (big blind) collected ($0.16)
Seat 4: PlayTheBlues4U folded before Flop (didn't bet)
Seat 5: MozenMo folded on the River


PokerStars Hand #203844274976:  Hold'em No Limit ($0.02/$0.05 USD) - 2019/09/20 20:01:25 ET
Table 'Anser' 6-max Seat #5 is the button
Seat 1: CMc172 ($2.55 in chips)
Seat 2: clovvnfiesta ($4.95 in chips)
Seat 4: PlayTheBlues4U ($8.81 in chips)
Seat 5: MozenMo ($4.12 in chips)
CMc172: posts small blind $0.02
clovvnfiesta: posts big blind $0.05
seags21: sits out
*** HOLE CARDS ***
Dealt to PlayTheBlues4U [Ad 3d]
PlayTheBlues4U: raises $0.10 to $0.15
MozenMo: folds
CMc172: folds
clovvnfiesta: folds
Uncalled bet ($0.10) returned to PlayTheBlues4U
PlayTheBlues4U collected $0.12 from pot
PlayTheBlues4U: doesn't show hand
*** SUMMARY ***
Total pot $0.12 | Rake $0
Seat 1: CMc172 (small blind) folded before Flop
Seat 2: clovvnfiesta (big blind) folded before Flop
Seat 4: PlayTheBlues4U collected ($0.12)
Seat 5: MozenMo (button) folded before Flop (didn't bet)


PokerStars Hand #203844274900:  Hold'em No Limit ($0.05/$0.10 USD) - 2019/09/20 20:00:54 ET
Table 'Lacerta' 6-max Seat #2 is the button
Seat 2: PlayTheBlues4U ($12.09 in chips)
Seat 3: RNixon'sHead ($13.82 in chips)
Seat 4: EddieMoney9 ($12.33 in chips)
Seat 5: pairofdz ($11.18 in chips)
Seat 6: JDM0226 ($7.65 in chips)
RNixon'sHead: posts small blind $0.05
EddieMoney9: posts big blind $0.10
*** HOLE CARDS ***
Dealt to PlayTheBlues4U [5h 7s]
pairofdz: raises $0.10 to $0.20
JDM0226: folds
PlayTheBlues4U: folds
RNixon'sHead: folds
EddieMoney9: raises $0.10 to $0.30
pairofdz: raises $0.60 to $0.90
EddieMoney9: calls $0.60
*** FLOP *** [5s Qs 6d]
EddieMoney9: checks
pairofdz: bets $0.80
EddieMoney9: folds
Uncalled bet ($0.80) returned to pairofdz
pairofdz collected $1.76 from pot
pairofdz: doesn't show hand
*** SUMMARY ***
Total pot $1.85 | Rake $0.09
Board [5s Qs 6d]
Seat 2: PlayTheBlues4U (button) folded before Flop (didn't bet)
Seat 3: RNixon'sHead (small blind) folded before Flop
Seat 4: EddieMoney9 (big blind) folded on the Flop
Seat 5: pairofdz collected ($1.76)
Seat 6: JDM0226 folded before Flop (didn't bet)


PokerStars Hand #203844274820:  Hold'em No Limit ($0.05/$0.10 USD) - 2019/09/20 20:00:14 ET
Table 'Lacerta' 6-max Seat #6 is the button
Seat 2: PlayTheBlues4U ($11.91 in chips)
Seat 3: RNixon'sHead ($13.92 in chips)
Seat 4: EddieMoney9 ($12.33 in chips)
Seat 5: pairofdz ($11.28 in chips)
Seat 6: JDM0226 ($7.65 in chips)
PlayTheBlues4U: posts small blind $0.05
RNixon'sHead: posts big blind $0.10
*** HOLE CARDS ***
Dealt to PlayTheBlues4U [Kd 9d]
EddieMoney9: folds
pairofdz: calls $0.10
JDM0226: folds
PlayTheBlues4U: calls $0.05
RNixon'sHead: checks
*** FLOP *** [5d Ks 7c]
PlayTheBlues4U: checks
RNixon'sHead: checks
pairofdz: checks
*** TURN *** [5d Ks 7c] [Qd]
PlayTheBlues4U: bets $0.20
RNixon'sHead: folds
pairofdz: folds
Uncalled bet ($0.20) returned to PlayTheBlues4U
PlayTheBlues4U collected $0.28 from pot
PlayTheBlues4U: doesn't show hand
*** SUMMARY ***
Total pot $0.30 | Rake $0.02
Board [5d Ks 7c Qd]
Seat 2: PlayTheBlues4U (small blind) collected ($0.28)
Seat 3: RNixon'sHead (big blind) folded on the Turn
Seat 4: EddieMoney9 folded before Flop (didn't bet)
Seat 5: pairofdz folded on the Turn
Seat 6: JDM0226 (button) folded before Flop (didn't bet)


PokerStars Hand #203844274807:  Hold'em No Limit ($0.02/$0.05 USD) - 2019/09/20 20:00:10 ET
Table 'Anser' 6-max Seat #4 is the button
Seat 1: CMc172 ($2.46 in chips)
Seat 2: clovvnfiesta ($5 in chips)
Seat 4: PlayTheBlues4U ($8.81 in chips)
Seat 5: MozenMo ($4.17 in chips)
MozenMo: posts small blind $0.02
CMc172: posts big blind $0.05
clovvnfiesta: posts big blind $0.05
*** HOLE CARDS ***
Dealt to PlayTheBlues4U [4s 5h]
clovvnfiesta: checks
PlayTheBlues4U: folds
MozenMo: calls $0.03
CMc172: checks
*** FLOP *** [9c 6d Ts]
MozenMo: checks
CMc172: checks
clovvnfiesta: checks
*** TURN *** [9c 6d Ts] [2s]
MozenMo: checks
CMc172: checks
clovvnfiesta: checks
*** RIVER *** [9c 6d Ts 2s] [Qc]
MozenMo: checks
CMc172: checks
clovvnfiesta: checks
*** SHOW DOWN ***
MozenMo: shows [4h 2d] (a pair of Deuces)
CMc172: shows [Ac 9h] (a pair of Nines)
clovvnfiesta: mucks hand
CMc172 collected $0.14 from pot
*** SUMMARY ***
Total pot $0.15 | Rake $0.01
Board [9c 6d Ts 2s Qc]
Seat 1: CMc172 (big blind) showed [Ac 9h] and won ($0.14) with a pair of Nines
Seat 2: clovvnfiesta mucked [8s 5c]
Seat 4: PlayTheBlues4U (button) folded before Flop (didn't bet)
Seat 5: MozenMo (small blind) showed [4h 2d] and lost with a pair of Deuces


PokerStars Hand #203844274798:  Hold'em No Limit ($0.05/$0.10 USD) - 2019/09/20 20:00:03 ET
Table 'Lacerta' 6-max Seat #5 is the button
Seat 2: PlayTheBlues4U ($11.86 in chips)
Seat 3: RNixon'sHead ($13.92 in chips)
Seat 4: EddieMoney9 ($12.33 in chips)
Seat 5: pairofdz ($11.28 in chips)
Seat 6: JDM0226 ($7.70 in chips)
JDM0226: posts small blind $0.05
PlayTheBlues4U: posts big blind $0.10
*** HOLE CARDS ***
Dealt to PlayTheBlues4U [5c 8d]
RNixon'sHead: folds
EddieMoney9: folds
pairofdz: folds
JDM0226: folds
Uncalled bet ($0.05) returned to PlayTheBlues4U
PlayTheBlues4U collected $0.10 from pot
PlayTheBlues4U: doesn't show hand
*** SUMMARY ***
Total pot $0.10 | Rake $0
Seat 2: PlayTheBlues4U (big blind) collected ($0.10)
Seat 3: RNixon'sHead folded before Flop (didn't bet)
Seat 4: EddieMoney9 folded before Flop (didn't bet)
Seat 5: pairofdz (button) folded before Flop (didn't bet)
Seat 6: JDM0226 (small blind) folded before Flop


PokerStars Hand #203844274766:  Hold'em No Limit ($0.05/$0.10 USD) - 2019/09/20 19:59:42 ET
Table 'Lacerta' 6-max Seat #4 is the button
Seat 2: PlayTheBlues4U ($11.86 in chips)
Seat 3: RNixon'sHead ($13.92 in chips)
Seat 4: EddieMoney9 ($12.18 in chips)
Seat 5: pairofdz ($11.33 in chips)
Seat 6: JDM0226 ($7.80 in chips)
pairofdz: posts small blind $0.05
JDM0226: posts big blind $0.10
*** HOLE CARDS ***
Dealt to PlayTheBlues4U [Qh 6h]
PlayTheBlues4U: folds
RNixon'sHead: folds
EddieMoney9: raises $0.20 to $0.30
pairofdz: folds
JDM0226: folds
Uncalled bet ($0.20) returned to EddieMoney9
EddieMoney9 collected $0.25 from pot
EddieMoney9: doesn't show hand
*** SUMMARY ***
Total pot $0.25 | Rake $0
Seat 2: PlayTheBlues4U folded before Flop (didn't bet)
Seat 3: RNixon'sHead folded before Flop (didn't bet)
Seat 4: EddieMoney9 (button) collected ($0.25)
Seat 5: pairofdz (small blind) folded before Flop
Seat 6: JDM0226 (big blind) folded before Flop


PokerStars Hand #203844274724:  Hold'em No Limit ($0.02/$0.05 USD) - 2019/09/20 19:59:17 ET
Table 'Anser' 6-max Seat #1 is the button
Seat 1: CMc172 ($2.66 in chips)
Seat 4: PlayTheBlues4U ($8.83 in chips)
Seat 5: MozenMo ($3.97 in chips)
clovvnfiesta will be allowed to play after the button
PlayTheBlues4U: posts small blind $0.02
MozenMo: posts big blind $0.05
*** HOLE CARDS ***
Dealt to PlayTheBlues4U [6d Ts]
CMc172: calls $0.05
PlayTheBlues4U: folds
MozenMo: raises $0.05 to $0.10
CMc172: calls $0.05
*** FLOP *** [7c 2h 8s]
MozenMo: bets $0.10
CMc172: calls $0.10
*** TURN *** [7c 2h 8s] [7s]
MozenMo: bets $0.20
CMc172: folds
Uncalled bet ($0.20) returned to MozenMo
MozenMo collected $0.40 from pot
MozenMo: doesn't show hand
*** SUMMARY ***
Total pot $0.42 | Rake $0.02
Board [7c 2h 8s 7s]
Seat 1: CMc172 (button) folded on the Turn
Seat 4: PlayTheBlues4U (small blind) folded before Flop
Seat 5: MozenMo (big blind) collected ($0.40)


PokerStars Hand #203844274692:  Hold'em No Limit ($0.05/$0.10 USD) - 2019/09/20 19:58:59 ET
Table 'Lacerta' 6-max Seat #3 is the button
Seat 2: PlayTheBlues4U ($11.86 in chips)
Seat 3: RNixon'sHead ($13.92 in chips)
Seat 4: EddieMoney9 ($12.09 in chips)
Seat 5: pairofdz ($11.43 in chips)
Seat 6: JDM0226 ($7.80 in chips)
EddieMoney9: posts small blind $0.05
pairofdz: posts big blind $0.10
*** HOLE CARDS ***
Dealt to PlayTheBlues4U [Qd 3c]
JDM0226: folds
PlayTheBlues4U: folds
RNixon'sHead: folds
EddieMoney9: calls $0.05
pairofdz: checks
*** FLOP *** [7d 6c 8s]
EddieMoney9: checks
pairofdz: checks
*** TURN *** [7d 6c 8s] [6h]
EddieMoney9: checks
pairofdz: checks
*** RIVER *** [7d 6c 8s 6h] [5d]
EddieMoney9: checks
pairofdz: checks
*** SHOW DOWN ***
EddieMoney9: shows [Kc Th] (a pair of Sixes)
pairofdz: mucks hand
EddieMoney9 collected $0.19 from pot
*** SUMMARY ***
Total pot $0.20 | Rake $0.01
Board [7d 6c 8s 6h 5d]
Seat 2: PlayTheBlues4U folded before Flop (didn't bet)
Seat 3: RNixon'sHead (button) folded before Flop (didn't bet)
Seat 4: EddieMoney9 (small blind) showed [Kc Th] and won ($0.19) with a pair of Sixes
Seat 5: pairofdz (big blind) mucked [Kd 3h]
Seat 6: JDM0226 folded before Flop (didn't bet)


PokerStars Hand #203844274665:  Hold'em No Limit ($0.05/$0.10 USD) - 2019/09/20 19:58:46 ET
Table 'Lacerta' 6-max Seat #2 is the button
Seat 2: PlayTheBlues4U ($11.86 in chips)
Seat 3: RNixon'sHead ($13.97 in chips)
Seat 4: EddieMoney9 ($12.04 in chips)
Seat 5: pairofdz ($11.43 in chips)
Seat 6: JDM0226 ($7.80 in chips)
RNixon'sHead: posts small blind $0.05
EddieMoney9: posts big blind $0.10
*** HOLE CARDS ***
Dealt to PlayTheBlues4U [3c 2s]
pairofdz: folds
JDM0226: folds
PlayTheBlues4U: folds
RNixon'sHead: folds
Uncalled bet ($0.05) returned to EddieMoney9
EddieMoney9 collected $0.10 from pot
EddieMoney9: doesn't show hand
*** SUMMARY ***
Total pot $0.10 | Rake $0
Seat 2: PlayTheBlues4U (button) folded before Flop (didn't bet)
Seat 3: RNixon'sHead (small blind) folded before Flop
Seat 4: EddieMoney9 (big blind) collected ($0.10)
Seat 5: pairofdz folded before Flop (didn't bet)
Seat 6: JDM0226 folded before Flop (didn't bet)


PokerStars Hand #203844274631:  Hold'em No Limit ($0.02/$0.05 USD) - 2019/09/20 19:58:29 ET
Table 'Anser' 6-max Seat #5 is the button
Seat 1: CMc172 ($2.81 in chips)
Seat 3: seags21 ($4.03 in chips)
Seat 4: PlayTheBlues4U ($8.53 in chips)
Seat 5: MozenMo ($4.12 in chips)
Seat 6: DemolishIT ($6.21 in chips)
DemolishIT: posts small blind $0.02
CMc172: posts big blind $0.05
clovvnfiesta: sits out
*** HOLE CARDS ***
Dealt to PlayTheBlues4U [2c Ac]
seags21 has timed out
seags21: folds
PlayTheBlues4U: raises $0.10 to $0.15
MozenMo: calls $0.15
DemolishIT: folds
CMc172: calls $0.10
*** FLOP *** [2h Ah Qh]
CMc172: checks
PlayTheBlues4U: bets $0.45
MozenMo: folds
CMc172: folds
Uncalled bet ($0.45) returned to PlayTheBlues4U
PlayTheBlues4U collected $0.45 from pot
PlayTheBlues4U: doesn't show hand
*** SUMMARY ***
Total pot $0.47 | Rake $0.02
Board [2h Ah Qh]
Seat 1: CMc172 (big blind) folded on the Flop
Seat 3: seags21 folded before Flop (didn't bet)
Seat 4: PlayTheBlues4U collected ($0.45)
Seat 5: MozenMo (button) folded on the Flop
Seat 6: DemolishIT (small blind) folded before Flop


PokerStars Hand #203844274571:  Hold'em No Limit ($0.05/$0.10 USD) - 2019/09/20 19:57:58 ET
Table 'Lacerta' 6-max Seat #6 is the button
Seat 2: PlayTheBlues4U ($11.77 in chips)
Seat 3: RNixon'sHead ($14.07 in chips)
Seat 4: EddieMoney9 ($12.04 in chips)
Seat 5: pairofdz ($11.43 in chips)
Seat 6: JDM0226 ($7.80 in chips)
PlayTheBlues4U: posts small blind $0.05
RNixon'sHead: posts big blind $0.10
*** HOLE CARDS ***
Dealt to PlayTheBlues4U [Th 9h]
EddieMoney9: folds
pairofdz: folds
JDM0226: folds
PlayTheBlues4U: calls $0.05
RNixon'sHead: checks
*** FLOP *** [6s Qh 3d]
PlayTheBlues4U: checks
RNixon'sHead: checks
*** TURN *** [6s Qh 3d] [Jc]
PlayTheBlues4U: bets $0.10
RNixon'sHead: folds
Uncalled bet ($0.10) returned to PlayTheBlues4U
PlayTheBlues4U collected $0.19 from pot
PlayTheBlues4U: doesn't show hand
*** SUMMARY ***
Total pot $0.20 | Rake $0.01
Board [6s Qh 3d Jc]
Seat 2: PlayTheBlues4U (small blind) collected ($0.19)
Seat 3: RNixon'sHead (big blind) folded on the Turn
Seat 4: EddieMoney9 folded before Flop (didn't bet)
Seat 5: pairofdz folded before Flop (didn't bet)
Seat 6: JDM0226 (button) folded before Flop (didn't bet)


PokerStars Hand #203844274542:  Hold'em No Limit ($0.02/$0.05 USD) - 2019/09/20 19:57:39 ET
Table 'Anser' 6-max Seat #4 is the button
Seat 1: CMc172 ($2.81 in chips)
Seat 3: seags21 ($4.03 in chips)
Seat 4: PlayTheBlues4U ($8.24 in chips)
Seat 5: MozenMo ($4.14 in chips)
Seat 6: DemolishIT ($6.51 in chips)
MozenMo: posts small blind $0.02
DemolishIT: posts big blind $0.05
clovvnfiesta: sits out
*** HOLE CARDS ***
Dealt to PlayTheBlues4U [Js 8s]
CMc172: folds
seags21: folds
PlayTheBlues4U: raises $0.10 to $0.15
MozenMo: folds
DemolishIT: calls $0.10
*** FLOP *** [Ts As 8c]
DemolishIT: checks
PlayTheBlues4U: bets $0.15
DemolishIT: calls $0.15
*** TURN *** [Ts As 8c] [3s]
DemolishIT: checks
PlayTheBlues4U: bets $0.45
DemolishIT: folds
Uncalled bet ($0.45) returned to PlayTheBlues4U
PlayTheBlues4U collected $0.59 from pot
PlayTheBlues4U: doesn't show hand
*** SUMMARY ***
Total pot $0.62 | Rake $0.03
Board [Ts As 8c 3s]
Seat 1: CMc172 folded before Flop (didn't bet)
Seat 3: seags21 folded before Flop (didn't bet)
Seat 4: PlayTheBlues4U (button) collected ($0.59)
Seat 5: MozenMo (small blind) folded before Flop
Seat 6: DemolishIT (big blind) folded on the Turn


PokerStars Hand #203844274533:  Hold'em No Limit ($0.05/$0.10 USD) - 2019/09/20 19:57:33 ET
Table 'Lacerta' 6-max Seat #5 is the button
Seat 2: PlayTheBlues4U ($11.87 in chips)
Seat 3: RNixon'sHead ($14.07 in chips)
Seat 4: EddieMoney9 ($11.89 in chips)
Seat 5: pairofdz ($11.43 in chips)
Seat 6: JDM0226 ($7.85 in chips)
JDM0226: posts small blind $0.05
PlayTheBlues4U: posts big blind $0.10
*** HOLE CARDS ***
Dealt to PlayTheBlues4U [6h Js]
RNixon'sHead: folds
EddieMoney9: raises $0.20 to $0.30
pairofdz: folds
JDM0226: folds
PlayTheBlues4U: folds
Uncalled bet ($0.20) returned to EddieMoney9
EddieMoney9 collected $0.25 from pot
EddieMoney9: doesn't show hand
*** SUMMARY ***
Total pot $0.25 | Rake $0
Seat 2: PlayTheBlues4U (big blind) folded before Flop
Seat 3: RNixon'sHead folded before Flop (didn't bet)
Seat 4: EddieMoney9 collected ($0.25)
Seat 5: pairofdz (button) folded before Flop (didn't bet)
Seat 6: JDM0226 (small blind) folded before Flop


PokerStars Hand #203844274492:  Hold'em No Limit ($0.05/$0.10 USD) - 2019/09/20 19:57:09 ET
Table 'Lacerta' 6-max Seat #4 is the button
Seat 2: PlayTheBlues4U ($11.87 in chips)
Seat 3: RNixon'sHead ($14.07 in chips)
Seat 4: EddieMoney9 ($11.89 in chips)
Seat 5: pairofdz ($11.25 in chips)
Seat 6: JDM0226 ($8.05 in chips)
pairofdz: posts small blind $0.05
JDM0226: posts big blind $0.10
*** HOLE CARDS ***
Dealt to PlayTheBlues4U [3d Td]
PlayTheBlues4U: folds
RNixon'sHead: folds
EddieMoney9: folds
pairofdz: raises $0.10 to $0.20
JDM0226: calls $0.10
*** FLOP *** [Jc Kd Tc]
pairofdz: bets $0.20
JDM0226: folds
Uncalled bet ($0.20) returned to pairofdz
pairofdz collected $0.38 from pot
pairofdz: doesn't show hand
*** SUMMARY ***
Total pot $0.40 | Rake $0.02
Board [Jc Kd Tc]
Seat 2: PlayTheBlues4U folded before Flop (didn't bet)
Seat 3: RNixon'sHead folded before Flop (didn't bet)
Seat 4: EddieMoney9 (button) folded before Flop (didn't bet)
Seat 5: pairofdz (small blind) collected ($0.38)
Seat 6: JDM0226 (big blind) folded on the Flop


PokerStars Hand #203844274441:  Hold'em No Limit ($0.05/$0.10 USD) - 2019/09/20 19:56:39 ET
Table 'Lacerta' 6-max Seat #3 is the button
Seat 2: PlayTheBlues4U ($11.87 in chips)
Seat 3: RNixon'sHead ($14.07 in chips)
Seat 4: EddieMoney9 ($11.99 in chips)
Seat 5: pairofdz ($11.16 in chips)
Seat 6: JDM0226 ($8.05 in chips)
EddieMoney9: posts small blind $0.05
pairofdz: posts big blind $0.10
*** HOLE CARDS ***
Dealt to PlayTheBlues4U [3d Ks]
JDM0226: folds
PlayTheBlues4U: folds
RNixon'sHead: folds
EddieMoney9: calls $0.05
pairofdz: checks
*** FLOP *** [Qh 7s Td]
EddieMoney9: checks
pairofdz: checks
*** TURN *** [Qh 7s Td] [Js]
EddieMoney9: checks
pairofdz: bets $0.10
EddieMoney9: folds
Uncalled bet ($0.10) returned to pairofdz
pairofdz collected $0.19 from pot
pairofdz: doesn't show hand
*** SUMMARY ***
Total pot $0.20 | Rake $0.01
Board [Qh 7s Td Js]
Seat 2: PlayTheBlues4U folded before Flop (didn't bet)
Seat 3: RNixon'sHead (button) folded before Flop (didn't bet)
Seat 4: EddieMoney9 (small blind) folded on the Turn
Seat 5: pairofdz (big blind) collected ($0.19)
Seat 6: JDM0226 folded before Flop (didn't bet)


PokerStars Hand #203844274430:  Hold'em No Limit ($0.02/$0.05 USD) - 2019/09/20 19:56:29 ET
Table 'Anser' 6-max Seat #3 is the button
Seat 1: CMc172 ($2.86 in chips)
Seat 3: seags21 ($4.03 in chips)
Seat 4: PlayTheBlues4U ($7.95 in chips)
Seat 5: MozenMo ($4.19 in chips)
Seat 6: DemolishIT ($6.73 in chips)
PlayTheBlues4U: posts small blind $0.02
MozenMo: posts big blind $0.05
DemolishIT: posts small & big blinds $0.07
clovvnfiesta: sits out
*** HOLE CARDS ***
Dealt to PlayTheBlues4U [8c Qd]
DemolishIT: checks
CMc172: calls $0.05
seags21: folds
PlayTheBlues4U: calls $0.03
MozenMo: checks
*** FLOP *** [Jh 6c Qs]
PlayTheBlues4U: checks
MozenMo: checks
DemolishIT: checks
CMc172: checks
*** TURN *** [Jh 6c Qs] [7d]
PlayTheBlues4U: bets $0.15
MozenMo: folds
DemolishIT: calls $0.15
CMc172: folds
*** RIVER *** [Jh 6c Qs 7d] [9s]
PlayTheBlues4U: checks
DemolishIT: checks
*** SHOW DOWN ***
PlayTheBlues4U: shows [8c Qd] (a pair of Queens)
DemolishIT: mucks hand
PlayTheBlues4U collected $0.49 from pot
*** SUMMARY ***
Total pot $0.52 | Rake $0.03
Board [Jh 6c Qs 7d 9s]
Seat 1: CMc172 folded on the Turn
Seat 3: seags21 (button) folded before Flop (didn't bet)
Seat 4: PlayTheBlues4U (small blind) showed [8c Qd] and won ($0.49) with a pair of Queens
Seat 5: MozenMo (big blind) folded on the Turn
Seat 6: DemolishIT mucked [Ks Js]


PokerStars Hand #203844274385:  Hold'em No Limit ($0.05/$0.10 USD) - 2019/09/20 19:56:05 ET
Table 'Lacerta' 6-max Seat #2 is the button
Seat 2: PlayTheBlues4U ($11.87 in chips)
Seat 3: RNixon'sHead ($14.37 in chips)
Seat 4: EddieMoney9 ($12.09 in chips)
Seat 5: pairofdz ($10.80 in chips)
Seat 6: JDM0226 ($8.05 in chips)
RNixon'sHead: posts small blind $0.05
EddieMoney9: posts big blind $0.10
*** HOLE CARDS ***
Dealt to PlayTheBlues4U [9c 2c]
pairofdz: raises $0.20 to $0.30
JDM0226: folds
PlayTheBlues4U: folds
RNixon'sHead: calls $0.25
EddieMoney9: folds
*** FLOP *** [Jd Qh Th]
RNixon'sHead: checks
pairofdz: bets $0.40
RNixon'sHead: folds
Uncalled bet ($0.40) returned to pairofdz
pairofdz collected $0.66 from pot
pairofdz: doesn't show hand
*** SUMMARY ***
Total pot $0.70 | Rake $0.04
Board [Jd Qh Th]
Seat 2: PlayTheBlues4U (button) folded before Flop (didn't bet)
Seat 3: RNixon'sHead (small blind) folded on the Flop
Seat 4: EddieMoney9 (big blind) folded before Flop
Seat 5: pairofdz collected ($0.66)
Seat 6: JDM0226 folded before Flop (didn't bet)


PokerStars Hand #203844274367:  Hold'em No Limit ($0.05/$0.10 USD) - 2019/09/20 19:55:52 ET
Table 'Lacerta' 6-max Seat #6 is the button
Seat 2: PlayTheBlues4U ($11.92 in chips)
Seat 3: RNixon'sHead ($14.47 in chips)
Seat 4: EddieMoney9 ($12.09 in chips)
Seat 5: pairofdz ($10.65 in chips)
Seat 6: JDM0226 ($8.05 in chips)
PlayTheBlues4U: posts small blind $0.05
RNixon'sHead: posts big blind $0.10
*** HOLE CARDS ***
Dealt to PlayTheBlues4U [3c Th]
EddieMoney9: folds
pairofdz: raises $0.10 to $0.20
JDM0226: folds
PlayTheBlues4U: folds
RNixon'sHead: folds
Uncalled bet ($0.10) returned to pairofdz
pairofdz collected $0.25 from pot
pairofdz: doesn't show hand
*** SUMMARY ***
Total pot $0.25 | Rake $0
Seat 2: PlayTheBlues4U (small blind) folded before Flop
Seat 3: RNixon'sHead (big blind) folded before Flop
Seat 4: EddieMoney9 folded before Flop (didn't bet)
Seat 5: pairofdz collected ($0.25)
Seat 6: JDM0226 (button) folded before Flop (didn't bet)


PokerStars Hand #203844274336:  Hold'em No Limit ($0.05/$0.10 USD) - 2019/09/20 19:55:34 ET
Table 'Lacerta' 6-max Seat #5 is the button
Seat 2: PlayTheBlues4U ($11.87 in chips)
Seat 3: RNixon'sHead ($14.47 in chips)
Seat 4: EddieMoney9 ($12.09 in chips)
Seat 5: pairofdz ($10.65 in chips)
Seat 6: JDM0226 ($8.10 in chips)
JDM0226: posts small blind $0.05
PlayTheBlues4U: posts big blind $0.10
*** HOLE CARDS ***
Dealt to PlayTheBlues4U [Jh 4d]
RNixon'sHead: folds
EddieMoney9: folds
pairofdz: folds
JDM0226: folds
Uncalled bet ($0.05) returned to PlayTheBlues4U
PlayTheBlues4U collected $0.10 from pot
PlayTheBlues4U: doesn't show hand
*** SUMMARY ***
Total pot $0.10 | Rake $0
Seat 2: PlayTheBlues4U (big blind) collected ($0.10)
Seat 3: RNixon'sHead folded before Flop (didn't bet)
Seat 4: EddieMoney9 folded before Flop (didn't bet)
Seat 5: pairofdz (button) folded before Flop (didn't bet)
Seat 6: JDM0226 (small blind) folded before Flop


PokerStars Hand #203844274279:  Hold'em No Limit ($0.02/$0.05 USD) - 2019/09/20 19:54:58 ET
Table 'Anser' 6-max Seat #1 is the button
Seat 1: CMc172 ($3.41 in chips)
Seat 3: seags21 ($4.05 in chips)
Seat 4: PlayTheBlues4U ($8.05 in chips)
Seat 5: MozenMo ($3.58 in chips)
seags21: posts small blind $0.02
PlayTheBlues4U: posts big blind $0.05
*** HOLE CARDS ***
Dealt to PlayTheBlues4U [4d 5d]
MozenMo: raises $0.05 to $0.10
CMc172: calls $0.10
UmmmYummy leaves the table
seags21: folds
PlayTheBlues4U: calls $0.05
*** FLOP *** [Jd Kc 7c]
clovvnfiesta joins the table at seat #2
PlayTheBlues4U: checks
MozenMo: bets $0.30
CMc172: calls $0.30
PlayTheBlues4U: folds
*** TURN *** [Jd Kc 7c] [2d]
MozenMo: checks
CMc172: bets $0.15
MozenMo: calls $0.15
*** RIVER *** [Jd Kc 7c 2d] [6c]
MozenMo: bets $1.15
CMc172: folds
Uncalled bet ($1.15) returned to MozenMo
MozenMo collected $1.16 from pot
MozenMo: doesn't show hand
*** SUMMARY ***
Total pot $1.22 | Rake $0.06
Board [Jd Kc 7c 2d 6c]
Seat 1: CMc172 (button) folded on the River
Seat 3: seags21 (small blind) folded before Flop
Seat 4: PlayTheBlues4U (big blind) folded on the Flop
Seat 5: MozenMo collected ($1.16)


PokerStars Hand #203844274260:  Hold'em No Limit ($0.05/$0.10 USD) - 2019/09/20 19:54:48 ET
Table 'Lacerta' 6-max Seat #4 is the button
Seat 2: PlayTheBlues4U ($11.87 in chips)
Seat 3: RNixon'sHead ($14.47 in chips)
Seat 4: EddieMoney9 ($11.77 in chips)
Seat 5: pairofdz ($10.70 in chips)
Seat 6: JDM0226 ($8.40 in chips)
pairofdz: posts small blind $0.05
JDM0226: posts big blind $0.10
*** HOLE CARDS ***
Dealt to PlayTheBlues4U [8h 3d]
PlayTheBlues4U: folds
RNixon'sHead: folds
EddieMoney9: raises $0.20 to $0.30
pairofdz: folds
JDM0226: calls $0.20
*** FLOP *** [Jh 5c 7d]
JDM0226: checks
EddieMoney9: checks
*** TURN *** [Jh 5c 7d] [Th]
JDM0226: checks
EddieMoney9: bets $0.25
JDM0226: folds
Uncalled bet ($0.25) returned to EddieMoney9
EddieMoney9 collected $0.62 from pot
EddieMoney9: doesn't show hand
*** SUMMARY ***
Total pot $0.65 | Rake $0.03
Board [Jh 5c 7d Th]
Seat 2: PlayTheBlues4U folded before Flop (didn't bet)
Seat 3: RNixon'sHead folded before Flop (didn't bet)
Seat 4: EddieMoney9 (button) collected ($0.62)
Seat 5: pairofdz (small blind) folded before Flop
Seat 6: JDM0226 (big blind) folded on the Turn


PokerStars Hand #203844274238:  Hold'em No Limit ($0.02/$0.05 USD) - 2019/09/20 19:54:40 ET
Table 'Anser' 6-max Seat #5 is the button
Seat 1: CMc172 ($3.58 in chips)
Seat 3: seags21 ($4.10 in chips)
Seat 4: PlayTheBlues4U ($8.05 in chips)
Seat 5: MozenMo ($3.38 in chips)
CMc172: posts small blind $0.02
seags21: posts big blind $0.05
*** HOLE CARDS ***
Dealt to PlayTheBlues4U [2s 4c]
PlayTheBlues4U: folds
MozenMo: raises $0.12 to $0.17
CMc172: calls $0.15
seags21: folds
*** FLOP *** [5s Js Ad]
CMc172: checks
MozenMo: bets $0.35
CMc172: folds
Uncalled bet ($0.35) returned to MozenMo
MozenMo collected $0.37 from pot
MozenMo: doesn't show hand
*** SUMMARY ***
Total pot $0.39 | Rake $0.02
Board [5s Js Ad]
Seat 1: CMc172 (small blind) folded on the Flop
Seat 3: seags21 (big blind) folded before Flop
Seat 4: PlayTheBlues4U folded before Flop (didn't bet)
Seat 5: MozenMo (button) collected ($0.37)


PokerStars Hand #203844274203:  Hold'em No Limit ($0.05/$0.10 USD) - 2019/09/20 19:54:22 ET
Table 'Lacerta' 6-max Seat #3 is the button
Seat 2: PlayTheBlues4U ($11.87 in chips)
Seat 3: RNixon'sHead ($14.47 in chips)
Seat 4: EddieMoney9 ($11.82 in chips)
Seat 5: pairofdz ($10.65 in chips)
Seat 6: JDM0226 ($8.40 in chips)
EddieMoney9: posts small blind $0.05
pairofdz: posts big blind $0.10
*** HOLE CARDS ***
Dealt to PlayTheBlues4U [Js 4d]
JDM0226: folds
PlayTheBlues4U: folds
RNixon'sHead: folds
EddieMoney9: folds
Uncalled bet ($0.05) returned to pairofdz
pairofdz collected $0.10 from pot
pairofdz: doesn't show hand
*** SUMMARY ***
Total pot $0.10 | Rake $0
Seat 2: PlayTheBlues4U folded before Flop (didn't bet)
Seat 3: RNixon'sHead (button) folded before Flop (didn't bet)
Seat 4: EddieMoney9 (small blind) folded before Flop
Seat 5: pairofdz (big blind) collected ($0.10)
Seat 6: JDM0226 folded before Flop (didn't bet)


PokerStars Hand #203844274176:  Hold'em No Limit ($0.05/$0.10 USD) - 2019/09/20 19:54:05 ET
Table 'Lacerta' 6-max Seat #2 is the button
Seat 2: PlayTheBlues4U ($11.87 in chips)
Seat 3: RNixon'sHead ($14.37 in chips)
Seat 4: EddieMoney9 ($11.92 in chips)
Seat 5: pairofdz ($10.65 in chips)
Seat 6: JDM0226 ($8.40 in chips)
RNixon'sHead: posts small blind $0.05
EddieMoney9: posts big blind $0.10
*** HOLE CARDS ***
Dealt to PlayTheBlues4U [5s 9c]
pairofdz: folds
JDM0226: folds
PlayTheBlues4U: folds
RNixon'sHead: raises $0.20 to $0.30
EddieMoney9: folds
Uncalled bet ($0.20) returned to RNixon'sHead
RNixon'sHead collected $0.20 from pot
RNixon'sHead: doesn't show hand
*** SUMMARY ***
Total pot $0.20 | Rake $0
Seat 2: PlayTheBlues4U (button) folded before Flop (didn't bet)
Seat 3: RNixon'sHead (small blind) collected ($0.20)
Seat 4: EddieMoney9 (big blind) folded before Flop
Seat 5: pairofdz folded before Flop (didn't bet)
Seat 6: JDM0226 folded before Flop (didn't bet)


PokerStars Hand #203844274155:  Hold'em No Limit ($0.05/$0.10 USD) - 2019/09/20 19:53:52 ET
Table 'Lacerta' 6-max Seat #6 is the button
Seat 2: PlayTheBlues4U ($11.92 in chips)
Seat 3: RNixon'sHead ($14.47 in chips)
Seat 5: pairofdz ($10.50 in chips)
Seat 6: JDM0226 ($8.40 in chips)
PlayTheBlues4U: posts small blind $0.05
RNixon'sHead: posts big blind $0.10
EddieMoney9: sits out
*** HOLE CARDS ***
Dealt to PlayTheBlues4U [9c 2h]
pairofdz: raises $0.10 to $0.20
JDM0226: folds
PlayTheBlues4U: folds
RNixon'sHead: folds
Uncalled bet ($0.10) returned to pairofdz
pairofdz collected $0.25 from pot
pairofdz: doesn't show hand
*** SUMMARY ***
Total pot $0.25 | Rake $0
Seat 2: PlayTheBlues4U (small blind) folded before Flop
Seat 3: RNixon'sHead (big blind) folded before Flop
Seat 5: pairofdz collected ($0.25)
Seat 6: JDM0226 (button) folded before Flop (didn't bet)


PokerStars Hand #203844274150:  Hold'em No Limit ($0.02/$0.05 USD) - 2019/09/20 19:53:51 ET
Table 'Anser' 6-max Seat #4 is the button
Seat 1: CMc172 ($3.38 in chips)
Seat 2: UmmmYummy ($4.78 in chips)
Seat 3: seags21 ($4.10 in chips)
Seat 4: PlayTheBlues4U ($8.25 in chips)
Seat 5: MozenMo ($3.40 in chips)
MozenMo: posts small blind $0.02
CMc172: posts big blind $0.05
*** HOLE CARDS ***
Dealt to PlayTheBlues4U [Jd 6d]
UmmmYummy: folds
seags21: folds
PlayTheBlues4U: raises $0.05 to $0.10
MozenMo: folds
CMc172: calls $0.05
*** FLOP *** [9d 5h Ks]
CMc172: checks
PlayTheBlues4U: bets $0.10
CMc172: calls $0.10
*** TURN *** [9d 5h Ks] [Qs]
CMc172: checks
PlayTheBlues4U: checks
*** RIVER *** [9d 5h Ks Qs] [Kd]
CMc172: checks
PlayTheBlues4U: checks
*** SHOW DOWN ***
CMc172: shows [8h Ah] (a pair of Kings)
PlayTheBlues4U: mucks hand
CMc172 collected $0.40 from pot
*** SUMMARY ***
Total pot $0.42 | Rake $0.02
Board [9d 5h Ks Qs Kd]
Seat 1: CMc172 (big blind) showed [8h Ah] and won ($0.40) with a pair of Kings
Seat 2: UmmmYummy folded before Flop (didn't bet)
Seat 3: seags21 folded before Flop (didn't bet)
Seat 4: PlayTheBlues4U (button) mucked [Jd 6d]
Seat 5: MozenMo (small blind) folded before Flop


PokerStars Hand #203844274113:  Hold'em No Limit ($0.05/$0.10 USD) - 2019/09/20 19:53:34 ET
Table 'Lacerta' 6-max Seat #5 is the button
Seat 2: PlayTheBlues4U ($12.02 in chips)
Seat 3: RNixon'sHead ($14.47 in chips)
Seat 5: pairofdz ($10.50 in chips)
Seat 6: JDM0226 ($8.31 in chips)
JDM0226: posts small blind $0.05
PlayTheBlues4U: posts big blind $0.10
EddieMoney9: sits out
*** HOLE CARDS ***
Dealt to PlayTheBlues4U [2s Jh]
RNixon'sHead: folds
pairofdz: folds
JDM0226: calls $0.05
PlayTheBlues4U: checks
*** FLOP *** [5h 3c 3d]
JDM0226: checks
PlayTheBlues4U: checks
*** TURN *** [5h 3c 3d] [6s]
JDM0226: checks
PlayTheBlues4U: checks
*** RIVER *** [5h 3c 3d 6s] [Qh]
JDM0226: bets $0.10
PlayTheBlues4U: folds
Uncalled bet ($0.10) returned to JDM0226
JDM0226 collected $0.19 from pot
JDM0226: doesn't show hand
*** SUMMARY ***
Total pot $0.20 | Rake $0.01
Board [5h 3c 3d 6s Qh]
Seat 2: PlayTheBlues4U (big blind) folded on the River
Seat 3: RNixon'sHead folded before Flop (didn't bet)
Seat 5: pairofdz (button) folded before Flop (didn't bet)
Seat 6: JDM0226 (small blind) collected ($0.19)


PokerStars Hand #203844274088:  Hold'em No Limit ($0.05/$0.10 USD) - 2019/09/20 19:53:20 ET
Table 'Lacerta' 6-max Seat #3 is the button
Seat 2: PlayTheBlues4U ($11.87 in chips)
Seat 3: RNixon'sHead ($14.47 in chips)
Seat 5: pairofdz ($10.55 in chips)
Seat 6: JDM0226 ($8.41 in chips)
EddieMoney9 will be allowed to play after the button
pairofdz: posts small blind $0.05
JDM0226: posts big blind $0.10
*** HOLE CARDS ***
Dealt to PlayTheBlues4U [9c Kh]
PlayTheBlues4U: raises $0.20 to $0.30
RNixon'sHead: folds
pairofdz: folds
JDM0226: folds
Uncalled bet ($0.20) returned to PlayTheBlues4U
PlayTheBlues4U collected $0.25 from pot
PlayTheBlues4U: doesn't show hand
*** SUMMARY ***
Total pot $0.25 | Rake $0
Seat 2: PlayTheBlues4U collected ($0.25)
Seat 3: RNixon'sHead (button) folded before Flop (didn't bet)
Seat 5: pairofdz (small blind) folded before Flop
Seat 6: JDM0226 (big blind) folded before Flop


PokerStars Hand #203844274060:  Hold'em No Limit ($0.05/$0.10 USD) - 2019/09/20 19:53:07 ET
Table 'Lacerta' 6-max Seat #2 is the button
Seat 2: PlayTheBlues4U ($11.87 in chips)
Seat 3: RNixon'sHead ($14.52 in chips)
Seat 5: pairofdz ($10.50 in chips)
Seat 6: JDM0226 ($8.41 in chips)
RNixon'sHead: posts small blind $0.05
pairofdz: posts big blind $0.10
*** HOLE CARDS ***
Dealt to PlayTheBlues4U [9h 7c]
JDM0226: folds
PlayTheBlues4U: folds
RNixon'sHead: folds
Uncalled bet ($0.05) returned to pairofdz
pairofdz collected $0.10 from pot
pairofdz: doesn't show hand
*** SUMMARY ***
Total pot $0.10 | Rake $0
Seat 2: PlayTheBlues4U (button) folded before Flop (didn't bet)
Seat 3: RNixon'sHead (small blind) folded before Flop
Seat 5: pairofdz (big blind) collected ($0.10)
Seat 6: JDM0226 folded before Flop (didn't bet)


PokerStars Hand #203844273996:  Hold'em No Limit ($0.05/$0.10 USD) - 2019/09/20 19:52:29 ET
Table 'Lacerta' 6-max Seat #6 is the button
Seat 2: PlayTheBlues4U ($11.92 in chips)
Seat 3: RNixon'sHead ($14.62 in chips)
Seat 4: EddieMoney9 ($11.92 in chips)
Seat 5: pairofdz ($10.35 in chips)
Seat 6: JDM0226 ($8.41 in chips)
PlayTheBlues4U: posts small blind $0.05
RNixon'sHead: posts big blind $0.10
*** HOLE CARDS ***
Dealt to PlayTheBlues4U [9d Qd]
EddieMoney9 has timed out
EddieMoney9: folds
pairofdz: raises $0.20 to $0.30
JDM0226: folds
PlayTheBlues4U: folds
RNixon'sHead: folds
Uncalled bet ($0.20) returned to pairofdz
pairofdz collected $0.25 from pot
*** SUMMARY ***
Total pot $0.25 | Rake $0
Seat 2: PlayTheBlues4U (small blind) folded before Flop
Seat 3: RNixon'sHead (big blind) folded before Flop
Seat 4: EddieMoney9 folded before Flop (didn't bet)
Seat 5: pairofdz collected ($0.25)
Seat 6: JDM0226 (button) folded before Flop (didn't bet)


PokerStars Hand #203844273992:  Hold'em No Limit ($0.02/$0.05 USD) - 2019/09/20 19:52:27 ET
Table 'Anser' 6-max Seat #3 is the button
Seat 1: CMc172 ($3.48 in chips)
Seat 2: UmmmYummy ($4.78 in chips)
Seat 3: seags21 ($4.10 in chips)
Seat 4: PlayTheBlues4U ($7.89 in chips)
Seat 5: MozenMo ($3.70 in chips)
PlayTheBlues4U: posts small blind $0.02
MozenMo: posts big blind $0.05
*** HOLE CARDS ***
Dealt to PlayTheBlues4U [3s Ks]
CMc172: calls $0.05
UmmmYummy: folds
seags21: folds
PlayTheBlues4U: calls $0.03
MozenMo: checks
*** FLOP *** [Jh 6s 7s]
PlayTheBlues4U: checks
MozenMo: bets $0.05
CMc172: calls $0.05
PlayTheBlues4U: calls $0.05
*** TURN *** [Jh 6s 7s] [Qs]
PlayTheBlues4U: bets $0.20
MozenMo: calls $0.20
CMc172: folds
*** RIVER *** [Jh 6s 7s Qs] [8c]
PlayTheBlues4U: bets $0.60
MozenMo: folds
Uncalled bet ($0.60) returned to PlayTheBlues4U
PlayTheBlues4U collected $0.66 from pot
PlayTheBlues4U: doesn't show hand
*** SUMMARY ***
Total pot $0.70 | Rake $0.04
Board [Jh 6s 7s Qs 8c]
Seat 1: CMc172 folded on the Turn
Seat 2: UmmmYummy folded before Flop (didn't bet)
Seat 3: seags21 (button) folded before Flop (didn't bet)
Seat 4: PlayTheBlues4U (small blind) collected ($0.66)
Seat 5: MozenMo (big blind) folded on the River


PokerStars Hand #203844273947:  Hold'em No Limit ($0.02/$0.05 USD) - 2019/09/20 19:52:00 ET
Table 'Anser' 6-max Seat #2 is the button
Seat 1: CMc172 ($3.42 in chips)
Seat 2: UmmmYummy ($4.78 in chips)
Seat 3: seags21 ($4.12 in chips)
Seat 4: PlayTheBlues4U ($7.94 in chips)
Seat 5: MozenMo ($3.70 in chips)
seags21: posts small blind $0.02
PlayTheBlues4U: posts big blind $0.05
*** HOLE CARDS ***
Dealt to PlayTheBlues4U [8h 9d]
MozenMo: folds
CMc172: calls $0.05
UmmmYummy: folds
seags21: folds
PlayTheBlues4U: checks
*** FLOP *** [6h 6d Qc]
PlayTheBlues4U: checks
CMc172: bets $0.05
PlayTheBlues4U: folds
Uncalled bet ($0.05) returned to CMc172
CMc172 collected $0.11 from pot
CMc172: doesn't show hand
*** SUMMARY ***
Total pot $0.12 | Rake $0.01
Board [6h 6d Qc]
Seat 1: CMc172 collected ($0.11)
Seat 2: UmmmYummy (button) folded before Flop (didn't bet)
Seat 3: seags21 (small blind) folded before Flop
Seat 4: PlayTheBlues4U (big blind) folded on the Flop
Seat 5: MozenMo folded before Flop (didn't bet)


PokerStars Hand #203844273881:  Hold'em No Limit ($0.05/$0.10 USD) - 2019/09/20 19:51:23 ET
Table 'Lacerta' 6-max Seat #5 is the button
Seat 2: PlayTheBlues4U ($12.02 in chips)
Seat 3: RNixon'sHead ($14.62 in chips)
Seat 4: EddieMoney9 ($12.32 in chips)
Seat 5: pairofdz ($9.85 in chips)
Seat 6: JDM0226 ($8.46 in chips)
JDM0226: posts small blind $0.05
PlayTheBlues4U: posts big blind $0.10
*** HOLE CARDS ***
Dealt to PlayTheBlues4U [8d 4c]
RNixon'sHead: folds
EddieMoney9: calls $0.10
pairofdz: raises $0.30 to $0.40
JDM0226: folds
PlayTheBlues4U: folds
EddieMoney9: calls $0.30
*** FLOP *** [4h 9c 5s]
EddieMoney9: checks
pairofdz: bets $0.30
EddieMoney9: folds
Uncalled bet ($0.30) returned to pairofdz
pairofdz collected $0.90 from pot
pairofdz: doesn't show hand
*** SUMMARY ***
Total pot $0.95 | Rake $0.05
Board [4h 9c 5s]
Seat 2: PlayTheBlues4U (big blind) folded before Flop
Seat 3: RNixon'sHead folded before Flop (didn't bet)
Seat 4: EddieMoney9 folded on the Flop
Seat 5: pairofdz (button) collected ($0.90)
Seat 6: JDM0226 (small blind) folded before Flop


PokerStars Hand #203844273856:  Hold'em No Limit ($0.02/$0.05 USD) - 2019/09/20 19:51:10 ET
Table 'Anser' 6-max Seat #1 is the button
Seat 1: CMc172 ($3.47 in chips)
Seat 2: UmmmYummy ($4.83 in chips)
Seat 3: seags21 ($4.17 in chips)
Seat 4: PlayTheBlues4U ($7.94 in chips)
Seat 5: MozenMo ($3.56 in chips)
UmmmYummy: posts small blind $0.02
seags21: posts big blind $0.05
*** HOLE CARDS ***
Dealt to PlayTheBlues4U [8c 3h]
PlayTheBlues4U: folds
MozenMo: calls $0.05
CMc172: calls $0.05
UmmmYummy: calls $0.03
seags21: checks
*** FLOP *** [6c 7d 2s]
UmmmYummy: checks
seags21: checks
MozenMo: bets $0.20
CMc172: folds
UmmmYummy: folds
seags21: folds
Uncalled bet ($0.20) returned to MozenMo
MozenMo collected $0.19 from pot
MozenMo: doesn't show hand
*** SUMMARY ***
Total pot $0.20 | Rake $0.01
Board [6c 7d 2s]
Seat 1: CMc172 (button) folded on the Flop
Seat 2: UmmmYummy (small blind) folded on the Flop
Seat 3: seags21 (big blind) folded on the Flop
Seat 4: PlayTheBlues4U folded before Flop (didn't bet)
Seat 5: MozenMo collected ($0.19)


PokerStars Hand #203844273807:  Hold'em No Limit ($0.05/$0.10 USD) - 2019/09/20 19:50:41 ET
Table 'Lacerta' 6-max Seat #4 is the button
Seat 1: turk1120 ($6.79 in chips)
Seat 2: PlayTheBlues4U ($12.02 in chips)
Seat 3: RNixon'sHead ($14.35 in chips)
Seat 4: EddieMoney9 ($12.32 in chips)
Seat 5: pairofdz ($9.90 in chips)
Seat 6: JDM0226 ($8.71 in chips)
pairofdz: posts small blind $0.05
JDM0226: posts big blind $0.10
*** HOLE CARDS ***
Dealt to PlayTheBlues4U [8h Tc]
turk1120: folds
PlayTheBlues4U: folds
RNixon'sHead: raises $0.15 to $0.25
EddieMoney9: folds
pairofdz: folds
JDM0226: calls $0.15
*** FLOP *** [3h Qh 2h]
JDM0226: checks
RNixon'sHead: bets $0.22
JDM0226: folds
Uncalled bet ($0.22) returned to RNixon'sHead
RNixon'sHead collected $0.52 from pot
RNixon'sHead: doesn't show hand
*** SUMMARY ***
Total pot $0.55 | Rake $0.03
Board [3h Qh 2h]
Seat 1: turk1120 folded before Flop (didn't bet)
Seat 2: PlayTheBlues4U folded before Flop (didn't bet)
Seat 3: RNixon'sHead collected ($0.52)
Seat 4: EddieMoney9 (button) folded before Flop (didn't bet)
Seat 5: pairofdz (small blind) folded before Flop
Seat 6: JDM0226 (big blind) folded on the Flop


PokerStars Hand #203844273779:  Hold'em No Limit ($0.02/$0.05 USD) - 2019/09/20 19:50:23 ET
Table 'Anser' 6-max Seat #5 is the button
Seat 1: CMc172 ($3.52 in chips)
Seat 2: UmmmYummy ($4.36 in chips)
Seat 3: seags21 ($4.17 in chips)
Seat 4: PlayTheBlues4U ($8.09 in chips)
Seat 5: MozenMo ($3.71 in chips)
Seat 6: DemolishIT ($6.88 in chips)
DemolishIT: posts small blind $0.02
CMc172: posts big blind $0.05
*** HOLE CARDS ***
Dealt to PlayTheBlues4U [Ad 3h]
UmmmYummy: calls $0.05
seags21: folds
PlayTheBlues4U: raises $0.10 to $0.15
MozenMo: calls $0.15
DemolishIT: calls $0.13
CMc172: folds
UmmmYummy: calls $0.10
*** FLOP *** [7c Qd 3d]
DemolishIT: checks
UmmmYummy: bets $0.42
PlayTheBlues4U: folds
MozenMo: folds
DemolishIT: folds
Uncalled bet ($0.42) returned to UmmmYummy
UmmmYummy collected $0.62 from pot
UmmmYummy: doesn't show hand
*** SUMMARY ***
Total pot $0.65 | Rake $0.03
Board [7c Qd 3d]
Seat 1: CMc172 (big blind) folded before Flop
Seat 2: UmmmYummy collected ($0.62)
Seat 3: seags21 folded before Flop (didn't bet)
Seat 4: PlayTheBlues4U folded on the Flop
Seat 5: MozenMo (button) folded on the Flop
Seat 6: DemolishIT (small blind) folded on the Flop


PokerStars Hand #203844273690:  Hold'em No Limit ($0.05/$0.10 USD) - 2019/09/20 19:49:35 ET
Table 'Lacerta' 6-max Seat #3 is the button
Seat 1: turk1120 ($2.21 in chips)
Seat 2: PlayTheBlues4U ($12.02 in chips)
Seat 3: RNixon'sHead ($14.35 in chips)
Seat 4: EddieMoney9 ($11.86 in chips)
Seat 5: pairofdz ($10 in chips)
Seat 6: JDM0226 ($8.71 in chips)
EddieMoney9: posts small blind $0.05
pairofdz: posts big blind $0.10
*** HOLE CARDS ***
Dealt to PlayTheBlues4U [Ah 6d]
JDM0226: folds
turk1120: calls $0.10
PlayTheBlues4U: folds
RNixon'sHead: folds
EddieMoney9: raises $0.30 to $0.40
pairofdz: folds
turk1120: calls $0.30
*** FLOP *** [Jc Jd 6h]
EddieMoney9: bets $0.60
turk1120: folds
Uncalled bet ($0.60) returned to EddieMoney9
EddieMoney9 collected $0.86 from pot
EddieMoney9: doesn't show hand
*** SUMMARY ***
Total pot $0.90 | Rake $0.04
Board [Jc Jd 6h]
Seat 1: turk1120 folded on the Flop
Seat 2: PlayTheBlues4U folded before Flop (didn't bet)
Seat 3: RNixon'sHead (button) folded before Flop (didn't bet)
Seat 4: EddieMoney9 (small blind) collected ($0.86)
Seat 5: pairofdz (big blind) folded before Flop
Seat 6: JDM0226 folded before Flop (didn't bet)


PokerStars Hand #203844273633:  Hold'em No Limit ($0.02/$0.05 USD) - 2019/09/20 19:49:03 ET
Table 'Anser' 6-max Seat #4 is the button
Seat 1: CMc172 ($3.57 in chips)
Seat 2: UmmmYummy ($4.36 in chips)
Seat 3: seags21 ($4.17 in chips)
Seat 4: PlayTheBlues4U ($8.09 in chips)
Seat 5: MozenMo ($3.76 in chips)
Seat 6: DemolishIT ($6.79 in chips)
MozenMo: posts small blind $0.02
DemolishIT: posts big blind $0.05
*** HOLE CARDS ***
Dealt to PlayTheBlues4U [3h Kd]
CMc172: calls $0.05
UmmmYummy: folds
seags21: folds
PlayTheBlues4U: folds
MozenMo: calls $0.03
DemolishIT: checks
*** FLOP *** [Kc 9c Ad]
MozenMo: checks
DemolishIT: checks
CMc172: checks
*** TURN *** [Kc 9c Ad] [Td]
MozenMo: checks
DemolishIT: checks
CMc172: checks
*** RIVER *** [Kc 9c Ad Td] [As]
MozenMo: checks
DemolishIT: checks
CMc172: checks
*** SHOW DOWN ***
MozenMo: shows [7h 6h] (a pair of Aces)
DemolishIT: shows [Qd 4c] (a pair of Aces - King+Queen kicker)
CMc172: mucks hand
DemolishIT collected $0.14 from pot
*** SUMMARY ***
Total pot $0.15 | Rake $0.01
Board [Kc 9c Ad Td As]
Seat 1: CMc172 mucked [8h 4h]
Seat 2: UmmmYummy folded before Flop (didn't bet)
Seat 3: seags21 folded before Flop (didn't bet)
Seat 4: PlayTheBlues4U (button) folded before Flop (didn't bet)
Seat 5: MozenMo (small blind) showed [7h 6h] and lost with a pair of Aces
Seat 6: DemolishIT (big blind) showed [Qd 4c] and won ($0.14) with a pair of Aces


PokerStars Hand #203844273562:  Hold'em No Limit ($0.05/$0.10 USD) - 2019/09/20 19:48:31 ET
Table 'Lacerta' 6-max Seat #2 is the button
Seat 1: turk1120 ($3.31 in chips)
Seat 2: PlayTheBlues4U ($10.89 in chips)
Seat 3: RNixon'sHead ($14.40 in chips)
Seat 4: EddieMoney9 ($11.96 in chips)
Seat 6: JDM0226 ($8.71 in chips)
RNixon'sHead: posts small blind $0.05
EddieMoney9: posts big blind $0.10
*** HOLE CARDS ***
Dealt to PlayTheBlues4U [Kh Qc]
JDM0226: folds
turk1120: calls $0.10
PlayTheBlues4U: raises $0.20 to $0.30
PlayTheBlues4U said, "arroooo"
RNixon'sHead: folds
EddieMoney9: folds
turk1120: calls $0.20
*** FLOP *** [2s 9s Jh]
GoodKnight1365 was removed from the table for failing to post
GoodKnight1365 leaves the table
turk1120: bets $0.10
PlayTheBlues4U: calls $0.10
*** TURN *** [2s 9s Jh] [Qs]
turk1120: bets $0.20
PlayTheBlues4U: raises $0.50 to $0.70
pairofdz joins the table at seat #5
turk1120: calls $0.50
*** RIVER *** [2s 9s Jh Qs] [Ad]
turk1120: checks
PlayTheBlues4U: checks
*** SHOW DOWN ***
turk1120: shows [Kd Js] (a pair of Jacks)
PlayTheBlues4U: shows [Kh Qc] (a pair of Queens)
PlayTheBlues4U collected $2.23 from pot
*** SUMMARY ***
Total pot $2.35 | Rake $0.12
Board [2s 9s Jh Qs Ad]
Seat 1: turk1120 showed [Kd Js] and lost with a pair of Jacks
Seat 2: PlayTheBlues4U (button) showed [Kh Qc] and won ($2.23) with a pair of Queens
Seat 3: RNixon'sHead (small blind) folded before Flop
Seat 4: EddieMoney9 (big blind) folded before Flop
Seat 6: JDM0226 folded before Flop (didn't bet)


PokerStars Hand #203844273529:  Hold'em No Limit ($0.05/$0.10 USD) - 2019/09/20 19:48:15 ET
Table 'Lacerta' 6-max Seat #1 is the button
Seat 1: turk1120 ($3.31 in chips)
Seat 2: PlayTheBlues4U ($10.94 in chips)
Seat 3: RNixon'sHead ($14.35 in chips)
Seat 4: EddieMoney9 ($11.96 in chips)
Seat 6: JDM0226 ($8.71 in chips)
PlayTheBlues4U: posts small blind $0.05
RNixon'sHead: posts big blind $0.10
*** HOLE CARDS ***
Dealt to PlayTheBlues4U [Qd 4c]
EddieMoney9: folds
JDM0226: folds
turk1120: folds
PlayTheBlues4U: folds
Uncalled bet ($0.05) returned to RNixon'sHead
RNixon'sHead collected $0.10 from pot
RNixon'sHead: doesn't show hand
*** SUMMARY ***
Total pot $0.10 | Rake $0
Seat 1: turk1120 (button) folded before Flop (didn't bet)
Seat 2: PlayTheBlues4U (small blind) folded before Flop
Seat 3: RNixon'sHead (big blind) collected ($0.10)
Seat 4: EddieMoney9 folded before Flop (didn't bet)
Seat 6: JDM0226 folded before Flop (didn't bet)


PokerStars Hand #203844273504:  Hold'em No Limit ($0.02/$0.05 USD) - 2019/09/20 19:48:00 ET
Table 'Anser' 6-max Seat #3 is the button
Seat 1: CMc172 ($3.87 in chips)
Seat 2: UmmmYummy ($4.36 in chips)
Seat 3: seags21 ($4.17 in chips)
Seat 4: PlayTheBlues4U ($8.14 in chips)
Seat 5: MozenMo ($3.38 in chips)
Seat 6: DemolishIT ($6.86 in chips)
PlayTheBlues4U: posts small blind $0.02
MozenMo: posts big blind $0.05
DemolishIT: posts small & big blinds $0.07
*** HOLE CARDS ***
Dealt to PlayTheBlues4U [Js 2h]
DemolishIT: checks
CMc172: calls $0.05
UmmmYummy: folds
seags21: folds
PlayTheBlues4U: calls $0.03
MozenMo: checks
*** FLOP *** [3h 8c Td]
PlayTheBlues4U: checks
MozenMo: checks
DemolishIT: checks
CMc172: bets $0.10
PlayTheBlues4U: folds
MozenMo: calls $0.10
DemolishIT: folds
*** TURN *** [3h 8c Td] [7c]
MozenMo: bets $0.15
CMc172: calls $0.15
*** RIVER *** [3h 8c Td 7c] [2c]
MozenMo: checks
CMc172: checks
*** SHOW DOWN ***
MozenMo: shows [Jd 7d] (a pair of Sevens)
CMc172: mucks hand
MozenMo collected $0.68 from pot
*** SUMMARY ***
Total pot $0.72 | Rake $0.04
Board [3h 8c Td 7c 2c]
Seat 1: CMc172 mucked [3c Qd]
Seat 2: UmmmYummy folded before Flop (didn't bet)
Seat 3: seags21 (button) folded before Flop (didn't bet)
Seat 4: PlayTheBlues4U (small blind) folded on the Flop
Seat 5: MozenMo (big blind) showed [Jd 7d] and won ($0.68) with a pair of Sevens
Seat 6: DemolishIT folded on the Flop (didn't bet)


PokerStars Hand #203844273457:  Hold'em No Limit ($0.05/$0.10 USD) - 2019/09/20 19:47:40 ET
Table 'Lacerta' 6-max Seat #6 is the button
Seat 1: turk1120 ($3.22 in chips)
Seat 2: PlayTheBlues4U ($11.04 in chips)
Seat 3: RNixon'sHead ($14.35 in chips)
Seat 4: EddieMoney9 ($11.96 in chips)
Seat 6: JDM0226 ($8.71 in chips)
turk1120: posts small blind $0.05
PlayTheBlues4U: posts big blind $0.10
*** HOLE CARDS ***
Dealt to PlayTheBlues4U [8h Kc]
RNixon'sHead: folds
EddieMoney9 said, "worst flop ever for KK"
EddieMoney9: folds
JDM0226: folds
turk1120: calls $0.05
PlayTheBlues4U: checks
*** FLOP *** [6s 2d 5h]
turk1120: checks
PlayTheBlues4U: checks
*** TURN *** [6s 2d 5h] [7c]
turk1120: bets $0.10
PlayTheBlues4U: folds
Uncalled bet ($0.10) returned to turk1120
turk1120 collected $0.19 from pot
*** SUMMARY ***
Total pot $0.20 | Rake $0.01
Board [6s 2d 5h 7c]
Seat 1: turk1120 (small blind) collected ($0.19)
Seat 2: PlayTheBlues4U (big blind) folded on the Turn
Seat 3: RNixon'sHead folded before Flop (didn't bet)
Seat 4: EddieMoney9 folded before Flop (didn't bet)
Seat 6: JDM0226 (button) folded before Flop (didn't bet)


PokerStars Hand #203844273419:  Hold'em No Limit ($0.02/$0.05 USD) - 2019/09/20 19:47:22 ET
Table 'Anser' 6-max Seat #2 is the button
Seat 1: CMc172 ($4.02 in chips)
Seat 2: UmmmYummy ($4.36 in chips)
Seat 3: seags21 ($3.99 in chips)
Seat 4: PlayTheBlues4U ($8.19 in chips)
Seat 5: MozenMo ($3.38 in chips)
seags21: posts small blind $0.02
PlayTheBlues4U: posts big blind $0.05
*** HOLE CARDS ***
Dealt to PlayTheBlues4U [9c 4c]
MozenMo: folds
CMc172: calls $0.05
UmmmYummy: folds
seags21: raises $0.10 to $0.15
PlayTheBlues4U: folds
CMc172: calls $0.10
*** FLOP *** [Th Qd Qc]
seags21: bets $0.20
CMc172: folds
Uncalled bet ($0.20) returned to seags21
seags21 collected $0.33 from pot
*** SUMMARY ***
Total pot $0.35 | Rake $0.02
Board [Th Qd Qc]
Seat 1: CMc172 folded on the Flop
Seat 2: UmmmYummy (button) folded before Flop (didn't bet)
Seat 3: seags21 (small blind) collected ($0.33)
Seat 4: PlayTheBlues4U (big blind) folded before Flop
Seat 5: MozenMo folded before Flop (didn't bet)


PokerStars Hand #203844009959:  Hold'em No Limit ($0.02/$0.05 USD) - 2019/09/20 19:46:53 ET
Table 'Anser' 6-max Seat #1 is the button
Seat 1: CMc172 ($3.96 in chips)
Seat 2: UmmmYummy ($4.38 in chips)
Seat 3: seags21 ($4.04 in chips)
Seat 4: PlayTheBlues4U ($8.19 in chips)
Seat 5: MozenMo ($3.38 in chips)
UmmmYummy: posts small blind $0.02
seags21: posts big blind $0.05
*** HOLE CARDS ***
Dealt to PlayTheBlues4U [5s Kh]
PlayTheBlues4U: folds
MozenMo: folds
CMc172: calls $0.05
UmmmYummy: folds
seags21: checks
*** FLOP *** [2c 3s 3d]
seags21: checks
CMc172: checks
*** TURN *** [2c 3s 3d] [Ad]
seags21: checks
CMc172: checks
*** RIVER *** [2c 3s 3d Ad] [7d]
seags21: checks
CMc172: bets $0.05
seags21: folds
Uncalled bet ($0.05) returned to CMc172
CMc172 collected $0.11 from pot
CMc172: doesn't show hand
*** SUMMARY ***
Total pot $0.12 | Rake $0.01
Board [2c 3s 3d Ad 7d]
Seat 1: CMc172 (button) collected ($0.11)
Seat 2: UmmmYummy (small blind) folded before Flop
Seat 3: seags21 (big blind) folded on the River
Seat 4: PlayTheBlues4U folded before Flop (didn't bet)
Seat 5: MozenMo folded before Flop (didn't bet)


PokerStars Hand #203844009893:  Hold'em No Limit ($0.05/$0.10 USD) - 2019/09/20 19:46:22 ET
Table 'Lacerta' 6-max Seat #4 is the button
Seat 1: turk1120 ($3.32 in chips)
Seat 2: PlayTheBlues4U ($9.95 in chips)
Seat 3: RNixon'sHead ($14.35 in chips)
Seat 4: EddieMoney9 ($13.01 in chips)
Seat 6: JDM0226 ($8.76 in chips)
JDM0226: posts small blind $0.05
turk1120: posts big blind $0.10
*** HOLE CARDS ***
Dealt to PlayTheBlues4U [Ac Jc]
PlayTheBlues4U: raises $0.20 to $0.30
RNixon'sHead: folds
EddieMoney9: raises $0.75 to $1.05
JDM0226: folds
turk1120: folds
PlayTheBlues4U: calls $0.75
*** FLOP *** [6d 5d Ad]
PlayTheBlues4U: checks
EddieMoney9: checks
*** TURN *** [6d 5d Ad] [5s]
PlayTheBlues4U: bets $1.30
EddieMoney9: folds
Uncalled bet ($1.30) returned to PlayTheBlues4U
PlayTheBlues4U collected $2.14 from pot
PlayTheBlues4U: doesn't show hand
*** SUMMARY ***
Total pot $2.25 | Rake $0.11
Board [6d 5d Ad 5s]
Seat 1: turk1120 (big blind) folded before Flop
Seat 2: PlayTheBlues4U collected ($2.14)
Seat 3: RNixon'sHead folded before Flop (didn't bet)
Seat 4: EddieMoney9 (button) folded on the Turn
Seat 6: JDM0226 (small blind) folded before Flop


PokerStars Hand #203844009868:  Hold'em No Limit ($0.02/$0.05 USD) - 2019/09/20 19:46:09 ET
Table 'Anser' 6-max Seat #5 is the button
Seat 1: CMc172 ($3.98 in chips)
Seat 2: UmmmYummy ($5.07 in chips)
Seat 3: seags21 ($3.40 in chips)
Seat 4: PlayTheBlues4U ($8.19 in chips)
Seat 5: MozenMo ($3.38 in chips)
CMc172: posts small blind $0.02
UmmmYummy: posts big blind $0.05
*** HOLE CARDS ***
Dealt to PlayTheBlues4U [3h 8d]
seags21: raises $0.15 to $0.20
PlayTheBlues4U: folds
MozenMo: folds
CMc172: folds
UmmmYummy: calls $0.15
*** FLOP *** [6d Kd 8h]
UmmmYummy: checks
seags21: bets $0.15
UmmmYummy: calls $0.15
*** TURN *** [6d Kd 8h] [6s]
UmmmYummy: checks
seags21: checks
*** RIVER *** [6d Kd 8h 6s] [Jh]
UmmmYummy: bets $0.34
seags21: calls $0.34
*** SHOW DOWN ***
UmmmYummy: shows [Tc Td] (two pair, Tens and Sixes)
seags21: shows [Qd Kh] (two pair, Kings and Sixes)
seags21 collected $1.33 from pot
*** SUMMARY ***
Total pot $1.40 | Rake $0.07
Board [6d Kd 8h 6s Jh]
Seat 1: CMc172 (small blind) folded before Flop
Seat 2: UmmmYummy (big blind) showed [Tc Td] and lost with two pair, Tens and Sixes
Seat 3: seags21 showed [Qd Kh] and won ($1.33) with two pair, Kings and Sixes
Seat 4: PlayTheBlues4U folded before Flop (didn't bet)
Seat 5: MozenMo (button) folded before Flop (didn't bet)


PokerStars Hand #203844009859:  Hold'em No Limit ($0.05/$0.10 USD) - 2019/09/20 19:46:08 ET
Table 'Lacerta' 6-max Seat #3 is the button
Seat 1: turk1120 ($3.32 in chips)
Seat 2: PlayTheBlues4U ($9.95 in chips)
Seat 3: RNixon'sHead ($14.35 in chips)
Seat 4: EddieMoney9 ($13.06 in chips)
Seat 6: JDM0226 ($8.71 in chips)
EddieMoney9: posts small blind $0.05
JDM0226: posts big blind $0.10
*** HOLE CARDS ***
Dealt to PlayTheBlues4U [7c 4c]
turk1120: folds
PlayTheBlues4U: folds
RNixon'sHead: folds
EddieMoney9: folds
Uncalled bet ($0.05) returned to JDM0226
JDM0226 collected $0.10 from pot
JDM0226: doesn't show hand
*** SUMMARY ***
Total pot $0.10 | Rake $0
Seat 1: turk1120 folded before Flop (didn't bet)
Seat 2: PlayTheBlues4U folded before Flop (didn't bet)
Seat 3: RNixon'sHead (button) folded before Flop (didn't bet)
Seat 4: EddieMoney9 (small blind) folded before Flop
Seat 6: JDM0226 (big blind) collected ($0.10)


PokerStars Hand #203844009833:  Hold'em No Limit ($0.02/$0.05 USD) - 2019/09/20 19:45:53 ET
Table 'Anser' 6-max Seat #4 is the button
Seat 1: CMc172 ($4.03 in chips)
Seat 2: UmmmYummy ($5 in chips)
Seat 3: seags21 ($3.40 in chips)
Seat 4: PlayTheBlues4U ($8.19 in chips)
Seat 5: MozenMo ($3.40 in chips)
MozenMo: posts small blind $0.02
CMc172: posts big blind $0.05
*** HOLE CARDS ***
Dealt to PlayTheBlues4U [Td 7s]
UmmmYummy: raises $0.12 to $0.17
seags21: folds
PlayTheBlues4U: folds
MozenMo: folds
CMc172: folds
Uncalled bet ($0.12) returned to UmmmYummy
UmmmYummy collected $0.12 from pot
UmmmYummy: doesn't show hand
*** SUMMARY ***
Total pot $0.12 | Rake $0
Seat 1: CMc172 (big blind) folded before Flop
Seat 2: UmmmYummy collected ($0.12)
Seat 3: seags21 folded before Flop (didn't bet)
Seat 4: PlayTheBlues4U (button) folded before Flop (didn't bet)
Seat 5: MozenMo (small blind) folded before Flop


PokerStars Hand #203844009787:  Hold'em No Limit ($0.05/$0.10 USD) - 2019/09/20 19:45:28 ET
Table 'Lacerta' 6-max Seat #2 is the button
Seat 1: turk1120 ($3.62 in chips)
Seat 2: PlayTheBlues4U ($9.54 in chips)
Seat 3: RNixon'sHead ($14.40 in chips)
Seat 4: EddieMoney9 ($13.16 in chips)
Seat 6: JDM0226 ($8.71 in chips)
RNixon'sHead: posts small blind $0.05
EddieMoney9: posts big blind $0.10
*** HOLE CARDS ***
Dealt to PlayTheBlues4U [Ad 4c]
JDM0226: folds
turk1120: calls $0.10
PlayTheBlues4U: raises $0.20 to $0.30
RNixon'sHead: folds
EddieMoney9: folds
turk1120: calls $0.20
*** FLOP *** [9s Kd 7d]
turk1120: checks
PlayTheBlues4U: bets $0.40
turk1120: folds
Uncalled bet ($0.40) returned to PlayTheBlues4U
PlayTheBlues4U collected $0.71 from pot
PlayTheBlues4U: doesn't show hand
*** SUMMARY ***
Total pot $0.75 | Rake $0.04
Board [9s Kd 7d]
Seat 1: turk1120 folded on the Flop
Seat 2: PlayTheBlues4U (button) collected ($0.71)
Seat 3: RNixon'sHead (small blind) folded before Flop
Seat 4: EddieMoney9 (big blind) folded before Flop
Seat 6: JDM0226 folded before Flop (didn't bet)


PokerStars Hand #203844009695:  Hold'em No Limit ($0.02/$0.05 USD) - 2019/09/20 19:44:46 ET
Table 'Anser' 6-max Seat #3 is the button
Seat 1: CMc172 ($3.47 in chips)
Seat 2: UmmmYummy ($3.14 in chips)
Seat 3: seags21 ($3.40 in chips)
Seat 4: PlayTheBlues4U ($8.21 in chips)
Seat 5: MozenMo ($4 in chips)
PlayTheBlues4U: posts small blind $0.02
MozenMo: posts big blind $0.05
*** HOLE CARDS ***
Dealt to PlayTheBlues4U [Js Qd]
CMc172: calls $0.05
UmmmYummy: folds
seags21: folds
PlayTheBlues4U: folds
MozenMo: raises $0.10 to $0.15
CMc172: calls $0.10
*** FLOP *** [Td Kh Jh]
MozenMo: bets $0.15
CMc172: calls $0.15
*** TURN *** [Td Kh Jh] [Ah]
MozenMo: bets $0.30
CMc172: calls $0.30
*** RIVER *** [Td Kh Jh Ah] [9c]
MozenMo: checks
CMc172: checks
*** SHOW DOWN ***
MozenMo: shows [Ac 3d] (a pair of Aces)
CMc172: shows [Ks 9h] (two pair, Kings and Nines)
CMc172 collected $1.16 from pot
*** SUMMARY ***
Total pot $1.22 | Rake $0.06
Board [Td Kh Jh Ah 9c]
Seat 1: CMc172 showed [Ks 9h] and won ($1.16) with two pair, Kings and Nines
Seat 2: UmmmYummy folded before Flop (didn't bet)
Seat 3: seags21 (button) folded before Flop (didn't bet)
Seat 4: PlayTheBlues4U (small blind) folded before Flop
Seat 5: MozenMo (big blind) showed [Ac 3d] and lost with a pair of Aces


PokerStars Hand #203844009638:  Hold'em No Limit ($0.02/$0.05 USD) - 2019/09/20 19:44:18 ET
Table 'Anser' 6-max Seat #2 is the button
Seat 1: CMc172 ($3.47 in chips)
Seat 2: UmmmYummy ($3.34 in chips)
Seat 3: seags21 ($3.42 in chips)
Seat 4: PlayTheBlues4U ($8.01 in chips)
seags21: posts small blind $0.02
PlayTheBlues4U: posts big blind $0.05
MozenMo: sits out
*** HOLE CARDS ***
Dealt to PlayTheBlues4U [As 3s]
CMc172: folds
UmmmYummy: calls $0.05
seags21: folds
PlayTheBlues4U: raises $0.15 to $0.20
UmmmYummy: calls $0.15
*** FLOP *** [Qs Jc 7d]
PlayTheBlues4U: bets $0.25
UmmmYummy: folds
Uncalled bet ($0.25) returned to PlayTheBlues4U
PlayTheBlues4U collected $0.40 from pot
PlayTheBlues4U: doesn't show hand
*** SUMMARY ***
Total pot $0.42 | Rake $0.02
Board [Qs Jc 7d]
Seat 1: CMc172 folded before Flop (didn't bet)
Seat 2: UmmmYummy (button) folded on the Flop
Seat 3: seags21 (small blind) folded before Flop
Seat 4: PlayTheBlues4U (big blind) collected ($0.40)


PokerStars Hand #203844009635:  Hold'em No Limit ($0.05/$0.10 USD) - 2019/09/20 19:44:16 ET
Table 'Lacerta' 6-max Seat #1 is the button
Seat 1: turk1120 ($3.72 in chips)
Seat 2: PlayTheBlues4U ($9.36 in chips)
Seat 3: RNixon'sHead ($14.50 in chips)
Seat 4: EddieMoney9 ($13.16 in chips)
Seat 6: JDM0226 ($8.71 in chips)
PlayTheBlues4U: posts small blind $0.05
RNixon'sHead: posts big blind $0.10
*** HOLE CARDS ***
Dealt to PlayTheBlues4U [Kc Th]
EddieMoney9: folds
JDM0226: folds
turk1120: calls $0.10
PlayTheBlues4U: calls $0.05
RNixon'sHead: checks
*** FLOP *** [Tc Ah Qd]
PlayTheBlues4U: checks
RNixon'sHead: checks
turk1120: checks
*** TURN *** [Tc Ah Qd] [7d]
PlayTheBlues4U: checks
RNixon'sHead: checks
turk1120: checks
*** RIVER *** [Tc Ah Qd 7d] [8c]
PlayTheBlues4U: checks
RNixon'sHead: checks
turk1120: checks
*** SHOW DOWN ***
PlayTheBlues4U: shows [Kc Th] (a pair of Tens)
RNixon'sHead: mucks hand
turk1120: mucks hand
PlayTheBlues4U collected $0.28 from pot
*** SUMMARY ***
Total pot $0.30 | Rake $0.02
Board [Tc Ah Qd 7d 8c]
Seat 1: turk1120 (button) mucked [6c 5s]
Seat 2: PlayTheBlues4U (small blind) showed [Kc Th] and won ($0.28) with a pair of Tens
Seat 3: RNixon'sHead (big blind) mucked [2c 3c]
Seat 4: EddieMoney9 folded before Flop (didn't bet)
Seat 6: JDM0226 folded before Flop (didn't bet)


PokerStars Hand #203844009538:  Hold'em No Limit ($0.02/$0.05 USD) - 2019/09/20 19:43:23 ET
Table 'Anser' 6-max Seat #1 is the button
Seat 1: CMc172 ($3.62 in chips)
Seat 2: UmmmYummy ($4.84 in chips)
Seat 3: seags21 ($3.57 in chips)
Seat 4: PlayTheBlues4U ($6.37 in chips)
UmmmYummy: posts small blind $0.02
seags21: posts big blind $0.05
MozenMo: sits out
*** HOLE CARDS ***
Dealt to PlayTheBlues4U [6h Ah]
PlayTheBlues4U: raises $0.10 to $0.15
CMc172: calls $0.15
UmmmYummy: calls $0.13
seags21: calls $0.10
*** FLOP *** [Ad 7h 6s]
UmmmYummy: checks
seags21: checks
PlayTheBlues4U: bets $0.40
CMc172: folds
UmmmYummy: calls $0.40
seags21: folds
*** TURN *** [Ad 7h 6s] [Js]
UmmmYummy: checks
PlayTheBlues4U: checks
*** RIVER *** [Ad 7h 6s Js] [2d]
UmmmYummy: checks
PlayTheBlues4U: bets $0.95
UmmmYummy: calls $0.95
*** SHOW DOWN ***
PlayTheBlues4U: shows [6h Ah] (two pair, Aces and Sixes)
UmmmYummy: mucks hand
PlayTheBlues4U collected $3.14 from pot
*** SUMMARY ***
Total pot $3.30 | Rake $0.16
Board [Ad 7h 6s Js 2d]
Seat 1: CMc172 (button) folded on the Flop
Seat 2: UmmmYummy (small blind) mucked [As Th]
Seat 3: seags21 (big blind) folded on the Flop
Seat 4: PlayTheBlues4U showed [6h Ah] and won ($3.14) with two pair, Aces and Sixes


PokerStars Hand #203844009476:  Hold'em No Limit ($0.02/$0.05 USD) - 2019/09/20 19:42:55 ET
Table 'Anser' 6-max Seat #4 is the button
Seat 1: CMc172 ($3.67 in chips)
Seat 2: UmmmYummy ($4.79 in chips)
Seat 3: seags21 ($3.57 in chips)
Seat 4: PlayTheBlues4U ($6.37 in chips)
CMc172: posts small blind $0.02
UmmmYummy: posts big blind $0.05
*** HOLE CARDS ***
Dealt to PlayTheBlues4U [2c 8s]
lj001ll leaves the table
seags21: folds
MozenMo joins the table at seat #5
PlayTheBlues4U: folds
CMc172: calls $0.03
UmmmYummy: raises $0.15 to $0.20
CMc172: folds
Uncalled bet ($0.15) returned to UmmmYummy
UmmmYummy collected $0.10 from pot
UmmmYummy: doesn't show hand
*** SUMMARY ***
Total pot $0.10 | Rake $0
Seat 1: CMc172 (small blind) folded before Flop
Seat 2: UmmmYummy (big blind) collected ($0.10)
Seat 3: seags21 folded before Flop (didn't bet)
Seat 4: PlayTheBlues4U (button) folded before Flop (didn't bet)


PokerStars Hand #203844009468:  Hold'em No Limit ($0.05/$0.10 USD) - 2019/09/20 19:42:49 ET
Table 'Lacerta' 6-max Seat #6 is the button
Seat 1: turk1120 ($9.05 in chips)
Seat 2: PlayTheBlues4U ($9.66 in chips)
Seat 3: RNixon'sHead ($14.50 in chips)
Seat 4: EddieMoney9 ($7.79 in chips)
Seat 6: JDM0226 ($9.01 in chips)
turk1120: posts small blind $0.05
PlayTheBlues4U: posts big blind $0.10
*** HOLE CARDS ***
Dealt to PlayTheBlues4U [8s 9h]
RNixon'sHead: folds
EddieMoney9: raises $0.20 to $0.30
JDM0226: calls $0.30
turk1120: calls $0.25
PlayTheBlues4U: calls $0.20
*** FLOP *** [Qh 8h 5d]
turk1120: bets $0.57
PlayTheBlues4U: folds
EddieMoney9: calls $0.57
JDM0226: folds
*** TURN *** [Qh 8h 5d] [Ts]
turk1120: bets $0.20
EddieMoney9: raises $1.83 to $2.03
turk1120: calls $1.83
*** RIVER *** [Qh 8h 5d Ts] [3c]
turk1120: checks
EddieMoney9: bets $2.43
turk1120: calls $2.43
*** SHOW DOWN ***
EddieMoney9: shows [Qd Qs] (three of a kind, Queens)
turk1120: mucks hand
EddieMoney9 collected $10.70 from pot
*** SUMMARY ***
Total pot $11.26 | Rake $0.56
Board [Qh 8h 5d Ts 3c]
Seat 1: turk1120 (small blind) mucked [Qc Ks]
Seat 2: PlayTheBlues4U (big blind) folded on the Flop
Seat 3: RNixon'sHead folded before Flop (didn't bet)
Seat 4: EddieMoney9 showed [Qd Qs] and won ($10.70) with three of a kind, Queens
Seat 6: JDM0226 (button) folded on the Flop


PokerStars Hand #203844009429:  Hold'em No Limit ($0.02/$0.05 USD) - 2019/09/20 19:42:29 ET
Table 'Anser' 6-max Seat #3 is the button
Seat 1: CMc172 ($3.77 in chips)
Seat 2: UmmmYummy ($4.65 in chips)
Seat 3: seags21 ($3.57 in chips)
Seat 4: PlayTheBlues4U ($6.42 in chips)
PlayTheBlues4U: posts small blind $0.02
CMc172: posts big blind $0.05
*** HOLE CARDS ***
Dealt to PlayTheBlues4U [6c Qd]
UmmmYummy: calls $0.05
seags21: folds
PlayTheBlues4U: calls $0.03
CMc172: checks
*** FLOP *** [8c Ks Ac]
PlayTheBlues4U: checks
CMc172: bets $0.05
UmmmYummy: raises $0.12 to $0.17
PlayTheBlues4U: folds
CMc172: folds
Uncalled bet ($0.12) returned to UmmmYummy
UmmmYummy collected $0.24 from pot
UmmmYummy: doesn't show hand
*** SUMMARY ***
Total pot $0.25 | Rake $0.01
Board [8c Ks Ac]
Seat 1: CMc172 (big blind) folded on the Flop
Seat 2: UmmmYummy collected ($0.24)
Seat 3: seags21 (button) folded before Flop (didn't bet)
Seat 4: PlayTheBlues4U (small blind) folded on the Flop


PokerStars Hand #203844009376:  Hold'em No Limit ($0.02/$0.05 USD) - 2019/09/20 19:42:02 ET
Table 'Anser' 6-max Seat #2 is the button
Seat 1: CMc172 ($3.82 in chips)
Seat 2: UmmmYummy ($4.65 in chips)
Seat 3: seags21 ($3.47 in chips)
Seat 4: PlayTheBlues4U ($6.47 in chips)
seags21: posts small blind $0.02
PlayTheBlues4U: posts big blind $0.05
*** HOLE CARDS ***
Dealt to PlayTheBlues4U [5c 3h]
CMc172: calls $0.05
UmmmYummy: folds
seags21: raises $0.15 to $0.20
PlayTheBlues4U: folds
CMc172: folds
Uncalled bet ($0.15) returned to seags21
seags21 collected $0.15 from pot
seags21: doesn't show hand
*** SUMMARY ***
Total pot $0.15 | Rake $0
Seat 1: CMc172 folded before Flop
Seat 2: UmmmYummy (button) folded before Flop (didn't bet)
Seat 3: seags21 (small blind) collected ($0.15)
Seat 4: PlayTheBlues4U (big blind) folded before Flop


PokerStars Hand #203844009359:  Hold'em No Limit ($0.05/$0.10 USD) - 2019/09/20 19:41:55 ET
Table 'Lacerta' 6-max Seat #4 is the button
Seat 1: turk1120 ($7.90 in chips)
Seat 2: PlayTheBlues4U ($9.66 in chips)
Seat 3: RNixon'sHead ($14.50 in chips)
Seat 4: EddieMoney9 ($9.01 in chips)
Seat 6: JDM0226 ($9.06 in chips)
JDM0226: posts small blind $0.05
turk1120: posts big blind $0.10
*** HOLE CARDS ***
Dealt to PlayTheBlues4U [5d 4h]
PlayTheBlues4U: folds
RNixon'sHead: folds
EddieMoney9: raises $0.20 to $0.30
JDM0226: folds
turk1120: calls $0.20
*** FLOP *** [Kh 6s Ts]
turk1120: bets $0.31
EddieMoney9: calls $0.31
*** TURN *** [Kh 6s Ts] [Qs]
turk1120: bets $0.61
EddieMoney9: calls $0.61
*** RIVER *** [Kh 6s Ts Qs] [7s]
turk1120: checks
EddieMoney9: checks
*** SHOW DOWN ***
turk1120: shows [Kc Tc] (two pair, Kings and Tens)
EddieMoney9: mucks hand
turk1120 collected $2.37 from pot
*** SUMMARY ***
Total pot $2.49 | Rake $0.12
Board [Kh 6s Ts Qs 7s]
Seat 1: turk1120 (big blind) showed [Kc Tc] and won ($2.37) with two pair, Kings and Tens
Seat 2: PlayTheBlues4U folded before Flop (didn't bet)
Seat 3: RNixon'sHead folded before Flop (didn't bet)
Seat 4: EddieMoney9 (button) mucked [Qh 9h]
Seat 6: JDM0226 (small blind) folded before Flop


PokerStars Hand #203844009252:  Hold'em No Limit ($0.05/$0.10 USD) - 2019/09/20 19:40:57 ET
Table 'Lacerta' 6-max Seat #3 is the button
Seat 1: turk1120 ($8 in chips)
Seat 2: PlayTheBlues4U ($9.11 in chips)
Seat 3: RNixon'sHead ($14.50 in chips)
Seat 4: EddieMoney9 ($9.41 in chips)
Seat 6: JDM0226 ($9.16 in chips)
EddieMoney9: posts small blind $0.05
JDM0226: posts big blind $0.10
*** HOLE CARDS ***
Dealt to PlayTheBlues4U [Ac 7c]
turk1120: calls $0.10
PlayTheBlues4U: raises $0.30 to $0.40
RNixon'sHead: folds
EddieMoney9: calls $0.35
JDM0226: folds
turk1120: folds
*** FLOP *** [7d Qc Qd]
EddieMoney9: checks
PlayTheBlues4U: bets $0.60
EddieMoney9: folds
Uncalled bet ($0.60) returned to PlayTheBlues4U
PlayTheBlues4U collected $0.95 from pot
PlayTheBlues4U: doesn't show hand
*** SUMMARY ***
Total pot $1 | Rake $0.05
Board [7d Qc Qd]
Seat 1: turk1120 folded before Flop
Seat 2: PlayTheBlues4U collected ($0.95)
Seat 3: RNixon'sHead (button) folded before Flop (didn't bet)
Seat 4: EddieMoney9 (small blind) folded on the Flop
Seat 6: JDM0226 (big blind) folded before Flop


PokerStars Hand #203844009240:  Hold'em No Limit ($0.02/$0.05 USD) - 2019/09/20 19:40:49 ET
Table 'Anser' 6-max Seat #1 is the button
Seat 1: CMc172 ($3.99 in chips)
Seat 2: UmmmYummy ($4.67 in chips)
Seat 3: seags21 ($5.07 in chips)
Seat 4: PlayTheBlues4U ($6.47 in chips)
Seat 5: lj001ll ($1.60 in chips)
UmmmYummy: posts small blind $0.02
seags21: posts big blind $0.05
*** HOLE CARDS ***
Dealt to PlayTheBlues4U [Ah 7s]
PlayTheBlues4U: folds
lj001ll: calls $0.05
CMc172: calls $0.05
UmmmYummy: folds
seags21: checks
*** FLOP *** [Qc Jh 6s]
seags21: checks
lj001ll: checks
CMc172: checks
*** TURN *** [Qc Jh 6s] [3s]
seags21: bets $0.06
lj001ll: raises $0.06 to $0.12
CMc172: calls $0.12
seags21: raises $0.52 to $0.64
lj001ll: calls $0.52
CMc172: folds
*** RIVER *** [Qc Jh 6s 3s] [Ts]
seags21: bets $0.91
lj001ll: calls $0.91 and is all-in
*** SHOW DOWN ***
seags21: shows [3c 6c] (two pair, Sixes and Threes)
lj001ll: shows [3d 3h] (three of a kind, Threes)
lj001ll collected $3.22 from pot
*** SUMMARY ***
Total pot $3.39 | Rake $0.17
Board [Qc Jh 6s 3s Ts]
Seat 1: CMc172 (button) folded on the Turn
Seat 2: UmmmYummy (small blind) folded before Flop
Seat 3: seags21 (big blind) showed [3c 6c] and lost with two pair, Sixes and Threes
Seat 4: PlayTheBlues4U folded before Flop (didn't bet)
Seat 5: lj001ll showed [3d 3h] and won ($3.22) with three of a kind, Threes


PokerStars Hand #203844009150:  Hold'em No Limit ($0.02/$0.05 USD) - 2019/09/20 19:40:02 ET
Table 'Anser' 6-max Seat #5 is the button
Seat 1: CMc172 ($4.14 in chips)
Seat 2: UmmmYummy ($4.77 in chips)
Seat 3: seags21 ($5.07 in chips)
Seat 4: PlayTheBlues4U ($6.47 in chips)
Seat 5: lj001ll ($1.37 in chips)
CMc172: posts small blind $0.02
UmmmYummy: posts big blind $0.05
*** HOLE CARDS ***
Dealt to PlayTheBlues4U [5h 2c]
seags21: folds
PlayTheBlues4U: folds
lj001ll: calls $0.05
CMc172: calls $0.03
UmmmYummy: checks
*** FLOP *** [3s 5d 7d]
CMc172: checks
UmmmYummy: checks
lj001ll: checks
*** TURN *** [3s 5d 7d] [Jc]
CMc172: bets $0.05
UmmmYummy: calls $0.05
lj001ll: calls $0.05
*** RIVER *** [3s 5d 7d Jc] [Ts]
CMc172: bets $0.05
UmmmYummy: folds
lj001ll: raises $0.19 to $0.24
CMc172: folds
Uncalled bet ($0.19) returned to lj001ll
lj001ll collected $0.38 from pot
lj001ll: doesn't show hand
*** SUMMARY ***
Total pot $0.40 | Rake $0.02
Board [3s 5d 7d Jc Ts]
Seat 1: CMc172 (small blind) folded on the River
Seat 2: UmmmYummy (big blind) folded on the River
Seat 3: seags21 folded before Flop (didn't bet)
Seat 4: PlayTheBlues4U folded before Flop (didn't bet)
Seat 5: lj001ll (button) collected ($0.38)


PokerStars Hand #203844009120:  Hold'em No Limit ($0.02/$0.05 USD) - 2019/09/20 19:39:43 ET
Table 'Anser' 6-max Seat #4 is the button
Seat 1: CMc172 ($4.12 in chips)
Seat 2: UmmmYummy ($4.77 in chips)
Seat 3: seags21 ($5.07 in chips)
Seat 4: PlayTheBlues4U ($6.47 in chips)
Seat 5: lj001ll ($1.39 in chips)
lj001ll: posts small blind $0.02
CMc172: posts big blind $0.05
*** HOLE CARDS ***
Dealt to PlayTheBlues4U [3h Jd]
UmmmYummy: folds
seags21: folds
PlayTheBlues4U: folds
lj001ll: folds
Uncalled bet ($0.03) returned to CMc172
CMc172 collected $0.04 from pot
CMc172: doesn't show hand
*** SUMMARY ***
Total pot $0.04 | Rake $0
Seat 1: CMc172 (big blind) collected ($0.04)
Seat 2: UmmmYummy folded before Flop (didn't bet)
Seat 3: seags21 folded before Flop (didn't bet)
Seat 4: PlayTheBlues4U (button) folded before Flop (didn't bet)
Seat 5: lj001ll (small blind) folded before Flop


PokerStars Hand #203844009108:  Hold'em No Limit ($0.05/$0.10 USD) - 2019/09/20 19:39:39 ET
Table 'Lacerta' 6-max Seat #2 is the button
Seat 1: turk1120 ($9.05 in chips)
Seat 2: PlayTheBlues4U ($9.41 in chips)
Seat 3: RNixon'sHead ($14.55 in chips)
Seat 4: EddieMoney9 ($8.13 in chips)
Seat 6: JDM0226 ($9.16 in chips)
RNixon'sHead: posts small blind $0.05
EddieMoney9: posts big blind $0.10
*** HOLE CARDS ***
Dealt to PlayTheBlues4U [4d Kd]
JDM0226: folds
turk1120: calls $0.10
PlayTheBlues4U: raises $0.20 to $0.30
RNixon'sHead: folds
EddieMoney9: raises $0.75 to $1.05
turk1120: calls $0.95
PlayTheBlues4U: folds
*** FLOP *** [6s 3h 4s]
EddieMoney9: checks
turk1120: checks
*** TURN *** [6s 3h 4s] [5c]
EddieMoney9: checks
turk1120: checks
*** RIVER *** [6s 3h 4s 5c] [Jh]
EddieMoney9: bets $0.93
turk1120: folds
Uncalled bet ($0.93) returned to EddieMoney9
EddieMoney9 collected $2.33 from pot
EddieMoney9: doesn't show hand
*** SUMMARY ***
Total pot $2.45 | Rake $0.12
Board [6s 3h 4s 5c Jh]
Seat 1: turk1120 folded on the River
Seat 2: PlayTheBlues4U (button) folded before Flop
Seat 3: RNixon'sHead (small blind) folded before Flop
Seat 4: EddieMoney9 (big blind) collected ($2.33)
Seat 6: JDM0226 folded before Flop (didn't bet)


PokerStars Hand #203844009034:  Hold'em No Limit ($0.05/$0.10 USD) - 2019/09/20 19:39:01 ET
Table 'Lacerta' 6-max Seat #1 is the button
Seat 1: turk1120 ($8.91 in chips)
Seat 2: PlayTheBlues4U ($9.46 in chips)
Seat 3: RNixon'sHead ($14.65 in chips)
Seat 4: EddieMoney9 ($8.13 in chips)
Seat 6: JDM0226 ($9.16 in chips)
PlayTheBlues4U: posts small blind $0.05
RNixon'sHead: posts big blind $0.10
*** HOLE CARDS ***
Dealt to PlayTheBlues4U [4d 8c]
EddieMoney9: folds
JDM0226: folds
turk1120: calls $0.10
PlayTheBlues4U: folds
RNixon'sHead: checks
*** FLOP *** [3d Jh 3h]
RNixon'sHead: checks
turk1120: bets $0.20
RNixon'sHead: folds
Uncalled bet ($0.20) returned to turk1120
turk1120 collected $0.24 from pot
*** SUMMARY ***
Total pot $0.25 | Rake $0.01
Board [3d Jh 3h]
Seat 1: turk1120 (button) collected ($0.24)
Seat 2: PlayTheBlues4U (small blind) folded before Flop
Seat 3: RNixon'sHead (big blind) folded on the Flop
Seat 4: EddieMoney9 folded before Flop (didn't bet)
Seat 6: JDM0226 folded before Flop (didn't bet)


PokerStars Hand #203844009005:  Hold'em No Limit ($0.02/$0.05 USD) - 2019/09/20 19:38:48 ET
Table 'Anser' 6-max Seat #3 is the button
Seat 1: CMc172 ($4.06 in chips)
Seat 2: UmmmYummy ($4.77 in chips)
Seat 3: seags21 ($5.07 in chips)
Seat 4: PlayTheBlues4U ($6.49 in chips)
Seat 5: lj001ll ($1.44 in chips)
PlayTheBlues4U: posts small blind $0.02
lj001ll: posts big blind $0.05
*** HOLE CARDS ***
Dealt to PlayTheBlues4U [4h Jh]
CMc172: calls $0.05
UmmmYummy: folds
seags21: folds
PlayTheBlues4U: folds
lj001ll: checks
*** FLOP *** [4d Ts Kc]
lj001ll: checks
CMc172: checks
*** TURN *** [4d Ts Kc] [9h]
lj001ll: checks
CMc172: bets $0.05
lj001ll: folds
Uncalled bet ($0.05) returned to CMc172
CMc172 collected $0.11 from pot
CMc172: doesn't show hand
*** SUMMARY ***
Total pot $0.12 | Rake $0.01
Board [4d Ts Kc 9h]
Seat 1: CMc172 collected ($0.11)
Seat 2: UmmmYummy folded before Flop (didn't bet)
Seat 3: seags21 (button) folded before Flop (didn't bet)
Seat 4: PlayTheBlues4U (small blind) folded before Flop
Seat 5: lj001ll (big blind) folded on the Turn


PokerStars Hand #203841579959:  Hold'em No Limit ($0.05/$0.10 USD) - 2019/09/20 19:38:25 ET
Table 'Lacerta' 6-max Seat #6 is the button
Seat 1: turk1120 ($9.01 in chips)
Seat 2: PlayTheBlues4U ($9.37 in chips)
Seat 3: RNixon'sHead ($14.65 in chips)
Seat 4: EddieMoney9 ($8.13 in chips)
Seat 6: JDM0226 ($9.16 in chips)
turk1120: posts small blind $0.05
PlayTheBlues4U: posts big blind $0.10
*** HOLE CARDS ***
Dealt to PlayTheBlues4U [Kd 4h]
RNixon'sHead said, "combo draw"
RNixon'sHead: folds
EddieMoney9 said, "i had overpair"
EddieMoney9: folds
JDM0226: folds
RNixon'sHead said, "head"
RNixon'sHead said, "ahead"
turk1120: calls $0.05
PlayTheBlues4U: checks
*** FLOP *** [2h Tc 8s]
turk1120: checks
PlayTheBlues4U: checks
*** TURN *** [2h Tc 8s] [7c]
turk1120: checks
PlayTheBlues4U: checks
*** RIVER *** [2h Tc 8s 7c] [As]
EddieMoney9 said, "good bet i guess"
turk1120: checks
PlayTheBlues4U: checks
*** SHOW DOWN ***
turk1120: shows [Js 5c] (high card Ace)
PlayTheBlues4U: shows [Kd 4h] (high card Ace - King kicker)
GoodKnight1365 is disconnected
PlayTheBlues4U collected $0.19 from pot
*** SUMMARY ***
Total pot $0.20 | Rake $0.01
Board [2h Tc 8s 7c As]
Seat 1: turk1120 (small blind) showed [Js 5c] and lost with high card Ace
Seat 2: PlayTheBlues4U (big blind) showed [Kd 4h] and won ($0.19) with high card Ace
Seat 3: RNixon'sHead folded before Flop (didn't bet)
Seat 4: EddieMoney9 folded before Flop (didn't bet)
Seat 6: JDM0226 (button) folded before Flop (didn't bet)


PokerStars Hand #203841579905:  Hold'em No Limit ($0.02/$0.05 USD) - 2019/09/20 19:38:01 ET
Table 'Anser' 6-max Seat #2 is the button
Seat 1: CMc172 ($4.40 in chips)
Seat 2: UmmmYummy ($4.40 in chips)
Seat 3: seags21 ($5.09 in chips)
Seat 4: PlayTheBlues4U ($6.54 in chips)
Seat 5: lj001ll ($1.44 in chips)
seags21: posts small blind $0.02
PlayTheBlues4U: posts big blind $0.05
*** HOLE CARDS ***
Dealt to PlayTheBlues4U [2c 4s]
lj001ll: folds
CMc172: calls $0.05
UmmmYummy: raises $0.07 to $0.12
seags21: folds
PlayTheBlues4U: folds
CMc172: calls $0.07
*** FLOP *** [Qh 9h Jd]
CMc172: checks
UmmmYummy: bets $0.22
CMc172: calls $0.22
*** TURN *** [Qh 9h Jd] [7h]
CMc172: checks
UmmmYummy: bets $0.53
CMc172: folds
Uncalled bet ($0.53) returned to UmmmYummy
UmmmYummy collected $0.71 from pot
UmmmYummy: doesn't show hand
*** SUMMARY ***
Total pot $0.75 | Rake $0.04
Board [Qh 9h Jd 7h]
Seat 1: CMc172 folded on the Turn
Seat 2: UmmmYummy (button) collected ($0.71)
Seat 3: seags21 (small blind) folded before Flop
Seat 4: PlayTheBlues4U (big blind) folded before Flop
Seat 5: lj001ll folded before Flop (didn't bet)


PokerStars Hand #203841579864:  Hold'em No Limit ($0.02/$0.05 USD) - 2019/09/20 19:37:37 ET
Table 'Anser' 6-max Seat #1 is the button
Seat 1: CMc172 ($4.45 in chips)
Seat 2: UmmmYummy ($4.45 in chips)
Seat 3: seags21 ($5 in chips)
Seat 4: PlayTheBlues4U ($6.54 in chips)
Seat 5: lj001ll ($1.44 in chips)
UmmmYummy: posts small blind $0.02
seags21: posts big blind $0.05
*** HOLE CARDS ***
Dealt to PlayTheBlues4U [Td 5h]
PlayTheBlues4U: folds
lj001ll: folds
CMc172: calls $0.05
UmmmYummy: calls $0.03
seags21: checks
*** FLOP *** [6c Ad 4s]
UmmmYummy: checks
seags21: checks
CMc172: checks
*** TURN *** [6c Ad 4s] [9d]
UmmmYummy: checks
seags21: checks
CMc172: checks
*** RIVER *** [6c Ad 4s 9d] [2s]
UmmmYummy: checks
seags21: checks
CMc172: checks
*** SHOW DOWN ***
UmmmYummy: shows [Jh 8h] (high card Ace)
seags21: shows [7s 2c] (a pair of Deuces)
CMc172: mucks hand
seags21 collected $0.14 from pot
*** SUMMARY ***
Total pot $0.15 | Rake $0.01
Board [6c Ad 4s 9d 2s]
Seat 1: CMc172 (button) mucked [Jc Kh]
Seat 2: UmmmYummy (small blind) showed [Jh 8h] and lost with high card Ace
Seat 3: seags21 (big blind) showed [7s 2c] and won ($0.14) with a pair of Deuces
Seat 4: PlayTheBlues4U folded before Flop (didn't bet)
Seat 5: lj001ll folded before Flop (didn't bet)


PokerStars Hand #203841579783:  Hold'em No Limit ($0.02/$0.05 USD) - 2019/09/20 19:36:56 ET
Table 'Anser' 6-max Seat #5 is the button
Seat 1: CMc172 ($4.25 in chips)
Seat 2: UmmmYummy ($4.67 in chips)
Seat 3: dmakai ($5.85 in chips)
Seat 4: PlayTheBlues4U ($6.54 in chips)
Seat 5: lj001ll ($1.44 in chips)
CMc172: posts small blind $0.02
UmmmYummy: posts big blind $0.05
*** HOLE CARDS ***
Dealt to PlayTheBlues4U [8h Tc]
dmakai: folds
PlayTheBlues4U: folds
lj001ll: folds
CMc172: calls $0.03
dmakai leaves the table
UmmmYummy: checks
*** FLOP *** [Ah 6h 2s]
CMc172: checks
UmmmYummy: bets $0.06
seags21 joins the table at seat #3
CMc172: calls $0.06
*** TURN *** [Ah 6h 2s] [Jh]
CMc172: checks
UmmmYummy: bets $0.11
CMc172: calls $0.11
*** RIVER *** [Ah 6h 2s Jh] [5s]
CMc172: bets $0.25
UmmmYummy: folds
Uncalled bet ($0.25) returned to CMc172
CMc172 collected $0.42 from pot
CMc172: doesn't show hand
*** SUMMARY ***
Total pot $0.44 | Rake $0.02
Board [Ah 6h 2s Jh 5s]
Seat 1: CMc172 (small blind) collected ($0.42)
Seat 2: UmmmYummy (big blind) folded on the River
Seat 3: dmakai folded before Flop (didn't bet)
Seat 4: PlayTheBlues4U folded before Flop (didn't bet)
Seat 5: lj001ll (button) folded before Flop (didn't bet)


PokerStars Hand #203841579709:  Hold'em No Limit ($0.02/$0.05 USD) - 2019/09/20 19:36:17 ET
Table 'Anser' 6-max Seat #4 is the button
Seat 1: CMc172 ($3.96 in chips)
Seat 2: UmmmYummy ($4.67 in chips)
Seat 3: dmakai ($6.15 in chips)
Seat 4: PlayTheBlues4U ($6.54 in chips)
Seat 5: lj001ll ($1.46 in chips)
lj001ll: posts small blind $0.02
CMc172: posts big blind $0.05
*** HOLE CARDS ***
Dealt to PlayTheBlues4U [4d 2c]
UmmmYummy: folds
dmakai: calls $0.05
PlayTheBlues4U: folds
lj001ll: folds
CMc172: checks
*** FLOP *** [3s 4c 5d]
CMc172: checks
dmakai: checks
*** TURN *** [3s 4c 5d] [Jd]
CMc172: checks
dmakai: bets $0.10
CMc172: calls $0.10
*** RIVER *** [3s 4c 5d Jd] [Qh]
CMc172: bets $0.15
dmakai: calls $0.15
*** SHOW DOWN ***
CMc172: shows [3d Qc] (two pair, Queens and Threes)
dmakai: mucks hand
CMc172 collected $0.59 from pot
*** SUMMARY ***
Total pot $0.62 | Rake $0.03
Board [3s 4c 5d Jd Qh]
Seat 1: CMc172 (big blind) showed [3d Qc] and won ($0.59) with two pair, Queens and Threes
Seat 2: UmmmYummy folded before Flop (didn't bet)
Seat 3: dmakai mucked [9d Jc]
Seat 4: PlayTheBlues4U (button) folded before Flop (didn't bet)
Seat 5: lj001ll (small blind) folded before Flop


PokerStars Hand #203841579702:  Hold'em No Limit ($0.05/$0.10 USD) - 2019/09/20 19:36:12 ET
Table 'Lacerta' 6-max Seat #4 is the button
Seat 1: turk1120 ($9.01 in chips)
Seat 2: PlayTheBlues4U ($9.37 in chips)
Seat 3: RNixon'sHead ($12.80 in chips)
Seat 4: EddieMoney9 ($9.87 in chips)
Seat 5: GoodKnight1365 ($15.39 in chips)
Seat 6: JDM0226 ($9.41 in chips)
GoodKnight1365: posts small blind $0.05
JDM0226: posts big blind $0.10
*** HOLE CARDS ***
Dealt to PlayTheBlues4U [5s Jd]
turk1120: folds
PlayTheBlues4U: folds
RNixon'sHead: raises $0.15 to $0.25
EddieMoney9: calls $0.25
GoodKnight1365: folds
JDM0226: calls $0.15
*** FLOP *** [2h 7c 3c]
JDM0226: checks
RNixon'sHead: bets $0.40
EddieMoney9: raises $1.09 to $1.49
JDM0226: folds
RNixon'sHead: raises $2.88 to $4.37
EddieMoney9 said, "set?"
EddieMoney9: folds
Uncalled bet ($2.88) returned to RNixon'sHead
RNixon'sHead collected $3.59 from pot
RNixon'sHead: doesn't show hand
*** SUMMARY ***
Total pot $3.78 | Rake $0.19
Board [2h 7c 3c]
Seat 1: turk1120 folded before Flop (didn't bet)
Seat 2: PlayTheBlues4U folded before Flop (didn't bet)
Seat 3: RNixon'sHead collected ($3.59)
Seat 4: EddieMoney9 (button) folded on the Flop
Seat 5: GoodKnight1365 (small blind) folded before Flop
Seat 6: JDM0226 (big blind) folded on the Flop


PokerStars Hand #203841579617:  Hold'em No Limit ($0.02/$0.05 USD) - 2019/09/20 19:35:14 ET
Table 'Anser' 6-max Seat #3 is the button
Seat 1: CMc172 ($4.11 in chips)
Seat 2: UmmmYummy ($4.61 in chips)
Seat 3: dmakai ($6.15 in chips)
Seat 4: PlayTheBlues4U ($6.56 in chips)
Seat 5: lj001ll ($1.39 in chips)
PlayTheBlues4U: posts small blind $0.02
lj001ll: posts big blind $0.05
*** HOLE CARDS ***
Dealt to PlayTheBlues4U [3s Th]
CMc172: calls $0.05
UmmmYummy: calls $0.05
dmakai: folds
PlayTheBlues4U: folds
lj001ll: checks
*** FLOP *** [Jh 9h 6h]
lj001ll: checks
CMc172: checks
UmmmYummy: checks
*** TURN *** [Jh 9h 6h] [Tc]
lj001ll: bets $0.10
CMc172: calls $0.10
UmmmYummy: calls $0.10
*** RIVER *** [Jh 9h 6h Tc] [7c]
lj001ll: checks
CMc172: checks
UmmmYummy: bets $0.14
lj001ll: calls $0.14
CMc172: folds
*** SHOW DOWN ***
UmmmYummy: shows [Ah 8s] (a straight, Seven to Jack)
lj001ll: shows [2c 8c] (a straight, Seven to Jack)
lj001ll collected $0.36 from pot
UmmmYummy collected $0.35 from pot
*** SUMMARY ***
Total pot $0.75 | Rake $0.04
Board [Jh 9h 6h Tc 7c]
Seat 1: CMc172 folded on the River
Seat 2: UmmmYummy showed [Ah 8s] and won ($0.35) with a straight, Seven to Jack
Seat 3: dmakai (button) folded before Flop (didn't bet)
Seat 4: PlayTheBlues4U (small blind) folded before Flop
Seat 5: lj001ll (big blind) showed [2c 8c] and won ($0.36) with a straight, Seven to Jack


PokerStars Hand #203841579601:  Hold'em No Limit ($0.02/$0.05 USD) - 2019/09/20 19:35:05 ET
Table 'Anser' 6-max Seat #2 is the button
Seat 1: CMc172 ($4.11 in chips)
Seat 2: UmmmYummy ($4.61 in chips)
Seat 3: dmakai ($6.17 in chips)
Seat 4: PlayTheBlues4U ($6.54 in chips)
Seat 5: lj001ll ($1.39 in chips)
dmakai: posts small blind $0.02
PlayTheBlues4U: posts big blind $0.05
*** HOLE CARDS ***
Dealt to PlayTheBlues4U [7c Qc]
lj001ll: folds
CMc172: folds
UmmmYummy: folds
dmakai: folds
Uncalled bet ($0.03) returned to PlayTheBlues4U
PlayTheBlues4U collected $0.04 from pot
PlayTheBlues4U: doesn't show hand
*** SUMMARY ***
Total pot $0.04 | Rake $0
Seat 1: CMc172 folded before Flop (didn't bet)
Seat 2: UmmmYummy (button) folded before Flop (didn't bet)
Seat 3: dmakai (small blind) folded before Flop
Seat 4: PlayTheBlues4U (big blind) collected ($0.04)
Seat 5: lj001ll folded before Flop (didn't bet)


PokerStars Hand #203841579541:  Hold'em No Limit ($0.02/$0.05 USD) - 2019/09/20 19:34:36 ET
Table 'Anser' 6-max Seat #1 is the button
Seat 1: CMc172 ($4.11 in chips)
Seat 2: UmmmYummy ($4.63 in chips)
Seat 3: dmakai ($6.15 in chips)
Seat 4: PlayTheBlues4U ($6.54 in chips)
Seat 5: lj001ll ($1.39 in chips)
UmmmYummy: posts small blind $0.02
dmakai: posts big blind $0.05
*** HOLE CARDS ***
Dealt to PlayTheBlues4U [3s 9h]
PlayTheBlues4U: folds
lj001ll: folds
CMc172: folds
UmmmYummy: folds
Uncalled bet ($0.03) returned to dmakai
dmakai collected $0.04 from pot
dmakai: doesn't show hand
*** SUMMARY ***
Total pot $0.04 | Rake $0
Seat 1: CMc172 (button) folded before Flop (didn't bet)
Seat 2: UmmmYummy (small blind) folded before Flop
Seat 3: dmakai (big blind) collected ($0.04)
Seat 4: PlayTheBlues4U folded before Flop (didn't bet)
Seat 5: lj001ll folded before Flop (didn't bet)


PokerStars Hand #203841579535:  Hold'em No Limit ($0.05/$0.10 USD) - 2019/09/20 19:34:31 ET
Table 'Lacerta' 6-max Seat #3 is the button
Seat 1: turk1120 ($8.09 in chips)
Seat 2: PlayTheBlues4U ($9.37 in chips)
Seat 3: RNixon'sHead ($12.80 in chips)
Seat 4: EddieMoney9 ($10.17 in chips)
Seat 5: GoodKnight1365 ($16.09 in chips)
Seat 6: JDM0226 ($9.41 in chips)
EddieMoney9: posts small blind $0.05
GoodKnight1365: posts big blind $0.10
*** HOLE CARDS ***
Dealt to PlayTheBlues4U [9c 7h]
JDM0226: folds
turk1120: calls $0.10
PlayTheBlues4U: folds
RNixon'sHead: folds
EddieMoney9: raises $0.20 to $0.30
GoodKnight1365: calls $0.20
turk1120: calls $0.20
*** FLOP *** [Jd 2d Ts]
EddieMoney9: checks
GoodKnight1365: bets $0.40
turk1120: calls $0.40
EddieMoney9: folds
*** TURN *** [Jd 2d Ts] [8d]
GoodKnight1365: checks
turk1120: checks
*** RIVER *** [Jd 2d Ts 8d] [9d]
GoodKnight1365: checks
turk1120: bets $0.50
GoodKnight1365: folds
Uncalled bet ($0.50) returned to turk1120
turk1120 collected $1.62 from pot
*** SUMMARY ***
Total pot $1.70 | Rake $0.08
Board [Jd 2d Ts 8d 9d]
Seat 1: turk1120 collected ($1.62)
Seat 2: PlayTheBlues4U folded before Flop (didn't bet)
Seat 3: RNixon'sHead (button) folded before Flop (didn't bet)
Seat 4: EddieMoney9 (small blind) folded on the Flop
Seat 5: GoodKnight1365 (big blind) folded on the River
Seat 6: JDM0226 folded before Flop (didn't bet)


PokerStars Hand #203841579502:  Hold'em No Limit ($0.02/$0.05 USD) - 2019/09/20 19:34:12 ET
Table 'Anser' 6-max Seat #5 is the button
Seat 1: CMc172 ($4.16 in chips)
Seat 2: UmmmYummy ($4.58 in chips)
Seat 3: dmakai ($6.15 in chips)
Seat 4: PlayTheBlues4U ($6.54 in chips)
Seat 5: lj001ll ($1.39 in chips)
CMc172: posts small blind $0.02
UmmmYummy: posts big blind $0.05
*** HOLE CARDS ***
Dealt to PlayTheBlues4U [7s 8c]
dmakai: folds
PlayTheBlues4U: folds
lj001ll: folds
CMc172: calls $0.03
UmmmYummy: checks
*** FLOP *** [6d 4c 9d]
CMc172: checks
UmmmYummy: checks
*** TURN *** [6d 4c 9d] [3d]
CMc172: checks
UmmmYummy: bets $0.08
CMc172: folds
Uncalled bet ($0.08) returned to UmmmYummy
UmmmYummy collected $0.10 from pot
UmmmYummy: doesn't show hand
*** SUMMARY ***
Total pot $0.10 | Rake $0
Board [6d 4c 9d 3d]
Seat 1: CMc172 (small blind) folded on the Turn
Seat 2: UmmmYummy (big blind) collected ($0.10)
Seat 3: dmakai folded before Flop (didn't bet)
Seat 4: PlayTheBlues4U folded before Flop (didn't bet)
Seat 5: lj001ll (button) folded before Flop (didn't bet)


PokerStars Hand #203841579459:  Hold'em No Limit ($0.05/$0.10 USD) - 2019/09/20 19:33:52 ET
Table 'Lacerta' 6-max Seat #2 is the button
Seat 1: turk1120 ($8.39 in chips)
Seat 2: PlayTheBlues4U ($9.37 in chips)
Seat 3: RNixon'sHead ($12.85 in chips)
Seat 4: EddieMoney9 ($9.85 in chips)
Seat 5: GoodKnight1365 ($16.09 in chips)
Seat 6: JDM0226 ($9.41 in chips)
RNixon'sHead: posts small blind $0.05
EddieMoney9: posts big blind $0.10
*** HOLE CARDS ***
Dealt to PlayTheBlues4U [Qd 5h]
GoodKnight1365: folds
JDM0226: folds
turk1120: calls $0.10
PlayTheBlues4U: folds
RNixon'sHead: folds
EddieMoney9: raises $0.20 to $0.30
turk1120: calls $0.20
*** FLOP *** [Kh 8h Ac]
EddieMoney9: bets $0.40
turk1120: folds
Uncalled bet ($0.40) returned to EddieMoney9
EddieMoney9 collected $0.62 from pot
EddieMoney9: doesn't show hand
*** SUMMARY ***
Total pot $0.65 | Rake $0.03
Board [Kh 8h Ac]
Seat 1: turk1120 folded on the Flop
Seat 2: PlayTheBlues4U (button) folded before Flop (didn't bet)
Seat 3: RNixon'sHead (small blind) folded before Flop
Seat 4: EddieMoney9 (big blind) collected ($0.62)
Seat 5: GoodKnight1365 folded before Flop (didn't bet)
Seat 6: JDM0226 folded before Flop (didn't bet)


PokerStars Hand #203841579447:  Hold'em No Limit ($0.02/$0.05 USD) - 2019/09/20 19:33:44 ET
Table 'Anser' 6-max Seat #4 is the button
Seat 1: CMc172 ($4.21 in chips)
Seat 2: UmmmYummy ($4.42 in chips)
Seat 3: dmakai ($6.20 in chips)
Seat 4: PlayTheBlues4U ($6.54 in chips)
Seat 5: lj001ll ($1.41 in chips)
Seat 6: DemolishIT ($6.91 in chips)
lj001ll: posts small blind $0.02
DemolishIT: posts big blind $0.05
*** HOLE CARDS ***
Dealt to PlayTheBlues4U [3s 2d]
CMc172: calls $0.05
UmmmYummy: calls $0.05
dmakai: calls $0.05
PlayTheBlues4U: folds
lj001ll: folds
DemolishIT: checks
*** FLOP *** [9s 8h 5c]
DemolishIT: checks
CMc172: checks
UmmmYummy: bets $0.16
dmakai: folds
DemolishIT: folds
CMc172: folds
Uncalled bet ($0.16) returned to UmmmYummy
UmmmYummy collected $0.21 from pot
UmmmYummy: doesn't show hand
*** SUMMARY ***
Total pot $0.22 | Rake $0.01
Board [9s 8h 5c]
Seat 1: CMc172 folded on the Flop
Seat 2: UmmmYummy collected ($0.21)
Seat 3: dmakai folded on the Flop
Seat 4: PlayTheBlues4U (button) folded before Flop (didn't bet)
Seat 5: lj001ll (small blind) folded before Flop
Seat 6: DemolishIT (big blind) folded on the Flop


PokerStars Hand #203841579421:  Hold'em No Limit ($0.05/$0.10 USD) - 2019/09/20 19:33:31 ET
Table 'Lacerta' 6-max Seat #1 is the button
Seat 1: turk1120 ($8.39 in chips)
Seat 2: PlayTheBlues4U ($9.42 in chips)
Seat 3: RNixon'sHead ($12.95 in chips)
Seat 4: EddieMoney9 ($9.85 in chips)
Seat 5: GoodKnight1365 ($15.94 in chips)
Seat 6: JDM0226 ($9.41 in chips)
PlayTheBlues4U: posts small blind $0.05
RNixon'sHead: posts big blind $0.10
*** HOLE CARDS ***
Dealt to PlayTheBlues4U [Qd 7h]
EddieMoney9: folds
GoodKnight1365: raises $0.10 to $0.20
JDM0226: folds
turk1120: folds
PlayTheBlues4U: folds
RNixon'sHead: folds
Uncalled bet ($0.10) returned to GoodKnight1365
GoodKnight1365 collected $0.25 from pot
GoodKnight1365: doesn't show hand
*** SUMMARY ***
Total pot $0.25 | Rake $0
Seat 1: turk1120 (button) folded before Flop (didn't bet)
Seat 2: PlayTheBlues4U (small blind) folded before Flop
Seat 3: RNixon'sHead (big blind) folded before Flop
Seat 4: EddieMoney9 folded before Flop (didn't bet)
Seat 5: GoodKnight1365 collected ($0.25)
Seat 6: JDM0226 folded before Flop (didn't bet)


PokerStars Hand #203841579372:  Hold'em No Limit ($0.02/$0.05 USD) - 2019/09/20 19:33:08 ET
Table 'Anser' 6-max Seat #3 is the button
Seat 1: CMc172 ($4.21 in chips)
Seat 2: UmmmYummy ($4.42 in chips)
Seat 3: dmakai ($6.20 in chips)
Seat 4: PlayTheBlues4U ($6.31 in chips)
Seat 5: lj001ll ($1.46 in chips)
Seat 6: DemolishIT ($7.11 in chips)
PlayTheBlues4U: posts small blind $0.02
lj001ll: posts big blind $0.05
*** HOLE CARDS ***
Dealt to PlayTheBlues4U [6h 7h]
DemolishIT: raises $0.15 to $0.20
CMc172: folds
UmmmYummy: folds
dmakai: folds
PlayTheBlues4U: calls $0.18
lj001ll: folds
*** FLOP *** [Tc Ks Qh]
PlayTheBlues4U: checks
DemolishIT: checks
*** TURN *** [Tc Ks Qh] [4c]
PlayTheBlues4U: checks
DemolishIT: checks
*** RIVER *** [Tc Ks Qh 4c] [7s]
PlayTheBlues4U: checks
DemolishIT: checks
*** SHOW DOWN ***
PlayTheBlues4U: shows [6h 7h] (a pair of Sevens)
DemolishIT: mucks hand
PlayTheBlues4U collected $0.43 from pot
*** SUMMARY ***
Total pot $0.45 | Rake $0.02
Board [Tc Ks Qh 4c 7s]
Seat 1: CMc172 folded before Flop (didn't bet)
Seat 2: UmmmYummy folded before Flop (didn't bet)
Seat 3: dmakai (button) folded before Flop (didn't bet)
Seat 4: PlayTheBlues4U (small blind) showed [6h 7h] and won ($0.43) with a pair of Sevens
Seat 5: lj001ll (big blind) folded before Flop
Seat 6: DemolishIT mucked [3s As]


PokerStars Hand #203841579342:  Hold'em No Limit ($0.05/$0.10 USD) - 2019/09/20 19:32:55 ET
Table 'Lacerta' 6-max Seat #6 is the button
Seat 1: turk1120 ($7.98 in chips)
Seat 2: PlayTheBlues4U ($9.52 in chips)
Seat 3: RNixon'sHead ($13.30 in chips)
Seat 4: EddieMoney9 ($9.85 in chips)
Seat 5: GoodKnight1365 ($15.94 in chips)
Seat 6: JDM0226 ($9.41 in chips)
turk1120: posts small blind $0.05
PlayTheBlues4U: posts big blind $0.10
*** HOLE CARDS ***
Dealt to PlayTheBlues4U [Kh 9d]
RNixon'sHead: raises $0.15 to $0.25
EddieMoney9: folds
GoodKnight1365: folds
JDM0226: folds
turk1120: calls $0.20
PlayTheBlues4U: folds
*** FLOP *** [8d 6c 2d]
turk1120: bets $0.10
RNixon'sHead: calls $0.10
*** TURN *** [8d 6c 2d] [7s]
turk1120: bets $0.10
RNixon'sHead: folds
Uncalled bet ($0.10) returned to turk1120
turk1120 collected $0.76 from pot
*** SUMMARY ***
Total pot $0.80 | Rake $0.04
Board [8d 6c 2d 7s]
Seat 1: turk1120 (small blind) collected ($0.76)
Seat 2: PlayTheBlues4U (big blind) folded before Flop
Seat 3: RNixon'sHead folded on the Turn
Seat 4: EddieMoney9 folded before Flop (didn't bet)
Seat 5: GoodKnight1365 folded before Flop (didn't bet)
Seat 6: JDM0226 (button) folded before Flop (didn't bet)


PokerStars Hand #203841579264:  Hold'em No Limit ($0.05/$0.10 USD) - 2019/09/20 19:32:22 ET
Table 'Lacerta' 6-max Seat #5 is the button
Seat 1: turk1120 ($7.57 in chips)
Seat 2: PlayTheBlues4U ($9.52 in chips)
Seat 3: RNixon'sHead ($13.30 in chips)
Seat 4: EddieMoney9 ($9.85 in chips)
Seat 5: GoodKnight1365 ($16.34 in chips)
Seat 6: JDM0226 ($9.46 in chips)
JDM0226: posts small blind $0.05
turk1120: posts big blind $0.10
*** HOLE CARDS ***
Dealt to PlayTheBlues4U [8s Jd]
PlayTheBlues4U: folds
RNixon'sHead: folds
EddieMoney9: folds
GoodKnight1365: raises $0.10 to $0.20
JDM0226: folds
turk1120: calls $0.10
*** FLOP *** [2c 9d 3s]
turk1120: bets $0.10
GoodKnight1365: calls $0.10
*** TURN *** [2c 9d 3s] [Qd]
turk1120: bets $0.10
GoodKnight1365: calls $0.10
*** RIVER *** [2c 9d 3s Qd] [Jh]
turk1120: bets $0.20
GoodKnight1365: folds
Uncalled bet ($0.20) returned to turk1120
turk1120 collected $0.81 from pot
*** SUMMARY ***
Total pot $0.85 | Rake $0.04
Board [2c 9d 3s Qd Jh]
Seat 1: turk1120 (big blind) collected ($0.81)
Seat 2: PlayTheBlues4U folded before Flop (didn't bet)
Seat 3: RNixon'sHead folded before Flop (didn't bet)
Seat 4: EddieMoney9 folded before Flop (didn't bet)
Seat 5: GoodKnight1365 (button) folded on the River
Seat 6: JDM0226 (small blind) folded before Flop


PokerStars Hand #203841579241:  Hold'em No Limit ($0.02/$0.05 USD) - 2019/09/20 19:32:11 ET
Table 'Anser' 6-max Seat #2 is the button
Seat 1: CMc172 ($3.96 in chips)
Seat 2: UmmmYummy ($4.62 in chips)
Seat 3: dmakai ($6.22 in chips)
Seat 4: PlayTheBlues4U ($6.36 in chips)
Seat 6: DemolishIT ($7.11 in chips)
dmakai: posts small blind $0.02
PlayTheBlues4U: posts big blind $0.05
*** HOLE CARDS ***
Dealt to PlayTheBlues4U [3h 2h]
DemolishIT: folds
CMc172: calls $0.05
UmmmYummy: calls $0.05
dmakai: folds
PlayTheBlues4U: checks
*** FLOP *** [Kd Qc Ah]
PlayTheBlues4U: checks
CMc172: checks
UmmmYummy: checks
*** TURN *** [Kd Qc Ah] [7s]
PlayTheBlues4U: checks
CMc172: bets $0.10
UmmmYummy: calls $0.10
PlayTheBlues4U: folds
*** RIVER *** [Kd Qc Ah 7s] [4c]
CMc172: bets $0.05
UmmmYummy: calls $0.05
*** SHOW DOWN ***
CMc172: shows [Tc Qh] (a pair of Queens)
UmmmYummy: mucks hand
CMc172 collected $0.45 from pot
*** SUMMARY ***
Total pot $0.47 | Rake $0.02
Board [Kd Qc Ah 7s 4c]
Seat 1: CMc172 showed [Tc Qh] and won ($0.45) with a pair of Queens
Seat 2: UmmmYummy (button) mucked [7h 5h]
Seat 3: dmakai (small blind) folded before Flop
Seat 4: PlayTheBlues4U (big blind) folded on the Turn
Seat 6: DemolishIT folded before Flop (didn't bet)


PokerStars Hand #203841579203:  Hold'em No Limit ($0.05/$0.10 USD) - 2019/09/20 19:31:56 ET
Table 'Lacerta' 6-max Seat #4 is the button
Seat 1: turk1120 ($7.39 in chips)
Seat 2: PlayTheBlues4U ($9.52 in chips)
Seat 3: RNixon'sHead ($13.30 in chips)
Seat 4: EddieMoney9 ($9.85 in chips)
Seat 5: GoodKnight1365 ($16.44 in chips)
Seat 6: JDM0226 ($9.56 in chips)
GoodKnight1365: posts small blind $0.05
JDM0226: posts big blind $0.10
*** HOLE CARDS ***
Dealt to PlayTheBlues4U [6c Ts]
turk1120: calls $0.10
PlayTheBlues4U: folds
RNixon'sHead: folds
EddieMoney9: folds
GoodKnight1365: calls $0.05
JDM0226: checks
*** FLOP *** [5s 2d 2h]
GoodKnight1365: checks
JDM0226: checks
turk1120: bets $0.20
GoodKnight1365: folds
JDM0226: folds
Uncalled bet ($0.20) returned to turk1120
turk1120 collected $0.28 from pot
*** SUMMARY ***
Total pot $0.30 | Rake $0.02
Board [5s 2d 2h]
Seat 1: turk1120 collected ($0.28)
Seat 2: PlayTheBlues4U folded before Flop (didn't bet)
Seat 3: RNixon'sHead folded before Flop (didn't bet)
Seat 4: EddieMoney9 (button) folded before Flop (didn't bet)
Seat 5: GoodKnight1365 (small blind) folded on the Flop
Seat 6: JDM0226 (big blind) folded on the Flop


PokerStars Hand #203841579199:  Hold'em No Limit ($0.02/$0.05 USD) - 2019/09/20 19:31:54 ET
Table 'Anser' 6-max Seat #1 is the button
Seat 1: CMc172 ($4.01 in chips)
Seat 2: UmmmYummy ($4.53 in chips)
Seat 3: dmakai ($6.27 in chips)
Seat 4: PlayTheBlues4U ($6.36 in chips)
Seat 6: DemolishIT ($7.11 in chips)
UmmmYummy: posts small blind $0.02
dmakai: posts big blind $0.05
*** HOLE CARDS ***
Dealt to PlayTheBlues4U [4c Qh]
PlayTheBlues4U: folds
DemolishIT: folds
CMc172: calls $0.05
UmmmYummy: calls $0.03
dmakai: checks
*** FLOP *** [Qs As 8s]
UmmmYummy: bets $0.11
dmakai: folds
CMc172: folds
Uncalled bet ($0.11) returned to UmmmYummy
UmmmYummy collected $0.14 from pot
UmmmYummy: doesn't show hand
*** SUMMARY ***
Total pot $0.15 | Rake $0.01
Board [Qs As 8s]
Seat 1: CMc172 (button) folded on the Flop
Seat 2: UmmmYummy (small blind) collected ($0.14)
Seat 3: dmakai (big blind) folded on the Flop
Seat 4: PlayTheBlues4U folded before Flop (didn't bet)
Seat 6: DemolishIT folded before Flop (didn't bet)


PokerStars Hand #203841579122:  Hold'em No Limit ($0.05/$0.10 USD) - 2019/09/20 19:31:16 ET
Table 'Lacerta' 6-max Seat #3 is the button
Seat 1: turk1120 ($7.49 in chips)
Seat 2: PlayTheBlues4U ($9.82 in chips)
Seat 3: RNixon'sHead ($12.75 in chips)
Seat 4: EddieMoney9 ($9.90 in chips)
Seat 5: GoodKnight1365 ($16.54 in chips)
Seat 6: JDM0226 ($9.56 in chips)
EddieMoney9: posts small blind $0.05
GoodKnight1365: posts big blind $0.10
*** HOLE CARDS ***
Dealt to PlayTheBlues4U [Ah 9s]
JDM0226: folds
turk1120: calls $0.10
PlayTheBlues4U: raises $0.20 to $0.30
RNixon'sHead: raises $0.85 to $1.15
EddieMoney9: folds
GoodKnight1365: folds
turk1120: folds
PlayTheBlues4U: folds
Uncalled bet ($0.85) returned to RNixon'sHead
RNixon'sHead collected $0.85 from pot
RNixon'sHead: doesn't show hand
*** SUMMARY ***
Total pot $0.85 | Rake $0
Seat 1: turk1120 folded before Flop
Seat 2: PlayTheBlues4U folded before Flop
Seat 3: RNixon'sHead (button) collected ($0.85)
Seat 4: EddieMoney9 (small blind) folded before Flop
Seat 5: GoodKnight1365 (big blind) folded before Flop
Seat 6: JDM0226 folded before Flop (didn't bet)


PokerStars Hand #203841579074:  Hold'em No Limit ($0.02/$0.05 USD) - 2019/09/20 19:30:54 ET
Table 'Anser' 6-max Seat #6 is the button
Seat 1: CMc172 ($3.73 in chips)
Seat 2: UmmmYummy ($4.63 in chips)
Seat 3: dmakai ($6.27 in chips)
Seat 4: PlayTheBlues4U ($6.36 in chips)
Seat 5: lj001ll ($1.56 in chips)
Seat 6: DemolishIT ($7.21 in chips)
CMc172: posts small blind $0.02
UmmmYummy: posts big blind $0.05
*** HOLE CARDS ***
Dealt to PlayTheBlues4U [5h Qh]
dmakai: folds
PlayTheBlues4U: folds
lj001ll: raises $0.05 to $0.10
DemolishIT: calls $0.10
CMc172: calls $0.08
UmmmYummy: calls $0.05
*** FLOP *** [3c Th 2d]
CMc172: checks
UmmmYummy: checks
lj001ll: checks
DemolishIT: checks
*** TURN *** [3c Th 2d] [6d]
CMc172: bets $0.10
UmmmYummy: folds
lj001ll: folds
DemolishIT: folds
Uncalled bet ($0.10) returned to CMc172
CMc172 collected $0.38 from pot
CMc172: doesn't show hand
*** SUMMARY ***
Total pot $0.40 | Rake $0.02
Board [3c Th 2d 6d]
Seat 1: CMc172 (small blind) collected ($0.38)
Seat 2: UmmmYummy (big blind) folded on the Turn
Seat 3: dmakai folded before Flop (didn't bet)
Seat 4: PlayTheBlues4U folded before Flop (didn't bet)
Seat 5: lj001ll folded on the Turn
Seat 6: DemolishIT (button) folded on the Turn


PokerStars Hand #203841579003:  Hold'em No Limit ($0.02/$0.05 USD) - 2019/09/20 19:30:18 ET
Table 'Anser' 6-max Seat #5 is the button
Seat 1: CMc172 ($3.78 in chips)
Seat 2: UmmmYummy ($4.63 in chips)
Seat 3: dmakai ($6.32 in chips)
Seat 4: PlayTheBlues4U ($6.36 in chips)
Seat 5: lj001ll ($1.45 in chips)
Seat 6: DemolishIT ($7.23 in chips)
DemolishIT: posts small blind $0.02
CMc172: posts big blind $0.05
*** HOLE CARDS ***
Dealt to PlayTheBlues4U [Js 3c]
UmmmYummy: folds
dmakai: calls $0.05
PlayTheBlues4U: folds
lj001ll: calls $0.05
DemolishIT: folds
CMc172: checks
*** FLOP *** [Ks 9s Kd]
CMc172: checks
dmakai: checks
lj001ll: checks
*** TURN *** [Ks 9s Kd] [2h]
CMc172: checks
dmakai: checks
lj001ll: checks
*** RIVER *** [Ks 9s Kd 2h] [3s]
CMc172: checks
dmakai: checks
lj001ll: bets $0.05
CMc172: folds
dmakai: folds
Uncalled bet ($0.05) returned to lj001ll
lj001ll collected $0.16 from pot
lj001ll: doesn't show hand
*** SUMMARY ***
Total pot $0.17 | Rake $0.01
Board [Ks 9s Kd 2h 3s]
Seat 1: CMc172 (big blind) folded on the River
Seat 2: UmmmYummy folded before Flop (didn't bet)
Seat 3: dmakai folded on the River
Seat 4: PlayTheBlues4U folded before Flop (didn't bet)
Seat 5: lj001ll (button) collected ($0.16)
Seat 6: DemolishIT (small blind) folded before Flop


PokerStars Hand #203841578987:  Hold'em No Limit ($0.05/$0.10 USD) - 2019/09/20 19:30:11 ET
Table 'Lacerta' 6-max Seat #2 is the button
Seat 1: turk1120 ($7.08 in chips)
Seat 2: PlayTheBlues4U ($10.12 in chips)
Seat 3: RNixon'sHead ($12.80 in chips)
Seat 4: EddieMoney9 ($10 in chips)
Seat 5: GoodKnight1365 ($16.54 in chips)
Seat 6: JDM0226 ($9.56 in chips)
RNixon'sHead: posts small blind $0.05
EddieMoney9: posts big blind $0.10
*** HOLE CARDS ***
Dealt to PlayTheBlues4U [9h Ts]
GoodKnight1365: folds
JDM0226: folds
turk1120: calls $0.10
PlayTheBlues4U: calls $0.10
RNixon'sHead: folds
EddieMoney9: checks
*** FLOP *** [7s 3d 7c]
EddieMoney9: checks
turk1120: bets $0.20
PlayTheBlues4U: calls $0.20
EddieMoney9: folds
*** TURN *** [7s 3d 7c] [6s]
turk1120: checks
PlayTheBlues4U: checks
*** RIVER *** [7s 3d 7c 6s] [5d]
turk1120: bets $0.10
PlayTheBlues4U: folds
Uncalled bet ($0.10) returned to turk1120
turk1120 collected $0.71 from pot
*** SUMMARY ***
Total pot $0.75 | Rake $0.04
Board [7s 3d 7c 6s 5d]
Seat 1: turk1120 collected ($0.71)
Seat 2: PlayTheBlues4U (button) folded on the River
Seat 3: RNixon'sHead (small blind) folded before Flop
Seat 4: EddieMoney9 (big blind) folded on the Flop
Seat 5: GoodKnight1365 folded before Flop (didn't bet)
Seat 6: JDM0226 folded before Flop (didn't bet)


PokerStars Hand #203841578917:  Hold'em No Limit ($0.02/$0.05 USD) - 2019/09/20 19:29:36 ET
Table 'Anser' 6-max Seat #4 is the button
Seat 1: CMc172 ($3.83 in chips)
Seat 2: UmmmYummy ($4.63 in chips)
Seat 3: dmakai ($6.37 in chips)
Seat 4: PlayTheBlues4U ($6.36 in chips)
Seat 5: lj001ll ($1.47 in chips)
Seat 6: DemolishIT ($7.12 in chips)
lj001ll: posts small blind $0.02
DemolishIT: posts big blind $0.05
*** HOLE CARDS ***
Dealt to PlayTheBlues4U [Qc 4d]
CMc172: calls $0.05
UmmmYummy: folds
dmakai: calls $0.05
PlayTheBlues4U: folds
lj001ll: folds
DemolishIT: checks
*** FLOP *** [9s 9h Qs]
DemolishIT: checks
CMc172: checks
dmakai: checks
*** TURN *** [9s 9h Qs] [Ah]
DemolishIT: bets $0.16
CMc172 is disconnected
CMc172 is connected
CMc172: folds
dmakai: folds
Uncalled bet ($0.16) returned to DemolishIT
DemolishIT collected $0.16 from pot
DemolishIT: doesn't show hand
*** SUMMARY ***
Total pot $0.17 | Rake $0.01
Board [9s 9h Qs Ah]
Seat 1: CMc172 folded on the Turn
Seat 2: UmmmYummy folded before Flop (didn't bet)
Seat 3: dmakai folded on the Turn
Seat 4: PlayTheBlues4U (button) folded before Flop (didn't bet)
Seat 5: lj001ll (small blind) folded before Flop
Seat 6: DemolishIT (big blind) collected ($0.16)


PokerStars Hand #203841578858:  Hold'em No Limit ($0.02/$0.05 USD) - 2019/09/20 19:29:07 ET
Table 'Anser' 6-max Seat #3 is the button
Seat 1: CMc172 ($3.93 in chips)
Seat 2: UmmmYummy ($4.63 in chips)
Seat 3: dmakai ($6.17 in chips)
Seat 4: PlayTheBlues4U ($6.38 in chips)
Seat 5: lj001ll ($1.57 in chips)
Seat 6: DemolishIT ($7.12 in chips)
PlayTheBlues4U: posts small blind $0.02
lj001ll: posts big blind $0.05
*** HOLE CARDS ***
Dealt to PlayTheBlues4U [9d 2s]
DemolishIT: folds
CMc172: calls $0.05
UmmmYummy: folds
dmakai: raises $0.05 to $0.10
PlayTheBlues4U: folds
lj001ll: calls $0.05
CMc172: calls $0.05
*** FLOP *** [8c 7s Qs]
lj001ll: checks
CMc172: checks
dmakai: bets $0.30
lj001ll: folds
CMc172: folds
Uncalled bet ($0.30) returned to dmakai
dmakai collected $0.30 from pot
dmakai: doesn't show hand
*** SUMMARY ***
Total pot $0.32 | Rake $0.02
Board [8c 7s Qs]
Seat 1: CMc172 folded on the Flop
Seat 2: UmmmYummy folded before Flop (didn't bet)
Seat 3: dmakai (button) collected ($0.30)
Seat 4: PlayTheBlues4U (small blind) folded before Flop
Seat 5: lj001ll (big blind) folded on the Flop
Seat 6: DemolishIT folded before Flop (didn't bet)


PokerStars Hand #203841578836:  Hold'em No Limit ($0.05/$0.10 USD) - 2019/09/20 19:29:00 ET
Table 'Lacerta' 6-max Seat #1 is the button
Seat 1: turk1120 ($7.78 in chips)
Seat 2: PlayTheBlues4U ($9.40 in chips)
Seat 3: RNixon'sHead ($12.90 in chips)
Seat 5: GoodKnight1365 ($16.54 in chips)
Seat 6: JDM0226 ($9.56 in chips)
PlayTheBlues4U: posts small blind $0.05
RNixon'sHead: posts big blind $0.10
EddieMoney9: sits out
*** HOLE CARDS ***
Dealt to PlayTheBlues4U [8c 6d]
GoodKnight1365: folds
JDM0226: folds
turk1120: calls $0.10
PlayTheBlues4U: calls $0.05
RNixon'sHead: checks
*** FLOP *** [Jc 6s 4s]
PlayTheBlues4U: checks
RNixon'sHead: checks
turk1120: bets $0.10
PlayTheBlues4U: calls $0.10
RNixon'sHead: folds
*** TURN *** [Jc 6s 4s] [2h]
PlayTheBlues4U: checks
turk1120: bets $0.10
PlayTheBlues4U: calls $0.10
*** RIVER *** [Jc 6s 4s 2h] [8h]
PlayTheBlues4U: checks
turk1120: bets $0.10
PlayTheBlues4U: raises $0.30 to $0.40
turk1120: calls $0.30
*** SHOW DOWN ***
PlayTheBlues4U: shows [8c 6d] (two pair, Eights and Sixes)
turk1120: mucks hand
PlayTheBlues4U collected $1.42 from pot
*** SUMMARY ***
Total pot $1.50 | Rake $0.08
Board [Jc 6s 4s 2h 8h]
Seat 1: turk1120 (button) mucked [7s Jd]
Seat 2: PlayTheBlues4U (small blind) showed [8c 6d] and won ($1.42) with two pair, Eights and Sixes
Seat 3: RNixon'sHead (big blind) folded on the Flop
Seat 5: GoodKnight1365 folded before Flop (didn't bet)
Seat 6: JDM0226 folded before Flop (didn't bet)


PokerStars Hand #203841578785:  Hold'em No Limit ($0.02/$0.05 USD) - 2019/09/20 19:28:34 ET
Table 'Anser' 6-max Seat #2 is the button
Seat 1: CMc172 ($3.93 in chips)
Seat 2: UmmmYummy ($4.16 in chips)
Seat 3: dmakai ($6.19 in chips)
Seat 4: PlayTheBlues4U ($6.43 in chips)
Seat 5: lj001ll ($1.57 in chips)
Seat 6: DemolishIT ($7.52 in chips)
dmakai: posts small blind $0.02
PlayTheBlues4U: posts big blind $0.05
*** HOLE CARDS ***
Dealt to PlayTheBlues4U [2s Tc]
lj001ll: folds
DemolishIT: raises $0.35 to $0.40
CMc172: folds
UmmmYummy: raises $3.76 to $4.16 and is all-in
dmakai: folds
PlayTheBlues4U: folds
DemolishIT: folds
Uncalled bet ($3.76) returned to UmmmYummy
UmmmYummy collected $0.87 from pot
UmmmYummy: doesn't show hand
*** SUMMARY ***
Total pot $0.87 | Rake $0
Seat 1: CMc172 folded before Flop (didn't bet)
Seat 2: UmmmYummy (button) collected ($0.87)
Seat 3: dmakai (small blind) folded before Flop
Seat 4: PlayTheBlues4U (big blind) folded before Flop
Seat 5: lj001ll folded before Flop (didn't bet)
Seat 6: DemolishIT folded before Flop


PokerStars Hand #203841578759:  Hold'em No Limit ($0.05/$0.10 USD) - 2019/09/20 19:28:22 ET
Table 'Lacerta' 6-max Seat #6 is the button
Seat 1: turk1120 ($7.98 in chips)
Seat 2: PlayTheBlues4U ($9.22 in chips)
Seat 3: RNixon'sHead ($12.90 in chips)
Seat 4: Pergy21 ($1.06 in chips)
Seat 5: GoodKnight1365 ($16.54 in chips)
Seat 6: JDM0226 ($9.56 in chips)
turk1120: posts small blind $0.05
PlayTheBlues4U: posts big blind $0.10
*** HOLE CARDS ***
Dealt to PlayTheBlues4U [8s 7s]
RNixon'sHead: folds
Pergy21: folds
Pergy21 leaves the table
GoodKnight1365: folds
JDM0226: folds
PlayTheBlues4U said, "he is right!"
turk1120: calls $0.05
EddieMoney9 joins the table at seat #4
PlayTheBlues4U: checks
*** FLOP *** [Jc 4c 8c]
turk1120: checks
PlayTheBlues4U: checks
*** TURN *** [Jc 4c 8c] [Js]
turk1120: checks
PlayTheBlues4U: bets $0.10
turk1120: calls $0.10
*** RIVER *** [Jc 4c 8c Js] [7h]
turk1120: checks
PlayTheBlues4U: checks
*** SHOW DOWN ***
turk1120: shows [Qd Kh] (a pair of Jacks)
PlayTheBlues4U: shows [8s 7s] (two pair, Jacks and Eights)
PlayTheBlues4U collected $0.38 from pot
*** SUMMARY ***
Total pot $0.40 | Rake $0.02
Board [Jc 4c 8c Js 7h]
Seat 1: turk1120 (small blind) showed [Qd Kh] and lost with a pair of Jacks
Seat 2: PlayTheBlues4U (big blind) showed [8s 7s] and won ($0.38) with two pair, Jacks and Eights
Seat 3: RNixon'sHead folded before Flop (didn't bet)
Seat 4: Pergy21 folded before Flop (didn't bet)
Seat 5: GoodKnight1365 folded before Flop (didn't bet)
Seat 6: JDM0226 (button) folded before Flop (didn't bet)


PokerStars Hand #203841578733:  Hold'em No Limit ($0.02/$0.05 USD) - 2019/09/20 19:28:08 ET
Table 'Anser' 6-max Seat #1 is the button
Seat 1: CMc172 ($3.98 in chips)
Seat 2: UmmmYummy ($4.18 in chips)
Seat 3: dmakai ($6.13 in chips)
Seat 4: PlayTheBlues4U ($6.43 in chips)
Seat 5: lj001ll ($1.57 in chips)
Seat 6: DemolishIT ($7.52 in chips)
UmmmYummy: posts small blind $0.02
dmakai: posts big blind $0.05
*** HOLE CARDS ***
Dealt to PlayTheBlues4U [Js Tc]
PlayTheBlues4U: folds
lj001ll: folds
DemolishIT: folds
CMc172: calls $0.05
UmmmYummy: folds
dmakai: checks
*** FLOP *** [9c 4c 8h]
dmakai: checks
CMc172: checks
*** TURN *** [9c 4c 8h] [6s]
dmakai: bets $0.05
CMc172: folds
Uncalled bet ($0.05) returned to dmakai
dmakai collected $0.11 from pot
dmakai: doesn't show hand
*** SUMMARY ***
Total pot $0.12 | Rake $0.01
Board [9c 4c 8h 6s]
Seat 1: CMc172 (button) folded on the Turn
Seat 2: UmmmYummy (small blind) folded before Flop
Seat 3: dmakai (big blind) collected ($0.11)
Seat 4: PlayTheBlues4U folded before Flop (didn't bet)
Seat 5: lj001ll folded before Flop (didn't bet)
Seat 6: DemolishIT folded before Flop (didn't bet)


PokerStars Hand #203841578650:  Hold'em No Limit ($0.02/$0.05 USD) - 2019/09/20 19:27:29 ET
Table 'Anser' 6-max Seat #6 is the button
Seat 1: CMc172 ($4.08 in chips)
Seat 2: UmmmYummy ($4 in chips)
Seat 3: dmakai ($6.13 in chips)
Seat 4: PlayTheBlues4U ($6.43 in chips)
Seat 5: lj001ll ($1.67 in chips)
Seat 6: DemolishIT ($7.52 in chips)
CMc172: posts small blind $0.02
UmmmYummy: posts big blind $0.05
*** HOLE CARDS ***
Dealt to PlayTheBlues4U [Qh 4c]
dmakai: folds
PlayTheBlues4U: folds
lj001ll: raises $0.05 to $0.10
DemolishIT: folds
CMc172: calls $0.08
UmmmYummy: calls $0.05
*** FLOP *** [7s 3d 8h]
CMc172: checks
UmmmYummy: checks
lj001ll: checks
*** TURN *** [7s 3d 8h] [Th]
CMc172: checks
UmmmYummy: checks
lj001ll: checks
*** RIVER *** [7s 3d 8h Th] [2c]
CMc172: checks
UmmmYummy: checks
lj001ll: checks
*** SHOW DOWN ***
CMc172: shows [5h 6s] (high card Ten)
UmmmYummy: shows [2h Kc] (a pair of Deuces)
lj001ll: mucks hand
UmmmYummy collected $0.28 from pot
*** SUMMARY ***
Total pot $0.30 | Rake $0.02
Board [7s 3d 8h Th 2c]
Seat 1: CMc172 (small blind) showed [5h 6s] and lost with high card Ten
Seat 2: UmmmYummy (big blind) showed [2h Kc] and won ($0.28) with a pair of Deuces
Seat 3: dmakai folded before Flop (didn't bet)
Seat 4: PlayTheBlues4U folded before Flop (didn't bet)
Seat 5: lj001ll mucked [Qd Ah]
Seat 6: DemolishIT (button) folded before Flop (didn't bet)


PokerStars Hand #203841578583:  Hold'em No Limit ($0.02/$0.05 USD) - 2019/09/20 19:26:49 ET
Table 'Anser' 6-max Seat #5 is the button
Seat 1: CMc172 ($4.23 in chips)
Seat 3: dmakai ($6.28 in chips)
Seat 4: PlayTheBlues4U ($6.43 in chips)
Seat 5: lj001ll ($1.37 in chips)
Seat 6: DemolishIT ($7.54 in chips)
DemolishIT: posts small blind $0.02
CMc172: posts big blind $0.05
UmmmYummy: sits out
*** HOLE CARDS ***
Dealt to PlayTheBlues4U [7s 9c]
dmakai: raises $0.10 to $0.15
PlayTheBlues4U: folds
lj001ll: calls $0.15
DemolishIT: folds
CMc172: calls $0.10
*** FLOP *** [8c 4d Td]
CMc172: checks
dmakai: checks
lj001ll: checks
*** TURN *** [8c 4d Td] [9d]
CMc172: checks
dmakai: checks
lj001ll: bets $0.23
CMc172: folds
dmakai: folds
Uncalled bet ($0.23) returned to lj001ll
lj001ll collected $0.45 from pot
lj001ll: doesn't show hand
*** SUMMARY ***
Total pot $0.47 | Rake $0.02
Board [8c 4d Td 9d]
Seat 1: CMc172 (big blind) folded on the Turn
Seat 3: dmakai folded on the Turn
Seat 4: PlayTheBlues4U folded before Flop (didn't bet)
Seat 5: lj001ll (button) collected ($0.45)
Seat 6: DemolishIT (small blind) folded before Flop


PokerStars Hand #203841578524:  Hold'em No Limit ($0.05/$0.10 USD) - 2019/09/20 19:26:17 ET
Table 'Lacerta' 6-max Seat #5 is the button
Seat 1: turk1120 ($8.18 in chips)
Seat 2: PlayTheBlues4U ($9.22 in chips)
Seat 3: RNixon'sHead ($12.90 in chips)
Seat 4: Pergy21 ($8.16 in chips)
Seat 5: GoodKnight1365 ($9.91 in chips)
Seat 6: JDM0226 ($9.61 in chips)
JDM0226: posts small blind $0.05
turk1120: posts big blind $0.10
*** HOLE CARDS ***
Dealt to PlayTheBlues4U [7s Kc]
PlayTheBlues4U: folds
RNixon'sHead: folds
Pergy21: raises $0.10 to $0.20
GoodKnight1365: calls $0.20
JDM0226: folds
turk1120: calls $0.10
*** FLOP *** [4d Ts Ad]
turk1120: checks
turk1120 said, "/////////////////"
Pergy21: bets $0.30
GoodKnight1365: raises $0.60 to $0.90
turk1120 said, "///////////////////////////////////////////////////////////////////////////"
turk1120: folds
Pergy21: calls $0.60
*** TURN *** [4d Ts Ad] [Qh]
Pergy21: checks
GoodKnight1365: bets $1.20
RNixon'sHead said, "\ is better"
Pergy21: raises $1.80 to $3
GoodKnight1365: calls $1.80
*** RIVER *** [4d Ts Ad Qh] [Tc]
Pergy21: checks
GoodKnight1365: bets $3
Pergy21: calls $3
*** SHOW DOWN ***
GoodKnight1365: shows [As Th] (a full house, Tens full of Aces)
PlayTheBlues4U said, "\\\\\\\\\\\\"
Pergy21: shows [Qs Ac] (two pair, Aces and Queens)
GoodKnight1365 collected $13.73 from pot
*** SUMMARY ***
Total pot $14.45 | Rake $0.72
Board [4d Ts Ad Qh Tc]
Seat 1: turk1120 (big blind) folded on the Flop
Seat 2: PlayTheBlues4U folded before Flop (didn't bet)
Seat 3: RNixon'sHead folded before Flop (didn't bet)
Seat 4: Pergy21 showed [Qs Ac] and lost with two pair, Aces and Queens
Seat 5: GoodKnight1365 (button) showed [As Th] and won ($13.73) with a full house, Tens full of Aces
Seat 6: JDM0226 (small blind) folded before Flop


PokerStars Hand #203841578520:  Hold'em No Limit ($0.02/$0.05 USD) - 2019/09/20 19:26:14 ET
Table 'Anser' 6-max Seat #4 is the button
Seat 1: CMc172 ($4.23 in chips)
Seat 3: dmakai ($6.28 in chips)
Seat 4: PlayTheBlues4U ($6.88 in chips)
Seat 5: lj001ll ($1.39 in chips)
Seat 6: DemolishIT ($7.12 in chips)
lj001ll: posts small blind $0.02
DemolishIT: posts big blind $0.05
UmmmYummy: sits out
*** HOLE CARDS ***
Dealt to PlayTheBlues4U [7s 7c]
CMc172: folds
dmakai: folds
PlayTheBlues4U: raises $0.10 to $0.15
lj001ll: folds
DemolishIT: calls $0.10
*** FLOP *** [8s Jc 9c]
DemolishIT: checks
PlayTheBlues4U: checks
*** TURN *** [8s Jc 9c] [6c]
DemolishIT: bets $0.30
PlayTheBlues4U: calls $0.30
*** RIVER *** [8s Jc 9c 6c] [Qs]
DemolishIT: checks
PlayTheBlues4U: checks
*** SHOW DOWN ***
DemolishIT: shows [7d 5s] (a straight, Five to Nine)
PlayTheBlues4U: mucks hand
DemolishIT collected $0.87 from pot
*** SUMMARY ***
Total pot $0.92 | Rake $0.05
Board [8s Jc 9c 6c Qs]
Seat 1: CMc172 folded before Flop (didn't bet)
Seat 3: dmakai folded before Flop (didn't bet)
Seat 4: PlayTheBlues4U (button) mucked [7s 7c]
Seat 5: lj001ll (small blind) folded before Flop
Seat 6: DemolishIT (big blind) showed [7d 5s] and won ($0.87) with a straight, Five to Nine


PokerStars Hand #203841578403:  Hold'em No Limit ($0.02/$0.05 USD) - 2019/09/20 19:25:18 ET
Table 'Anser' 6-max Seat #3 is the button
Seat 1: CMc172 ($4.43 in chips)
Seat 2: Star6543 ($2.88 in chips)
Seat 3: dmakai ($5.53 in chips)
Seat 4: PlayTheBlues4U ($6.90 in chips)
Seat 5: lj001ll ($1.44 in chips)
Seat 6: DemolishIT ($7.67 in chips)
PlayTheBlues4U: posts small blind $0.02
lj001ll: posts big blind $0.05
*** HOLE CARDS ***
Dealt to PlayTheBlues4U [2h 3s]
Star6543 said, "gh"
DemolishIT: calls $0.05
CMc172: calls $0.05
Star6543: folds
dmakai: raises $0.15 to $0.20
PlayTheBlues4U: folds
lj001ll: folds
DemolishIT: calls $0.15
CMc172: calls $0.15
*** FLOP *** [Td 7s 7c]
DemolishIT: checks
CMc172: checks
dmakai: bets $0.35
DemolishIT: calls $0.35
Star6543 leaves the table
CMc172: folds
*** TURN *** [Td 7s 7c] [Ts]
UmmmYummy joins the table at seat #2
DemolishIT: checks
dmakai: checks
*** RIVER *** [Td 7s 7c Ts] [Qc]
DemolishIT: checks
dmakai: checks
*** SHOW DOWN ***
DemolishIT: shows [9c 6c] (two pair, Tens and Sevens)
dmakai: shows [Kc Kd] (two pair, Kings and Tens)
dmakai collected $1.30 from pot
*** SUMMARY ***
Total pot $1.37 | Rake $0.07
Board [Td 7s 7c Ts Qc]
Seat 1: CMc172 folded on the Flop
Seat 2: Star6543 folded before Flop (didn't bet)
Seat 3: dmakai (button) showed [Kc Kd] and won ($1.30) with two pair, Kings and Tens
Seat 4: PlayTheBlues4U (small blind) folded before Flop
Seat 5: lj001ll (big blind) folded before Flop
Seat 6: DemolishIT showed [9c 6c] and lost with two pair, Tens and Sevens


PokerStars Hand #203841578385:  Hold'em No Limit ($0.05/$0.10 USD) - 2019/09/20 19:25:11 ET
Table 'Lacerta' 6-max Seat #4 is the button
Seat 1: turk1120 ($6.82 in chips)
Seat 2: PlayTheBlues4U ($9.22 in chips)
Seat 3: RNixon'sHead ($12.90 in chips)
Seat 4: Pergy21 ($8.16 in chips)
Seat 5: GoodKnight1365 ($11.31 in chips)
Seat 6: JDM0226 ($9.71 in chips)
GoodKnight1365: posts small blind $0.05
JDM0226: posts big blind $0.10
*** HOLE CARDS ***
Dealt to PlayTheBlues4U [4s 8c]
turk1120: calls $0.10
PlayTheBlues4U: folds
RNixon'sHead: folds
Pergy21: folds
GoodKnight1365: raises $0.20 to $0.30
JDM0226: folds
turk1120: calls $0.20
*** FLOP *** [4c 9d Kd]
GoodKnight1365: checks
turk1120: bets $0.30
GoodKnight1365: calls $0.30
*** TURN *** [4c 9d Kd] [Ks]
GoodKnight1365: checks
turk1120: bets $0.10
GoodKnight1365: raises $0.70 to $0.80
turk1120: calls $0.70
*** RIVER *** [4c 9d Kd Ks] [2d]
GoodKnight1365: checks
turk1120: checks
*** SHOW DOWN ***
GoodKnight1365: shows [Jh Ad] (a pair of Kings)
turk1120: shows [Qh Qs] (two pair, Kings and Queens)
turk1120 collected $2.76 from pot
*** SUMMARY ***
Total pot $2.90 | Rake $0.14
Board [4c 9d Kd Ks 2d]
Seat 1: turk1120 showed [Qh Qs] and won ($2.76) with two pair, Kings and Queens
Seat 2: PlayTheBlues4U folded before Flop (didn't bet)
Seat 3: RNixon'sHead folded before Flop (didn't bet)
Seat 4: Pergy21 (button) folded before Flop (didn't bet)
Seat 5: GoodKnight1365 (small blind) showed [Jh Ad] and lost with a pair of Kings
Seat 6: JDM0226 (big blind) folded before Flop


PokerStars Hand #203841578347:  Hold'em No Limit ($0.05/$0.10 USD) - 2019/09/20 19:24:43 ET
Table 'Lacerta' 6-max Seat #3 is the button
Seat 1: turk1120 ($6.82 in chips)
Seat 2: PlayTheBlues4U ($9.22 in chips)
Seat 3: RNixon'sHead ($12.58 in chips)
Seat 4: Pergy21 ($8.41 in chips)
Seat 5: GoodKnight1365 ($11.41 in chips)
Seat 6: JDM0226 ($9.71 in chips)
Pergy21: posts small blind $0.05
GoodKnight1365: posts big blind $0.10
*** HOLE CARDS ***
Dealt to PlayTheBlues4U [4c 8h]
JDM0226: folds
turk1120: folds
PlayTheBlues4U: folds
RNixon'sHead: raises $0.15 to $0.25
Pergy21: calls $0.20
GoodKnight1365: folds
*** FLOP *** [Js 9h Jh]
Pergy21: checks
RNixon'sHead: bets $0.25
Pergy21: folds
Uncalled bet ($0.25) returned to RNixon'sHead
RNixon'sHead collected $0.57 from pot
RNixon'sHead: doesn't show hand
*** SUMMARY ***
Total pot $0.60 | Rake $0.03
Board [Js 9h Jh]
Seat 1: turk1120 folded before Flop (didn't bet)
Seat 2: PlayTheBlues4U folded before Flop (didn't bet)
Seat 3: RNixon'sHead (button) collected ($0.57)
Seat 4: Pergy21 (small blind) folded on the Flop
Seat 5: GoodKnight1365 (big blind) folded before Flop
Seat 6: JDM0226 folded before Flop (didn't bet)


PokerStars Hand #203841578323:  Hold'em No Limit ($0.02/$0.05 USD) - 2019/09/20 19:24:31 ET
Table 'Anser' 6-max Seat #2 is the button
Seat 1: CMc172 ($4.43 in chips)
Seat 2: Star6543 ($1.48 in chips)
Seat 3: dmakai ($5.55 in chips)
Seat 4: PlayTheBlues4U ($6.95 in chips)
Seat 5: lj001ll ($2.92 in chips)
Seat 6: DemolishIT ($7.67 in chips)
dmakai: posts small blind $0.02
PlayTheBlues4U: posts big blind $0.05
*** HOLE CARDS ***
Dealt to PlayTheBlues4U [6d 4s]
lj001ll: raises $0.15 to $0.20
DemolishIT: folds
CMc172: folds
Star6543: raises $0.30 to $0.50
dmakai: folds
PlayTheBlues4U: folds
lj001ll: calls $0.30
*** FLOP *** [Qc 3h Td]
lj001ll: checks
Star6543: bets $0.15
lj001ll: calls $0.15
*** TURN *** [Qc 3h Td] [Jd]
lj001ll: bets $1.83
Star6543: calls $0.83 and is all-in
Uncalled bet ($1) returned to lj001ll
*** RIVER *** [Qc 3h Td Jd] [Jc]
*** SHOW DOWN ***
lj001ll: shows [Kh As] (a straight, Ten to Ace)
Star6543: shows [Th Tc] (a full house, Tens full of Jacks)
Star6543 collected $2.88 from pot
*** SUMMARY ***
Total pot $3.03 | Rake $0.15
Board [Qc 3h Td Jd Jc]
Seat 1: CMc172 folded before Flop (didn't bet)
Seat 2: Star6543 (button) showed [Th Tc] and won ($2.88) with a full house, Tens full of Jacks
Seat 3: dmakai (small blind) folded before Flop
Seat 4: PlayTheBlues4U (big blind) folded before Flop
Seat 5: lj001ll showed [Kh As] and lost with a straight, Ten to Ace
Seat 6: DemolishIT folded before Flop (didn't bet)


PokerStars Hand #203841578292:  Hold'em No Limit ($0.05/$0.10 USD) - 2019/09/20 19:24:16 ET
Table 'Lacerta' 6-max Seat #2 is the button
Seat 1: turk1120 ($7.22 in chips)
Seat 2: PlayTheBlues4U ($9.22 in chips)
Seat 3: RNixon'sHead ($12.63 in chips)
Seat 4: Pergy21 ($8 in chips)
Seat 5: GoodKnight1365 ($11.41 in chips)
Seat 6: JDM0226 ($9.71 in chips)
RNixon'sHead: posts small blind $0.05
Pergy21: posts big blind $0.10
*** HOLE CARDS ***
Dealt to PlayTheBlues4U [3h 6c]
GoodKnight1365: folds
JDM0226: folds
turk1120: calls $0.10
PlayTheBlues4U: folds
RNixon'sHead: folds
Pergy21: checks
*** FLOP *** [Kc Ts 7d]
Pergy21: bets $0.10
turk1120: calls $0.10
*** TURN *** [Kc Ts 7d] [2h]
Pergy21: bets $0.10
turk1120: calls $0.10
*** RIVER *** [Kc Ts 7d 2h] [4s]
Pergy21: bets $0.10
turk1120: calls $0.10
*** SHOW DOWN ***
Pergy21: shows [Ac Th] (a pair of Tens)
turk1120: mucks hand
Pergy21 collected $0.81 from pot
*** SUMMARY ***
Total pot $0.85 | Rake $0.04
Board [Kc Ts 7d 2h 4s]
Seat 1: turk1120 mucked [9h Qd]
Seat 2: PlayTheBlues4U (button) folded before Flop (didn't bet)
Seat 3: RNixon'sHead (small blind) folded before Flop
Seat 4: Pergy21 (big blind) showed [Ac Th] and won ($0.81) with a pair of Tens
Seat 5: GoodKnight1365 folded before Flop (didn't bet)
Seat 6: JDM0226 folded before Flop (didn't bet)


PokerStars Hand #203841578214:  Hold'em No Limit ($0.02/$0.05 USD) - 2019/09/20 19:23:35 ET
Table 'Anser' 6-max Seat #1 is the button
Seat 1: CMc172 ($4.63 in chips)
Seat 2: Star6543 ($1.68 in chips)
Seat 3: dmakai ($5.65 in chips)
Seat 4: PlayTheBlues4U ($6.95 in chips)
Seat 5: lj001ll ($2.46 in chips)
Seat 6: DemolishIT ($7.67 in chips)
Star6543: posts small blind $0.02
dmakai: posts big blind $0.05
*** HOLE CARDS ***
Dealt to PlayTheBlues4U [Qs 2c]
PlayTheBlues4U: folds
lj001ll: calls $0.05
DemolishIT: folds
CMc172: calls $0.05
Star6543: calls $0.03
dmakai: checks
*** FLOP *** [8c Ad Jh]
Star6543: checks
dmakai: checks
lj001ll: bets $0.05
CMc172: calls $0.05
Star6543: calls $0.05
dmakai: calls $0.05
*** TURN *** [8c Ad Jh] [4h]
Star6543: checks
dmakai: checks
lj001ll: bets $0.10
CMc172: calls $0.10
Star6543: calls $0.10
dmakai: folds
*** RIVER *** [8c Ad Jh 4h] [Js]
Star6543: checks
lj001ll: bets $0.33
CMc172: folds
Star6543: folds
Uncalled bet ($0.33) returned to lj001ll
lj001ll collected $0.66 from pot
lj001ll: doesn't show hand
*** SUMMARY ***
Total pot $0.70 | Rake $0.04
Board [8c Ad Jh 4h Js]
Seat 1: CMc172 (button) folded on the River
Seat 2: Star6543 (small blind) folded on the River
Seat 3: dmakai (big blind) folded on the Turn
Seat 4: PlayTheBlues4U folded before Flop (didn't bet)
Seat 5: lj001ll collected ($0.66)
Seat 6: DemolishIT folded before Flop (didn't bet)


PokerStars Hand #203841578180:  Hold'em No Limit ($0.05/$0.10 USD) - 2019/09/20 19:23:18 ET
Table 'Lacerta' 6-max Seat #1 is the button
Seat 1: turk1120 ($7.32 in chips)
Seat 2: PlayTheBlues4U ($9.62 in chips)
Seat 3: RNixon'sHead ($12.73 in chips)
Seat 4: Pergy21 ($8 in chips)
Seat 5: GoodKnight1365 ($11.41 in chips)
Seat 6: JDM0226 ($9.16 in chips)
PlayTheBlues4U: posts small blind $0.05
RNixon'sHead: posts big blind $0.10
*** HOLE CARDS ***
Dealt to PlayTheBlues4U [Th 5h]
Pergy21: folds
GoodKnight1365: folds
JDM0226: calls $0.10
turk1120: calls $0.10
PlayTheBlues4U: calls $0.05
RNixon'sHead: checks
*** FLOP *** [Ah As Td]
PlayTheBlues4U: checks
RNixon'sHead: checks
JDM0226: checks
turk1120: checks
*** TURN *** [Ah As Td] [3s]
PlayTheBlues4U: checks
RNixon'sHead: checks
JDM0226: checks
turk1120: checks
*** RIVER *** [Ah As Td 3s] [4c]
PlayTheBlues4U: bets $0.30
RNixon'sHead: folds
JDM0226: calls $0.30
turk1120: folds
*** SHOW DOWN ***
PlayTheBlues4U: shows [Th 5h] (two pair, Aces and Tens)
JDM0226: shows [Jh Jc] (two pair, Aces and Jacks)
JDM0226 collected $0.95 from pot
*** SUMMARY ***
Total pot $1 | Rake $0.05
Board [Ah As Td 3s 4c]
Seat 1: turk1120 (button) folded on the River
Seat 2: PlayTheBlues4U (small blind) showed [Th 5h] and lost with two pair, Aces and Tens
Seat 3: RNixon'sHead (big blind) folded on the River
Seat 4: Pergy21 folded before Flop (didn't bet)
Seat 5: GoodKnight1365 folded before Flop (didn't bet)
Seat 6: JDM0226 showed [Jh Jc] and won ($0.95) with two pair, Aces and Jacks


PokerStars Hand #203841578128:  Hold'em No Limit ($0.05/$0.10 USD) - 2019/09/20 19:22:56 ET
Table 'Lacerta' 6-max Seat #6 is the button
Seat 1: turk1120 ($7.57 in chips)
Seat 2: PlayTheBlues4U ($9.72 in chips)
Seat 3: RNixon'sHead ($12.41 in chips)
Seat 4: Pergy21 ($8 in chips)
Seat 5: GoodKnight1365 ($11.41 in chips)
Seat 6: JDM0226 ($9.16 in chips)
turk1120: posts small blind $0.05
PlayTheBlues4U: posts big blind $0.10
*** HOLE CARDS ***
Dealt to PlayTheBlues4U [Jh 5h]
RNixon'sHead: raises $0.15 to $0.25
Pergy21: folds
GoodKnight1365: folds
JDM0226: folds
turk1120: calls $0.20
PlayTheBlues4U: folds
*** FLOP *** [Th Qh 3h]
turk1120: checks
RNixon'sHead: bets $0.25
turk1120: folds
Uncalled bet ($0.25) returned to RNixon'sHead
RNixon'sHead collected $0.57 from pot
RNixon'sHead: doesn't show hand
*** SUMMARY ***
Total pot $0.60 | Rake $0.03
Board [Th Qh 3h]
Seat 1: turk1120 (small blind) folded on the Flop
Seat 2: PlayTheBlues4U (big blind) folded before Flop
Seat 3: RNixon'sHead collected ($0.57)
Seat 4: Pergy21 folded before Flop (didn't bet)
Seat 5: GoodKnight1365 folded before Flop (didn't bet)
Seat 6: JDM0226 (button) folded before Flop (didn't bet)


PokerStars Hand #203841578076:  Hold'em No Limit ($0.02/$0.05 USD) - 2019/09/20 19:22:28 ET
Table 'Anser' 6-max Seat #6 is the button
Seat 1: CMc172 ($4.65 in chips)
Seat 2: Star6543 ($1.73 in chips)
Seat 3: dmakai ($5.65 in chips)
Seat 4: PlayTheBlues4U ($6.12 in chips)
Seat 5: lj001ll ($2.46 in chips)
Seat 6: DemolishIT ($8.52 in chips)
CMc172: posts small blind $0.02
Star6543: posts big blind $0.05
*** HOLE CARDS ***
Dealt to PlayTheBlues4U [9h 9s]
dmakai: folds
PlayTheBlues4U: raises $0.10 to $0.15
lj001ll: folds
DemolishIT: calls $0.15
CMc172: folds
Star6543: folds
*** FLOP *** [3d 8c 9c]
PlayTheBlues4U: bets $0.20
DemolishIT: calls $0.20
*** TURN *** [3d 8c 9c] [2h]
PlayTheBlues4U: bets $0.50
DemolishIT: calls $0.50
*** RIVER *** [3d 8c 9c 2h] [8h]
PlayTheBlues4U: bets $1.25
DemolishIT: folds
Uncalled bet ($1.25) returned to PlayTheBlues4U
PlayTheBlues4U collected $1.68 from pot
PlayTheBlues4U: doesn't show hand
*** SUMMARY ***
Total pot $1.77 | Rake $0.09
Board [3d 8c 9c 2h 8h]
Seat 1: CMc172 (small blind) folded before Flop
Seat 2: Star6543 (big blind) folded before Flop
Seat 3: dmakai folded before Flop (didn't bet)
Seat 4: PlayTheBlues4U collected ($1.68)
Seat 5: lj001ll folded before Flop (didn't bet)
Seat 6: DemolishIT (button) folded on the River


PokerStars Hand #203841578068:  Hold'em No Limit ($0.05/$0.10 USD) - 2019/09/20 19:22:25 ET
Table 'Lacerta' 6-max Seat #5 is the button
Seat 1: turk1120 ($7.48 in chips)
Seat 2: PlayTheBlues4U ($9.72 in chips)
Seat 3: RNixon'sHead ($12.41 in chips)
Seat 4: Pergy21 ($8 in chips)
Seat 5: GoodKnight1365 ($11.41 in chips)
Seat 6: JDM0226 ($9.26 in chips)
JDM0226: posts small blind $0.05
turk1120: posts big blind $0.10
*** HOLE CARDS ***
Dealt to PlayTheBlues4U [Js 9d]
PlayTheBlues4U: folds
RNixon'sHead: folds
Pergy21: folds
GoodKnight1365: folds
JDM0226: calls $0.05
turk1120: checks
*** FLOP *** [Kc 9h Kh]
JDM0226: checks
turk1120: checks
*** TURN *** [Kc 9h Kh] [Td]
JDM0226: checks
turk1120: checks
*** RIVER *** [Kc 9h Kh Td] [7s]
JDM0226: checks
turk1120: checks
*** SHOW DOWN ***
JDM0226: shows [5d 4c] (a pair of Kings)
turk1120: shows [3d As] (a pair of Kings - Ace kicker)
turk1120 collected $0.19 from pot
*** SUMMARY ***
Total pot $0.20 | Rake $0.01
Board [Kc 9h Kh Td 7s]
Seat 1: turk1120 (big blind) showed [3d As] and won ($0.19) with a pair of Kings
Seat 2: PlayTheBlues4U folded before Flop (didn't bet)
Seat 3: RNixon'sHead folded before Flop (didn't bet)
Seat 4: Pergy21 folded before Flop (didn't bet)
Seat 5: GoodKnight1365 (button) folded before Flop (didn't bet)
Seat 6: JDM0226 (small blind) showed [5d 4c] and lost with a pair of Kings


PokerStars Hand #203841578039:  Hold'em No Limit ($0.02/$0.05 USD) - 2019/09/20 19:22:14 ET
Table 'Anser' 6-max Seat #5 is the button
Seat 1: CMc172 ($4.63 in chips)
Seat 2: Star6543 ($1.73 in chips)
Seat 3: dmakai ($5.65 in chips)
Seat 4: PlayTheBlues4U ($6.12 in chips)
Seat 5: lj001ll ($2.46 in chips)
Seat 6: DemolishIT ($8.54 in chips)
DemolishIT: posts small blind $0.02
CMc172: posts big blind $0.05
*** HOLE CARDS ***
Dealt to PlayTheBlues4U [5d 8d]
Star6543: folds
dmakai: folds
PlayTheBlues4U: folds
lj001ll: folds
DemolishIT: folds
Uncalled bet ($0.03) returned to CMc172
CMc172 collected $0.04 from pot
CMc172: doesn't show hand
*** SUMMARY ***
Total pot $0.04 | Rake $0
Seat 1: CMc172 (big blind) collected ($0.04)
Seat 2: Star6543 folded before Flop (didn't bet)
Seat 3: dmakai folded before Flop (didn't bet)
Seat 4: PlayTheBlues4U folded before Flop (didn't bet)
Seat 5: lj001ll (button) folded before Flop (didn't bet)
Seat 6: DemolishIT (small blind) folded before Flop


PokerStars Hand #203841577995:  Hold'em No Limit ($0.05/$0.10 USD) - 2019/09/20 19:21:51 ET
Table 'Lacerta' 6-max Seat #4 is the button
Seat 1: turk1120 ($7.48 in chips)
Seat 2: PlayTheBlues4U ($9.72 in chips)
Seat 3: RNixon'sHead ($12.41 in chips)
Seat 4: Pergy21 ($8.40 in chips)
Seat 5: GoodKnight1365 ($11.46 in chips)
Seat 6: JDM0226 ($8.85 in chips)
GoodKnight1365: posts small blind $0.05
JDM0226: posts big blind $0.10
*** HOLE CARDS ***
Dealt to PlayTheBlues4U [7c Js]
turk1120: folds
PlayTheBlues4U: folds
RNixon'sHead: folds
Pergy21: calls $0.10
GoodKnight1365: folds
JDM0226: checks
*** FLOP *** [7d 2c Jh]
JDM0226: checks
Pergy21: checks
*** TURN *** [7d 2c Jh] [Qh]
JDM0226: bets $0.30
Pergy21: calls $0.30
*** RIVER *** [7d 2c Jh Qh] [Ah]
JDM0226: checks
Pergy21: checks
*** SHOW DOWN ***
JDM0226: shows [2h 2d] (three of a kind, Deuces)
Pergy21: mucks hand
JDM0226 collected $0.81 from pot
*** SUMMARY ***
Total pot $0.85 | Rake $0.04
Board [7d 2c Jh Qh Ah]
Seat 1: turk1120 folded before Flop (didn't bet)
Seat 2: PlayTheBlues4U folded before Flop (didn't bet)
Seat 3: RNixon'sHead folded before Flop (didn't bet)
Seat 4: Pergy21 (button) mucked [Qd 9c]
Seat 5: GoodKnight1365 (small blind) folded before Flop
Seat 6: JDM0226 (big blind) showed [2h 2d] and won ($0.81) with three of a kind, Deuces


PokerStars Hand #203841577960:  Hold'em No Limit ($0.02/$0.05 USD) - 2019/09/20 19:21:36 ET
Table 'Anser' 6-max Seat #4 is the button
Seat 1: CMc172 ($4.63 in chips)
Seat 2: Star6543 ($1.73 in chips)
Seat 3: dmakai ($5.65 in chips)
Seat 4: PlayTheBlues4U ($6.12 in chips)
Seat 5: lj001ll ($2.37 in chips)
Seat 6: DemolishIT ($8.64 in chips)
lj001ll: posts small blind $0.02
DemolishIT: posts big blind $0.05
*** HOLE CARDS ***
Dealt to PlayTheBlues4U [3d 6h]
CMc172: folds
Star6543: folds
dmakai: folds
PlayTheBlues4U: folds
lj001ll: calls $0.03
DemolishIT: checks
*** FLOP *** [Ts 9h Qh]
lj001ll: checks
DemolishIT: checks
*** TURN *** [Ts 9h Qh] [Qs]
lj001ll: bets $0.05
DemolishIT: calls $0.05
*** RIVER *** [Ts 9h Qh Qs] [5d]
lj001ll: checks
DemolishIT: checks
*** SHOW DOWN ***
lj001ll: shows [As Tc] (two pair, Queens and Tens)
DemolishIT: mucks hand
lj001ll collected $0.19 from pot
*** SUMMARY ***
Total pot $0.20 | Rake $0.01
Board [Ts 9h Qh Qs 5d]
Seat 1: CMc172 folded before Flop (didn't bet)
Seat 2: Star6543 folded before Flop (didn't bet)
Seat 3: dmakai folded before Flop (didn't bet)
Seat 4: PlayTheBlues4U (button) folded before Flop (didn't bet)
Seat 5: lj001ll (small blind) showed [As Tc] and won ($0.19) with two pair, Queens and Tens
Seat 6: DemolishIT (big blind) mucked [9c 7h]


PokerStars Hand #203841577911:  Hold'em No Limit ($0.05/$0.10 USD) - 2019/09/20 19:21:11 ET
Table 'Lacerta' 6-max Seat #3 is the button
Seat 1: turk1120 ($6.53 in chips)
Seat 2: PlayTheBlues4U ($9.72 in chips)
Seat 3: RNixon'sHead ($12.41 in chips)
Seat 4: Pergy21 ($8.45 in chips)
Seat 5: GoodKnight1365 ($12.46 in chips)
Seat 6: JDM0226 ($8.85 in chips)
Pergy21: posts small blind $0.05
GoodKnight1365: posts big blind $0.10
*** HOLE CARDS ***
Dealt to PlayTheBlues4U [4s Qh]
JDM0226: folds
turk1120: calls $0.10
PlayTheBlues4U: folds
RNixon'sHead: folds
Pergy21: folds
GoodKnight1365: raises $0.10 to $0.20
turk1120: calls $0.10
*** FLOP *** [3c 2d 3s]
GoodKnight1365: bets $0.20
turk1120: calls $0.20
*** TURN *** [3c 2d 3s] [Ad]
GoodKnight1365: bets $0.60
turk1120: calls $0.60
*** RIVER *** [3c 2d 3s Ad] [7c]
GoodKnight1365: checks
turk1120: checks
*** SHOW DOWN ***
GoodKnight1365: shows [5d 6d] (a pair of Threes)
turk1120: shows [Kh Ks] (two pair, Kings and Threes)
turk1120 collected $1.95 from pot
*** SUMMARY ***
Total pot $2.05 | Rake $0.10
Board [3c 2d 3s Ad 7c]
Seat 1: turk1120 showed [Kh Ks] and won ($1.95) with two pair, Kings and Threes
Seat 2: PlayTheBlues4U folded before Flop (didn't bet)
Seat 3: RNixon'sHead (button) folded before Flop (didn't bet)
Seat 4: Pergy21 (small blind) folded before Flop
Seat 5: GoodKnight1365 (big blind) showed [5d 6d] and lost with a pair of Threes
Seat 6: JDM0226 folded before Flop (didn't bet)


PokerStars Hand #203841577895:  Hold'em No Limit ($0.02/$0.05 USD) - 2019/09/20 19:21:03 ET
Table 'Anser' 6-max Seat #3 is the button
Seat 1: CMc172 ($4.68 in chips)
Seat 2: Star6543 ($1.73 in chips)
Seat 3: dmakai ($5.65 in chips)
Seat 4: PlayTheBlues4U ($6.17 in chips)
Seat 5: lj001ll ($2.28 in chips)
Seat 6: DemolishIT ($8.64 in chips)
PlayTheBlues4U: posts small blind $0.02
lj001ll: posts big blind $0.05
*** HOLE CARDS ***
Dealt to PlayTheBlues4U [Qs 9d]
DemolishIT: folds
CMc172: calls $0.05
Star6543: folds
dmakai: folds
PlayTheBlues4U: calls $0.03
lj001ll: checks
*** FLOP *** [6d 6s Tc]
PlayTheBlues4U: checks
lj001ll: bets $0.07
CMc172: folds
PlayTheBlues4U: folds
Uncalled bet ($0.07) returned to lj001ll
lj001ll collected $0.14 from pot
lj001ll: doesn't show hand
*** SUMMARY ***
Total pot $0.15 | Rake $0.01
Board [6d 6s Tc]
Seat 1: CMc172 folded on the Flop
Seat 2: Star6543 folded before Flop (didn't bet)
Seat 3: dmakai (button) folded before Flop (didn't bet)
Seat 4: PlayTheBlues4U (small blind) folded on the Flop
Seat 5: lj001ll (big blind) collected ($0.14)
Seat 6: DemolishIT folded before Flop (didn't bet)


PokerStars Hand #203841577824:  Hold'em No Limit ($0.02/$0.05 USD) - 2019/09/20 19:20:21 ET
Table 'Anser' 6-max Seat #2 is the button
Seat 1: CMc172 ($4.68 in chips)
Seat 2: Star6543 ($1.45 in chips)
Seat 3: dmakai ($5.75 in chips)
Seat 4: PlayTheBlues4U ($6.27 in chips)
Seat 5: lj001ll ($2.38 in chips)
Seat 6: DemolishIT ($8.64 in chips)
dmakai: posts small blind $0.02
PlayTheBlues4U: posts big blind $0.05
*** HOLE CARDS ***
Dealt to PlayTheBlues4U [9s As]
lj001ll: calls $0.05
DemolishIT: folds
CMc172: folds
Star6543: calls $0.05
dmakai: calls $0.03
PlayTheBlues4U: raises $0.05 to $0.10
lj001ll: calls $0.05
Star6543: calls $0.05
dmakai: calls $0.05
*** FLOP *** [Qd Ks 4c]
dmakai: checks
PlayTheBlues4U: checks
lj001ll: checks
Star6543: bets $0.38
dmakai: folds
PlayTheBlues4U: folds
lj001ll: folds
Uncalled bet ($0.38) returned to Star6543
Star6543 collected $0.38 from pot
Star6543: doesn't show hand
*** SUMMARY ***
Total pot $0.40 | Rake $0.02
Board [Qd Ks 4c]
Seat 1: CMc172 folded before Flop (didn't bet)
Seat 2: Star6543 (button) collected ($0.38)
Seat 3: dmakai (small blind) folded on the Flop
Seat 4: PlayTheBlues4U (big blind) folded on the Flop
Seat 5: lj001ll folded on the Flop
Seat 6: DemolishIT folded before Flop (didn't bet)


PokerStars Hand #203841577809:  Hold'em No Limit ($0.05/$0.10 USD) - 2019/09/20 19:20:14 ET
Table 'Lacerta' 6-max Seat #2 is the button
Seat 1: turk1120 ($6.53 in chips)
Seat 2: PlayTheBlues4U ($9.92 in chips)
Seat 3: RNixon'sHead ($12.46 in chips)
Seat 4: Pergy21 ($8.95 in chips)
Seat 5: GoodKnight1365 ($11.77 in chips)
Seat 6: JDM0226 ($8.85 in chips)
RNixon'sHead: posts small blind $0.05
Pergy21: posts big blind $0.10
*** HOLE CARDS ***
Dealt to PlayTheBlues4U [8h Jh]
GoodKnight1365: raises $0.10 to $0.20
JDM0226: folds
turk1120: folds
PlayTheBlues4U: calls $0.20
RNixon'sHead: folds
Pergy21: calls $0.10
*** FLOP *** [Qd Tc 3h]
Pergy21: checks
GoodKnight1365: bets $0.30
PlayTheBlues4U: folds
Pergy21: calls $0.30
*** TURN *** [Qd Tc 3h] [3c]
Pergy21: checks
GoodKnight1365: checks
*** RIVER *** [Qd Tc 3h 3c] [Ad]
Pergy21: checks
GoodKnight1365: checks
*** SHOW DOWN ***
Pergy21: shows [Ks 7s] (a pair of Threes)
GoodKnight1365: shows [Qh 9h] (two pair, Queens and Threes)
GoodKnight1365 collected $1.19 from pot
*** SUMMARY ***
Total pot $1.25 | Rake $0.06
Board [Qd Tc 3h 3c Ad]
Seat 1: turk1120 folded before Flop (didn't bet)
Seat 2: PlayTheBlues4U (button) folded on the Flop
Seat 3: RNixon'sHead (small blind) folded before Flop
Seat 4: Pergy21 (big blind) showed [Ks 7s] and lost with a pair of Threes
Seat 5: GoodKnight1365 showed [Qh 9h] and won ($1.19) with two pair, Queens and Threes
Seat 6: JDM0226 folded before Flop (didn't bet)


PokerStars Hand #203841577746:  Hold'em No Limit ($0.02/$0.05 USD) - 2019/09/20 19:19:42 ET
Table 'Anser' 6-max Seat #1 is the button
Seat 1: CMc172 ($4.73 in chips)
Seat 2: Star6543 ($1.70 in chips)
Seat 3: dmakai ($5.80 in chips)
Seat 4: PlayTheBlues4U ($6.27 in chips)
Seat 5: lj001ll ($2.38 in chips)
Seat 6: DemolishIT ($8.32 in chips)
Star6543: posts small blind $0.02
dmakai: posts big blind $0.05
*** HOLE CARDS ***
Dealt to PlayTheBlues4U [9d Kd]
PlayTheBlues4U: folds
lj001ll: folds
DemolishIT: calls $0.05
CMc172: calls $0.05
Star6543: calls $0.03
dmakai: checks
*** FLOP *** [7h 8s 7c]
Star6543: bets $0.05
dmakai: folds
DemolishIT: calls $0.05
CMc172: folds
*** TURN *** [7h 8s 7c] [Jd]
Star6543: bets $0.05
DemolishIT: calls $0.05
*** RIVER *** [7h 8s 7c Jd] [Tc]
Star6543: bets $0.05
DemolishIT: raises $0.05 to $0.10
Star6543: calls $0.05
*** SHOW DOWN ***
DemolishIT: shows [As 9s] (a straight, Seven to Jack)
Star6543: mucks hand
DemolishIT collected $0.57 from pot
*** SUMMARY ***
Total pot $0.60 | Rake $0.03
Board [7h 8s 7c Jd Tc]
Seat 1: CMc172 (button) folded on the Flop
Seat 2: Star6543 (small blind) mucked [Ad 8c]
Seat 3: dmakai (big blind) folded on the Flop
Seat 4: PlayTheBlues4U folded before Flop (didn't bet)
Seat 5: lj001ll folded before Flop (didn't bet)
Seat 6: DemolishIT showed [As 9s] and won ($0.57) with a straight, Seven to Jack


PokerStars Hand #203841577743:  Hold'em No Limit ($0.05/$0.10 USD) - 2019/09/20 19:19:39 ET
Table 'Lacerta' 6-max Seat #1 is the button
Seat 1: turk1120 ($6.35 in chips)
Seat 2: PlayTheBlues4U ($10.02 in chips)
Seat 3: RNixon'sHead ($12.56 in chips)
Seat 4: Pergy21 ($8.95 in chips)
Seat 5: GoodKnight1365 ($11.77 in chips)
Seat 6: JDM0226 ($8.85 in chips)
PlayTheBlues4U: posts small blind $0.05
RNixon'sHead: posts big blind $0.10
*** HOLE CARDS ***
Dealt to PlayTheBlues4U [6s Kh]
Pergy21: folds
GoodKnight1365: folds
JDM0226: folds
turk1120: calls $0.10
PlayTheBlues4U: calls $0.05
RNixon'sHead: checks
*** FLOP *** [Ac Qd 2d]
PlayTheBlues4U: checks
RNixon'sHead: checks
turk1120: checks
*** TURN *** [Ac Qd 2d] [7d]
PlayTheBlues4U: checks
RNixon'sHead: checks
turk1120: bets $0.10
PlayTheBlues4U: folds
RNixon'sHead: folds
Uncalled bet ($0.10) returned to turk1120
turk1120 collected $0.28 from pot
*** SUMMARY ***
Total pot $0.30 | Rake $0.02
Board [Ac Qd 2d 7d]
Seat 1: turk1120 (button) collected ($0.28)
Seat 2: PlayTheBlues4U (small blind) folded on the Turn
Seat 3: RNixon'sHead (big blind) folded on the Turn
Seat 4: Pergy21 folded before Flop (didn't bet)
Seat 5: GoodKnight1365 folded before Flop (didn't bet)
Seat 6: JDM0226 folded before Flop (didn't bet)


PokerStars Hand #203841577685:  Hold'em No Limit ($0.02/$0.05 USD) - 2019/09/20 19:19:08 ET
Table 'Anser' 6-max Seat #6 is the button
Seat 1: CMc172 ($4.12 in chips)
Seat 2: Star6543 ($1.75 in chips)
Seat 3: dmakai ($5.80 in chips)
Seat 4: PlayTheBlues4U ($6.27 in chips)
Seat 5: lj001ll ($2.38 in chips)
Seat 6: DemolishIT ($8.95 in chips)
CMc172: posts small blind $0.02
Star6543: posts big blind $0.05
*** HOLE CARDS ***
Dealt to PlayTheBlues4U [8s 4h]
dmakai: folds
PlayTheBlues4U: folds
lj001ll: folds
DemolishIT: raises $0.15 to $0.20
CMc172: calls $0.18
Star6543: folds
*** FLOP *** [8h Ac 5s]
CMc172: checks
DemolishIT: checks
*** TURN *** [8h Ac 5s] [2d]
CMc172: checks
DemolishIT: bets $0.43
CMc172: calls $0.43
*** RIVER *** [8h Ac 5s 2d] [5c]
CMc172: checks
DemolishIT: checks
*** SHOW DOWN ***
CMc172: shows [Ad Qh] (two pair, Aces and Fives)
DemolishIT: mucks hand
CMc172 collected $1.24 from pot
*** SUMMARY ***
Total pot $1.31 | Rake $0.07
Board [8h Ac 5s 2d 5c]
Seat 1: CMc172 (small blind) showed [Ad Qh] and won ($1.24) with two pair, Aces and Fives
Seat 2: Star6543 (big blind) folded before Flop
Seat 3: dmakai folded before Flop (didn't bet)
Seat 4: PlayTheBlues4U folded before Flop (didn't bet)
Seat 5: lj001ll folded before Flop (didn't bet)
Seat 6: DemolishIT (button) mucked [4c 2c]


PokerStars Hand #203841577632:  Hold'em No Limit ($0.05/$0.10 USD) - 2019/09/20 19:18:40 ET
Table 'Lacerta' 6-max Seat #6 is the button
Seat 1: turk1120 ($6.40 in chips)
Seat 2: PlayTheBlues4U ($10.12 in chips)
Seat 3: RNixon'sHead ($12.56 in chips)
Seat 4: Pergy21 ($9.55 in chips)
Seat 5: GoodKnight1365 ($11.09 in chips)
Seat 6: JDM0226 ($8.85 in chips)
turk1120: posts small blind $0.05
PlayTheBlues4U: posts big blind $0.10
*** HOLE CARDS ***
Dealt to PlayTheBlues4U [2h Th]
RNixon'sHead: folds
Pergy21: raises $0.10 to $0.20
GoodKnight1365: raises $0.40 to $0.60
JDM0226: folds
turk1120: folds
PlayTheBlues4U: folds
Pergy21: calls $0.40
*** FLOP *** [5c 4d 6s]
Pergy21: checks
GoodKnight1365: checks
*** TURN *** [5c 4d 6s] [Kd]
Pergy21: checks
GoodKnight1365: bets $0.80
Pergy21: folds
Uncalled bet ($0.80) returned to GoodKnight1365
GoodKnight1365 collected $1.28 from pot
GoodKnight1365: doesn't show hand
*** SUMMARY ***
Total pot $1.35 | Rake $0.07
Board [5c 4d 6s Kd]
Seat 1: turk1120 (small blind) folded before Flop
Seat 2: PlayTheBlues4U (big blind) folded before Flop
Seat 3: RNixon'sHead folded before Flop (didn't bet)
Seat 4: Pergy21 folded on the Turn
Seat 5: GoodKnight1365 collected ($1.28)
Seat 6: JDM0226 (button) folded before Flop (didn't bet)


PokerStars Hand #203841577616:  Hold'em No Limit ($0.02/$0.05 USD) - 2019/09/20 19:18:32 ET
Table 'Anser' 6-max Seat #5 is the button
Seat 1: CMc172 ($4.27 in chips)
Seat 2: Star6543 ($1.75 in chips)
Seat 3: dmakai ($5.80 in chips)
Seat 4: PlayTheBlues4U ($5.99 in chips)
Seat 5: lj001ll ($2.38 in chips)
Seat 6: DemolishIT ($9.10 in chips)
DemolishIT: posts small blind $0.02
CMc172: posts big blind $0.05
*** HOLE CARDS ***
Dealt to PlayTheBlues4U [Ac 2c]
Star6543: folds
dmakai: folds
PlayTheBlues4U: raises $0.10 to $0.15
lj001ll: folds
DemolishIT: calls $0.13
CMc172: calls $0.10
*** FLOP *** [7h 4s Ks]
DemolishIT: checks
CMc172: checks
PlayTheBlues4U: bets $0.20
DemolishIT: folds
CMc172: folds
Uncalled bet ($0.20) returned to PlayTheBlues4U
PlayTheBlues4U collected $0.43 from pot
PlayTheBlues4U: doesn't show hand
*** SUMMARY ***
Total pot $0.45 | Rake $0.02
Board [7h 4s Ks]
Seat 1: CMc172 (big blind) folded on the Flop
Seat 2: Star6543 folded before Flop (didn't bet)
Seat 3: dmakai folded before Flop (didn't bet)
Seat 4: PlayTheBlues4U collected ($0.43)
Seat 5: lj001ll (button) folded before Flop (didn't bet)
Seat 6: DemolishIT (small blind) folded on the Flop


PokerStars Hand #203841577607:  Hold'em No Limit ($0.05/$0.10 USD) - 2019/09/20 19:18:27 ET
Table 'Lacerta' 6-max Seat #5 is the button
Seat 1: turk1120 ($6.50 in chips)
Seat 2: PlayTheBlues4U ($9.97 in chips)
Seat 3: RNixon'sHead ($12.56 in chips)
Seat 4: Pergy21 ($9.55 in chips)
Seat 5: GoodKnight1365 ($11.09 in chips)
Seat 6: JDM0226 ($8.90 in chips)
JDM0226: posts small blind $0.05
turk1120: posts big blind $0.10
*** HOLE CARDS ***
Dealt to PlayTheBlues4U [Qh Kh]
PlayTheBlues4U: raises $0.20 to $0.30
RNixon'sHead: folds
Pergy21: folds
GoodKnight1365: folds
JDM0226: folds
turk1120: folds
Uncalled bet ($0.20) returned to PlayTheBlues4U
PlayTheBlues4U collected $0.25 from pot
PlayTheBlues4U: doesn't show hand
*** SUMMARY ***
Total pot $0.25 | Rake $0
Seat 1: turk1120 (big blind) folded before Flop
Seat 2: PlayTheBlues4U collected ($0.25)
Seat 3: RNixon'sHead folded before Flop (didn't bet)
Seat 4: Pergy21 folded before Flop (didn't bet)
Seat 5: GoodKnight1365 (button) folded before Flop (didn't bet)
Seat 6: JDM0226 (small blind) folded before Flop


PokerStars Hand #203841577540:  Hold'em No Limit ($0.05/$0.10 USD) - 2019/09/20 19:17:44 ET
Table 'Lacerta' 6-max Seat #4 is the button
Seat 1: turk1120 ($6.95 in chips)
Seat 2: PlayTheBlues4U ($9.97 in chips)
Seat 3: RNixon'sHead ($12.01 in chips)
Seat 4: Pergy21 ($9.55 in chips)
Seat 5: GoodKnight1365 ($11.14 in chips)
Seat 6: JDM0226 ($9 in chips)
GoodKnight1365: posts small blind $0.05
JDM0226: posts big blind $0.10
*** HOLE CARDS ***
Dealt to PlayTheBlues4U [5s Tc]
turk1120: calls $0.10
PlayTheBlues4U: folds
RNixon'sHead: raises $0.35 to $0.45
Pergy21: folds
GoodKnight1365: folds
JDM0226: folds
turk1120: calls $0.35
*** FLOP *** [6s Kh 9c]
turk1120: checks
RNixon'sHead: checks
*** TURN *** [6s Kh 9c] [Ac]
turk1120: checks
RNixon'sHead: bets $0.77
turk1120: folds
Uncalled bet ($0.77) returned to RNixon'sHead
RNixon'sHead collected $1 from pot
RNixon'sHead: doesn't show hand
*** SUMMARY ***
Total pot $1.05 | Rake $0.05
Board [6s Kh 9c Ac]
Seat 1: turk1120 folded on the Turn
Seat 2: PlayTheBlues4U folded before Flop (didn't bet)
Seat 3: RNixon'sHead collected ($1)
Seat 4: Pergy21 (button) folded before Flop (didn't bet)
Seat 5: GoodKnight1365 (small blind) folded before Flop
Seat 6: JDM0226 (big blind) folded before Flop


PokerStars Hand #203841577504:  Hold'em No Limit ($0.02/$0.05 USD) - 2019/09/20 19:17:26 ET
Table 'Anser' 6-max Seat #4 is the button
Seat 1: CMc172 ($4.72 in chips)
Seat 2: Star6543 ($1.75 in chips)
Seat 3: dmakai ($5.80 in chips)
Seat 4: PlayTheBlues4U ($5.14 in chips)
Seat 5: lj001ll ($2.40 in chips)
Seat 6: DemolishIT ($9.55 in chips)
lj001ll: posts small blind $0.02
DemolishIT: posts big blind $0.05
*** HOLE CARDS ***
Dealt to PlayTheBlues4U [7s 8s]
CMc172: calls $0.05
Star6543: folds
dmakai: folds
PlayTheBlues4U: raises $0.10 to $0.15
lj001ll: folds
DemolishIT: calls $0.10
CMc172: calls $0.10
*** FLOP *** [9d Qs 8h]
DemolishIT: checks
CMc172: checks
PlayTheBlues4U: bets $0.30
DemolishIT: calls $0.30
CMc172: calls $0.30
*** TURN *** [9d Qs 8h] [2d]
DemolishIT: checks
CMc172: checks
PlayTheBlues4U: checks
*** RIVER *** [9d Qs 8h 2d] [Kc]
DemolishIT: checks
CMc172: checks
PlayTheBlues4U: bets $0.80
DemolishIT: folds
CMc172: folds
Uncalled bet ($0.80) returned to PlayTheBlues4U
PlayTheBlues4U collected $1.30 from pot
PlayTheBlues4U: doesn't show hand
*** SUMMARY ***
Total pot $1.37 | Rake $0.07
Board [9d Qs 8h 2d Kc]
Seat 1: CMc172 folded on the River
Seat 2: Star6543 folded before Flop (didn't bet)
Seat 3: dmakai folded before Flop (didn't bet)
Seat 4: PlayTheBlues4U (button) collected ($1.30)
Seat 5: lj001ll (small blind) folded before Flop
Seat 6: DemolishIT (big blind) folded on the River


PokerStars Hand #203841577442:  Hold'em No Limit ($0.05/$0.10 USD) - 2019/09/20 19:16:47 ET
Table 'Lacerta' 6-max Seat #3 is the button
Seat 1: turk1120 ($7.25 in chips)
Seat 2: PlayTheBlues4U ($10.87 in chips)
Seat 3: RNixon'sHead ($12.01 in chips)
Seat 4: Pergy21 ($9.60 in chips)
Seat 5: GoodKnight1365 ($10 in chips)
Pergy21: posts small blind $0.05
GoodKnight1365: posts big blind $0.10
*** HOLE CARDS ***
Dealt to PlayTheBlues4U [4d 5d]
turk1120: calls $0.10
PlayTheBlues4U: calls $0.10
JDM0226 joins the table at seat #6
RNixon'sHead: folds
Pergy21: folds
GoodKnight1365: checks
*** FLOP *** [2d 3c Kh]
GoodKnight1365: bets $0.20
turk1120: calls $0.20
PlayTheBlues4U: calls $0.20
*** TURN *** [2d 3c Kh] [8d]
GoodKnight1365: bets $0.60
turk1120: folds
PlayTheBlues4U: calls $0.60
*** RIVER *** [2d 3c Kh 8d] [9c]
GoodKnight1365: bets $1
PlayTheBlues4U: folds
Uncalled bet ($1) returned to GoodKnight1365
GoodKnight1365 collected $2.04 from pot
GoodKnight1365: doesn't show hand
*** SUMMARY ***
Total pot $2.15 | Rake $0.11
Board [2d 3c Kh 8d 9c]
Seat 1: turk1120 folded on the Turn
Seat 2: PlayTheBlues4U folded on the River
Seat 3: RNixon'sHead (button) folded before Flop (didn't bet)
Seat 4: Pergy21 (small blind) folded before Flop
Seat 5: GoodKnight1365 (big blind) collected ($2.04)


PokerStars Hand #203841577435:  Hold'em No Limit ($0.02/$0.05 USD) - 2019/09/20 19:16:39 ET
Table 'Anser' 6-max Seat #3 is the button
Seat 1: CMc172 ($4.77 in chips)
Seat 2: Star6543 ($1.80 in chips)
Seat 3: dmakai ($5.85 in chips)
Seat 4: PlayTheBlues4U ($4.95 in chips)
Seat 5: lj001ll ($2.45 in chips)
Seat 6: DemolishIT ($9.55 in chips)
PlayTheBlues4U: posts small blind $0.02
lj001ll: posts big blind $0.05
*** HOLE CARDS ***
Dealt to PlayTheBlues4U [4h Ah]
DemolishIT: folds
CMc172: calls $0.05
Star6543: calls $0.05
dmakai: calls $0.05
PlayTheBlues4U: calls $0.03
lj001ll: checks
*** FLOP *** [7h 7c Ad]
PlayTheBlues4U: checks
lj001ll: checks
CMc172: checks
Star6543: checks
dmakai: checks
*** TURN *** [7h 7c Ad] [9c]
PlayTheBlues4U: bets $0.15
lj001ll: folds
CMc172: folds
Star6543: folds
dmakai: folds
Uncalled bet ($0.15) returned to PlayTheBlues4U
PlayTheBlues4U collected $0.24 from pot
PlayTheBlues4U: doesn't show hand
*** SUMMARY ***
Total pot $0.25 | Rake $0.01
Board [7h 7c Ad 9c]
Seat 1: CMc172 folded on the Turn
Seat 2: Star6543 folded on the Turn
Seat 3: dmakai (button) folded on the Turn
Seat 4: PlayTheBlues4U (small blind) collected ($0.24)
Seat 5: lj001ll (big blind) folded on the Turn
Seat 6: DemolishIT folded before Flop (didn't bet)


PokerStars Hand #203841577346:  Hold'em No Limit ($0.02/$0.05 USD) - 2019/09/20 19:15:53 ET
Table 'Anser' 6-max Seat #2 is the button
Seat 1: CMc172 ($4.66 in chips)
Seat 2: Star6543 ($1.85 in chips)
Seat 3: dmakai ($5.87 in chips)
Seat 4: PlayTheBlues4U ($5 in chips)
Seat 5: lj001ll ($2.45 in chips)
Seat 6: DemolishIT ($9.55 in chips)
dmakai: posts small blind $0.02
PlayTheBlues4U: posts big blind $0.05
*** HOLE CARDS ***
Dealt to PlayTheBlues4U [2h 8s]
lj001ll: folds
DemolishIT: folds
CMc172: calls $0.05
Star6543: calls $0.05
dmakai: folds
PlayTheBlues4U: checks
*** FLOP *** [Qc Ah As]
PlayTheBlues4U: checks
CMc172: checks
Star6543: checks
*** TURN *** [Qc Ah As] [9s]
PlayTheBlues4U: checks
CMc172: checks
Star6543: checks
*** RIVER *** [Qc Ah As 9s] [5d]
PlayTheBlues4U: checks
CMc172: bets $0.10
Star6543: folds
PlayTheBlues4U: folds
Uncalled bet ($0.10) returned to CMc172
CMc172 collected $0.16 from pot
CMc172: doesn't show hand
*** SUMMARY ***
Total pot $0.17 | Rake $0.01
Board [Qc Ah As 9s 5d]
Seat 1: CMc172 collected ($0.16)
Seat 2: Star6543 (button) folded on the River
Seat 3: dmakai (small blind) folded before Flop
Seat 4: PlayTheBlues4U (big blind) folded on the River
Seat 5: lj001ll folded before Flop (didn't bet)
Seat 6: DemolishIT folded before Flop (didn't bet)


PokerStars Hand #203841577322:  Hold'em No Limit ($0.05/$0.10 USD) - 2019/09/20 19:15:42 ET
Table 'Lacerta' 6-max Seat #2 is the button
Seat 1: turk1120 ($7.25 in chips)
Seat 2: PlayTheBlues4U ($10.87 in chips)
Seat 3: RNixon'sHead ($12.06 in chips)
Seat 4: Pergy21 ($9.60 in chips)
RNixon'sHead: posts small blind $0.05
Pergy21: posts big blind $0.10
*** HOLE CARDS ***
Dealt to PlayTheBlues4U [Ac 4s]
GoodKnight1365 joins the table at seat #5
turk1120: folds
PlayTheBlues4U: raises $0.10 to $0.20
RNixon'sHead: folds
Pergy21: calls $0.10
*** FLOP *** [Qd 7d Td]
Pergy21: checks
PlayTheBlues4U: checks
*** TURN *** [Qd 7d Td] [As]
Pergy21: checks
PlayTheBlues4U: bets $0.30
Pergy21: calls $0.30
*** RIVER *** [Qd 7d Td As] [Ts]
Pergy21: checks
PlayTheBlues4U: checks
*** SHOW DOWN ***
Pergy21: shows [4d Ah] (two pair, Aces and Tens)
PlayTheBlues4U: shows [Ac 4s] (two pair, Aces and Tens)
Pergy21 collected $0.50 from pot
PlayTheBlues4U collected $0.50 from pot
*** SUMMARY ***
Total pot $1.05 | Rake $0.05
Board [Qd 7d Td As Ts]
Seat 1: turk1120 folded before Flop (didn't bet)
Seat 2: PlayTheBlues4U (button) showed [Ac 4s] and won ($0.50) with two pair, Aces and Tens
Seat 3: RNixon'sHead (small blind) folded before Flop
Seat 4: Pergy21 (big blind) showed [4d Ah] and won ($0.50) with two pair, Aces and Tens


PokerStars Hand #203841577280:  Hold'em No Limit ($0.02/$0.05 USD) - 2019/09/20 19:15:20 ET
Table 'Anser' 6-max Seat #1 is the button
Seat 1: CMc172 ($4.52 in chips)
Seat 2: Star6543 ($1.90 in chips)
Seat 3: dmakai ($5.92 in chips)
Seat 4: PlayTheBlues4U ($5 in chips)
Seat 5: lj001ll ($2.45 in chips)
Seat 6: DemolishIT ($9.60 in chips)
Star6543: posts small blind $0.02
dmakai: posts big blind $0.05
*** HOLE CARDS ***
Dealt to PlayTheBlues4U [7c 2d]
PlayTheBlues4U: folds
lj001ll: folds
DemolishIT: calls $0.05
CMc172: calls $0.05
Star6543: calls $0.03
dmakai: checks
*** FLOP *** [Ts 3s 3d]
Star6543: checks
dmakai: checks
DemolishIT: checks
CMc172: checks
*** TURN *** [Ts 3s 3d] [Qs]
Star6543: checks
dmakai: checks
DemolishIT: checks
CMc172: bets $0.10
Star6543: folds
dmakai: folds
DemolishIT: folds
Uncalled bet ($0.10) returned to CMc172
CMc172 collected $0.19 from pot
CMc172: doesn't show hand
*** SUMMARY ***
Total pot $0.20 | Rake $0.01
Board [Ts 3s 3d Qs]
Seat 1: CMc172 (button) collected ($0.19)
Seat 2: Star6543 (small blind) folded on the Turn
Seat 3: dmakai (big blind) folded on the Turn
Seat 4: PlayTheBlues4U folded before Flop (didn't bet)
Seat 5: lj001ll folded before Flop (didn't bet)
Seat 6: DemolishIT folded on the Turn


PokerStars Hand #203841577262:  Hold'em No Limit ($0.05/$0.10 USD) - 2019/09/20 19:15:10 ET
Table 'Lacerta' 6-max Seat #1 is the button
Seat 1: turk1120 ($7.25 in chips)
Seat 2: PlayTheBlues4U ($10.97 in chips)
Seat 3: RNixon'sHead ($11.97 in chips)
Seat 4: Pergy21 ($9.60 in chips)
Seat 6: TylerD1775 ($19.95 in chips)
PlayTheBlues4U: posts small blind $0.05
RNixon'sHead: posts big blind $0.10
*** HOLE CARDS ***
Dealt to PlayTheBlues4U [7h Jc]
Pergy21: folds
TylerD1775: folds
turk1120: folds
tomasz2016 leaves the table
PlayTheBlues4U: calls $0.05
TylerD1775 leaves the table
RNixon'sHead: checks
*** FLOP *** [6h Qc 8s]
PlayTheBlues4U: checks
RNixon'sHead: bets $0.13
PlayTheBlues4U: folds
Uncalled bet ($0.13) returned to RNixon'sHead
RNixon'sHead collected $0.19 from pot
RNixon'sHead: doesn't show hand
*** SUMMARY ***
Total pot $0.20 | Rake $0.01
Board [6h Qc 8s]
Seat 1: turk1120 (button) folded before Flop (didn't bet)
Seat 2: PlayTheBlues4U (small blind) folded on the Flop
Seat 3: RNixon'sHead (big blind) collected ($0.19)
Seat 4: Pergy21 folded before Flop (didn't bet)
Seat 6: TylerD1775 folded before Flop (didn't bet)


PokerStars Hand #203841577220:  Hold'em No Limit ($0.02/$0.05 USD) - 2019/09/20 19:14:50 ET
Table 'Anser' 6-max Seat #6 is the button
Seat 1: CMc172 ($4.43 in chips)
Seat 2: Star6543 ($2 in chips)
Seat 3: dmakai ($5.92 in chips)
Seat 4: PlayTheBlues4U ($5 in chips)
Seat 5: lj001ll ($2.45 in chips)
Seat 6: DemolishIT ($9.60 in chips)
CMc172: posts small blind $0.02
Star6543: posts big blind $0.05
*** HOLE CARDS ***
Dealt to PlayTheBlues4U [6s 8s]
dmakai: folds
PlayTheBlues4U: folds
lj001ll: folds
DemolishIT: folds
CMc172: calls $0.03
Star6543: checks
*** FLOP *** [Ah 9s Kc]
CMc172: checks
Star6543: checks
*** TURN *** [Ah 9s Kc] [3s]
CMc172: checks
Star6543: bets $0.05
CMc172: calls $0.05
*** RIVER *** [Ah 9s Kc 3s] [7s]
CMc172: checks
Star6543: checks
*** SHOW DOWN ***
CMc172: shows [Jd Js] (a pair of Jacks)
Star6543: mucks hand
CMc172 collected $0.19 from pot
*** SUMMARY ***
Total pot $0.20 | Rake $0.01
Board [Ah 9s Kc 3s 7s]
Seat 1: CMc172 (small blind) showed [Jd Js] and won ($0.19) with a pair of Jacks
Seat 2: Star6543 (big blind) mucked [8d 3c]
Seat 3: dmakai folded before Flop (didn't bet)
Seat 4: PlayTheBlues4U folded before Flop (didn't bet)
Seat 5: lj001ll folded before Flop (didn't bet)
Seat 6: DemolishIT (button) folded before Flop (didn't bet)


PokerStars Hand #203841577190:  Hold'em No Limit ($0.05/$0.10 USD) - 2019/09/20 19:14:32 ET
Table 'Lacerta' 6-max Seat #6 is the button
Seat 1: turk1120 ($7.30 in chips)
Seat 2: PlayTheBlues4U ($9.38 in chips)
Seat 3: RNixon'sHead ($11.97 in chips)
Seat 4: Pergy21 ($9.80 in chips)
Seat 5: tomasz2016 ($1.50 in chips)
Seat 6: TylerD1775 ($19.95 in chips)
turk1120: posts small blind $0.05
PlayTheBlues4U: posts big blind $0.10
*** HOLE CARDS ***
Dealt to PlayTheBlues4U [Kd As]
RNixon'sHead: folds
Pergy21: raises $0.10 to $0.20
tomasz2016: raises $0.55 to $0.75
TylerD1775: folds
turk1120: folds
PlayTheBlues4U: raises $1.15 to $1.90
Pergy21: folds
tomasz2016: calls $0.75 and is all-in
Uncalled bet ($0.40) returned to PlayTheBlues4U
*** FLOP *** [2c 8d 5s]
*** TURN *** [2c 8d 5s] [Ad]
*** RIVER *** [2c 8d 5s Ad] [3s]
*** SHOW DOWN ***
PlayTheBlues4U: shows [Kd As] (a pair of Aces)
tomasz2016: shows [6c Ac] (a pair of Aces - lower kicker)
PlayTheBlues4U collected $3.09 from pot
*** SUMMARY ***
Total pot $3.25 | Rake $0.16
Board [2c 8d 5s Ad 3s]
Seat 1: turk1120 (small blind) folded before Flop
Seat 2: PlayTheBlues4U (big blind) showed [Kd As] and won ($3.09) with a pair of Aces
Seat 3: RNixon'sHead folded before Flop (didn't bet)
Seat 4: Pergy21 folded before Flop
Seat 5: tomasz2016 showed [6c Ac] and lost with a pair of Aces
Seat 6: TylerD1775 (button) folded before Flop (didn't bet)


PokerStars Hand #203841577150:  Hold'em No Limit ($0.05/$0.10 USD) - 2019/09/20 19:14:11 ET
Table 'Lacerta' 6-max Seat #5 is the button
Seat 1: turk1120 ($7.21 in chips)
Seat 2: PlayTheBlues4U ($9.38 in chips)
Seat 3: RNixon'sHead ($11.97 in chips)
Seat 4: Pergy21 ($9.80 in chips)
Seat 5: tomasz2016 ($1.50 in chips)
Seat 6: TylerD1775 ($20.05 in chips)
TylerD1775: posts small blind $0.05
turk1120: posts big blind $0.10
*** HOLE CARDS ***
Dealt to PlayTheBlues4U [7h 3c]
PlayTheBlues4U: folds
RNixon'sHead: folds
Pergy21: folds
tomasz2016: folds
TylerD1775: calls $0.05
turk1120: checks
*** FLOP *** [4c Js 6c]
TylerD1775: checks
turk1120: checks
*** TURN *** [4c Js 6c] [2d]
TylerD1775: checks
turk1120: bets $0.10
TylerD1775: folds
Uncalled bet ($0.10) returned to turk1120
turk1120 collected $0.19 from pot
*** SUMMARY ***
Total pot $0.20 | Rake $0.01
Board [4c Js 6c 2d]
Seat 1: turk1120 (big blind) collected ($0.19)
Seat 2: PlayTheBlues4U folded before Flop (didn't bet)
Seat 3: RNixon'sHead folded before Flop (didn't bet)
Seat 4: Pergy21 folded before Flop (didn't bet)
Seat 5: tomasz2016 (button) folded before Flop (didn't bet)
Seat 6: TylerD1775 (small blind) folded on the Turn


PokerStars Hand #203841577097:  Hold'em No Limit ($0.02/$0.05 USD) - 2019/09/20 19:13:40 ET
Table 'Anser' 6-max Seat #5 is the button
Seat 1: CMc172 ($4.53 in chips)
Seat 3: dmakai ($5.92 in chips)
Seat 4: PlayTheBlues4U ($5 in chips)
Seat 5: lj001ll ($3.78 in chips)
Seat 6: DemolishIT ($8.31 in chips)
DemolishIT: posts small blind $0.02
CMc172: posts big blind $0.05
*** HOLE CARDS ***
Dealt to PlayTheBlues4U [Td 7s]
dmakai: folds
PlayTheBlues4U: folds
lj001ll: raises $0.05 to $0.10
Star6543 said, "fkn donk gets lucky"
DemolishIT: calls $0.08
CMc172: calls $0.05
*** FLOP *** [Jc Ac 4s]
DemolishIT: bets $0.28
CMc172: folds
lj001ll: calls $0.28
*** TURN *** [Jc Ac 4s] [2c]
DemolishIT: checks
lj001ll: checks
*** RIVER *** [Jc Ac 4s 2c] [Ks]
DemolishIT: bets $0.95
lj001ll: calls $0.95
*** SHOW DOWN ***
DemolishIT: shows [Kc 7c] (a flush, Ace high)
lj001ll: mucks hand
DemolishIT collected $2.62 from pot
*** SUMMARY ***
Total pot $2.76 | Rake $0.14
Board [Jc Ac 4s 2c Ks]
Seat 1: CMc172 (big blind) folded on the Flop
Seat 3: dmakai folded before Flop (didn't bet)
Seat 4: PlayTheBlues4U folded before Flop (didn't bet)
Seat 5: lj001ll (button) mucked [Ad 9h]
Seat 6: DemolishIT (small blind) showed [Kc 7c] and won ($2.62) with a flush, Ace high


PokerStars Hand #203841577078:  Hold'em No Limit ($0.05/$0.10 USD) - 2019/09/20 19:13:31 ET
Table 'Lacerta' 6-max Seat #4 is the button
Seat 1: turk1120 ($7.68 in chips)
Seat 2: PlayTheBlues4U ($9.85 in chips)
Seat 3: RNixon'sHead ($11.97 in chips)
Seat 4: Pergy21 ($9.80 in chips)
Seat 5: tomasz2016 ($1.55 in chips)
Seat 6: TylerD1775 ($19.13 in chips)
tomasz2016: posts small blind $0.05
TylerD1775: posts big blind $0.10
*** HOLE CARDS ***
Dealt to PlayTheBlues4U [2h 2s]
turk1120: calls $0.10
PlayTheBlues4U: calls $0.10
RNixon'sHead: folds
Pergy21: folds
tomasz2016: folds
TylerD1775: raises $0.37 to $0.47
turk1120: calls $0.37
PlayTheBlues4U: calls $0.37
*** FLOP *** [7c 7s 5c]
TylerD1775: bets $1.14
turk1120: folds
PlayTheBlues4U: folds
Uncalled bet ($1.14) returned to TylerD1775
TylerD1775 collected $1.39 from pot
*** SUMMARY ***
Total pot $1.46 | Rake $0.07
Board [7c 7s 5c]
Seat 1: turk1120 folded on the Flop
Seat 2: PlayTheBlues4U folded on the Flop
Seat 3: RNixon'sHead folded before Flop (didn't bet)
Seat 4: Pergy21 (button) folded before Flop (didn't bet)
Seat 5: tomasz2016 (small blind) folded before Flop
Seat 6: TylerD1775 (big blind) collected ($1.39)


PokerStars Hand #203841577021:  Hold'em No Limit ($0.05/$0.10 USD) - 2019/09/20 19:13:01 ET
Table 'Lacerta' 6-max Seat #3 is the button
Seat 1: turk1120 ($7.50 in chips)
Seat 2: PlayTheBlues4U ($9.85 in chips)
Seat 3: RNixon'sHead ($11.97 in chips)
Seat 4: Pergy21 ($9.90 in chips)
Seat 5: tomasz2016 ($1.65 in chips)
Seat 6: TylerD1775 ($19.13 in chips)
Pergy21: posts small blind $0.05
tomasz2016: posts big blind $0.10
*** HOLE CARDS ***
Dealt to PlayTheBlues4U [7d 8s]
TylerD1775: folds
turk1120: calls $0.10
PlayTheBlues4U: folds
RNixon'sHead: folds
Pergy21: calls $0.05
tomasz2016: checks
*** FLOP *** [4d Ad Kh]
Pergy21: checks
tomasz2016: checks
turk1120: bets $0.10
Pergy21: folds
tomasz2016: folds
Uncalled bet ($0.10) returned to turk1120
turk1120 collected $0.28 from pot
*** SUMMARY ***
Total pot $0.30 | Rake $0.02
Board [4d Ad Kh]
Seat 1: turk1120 collected ($0.28)
Seat 2: PlayTheBlues4U folded before Flop (didn't bet)
Seat 3: RNixon'sHead (button) folded before Flop (didn't bet)
Seat 4: Pergy21 (small blind) folded on the Flop
Seat 5: tomasz2016 (big blind) folded on the Flop
Seat 6: TylerD1775 folded before Flop (didn't bet)


PokerStars Hand #203841576998:  Hold'em No Limit ($0.02/$0.05 USD) - 2019/09/20 19:12:44 ET
Table 'Anser' 6-max Seat #4 is the button
Seat 1: CMc172 ($4.58 in chips)
Seat 2: Star6543 ($1.90 in chips)
Seat 3: dmakai ($4 in chips)
Seat 4: PlayTheBlues4U ($0.63 in chips)
Seat 5: lj001ll ($3.80 in chips)
Seat 6: DemolishIT ($8.46 in chips)
lj001ll: posts small blind $0.02
DemolishIT: posts big blind $0.05
Star6543: posts big blind $0.05
dmakai: posts big blind $0.05
*** HOLE CARDS ***
Dealt to PlayTheBlues4U [5c 2s]
CMc172: calls $0.05
Star6543: checks
dmakai: checks
PlayTheBlues4U: folds
lj001ll: folds
DemolishIT: checks
*** FLOP *** [Jd Jh Kc]
DemolishIT: checks
CMc172: checks
Star6543: bets $0.10
dmakai: calls $0.10
DemolishIT: calls $0.10
CMc172: folds
*** TURN *** [Jd Jh Kc] [Th]
DemolishIT: checks
Star6543: bets $0.20
dmakai: raises $0.50 to $0.70
DemolishIT: folds
Star6543: calls $0.50
*** RIVER *** [Jd Jh Kc Th] [3c]
Star6543: checks
dmakai: bets $1.80
Star6543: calls $1.05 and is all-in
Uncalled bet ($0.75) returned to dmakai
*** SHOW DOWN ***
dmakai: shows [Js 3s] (a full house, Jacks full of Threes)
Star6543: shows [Ts Ks] (two pair, Kings and Jacks)
dmakai collected $3.82 from pot
*** SUMMARY ***
Total pot $4.02 | Rake $0.20
Board [Jd Jh Kc Th 3c]
Seat 1: CMc172 folded on the Flop
Seat 2: Star6543 showed [Ts Ks] and lost with two pair, Kings and Jacks
Seat 3: dmakai showed [Js 3s] and won ($3.82) with a full house, Jacks full of Threes
Seat 4: PlayTheBlues4U (button) folded before Flop (didn't bet)
Seat 5: lj001ll (small blind) folded before Flop
Seat 6: DemolishIT (big blind) folded on the Turn


PokerStars Hand #203841576996:  Hold'em No Limit ($0.05/$0.10 USD) - 2019/09/20 19:12:41 ET
Table 'Lacerta' 6-max Seat #2 is the button
Seat 1: turk1120 ($7.50 in chips)
Seat 2: PlayTheBlues4U ($9.85 in chips)
Seat 3: RNixon'sHead ($12.02 in chips)
Seat 4: Pergy21 ($10 in chips)
Seat 5: tomasz2016 ($1.50 in chips)
Seat 6: TylerD1775 ($19.13 in chips)
RNixon'sHead: posts small blind $0.05
Pergy21: posts big blind $0.10
*** HOLE CARDS ***
Dealt to PlayTheBlues4U [Tc 4s]
tomasz2016: raises $0.25 to $0.35
TylerD1775: folds
turk1120: folds
PlayTheBlues4U: folds
RNixon'sHead: folds
Pergy21: folds
Uncalled bet ($0.25) returned to tomasz2016
tomasz2016 collected $0.25 from pot
tomasz2016: doesn't show hand
*** SUMMARY ***
Total pot $0.25 | Rake $0
Seat 1: turk1120 folded before Flop (didn't bet)
Seat 2: PlayTheBlues4U (button) folded before Flop (didn't bet)
Seat 3: RNixon'sHead (small blind) folded before Flop
Seat 4: Pergy21 (big blind) folded before Flop
Seat 5: tomasz2016 collected ($0.25)
Seat 6: TylerD1775 folded before Flop (didn't bet)


PokerStars Hand #203841576933:  Hold'em No Limit ($0.05/$0.10 USD) - 2019/09/20 19:12:05 ET
Table 'Lacerta' 6-max Seat #1 is the button
Seat 1: turk1120 ($8 in chips)
Seat 2: PlayTheBlues4U ($9.90 in chips)
Seat 3: RNixon'sHead ($11.52 in chips)
Seat 5: tomasz2016 ($1.50 in chips)
Seat 6: TylerD1775 ($19.13 in chips)
PlayTheBlues4U: posts small blind $0.05
RNixon'sHead: posts big blind $0.10
*** HOLE CARDS ***
Dealt to PlayTheBlues4U [4c Jh]
tomasz2016: folds
Pergy21 joins the table at seat #4
TylerD1775: folds
turk1120: calls $0.10
PlayTheBlues4U: folds
RNixon'sHead: raises $0.40 to $0.50
turk1120: calls $0.40
*** FLOP *** [6h 9h Qc]
RNixon'sHead: bets $0.52
turk1120: folds
Uncalled bet ($0.52) returned to RNixon'sHead
RNixon'sHead collected $1 from pot
RNixon'sHead: doesn't show hand
*** SUMMARY ***
Total pot $1.05 | Rake $0.05
Board [6h 9h Qc]
Seat 1: turk1120 (button) folded on the Flop
Seat 2: PlayTheBlues4U (small blind) folded before Flop
Seat 3: RNixon'sHead (big blind) collected ($1)
Seat 5: tomasz2016 folded before Flop (didn't bet)
Seat 6: TylerD1775 folded before Flop (didn't bet)


PokerStars Hand #203841576892:  Hold'em No Limit ($0.02/$0.05 USD) - 2019/09/20 19:11:43 ET
Table 'Anser' 6-max Seat #1 is the button
Seat 1: CMc172 ($4.78 in chips)
Seat 4: PlayTheBlues4U ($4.96 in chips)
Seat 5: lj001ll ($3.85 in chips)
Seat 6: DemolishIT ($4.33 in chips)
Star6543 will be allowed to play after the button
dmakai will be allowed to play after the button
PlayTheBlues4U: posts small blind $0.02
lj001ll: posts big blind $0.05
*** HOLE CARDS ***
Dealt to PlayTheBlues4U [4s As]
DemolishIT: raises $0.15 to $0.20
CMc172: calls $0.20
PlayTheBlues4U: calls $0.18
lj001ll: folds
*** FLOP *** [Js Qs Tc]
PlayTheBlues4U: bets $0.30
DemolishIT: raises $0.95 to $1.25
CMc172: folds
PlayTheBlues4U: raises $3.51 to $4.76 and is all-in
DemolishIT: calls $2.88 and is all-in
Uncalled bet ($0.63) returned to PlayTheBlues4U
*** TURN *** [Js Qs Tc] [Th]
*** RIVER *** [Js Qs Tc Th] [Qd]
*** SHOW DOWN ***
PlayTheBlues4U: shows [4s As] (two pair, Queens and Tens)
DemolishIT: shows [Ah Ad] (two pair, Aces and Queens)
DemolishIT collected $8.46 from pot
*** SUMMARY ***
Total pot $8.91 | Rake $0.45
Board [Js Qs Tc Th Qd]
Seat 1: CMc172 (button) folded on the Flop
Seat 4: PlayTheBlues4U (small blind) showed [4s As] and lost with two pair, Queens and Tens
Seat 5: lj001ll (big blind) folded before Flop
Seat 6: DemolishIT showed [Ah Ad] and won ($8.46) with two pair, Aces and Queens


PokerStars Hand #203841576877:  Hold'em No Limit ($0.05/$0.10 USD) - 2019/09/20 19:11:35 ET
Table 'Lacerta' 6-max Seat #6 is the button
Seat 1: turk1120 ($8.05 in chips)
Seat 2: PlayTheBlues4U ($10 in chips)
Seat 5: tomasz2016 ($1.50 in chips)
Seat 6: TylerD1775 ($18.98 in chips)
turk1120: posts small blind $0.05
PlayTheBlues4U: posts big blind $0.10
*** HOLE CARDS ***
Dealt to PlayTheBlues4U [6c Jh]
tomasz2016: folds
TylerD1775: raises $0.15 to $0.25
turk1120: folds
PlayTheBlues4U: folds
Uncalled bet ($0.15) returned to TylerD1775
TylerD1775 collected $0.25 from pot
*** SUMMARY ***
Total pot $0.25 | Rake $0
Seat 1: turk1120 (small blind) folded before Flop
Seat 2: PlayTheBlues4U (big blind) folded before Flop
Seat 5: tomasz2016 folded before Flop (didn't bet)
Seat 6: TylerD1775 (button) collected ($0.25)


PokerStars Hand #203841576786:  Hold'em No Limit ($0.02/$0.05 USD) - 2019/09/20 19:10:40 ET
Table 'Anser' 6-max Seat #6 is the button
Seat 1: CMc172 ($4.93 in chips)
Seat 4: PlayTheBlues4U ($5.01 in chips)
Seat 5: lj001ll ($3.62 in chips)
Seat 6: DemolishIT ($4.38 in chips)
CMc172: posts small blind $0.02
Star6543 joins the table at seat #2
dmakai is disconnected
dmakai has timed out
dmakai: is sitting out
PlayTheBlues4U: posts big blind $0.05
*** HOLE CARDS ***
Dealt to PlayTheBlues4U [7h 3c]
lj001ll: calls $0.05
DemolishIT: calls $0.05
CMc172: calls $0.03
PlayTheBlues4U: checks
*** FLOP *** [6h Ad 2c]
CMc172: checks
PlayTheBlues4U: checks
lj001ll: checks
DemolishIT: checks
*** TURN *** [6h Ad 2c] [Qs]
CMc172: checks
PlayTheBlues4U: checks
lj001ll: bets $0.10
DemolishIT: folds
CMc172: calls $0.10
PlayTheBlues4U: folds
*** RIVER *** [6h Ad 2c Qs] [6s]
CMc172: checks
lj001ll: checks
*** SHOW DOWN ***
CMc172: shows [3h 5s] (a pair of Sixes)
lj001ll: shows [Kc Td] (a pair of Sixes - Ace+King kicker)
lj001ll collected $0.38 from pot
*** SUMMARY ***
Total pot $0.40 | Rake $0.02
Board [6h Ad 2c Qs 6s]
Seat 1: CMc172 (small blind) showed [3h 5s] and lost with a pair of Sixes
Seat 4: PlayTheBlues4U (big blind) folded on the Turn
Seat 5: lj001ll showed [Kc Td] and won ($0.38) with a pair of Sixes
Seat 6: DemolishIT (button) folded on the Turn


PokerStars Hand #203841576691:  Hold'em No Limit ($0.02/$0.05 USD) - 2019/09/20 19:09:51 ET
Table 'Anser' 6-max Seat #5 is the button
Seat 1: CMc172 ($4.91 in chips)
Seat 4: PlayTheBlues4U ($5 in chips)
Seat 5: lj001ll ($3.62 in chips)
Seat 6: DemolishIT ($4.43 in chips)
DemolishIT: posts small blind $0.02
CMc172: posts big blind $0.05
*** HOLE CARDS ***
Dealt to PlayTheBlues4U [6c 6h]
dmakai joins the table at seat #3
PlayTheBlues4U: calls $0.05
lj001ll: folds
DemolishIT: calls $0.03
CMc172: checks
*** FLOP *** [Tc 7d 7h]
DemolishIT: checks
CMc172: checks
PlayTheBlues4U: bets $0.10
DemolishIT: folds
CMc172: calls $0.10
*** TURN *** [Tc 7d 7h] [Td]
CMc172: checks
PlayTheBlues4U: checks
*** RIVER *** [Tc 7d 7h Td] [Ts]
CMc172: checks
PlayTheBlues4U: checks
*** SHOW DOWN ***
CMc172: shows [8d Jh] (a full house, Tens full of Sevens)
PlayTheBlues4U: shows [6c 6h] (a full house, Tens full of Sevens)
CMc172 collected $0.17 from pot
PlayTheBlues4U collected $0.16 from pot
*** SUMMARY ***
Total pot $0.35 | Rake $0.02
Board [Tc 7d 7h Td Ts]
Seat 1: CMc172 (big blind) showed [8d Jh] and won ($0.17) with a full house, Tens full of Sevens
Seat 4: PlayTheBlues4U showed [6c 6h] and won ($0.16) with a full house, Tens full of Sevens
Seat 5: lj001ll (button) folded before Flop (didn't bet)
Seat 6: DemolishIT (small blind) folded on the Flop


PokerStars Hand #203841576619:  Hold'em No Limit ($0.02/$0.05 USD) - 2019/09/20 19:09:11 ET
Table 'Anser' 6-max Seat #4 is the button
Seat 1: CMc172 ($4.96 in chips)
Seat 4: PlayTheBlues4U ($5 in chips)
Seat 5: lj001ll ($3.64 in chips)
Seat 6: DemolishIT ($4.37 in chips)
lj001ll: posts small blind $0.02
DemolishIT: posts big blind $0.05
*** HOLE CARDS ***
Dealt to PlayTheBlues4U [3s Qs]
CMc172: calls $0.05
PlayTheBlues4U: folds
lj001ll: folds
DemolishIT: checks
*** FLOP *** [8c Kd 6h]
DemolishIT: checks
CMc172: checks
*** TURN *** [8c Kd 6h] [4h]
DemolishIT: checks
CMc172: checks
*** RIVER *** [8c Kd 6h 4h] [Ts]
DemolishIT: checks
CMc172: checks
*** SHOW DOWN ***
DemolishIT: shows [4c Th] (two pair, Tens and Fours)
CMc172: mucks hand
DemolishIT collected $0.11 from pot
*** SUMMARY ***
Total pot $0.12 | Rake $0.01
Board [8c Kd 6h 4h Ts]
Seat 1: CMc172 mucked [2d Ac]
Seat 4: PlayTheBlues4U (button) folded before Flop (didn't bet)
Seat 5: lj001ll (small blind) folded before Flop
Seat 6: DemolishIT (big blind) showed [4c Th] and won ($0.11) with two pair, Tens and Fours


PokerStars Hand #203841576497:  Hold'em No Limit ($0.02/$0.05 USD) - 2019/09/20 19:08:11 ET
Table 'Anser' 6-max Seat #1 is the button
Seat 1: CMc172 ($5.01 in chips)
Seat 4: PlayTheBlues4U ($5.05 in chips)
Seat 5: lj001ll ($3.50 in chips)
Seat 6: DemolishIT ($4.42 in chips)
PlayTheBlues4U: posts small blind $0.02
lj001ll: posts big blind $0.05
*** HOLE CARDS ***
Dealt to PlayTheBlues4U [6h 9s]
DemolishIT: calls $0.05
CMc172: calls $0.05
PlayTheBlues4U: calls $0.03
lj001ll: checks
*** FLOP *** [8h Kh 2s]
PlayTheBlues4U: checks
lj001ll: checks
DemolishIT: checks
CMc172: checks
*** TURN *** [8h Kh 2s] [Qc]
PlayTheBlues4U: checks
lj001ll: checks
DemolishIT: checks
CMc172: checks
*** RIVER *** [8h Kh 2s Qc] [7c]
PlayTheBlues4U: checks
lj001ll: checks
DemolishIT: checks
CMc172: checks
*** SHOW DOWN ***
PlayTheBlues4U: shows [6h 9s] (high card King)
lj001ll: shows [3s 2c] (a pair of Deuces)
DemolishIT: mucks hand
CMc172: mucks hand
lj001ll collected $0.19 from pot
*** SUMMARY ***
Total pot $0.20 | Rake $0.01
Board [8h Kh 2s Qc 7c]
Seat 1: CMc172 (button) mucked [As Jd]
Seat 4: PlayTheBlues4U (small blind) showed [6h 9s] and lost with high card King
Seat 5: lj001ll (big blind) showed [3s 2c] and won ($0.19) with a pair of Deuces
Seat 6: DemolishIT mucked [5d Ad]


PokerStars Hand #203841576448:  Hold'em No Limit ($0.02/$0.05 USD) - 2019/09/20 19:07:45 ET
Table 'Anser' 6-max Seat #6 is the button
Seat 1: CMc172 ($4.96 in chips)
Seat 4: PlayTheBlues4U ($5.10 in chips)
Seat 6: DemolishIT ($4.42 in chips)
CMc172: posts small blind $0.02
PlayTheBlues4U: posts big blind $0.05
lj001ll: sits out
*** HOLE CARDS ***
Dealt to PlayTheBlues4U [5c 6h]
DemolishIT: folds
CMc172: calls $0.03
PlayTheBlues4U: checks
*** FLOP *** [Qs 2h 7s]
CMc172: checks
PlayTheBlues4U: checks
*** TURN *** [Qs 2h 7s] [2c]
CMc172: checks
PlayTheBlues4U: checks
*** RIVER *** [Qs 2h 7s 2c] [4c]
CMc172: bets $0.05
PlayTheBlues4U: folds
Uncalled bet ($0.05) returned to CMc172
CMc172 collected $0.10 from pot
CMc172: doesn't show hand
*** SUMMARY ***
Total pot $0.10 | Rake $0
Board [Qs 2h 7s 2c 4c]
Seat 1: CMc172 (small blind) collected ($0.10)
Seat 4: PlayTheBlues4U (big blind) folded on the River
Seat 6: DemolishIT (button) folded before Flop (didn't bet)


PokerStars Hand #203841576407:  Hold'em No Limit ($0.02/$0.05 USD) - 2019/09/20 19:07:27 ET
Table 'Anser' 6-max Seat #4 is the button
Seat 1: CMc172 ($5.11 in chips)
Seat 4: PlayTheBlues4U ($4.95 in chips)
Seat 6: DemolishIT ($4.44 in chips)
lj001ll will be allowed to play after the button
DemolishIT: posts small blind $0.02
CMc172: posts big blind $0.05
*** HOLE CARDS ***
Dealt to PlayTheBlues4U [9c Kh]
PlayTheBlues4U: raises $0.10 to $0.15
DemolishIT: folds
CMc172: calls $0.10
*** FLOP *** [2s 2h Th]
CMc172: checks
PlayTheBlues4U: bets $0.15
CMc172: folds
Uncalled bet ($0.15) returned to PlayTheBlues4U
PlayTheBlues4U collected $0.30 from pot
PlayTheBlues4U: doesn't show hand
*** SUMMARY ***
Total pot $0.32 | Rake $0.02
Board [2s 2h Th]
Seat 1: CMc172 (big blind) folded on the Flop
Seat 4: PlayTheBlues4U (button) collected ($0.30)
Seat 6: DemolishIT (small blind) folded before Flop


PokerStars Hand #203841576295:  Hold'em No Limit ($0.02/$0.05 USD) - 2019/09/20 19:06:38 ET
Table 'Anser' 6-max Seat #1 is the button
Seat 1: CMc172 ($5.49 in chips)
Seat 3: HardMerch ($4.21 in chips)
Seat 4: PlayTheBlues4U ($5 in chips)
Seat 6: DemolishIT ($4 in chips)
HardMerch: posts small blind $0.02
PlayTheBlues4U: posts big blind $0.05
DemolishIT: posts big blind $0.05
*** HOLE CARDS ***
Dealt to PlayTheBlues4U [Js 4h]
DemolishIT: checks
CMc172: calls $0.05
HardMerch: calls $0.03
PlayTheBlues4U: checks
*** FLOP *** [7c Ad 7h]
HardMerch: checks
PlayTheBlues4U: checks
DemolishIT: checks
CMc172: bets $0.05
HardMerch: folds
lj001ll joins the table at seat #5
HardMerch leaves the table
PlayTheBlues4U: folds
DemolishIT: calls $0.05
*** TURN *** [7c Ad 7h] [Ks]
DemolishIT: checks
CMc172: checks
*** RIVER *** [7c Ad 7h Ks] [Jd]
DemolishIT: bets $0.28
CMc172: calls $0.28
*** SHOW DOWN ***
DemolishIT: shows [7s As] (a full house, Sevens full of Aces)
CMc172: mucks hand
DemolishIT collected $0.82 from pot
*** SUMMARY ***
Total pot $0.86 | Rake $0.04
Board [7c Ad 7h Ks Jd]
Seat 1: CMc172 (button) mucked [7d 2h]
Seat 3: HardMerch (small blind) folded on the Flop
Seat 4: PlayTheBlues4U (big blind) folded on the Flop
Seat 6: DemolishIT showed [7s As] and won ($0.82) with a full house, Sevens full of Aces


PokerStars Hand #203824859333:  Hold'em No Limit ($0.02/$0.05 USD) - 2019/09/19 21:13:41 ET
Table 'Pollux' 6-max Seat #6 is the button
Seat 1: PornoBob777 ($7.41 in chips)
Seat 2: absalon1320 ($3.24 in chips)
Seat 3: PlayTheBlues4U ($6.08 in chips)
Seat 5: JohanFlohan ($2.20 in chips)
Seat 6: Part77 ($4.90 in chips)
PornoBob777: posts small blind $0.02
absalon1320: posts big blind $0.05
timdalyiiiNJ: sits out
*** HOLE CARDS ***
Dealt to PlayTheBlues4U [Ad 9h]
PlayTheBlues4U: raises $0.10 to $0.15
JohanFlohan: calls $0.15
Part77: folds
PornoBob777: folds
absalon1320: calls $0.10
*** FLOP *** [6s 5s 7h]
absalon1320: bets $0.25
PlayTheBlues4U: folds
PlayTheBlues4U leaves the table
JohanFlohan is connected
JohanFlohan: calls $0.25
*** TURN *** [6s 5s 7h] [Qc]
absalon1320: checks
JohanFlohan: checks
*** RIVER *** [6s 5s 7h Qc] [4c]
absalon1320: bets $0.90
JohanFlohan: calls $0.90
*** SHOW DOWN ***
absalon1320: shows [8s Ac] (a straight, Four to Eight)
JohanFlohan: mucks hand
absalon1320 collected $2.63 from pot
*** SUMMARY ***
Total pot $2.77 | Rake $0.14
Board [6s 5s 7h Qc 4c]
Seat 1: PornoBob777 (small blind) folded before Flop
Seat 2: absalon1320 (big blind) showed [8s Ac] and won ($2.63) with a straight, Four to Eight
Seat 3: PlayTheBlues4U folded on the Flop
Seat 5: JohanFlohan mucked [9d 5d]
Seat 6: Part77 (button) folded before Flop (didn't bet)


PokerStars Hand #203824859159:  Hold'em No Limit ($0.02/$0.05 USD) - 2019/09/19 21:12:54 ET
Table 'Semele' 6-max Seat #5 is the button
Seat 2: V@nce12 ($4.39 in chips)
Seat 3: PlayTheBlues4U ($7.47 in chips)
Seat 5: tss22 ($2.05 in chips)
Seat 6: liaocs2016 ($8.12 in chips)
liaocs2016: posts small blind $0.02
V@nce12: posts big blind $0.05
*** HOLE CARDS ***
Dealt to PlayTheBlues4U [9d 9h]
PlayTheBlues4U: raises $0.10 to $0.15
tss22: folds
liaocs2016: folds
V@nce12: folds
Uncalled bet ($0.10) returned to PlayTheBlues4U
PlayTheBlues4U collected $0.12 from pot
seags21 was removed from the table for failing to post
seags21 leaves the table
PlayTheBlues4U: doesn't show hand
*** SUMMARY ***
Total pot $0.12 | Rake $0
Seat 2: V@nce12 (big blind) folded before Flop
Seat 3: PlayTheBlues4U collected ($0.12)
Seat 5: tss22 (button) folded before Flop (didn't bet)
Seat 6: liaocs2016 (small blind) folded before Flop


PokerStars Hand #203824859119:  Hold'em No Limit ($0.02/$0.05 USD) - 2019/09/19 21:12:42 ET
Table 'Pollux' 6-max Seat #5 is the button
Seat 1: PornoBob777 ($6.82 in chips)
Seat 2: absalon1320 ($3.84 in chips)
Seat 3: PlayTheBlues4U ($6.08 in chips)
Seat 5: JohanFlohan ($2.20 in chips)
Seat 6: Part77 ($4.95 in chips)
Part77: posts small blind $0.02
PornoBob777: posts big blind $0.05
timdalyiiiNJ: sits out
*** HOLE CARDS ***
Dealt to PlayTheBlues4U [2h Td]
absalon1320: calls $0.05
PlayTheBlues4U: folds
JohanFlohan: folds
Part77: calls $0.03
PornoBob777: checks
*** FLOP *** [5d 7h Jh]
Part77: checks
PornoBob777: bets $0.25
absalon1320: calls $0.25
Part77: folds
*** TURN *** [5d 7h Jh] [6c]
PornoBob777: checks
absalon1320: bets $0.30
PornoBob777: raises $3.75 to $4.05
absalon1320: folds
Uncalled bet ($3.75) returned to PornoBob777
PornoBob777 collected $1.19 from pot
PornoBob777: doesn't show hand
*** SUMMARY ***
Total pot $1.25 | Rake $0.06
Board [5d 7h Jh 6c]
Seat 1: PornoBob777 (big blind) collected ($1.19)
Seat 2: absalon1320 folded on the Turn
Seat 3: PlayTheBlues4U folded before Flop (didn't bet)
Seat 5: JohanFlohan (button) folded before Flop (didn't bet)
Seat 6: Part77 (small blind) folded on the Flop


PokerStars Hand #203824859069:  Hold'em No Limit ($0.02/$0.05 USD) - 2019/09/19 21:12:30 ET
Table 'Semele' 6-max Seat #3 is the button
Seat 2: V@nce12 ($4.51 in chips)
Seat 3: PlayTheBlues4U ($7.47 in chips)
Seat 5: tss22 ($1.88 in chips)
Seat 6: liaocs2016 ($8.17 in chips)
tss22: posts small blind $0.02
liaocs2016: posts big blind $0.05
*** HOLE CARDS ***
Dealt to PlayTheBlues4U [Qs 2c]
V@nce12: raises $0.07 to $0.12
PlayTheBlues4U: folds
tss22: raises $1.76 to $1.88 and is all-in
liaocs2016: folds
V@nce12: folds
Uncalled bet ($1.76) returned to tss22
tss22 collected $0.29 from pot
tss22: doesn't show hand
*** SUMMARY ***
Total pot $0.29 | Rake $0
Seat 2: V@nce12 folded before Flop
Seat 3: PlayTheBlues4U (button) folded before Flop (didn't bet)
Seat 5: tss22 (small blind) collected ($0.29)
Seat 6: liaocs2016 (big blind) folded before Flop


PokerStars Hand #203824859021:  Hold'em No Limit ($0.02/$0.05 USD) - 2019/09/19 21:12:15 ET
Table 'Semele' 6-max Seat #2 is the button
Seat 2: V@nce12 ($4.44 in chips)
Seat 3: PlayTheBlues4U ($7.49 in chips)
Seat 5: tss22 ($1.93 in chips)
Seat 6: liaocs2016 ($8.17 in chips)
PlayTheBlues4U: posts small blind $0.02
tss22: posts big blind $0.05
*** HOLE CARDS ***
Dealt to PlayTheBlues4U [2h Ks]
liaocs2016: folds
V@nce12: raises $0.07 to $0.12
PlayTheBlues4U: folds
seags21 is disconnected
tss22: folds
Uncalled bet ($0.07) returned to V@nce12
V@nce12 collected $0.12 from pot
V@nce12: doesn't show hand
*** SUMMARY ***
Total pot $0.12 | Rake $0
Seat 2: V@nce12 (button) collected ($0.12)
Seat 3: PlayTheBlues4U (small blind) folded before Flop
Seat 5: tss22 (big blind) folded before Flop
Seat 6: liaocs2016 folded before Flop (didn't bet)


PokerStars Hand #203824858891:  Hold'em No Limit ($0.02/$0.05 USD) - 2019/09/19 21:11:35 ET
Table 'Semele' 6-max Seat #6 is the button
Seat 2: V@nce12 ($4.39 in chips)
Seat 3: PlayTheBlues4U ($7.54 in chips)
Seat 4: crazy turfer ($4.91 in chips)
Seat 5: tss22 ($1.93 in chips)
Seat 6: liaocs2016 ($8.17 in chips)
V@nce12: posts small blind $0.02
PlayTheBlues4U: posts big blind $0.05
*** HOLE CARDS ***
Dealt to PlayTheBlues4U [Qd 9d]
crazy turfer has timed out
crazy turfer: folds
tss22: folds
liaocs2016: folds
V@nce12: calls $0.03
PlayTheBlues4U: checks
*** FLOP *** [7s 5s 4s]
V@nce12: checks
PlayTheBlues4U: checks
*** TURN *** [7s 5s 4s] [Th]
V@nce12: bets $0.06
PlayTheBlues4U: folds
Uncalled bet ($0.06) returned to V@nce12
V@nce12 collected $0.10 from pot
V@nce12: doesn't show hand
*** SUMMARY ***
Total pot $0.10 | Rake $0
Board [7s 5s 4s Th]
Seat 2: V@nce12 (small blind) collected ($0.10)
Seat 3: PlayTheBlues4U (big blind) folded on the Turn
Seat 4: crazy turfer folded before Flop (didn't bet)
Seat 5: tss22 folded before Flop (didn't bet)
Seat 6: liaocs2016 (button) folded before Flop (didn't bet)


PokerStars Hand #203824858850:  Hold'em No Limit ($0.02/$0.05 USD) - 2019/09/19 21:11:21 ET
Table 'Pollux' 6-max Seat #3 is the button
Seat 1: PornoBob777 ($5.06 in chips)
Seat 2: absalon1320 ($4.03 in chips)
Seat 3: PlayTheBlues4U ($7.32 in chips)
Seat 5: JohanFlohan ($2.64 in chips)
Seat 6: Part77 ($5 in chips)
JohanFlohan: posts small blind $0.02
Part77: posts big blind $0.05
absalon1320: posts small & big blinds $0.07
*** HOLE CARDS ***
Dealt to PlayTheBlues4U [Jd Ad]
PornoBob777: raises $0.12 to $0.17
absalon1320: calls $0.12
PlayTheBlues4U: raises $0.27 to $0.44
timdalyiiiNJ joins the table at seat #4
JohanFlohan: calls $0.42
Part77: folds
PornoBob777: calls $0.27
absalon1320: folds
*** FLOP *** [9s Ks 4c]
JohanFlohan: checks
PornoBob777: checks
PlayTheBlues4U: bets $0.80
JohanFlohan: folds
PornoBob777: calls $0.80
*** TURN *** [9s Ks 4c] [6c]
PornoBob777: checks
PlayTheBlues4U: checks
*** RIVER *** [9s Ks 4c 6c] [Kc]
PornoBob777: checks
PlayTheBlues4U: checks
*** SHOW DOWN ***
PornoBob777: shows [9h 8s] (two pair, Kings and Nines)
PlayTheBlues4U: mucks hand
PornoBob777 collected $3 from pot
*** SUMMARY ***
Total pot $3.16 | Rake $0.16
Board [9s Ks 4c 6c Kc]
Seat 1: PornoBob777 showed [9h 8s] and won ($3) with two pair, Kings and Nines
Seat 2: absalon1320 folded before Flop
Seat 3: PlayTheBlues4U (button) mucked [Jd Ad]
Seat 5: JohanFlohan (small blind) folded on the Flop
Seat 6: Part77 (big blind) folded before Flop


PokerStars Hand #203824858769:  Hold'em No Limit ($0.02/$0.05 USD) - 2019/09/19 21:10:56 ET
Table 'Semele' 6-max Seat #5 is the button
Seat 2: V@nce12 ($4.74 in chips)
Seat 3: PlayTheBlues4U ($7.21 in chips)
Seat 4: crazy turfer ($4.91 in chips)
Seat 5: tss22 ($1.93 in chips)
Seat 6: liaocs2016 ($8.19 in chips)
liaocs2016: posts small blind $0.02
V@nce12: posts big blind $0.05
*** HOLE CARDS ***
Dealt to PlayTheBlues4U [Ad Ac]
PlayTheBlues4U: raises $0.10 to $0.15
crazy turfer: folds
tss22: folds
liaocs2016: folds
V@nce12: calls $0.10
*** FLOP *** [Js 9h 2h]
V@nce12: checks
PlayTheBlues4U: bets $0.20
V@nce12: calls $0.20
*** TURN *** [Js 9h 2h] [Kh]
V@nce12: checks
PlayTheBlues4U: checks
*** RIVER *** [Js 9h 2h Kh] [Ah]
V@nce12: checks
PlayTheBlues4U: checks
*** SHOW DOWN ***
V@nce12: shows [8s Ks] (a pair of Kings)
PlayTheBlues4U: shows [Ad Ac] (three of a kind, Aces)
PlayTheBlues4U collected $0.68 from pot
*** SUMMARY ***
Total pot $0.72 | Rake $0.04
Board [Js 9h 2h Kh Ah]
Seat 2: V@nce12 (big blind) showed [8s Ks] and lost with a pair of Kings
Seat 3: PlayTheBlues4U showed [Ad Ac] and won ($0.68) with three of a kind, Aces
Seat 4: crazy turfer folded before Flop (didn't bet)
Seat 5: tss22 (button) folded before Flop (didn't bet)
Seat 6: liaocs2016 (small blind) folded before Flop


PokerStars Hand #203824858758:  Hold'em No Limit ($0.02/$0.05 USD) - 2019/09/19 21:10:54 ET
Table 'Pollux' 6-max Seat #1 is the button
Seat 1: PornoBob777 ($5.06 in chips)
Seat 3: PlayTheBlues4U ($7.27 in chips)
Seat 5: JohanFlohan ($2.69 in chips)
absalon1320 will be allowed to play after the button
PlayTheBlues4U: posts small blind $0.02
JohanFlohan: posts big blind $0.05
*** HOLE CARDS ***
Dealt to PlayTheBlues4U [Ac 2s]
PornoBob777: folds
Part77 joins the table at seat #6
PlayTheBlues4U: calls $0.03
JohanFlohan: checks
*** FLOP *** [9d 2d 9s]
PlayTheBlues4U: checks
JohanFlohan: checks
*** TURN *** [9d 2d 9s] [Kh]
PlayTheBlues4U: bets $0.05
JohanFlohan: folds
Uncalled bet ($0.05) returned to PlayTheBlues4U
PlayTheBlues4U collected $0.10 from pot
PlayTheBlues4U: doesn't show hand
*** SUMMARY ***
Total pot $0.10 | Rake $0
Board [9d 2d 9s Kh]
Seat 1: PornoBob777 (button) folded before Flop (didn't bet)
Seat 3: PlayTheBlues4U (small blind) collected ($0.10)
Seat 5: JohanFlohan (big blind) folded on the Turn


PokerStars Hand #203824858652:  Hold'em No Limit ($0.02/$0.05 USD) - 2019/09/19 21:10:22 ET
Table 'Pollux' 6-max Seat #5 is the button
Seat 1: PornoBob777 ($5.08 in chips)
Seat 3: PlayTheBlues4U ($7.16 in chips)
Seat 5: JohanFlohan ($2.79 in chips)
PornoBob777: posts small blind $0.02
PlayTheBlues4U: posts big blind $0.05
*** HOLE CARDS ***
Dealt to PlayTheBlues4U [Th Jd]
JohanFlohan: calls $0.05
PornoBob777: folds
PlayTheBlues4U: checks
*** FLOP *** [Qd 5d Qc]
PlayTheBlues4U: checks
JohanFlohan: checks
*** TURN *** [Qd 5d Qc] [Td]
PlayTheBlues4U: bets $0.05
JohanFlohan: calls $0.05
*** RIVER *** [Qd 5d Qc Td] [5s]
PlayTheBlues4U: checks
JohanFlohan: checks
*** SHOW DOWN ***
PlayTheBlues4U: shows [Th Jd] (two pair, Queens and Tens)
JohanFlohan: mucks hand
PlayTheBlues4U collected $0.21 from pot
*** SUMMARY ***
Total pot $0.22 | Rake $0.01
Board [Qd 5d Qc Td 5s]
Seat 1: PornoBob777 (small blind) folded before Flop
Seat 3: PlayTheBlues4U (big blind) showed [Th Jd] and won ($0.21) with two pair, Queens and Tens
Seat 5: JohanFlohan (button) mucked [Ah 9c]


PokerStars Hand #203824858612:  Hold'em No Limit ($0.02/$0.05 USD) - 2019/09/19 21:10:09 ET
Table 'Semele' 6-max Seat #4 is the button
Seat 2: V@nce12 ($4.74 in chips)
Seat 3: PlayTheBlues4U ($7.21 in chips)
Seat 4: crazy turfer ($4.76 in chips)
Seat 5: tss22 ($1.95 in chips)
Seat 6: liaocs2016 ($8.34 in chips)
tss22: posts small blind $0.02
liaocs2016: posts big blind $0.05
*** HOLE CARDS ***
Dealt to PlayTheBlues4U [Qd 6s]
V@nce12: folds
PlayTheBlues4U: folds
crazy turfer: raises $0.10 to $0.15
tss22: folds
liaocs2016: calls $0.10
*** FLOP *** [Jh 8d 7d]
liaocs2016: checks
crazy turfer: bets $0.30
liaocs2016: folds
Uncalled bet ($0.30) returned to crazy turfer
crazy turfer collected $0.30 from pot
*** SUMMARY ***
Total pot $0.32 | Rake $0.02
Board [Jh 8d 7d]
Seat 2: V@nce12 folded before Flop (didn't bet)
Seat 3: PlayTheBlues4U folded before Flop (didn't bet)
Seat 4: crazy turfer (button) collected ($0.30)
Seat 5: tss22 (small blind) folded before Flop
Seat 6: liaocs2016 (big blind) folded on the Flop


PokerStars Hand #203824858521:  Hold'em No Limit ($0.02/$0.05 USD) - 2019/09/19 21:09:44 ET
Table 'Pollux' 6-max Seat #3 is the button
Seat 1: PornoBob777 ($5.13 in chips)
Seat 3: PlayTheBlues4U ($6.66 in chips)
Seat 5: JohanFlohan ($3.29 in chips)
JohanFlohan: posts small blind $0.02
PornoBob777: posts big blind $0.05
*** HOLE CARDS ***
Dealt to PlayTheBlues4U [Th 7h]
PlayTheBlues4U: raises $0.10 to $0.15
JohanFlohan: calls $0.13
PornoBob777: folds
*** FLOP *** [8c 3d 5d]
JohanFlohan: checks
PlayTheBlues4U: checks
*** TURN *** [8c 3d 5d] [Ts]
JohanFlohan: bets $0.10
PlayTheBlues4U: calls $0.10
*** RIVER *** [8c 3d 5d Ts] [4c]
JohanFlohan: bets $0.25
PlayTheBlues4U: calls $0.25
*** SHOW DOWN ***
JohanFlohan: shows [As 7c] (high card Ace)
PlayTheBlues4U: shows [Th 7h] (a pair of Tens)
PlayTheBlues4U collected $1 from pot
*** SUMMARY ***
Total pot $1.05 | Rake $0.05
Board [8c 3d 5d Ts 4c]
Seat 1: PornoBob777 (big blind) folded before Flop
Seat 3: PlayTheBlues4U (button) showed [Th 7h] and won ($1) with a pair of Tens
Seat 5: JohanFlohan (small blind) showed [As 7c] and lost with high card Ace


PokerStars Hand #203824858507:  Hold'em No Limit ($0.02/$0.05 USD) - 2019/09/19 21:09:40 ET
Table 'Semele' 6-max Seat #3 is the button
Seat 2: V@nce12 ($4.74 in chips)
Seat 3: PlayTheBlues4U ($7.14 in chips)
Seat 4: crazy turfer ($4.78 in chips)
Seat 5: tss22 ($2 in chips)
Seat 6: liaocs2016 ($8.34 in chips)
crazy turfer: posts small blind $0.02
tss22: posts big blind $0.05
*** HOLE CARDS ***
Dealt to PlayTheBlues4U [9d 8d]
liaocs2016: folds
V@nce12: folds
PlayTheBlues4U: raises $0.10 to $0.15
seags21 is disconnected
crazy turfer: folds
tss22: folds
Uncalled bet ($0.10) returned to PlayTheBlues4U
PlayTheBlues4U collected $0.12 from pot
PlayTheBlues4U: doesn't show hand
*** SUMMARY ***
Total pot $0.12 | Rake $0
Seat 2: V@nce12 folded before Flop (didn't bet)
Seat 3: PlayTheBlues4U (button) collected ($0.12)
Seat 4: crazy turfer (small blind) folded before Flop
Seat 5: tss22 (big blind) folded before Flop
Seat 6: liaocs2016 folded before Flop (didn't bet)


PokerStars Hand #203824858381:  Hold'em No Limit ($0.02/$0.05 USD) - 2019/09/19 21:09:01 ET
Table 'Pollux' 6-max Seat #1 is the button
Seat 1: PornoBob777 ($5.13 in chips)
Seat 3: PlayTheBlues4U ($6.61 in chips)
Seat 5: JohanFlohan ($3.34 in chips)
PlayTheBlues4U: posts small blind $0.02
JohanFlohan: posts big blind $0.05
*** HOLE CARDS ***
Dealt to PlayTheBlues4U [8s 2h]
PornoBob777: folds
PlayTheBlues4U: calls $0.03
JohanFlohan: checks
*** FLOP *** [3s 3h Ac]
PlayTheBlues4U: checks
JohanFlohan: checks
*** TURN *** [3s 3h Ac] [6s]
PlayTheBlues4U: checks
JohanFlohan: checks
*** RIVER *** [3s 3h Ac 6s] [8c]
PlayTheBlues4U: checks
JohanFlohan: checks
*** SHOW DOWN ***
PlayTheBlues4U: shows [8s 2h] (two pair, Eights and Threes)
JohanFlohan: mucks hand
PlayTheBlues4U collected $0.10 from pot
xxzuluzuluxx was removed from the table for failing to post
xxzuluzuluxx leaves the table
*** SUMMARY ***
Total pot $0.10 | Rake $0
Board [3s 3h Ac 6s 8c]
Seat 1: PornoBob777 (button) folded before Flop (didn't bet)
Seat 3: PlayTheBlues4U (small blind) showed [8s 2h] and won ($0.10) with two pair, Eights and Threes
Seat 5: JohanFlohan (big blind) mucked [9d Ks]


PokerStars Hand #203824858355:  Hold'em No Limit ($0.02/$0.05 USD) - 2019/09/19 21:08:56 ET
Table 'Pollux' 6-max Seat #5 is the button
Seat 1: PornoBob777 ($5.15 in chips)
Seat 3: PlayTheBlues4U ($6.59 in chips)
Seat 5: JohanFlohan ($3.34 in chips)
PornoBob777: posts small blind $0.02
PlayTheBlues4U: posts big blind $0.05
*** HOLE CARDS ***
Dealt to PlayTheBlues4U [Tc 6s]
JohanFlohan: folds
PornoBob777: folds
Uncalled bet ($0.03) returned to PlayTheBlues4U
PlayTheBlues4U collected $0.04 from pot
PlayTheBlues4U: doesn't show hand
*** SUMMARY ***
Total pot $0.04 | Rake $0
Seat 1: PornoBob777 (small blind) folded before Flop
Seat 3: PlayTheBlues4U (big blind) collected ($0.04)
Seat 5: JohanFlohan (button) folded before Flop (didn't bet)


PokerStars Hand #203824858298:  Hold'em No Limit ($0.02/$0.05 USD) - 2019/09/19 21:08:37 ET
Table 'Pollux' 6-max Seat #3 is the button
Seat 1: PornoBob777 ($5.10 in chips)
Seat 3: PlayTheBlues4U ($6.59 in chips)
Seat 5: JohanFlohan ($3.39 in chips)
JohanFlohan: posts small blind $0.02
PornoBob777: posts big blind $0.05
*** HOLE CARDS ***
Dealt to PlayTheBlues4U [Jd 2d]
PlayTheBlues4U: folds
JohanFlohan: calls $0.03
PornoBob777: checks
*** FLOP *** [7h Tc 4h]
JohanFlohan: checks
PornoBob777: checks
*** TURN *** [7h Tc 4h] [9h]
JohanFlohan: checks
PornoBob777: checks
*** RIVER *** [7h Tc 4h 9h] [4c]
JohanFlohan: checks
PornoBob777: checks
*** SHOW DOWN ***
JohanFlohan: shows [Kc Ah] (a pair of Fours)
PornoBob777: shows [7s 3s] (two pair, Sevens and Fours)
PornoBob777 collected $0.10 from pot
crazy turfer was removed from the table for failing to post
crazy turfer leaves the table
*** SUMMARY ***
Total pot $0.10 | Rake $0
Board [7h Tc 4h 9h 4c]
Seat 1: PornoBob777 (big blind) showed [7s 3s] and won ($0.10) with two pair, Sevens and Fours
Seat 3: PlayTheBlues4U (button) folded before Flop (didn't bet)
Seat 5: JohanFlohan (small blind) showed [Kc Ah] and lost with a pair of Fours


PokerStars Hand #203824858296:  Hold'em No Limit ($0.02/$0.05 USD) - 2019/09/19 21:08:37 ET
Table 'Semele' 6-max Seat #2 is the button
Seat 2: V@nce12 ($4.74 in chips)
Seat 3: PlayTheBlues4U ($7.49 in chips)
Seat 4: crazy turfer ($4.93 in chips)
Seat 6: liaocs2016 ($7.88 in chips)
PlayTheBlues4U: posts small blind $0.02
crazy turfer: posts big blind $0.05
tss22: sits out
*** HOLE CARDS ***
Dealt to PlayTheBlues4U [Ts Js]
liaocs2016: raises $0.10 to $0.15
V@nce12: folds
PlayTheBlues4U: calls $0.13
crazy turfer: calls $0.10
*** FLOP *** [Kh Th 2h]
PlayTheBlues4U: bets $0.20
crazy turfer: folds
liaocs2016: calls $0.20
*** TURN *** [Kh Th 2h] [7s]
PlayTheBlues4U: checks
liaocs2016: bets $0.80
PlayTheBlues4U: folds
Uncalled bet ($0.80) returned to liaocs2016
liaocs2016 collected $0.81 from pot
liaocs2016: doesn't show hand
*** SUMMARY ***
Total pot $0.85 | Rake $0.04
Board [Kh Th 2h 7s]
Seat 2: V@nce12 (button) folded before Flop (didn't bet)
Seat 3: PlayTheBlues4U (small blind) folded on the Turn
Seat 4: crazy turfer (big blind) folded on the Flop
Seat 6: liaocs2016 collected ($0.81)


PokerStars Hand #203824858265:  Hold'em No Limit ($0.02/$0.05 USD) - 2019/09/19 21:08:27 ET
Table 'Pollux' 6-max Seat #1 is the button
Seat 1: PornoBob777 ($5.10 in chips)
Seat 2: absalon1320 ($4.05 in chips)
Seat 3: PlayTheBlues4U ($6.57 in chips)
Seat 5: JohanFlohan ($3.39 in chips)
absalon1320: posts small blind $0.02
PlayTheBlues4U: posts big blind $0.05
*** HOLE CARDS ***
Dealt to PlayTheBlues4U [2c Qh]
JohanFlohan: folds
PornoBob777: folds
absalon1320: folds
Uncalled bet ($0.03) returned to PlayTheBlues4U
PlayTheBlues4U collected $0.04 from pot
PlayTheBlues4U: doesn't show hand
*** SUMMARY ***
Total pot $0.04 | Rake $0
Seat 1: PornoBob777 (button) folded before Flop (didn't bet)
Seat 2: absalon1320 (small blind) folded before Flop
Seat 3: PlayTheBlues4U (big blind) collected ($0.04)
Seat 5: JohanFlohan folded before Flop (didn't bet)


PokerStars Hand #203824858193:  Hold'em No Limit ($0.02/$0.05 USD) - 2019/09/19 21:08:07 ET
Table 'Pollux' 6-max Seat #5 is the button
Seat 1: PornoBob777 ($5 in chips)
Seat 2: absalon1320 ($4.10 in chips)
Seat 3: PlayTheBlues4U ($6.57 in chips)
Seat 5: JohanFlohan ($3.44 in chips)
PornoBob777: posts small blind $0.02
absalon1320: posts big blind $0.05
*** HOLE CARDS ***
Dealt to PlayTheBlues4U [2d 4d]
PlayTheBlues4U: folds
JohanFlohan: calls $0.05
PornoBob777: raises $0.12 to $0.17
absalon1320: folds
JohanFlohan: folds
Uncalled bet ($0.12) returned to PornoBob777
PornoBob777 collected $0.15 from pot
PornoBob777: doesn't show hand
*** SUMMARY ***
Total pot $0.15 | Rake $0
Seat 1: PornoBob777 (small blind) collected ($0.15)
Seat 2: absalon1320 (big blind) folded before Flop
Seat 3: PlayTheBlues4U folded before Flop (didn't bet)
Seat 5: JohanFlohan (button) folded before Flop


PokerStars Hand #203824858187:  Hold'em No Limit ($0.02/$0.05 USD) - 2019/09/19 21:08:06 ET
Table 'Semele' 6-max Seat #6 is the button
Seat 2: V@nce12 ($4.76 in chips)
Seat 3: PlayTheBlues4U ($7.54 in chips)
Seat 4: crazy turfer ($5 in chips)
Seat 6: liaocs2016 ($7.75 in chips)
V@nce12: posts small blind $0.02
PlayTheBlues4U: posts big blind $0.05
crazy turfer: posts small & big blinds $0.07
*** HOLE CARDS ***
Dealt to PlayTheBlues4U [Qc 9d]
crazy turfer: checks
liaocs2016: calls $0.05
V@nce12: folds
PlayTheBlues4U: checks
*** FLOP *** [7d 5s 5c]
PlayTheBlues4U: checks
tss22 joins the table at seat #5
crazy turfer: checks
liaocs2016: bets $0.20
PlayTheBlues4U: folds
crazy turfer: folds
Uncalled bet ($0.20) returned to liaocs2016
liaocs2016 collected $0.18 from pot
liaocs2016: doesn't show hand
*** SUMMARY ***
Total pot $0.19 | Rake $0.01
Board [7d 5s 5c]
Seat 2: V@nce12 (small blind) folded before Flop
Seat 3: PlayTheBlues4U (big blind) folded on the Flop
Seat 4: crazy turfer folded on the Flop (didn't bet)
Seat 6: liaocs2016 (button) collected ($0.18)


PokerStars Hand #203824858150:  Hold'em No Limit ($0.02/$0.05 USD) - 2019/09/19 21:07:54 ET
Table 'Semele' 6-max Seat #3 is the button
Seat 2: V@nce12 ($4.81 in chips)
Seat 3: PlayTheBlues4U ($7.54 in chips)
Seat 6: liaocs2016 ($7.70 in chips)
crazy turfer will be allowed to play after the button
liaocs2016: posts small blind $0.02
V@nce12: posts big blind $0.05
*** HOLE CARDS ***
Dealt to PlayTheBlues4U [3h 8c]
PlayTheBlues4U: folds
liaocs2016: raises $0.10 to $0.15
V@nce12: folds
Uncalled bet ($0.10) returned to liaocs2016
liaocs2016 collected $0.10 from pot
liaocs2016: doesn't show hand
*** SUMMARY ***
Total pot $0.10 | Rake $0
Seat 2: V@nce12 (big blind) folded before Flop
Seat 3: PlayTheBlues4U (button) folded before Flop (didn't bet)
Seat 6: liaocs2016 (small blind) collected ($0.10)


PokerStars Hand #203824858084:  Hold'em No Limit ($0.02/$0.05 USD) - 2019/09/19 21:07:34 ET
Table 'Pollux' 6-max Seat #3 is the button
Seat 1: PornoBob777 ($5 in chips)
Seat 2: absalon1320 ($4.04 in chips)
Seat 3: PlayTheBlues4U ($6.57 in chips)
Seat 5: JohanFlohan ($3.46 in chips)
JohanFlohan: posts small blind $0.02
PornoBob777: posts big blind $0.05
*** HOLE CARDS ***
Dealt to PlayTheBlues4U [Jc 3d]
absalon1320: calls $0.05
PlayTheBlues4U: folds
JohanFlohan: folds
PornoBob777: checks
*** FLOP *** [Jh 2s 9d]
PornoBob777: checks
absalon1320: checks
*** TURN *** [Jh 2s 9d] [7d]
PornoBob777: checks
absalon1320: checks
*** RIVER *** [Jh 2s 9d 7d] [5d]
PornoBob777: checks
absalon1320: checks
*** SHOW DOWN ***
PornoBob777: shows [Td 3s] (high card Jack)
absalon1320: shows [3c 7c] (a pair of Sevens)
absalon1320 collected $0.11 from pot
*** SUMMARY ***
Total pot $0.12 | Rake $0.01
Board [Jh 2s 9d 7d 5d]
Seat 1: PornoBob777 (big blind) showed [Td 3s] and lost with high card Jack
Seat 2: absalon1320 showed [3c 7c] and won ($0.11) with a pair of Sevens
Seat 3: PlayTheBlues4U (button) folded before Flop (didn't bet)
Seat 5: JohanFlohan (small blind) folded before Flop


PokerStars Hand #203824858078:  Hold'em No Limit ($0.02/$0.05 USD) - 2019/09/19 21:07:32 ET
Table 'Semele' 6-max Seat #2 is the button
Seat 2: V@nce12 ($4.93 in chips)
Seat 3: PlayTheBlues4U ($7.37 in chips)
Seat 6: liaocs2016 ($7.75 in chips)
PlayTheBlues4U: posts small blind $0.02
liaocs2016: posts big blind $0.05
*** HOLE CARDS ***
Dealt to PlayTheBlues4U [Jc Jd]
V@nce12: raises $0.07 to $0.12
PlayTheBlues4U: raises $0.22 to $0.34
liaocs2016: folds
V@nce12: folds
Uncalled bet ($0.22) returned to PlayTheBlues4U
PlayTheBlues4U collected $0.29 from pot
PlayTheBlues4U: doesn't show hand
*** SUMMARY ***
Total pot $0.29 | Rake $0
Seat 2: V@nce12 (button) folded before Flop
Seat 3: PlayTheBlues4U (small blind) collected ($0.29)
Seat 6: liaocs2016 (big blind) folded before Flop


PokerStars Hand #203824858032:  Hold'em No Limit ($0.02/$0.05 USD) - 2019/09/19 21:07:19 ET
Table 'Semele' 6-max Seat #6 is the button
Seat 2: V@nce12 ($4.95 in chips)
Seat 3: PlayTheBlues4U ($7.35 in chips)
Seat 6: liaocs2016 ($7.75 in chips)
V@nce12: posts small blind $0.02
PlayTheBlues4U: posts big blind $0.05
*** HOLE CARDS ***
Dealt to PlayTheBlues4U [2d 5c]
liaocs2016: folds
V@nce12: folds
Uncalled bet ($0.03) returned to PlayTheBlues4U
PlayTheBlues4U collected $0.04 from pot
PlayTheBlues4U: doesn't show hand
*** SUMMARY ***
Total pot $0.04 | Rake $0
Seat 2: V@nce12 (small blind) folded before Flop
Seat 3: PlayTheBlues4U (big blind) collected ($0.04)
Seat 6: liaocs2016 (button) folded before Flop (didn't bet)


PokerStars Hand #203824857856:  Hold'em No Limit ($0.02/$0.05 USD) - 2019/09/19 21:06:27 ET
Table 'Pollux' 6-max Seat #2 is the button
Seat 1: PornoBob777 ($5 in chips)
Seat 2: absalon1320 ($3.87 in chips)
Seat 3: PlayTheBlues4U ($6.59 in chips)
Seat 5: JohanFlohan ($3.51 in chips)
PlayTheBlues4U: posts small blind $0.02
JohanFlohan: posts big blind $0.05
*** HOLE CARDS ***
Dealt to PlayTheBlues4U [2h 9d]
PornoBob777: raises $0.07 to $0.12
absalon1320: calls $0.12
PlayTheBlues4U: folds
JohanFlohan: folds
*** FLOP *** [7s 4s 4h]
PornoBob777: checks
absalon1320: bets $0.15
PornoBob777: folds
Uncalled bet ($0.15) returned to absalon1320
absalon1320 collected $0.29 from pot
*** SUMMARY ***
Total pot $0.31 | Rake $0.02
Board [7s 4s 4h]
Seat 1: PornoBob777 folded on the Flop
Seat 2: absalon1320 (button) collected ($0.29)
Seat 3: PlayTheBlues4U (small blind) folded before Flop
Seat 5: JohanFlohan (big blind) folded before Flop


PokerStars Hand #203824857741:  Hold'em No Limit ($0.02/$0.05 USD) - 2019/09/19 21:05:54 ET
Table 'Semele' 6-max Seat #5 is the button
Seat 2: V@nce12 ($5 in chips)
Seat 3: PlayTheBlues4U ($7.35 in chips)
Seat 4: crazy turfer ($3.49 in chips)
Seat 5: boxerpupp727 ($6.43 in chips)
Seat 6: liaocs2016 ($4.56 in chips)
liaocs2016: posts small blind $0.02
V@nce12: posts big blind $0.05
*** HOLE CARDS ***
Dealt to PlayTheBlues4U [Ah 7s]
PlayTheBlues4U: folds
crazy turfer: calls $0.05
boxerpupp727: folds
liaocs2016: raises $0.10 to $0.15
V@nce12: folds
crazy turfer: calls $0.10
*** FLOP *** [Tc Ks 2h]
liaocs2016: bets $0.20
crazy turfer: calls $0.20
*** TURN *** [Tc Ks 2h] [Jc]
boxerpupp727 leaves the table
liaocs2016: bets $0.50
crazy turfer: raises $0.50 to $1
liaocs2016: calls $0.50
*** RIVER *** [Tc Ks 2h Jc] [2d]
liaocs2016: bets $2.60
crazy turfer: calls $2.14 and is all-in
Uncalled bet ($0.46) returned to liaocs2016
*** SHOW DOWN ***
liaocs2016: shows [Kh Th] (two pair, Kings and Tens)
crazy turfer: shows [Kd 9c] (two pair, Kings and Deuces)
liaocs2016 collected $6.68 from pot
*** SUMMARY ***
Total pot $7.03 | Rake $0.35
Board [Tc Ks 2h Jc 2d]
Seat 2: V@nce12 (big blind) folded before Flop
Seat 3: PlayTheBlues4U folded before Flop (didn't bet)
Seat 4: crazy turfer showed [Kd 9c] and lost with two pair, Kings and Deuces
Seat 5: boxerpupp727 (button) folded before Flop (didn't bet)
Seat 6: liaocs2016 (small blind) showed [Kh Th] and won ($6.68) with two pair, Kings and Tens


PokerStars Hand #203824857554:  Hold'em No Limit ($0.02/$0.05 USD) - 2019/09/19 21:05:00 ET
Table 'Pollux' 6-max Seat #1 is the button
Seat 1: PornoBob777 ($5 in chips)
Seat 2: absalon1320 ($4.35 in chips)
Seat 3: PlayTheBlues4U ($5.57 in chips)
Seat 5: JohanFlohan ($3.65 in chips)
absalon1320: posts small blind $0.02
PlayTheBlues4U: posts big blind $0.05
JohanFlohan: posts small & big blinds $0.07
*** HOLE CARDS ***
Dealt to PlayTheBlues4U [Ah 7c]
JohanFlohan: checks
PornoBob777: raises $0.07 to $0.12
absalon1320: calls $0.10
PlayTheBlues4U: calls $0.07
JohanFlohan: calls $0.07
*** FLOP *** [Ac 7h 2d]
absalon1320: checks
PlayTheBlues4U: checks
JohanFlohan: checks
PornoBob777: bets $0.36
absalon1320: calls $0.36
PlayTheBlues4U: calls $0.36
JohanFlohan: folds
*** TURN *** [Ac 7h 2d] [Ks]
absalon1320: checks
PlayTheBlues4U: checks
PornoBob777: checks
*** RIVER *** [Ac 7h 2d Ks] [2s]
absalon1320: checks
PlayTheBlues4U: bets $1.15
PornoBob777: folds
absalon1320: folds
Uncalled bet ($1.15) returned to PlayTheBlues4U
PlayTheBlues4U collected $1.50 from pot
PlayTheBlues4U: doesn't show hand
*** SUMMARY ***
Total pot $1.58 | Rake $0.08
Board [Ac 7h 2d Ks 2s]
Seat 1: PornoBob777 (button) folded on the River
Seat 2: absalon1320 (small blind) folded on the River
Seat 3: PlayTheBlues4U (big blind) collected ($1.50)
Seat 5: JohanFlohan folded on the Flop


PokerStars Hand #203824857539:  Hold'em No Limit ($0.02/$0.05 USD) - 2019/09/19 21:04:55 ET
Table 'Pollux' 6-max Seat #3 is the button
Seat 1: PornoBob777 ($5 in chips)
Seat 2: absalon1320 ($4.33 in chips)
Seat 3: PlayTheBlues4U ($5.57 in chips)
JohanFlohan will be allowed to play after the button
PornoBob777: posts small blind $0.02
absalon1320: posts big blind $0.05
*** HOLE CARDS ***
Dealt to PlayTheBlues4U [Qc 8c]
PlayTheBlues4U: folds
PornoBob777: folds
Uncalled bet ($0.03) returned to absalon1320
absalon1320 collected $0.04 from pot
*** SUMMARY ***
Total pot $0.04 | Rake $0
Seat 1: PornoBob777 (small blind) folded before Flop
Seat 2: absalon1320 (big blind) collected ($0.04)
Seat 3: PlayTheBlues4U (button) folded before Flop (didn't bet)


PokerStars Hand #203824857430:  Hold'em No Limit ($0.02/$0.05 USD) - 2019/09/19 21:04:25 ET
Table 'Semele' 6-max Seat #4 is the button
Seat 2: CMc172 ($5.67 in chips)
Seat 3: PlayTheBlues4U ($7.35 in chips)
Seat 4: crazy turfer ($4.09 in chips)
Seat 5: boxerpupp727 ($6.45 in chips)
Seat 6: liaocs2016 ($4 in chips)
boxerpupp727: posts small blind $0.02
liaocs2016: posts big blind $0.05
*** HOLE CARDS ***
Dealt to PlayTheBlues4U [6h Qc]
CMc172: folds
PlayTheBlues4U: folds
crazy turfer: raises $0.10 to $0.15
CMc172 leaves the table
V@nce12 joins the table at seat #2
boxerpupp727: folds
liaocs2016: calls $0.10
*** FLOP *** [7d 5s 7s]
liaocs2016: checks
crazy turfer: bets $0.15
liaocs2016: calls $0.15
*** TURN *** [7d 5s 7s] [Ah]
liaocs2016: checks
crazy turfer: bets $0.30
liaocs2016: calls $0.30
*** RIVER *** [7d 5s 7s Ah] [Ad]
liaocs2016: bets $0.60
crazy turfer: folds
Uncalled bet ($0.60) returned to liaocs2016
liaocs2016 collected $1.16 from pot
liaocs2016: doesn't show hand
*** SUMMARY ***
Total pot $1.22 | Rake $0.06
Board [7d 5s 7s Ah Ad]
Seat 2: CMc172 folded before Flop (didn't bet)
Seat 3: PlayTheBlues4U folded before Flop (didn't bet)
Seat 4: crazy turfer (button) folded on the River
Seat 5: boxerpupp727 (small blind) folded before Flop
Seat 6: liaocs2016 (big blind) collected ($1.16)


PokerStars Hand #203824857339:  Hold'em No Limit ($0.02/$0.05 USD) - 2019/09/19 21:03:59 ET
Table 'Pollux' 6-max Seat #2 is the button
Seat 1: PornoBob777 ($5 in chips)
Seat 2: absalon1320 ($4.38 in chips)
Seat 3: PlayTheBlues4U ($5.07 in chips)
PlayTheBlues4U: posts small blind $0.02
PornoBob777: posts big blind $0.05
*** HOLE CARDS ***
Dealt to PlayTheBlues4U [Ad Qc]
absalon1320: calls $0.05
PlayTheBlues4U: raises $0.15 to $0.20
PornoBob777: calls $0.15
absalon1320: folds
*** FLOP *** [Ah 7h Qd]
PlayTheBlues4U: bets $0.30
PornoBob777: calls $0.30
*** TURN *** [Ah 7h Qd] [Jd]
PlayTheBlues4U: bets $0.80
PornoBob777: folds
Uncalled bet ($0.80) returned to PlayTheBlues4U
PlayTheBlues4U collected $1 from pot
PlayTheBlues4U: doesn't show hand
*** SUMMARY ***
Total pot $1.05 | Rake $0.05
Board [Ah 7h Qd Jd]
Seat 1: PornoBob777 (big blind) folded on the Turn
Seat 2: absalon1320 (button) folded before Flop
Seat 3: PlayTheBlues4U (small blind) collected ($1)


PokerStars Hand #203824857329:  Hold'em No Limit ($0.02/$0.05 USD) - 2019/09/19 21:03:55 ET
Table 'Semele' 6-max Seat #3 is the button
Seat 2: CMc172 ($5.82 in chips)
Seat 3: PlayTheBlues4U ($7.35 in chips)
Seat 4: crazy turfer ($0.88 in chips)
Seat 5: boxerpupp727 ($6.50 in chips)
Seat 6: liaocs2016 ($3.67 in chips)
crazy turfer: posts small blind $0.02
boxerpupp727: posts big blind $0.05
*** HOLE CARDS ***
Dealt to PlayTheBlues4U [5c 2h]
liaocs2016: raises $0.10 to $0.15
CMc172: calls $0.15
PlayTheBlues4U: folds
crazy turfer: calls $0.13
boxerpupp727: folds
*** FLOP *** [5d 6h Ah]
crazy turfer: checks
liaocs2016: bets $0.30
CMc172: folds
crazy turfer: folds
Uncalled bet ($0.30) returned to liaocs2016
liaocs2016 collected $0.48 from pot
liaocs2016: doesn't show hand
*** SUMMARY ***
Total pot $0.50 | Rake $0.02
Board [5d 6h Ah]
Seat 2: CMc172 folded on the Flop
Seat 3: PlayTheBlues4U (button) folded before Flop (didn't bet)
Seat 4: crazy turfer (small blind) folded on the Flop
Seat 5: boxerpupp727 (big blind) folded before Flop
Seat 6: liaocs2016 collected ($0.48)


PokerStars Hand #203824857207:  Hold'em No Limit ($0.02/$0.05 USD) - 2019/09/19 21:03:21 ET
Table 'Pollux' 6-max Seat #1 is the button
Seat 1: PornoBob777 ($5 in chips)
Seat 2: absalon1320 ($4.40 in chips)
Seat 3: PlayTheBlues4U ($5.05 in chips)
Seat 5: JohanFlohan ($3.65 in chips)
absalon1320: posts small blind $0.02
PlayTheBlues4U: posts big blind $0.05
*** HOLE CARDS ***
Dealt to PlayTheBlues4U [8d 5d]
JohanFlohan has timed out
JohanFlohan: folds
PornoBob777: folds
absalon1320: folds
Uncalled bet ($0.03) returned to PlayTheBlues4U
PlayTheBlues4U collected $0.04 from pot
PlayTheBlues4U: doesn't show hand
*** SUMMARY ***
Total pot $0.04 | Rake $0
Seat 1: PornoBob777 (button) folded before Flop (didn't bet)
Seat 2: absalon1320 (small blind) folded before Flop
Seat 3: PlayTheBlues4U (big blind) collected ($0.04)
Seat 5: JohanFlohan folded before Flop (didn't bet)


PokerStars Hand #203824857118:  Hold'em No Limit ($0.02/$0.05 USD) - 2019/09/19 21:02:53 ET
Table 'Semele' 6-max Seat #2 is the button
Seat 2: CMc172 ($6.02 in chips)
Seat 3: PlayTheBlues4U ($6.98 in chips)
Seat 4: crazy turfer ($1.08 in chips)
Seat 5: boxerpupp727 ($6.50 in chips)
Seat 6: liaocs2016 ($3.67 in chips)
PlayTheBlues4U: posts small blind $0.02
crazy turfer: posts big blind $0.05
*** HOLE CARDS ***
Dealt to PlayTheBlues4U [9h Ts]
boxerpupp727: folds
boxerpupp727 said, "under. bet smart"
liaocs2016: folds
CMc172: calls $0.05
boxerpupp727 said, "givven"
PlayTheBlues4U: calls $0.03
boxerpupp727 said, "both suck lol"
crazy turfer: raises $0.15 to $0.20
CMc172: calls $0.15
PlayTheBlues4U: calls $0.15
*** FLOP *** [Kc 2d 5d]
PlayTheBlues4U: checks
crazy turfer: checks
CMc172: checks
*** TURN *** [Kc 2d 5d] [8h]
PlayTheBlues4U: bets $0.35
crazy turfer: folds
CMc172: folds
Uncalled bet ($0.35) returned to PlayTheBlues4U
PlayTheBlues4U collected $0.57 from pot
PlayTheBlues4U: doesn't show hand
*** SUMMARY ***
Total pot $0.60 | Rake $0.03
Board [Kc 2d 5d 8h]
Seat 2: CMc172 (button) folded on the Turn
Seat 3: PlayTheBlues4U (small blind) collected ($0.57)
Seat 4: crazy turfer (big blind) folded on the Turn
Seat 5: boxerpupp727 folded before Flop (didn't bet)
Seat 6: liaocs2016 folded before Flop (didn't bet)


PokerStars Hand #203824857017:  Hold'em No Limit ($0.02/$0.05 USD) - 2019/09/19 21:02:25 ET
Table 'Pollux' 6-max Seat #5 is the button
Seat 1: PornoBob777 ($5 in chips)
Seat 2: absalon1320 ($3.42 in chips)
Seat 3: PlayTheBlues4U ($5.05 in chips)
Seat 5: JohanFlohan ($3.65 in chips)
PornoBob777: posts small blind $0.02
absalon1320: posts big blind $0.05
*** HOLE CARDS ***
Dealt to PlayTheBlues4U [9d 6s]
PlayTheBlues4U: folds
JohanFlohan: folds
PornoBob777: raises $0.07 to $0.12
absalon1320: calls $0.07
*** FLOP *** [3h 7s 4s]
PornoBob777: bets $0.17
absalon1320: calls $0.17
*** TURN *** [3h 7s 4s] [6c]
PornoBob777: checks
absalon1320: checks
*** RIVER *** [3h 7s 4s 6c] [As]
PornoBob777: bets $0.25
absalon1320: raises $0.55 to $0.80
PornoBob777: calls $0.55
*** SHOW DOWN ***
absalon1320: shows [Qs Ks] (a flush, Ace high)
PornoBob777: mucks hand
absalon1320 collected $2.07 from pot
*** SUMMARY ***
Total pot $2.18 | Rake $0.11
Board [3h 7s 4s 6c As]
Seat 1: PornoBob777 (small blind) mucked [7c 7d]
Seat 2: absalon1320 (big blind) showed [Qs Ks] and won ($2.07) with a flush, Ace high
Seat 3: PlayTheBlues4U folded before Flop (didn't bet)
Seat 5: JohanFlohan (button) folded before Flop (didn't bet)


PokerStars Hand #203824856901:  Hold'em No Limit ($0.02/$0.05 USD) - 2019/09/19 21:01:54 ET
Table 'Pollux' 6-max Seat #3 is the button
Seat 1: PornoBob777 ($5 in chips)
Seat 2: absalon1320 ($3.12 in chips)
Seat 3: PlayTheBlues4U ($5.20 in chips)
Seat 5: JohanFlohan ($3.67 in chips)
JohanFlohan: posts small blind $0.02
PornoBob777: posts big blind $0.05
*** HOLE CARDS ***
Dealt to PlayTheBlues4U [Ks 9d]
absalon1320: calls $0.05
PlayTheBlues4U: raises $0.10 to $0.15
JohanFlohan: folds
PornoBob777: calls $0.10
absalon1320: calls $0.10
*** FLOP *** [Jh 9h 4h]
PornoBob777: checks
absalon1320: bets $0.25
PlayTheBlues4U: folds
PornoBob777: folds
Uncalled bet ($0.25) returned to absalon1320
absalon1320 collected $0.45 from pot
*** SUMMARY ***
Total pot $0.47 | Rake $0.02
Board [Jh 9h 4h]
Seat 1: PornoBob777 (big blind) folded on the Flop
Seat 2: absalon1320 collected ($0.45)
Seat 3: PlayTheBlues4U (button) folded on the Flop
Seat 5: JohanFlohan (small blind) folded before Flop


PokerStars Hand #203824856888:  Hold'em No Limit ($0.02/$0.05 USD) - 2019/09/19 21:01:50 ET
Table 'Semele' 6-max Seat #6 is the button
Seat 2: CMc172 ($6.27 in chips)
Seat 3: PlayTheBlues4U ($6.38 in chips)
Seat 4: crazy turfer ($1.48 in chips)
Seat 5: boxerpupp727 ($6.50 in chips)
Seat 6: liaocs2016 ($3.67 in chips)
CMc172: posts small blind $0.02
PlayTheBlues4U: posts big blind $0.05
*** HOLE CARDS ***
Dealt to PlayTheBlues4U [4d 8d]
crazy turfer: raises $0.10 to $0.15
boxerpupp727: folds
liaocs2016: folds
CMc172: calls $0.13
PlayTheBlues4U: calls $0.10
*** FLOP *** [Kh 8s Kd]
CMc172: checks
PlayTheBlues4U: checks
crazy turfer: bets $0.10
CMc172: calls $0.10
PlayTheBlues4U: calls $0.10
*** TURN *** [Kh 8s Kd] [2s]
CMc172: checks
PlayTheBlues4U: checks
crazy turfer: bets $0.15
CMc172: folds
PlayTheBlues4U: calls $0.15
*** RIVER *** [Kh 8s Kd 2s] [9c]
PlayTheBlues4U: checks
crazy turfer: checks
*** SHOW DOWN ***
PlayTheBlues4U: shows [4d 8d] (two pair, Kings and Eights)
crazy turfer: mucks hand
PlayTheBlues4U collected $1 from pot
*** SUMMARY ***
Total pot $1.05 | Rake $0.05
Board [Kh 8s Kd 2s 9c]
Seat 2: CMc172 (small blind) folded on the Turn
Seat 3: PlayTheBlues4U (big blind) showed [4d 8d] and won ($1) with two pair, Kings and Eights
Seat 4: crazy turfer mucked [Th Qd]
Seat 5: boxerpupp727 folded before Flop (didn't bet)
Seat 6: liaocs2016 (button) folded before Flop (didn't bet)


PokerStars Hand #203824856867:  Hold'em No Limit ($0.02/$0.05 USD) - 2019/09/19 21:01:42 ET
Table 'Pollux' 6-max Seat #2 is the button
Seat 1: jvilla119 ($2.24 in chips)
Seat 2: absalon1320 ($3.05 in chips)
Seat 3: PlayTheBlues4U ($5.22 in chips)
Seat 5: JohanFlohan ($3.72 in chips)
PlayTheBlues4U: posts small blind $0.02
JohanFlohan: posts big blind $0.05
*** HOLE CARDS ***
Dealt to PlayTheBlues4U [9d 3c]
jvilla119: folds
jvilla119 leaves the table
absalon1320: raises $0.12 to $0.17
PornoBob777 joins the table at seat #1
PlayTheBlues4U: folds
JohanFlohan: folds
Uncalled bet ($0.12) returned to absalon1320
absalon1320 collected $0.12 from pot
*** SUMMARY ***
Total pot $0.12 | Rake $0
Seat 1: jvilla119 folded before Flop (didn't bet)
Seat 2: absalon1320 (button) collected ($0.12)
Seat 3: PlayTheBlues4U (small blind) folded before Flop
Seat 5: JohanFlohan (big blind) folded before Flop


PokerStars Hand #203998489753:  Hold'em No Limit ($0.05/$0.10 USD) - 2019/09/26 22:53:56 ET
Table 'Lynx' 6-max Seat #4 is the button
Seat 1: BigBlue ($7.10 in chips)
Seat 2: winbabywin7 ($6.40 in chips)
Seat 3: mellneazy ($17.29 in chips)
Seat 4: Ribeye63 ($12.17 in chips)
Seat 5: PlayTheBlues4U ($19.74 in chips)
Seat 6: donjt2653 ($10.12 in chips)
PlayTheBlues4U: posts small blind $0.05
donjt2653: posts big blind $0.10
*** HOLE CARDS ***
Dealt to PlayTheBlues4U [Qh Tc]
BigBlue: folds
winbabywin7: calls $0.10
mellneazy: folds
Ribeye63: calls $0.10
PlayTheBlues4U: calls $0.05
donjt2653: checks
*** FLOP *** [As 5d Ah]
PlayTheBlues4U: checks
donjt2653: bets $0.10
winbabywin7: folds
Ribeye63: folds
PlayTheBlues4U: folds
Uncalled bet ($0.10) returned to donjt2653
donjt2653 collected $0.38 from pot
donjt2653: doesn't show hand
*** SUMMARY ***
Total pot $0.40 | Rake $0.02
Board [As 5d Ah]
Seat 1: BigBlue folded before Flop (didn't bet)
Seat 2: winbabywin7 folded on the Flop
Seat 3: mellneazy folded before Flop (didn't bet)
Seat 4: Ribeye63 (button) folded on the Flop
Seat 5: PlayTheBlues4U (small blind) folded on the Flop
Seat 6: donjt2653 (big blind) collected ($0.38)








PokerStars Hand #203998489514:  Hold'em No Limit ($0.05/$0.10 USD) - 2019/09/26 22:52:33 ET
Table 'Lynx' 6-max Seat #3 is the button
Seat 1: BigBlue ($7.10 in chips)
Seat 2: winbabywin7 ($6.40 in chips)
Seat 3: mellneazy ($13.98 in chips)
Seat 4: Ribeye63 ($12.22 in chips)
Seat 5: PlayTheBlues4U ($22.89 in chips)
Seat 6: donjt2653 ($10.57 in chips)
Ribeye63: posts small blind $0.05
PlayTheBlues4U: posts big blind $0.10
*** HOLE CARDS ***
Dealt to PlayTheBlues4U [As 6c]
donjt2653: calls $0.10
BigBlue: folds
winbabywin7: folds
mellneazy: raises $0.35 to $0.45
Ribeye63: folds
PlayTheBlues4U: calls $0.35
donjt2653: calls $0.35
*** FLOP *** [6d 6s Js]
PlayTheBlues4U: checks
donjt2653: checks
mellneazy: bets $0.70
PlayTheBlues4U: calls $0.70
donjt2653: folds
*** TURN *** [6d 6s Js] [4s]
PlayTheBlues4U: checks
mellneazy: checks
*** RIVER *** [6d 6s Js 4s] [Tc]
PlayTheBlues4U: checks
mellneazy: bets $2
PlayTheBlues4U: calls $2
*** SHOW DOWN ***
mellneazy: shows [Jh 6h] (a full house, Sixes full of Jacks)
PlayTheBlues4U: mucks hand
mellneazy collected $6.46 from pot
*** SUMMARY ***
Total pot $6.80 | Rake $0.34
Board [6d 6s Js 4s Tc]
Seat 1: BigBlue folded before Flop (didn't bet)
Seat 2: winbabywin7 folded before Flop (didn't bet)
Seat 3: mellneazy (button) showed [Jh 6h] and won ($6.46) with a full house, Sixes full of Jacks
Seat 4: Ribeye63 (small blind) folded before Flop
Seat 5: PlayTheBlues4U (big blind) mucked [As 6c]
Seat 6: donjt2653 folded on the Flop


PokerStars Hand #203998489439:  Hold'em No Limit ($0.05/$0.10 USD) - 2019/09/26 22:52:06 ET
Table 'Lynx' 6-max Seat #2 is the button
Seat 1: BigBlue ($7.10 in chips)
Seat 2: winbabywin7 ($6.40 in chips)
Seat 3: mellneazy ($13.80 in chips)
Seat 4: Ribeye63 ($12.32 in chips)
Seat 5: PlayTheBlues4U ($22.89 in chips)
Seat 6: donjt2653 ($10.67 in chips)
mellneazy: posts small blind $0.05
Ribeye63: posts big blind $0.10
*** HOLE CARDS ***
Dealt to PlayTheBlues4U [Ad 4s]
PlayTheBlues4U: folds
donjt2653: calls $0.10
BigBlue: folds
winbabywin7: folds
mellneazy: calls $0.05
Ribeye63: checks
*** FLOP *** [9d 7c Jh]
mellneazy: bets $13.70 and is all-in
Ribeye63: folds
donjt2653: folds
Uncalled bet ($13.70) returned to mellneazy
mellneazy collected $0.28 from pot
mellneazy: doesn't show hand
*** SUMMARY ***
Total pot $0.30 | Rake $0.02
Board [9d 7c Jh]
Seat 1: BigBlue folded before Flop (didn't bet)
Seat 2: winbabywin7 (button) folded before Flop (didn't bet)
Seat 3: mellneazy (small blind) collected ($0.28)
Seat 4: Ribeye63 (big blind) folded on the Flop
Seat 5: PlayTheBlues4U folded before Flop (didn't bet)
Seat 6: donjt2653 folded on the Flop





PokerStars Hand #203998489275:  Hold'em No Limit ($0.05/$0.10 USD) - 2019/09/26 22:51:09 ET
Table 'Lynx' 6-max Seat #1 is the button
Seat 1: BigBlue ($7.10 in chips)
Seat 2: winbabywin7 ($7.60 in chips)
Seat 3: mellneazy ($11.58 in chips)
Seat 4: Ribeye63 ($12.32 in chips)
Seat 5: PlayTheBlues4U ($22.89 in chips)
Seat 6: donjt2653 ($11.87 in chips)
winbabywin7: posts small blind $0.05
mellneazy: posts big blind $0.10
*** HOLE CARDS ***
Dealt to PlayTheBlues4U [Qd 6s]
Ribeye63: folds
PlayTheBlues4U: folds
donjt2653: raises $0.20 to $0.30
BigBlue: folds
winbabywin7: calls $0.25
mellneazy: raises $0.90 to $1.20
donjt2653: calls $0.90
winbabywin7: calls $0.90
*** FLOP *** [Ts 9c Kh]
winbabywin7: checks
mellneazy: bets $2
donjt2653: folds
winbabywin7: folds
Uncalled bet ($2) returned to mellneazy
mellneazy collected $3.42 from pot
mellneazy: doesn't show hand
*** SUMMARY ***
Total pot $3.60 | Rake $0.18
Board [Ts 9c Kh]
Seat 1: BigBlue (button) folded before Flop (didn't bet)
Seat 2: winbabywin7 (small blind) folded on the Flop
Seat 3: mellneazy (big blind) collected ($3.42)
Seat 4: Ribeye63 folded before Flop (didn't bet)
Seat 5: PlayTheBlues4U folded before Flop (didn't bet)
Seat 6: donjt2653 folded on the Flop



PokerStars Hand #203998488967:  Hold'em No Limit ($0.05/$0.10 USD) - 2019/09/26 22:49:29 ET
Table 'Lynx' 6-max Seat #6 is the button
Seat 1: BigBlue ($7.15 in chips)
Seat 2: winbabywin7 ($7.70 in chips)
Seat 3: mellneazy ($20.38 in chips)
Seat 4: Ribeye63 ($12.32 in chips)
Seat 5: PlayTheBlues4U ($14.07 in chips)
Seat 6: donjt2653 ($12.67 in chips)
BigBlue: posts small blind $0.05
winbabywin7: posts big blind $0.10
*** HOLE CARDS ***
Dealt to PlayTheBlues4U [7c 7d]
mellneazy: raises $0.20 to $0.30
Ribeye63: folds
PlayTheBlues4U: calls $0.30
donjt2653: calls $0.30
BigBlue: folds
winbabywin7: folds
*** FLOP *** [5h 5s 7h]
mellneazy: bets $0.50
PlayTheBlues4U: calls $0.50
donjt2653: calls $0.50
*** TURN *** [5h 5s 7h] [Kh]
mellneazy: checks
PlayTheBlues4U: bets $1.60
donjt2653: folds
mellneazy: calls $1.60
*** RIVER *** [5h 5s 7h Kh] [Ts]
mellneazy: bets $3
PlayTheBlues4U: raises $3.40 to $6.40
mellneazy: calls $3.40
*** SHOW DOWN ***
PlayTheBlues4U: shows [7c 7d] (a full house, Sevens full of Fives)
mellneazy: mucks hand
PlayTheBlues4U collected $17.62 from pot
*** SUMMARY ***
Total pot $18.55 | Rake $0.93
Board [5h 5s 7h Kh Ts]
Seat 1: BigBlue (small blind) folded before Flop
Seat 2: winbabywin7 (big blind) folded before Flop
Seat 3: mellneazy mucked [Ah 9h]
Seat 4: Ribeye63 folded before Flop (didn't bet)
Seat 5: PlayTheBlues4U showed [7c 7d] and won ($17.62) with a full house, Sevens full of Fives
Seat 6: donjt2653 (button) folded on the Turn


PokerStars Hand #203998488838:  Hold'em No Limit ($0.05/$0.10 USD) - 2019/09/26 22:48:42 ET
Table 'Delphinus' 6-max Seat #1 is the button
Seat 1: daughterstuitio ($9.72 in chips)
Seat 2: maxplans323 ($6.68 in chips)
Seat 3: joncruise ($14.76 in chips)
Seat 4: 921zhaopeng ($8.23 in chips)
Seat 5: SuWasup ($9.27 in chips)
Seat 6: PlayTheBlues4U ($7.48 in chips)
maxplans323: posts small blind $0.05
joncruise: posts big blind $0.10
*** HOLE CARDS ***
Dealt to PlayTheBlues4U [Kc Kh]
921zhaopeng: raises $0.10 to $0.20
SuWasup: calls $0.20
PlayTheBlues4U: raises $0.10 to $0.30
daughterstuitio: calls $0.30
maxplans323: folds
joncruise: calls $0.20
921zhaopeng: raises $1.15 to $1.45
SuWasup: folds
PlayTheBlues4U: raises $1.75 to $3.20
daughterstuitio: folds
joncruise: folds
921zhaopeng: calls $1.75
*** FLOP *** [3d 4d 2c]
921zhaopeng: bets $3.40
PlayTheBlues4U: raises $0.88 to $4.28 and is all-in
921zhaopeng: calls $0.88
*** TURN *** [3d 4d 2c] [5d]
*** RIVER *** [3d 4d 2c 5d] [3s]
*** SHOW DOWN ***
921zhaopeng: shows [Ad Jc] (a straight, Ace to Five)
PlayTheBlues4U: shows [Kc Kh] (two pair, Kings and Threes)
921zhaopeng collected $15.02 from pot
*** SUMMARY ***
Total pot $15.81 | Rake $0.79
Board [3d 4d 2c 5d 3s]
Seat 1: daughterstuitio (button) folded before Flop
Seat 2: maxplans323 (small blind) folded before Flop
Seat 3: joncruise (big blind) folded before Flop
Seat 4: 921zhaopeng showed [Ad Jc] and won ($15.02) with a straight, Ace to Five
Seat 5: SuWasup folded before Flop
Seat 6: PlayTheBlues4U showed [Kc Kh] and lost with two pair, Kings and Threes


PokerStars Hand #203998488804:  Hold'em No Limit ($0.05/$0.10 USD) - 2019/09/26 22:48:31 ET
Table 'Lynx' 6-max Seat #5 is the button
Seat 1: BigBlue ($7.25 in chips)
Seat 2: winbabywin7 ($7.70 in chips)
Seat 3: mellneazy ($20.38 in chips)
Seat 4: Ribeye63 ($12.32 in chips)
Seat 5: PlayTheBlues4U ($14.07 in chips)
Seat 6: donjt2653 ($12.58 in chips)
donjt2653: posts small blind $0.05
BigBlue: posts big blind $0.10
*** HOLE CARDS ***
Dealt to PlayTheBlues4U [Ts 2s]
winbabywin7: folds
mellneazy: folds
Ribeye63: folds
PlayTheBlues4U: folds
donjt2653: calls $0.05
BigBlue: checks
*** FLOP *** [4c 7s 8d]
donjt2653: checks
BigBlue: checks
*** TURN *** [4c 7s 8d] [4h]
donjt2653: bets $0.10
BigBlue: folds
Uncalled bet ($0.10) returned to donjt2653
donjt2653 collected $0.19 from pot
donjt2653: doesn't show hand
*** SUMMARY ***
Total pot $0.20 | Rake $0.01
Board [4c 7s 8d 4h]
Seat 1: BigBlue (big blind) folded on the Turn
Seat 2: winbabywin7 folded before Flop (didn't bet)
Seat 3: mellneazy folded before Flop (didn't bet)
Seat 4: Ribeye63 folded before Flop (didn't bet)
Seat 5: PlayTheBlues4U (button) folded before Flop (didn't bet)
Seat 6: donjt2653 (small blind) collected ($0.19)

PokerStars Hand #203998488649:  Hold'em No Limit ($0.05/$0.10 USD) - 2019/09/26 22:47:35 ET
Table 'Delphinus' 6-max Seat #6 is the button
Seat 1: daughterstuitio ($10.02 in chips)
Seat 2: maxplans323 ($7.38 in chips)
Seat 3: joncruise ($14.76 in chips)
Seat 4: 921zhaopeng ($7.31 in chips)
Seat 5: SuWasup ($9.27 in chips)
Seat 6: PlayTheBlues4U ($7.48 in chips)
daughterstuitio: posts small blind $0.05
maxplans323: posts big blind $0.10
*** HOLE CARDS ***
Dealt to PlayTheBlues4U [5h 2c]
joncruise: folds
921zhaopeng: raises $0.20 to $0.30
SuWasup: folds
PlayTheBlues4U: folds
daughterstuitio: calls $0.25
maxplans323: calls $0.20
*** FLOP *** [Ah Ts 3d]
daughterstuitio: checks
maxplans323: checks
921zhaopeng: checks
*** TURN *** [Ah Ts 3d] [Ks]
daughterstuitio: checks
maxplans323: checks
921zhaopeng: bets $0.40
daughterstuitio: folds
maxplans323: calls $0.40
*** RIVER *** [Ah Ts 3d Ks] [Tc]
maxplans323: checks
921zhaopeng: checks
*** SHOW DOWN ***
maxplans323: shows [5s 6s] (a pair of Tens)
921zhaopeng: shows [9h 8h] (a pair of Tens - Ace+King+Nine kicker)
921zhaopeng collected $1.62 from pot
*** SUMMARY ***
Total pot $1.70 | Rake $0.08
Board [Ah Ts 3d Ks Tc]
Seat 1: daughterstuitio (small blind) folded on the Turn
Seat 2: maxplans323 (big blind) showed [5s 6s] and lost with a pair of Tens
Seat 3: joncruise folded before Flop (didn't bet)
Seat 4: 921zhaopeng showed [9h 8h] and won ($1.62) with a pair of Tens
Seat 5: SuWasup folded before Flop (didn't bet)
Seat 6: PlayTheBlues4U (button) folded before Flop (didn't bet)


PokerStars Hand #203998488633:  Hold'em No Limit ($0.05/$0.10 USD) - 2019/09/26 22:47:32 ET
Table 'Lynx' 6-max Seat #4 is the button
Seat 1: BigBlue ($7.25 in chips)
Seat 2: winbabywin7 ($8 in chips)
Seat 3: mellneazy ($20.38 in chips)
Seat 4: Ribeye63 ($12.42 in chips)
Seat 5: PlayTheBlues4U ($14.12 in chips)
Seat 6: donjt2653 ($12.17 in chips)
PlayTheBlues4U: posts small blind $0.05
donjt2653: posts big blind $0.10
winbabywin7: posts big blind $0.10
*** HOLE CARDS ***
Dealt to PlayTheBlues4U [6s Jd]
BigBlue: folds
winbabywin7: checks
mellneazy: folds
Ribeye63: calls $0.10
PlayTheBlues4U: folds
donjt2653: checks
*** FLOP *** [4d Kh Tc]
donjt2653: checks
winbabywin7: checks
Ribeye63: checks
*** TURN *** [4d Kh Tc] [3s]
donjt2653: checks
winbabywin7: checks
Ribeye63: checks
*** RIVER *** [4d Kh Tc 3s] [3c]
donjt2653: bets $0.20
winbabywin7: calls $0.20
Ribeye63: folds
*** SHOW DOWN ***
donjt2653: shows [Ts Kd] (two pair, Kings and Tens)
winbabywin7: mucks hand
donjt2653 collected $0.71 from pot
*** SUMMARY ***
Total pot $0.75 | Rake $0.04
Board [4d Kh Tc 3s 3c]
Seat 1: BigBlue folded before Flop (didn't bet)
Seat 2: winbabywin7 mucked [4h 2c]
Seat 3: mellneazy folded before Flop (didn't bet)
Seat 4: Ribeye63 (button) folded on the River
Seat 5: PlayTheBlues4U (small blind) folded before Flop
Seat 6: donjt2653 (big blind) showed [Ts Kd] and won ($0.71) with two pair, Kings and Tens


PokerStars Hand #203998488460:  Hold'em No Limit ($0.05/$0.10 USD) - 2019/09/26 22:46:30 ET
Table 'Delphinus' 6-max Seat #5 is the button
Seat 1: daughterstuitio ($10.12 in chips)
Seat 2: maxplans323 ($6.66 in chips)
Seat 3: joncruise ($14.76 in chips)
Seat 4: 921zhaopeng ($7.31 in chips)
Seat 5: SuWasup ($9.27 in chips)
Seat 6: PlayTheBlues4U ($8.18 in chips)
PlayTheBlues4U: posts small blind $0.05
daughterstuitio: posts big blind $0.10
*** HOLE CARDS ***
Dealt to PlayTheBlues4U [8d 6d]
maxplans323: raises $0.20 to $0.30
joncruise: folds
921zhaopeng: folds
SuWasup: folds
PlayTheBlues4U: calls $0.25
daughterstuitio: folds
*** FLOP *** [5h Qc Kd]
PlayTheBlues4U: bets $0.40
maxplans323: calls $0.40
*** TURN *** [5h Qc Kd] [3c]
PlayTheBlues4U: checks
maxplans323: checks
*** RIVER *** [5h Qc Kd 3c] [Th]
PlayTheBlues4U: checks
maxplans323: bets $0.95
PlayTheBlues4U: folds
Uncalled bet ($0.95) returned to maxplans323
maxplans323 collected $1.42 from pot
maxplans323: doesn't show hand
*** SUMMARY ***
Total pot $1.50 | Rake $0.08
Board [5h Qc Kd 3c Th]
Seat 1: daughterstuitio (big blind) folded before Flop
Seat 2: maxplans323 collected ($1.42)
Seat 3: joncruise folded before Flop (didn't bet)
Seat 4: 921zhaopeng folded before Flop (didn't bet)
Seat 5: SuWasup (button) folded before Flop (didn't bet)
Seat 6: PlayTheBlues4U (small blind) folded on the River


PokerStars Hand #203998488434:  Hold'em No Limit ($0.05/$0.10 USD) - 2019/09/26 22:46:18 ET
Table 'Lynx' 6-max Seat #3 is the button
Seat 1: BigBlue ($7.25 in chips)
Seat 3: mellneazy ($21.53 in chips)
Seat 4: Ribeye63 ($12.47 in chips)
Seat 5: PlayTheBlues4U ($15.27 in chips)
Seat 6: donjt2653 ($10 in chips)
Ribeye63: posts small blind $0.05
PlayTheBlues4U: posts big blind $0.10
*** HOLE CARDS ***
Dealt to PlayTheBlues4U [4s 5h]
winbabywin7 joins the table at seat #2
donjt2653: calls $0.10
BigBlue: folds
mellneazy: raises $0.35 to $0.45
Ribeye63: folds
PlayTheBlues4U: calls $0.35
donjt2653: calls $0.35
*** FLOP *** [4d 2s Ad]
PlayTheBlues4U: checks
donjt2653: checks
mellneazy: bets $0.70
PlayTheBlues4U: calls $0.70
donjt2653: raises $1 to $1.70
mellneazy: folds
PlayTheBlues4U: folds
Uncalled bet ($1) returned to donjt2653
donjt2653 collected $3.32 from pot
donjt2653: doesn't show hand
*** SUMMARY ***
Total pot $3.50 | Rake $0.18
Board [4d 2s Ad]
Seat 1: BigBlue folded before Flop (didn't bet)
Seat 3: mellneazy (button) folded on the Flop
Seat 4: Ribeye63 (small blind) folded before Flop
Seat 5: PlayTheBlues4U (big blind) folded on the Flop
Seat 6: donjt2653 collected ($3.32)


PokerStars Hand #203998488361:  Hold'em No Limit ($0.05/$0.10 USD) - 2019/09/26 22:45:57 ET
Table 'Lynx' 6-max Seat #2 is the button
Seat 1: BigBlue ($7.55 in chips)
Seat 2: DigBickBlad ($14.43 in chips)
Seat 3: mellneazy ($21.13 in chips)
Seat 4: Ribeye63 ($12.57 in chips)
Seat 5: PlayTheBlues4U ($15.27 in chips)
mellneazy: posts small blind $0.05
Ribeye63: posts big blind $0.10
*** HOLE CARDS ***
Dealt to PlayTheBlues4U [5s 2h]
PlayTheBlues4U: folds
BigBlue: raises $0.20 to $0.30
DigBickBlad: folds
DigBickBlad leaves the table
mellneazy: raises $0.70 to $1
Ribeye63: folds
BigBlue: folds
Uncalled bet ($0.70) returned to mellneazy
mellneazy collected $0.70 from pot
mellneazy: doesn't show hand
*** SUMMARY ***
Total pot $0.70 | Rake $0
Seat 1: BigBlue folded before Flop
Seat 2: DigBickBlad (button) folded before Flop (didn't bet)
Seat 3: mellneazy (small blind) collected ($0.70)
Seat 4: Ribeye63 (big blind) folded before Flop
Seat 5: PlayTheBlues4U folded before Flop (didn't bet)


PokerStars Hand #203998488209:  Hold'em No Limit ($0.05/$0.10 USD) - 2019/09/26 22:45:00 ET
Table 'Delphinus' 6-max Seat #4 is the button
Seat 1: daughterstuitio ($10.12 in chips)
Seat 2: maxplans323 ($6.66 in chips)
Seat 3: joncruise ($11.74 in chips)
Seat 4: 921zhaopeng ($9.71 in chips)
Seat 5: SuWasup ($10.07 in chips)
Seat 6: PlayTheBlues4U ($8.28 in chips)
SuWasup: posts small blind $0.05
PlayTheBlues4U: posts big blind $0.10
*** HOLE CARDS ***
Dealt to PlayTheBlues4U [Jh 5h]
daughterstuitio: folds
maxplans323: folds
joncruise: raises $0.10 to $0.20
921zhaopeng: calls $0.20
SuWasup: raises $0.60 to $0.80
PlayTheBlues4U: folds
joncruise: calls $0.60
921zhaopeng: calls $0.60
*** FLOP *** [Td Jd 9d]
SuWasup: checks
joncruise: checks
921zhaopeng: checks
*** TURN *** [Td Jd 9d] [8h]
SuWasup: checks
joncruise: bets $0.70
921zhaopeng: calls $0.70
SuWasup: folds
*** RIVER *** [Td Jd 9d 8h] [9s]
joncruise: bets $0.90
921zhaopeng: calls $0.90
*** SHOW DOWN ***
joncruise: shows [7h 7s] (a straight, Seven to Jack)
921zhaopeng: mucks hand
joncruise collected $5.42 from pot
*** SUMMARY ***
Total pot $5.70 | Rake $0.28
Board [Td Jd 9d 8h 9s]
Seat 1: daughterstuitio folded before Flop (didn't bet)
Seat 2: maxplans323 folded before Flop (didn't bet)
Seat 3: joncruise showed [7h 7s] and won ($5.42) with a straight, Seven to Jack
Seat 4: 921zhaopeng (button) mucked [Jc Ah]
Seat 5: SuWasup (small blind) folded on the Turn
Seat 6: PlayTheBlues4U (big blind) folded before Flop


PokerStars Hand #203998488188:  Hold'em No Limit ($0.05/$0.10 USD) - 2019/09/26 22:44:54 ET
Table 'Lynx' 6-max Seat #1 is the button
Seat 1: BigBlue ($7.55 in chips)
Seat 2: DigBickBlad ($9.49 in chips)
Seat 3: mellneazy ($21.23 in chips)
Seat 4: Ribeye63 ($12.57 in chips)
Seat 5: PlayTheBlues4U ($15.27 in chips)
Seat 6: donjt2653 ($5.38 in chips)
DigBickBlad: posts small blind $0.05
mellneazy: posts big blind $0.10
*** HOLE CARDS ***
Dealt to PlayTheBlues4U [8h Qs]
Ribeye63: folds
PlayTheBlues4U: folds
donjt2653: raises $0.20 to $0.30
BigBlue: folds
DigBickBlad: calls $0.25
mellneazy: folds
*** FLOP *** [2c As 9s]
DigBickBlad: bets $1
donjt2653: calls $1
*** TURN *** [2c As 9s] [6c]
DigBickBlad: bets $1.10
donjt2653: calls $1.10
*** RIVER *** [2c As 9s 6c] [Ts]
DigBickBlad: bets $3.70
donjt2653: calls $2.98 and is all-in
Uncalled bet ($0.72) returned to DigBickBlad
*** SHOW DOWN ***
DigBickBlad: shows [2h Ad] (two pair, Aces and Deuces)
donjt2653: shows [9h Tc] (two pair, Tens and Nines)
DigBickBlad collected $10.32 from pot
*** SUMMARY ***
Total pot $10.86 | Rake $0.54
Board [2c As 9s 6c Ts]
Seat 1: BigBlue (button) folded before Flop (didn't bet)
Seat 2: DigBickBlad (small blind) showed [2h Ad] and won ($10.32) with two pair, Aces and Deuces
Seat 3: mellneazy (big blind) folded before Flop
Seat 4: Ribeye63 folded before Flop (didn't bet)
Seat 5: PlayTheBlues4U folded before Flop (didn't bet)
Seat 6: donjt2653 showed [9h Tc] and lost with two pair, Tens and Nines


PokerStars Hand #203998488087:  Hold'em No Limit ($0.05/$0.10 USD) - 2019/09/26 22:44:24 ET
Table 'Delphinus' 6-max Seat #3 is the button
Seat 1: daughterstuitio ($10.12 in chips)
Seat 2: maxplans323 ($6.66 in chips)
Seat 3: joncruise ($7.85 in chips)
Seat 4: 921zhaopeng ($13.61 in chips)
Seat 5: SuWasup ($10.17 in chips)
Seat 6: PlayTheBlues4U ($8.58 in chips)
921zhaopeng: posts small blind $0.05
SuWasup: posts big blind $0.10
*** HOLE CARDS ***
Dealt to PlayTheBlues4U [7c Ac]
PlayTheBlues4U: raises $0.20 to $0.30
daughterstuitio: folds
maxplans323: folds
joncruise: calls $0.30
921zhaopeng: calls $0.25
SuWasup: folds
*** FLOP *** [Th 4c 4s]
921zhaopeng: bets $0.60
PlayTheBlues4U: folds
joncruise: calls $0.60
*** TURN *** [Th 4c 4s] [4d]
921zhaopeng: bets $1
joncruise: calls $1
*** RIVER *** [Th 4c 4s 4d] [8s]
921zhaopeng: bets $2
joncruise: calls $2
*** SHOW DOWN ***
921zhaopeng: shows [3d Qd] (three of a kind, Fours)
joncruise: shows [Tc 9d] (a full house, Fours full of Tens)
joncruise collected $7.79 from pot
*** SUMMARY ***
Total pot $8.20 | Rake $0.41
Board [Th 4c 4s 4d 8s]
Seat 1: daughterstuitio folded before Flop (didn't bet)
Seat 2: maxplans323 folded before Flop (didn't bet)
Seat 3: joncruise (button) showed [Tc 9d] and won ($7.79) with a full house, Fours full of Tens
Seat 4: 921zhaopeng (small blind) showed [3d Qd] and lost with three of a kind, Fours
Seat 5: SuWasup (big blind) folded before Flop
Seat 6: PlayTheBlues4U folded on the Flop


PokerStars Hand #203998488036:  Hold'em No Limit ($0.05/$0.10 USD) - 2019/09/26 22:44:09 ET
Table 'Lynx' 6-max Seat #6 is the button
Seat 1: BigBlue ($7.60 in chips)
Seat 2: DigBickBlad ($9.59 in chips)
Seat 3: mellneazy ($20.37 in chips)
Seat 4: Ribeye63 ($12.57 in chips)
Seat 5: PlayTheBlues4U ($16.07 in chips)
Seat 6: donjt2653 ($5.38 in chips)
BigBlue: posts small blind $0.05
DigBickBlad: posts big blind $0.10
*** HOLE CARDS ***
Dealt to PlayTheBlues4U [Tc Qc]
mellneazy: raises $0.20 to $0.30
Ribeye63: folds
PlayTheBlues4U: raises $0.50 to $0.80
donjt2653: folds
BigBlue: folds
DigBickBlad: folds
mellneazy: calls $0.50
*** FLOP *** [9h 6d 6h]
mellneazy: checks
PlayTheBlues4U: checks
*** TURN *** [9h 6d 6h] [3d]
mellneazy: checks
PlayTheBlues4U: checks
*** RIVER *** [9h 6d 6h 3d] [2c]
mellneazy: bets $1
PlayTheBlues4U: folds
Uncalled bet ($1) returned to mellneazy
mellneazy collected $1.66 from pot
mellneazy: doesn't show hand
*** SUMMARY ***
Total pot $1.75 | Rake $0.09
Board [9h 6d 6h 3d 2c]
Seat 1: BigBlue (small blind) folded before Flop
Seat 2: DigBickBlad (big blind) folded before Flop
Seat 3: mellneazy collected ($1.66)
Seat 4: Ribeye63 folded before Flop (didn't bet)
Seat 5: PlayTheBlues4U folded on the River
Seat 6: donjt2653 (button) folded before Flop (didn't bet)


PokerStars Hand #203998488011:  Hold'em No Limit ($0.05/$0.10 USD) - 2019/09/26 22:44:01 ET
Table 'Delphinus' 6-max Seat #2 is the button
Seat 1: daughterstuitio ($9.71 in chips)
Seat 2: maxplans323 ($6.96 in chips)
Seat 3: joncruise ($7.90 in chips)
Seat 4: 921zhaopeng ($13.71 in chips)
Seat 5: SuWasup ($10.17 in chips)
Seat 6: PlayTheBlues4U ($8.58 in chips)
joncruise: posts small blind $0.05
921zhaopeng: posts big blind $0.10
*** HOLE CARDS ***
Dealt to PlayTheBlues4U [Ks 4s]
SuWasup: folds
PlayTheBlues4U: folds
daughterstuitio: calls $0.10
maxplans323: raises $0.20 to $0.30
joncruise: folds
921zhaopeng: folds
daughterstuitio: calls $0.20
*** FLOP *** [5h 8d 3h]
daughterstuitio: bets $0.40
maxplans323: folds
Uncalled bet ($0.40) returned to daughterstuitio
daughterstuitio collected $0.71 from pot
daughterstuitio: doesn't show hand
*** SUMMARY ***
Total pot $0.75 | Rake $0.04
Board [5h 8d 3h]
Seat 1: daughterstuitio collected ($0.71)
Seat 2: maxplans323 (button) folded on the Flop
Seat 3: joncruise (small blind) folded before Flop
Seat 4: 921zhaopeng (big blind) folded before Flop
Seat 5: SuWasup folded before Flop (didn't bet)
Seat 6: PlayTheBlues4U folded before Flop (didn't bet)


PokerStars Hand #203998487950:  Hold'em No Limit ($0.05/$0.10 USD) - 2019/09/26 22:43:43 ET
Table 'Lynx' 6-max Seat #5 is the button
Seat 1: BigBlue ($7.70 in chips)
Seat 2: DigBickBlad ($10.04 in chips)
Seat 3: mellneazy ($19.82 in chips)
Seat 4: Ribeye63 ($12.57 in chips)
Seat 5: PlayTheBlues4U ($16.07 in chips)
Seat 6: donjt2653 ($5.43 in chips)
donjt2653: posts small blind $0.05
BigBlue: posts big blind $0.10
*** HOLE CARDS ***
Dealt to PlayTheBlues4U [Kc 3h]
DigBickBlad: calls $0.10
mellneazy: raises $0.35 to $0.45
Ribeye63: folds
PlayTheBlues4U: folds
donjt2653: folds
BigBlue: folds
DigBickBlad: calls $0.35
*** FLOP *** [Tc 8s 5d]
DigBickBlad: checks
mellneazy: bets $0.50
DigBickBlad: folds
Uncalled bet ($0.50) returned to mellneazy
mellneazy collected $1 from pot
mellneazy: doesn't show hand
*** SUMMARY ***
Total pot $1.05 | Rake $0.05
Board [Tc 8s 5d]
Seat 1: BigBlue (big blind) folded before Flop
Seat 2: DigBickBlad folded on the Flop
Seat 3: mellneazy collected ($1)
Seat 4: Ribeye63 folded before Flop (didn't bet)
Seat 5: PlayTheBlues4U (button) folded before Flop (didn't bet)
Seat 6: donjt2653 (small blind) folded before Flop


PokerStars Hand #203998487892:  Hold'em No Limit ($0.05/$0.10 USD) - 2019/09/26 22:43:21 ET
Table 'Delphinus' 6-max Seat #1 is the button
Seat 1: daughterstuitio ($9.71 in chips)
Seat 2: maxplans323 ($7.26 in chips)
Seat 3: joncruise ($7.34 in chips)
Seat 4: 921zhaopeng ($13.71 in chips)
Seat 5: SuWasup ($10.47 in chips)
Seat 6: PlayTheBlues4U ($8.58 in chips)
maxplans323: posts small blind $0.05
joncruise: posts big blind $0.10
*** HOLE CARDS ***
Dealt to PlayTheBlues4U [3d Jd]
921zhaopeng: folds
SuWasup: raises $0.20 to $0.30
PlayTheBlues4U: folds
daughterstuitio: folds
maxplans323: calls $0.25
joncruise: calls $0.20
*** FLOP *** [6h Tc 4c]
maxplans323: checks
joncruise: bets $0.40
SuWasup: folds
maxplans323: folds
Uncalled bet ($0.40) returned to joncruise
joncruise collected $0.86 from pot
joncruise: doesn't show hand
*** SUMMARY ***
Total pot $0.90 | Rake $0.04
Board [6h Tc 4c]
Seat 1: daughterstuitio (button) folded before Flop (didn't bet)
Seat 2: maxplans323 (small blind) folded on the Flop
Seat 3: joncruise (big blind) collected ($0.86)
Seat 4: 921zhaopeng folded before Flop (didn't bet)
Seat 5: SuWasup folded on the Flop
Seat 6: PlayTheBlues4U folded before Flop (didn't bet)


PokerStars Hand #203998487822:  Hold'em No Limit ($0.05/$0.10 USD) - 2019/09/26 22:42:58 ET
Table 'Lynx' 6-max Seat #4 is the button
Seat 1: BigBlue ($7.70 in chips)
Seat 2: DigBickBlad ($10.04 in chips)
Seat 3: mellneazy ($19.82 in chips)
Seat 4: Ribeye63 ($12.34 in chips)
Seat 5: PlayTheBlues4U ($16.12 in chips)
Seat 6: donjt2653 ($5.63 in chips)
PlayTheBlues4U: posts small blind $0.05
donjt2653: posts big blind $0.10
*** HOLE CARDS ***
Dealt to PlayTheBlues4U [2h Kh]
BigBlue: folds
DigBickBlad: folds
mellneazy: folds
Ribeye63: raises $0.10 to $0.20
PlayTheBlues4U: folds
donjt2653: calls $0.10
*** FLOP *** [8c 2s 4c]
donjt2653: checks
Ribeye63: checks
*** TURN *** [8c 2s 4c] [8h]
donjt2653: checks
Ribeye63: checks
*** RIVER *** [8c 2s 4c 8h] [7c]
donjt2653: checks
Ribeye63: checks
*** SHOW DOWN ***
donjt2653: shows [9c Ks] (a pair of Eights)
Ribeye63: shows [Ad Qd] (a pair of Eights - Ace kicker)
Ribeye63 collected $0.43 from pot
*** SUMMARY ***
Total pot $0.45 | Rake $0.02
Board [8c 2s 4c 8h 7c]
Seat 1: BigBlue folded before Flop (didn't bet)
Seat 2: DigBickBlad folded before Flop (didn't bet)
Seat 3: mellneazy folded before Flop (didn't bet)
Seat 4: Ribeye63 (button) showed [Ad Qd] and won ($0.43) with a pair of Eights
Seat 5: PlayTheBlues4U (small blind) folded before Flop
Seat 6: donjt2653 (big blind) showed [9c Ks] and lost with a pair of Eights


PokerStars Hand #203998487793:  Hold'em No Limit ($0.05/$0.10 USD) - 2019/09/26 22:42:48 ET
Table 'Delphinus' 6-max Seat #6 is the button
Seat 1: daughterstuitio ($10.01 in chips)
Seat 2: maxplans323 ($7.56 in chips)
Seat 3: joncruise ($7.34 in chips)
Seat 4: 921zhaopeng ($13.71 in chips)
Seat 5: SuWasup ($10.47 in chips)
Seat 6: PlayTheBlues4U ($8.02 in chips)
daughterstuitio: posts small blind $0.05
maxplans323: posts big blind $0.10
*** HOLE CARDS ***
Dealt to PlayTheBlues4U [Qd Tc]
joncruise: folds
921zhaopeng: folds
SuWasup: folds
PlayTheBlues4U: raises $0.20 to $0.30
daughterstuitio: calls $0.25
maxplans323: calls $0.20
*** FLOP *** [5d Js 8c]
daughterstuitio: checks
maxplans323: checks
PlayTheBlues4U: bets $0.40
daughterstuitio: folds
maxplans323: folds
Uncalled bet ($0.40) returned to PlayTheBlues4U
PlayTheBlues4U collected $0.86 from pot
PlayTheBlues4U: doesn't show hand
*** SUMMARY ***
Total pot $0.90 | Rake $0.04
Board [5d Js 8c]
Seat 1: daughterstuitio (small blind) folded on the Flop
Seat 2: maxplans323 (big blind) folded on the Flop
Seat 3: joncruise folded before Flop (didn't bet)
Seat 4: 921zhaopeng folded before Flop (didn't bet)
Seat 5: SuWasup folded before Flop (didn't bet)
Seat 6: PlayTheBlues4U (button) collected ($0.86)


PokerStars Hand #203998487757:  Hold'em No Limit ($0.05/$0.10 USD) - 2019/09/26 22:42:37 ET
Table 'Delphinus' 6-max Seat #5 is the button
Seat 1: daughterstuitio ($9.96 in chips)
Seat 2: maxplans323 ($7.56 in chips)
Seat 3: joncruise ($7.34 in chips)
Seat 4: 921zhaopeng ($13.71 in chips)
Seat 5: SuWasup ($10.47 in chips)
Seat 6: PlayTheBlues4U ($8.07 in chips)
PlayTheBlues4U: posts small blind $0.05
daughterstuitio: posts big blind $0.10
*** HOLE CARDS ***
Dealt to PlayTheBlues4U [Ts 3c]
maxplans323: folds
joncruise: folds
921zhaopeng: folds
SuWasup: folds
PlayTheBlues4U: folds
Uncalled bet ($0.05) returned to daughterstuitio
daughterstuitio collected $0.10 from pot
daughterstuitio: doesn't show hand
*** SUMMARY ***
Total pot $0.10 | Rake $0
Seat 1: daughterstuitio (big blind) collected ($0.10)
Seat 2: maxplans323 folded before Flop (didn't bet)
Seat 3: joncruise folded before Flop (didn't bet)
Seat 4: 921zhaopeng folded before Flop (didn't bet)
Seat 5: SuWasup (button) folded before Flop (didn't bet)
Seat 6: PlayTheBlues4U (small blind) folded before Flop


PokerStars Hand #203998487705:  Hold'em No Limit ($0.05/$0.10 USD) - 2019/09/26 22:42:19 ET
Table 'Lynx' 6-max Seat #3 is the button
Seat 1: BigBlue ($7.70 in chips)
Seat 2: DigBickBlad ($10.14 in chips)
Seat 3: mellneazy ($20.37 in chips)
Seat 4: Ribeye63 ($12.39 in chips)
Seat 5: PlayTheBlues4U ($16.67 in chips)
Seat 6: donjt2653 ($4.38 in chips)
Ribeye63: posts small blind $0.05
PlayTheBlues4U: posts big blind $0.10
*** HOLE CARDS ***
Dealt to PlayTheBlues4U [Ah 8h]
donjt2653: calls $0.10
BigBlue: folds
DigBickBlad: calls $0.10
mellneazy: raises $0.45 to $0.55
Ribeye63: folds
PlayTheBlues4U: calls $0.45
donjt2653: raises $3.83 to $4.38 and is all-in
DigBickBlad: folds
mellneazy: folds
PlayTheBlues4U: folds
Uncalled bet ($3.83) returned to donjt2653
donjt2653 collected $1.80 from pot
donjt2653: doesn't show hand
*** SUMMARY ***
Total pot $1.80 | Rake $0
Seat 1: BigBlue folded before Flop (didn't bet)
Seat 2: DigBickBlad folded before Flop
Seat 3: mellneazy (button) folded before Flop
Seat 4: Ribeye63 (small blind) folded before Flop
Seat 5: PlayTheBlues4U (big blind) folded before Flop
Seat 6: donjt2653 collected ($1.80)


PokerStars Hand #203998487543:  Hold'em No Limit ($0.05/$0.10 USD) - 2019/09/26 22:41:32 ET
Table 'Lynx' 6-max Seat #2 is the button
Seat 1: BigBlue ($7.70 in chips)
Seat 2: DigBickBlad ($10.64 in chips)
Seat 3: mellneazy ($18.63 in chips)
Seat 4: Ribeye63 ($12.49 in chips)
Seat 5: PlayTheBlues4U ($16.67 in chips)
Seat 6: donjt2653 ($5.68 in chips)
mellneazy: posts small blind $0.05
Ribeye63: posts big blind $0.10
*** HOLE CARDS ***
Dealt to PlayTheBlues4U [6h 3h]
PlayTheBlues4U: folds
donjt2653: calls $0.10
BigBlue: folds
DigBickBlad: calls $0.10
mellneazy: raises $0.40 to $0.50
Ribeye63: folds
donjt2653: calls $0.40
DigBickBlad: calls $0.40
*** FLOP *** [8h 5s 4c]
mellneazy: bets $0.80
donjt2653: calls $0.80
DigBickBlad: folds
*** TURN *** [8h 5s 4c] [Js]
mellneazy: checks
donjt2653: checks
*** RIVER *** [8h 5s 4c Js] [Qs]
mellneazy: checks
donjt2653: checks
*** SHOW DOWN ***
mellneazy: shows [Qh Ah] (a pair of Queens)
donjt2653: mucks hand
mellneazy collected $3.04 from pot
*** SUMMARY ***
Total pot $3.20 | Rake $0.16
Board [8h 5s 4c Js Qs]
Seat 1: BigBlue folded before Flop (didn't bet)
Seat 2: DigBickBlad (button) folded on the Flop
Seat 3: mellneazy (small blind) showed [Qh Ah] and won ($3.04) with a pair of Queens
Seat 4: Ribeye63 (big blind) folded before Flop
Seat 5: PlayTheBlues4U folded before Flop (didn't bet)
Seat 6: donjt2653 mucked [6d 4d]


PokerStars Hand #203998487420:  Hold'em No Limit ($0.05/$0.10 USD) - 2019/09/26 22:40:50 ET
Table 'Lynx' 6-max Seat #1 is the button
Seat 1: BigBlue ($7.70 in chips)
Seat 2: DigBickBlad ($5.45 in chips)
Seat 3: mellneazy ($18.93 in chips)
Seat 4: Ribeye63 ($12.49 in chips)
Seat 5: PlayTheBlues4U ($16.67 in chips)
Seat 6: donjt2653 ($11.13 in chips)
DigBickBlad: posts small blind $0.05
mellneazy: posts big blind $0.10
*** HOLE CARDS ***
Dealt to PlayTheBlues4U [4c 9s]
Ribeye63: folds
PlayTheBlues4U: folds
donjt2653: raises $0.20 to $0.30
BigBlue: folds
DigBickBlad: calls $0.25
mellneazy: calls $0.20
*** FLOP *** [2s 3s Qh]
DigBickBlad: bets $1
mellneazy: folds
donjt2653: calls $1
*** TURN *** [2s 3s Qh] [7d]
DigBickBlad: bets $1
donjt2653: raises $8.83 to $9.83 and is all-in
DigBickBlad: calls $3.15 and is all-in
Uncalled bet ($5.68) returned to donjt2653
*** RIVER *** [2s 3s Qh 7d] [9c]
*** SHOW DOWN ***
DigBickBlad: shows [Qs Jh] (a pair of Queens)
donjt2653: shows [Th Qd] (a pair of Queens - lower kicker)
DigBickBlad collected $10.64 from pot
*** SUMMARY ***
Total pot $11.20 | Rake $0.56
Board [2s 3s Qh 7d 9c]
Seat 1: BigBlue (button) folded before Flop (didn't bet)
Seat 2: DigBickBlad (small blind) showed [Qs Jh] and won ($10.64) with a pair of Queens
Seat 3: mellneazy (big blind) folded on the Flop
Seat 4: Ribeye63 folded before Flop (didn't bet)
Seat 5: PlayTheBlues4U folded before Flop (didn't bet)
Seat 6: donjt2653 showed [Th Qd] and lost with a pair of Queens


PokerStars Hand #203998487416:  Hold'em No Limit ($0.05/$0.10 USD) - 2019/09/26 22:40:49 ET
Table 'Delphinus' 6-max Seat #4 is the button
Seat 1: daughterstuitio ($9.96 in chips)
Seat 2: maxplans323 ($7.56 in chips)
Seat 3: joncruise ($7.34 in chips)
Seat 4: 921zhaopeng ($13.71 in chips)
Seat 5: SuWasup ($8.94 in chips)
Seat 6: PlayTheBlues4U ($9.77 in chips)
SuWasup: posts small blind $0.05
PlayTheBlues4U: posts big blind $0.10
*** HOLE CARDS ***
Dealt to PlayTheBlues4U [Ad 6s]
daughterstuitio: folds
maxplans323: folds
joncruise: folds
921zhaopeng: folds
SuWasup: raises $0.30 to $0.40
PlayTheBlues4U: calls $0.30
*** FLOP *** [5d Js Kh]
SuWasup: checks
PlayTheBlues4U: bets $0.40
SuWasup: calls $0.40
*** TURN *** [5d Js Kh] [3c]
SuWasup: checks
PlayTheBlues4U: checks
*** RIVER *** [5d Js Kh 3c] [9d]
SuWasup: checks
PlayTheBlues4U: bets $0.90
SuWasup: raises $1.30 to $2.20
PlayTheBlues4U: folds
Uncalled bet ($1.30) returned to SuWasup
SuWasup collected $3.23 from pot
SuWasup: doesn't show hand
*** SUMMARY ***
Total pot $3.40 | Rake $0.17
Board [5d Js Kh 3c 9d]
Seat 1: daughterstuitio folded before Flop (didn't bet)
Seat 2: maxplans323 folded before Flop (didn't bet)
Seat 3: joncruise folded before Flop (didn't bet)
Seat 4: 921zhaopeng (button) folded before Flop (didn't bet)
Seat 5: SuWasup (small blind) collected ($3.23)
Seat 6: PlayTheBlues4U (big blind) folded on the River


PokerStars Hand #203998487292:  Hold'em No Limit ($0.05/$0.10 USD) - 2019/09/26 22:40:04 ET
Table 'Lynx' 6-max Seat #6 is the button
Seat 1: BigBlue ($7.75 in chips)
Seat 2: DigBickBlad ($5.75 in chips)
Seat 3: mellneazy ($19.63 in chips)
Seat 4: Ribeye63 ($13.19 in chips)
Seat 5: PlayTheBlues4U ($16.67 in chips)
Seat 6: donjt2653 ($9.50 in chips)
BigBlue: posts small blind $0.05
DigBickBlad: posts big blind $0.10
*** HOLE CARDS ***
Dealt to PlayTheBlues4U [9d 7h]
mellneazy: raises $0.20 to $0.30
Ribeye63: calls $0.30
PlayTheBlues4U: folds
donjt2653: calls $0.30
BigBlue: folds
DigBickBlad: calls $0.20
*** FLOP *** [4h 8h 6d]
DigBickBlad: checks
mellneazy: checks
Ribeye63: bets $0.40
donjt2653: calls $0.40
DigBickBlad: folds
mellneazy: calls $0.40
*** TURN *** [4h 8h 6d] [5c]
mellneazy: checks
Ribeye63: checks
donjt2653: bets $2.30
mellneazy: folds
Ribeye63: folds
Uncalled bet ($2.30) returned to donjt2653
donjt2653 collected $2.33 from pot
donjt2653: doesn't show hand
*** SUMMARY ***
Total pot $2.45 | Rake $0.12
Board [4h 8h 6d 5c]
Seat 1: BigBlue (small blind) folded before Flop
Seat 2: DigBickBlad (big blind) folded on the Flop
Seat 3: mellneazy folded on the Turn
Seat 4: Ribeye63 folded on the Turn
Seat 5: PlayTheBlues4U folded before Flop (didn't bet)
Seat 6: donjt2653 (button) collected ($2.33)


PokerStars Hand #203998487224:  Hold'em No Limit ($0.05/$0.10 USD) - 2019/09/26 22:39:41 ET
Table 'Delphinus' 6-max Seat #3 is the button
Seat 1: daughterstuitio ($9.96 in chips)
Seat 2: maxplans323 ($7.56 in chips)
Seat 3: joncruise ($7.34 in chips)
Seat 4: 921zhaopeng ($13.17 in chips)
Seat 5: SuWasup ($9.54 in chips)
Seat 6: PlayTheBlues4U ($9.77 in chips)
921zhaopeng: posts small blind $0.05
SuWasup: posts big blind $0.10
*** HOLE CARDS ***
Dealt to PlayTheBlues4U [As 4c]
PlayTheBlues4U: folds
daughterstuitio: folds
maxplans323: folds
joncruise: folds
921zhaopeng: calls $0.05
SuWasup: checks
*** FLOP *** [3h Ks 8s]
921zhaopeng: bets $0.20
SuWasup: calls $0.20
*** TURN *** [3h Ks 8s] [Qh]
921zhaopeng: bets $0.30
SuWasup: calls $0.30
*** RIVER *** [3h Ks 8s Qh] [8d]
921zhaopeng: checks
SuWasup: checks
*** SHOW DOWN ***
921zhaopeng: shows [Kd 6h] (two pair, Kings and Eights)
SuWasup: mucks hand
921zhaopeng collected $1.14 from pot
*** SUMMARY ***
Total pot $1.20 | Rake $0.06
Board [3h Ks 8s Qh 8d]
Seat 1: daughterstuitio folded before Flop (didn't bet)
Seat 2: maxplans323 folded before Flop (didn't bet)
Seat 3: joncruise (button) folded before Flop (didn't bet)
Seat 4: 921zhaopeng (small blind) showed [Kd 6h] and won ($1.14) with two pair, Kings and Eights
Seat 5: SuWasup (big blind) mucked [Jh 3s]
Seat 6: PlayTheBlues4U folded before Flop (didn't bet)


PokerStars Hand #203998487208:  Hold'em No Limit ($0.05/$0.10 USD) - 2019/09/26 22:39:35 ET
Table 'Lynx' 6-max Seat #5 is the button
Seat 1: BigBlue ($7.85 in chips)
Seat 3: mellneazy ($19.27 in chips)
Seat 4: Ribeye63 ($13.19 in chips)
Seat 5: PlayTheBlues4U ($16.67 in chips)
Seat 6: donjt2653 ($9.80 in chips)
donjt2653: posts small blind $0.05
BigBlue: posts big blind $0.10
DigBickBlad: sits out
*** HOLE CARDS ***
Dealt to PlayTheBlues4U [7c Qd]
mellneazy: raises $0.20 to $0.30
Ribeye63: folds
PlayTheBlues4U: folds
donjt2653: calls $0.25
BigBlue: folds
*** FLOP *** [9s 5c 3c]
donjt2653: checks
mellneazy: bets $0.30
donjt2653: folds
Uncalled bet ($0.30) returned to mellneazy
mellneazy collected $0.66 from pot
mellneazy: doesn't show hand
*** SUMMARY ***
Total pot $0.70 | Rake $0.04
Board [9s 5c 3c]
Seat 1: BigBlue (big blind) folded before Flop
Seat 3: mellneazy collected ($0.66)
Seat 4: Ribeye63 folded before Flop (didn't bet)
Seat 5: PlayTheBlues4U (button) folded before Flop (didn't bet)
Seat 6: donjt2653 (small blind) folded on the Flop


PokerStars Hand #203998487143:  Hold'em No Limit ($0.05/$0.10 USD) - 2019/09/26 22:39:17 ET
Table 'Delphinus' 6-max Seat #2 is the button
Seat 1: daughterstuitio ($10.26 in chips)
Seat 2: maxplans323 ($7.56 in chips)
Seat 3: joncruise ($7.39 in chips)
Seat 4: 921zhaopeng ($13.27 in chips)
Seat 5: SuWasup ($9.54 in chips)
Seat 6: PlayTheBlues4U ($9.36 in chips)
joncruise: posts small blind $0.05
921zhaopeng: posts big blind $0.10
*** HOLE CARDS ***
Dealt to PlayTheBlues4U [Ac Td]
SuWasup: folds
PlayTheBlues4U: raises $0.20 to $0.30
daughterstuitio: calls $0.30
maxplans323: folds
joncruise: folds
921zhaopeng: folds
*** FLOP *** [8s 2h 4h]
PlayTheBlues4U: bets $0.40
daughterstuitio: folds
Uncalled bet ($0.40) returned to PlayTheBlues4U
PlayTheBlues4U collected $0.71 from pot
PlayTheBlues4U: doesn't show hand
*** SUMMARY ***
Total pot $0.75 | Rake $0.04
Board [8s 2h 4h]
Seat 1: daughterstuitio folded on the Flop
Seat 2: maxplans323 (button) folded before Flop (didn't bet)
Seat 3: joncruise (small blind) folded before Flop
Seat 4: 921zhaopeng (big blind) folded before Flop
Seat 5: SuWasup folded before Flop (didn't bet)
Seat 6: PlayTheBlues4U collected ($0.71)


PokerStars Hand #203998487088:  Hold'em No Limit ($0.05/$0.10 USD) - 2019/09/26 22:39:01 ET
Table 'Lynx' 6-max Seat #4 is the button
Seat 1: BigBlue ($7.85 in chips)
Seat 3: mellneazy ($19.27 in chips)
Seat 4: Ribeye63 ($12.01 in chips)
Seat 5: PlayTheBlues4U ($17.77 in chips)
Seat 6: donjt2653 ($10 in chips)
PlayTheBlues4U: posts small blind $0.05
donjt2653: posts big blind $0.10
*** HOLE CARDS ***
Dealt to PlayTheBlues4U [Jh Kc]
BigBlue: folds
mellneazy: folds
Ribeye63: raises $0.10 to $0.20
PlayTheBlues4U: calls $0.15
donjt2653: calls $0.10
*** FLOP *** [Ts Ac 4c]
PlayTheBlues4U: checks
donjt2653: checks
Ribeye63: checks
*** TURN *** [Ts Ac 4c] [6s]
PlayTheBlues4U: bets $0.30
DigBickBlad joins the table at seat #2
donjt2653: folds
Ribeye63: calls $0.30
*** RIVER *** [Ts Ac 4c 6s] [7h]
PlayTheBlues4U: bets $0.60
Ribeye63: calls $0.60
*** SHOW DOWN ***
PlayTheBlues4U: shows [Jh Kc] (high card Ace)
Ribeye63: shows [3h Ah] (a pair of Aces)
Ribeye63 collected $2.28 from pot
*** SUMMARY ***
Total pot $2.40 | Rake $0.12
Board [Ts Ac 4c 6s 7h]
Seat 1: BigBlue folded before Flop (didn't bet)
Seat 3: mellneazy folded before Flop (didn't bet)
Seat 4: Ribeye63 (button) showed [3h Ah] and won ($2.28) with a pair of Aces
Seat 5: PlayTheBlues4U (small blind) showed [Jh Kc] and lost with high card Ace
Seat 6: donjt2653 (big blind) folded on the Turn


PokerStars Hand #203998487039:  Hold'em No Limit ($0.05/$0.10 USD) - 2019/09/26 22:38:44 ET
Table 'Delphinus' 6-max Seat #1 is the button
Seat 1: daughterstuitio ($10.26 in chips)
Seat 2: maxplans323 ($7.61 in chips)
Seat 3: joncruise ($7.07 in chips)
Seat 4: 921zhaopeng ($13.57 in chips)
Seat 5: SuWasup ($9.54 in chips)
Seat 6: PlayTheBlues4U ($9.36 in chips)
maxplans323: posts small blind $0.05
joncruise: posts big blind $0.10
*** HOLE CARDS ***
Dealt to PlayTheBlues4U [7d Ks]
921zhaopeng: raises $0.10 to $0.20
SuWasup: folds
PlayTheBlues4U: folds
daughterstuitio: folds
maxplans323: folds
joncruise: calls $0.10
*** FLOP *** [2d 9s 7s]
joncruise: checks
921zhaopeng: checks
*** TURN *** [2d 9s 7s] [Qh]
joncruise: bets $0.10
921zhaopeng: calls $0.10
*** RIVER *** [2d 9s 7s Qh] [8d]
joncruise: checks
921zhaopeng: checks
*** SHOW DOWN ***
joncruise: shows [Ah Jd] (high card Ace)
921zhaopeng: mucks hand
joncruise collected $0.62 from pot
*** SUMMARY ***
Total pot $0.65 | Rake $0.03
Board [2d 9s 7s Qh 8d]
Seat 1: daughterstuitio (button) folded before Flop (didn't bet)
Seat 2: maxplans323 (small blind) folded before Flop
Seat 3: joncruise (big blind) showed [Ah Jd] and won ($0.62) with high card Ace
Seat 4: 921zhaopeng mucked [As 6s]
Seat 5: SuWasup folded before Flop (didn't bet)
Seat 6: PlayTheBlues4U folded before Flop (didn't bet)


PokerStars Hand #203998486873:  Hold'em No Limit ($0.05/$0.10 USD) - 2019/09/26 22:37:45 ET
Table 'Delphinus' 6-max Seat #6 is the button
Seat 1: daughterstuitio ($10.31 in chips)
Seat 2: maxplans323 ($7.91 in chips)
Seat 3: joncruise ($7.07 in chips)
Seat 4: 921zhaopeng ($11.71 in chips)
Seat 5: SuWasup ($9.54 in chips)
Seat 6: PlayTheBlues4U ($11.06 in chips)
daughterstuitio: posts small blind $0.05
maxplans323: posts big blind $0.10
*** HOLE CARDS ***
Dealt to PlayTheBlues4U [Ad 4h]
joncruise: folds
921zhaopeng: raises $0.20 to $0.30
SuWasup: folds
PlayTheBlues4U: calls $0.30
daughterstuitio: folds
maxplans323: calls $0.20
*** FLOP *** [Qc Ts 2s]
maxplans323: checks
921zhaopeng: bets $0.60
PlayTheBlues4U: raises $0.80 to $1.40
maxplans323: folds
921zhaopeng: raises $0.80 to $2.20
PlayTheBlues4U: folds
Uncalled bet ($0.80) returned to 921zhaopeng
921zhaopeng collected $3.56 from pot
921zhaopeng: doesn't show hand
*** SUMMARY ***
Total pot $3.75 | Rake $0.19
Board [Qc Ts 2s]
Seat 1: daughterstuitio (small blind) folded before Flop
Seat 2: maxplans323 (big blind) folded on the Flop
Seat 3: joncruise folded before Flop (didn't bet)
Seat 4: 921zhaopeng collected ($3.56)
Seat 5: SuWasup folded before Flop (didn't bet)
Seat 6: PlayTheBlues4U (button) folded on the Flop


PokerStars Hand #203998486860:  Hold'em No Limit ($0.05/$0.10 USD) - 2019/09/26 22:37:40 ET
Table 'Lynx' 6-max Seat #3 is the button
Seat 1: BigBlue ($7.85 in chips)
Seat 3: mellneazy ($23.77 in chips)
Seat 4: Ribeye63 ($12.06 in chips)
Seat 5: PlayTheBlues4U ($13.67 in chips)
Ribeye63: posts small blind $0.05
PlayTheBlues4U: posts big blind $0.10
donjt2653: sits out
*** HOLE CARDS ***
Dealt to PlayTheBlues4U [Ts Jh]
BigBlue: folds
mellneazy: raises $0.20 to $0.30
Ribeye63: folds
PlayTheBlues4U: calls $0.20
*** FLOP *** [Ac Qs Kc]
PlayTheBlues4U: checks
mellneazy: bets $0.30
PlayTheBlues4U: calls $0.30
*** TURN *** [Ac Qs Kc] [5h]
PlayTheBlues4U: checks
mellneazy: bets $0.60
PlayTheBlues4U: raises $0.80 to $1.40
mellneazy: calls $0.80
*** RIVER *** [Ac Qs Kc 5h] [5s]
PlayTheBlues4U: checks
mellneazy: bets $2.50
PlayTheBlues4U: raises $2.50 to $5
mellneazy: folds
Uncalled bet ($2.50) returned to PlayTheBlues4U
PlayTheBlues4U collected $8.60 from pot
PlayTheBlues4U: doesn't show hand
*** SUMMARY ***
Total pot $9.05 | Rake $0.45
Board [Ac Qs Kc 5h 5s]
Seat 1: BigBlue folded before Flop (didn't bet)
Seat 3: mellneazy (button) folded on the River
Seat 4: Ribeye63 (small blind) folded before Flop
Seat 5: PlayTheBlues4U (big blind) collected ($8.60)


PokerStars Hand #203998486834:  Hold'em No Limit ($0.05/$0.10 USD) - 2019/09/26 22:37:30 ET
Table 'Lynx' 6-max Seat #1 is the button
Seat 1: BigBlue ($7.85 in chips)
Seat 3: mellneazy ($23.82 in chips)
Seat 4: Ribeye63 ($12.16 in chips)
Seat 5: PlayTheBlues4U ($13.52 in chips)
mellneazy: posts small blind $0.05
Ribeye63: posts big blind $0.10
donjt2653: sits out
*** HOLE CARDS ***
Dealt to PlayTheBlues4U [Jd Th]
PlayTheBlues4U: raises $0.20 to $0.30
BigBlue: folds
mellneazy: folds
Ribeye63: folds
Uncalled bet ($0.20) returned to PlayTheBlues4U
PlayTheBlues4U collected $0.25 from pot
PlayTheBlues4U: doesn't show hand
*** SUMMARY ***
Total pot $0.25 | Rake $0
Seat 1: BigBlue (button) folded before Flop (didn't bet)
Seat 3: mellneazy (small blind) folded before Flop
Seat 4: Ribeye63 (big blind) folded before Flop
Seat 5: PlayTheBlues4U collected ($0.25)


PokerStars Hand #203998486806:  Hold'em No Limit ($0.05/$0.10 USD) - 2019/09/26 22:37:20 ET
Table 'Lynx' 6-max Seat #5 is the button
Seat 1: BigBlue ($7.90 in chips)
Seat 3: mellneazy ($23.92 in chips)
Seat 4: Ribeye63 ($12.16 in chips)
Seat 5: PlayTheBlues4U ($13.37 in chips)
donjt2653 will be allowed to play after the button
BigBlue: posts small blind $0.05
ironons: is sitting out
mellneazy: posts big blind $0.10
*** HOLE CARDS ***
Dealt to PlayTheBlues4U [Jh Qh]
Ribeye63: folds
ironons leaves the table
PlayTheBlues4U: raises $0.20 to $0.30
BigBlue: folds
mellneazy: folds
Uncalled bet ($0.20) returned to PlayTheBlues4U
PlayTheBlues4U collected $0.25 from pot
PlayTheBlues4U: doesn't show hand
*** SUMMARY ***
Total pot $0.25 | Rake $0
Seat 1: BigBlue (small blind) folded before Flop
Seat 3: mellneazy (big blind) folded before Flop
Seat 4: Ribeye63 folded before Flop (didn't bet)
Seat 5: PlayTheBlues4U (button) collected ($0.25)


PokerStars Hand #203998486762:  Hold'em No Limit ($0.05/$0.10 USD) - 2019/09/26 22:37:07 ET
Table 'Delphinus' 6-max Seat #5 is the button
Seat 1: daughterstuitio ($10.61 in chips)
Seat 2: maxplans323 ($7.91 in chips)
Seat 3: joncruise ($7.07 in chips)
Seat 4: 921zhaopeng ($11.71 in chips)
Seat 5: SuWasup ($9.22 in chips)
Seat 6: PlayTheBlues4U ($11.11 in chips)
PlayTheBlues4U: posts small blind $0.05
daughterstuitio: posts big blind $0.10
*** HOLE CARDS ***
Dealt to PlayTheBlues4U [Ts 2d]
maxplans323: folds
joncruise: folds
921zhaopeng: folds
SuWasup: raises $0.20 to $0.30
PlayTheBlues4U: folds
daughterstuitio: calls $0.20
*** FLOP *** [Qh Td Ah]
daughterstuitio: checks
SuWasup: bets $0.40
daughterstuitio: folds
Uncalled bet ($0.40) returned to SuWasup
SuWasup collected $0.62 from pot
SuWasup: doesn't show hand
*** SUMMARY ***
Total pot $0.65 | Rake $0.03
Board [Qh Td Ah]
Seat 1: daughterstuitio (big blind) folded on the Flop
Seat 2: maxplans323 folded before Flop (didn't bet)
Seat 3: joncruise folded before Flop (didn't bet)
Seat 4: 921zhaopeng folded before Flop (didn't bet)
Seat 5: SuWasup (button) collected ($0.62)
Seat 6: PlayTheBlues4U (small blind) folded before Flop


PokerStars Hand #203998486611:  Hold'em No Limit ($0.05/$0.10 USD) - 2019/09/26 22:36:15 ET
Table 'Delphinus' 6-max Seat #4 is the button
Seat 1: daughterstuitio ($10.61 in chips)
Seat 2: maxplans323 ($7.91 in chips)
Seat 3: joncruise ($6.30 in chips)
Seat 4: 921zhaopeng ($12.41 in chips)
Seat 5: SuWasup ($9.27 in chips)
Seat 6: PlayTheBlues4U ($11.21 in chips)
SuWasup: posts small blind $0.05
PlayTheBlues4U: posts big blind $0.10
*** HOLE CARDS ***
Dealt to PlayTheBlues4U [7s 4c]
daughterstuitio: folds
maxplans323: folds
joncruise: calls $0.10
921zhaopeng: calls $0.10
SuWasup: folds
PlayTheBlues4U: checks
*** FLOP *** [Qh Ks 2d]
PlayTheBlues4U: checks
joncruise: bets $0.20
921zhaopeng: calls $0.20
PlayTheBlues4U: folds
*** TURN *** [Qh Ks 2d] [9d]
joncruise: bets $0.40
921zhaopeng: calls $0.40
*** RIVER *** [Qh Ks 2d 9d] [6s]
joncruise: bets $0.70
921zhaopeng: folds
Uncalled bet ($0.70) returned to joncruise
joncruise collected $1.47 from pot
joncruise: doesn't show hand
*** SUMMARY ***
Total pot $1.55 | Rake $0.08
Board [Qh Ks 2d 9d 6s]
Seat 1: daughterstuitio folded before Flop (didn't bet)
Seat 2: maxplans323 folded before Flop (didn't bet)
Seat 3: joncruise collected ($1.47)
Seat 4: 921zhaopeng (button) folded on the River
Seat 5: SuWasup (small blind) folded before Flop
Seat 6: PlayTheBlues4U (big blind) folded on the Flop


PokerStars Hand #203998486592:  Hold'em No Limit ($0.05/$0.10 USD) - 2019/09/26 22:36:09 ET
Table 'Lynx' 6-max Seat #4 is the button
Seat 1: BigBlue ($8 in chips)
Seat 2: ironons ($7.90 in chips)
Seat 3: mellneazy ($25.72 in chips)
Seat 4: Ribeye63 ($10.40 in chips)
Seat 5: PlayTheBlues4U ($13.42 in chips)
PlayTheBlues4U: posts small blind $0.05
BigBlue: posts big blind $0.10
*** HOLE CARDS ***
Dealt to PlayTheBlues4U [4h 9s]
ironons: folds
PlayTheBlues4U said, "wow"
mellneazy: raises $0.20 to $0.30
Ribeye63: calls $0.30
PlayTheBlues4U: folds
BigBlue: folds
*** FLOP *** [6d 8c 8h]
mellneazy: checks
Ribeye63: bets $0.53
mellneazy: raises $0.97 to $1.50
Ribeye63: calls $0.97
*** TURN *** [6d 8c 8h] [7d]
mellneazy: checks
Ribeye63: bets $1
mellneazy: folds
Uncalled bet ($1) returned to Ribeye63
Ribeye63 collected $3.56 from pot
Ribeye63: doesn't show hand
*** SUMMARY ***
Total pot $3.75 | Rake $0.19
Board [6d 8c 8h 7d]
Seat 1: BigBlue (big blind) folded before Flop
Seat 2: ironons folded before Flop (didn't bet)
Seat 3: mellneazy folded on the Turn
Seat 4: Ribeye63 (button) collected ($3.56)
Seat 5: PlayTheBlues4U (small blind) folded before Flop


PokerStars Hand #203998486444:  Hold'em No Limit ($0.05/$0.10 USD) - 2019/09/26 22:35:10 ET
Table 'Lynx' 6-max Seat #3 is the button
Seat 2: ironons ($8.45 in chips)
Seat 3: mellneazy ($18.78 in chips)
Seat 4: Ribeye63 ($10.45 in chips)
Seat 5: PlayTheBlues4U ($13.52 in chips)
Seat 6: donjt2653 ($6.97 in chips)
Ribeye63: posts small blind $0.05
PlayTheBlues4U: posts big blind $0.10
BigBlue: sits out
*** HOLE CARDS ***
Dealt to PlayTheBlues4U [8c 7d]
donjt2653: calls $0.10
ironons: calls $0.10
mellneazy: raises $0.45 to $0.55
Ribeye63: folds
PlayTheBlues4U: folds
donjt2653: calls $0.45
ironons: calls $0.45
*** FLOP *** [Ts Qs 4c]
donjt2653: checks
ironons: checks
mellneazy: bets $0.90
donjt2653: raises $5.52 to $6.42 and is all-in
ironons: folds
mellneazy: calls $5.52
*** TURN *** [Ts Qs 4c] [4s]
*** RIVER *** [Ts Qs 4c 4s] [3h]
*** SHOW DOWN ***
donjt2653: shows [Qc Ks] (two pair, Queens and Fours)
mellneazy: shows [4d Qd] (a full house, Fours full of Queens)
mellneazy collected $13.91 from pot
*** SUMMARY ***
Total pot $14.64 | Rake $0.73
Board [Ts Qs 4c 4s 3h]
Seat 2: ironons folded on the Flop
Seat 3: mellneazy (button) showed [4d Qd] and won ($13.91) with a full house, Fours full of Queens
Seat 4: Ribeye63 (small blind) folded before Flop
Seat 5: PlayTheBlues4U (big blind) folded before Flop
Seat 6: donjt2653 showed [Qc Ks] and lost with two pair, Queens and Fours


PokerStars Hand #203998486413:  Hold'em No Limit ($0.05/$0.10 USD) - 2019/09/26 22:35:00 ET
Table 'Lynx' 6-max Seat #2 is the button
Seat 2: ironons ($8.45 in chips)
Seat 3: mellneazy ($18.68 in chips)
Seat 4: Ribeye63 ($10.55 in chips)
Seat 5: PlayTheBlues4U ($13.52 in chips)
Seat 6: donjt2653 ($6.97 in chips)
mellneazy: posts small blind $0.05
Ribeye63: posts big blind $0.10
BigBlue: sits out
*** HOLE CARDS ***
Dealt to PlayTheBlues4U [8d 4d]
PlayTheBlues4U: folds
donjt2653: folds
ironons: folds
mellneazy: raises $0.20 to $0.30
Ribeye63: folds
Uncalled bet ($0.20) returned to mellneazy
mellneazy collected $0.20 from pot
mellneazy: doesn't show hand
*** SUMMARY ***
Total pot $0.20 | Rake $0
Seat 2: ironons (button) folded before Flop (didn't bet)
Seat 3: mellneazy (small blind) collected ($0.20)
Seat 4: Ribeye63 (big blind) folded before Flop
Seat 5: PlayTheBlues4U folded before Flop (didn't bet)
Seat 6: donjt2653 folded before Flop (didn't bet)


PokerStars Hand #203998486375:  Hold'em No Limit ($0.05/$0.10 USD) - 2019/09/26 22:34:48 ET
Table 'Lynx' 6-max Seat #6 is the button
Seat 2: ironons ($8.50 in chips)
Seat 3: mellneazy ($18.78 in chips)
Seat 4: Ribeye63 ($10.40 in chips)
Seat 5: PlayTheBlues4U ($13.52 in chips)
Seat 6: donjt2653 ($6.97 in chips)
ironons: posts small blind $0.05
mellneazy: posts big blind $0.10
*** HOLE CARDS ***
Dealt to PlayTheBlues4U [8h 7s]
BigBlue joins the table at seat #1
Ribeye63: raises $0.30 to $0.40
PlayTheBlues4U: folds
donjt2653: folds
ironons: folds
mellneazy: folds
Uncalled bet ($0.30) returned to Ribeye63
Ribeye63 collected $0.25 from pot
Ribeye63: doesn't show hand
*** SUMMARY ***
Total pot $0.25 | Rake $0
Seat 2: ironons (small blind) folded before Flop
Seat 3: mellneazy (big blind) folded before Flop
Seat 4: Ribeye63 collected ($0.25)
Seat 5: PlayTheBlues4U folded before Flop (didn't bet)
Seat 6: donjt2653 (button) folded before Flop (didn't bet)


PokerStars Hand #203998486352:  Hold'em No Limit ($0.05/$0.10 USD) - 2019/09/26 22:34:39 ET
Table 'Delphinus' 6-max Seat #3 is the button
Seat 1: daughterstuitio ($10.61 in chips)
Seat 2: maxplans323 ($7.91 in chips)
Seat 3: joncruise ($6.30 in chips)
Seat 4: 921zhaopeng ($10.97 in chips)
Seat 5: SuWasup ($10.87 in chips)
Seat 6: PlayTheBlues4U ($11.21 in chips)
921zhaopeng: posts small blind $0.05
SuWasup: posts big blind $0.10
*** HOLE CARDS ***
Dealt to PlayTheBlues4U [6s 9h]
PlayTheBlues4U: folds
daughterstuitio: folds
maxplans323: folds
joncruise: folds
921zhaopeng: raises $0.10 to $0.20
SuWasup: raises $0.60 to $0.80
921zhaopeng: calls $0.60
*** FLOP *** [8s 4d 7s]
921zhaopeng: bets $0.80
SuWasup: calls $0.80
*** TURN *** [8s 4d 7s] [4c]
921zhaopeng: bets $1.50
SuWasup: folds
Uncalled bet ($1.50) returned to 921zhaopeng
921zhaopeng collected $3.04 from pot
921zhaopeng: doesn't show hand
*** SUMMARY ***
Total pot $3.20 | Rake $0.16
Board [8s 4d 7s 4c]
Seat 1: daughterstuitio folded before Flop (didn't bet)
Seat 2: maxplans323 folded before Flop (didn't bet)
Seat 3: joncruise (button) folded before Flop (didn't bet)
Seat 4: 921zhaopeng (small blind) collected ($3.04)
Seat 5: SuWasup (big blind) folded on the Turn
Seat 6: PlayTheBlues4U folded before Flop (didn't bet)


PokerStars Hand #203998486328:  Hold'em No Limit ($0.05/$0.10 USD) - 2019/09/26 22:34:31 ET
Table 'Lynx' 6-max Seat #5 is the button
Seat 2: ironons ($8.80 in chips)
Seat 3: mellneazy ($18.46 in chips)
Seat 4: Ribeye63 ($10.40 in chips)
Seat 5: PlayTheBlues4U ($13.52 in chips)
Seat 6: donjt2653 ($7.02 in chips)
donjt2653: posts small blind $0.05
ironons: posts big blind $0.10
*** HOLE CARDS ***
Dealt to PlayTheBlues4U [3c 8d]
mellneazy: raises $0.20 to $0.30
Ribeye63: folds
PlayTheBlues4U: folds
donjt2653: folds
ironons: calls $0.20
*** FLOP *** [Td Ad 8h]
ironons: checks
mellneazy: bets $0.30
ironons: folds
Uncalled bet ($0.30) returned to mellneazy
mellneazy collected $0.62 from pot
mellneazy: doesn't show hand
*** SUMMARY ***
Total pot $0.65 | Rake $0.03
Board [Td Ad 8h]
Seat 2: ironons (big blind) folded on the Flop
Seat 3: mellneazy collected ($0.62)
Seat 4: Ribeye63 folded before Flop (didn't bet)
Seat 5: PlayTheBlues4U (button) folded before Flop (didn't bet)
Seat 6: donjt2653 (small blind) folded before Flop


PokerStars Hand #203998486260:  Hold'em No Limit ($0.05/$0.10 USD) - 2019/09/26 22:34:04 ET
Table 'Delphinus' 6-max Seat #2 is the button
Seat 1: daughterstuitio ($10.61 in chips)
Seat 2: maxplans323 ($8.21 in chips)
Seat 3: joncruise ($6.35 in chips)
Seat 4: 921zhaopeng ($11.07 in chips)
Seat 5: SuWasup ($10.46 in chips)
Seat 6: PlayTheBlues4U ($11.21 in chips)
joncruise: posts small blind $0.05
921zhaopeng: posts big blind $0.10
*** HOLE CARDS ***
Dealt to PlayTheBlues4U [Jd 4h]
SuWasup: raises $0.20 to $0.30
PlayTheBlues4U: folds
daughterstuitio: folds
maxplans323: calls $0.30
joncruise: folds
921zhaopeng: folds
*** FLOP *** [6d Js Jh]
SuWasup: bets $0.30
maxplans323: folds
Uncalled bet ($0.30) returned to SuWasup
SuWasup collected $0.71 from pot
SuWasup: doesn't show hand
*** SUMMARY ***
Total pot $0.75 | Rake $0.04
Board [6d Js Jh]
Seat 1: daughterstuitio folded before Flop (didn't bet)
Seat 2: maxplans323 (button) folded on the Flop
Seat 3: joncruise (small blind) folded before Flop
Seat 4: 921zhaopeng (big blind) folded before Flop
Seat 5: SuWasup collected ($0.71)
Seat 6: PlayTheBlues4U folded before Flop (didn't bet)


PokerStars Hand #203998486251:  Hold'em No Limit ($0.05/$0.10 USD) - 2019/09/26 22:34:01 ET
Table 'Lynx' 6-max Seat #4 is the button
Seat 2: ironons ($8.80 in chips)
Seat 3: mellneazy ($19.36 in chips)
Seat 4: Ribeye63 ($9.45 in chips)
Seat 5: PlayTheBlues4U ($13.57 in chips)
Seat 6: donjt2653 ($7.12 in chips)
PlayTheBlues4U: posts small blind $0.05
donjt2653: posts big blind $0.10
*** HOLE CARDS ***
Dealt to PlayTheBlues4U [3h Tc]
ironons: folds
mellneazy: raises $0.20 to $0.30
Ribeye63: raises $0.60 to $0.90
PlayTheBlues4U: folds
donjt2653: folds
mellneazy: calls $0.60
*** FLOP *** [5c 2s Ac]
mellneazy: checks
Ribeye63: bets $1.39
mellneazy: folds
Uncalled bet ($1.39) returned to Ribeye63
Ribeye63 collected $1.85 from pot
Ribeye63: doesn't show hand
*** SUMMARY ***
Total pot $1.95 | Rake $0.10
Board [5c 2s Ac]
Seat 2: ironons folded before Flop (didn't bet)
Seat 3: mellneazy folded on the Flop
Seat 4: Ribeye63 (button) collected ($1.85)
Seat 5: PlayTheBlues4U (small blind) folded before Flop
Seat 6: donjt2653 (big blind) folded before Flop


PokerStars Hand #203998486106:  Hold'em No Limit ($0.05/$0.10 USD) - 2019/09/26 22:33:12 ET
Table 'Delphinus' 6-max Seat #1 is the button
Seat 1: daughterstuitio ($9.20 in chips)
Seat 2: maxplans323 ($8.26 in chips)
Seat 3: joncruise ($6.65 in chips)
Seat 4: 921zhaopeng ($12.27 in chips)
Seat 5: SuWasup ($10.46 in chips)
Seat 6: PlayTheBlues4U ($11.21 in chips)
maxplans323: posts small blind $0.05
joncruise: posts big blind $0.10
*** HOLE CARDS ***
Dealt to PlayTheBlues4U [Qd 3s]
921zhaopeng: raises $0.20 to $0.30
SuWasup: folds
PlayTheBlues4U: folds
daughterstuitio: calls $0.30
maxplans323: folds
joncruise: calls $0.20
*** FLOP *** [Ad 9h 2c]
joncruise: checks
921zhaopeng: bets $0.90
daughterstuitio: calls $0.90
joncruise: folds
*** TURN *** [Ad 9h 2c] [Qc]
921zhaopeng: checks
daughterstuitio: bets $1.30
921zhaopeng: folds [Kd Kc]
Uncalled bet ($1.30) returned to daughterstuitio
daughterstuitio collected $2.61 from pot
daughterstuitio: doesn't show hand
*** SUMMARY ***
Total pot $2.75 | Rake $0.14
Board [Ad 9h 2c Qc]
Seat 1: daughterstuitio (button) collected ($2.61)
Seat 2: maxplans323 (small blind) folded before Flop
Seat 3: joncruise (big blind) folded on the Flop
Seat 4: 921zhaopeng folded on the Turn
Seat 5: SuWasup folded before Flop (didn't bet)
Seat 6: PlayTheBlues4U folded before Flop (didn't bet)


PokerStars Hand #203998486096:  Hold'em No Limit ($0.05/$0.10 USD) - 2019/09/26 22:33:11 ET
Table 'Lynx' 6-max Seat #3 is the button
Seat 1: clovvnfiesta ($3.70 in chips)
Seat 2: ironons ($8.25 in chips)
Seat 3: mellneazy ($19.81 in chips)
Seat 4: Ribeye63 ($9.50 in chips)
Seat 5: PlayTheBlues4U ($13.67 in chips)
Seat 6: donjt2653 ($7.12 in chips)
Ribeye63: posts small blind $0.05
PlayTheBlues4U: posts big blind $0.10
*** HOLE CARDS ***
Dealt to PlayTheBlues4U [8d 2d]
donjt2653: folds
clovvnfiesta: folds
ironons: calls $0.10
mellneazy: raises $0.35 to $0.45
clovvnfiesta leaves the table
Ribeye63: folds
PlayTheBlues4U: folds
ironons: calls $0.35
*** FLOP *** [Td 4s 4h]
ironons: checks
mellneazy: checks
*** TURN *** [Td 4s 4h] [Js]
ironons: checks
mellneazy: checks
*** RIVER *** [Td 4s 4h Js] [Qc]
ironons: bets $0.30
mellneazy: folds
Uncalled bet ($0.30) returned to ironons
ironons collected $1 from pot
ironons: doesn't show hand
*** SUMMARY ***
Total pot $1.05 | Rake $0.05
Board [Td 4s 4h Js Qc]
Seat 1: clovvnfiesta folded before Flop (didn't bet)
Seat 2: ironons collected ($1)
Seat 3: mellneazy (button) folded on the River
Seat 4: Ribeye63 (small blind) folded before Flop
Seat 5: PlayTheBlues4U (big blind) folded before Flop
Seat 6: donjt2653 folded before Flop (didn't bet)


PokerStars Hand #203998485987:  Hold'em No Limit ($0.05/$0.10 USD) - 2019/09/26 22:32:34 ET
Table 'Delphinus' 6-max Seat #6 is the button
Seat 1: daughterstuitio ($9.50 in chips)
Seat 2: maxplans323 ($8.36 in chips)
Seat 3: joncruise ($6.95 in chips)
Seat 4: 921zhaopeng ($11.33 in chips)
Seat 5: SuWasup ($10.76 in chips)
Seat 6: PlayTheBlues4U ($11.21 in chips)
daughterstuitio: posts small blind $0.05
maxplans323: posts big blind $0.10
*** HOLE CARDS ***
Dealt to PlayTheBlues4U [Jd 2s]
joncruise: calls $0.10
921zhaopeng: raises $0.20 to $0.30
SuWasup: calls $0.30
PlayTheBlues4U: folds
daughterstuitio: calls $0.25
maxplans323: folds
joncruise: calls $0.20
*** FLOP *** [Js Tc 3h]
daughterstuitio: checks
joncruise: checks
921zhaopeng: bets $0.80
SuWasup: folds
daughterstuitio: folds
joncruise: folds
Uncalled bet ($0.80) returned to 921zhaopeng
921zhaopeng collected $1.24 from pot
921zhaopeng: doesn't show hand
*** SUMMARY ***
Total pot $1.30 | Rake $0.06
Board [Js Tc 3h]
Seat 1: daughterstuitio (small blind) folded on the Flop
Seat 2: maxplans323 (big blind) folded before Flop
Seat 3: joncruise folded on the Flop
Seat 4: 921zhaopeng collected ($1.24)
Seat 5: SuWasup folded on the Flop
Seat 6: PlayTheBlues4U (button) folded before Flop (didn't bet)


PokerStars Hand #203998485904:  Hold'em No Limit ($0.05/$0.10 USD) - 2019/09/26 22:32:06 ET
Table 'Lynx' 6-max Seat #2 is the button
Seat 1: clovvnfiesta ($3.70 in chips)
Seat 2: ironons ($8.25 in chips)
Seat 3: mellneazy ($18.55 in chips)
Seat 4: Ribeye63 ($9.60 in chips)
Seat 5: PlayTheBlues4U ($13.67 in chips)
Seat 6: donjt2653 ($8.42 in chips)
mellneazy: posts small blind $0.05
Ribeye63: posts big blind $0.10
*** HOLE CARDS ***
Dealt to PlayTheBlues4U [9c 2h]
PlayTheBlues4U: folds
donjt2653: calls $0.10
clovvnfiesta: folds
ironons: folds
mellneazy: calls $0.05
Ribeye63: checks
*** FLOP *** [As 2c Ad]
mellneazy: checks
Ribeye63: checks
donjt2653: bets $0.10
mellneazy: calls $0.10
Ribeye63: folds
*** TURN *** [As 2c Ad] [5h]
mellneazy: checks
donjt2653: bets $0.20
mellneazy: calls $0.20
*** RIVER *** [As 2c Ad 5h] [3h]
mellneazy: bets $0.90
donjt2653: calls $0.90
*** SHOW DOWN ***
mellneazy: shows [4s 6d] (a straight, Deuce to Six)
donjt2653: mucks hand
mellneazy collected $2.56 from pot
*** SUMMARY ***
Total pot $2.70 | Rake $0.14
Board [As 2c Ad 5h 3h]
Seat 1: clovvnfiesta folded before Flop (didn't bet)
Seat 2: ironons (button) folded before Flop (didn't bet)
Seat 3: mellneazy (small blind) showed [4s 6d] and won ($2.56) with a straight, Deuce to Six
Seat 4: Ribeye63 (big blind) folded on the Flop
Seat 5: PlayTheBlues4U folded before Flop (didn't bet)
Seat 6: donjt2653 mucked [6h 6s]


PokerStars Hand #203998485895:  Hold'em No Limit ($0.05/$0.10 USD) - 2019/09/26 22:32:04 ET
Table 'Delphinus' 6-max Seat #5 is the button
Seat 1: daughterstuitio ($9.80 in chips)
Seat 2: maxplans323 ($8.36 in chips)
Seat 3: joncruise ($6.95 in chips)
Seat 4: 921zhaopeng ($11.33 in chips)
Seat 5: SuWasup ($10.44 in chips)
Seat 6: PlayTheBlues4U ($11.26 in chips)
PlayTheBlues4U: posts small blind $0.05
daughterstuitio: posts big blind $0.10
*** HOLE CARDS ***
Dealt to PlayTheBlues4U [2c 3d]
maxplans323: folds
joncruise: folds
921zhaopeng: folds
SuWasup: raises $0.20 to $0.30
PlayTheBlues4U: folds
daughterstuitio: calls $0.20
*** FLOP *** [3h 7h Jh]
daughterstuitio: checks
SuWasup: bets $0.40
daughterstuitio: folds
Uncalled bet ($0.40) returned to SuWasup
SuWasup collected $0.62 from pot
SuWasup: doesn't show hand
*** SUMMARY ***
Total pot $0.65 | Rake $0.03
Board [3h 7h Jh]
Seat 1: daughterstuitio (big blind) folded on the Flop
Seat 2: maxplans323 folded before Flop (didn't bet)
Seat 3: joncruise folded before Flop (didn't bet)
Seat 4: 921zhaopeng folded before Flop (didn't bet)
Seat 5: SuWasup (button) collected ($0.62)
Seat 6: PlayTheBlues4U (small blind) folded before Flop


PokerStars Hand #203998485810:  Hold'em No Limit ($0.05/$0.10 USD) - 2019/09/26 22:31:35 ET
Table 'Lynx' 6-max Seat #1 is the button
Seat 1: clovvnfiesta ($3.70 in chips)
Seat 2: ironons ($8.65 in chips)
Seat 3: mellneazy ($18.95 in chips)
Seat 4: Ribeye63 ($9.60 in chips)
Seat 5: PlayTheBlues4U ($13.67 in chips)
Seat 6: donjt2653 ($7.68 in chips)
ironons: posts small blind $0.05
mellneazy: posts big blind $0.10
*** HOLE CARDS ***
Dealt to PlayTheBlues4U [2c 8h]
Ribeye63: folds
PlayTheBlues4U: folds
donjt2653: raises $0.30 to $0.40
clovvnfiesta: folds
ironons: calls $0.35
mellneazy: calls $0.30
*** FLOP *** [9c 2d 2s]
ironons: checks
mellneazy: checks
donjt2653: bets $1.10
ironons: folds
mellneazy: folds
Uncalled bet ($1.10) returned to donjt2653
donjt2653 collected $1.14 from pot
donjt2653: doesn't show hand
*** SUMMARY ***
Total pot $1.20 | Rake $0.06
Board [9c 2d 2s]
Seat 1: clovvnfiesta (button) folded before Flop (didn't bet)
Seat 2: ironons (small blind) folded on the Flop
Seat 3: mellneazy (big blind) folded on the Flop
Seat 4: Ribeye63 folded before Flop (didn't bet)
Seat 5: PlayTheBlues4U folded before Flop (didn't bet)
Seat 6: donjt2653 collected ($1.14)


PokerStars Hand #203998485757:  Hold'em No Limit ($0.05/$0.10 USD) - 2019/09/26 22:31:16 ET
Table 'Delphinus' 6-max Seat #4 is the button
Seat 1: daughterstuitio ($9.80 in chips)
Seat 2: maxplans323 ($8.36 in chips)
Seat 3: joncruise ($6.95 in chips)
Seat 4: 921zhaopeng ($11.33 in chips)
Seat 5: SuWasup ($10.45 in chips)
Seat 6: PlayTheBlues4U ($11.28 in chips)
SuWasup: posts small blind $0.05
PlayTheBlues4U: posts big blind $0.10
*** HOLE CARDS ***
Dealt to PlayTheBlues4U [Kd Jc]
daughterstuitio: folds
maxplans323: folds
joncruise: folds
921zhaopeng: folds
SuWasup: raises $0.20 to $0.30
PlayTheBlues4U: calls $0.20
*** FLOP *** [Td Th 5s]
SuWasup: checks
PlayTheBlues4U: checks
*** TURN *** [Td Th 5s] [3s]
SuWasup: checks
PlayTheBlues4U: checks
*** RIVER *** [Td Th 5s 3s] [3h]
SuWasup: checks
PlayTheBlues4U: checks
*** SHOW DOWN ***
SuWasup: shows [Kh 9c] (two pair, Tens and Threes)
PlayTheBlues4U: shows [Kd Jc] (two pair, Tens and Threes)
SuWasup collected $0.29 from pot
PlayTheBlues4U collected $0.28 from pot
*** SUMMARY ***
Total pot $0.60 | Rake $0.03
Board [Td Th 5s 3s 3h]
Seat 1: daughterstuitio folded before Flop (didn't bet)
Seat 2: maxplans323 folded before Flop (didn't bet)
Seat 3: joncruise folded before Flop (didn't bet)
Seat 4: 921zhaopeng (button) folded before Flop (didn't bet)
Seat 5: SuWasup (small blind) showed [Kh 9c] and won ($0.29) with two pair, Tens and Threes
Seat 6: PlayTheBlues4U (big blind) showed [Kd Jc] and won ($0.28) with two pair, Tens and Threes


PokerStars Hand #203998485694:  Hold'em No Limit ($0.05/$0.10 USD) - 2019/09/26 22:30:54 ET
Table 'Lynx' 6-max Seat #6 is the button
Seat 1: clovvnfiesta ($3.75 in chips)
Seat 2: ironons ($8.75 in chips)
Seat 3: mellneazy ($17.55 in chips)
Seat 4: Ribeye63 ($9.60 in chips)
Seat 5: PlayTheBlues4U ($13.67 in chips)
Seat 6: donjt2653 ($9.08 in chips)
clovvnfiesta: posts small blind $0.05
ironons: posts big blind $0.10
*** HOLE CARDS ***
Dealt to PlayTheBlues4U [Jh 2s]
mellneazy: raises $0.20 to $0.30
Ribeye63: folds
PlayTheBlues4U: folds
donjt2653: calls $0.30
clovvnfiesta: folds
ironons: folds
*** FLOP *** [6c 6d 4d]
mellneazy: bets $0.40
donjt2653: calls $0.40
*** TURN *** [6c 6d 4d] [Tc]
mellneazy: bets $0.70
donjt2653: calls $0.70
*** RIVER *** [6c 6d 4d Tc] [Qh]
mellneazy: bets $1.50
donjt2653: folds
Uncalled bet ($1.50) returned to mellneazy
mellneazy collected $2.80 from pot
mellneazy: doesn't show hand
*** SUMMARY ***
Total pot $2.95 | Rake $0.15
Board [6c 6d 4d Tc Qh]
Seat 1: clovvnfiesta (small blind) folded before Flop
Seat 2: ironons (big blind) folded before Flop
Seat 3: mellneazy collected ($2.80)
Seat 4: Ribeye63 folded before Flop (didn't bet)
Seat 5: PlayTheBlues4U folded before Flop (didn't bet)
Seat 6: donjt2653 (button) folded on the River


PokerStars Hand #203998485547:  Hold'em No Limit ($0.05/$0.10 USD) - 2019/09/26 22:30:09 ET
Table 'Delphinus' 6-max Seat #3 is the button
Seat 1: daughterstuitio ($9.80 in chips)
Seat 2: maxplans323 ($8.97 in chips)
Seat 3: joncruise ($6.95 in chips)
Seat 4: 921zhaopeng ($11.38 in chips)
Seat 5: SuWasup ($9.85 in chips)
Seat 6: PlayTheBlues4U ($11.28 in chips)
921zhaopeng: posts small blind $0.05
SuWasup: posts big blind $0.10
*** HOLE CARDS ***
Dealt to PlayTheBlues4U [Ac 5d]
PlayTheBlues4U: folds
daughterstuitio: folds
maxplans323: raises $0.20 to $0.30
joncruise: folds
921zhaopeng: folds
SuWasup: calls $0.20
*** FLOP *** [Tc 5c Qh]
SuWasup: checks
maxplans323: bets $0.31
SuWasup: calls $0.31
*** TURN *** [Tc 5c Qh] [4c]
SuWasup: checks
maxplans323: checks
*** RIVER *** [Tc 5c Qh 4c] [Ks]
SuWasup: bets $0.61
maxplans323: folds
Uncalled bet ($0.61) returned to SuWasup
SuWasup collected $1.21 from pot
SuWasup: doesn't show hand
*** SUMMARY ***
Total pot $1.27 | Rake $0.06
Board [Tc 5c Qh 4c Ks]
Seat 1: daughterstuitio folded before Flop (didn't bet)
Seat 2: maxplans323 folded on the River
Seat 3: joncruise (button) folded before Flop (didn't bet)
Seat 4: 921zhaopeng (small blind) folded before Flop
Seat 5: SuWasup (big blind) collected ($1.21)
Seat 6: PlayTheBlues4U folded before Flop (didn't bet)


PokerStars Hand #203998485470:  Hold'em No Limit ($0.05/$0.10 USD) - 2019/09/26 22:29:43 ET
Table 'Lynx' 6-max Seat #5 is the button
Seat 1: clovvnfiesta ($3.85 in chips)
Seat 2: ironons ($8.75 in chips)
Seat 3: mellneazy ($18.75 in chips)
Seat 4: Ribeye63 ($9.60 in chips)
Seat 5: PlayTheBlues4U ($13.67 in chips)
Seat 6: donjt2653 ($7.90 in chips)
donjt2653: posts small blind $0.05
clovvnfiesta: posts big blind $0.10
*** HOLE CARDS ***
Dealt to PlayTheBlues4U [2h 9s]
ironons: folds
mellneazy: raises $0.20 to $0.30
Ribeye63: folds
PlayTheBlues4U: folds
donjt2653: calls $0.25
clovvnfiesta: folds
*** FLOP *** [4s Ks Ac]
donjt2653: checks
mellneazy: bets $0.30
donjt2653: raises $0.60 to $0.90
mellneazy: calls $0.60
*** TURN *** [4s Ks Ac] [Qh]
donjt2653: bets $1.20
mellneazy: folds
Uncalled bet ($1.20) returned to donjt2653
donjt2653 collected $2.38 from pot
donjt2653: doesn't show hand
*** SUMMARY ***
Total pot $2.50 | Rake $0.12
Board [4s Ks Ac Qh]
Seat 1: clovvnfiesta (big blind) folded before Flop
Seat 2: ironons folded before Flop (didn't bet)
Seat 3: mellneazy folded on the Turn
Seat 4: Ribeye63 folded before Flop (didn't bet)
Seat 5: PlayTheBlues4U (button) folded before Flop (didn't bet)
Seat 6: donjt2653 (small blind) collected ($2.38)


PokerStars Hand #203998485379:  Hold'em No Limit ($0.05/$0.10 USD) - 2019/09/26 22:29:12 ET
Table 'Lynx' 6-max Seat #4 is the button
Seat 1: clovvnfiesta ($3.85 in chips)
Seat 2: ironons ($8.75 in chips)
Seat 3: mellneazy ($18.60 in chips)
Seat 4: Ribeye63 ($9.60 in chips)
Seat 5: PlayTheBlues4U ($13.72 in chips)
Seat 6: donjt2653 ($8 in chips)
PlayTheBlues4U: posts small blind $0.05
donjt2653: posts big blind $0.10
*** HOLE CARDS ***
Dealt to PlayTheBlues4U [2h 5s]
clovvnfiesta: folds
ironons: folds
mellneazy: raises $0.20 to $0.30
Ribeye63: folds
PlayTheBlues4U: folds
donjt2653: folds
Uncalled bet ($0.20) returned to mellneazy
mellneazy collected $0.25 from pot
mellneazy: doesn't show hand
*** SUMMARY ***
Total pot $0.25 | Rake $0
Seat 1: clovvnfiesta folded before Flop (didn't bet)
Seat 2: ironons folded before Flop (didn't bet)
Seat 3: mellneazy collected ($0.25)
Seat 4: Ribeye63 (button) folded before Flop (didn't bet)
Seat 5: PlayTheBlues4U (small blind) folded before Flop
Seat 6: donjt2653 (big blind) folded before Flop


PokerStars Hand #203998485375:  Hold'em No Limit ($0.05/$0.10 USD) - 2019/09/26 22:29:11 ET
Table 'Delphinus' 6-max Seat #2 is the button
Seat 1: daughterstuitio ($9.80 in chips)
Seat 2: maxplans323 ($7.72 in chips)
Seat 3: joncruise ($8.23 in chips)
Seat 4: 921zhaopeng ($11.48 in chips)
Seat 5: SuWasup ($9.85 in chips)
Seat 6: PlayTheBlues4U ($11.28 in chips)
joncruise: posts small blind $0.05
921zhaopeng: posts big blind $0.10
*** HOLE CARDS ***
Dealt to PlayTheBlues4U [Jh 7c]
SuWasup: folds
PlayTheBlues4U: folds
daughterstuitio: folds
maxplans323: raises $0.20 to $0.30
joncruise: calls $0.25
921zhaopeng: folds
*** FLOP *** [Js 9h 4s]
joncruise: checks
maxplans323: bets $0.33
joncruise: calls $0.33
*** TURN *** [Js 9h 4s] [7h]
joncruise: checks
maxplans323: bets $0.65
joncruise: calls $0.65
*** RIVER *** [Js 9h 4s 7h] [As]
joncruise: checks
maxplans323: bets $1.50
joncruise: folds
Uncalled bet ($1.50) returned to maxplans323
maxplans323 collected $2.53 from pot
maxplans323: doesn't show hand
*** SUMMARY ***
Total pot $2.66 | Rake $0.13
Board [Js 9h 4s 7h As]
Seat 1: daughterstuitio folded before Flop (didn't bet)
Seat 2: maxplans323 (button) collected ($2.53)
Seat 3: joncruise (small blind) folded on the River
Seat 4: 921zhaopeng (big blind) folded before Flop
Seat 5: SuWasup folded before Flop (didn't bet)
Seat 6: PlayTheBlues4U folded before Flop (didn't bet)


PokerStars Hand #203998485322:  Hold'em No Limit ($0.05/$0.10 USD) - 2019/09/26 22:28:55 ET
Table 'Delphinus' 6-max Seat #1 is the button
Seat 1: daughterstuitio ($9.80 in chips)
Seat 2: maxplans323 ($7.77 in chips)
Seat 3: joncruise ($8.33 in chips)
Seat 4: 921zhaopeng ($11.33 in chips)
Seat 5: SuWasup ($9.85 in chips)
Seat 6: PlayTheBlues4U ($11.28 in chips)
maxplans323: posts small blind $0.05
joncruise: posts big blind $0.10
*** HOLE CARDS ***
Dealt to PlayTheBlues4U [Kc 7h]
921zhaopeng: raises $0.20 to $0.30
SuWasup: folds
PlayTheBlues4U: folds
daughterstuitio: folds
maxplans323: folds
joncruise: folds
Uncalled bet ($0.20) returned to 921zhaopeng
921zhaopeng collected $0.25 from pot
921zhaopeng: doesn't show hand
*** SUMMARY ***
Total pot $0.25 | Rake $0
Seat 1: daughterstuitio (button) folded before Flop (didn't bet)
Seat 2: maxplans323 (small blind) folded before Flop
Seat 3: joncruise (big blind) folded before Flop
Seat 4: 921zhaopeng collected ($0.25)
Seat 5: SuWasup folded before Flop (didn't bet)
Seat 6: PlayTheBlues4U folded before Flop (didn't bet)


PokerStars Hand #203998485190:  Hold'em No Limit ($0.05/$0.10 USD) - 2019/09/26 22:28:10 ET
Table 'Lynx' 6-max Seat #3 is the button
Seat 1: clovvnfiesta ($3.85 in chips)
Seat 2: ironons ($10.45 in chips)
Seat 3: mellneazy ($16.69 in chips)
Seat 4: Ribeye63 ($9.90 in chips)
Seat 5: PlayTheBlues4U ($13.82 in chips)
Ribeye63: posts small blind $0.05
PlayTheBlues4U: posts big blind $0.10
donjt2653: sits out
*** HOLE CARDS ***
Dealt to PlayTheBlues4U [8c Qs]
clovvnfiesta: folds
ironons: raises $0.20 to $0.30
mellneazy: calls $0.30
Ribeye63: calls $0.25
PlayTheBlues4U: folds
*** FLOP *** [6d Kh 5h]
Ribeye63: checks
ironons: bets $0.48
mellneazy: raises $0.92 to $1.40
Ribeye63: folds
ironons: calls $0.92
*** TURN *** [6d Kh 5h] [Ks]
ironons: checks
mellneazy: checks
*** RIVER *** [6d Kh 5h Ks] [8h]
ironons: checks
mellneazy: bets $3
ironons: folds
Uncalled bet ($3) returned to mellneazy
mellneazy collected $3.61 from pot
mellneazy: doesn't show hand
*** SUMMARY ***
Total pot $3.80 | Rake $0.19
Board [6d Kh 5h Ks 8h]
Seat 1: clovvnfiesta folded before Flop (didn't bet)
Seat 2: ironons folded on the River
Seat 3: mellneazy (button) collected ($3.61)
Seat 4: Ribeye63 (small blind) folded on the Flop
Seat 5: PlayTheBlues4U (big blind) folded before Flop


PokerStars Hand #203998485140:  Hold'em No Limit ($0.05/$0.10 USD) - 2019/09/26 22:27:54 ET
Table 'Delphinus' 6-max Seat #6 is the button
Seat 1: daughterstuitio ($9.85 in chips)
Seat 2: maxplans323 ($6.54 in chips)
Seat 3: joncruise ($9.33 in chips)
Seat 4: 921zhaopeng ($11.63 in chips)
Seat 5: SuWasup ($9.85 in chips)
Seat 6: PlayTheBlues4U ($11.28 in chips)
daughterstuitio: posts small blind $0.05
maxplans323: posts big blind $0.10
*** HOLE CARDS ***
Dealt to PlayTheBlues4U [Qc 9h]
joncruise: calls $0.10
921zhaopeng: raises $0.20 to $0.30
SuWasup: folds
PlayTheBlues4U: folds
daughterstuitio: folds
maxplans323: calls $0.20
joncruise: calls $0.20
*** FLOP *** [6c 8h 3s]
maxplans323: bets $0.70
joncruise: calls $0.70
921zhaopeng: folds
*** TURN *** [6c 8h 3s] [Ad]
maxplans323: checks
joncruise: checks
*** RIVER *** [6c 8h 3s Ad] [2c]
maxplans323: checks
joncruise: checks
*** SHOW DOWN ***
maxplans323: shows [9s 9d] (a pair of Nines)
joncruise: mucks hand
maxplans323 collected $2.23 from pot
*** SUMMARY ***
Total pot $2.35 | Rake $0.12
Board [6c 8h 3s Ad 2c]
Seat 1: daughterstuitio (small blind) folded before Flop
Seat 2: maxplans323 (big blind) showed [9s 9d] and won ($2.23) with a pair of Nines
Seat 3: joncruise mucked [8d Tc]
Seat 4: 921zhaopeng folded on the Flop
Seat 5: SuWasup folded before Flop (didn't bet)
Seat 6: PlayTheBlues4U (button) folded before Flop (didn't bet)


PokerStars Hand #203998485130:  Hold'em No Limit ($0.05/$0.10 USD) - 2019/09/26 22:27:51 ET
Table 'Lynx' 6-max Seat #2 is the button
Seat 1: clovvnfiesta ($3.85 in chips)
Seat 2: ironons ($10.09 in chips)
Seat 3: mellneazy ($16.99 in chips)
Seat 4: Ribeye63 ($10 in chips)
Seat 5: PlayTheBlues4U ($13.82 in chips)
mellneazy: posts small blind $0.05
Ribeye63: posts big blind $0.10
donjt2653: sits out
*** HOLE CARDS ***
Dealt to PlayTheBlues4U [2s Ts]
PlayTheBlues4U: folds
clovvnfiesta: folds
ironons: raises $0.20 to $0.30
mellneazy: calls $0.25
Ribeye63: folds
*** FLOP *** [6d Jc 8s]
mellneazy: checks
ironons: checks
*** TURN *** [6d Jc 8s] [9h]
mellneazy: checks
ironons: bets $0.33
mellneazy: folds
Uncalled bet ($0.33) returned to ironons
ironons collected $0.66 from pot
ironons: doesn't show hand
*** SUMMARY ***
Total pot $0.70 | Rake $0.04
Board [6d Jc 8s 9h]
Seat 1: clovvnfiesta folded before Flop (didn't bet)
Seat 2: ironons (button) collected ($0.66)
Seat 3: mellneazy (small blind) folded on the Turn
Seat 4: Ribeye63 (big blind) folded before Flop
Seat 5: PlayTheBlues4U folded before Flop (didn't bet)


PokerStars Hand #203998485069:  Hold'em No Limit ($0.05/$0.10 USD) - 2019/09/26 22:27:33 ET
Table 'Lynx' 6-max Seat #1 is the button
Seat 1: clovvnfiesta ($3.85 in chips)
Seat 2: ironons ($10.19 in chips)
Seat 3: mellneazy ($16.90 in chips)
Seat 4: Ribeye63 ($10 in chips)
Seat 5: PlayTheBlues4U ($13.82 in chips)
ironons: posts small blind $0.05
mellneazy: posts big blind $0.10
donjt2653: sits out
*** HOLE CARDS ***
Dealt to PlayTheBlues4U [2h Qh]
Ribeye63: folds
PlayTheBlues4U: folds
clovvnfiesta: folds
ironons: calls $0.05
mellneazy: checks
*** FLOP *** [Ac 3s 6s]
ironons: checks
mellneazy: checks
*** TURN *** [Ac 3s 6s] [3h]
ironons: checks
mellneazy: checks
*** RIVER *** [Ac 3s 6s 3h] [5d]
ironons: checks
mellneazy: checks
*** SHOW DOWN ***
ironons: shows [9h Jc] (a pair of Threes)
mellneazy: shows [Jh Kc] (a pair of Threes - Ace+King kicker)
mellneazy collected $0.19 from pot
*** SUMMARY ***
Total pot $0.20 | Rake $0.01
Board [Ac 3s 6s 3h 5d]
Seat 1: clovvnfiesta (button) folded before Flop (didn't bet)
Seat 2: ironons (small blind) showed [9h Jc] and lost with a pair of Threes
Seat 3: mellneazy (big blind) showed [Jh Kc] and won ($0.19) with a pair of Threes
Seat 4: Ribeye63 folded before Flop (didn't bet)
Seat 5: PlayTheBlues4U folded before Flop (didn't bet)


PokerStars Hand #203998484988:  Hold'em No Limit ($0.05/$0.10 USD) - 2019/09/26 22:27:03 ET
Table 'Delphinus' 6-max Seat #5 is the button
Seat 1: daughterstuitio ($10.15 in chips)
Seat 2: maxplans323 ($6.54 in chips)
Seat 3: joncruise ($9.01 in chips)
Seat 4: 921zhaopeng ($11.63 in chips)
Seat 5: SuWasup ($9.85 in chips)
Seat 6: PlayTheBlues4U ($11.33 in chips)
PlayTheBlues4U: posts small blind $0.05
daughterstuitio: posts big blind $0.10
*** HOLE CARDS ***
Dealt to PlayTheBlues4U [4h Kd]
maxplans323: folds
joncruise: raises $0.20 to $0.30
921zhaopeng: folds
SuWasup: folds
PlayTheBlues4U: folds
daughterstuitio: calls $0.20
*** FLOP *** [9h Ah Ks]
daughterstuitio: checks
joncruise: checks
*** TURN *** [9h Ah Ks] [9s]
daughterstuitio: checks
joncruise: checks
*** RIVER *** [9h Ah Ks 9s] [2c]
daughterstuitio: checks
joncruise: bets $0.60
daughterstuitio: folds
Uncalled bet ($0.60) returned to joncruise
joncruise collected $0.62 from pot
joncruise: doesn't show hand
*** SUMMARY ***
Total pot $0.65 | Rake $0.03
Board [9h Ah Ks 9s 2c]
Seat 1: daughterstuitio (big blind) folded on the River
Seat 2: maxplans323 folded before Flop (didn't bet)
Seat 3: joncruise collected ($0.62)
Seat 4: 921zhaopeng folded before Flop (didn't bet)
Seat 5: SuWasup (button) folded before Flop (didn't bet)
Seat 6: PlayTheBlues4U (small blind) folded before Flop


PokerStars Hand #203998484880:  Hold'em No Limit ($0.05/$0.10 USD) - 2019/09/26 22:26:31 ET
Table 'Lynx' 6-max Seat #5 is the button
Seat 1: clovvnfiesta ($3.90 in chips)
Seat 2: ironons ($8.76 in chips)
Seat 3: mellneazy ($17.65 in chips)
Seat 4: Ribeye63 ($1.78 in chips)
Seat 5: PlayTheBlues4U ($14.57 in chips)
donjt2653 will be allowed to play after the button
clovvnfiesta: posts small blind $0.05
ironons: posts big blind $0.10
*** HOLE CARDS ***
Dealt to PlayTheBlues4U [Th Td]
mellneazy: raises $0.20 to $0.30
Ribeye63: folds
PlayTheBlues4U: calls $0.30
clovvnfiesta: folds
ironons: calls $0.20
*** FLOP *** [Jh 8s 5h]
ironons: checks
mellneazy: checks
PlayTheBlues4U: checks
*** TURN *** [Jh 8s 5h] [5s]
ironons: bets $0.45
mellneazy: calls $0.45
PlayTheBlues4U: calls $0.45
*** RIVER *** [Jh 8s 5h 5s] [6s]
ironons: bets $2
mellneazy: folds
PlayTheBlues4U: folds
Uncalled bet ($2) returned to ironons
ironons collected $2.18 from pot
ironons: doesn't show hand
*** SUMMARY ***
Total pot $2.30 | Rake $0.12
Board [Jh 8s 5h 5s 6s]
Seat 1: clovvnfiesta (small blind) folded before Flop
Seat 2: ironons (big blind) collected ($2.18)
Seat 3: mellneazy folded on the River
Seat 4: Ribeye63 folded before Flop (didn't bet)
Seat 5: PlayTheBlues4U (button) folded on the River


PokerStars Hand #203998484804:  Hold'em No Limit ($0.05/$0.10 USD) - 2019/09/26 22:26:05 ET
Table 'Delphinus' 6-max Seat #4 is the button
Seat 1: daughterstuitio ($10.25 in chips)
Seat 2: maxplans323 ($6.54 in chips)
Seat 3: joncruise ($9.01 in chips)
Seat 4: 921zhaopeng ($11.63 in chips)
Seat 5: SuWasup ($9.49 in chips)
Seat 6: PlayTheBlues4U ($11.63 in chips)
SuWasup: posts small blind $0.05
PlayTheBlues4U: posts big blind $0.10
*** HOLE CARDS ***
Dealt to PlayTheBlues4U [5c Qs]
daughterstuitio: calls $0.10
maxplans323: folds
joncruise: folds
921zhaopeng: folds
SuWasup: calls $0.05
PlayTheBlues4U: checks
*** FLOP *** [9d Qd 7h]
SuWasup: checks
PlayTheBlues4U: checks
daughterstuitio: checks
*** TURN *** [9d Qd 7h] [2d]
SuWasup: checks
PlayTheBlues4U: bets $0.20
daughterstuitio: folds
SuWasup: calls $0.20
*** RIVER *** [9d Qd 7h 2d] [9c]
SuWasup: checks
PlayTheBlues4U: checks
*** SHOW DOWN ***
SuWasup: shows [9s Jh] (three of a kind, Nines)
PlayTheBlues4U: mucks hand
SuWasup collected $0.66 from pot
*** SUMMARY ***
Total pot $0.70 | Rake $0.04
Board [9d Qd 7h 2d 9c]
Seat 1: daughterstuitio folded on the Turn
Seat 2: maxplans323 folded before Flop (didn't bet)
Seat 3: joncruise folded before Flop (didn't bet)
Seat 4: 921zhaopeng (button) folded before Flop (didn't bet)
Seat 5: SuWasup (small blind) showed [9s Jh] and won ($0.66) with three of a kind, Nines
Seat 6: PlayTheBlues4U (big blind) mucked [5c Qs]


PokerStars Hand #203998484735:  Hold'em No Limit ($0.05/$0.10 USD) - 2019/09/26 22:25:42 ET
Table 'Delphinus' 6-max Seat #3 is the button
Seat 1: daughterstuitio ($10.25 in chips)
Seat 2: maxplans323 ($6.54 in chips)
Seat 3: joncruise ($9.11 in chips)
Seat 4: 921zhaopeng ($11.73 in chips)
Seat 5: SuWasup ($9.31 in chips)
Seat 6: PlayTheBlues4U ($11.63 in chips)
921zhaopeng: posts small blind $0.05
SuWasup: posts big blind $0.10
*** HOLE CARDS ***
Dealt to PlayTheBlues4U [4c 3h]
PlayTheBlues4U: folds
daughterstuitio: folds
maxplans323: folds
joncruise: calls $0.10
921zhaopeng: calls $0.05
SuWasup: checks
*** FLOP *** [Ac 5h 6c]
921zhaopeng: checks
SuWasup: bets $0.20
joncruise: folds
921zhaopeng: folds
Uncalled bet ($0.20) returned to SuWasup
SuWasup collected $0.28 from pot
SuWasup: doesn't show hand
*** SUMMARY ***
Total pot $0.30 | Rake $0.02
Board [Ac 5h 6c]
Seat 1: daughterstuitio folded before Flop (didn't bet)
Seat 2: maxplans323 folded before Flop (didn't bet)
Seat 3: joncruise (button) folded on the Flop
Seat 4: 921zhaopeng (small blind) folded on the Flop
Seat 5: SuWasup (big blind) collected ($0.28)
Seat 6: PlayTheBlues4U folded before Flop (didn't bet)


PokerStars Hand #203998484710:  Hold'em No Limit ($0.05/$0.10 USD) - 2019/09/26 22:25:34 ET
Table 'Lynx' 6-max Seat #4 is the button
Seat 1: clovvnfiesta ($4 in chips)
Seat 2: ironons ($8.86 in chips)
Seat 3: mellneazy ($17.65 in chips)
Seat 4: Ribeye63 ($9.35 in chips)
Seat 5: PlayTheBlues4U ($7.57 in chips)
PlayTheBlues4U: posts small blind $0.05
clovvnfiesta: posts big blind $0.10
*** HOLE CARDS ***
Dealt to PlayTheBlues4U [Ah Qh]
ironons: calls $0.10
mellneazy: folds
Ribeye63: raises $0.30 to $0.40
donjt2653 joins the table at seat #6
PlayTheBlues4U: raises $0.60 to $1
clovvnfiesta: folds
ironons: folds
Ribeye63: calls $0.60
*** FLOP *** [6h 9s 3h]
PlayTheBlues4U: bets $1.10
Ribeye63: raises $1.10 to $2.20
PlayTheBlues4U: raises $4.37 to $6.57 and is all-in
Ribeye63: calls $4.37
*** TURN *** [6h 9s 3h] [7s]
*** RIVER *** [6h 9s 3h 7s] [9h]
*** SHOW DOWN ***
PlayTheBlues4U: shows [Ah Qh] (a flush, Ace high)
Ribeye63: shows [Kc Ks] (two pair, Kings and Nines)
PlayTheBlues4U collected $14.57 from pot
*** SUMMARY ***
Total pot $15.34 | Rake $0.77
Board [6h 9s 3h 7s 9h]
Seat 1: clovvnfiesta (big blind) folded before Flop
Seat 2: ironons folded before Flop
Seat 3: mellneazy folded before Flop (didn't bet)
Seat 4: Ribeye63 (button) showed [Kc Ks] and lost with two pair, Kings and Nines
Seat 5: PlayTheBlues4U (small blind) showed [Ah Qh] and won ($14.57) with a flush, Ace high


PokerStars Hand #203998484640:  Hold'em No Limit ($0.05/$0.10 USD) - 2019/09/26 22:25:11 ET
Table 'Delphinus' 6-max Seat #2 is the button
Seat 1: daughterstuitio ($10.55 in chips)
Seat 2: maxplans323 ($6.09 in chips)
Seat 3: joncruise ($9.16 in chips)
Seat 4: 921zhaopeng ($11.83 in chips)
Seat 5: SuWasup ($9.31 in chips)
Seat 6: PlayTheBlues4U ($11.63 in chips)
joncruise: posts small blind $0.05
921zhaopeng: posts big blind $0.10
*** HOLE CARDS ***
Dealt to PlayTheBlues4U [8h Jd]
SuWasup: folds
PlayTheBlues4U: folds
daughterstuitio: raises $0.20 to $0.30
maxplans323: raises $0.60 to $0.90
joncruise: folds
921zhaopeng: folds
daughterstuitio: folds
Uncalled bet ($0.60) returned to maxplans323
maxplans323 collected $0.75 from pot
maxplans323: doesn't show hand
*** SUMMARY ***
Total pot $0.75 | Rake $0
Seat 1: daughterstuitio folded before Flop
Seat 2: maxplans323 (button) collected ($0.75)
Seat 3: joncruise (small blind) folded before Flop
Seat 4: 921zhaopeng (big blind) folded before Flop
Seat 5: SuWasup folded before Flop (didn't bet)
Seat 6: PlayTheBlues4U folded before Flop (didn't bet)


PokerStars Hand #203998484575:  Hold'em No Limit ($0.05/$0.10 USD) - 2019/09/26 22:24:50 ET
Table 'Delphinus' 6-max Seat #1 is the button
Seat 1: daughterstuitio ($10.40 in chips)
Seat 2: maxplans323 ($6.14 in chips)
Seat 3: joncruise ($9.26 in chips)
Seat 4: 921zhaopeng ($11.83 in chips)
Seat 5: SuWasup ($9.31 in chips)
Seat 6: PlayTheBlues4U ($11.63 in chips)
maxplans323: posts small blind $0.05
joncruise: posts big blind $0.10
*** HOLE CARDS ***
Dealt to PlayTheBlues4U [Jd 3d]
921zhaopeng: folds
SuWasup: folds
PlayTheBlues4U: folds
daughterstuitio: raises $0.20 to $0.30
maxplans323: folds
joncruise: folds
Uncalled bet ($0.20) returned to daughterstuitio
daughterstuitio collected $0.25 from pot
daughterstuitio: doesn't show hand
*** SUMMARY ***
Total pot $0.25 | Rake $0
Seat 1: daughterstuitio (button) collected ($0.25)
Seat 2: maxplans323 (small blind) folded before Flop
Seat 3: joncruise (big blind) folded before Flop
Seat 4: 921zhaopeng folded before Flop (didn't bet)
Seat 5: SuWasup folded before Flop (didn't bet)
Seat 6: PlayTheBlues4U folded before Flop (didn't bet)


PokerStars Hand #203998484549:  Hold'em No Limit ($0.05/$0.10 USD) - 2019/09/26 22:24:42 ET
Table 'Lynx' 6-max Seat #3 is the button
Seat 2: ironons ($8.26 in chips)
Seat 3: mellneazy ($17.65 in chips)
Seat 4: Ribeye63 ($9.40 in chips)
Seat 5: PlayTheBlues4U ($8.18 in chips)
Ribeye63: posts small blind $0.05
PlayTheBlues4U: posts big blind $0.10
*** HOLE CARDS ***
Dealt to PlayTheBlues4U [8s 7c]
ironons: raises $0.20 to $0.30
StarsAccount1 leaves the table
mellneazy: folds
Ribeye63: folds
PlayTheBlues4U: calls $0.20
*** FLOP *** [7s Jd 9d]
PlayTheBlues4U: checks
ironons: bets $0.31
PlayTheBlues4U: calls $0.31
*** TURN *** [7s Jd 9d] [Kh]
PlayTheBlues4U: checks
ironons: bets $0.90
clovvnfiesta joins the table at seat #1
PlayTheBlues4U: folds
Uncalled bet ($0.90) returned to ironons
ironons collected $1.21 from pot
ironons: doesn't show hand
*** SUMMARY ***
Total pot $1.27 | Rake $0.06
Board [7s Jd 9d Kh]
Seat 2: ironons collected ($1.21)
Seat 3: mellneazy (button) folded before Flop (didn't bet)
Seat 4: Ribeye63 (small blind) folded before Flop
Seat 5: PlayTheBlues4U (big blind) folded on the Turn


PokerStars Hand #203998484413:  Hold'em No Limit ($0.05/$0.10 USD) - 2019/09/26 22:23:58 ET
Table 'Delphinus' 6-max Seat #6 is the button
Seat 1: daughterstuitio ($10.45 in chips)
Seat 2: maxplans323 ($6.75 in chips)
Seat 3: joncruise ($8.66 in chips)
Seat 4: 921zhaopeng ($11.83 in chips)
Seat 5: SuWasup ($9.31 in chips)
Seat 6: PlayTheBlues4U ($11.63 in chips)
daughterstuitio: posts small blind $0.05
maxplans323: posts big blind $0.10
*** HOLE CARDS ***
Dealt to PlayTheBlues4U [6h 2d]
joncruise: calls $0.10
921zhaopeng: folds
SuWasup: folds
PlayTheBlues4U: folds
daughterstuitio: folds
maxplans323: raises $0.20 to $0.30
joncruise: calls $0.20
*** FLOP *** [Ks 3h 9h]
maxplans323: bets $0.31
joncruise: calls $0.31
*** TURN *** [Ks 3h 9h] [Ah]
maxplans323: checks
joncruise: bets $0.60
maxplans323: folds
Uncalled bet ($0.60) returned to joncruise
joncruise collected $1.21 from pot
joncruise: doesn't show hand
*** SUMMARY ***
Total pot $1.27 | Rake $0.06
Board [Ks 3h 9h Ah]
Seat 1: daughterstuitio (small blind) folded before Flop
Seat 2: maxplans323 (big blind) folded on the Turn
Seat 3: joncruise collected ($1.21)
Seat 4: 921zhaopeng folded before Flop (didn't bet)
Seat 5: SuWasup folded before Flop (didn't bet)
Seat 6: PlayTheBlues4U (button) folded before Flop (didn't bet)


PokerStars Hand #203998484384:  Hold'em No Limit ($0.05/$0.10 USD) - 2019/09/26 22:23:49 ET
Table 'Lynx' 6-max Seat #2 is the button
Seat 2: ironons ($5.46 in chips)
Seat 3: mellneazy ($17.70 in chips)
Seat 4: Ribeye63 ($9.50 in chips)
Seat 5: PlayTheBlues4U ($8.98 in chips)
Seat 6: StarsAccount1 ($2.11 in chips)
mellneazy: posts small blind $0.05
Ribeye63: posts big blind $0.10
*** HOLE CARDS ***
Dealt to PlayTheBlues4U [Jd As]
PlayTheBlues4U: raises $0.20 to $0.30
StarsAccount1: calls $0.30
ironons: calls $0.30
mellneazy: folds
Ribeye63: folds
*** FLOP *** [Th 6h 9s]
PlayTheBlues4U: checks
StarsAccount1: bets $0.50
ironons: calls $0.50
PlayTheBlues4U: calls $0.50
*** TURN *** [Th 6h 9s] [5s]
PlayTheBlues4U: checks
StarsAccount1: bets $1.31 and is all-in
ironons: calls $1.31
PlayTheBlues4U: folds
*** RIVER *** [Th 6h 9s 5s] [2c]
*** SHOW DOWN ***
StarsAccount1: shows [Qh Jh] (high card Queen)
ironons: shows [5h 7h] (a pair of Fives)
ironons collected $4.91 from pot
*** SUMMARY ***
Total pot $5.17 | Rake $0.26
Board [Th 6h 9s 5s 2c]
Seat 2: ironons (button) showed [5h 7h] and won ($4.91) with a pair of Fives
Seat 3: mellneazy (small blind) folded before Flop
Seat 4: Ribeye63 (big blind) folded before Flop
Seat 5: PlayTheBlues4U folded on the Turn
Seat 6: StarsAccount1 showed [Qh Jh] and lost with high card Queen


PokerStars Hand #203998484290:  Hold'em No Limit ($0.05/$0.10 USD) - 2019/09/26 22:23:20 ET
Table 'Delphinus' 6-max Seat #5 is the button
Seat 1: daughterstuitio ($10 in chips)
Seat 2: maxplans323 ($6.75 in chips)
Seat 3: joncruise ($8.66 in chips)
Seat 4: 921zhaopeng ($11.83 in chips)
Seat 5: SuWasup ($9.71 in chips)
Seat 6: PlayTheBlues4U ($11.68 in chips)
PlayTheBlues4U: posts small blind $0.05
daughterstuitio: posts big blind $0.10
*** HOLE CARDS ***
Dealt to PlayTheBlues4U [5c Td]
maxplans323: folds
joncruise: folds
921zhaopeng: folds
SuWasup: raises $0.30 to $0.40
PlayTheBlues4U: folds
daughterstuitio: raises $0.80 to $1.20
SuWasup: folds
Uncalled bet ($0.80) returned to daughterstuitio
daughterstuitio collected $0.85 from pot
daughterstuitio: doesn't show hand
*** SUMMARY ***
Total pot $0.85 | Rake $0
Seat 1: daughterstuitio (big blind) collected ($0.85)
Seat 2: maxplans323 folded before Flop (didn't bet)
Seat 3: joncruise folded before Flop (didn't bet)
Seat 4: 921zhaopeng folded before Flop (didn't bet)
Seat 5: SuWasup (button) folded before Flop
Seat 6: PlayTheBlues4U (small blind) folded before Flop


PokerStars Hand #203998484182:  Hold'em No Limit ($0.05/$0.10 USD) - 2019/09/26 22:22:47 ET
Table 'Delphinus' 6-max Seat #4 is the button
Seat 2: maxplans323 ($6.75 in chips)
Seat 3: joncruise ($7.62 in chips)
Seat 4: 921zhaopeng ($12.83 in chips)
Seat 5: SuWasup ($9.76 in chips)
Seat 6: PlayTheBlues4U ($11.78 in chips)
SuWasup: posts small blind $0.05
PlayTheBlues4U: posts big blind $0.10
daughterstuitio: sits out
*** HOLE CARDS ***
Dealt to PlayTheBlues4U [8c 2d]
maxplans323: folds
joncruise: calls $0.10
921zhaopeng: raises $0.10 to $0.20
SuWasup: folds
PlayTheBlues4U: folds
joncruise: calls $0.10
*** FLOP *** [8s 7c 3h]
joncruise: checks
921zhaopeng: bets $0.30
joncruise: calls $0.30
*** TURN *** [8s 7c 3h] [4c]
joncruise: checks
921zhaopeng: bets $0.50
joncruise: calls $0.50
*** RIVER *** [8s 7c 3h 4c] [6d]
joncruise: checks
921zhaopeng: checks
*** SHOW DOWN ***
joncruise: shows [9c Th] (a straight, Six to Ten)
921zhaopeng: mucks hand
joncruise collected $2.04 from pot
*** SUMMARY ***
Total pot $2.15 | Rake $0.11
Board [8s 7c 3h 4c 6d]
Seat 2: maxplans323 folded before Flop (didn't bet)
Seat 3: joncruise showed [9c Th] and won ($2.04) with a straight, Six to Ten
Seat 4: 921zhaopeng (button) mucked [8h Jd]
Seat 5: SuWasup (small blind) folded before Flop
Seat 6: PlayTheBlues4U (big blind) folded before Flop


PokerStars Hand #203998484040:  Hold'em No Limit ($0.05/$0.10 USD) - 2019/09/26 22:22:04 ET
Table 'Lynx' 6-max Seat #6 is the button
Seat 1: DaGoodz33 ($12.24 in chips)
Seat 2: ironons ($5.76 in chips)
Seat 3: mellneazy ($14.32 in chips)
Seat 4: Ribeye63 ($9.50 in chips)
Seat 5: PlayTheBlues4U ($11.78 in chips)
Seat 6: StarsAccount1 ($2.41 in chips)
DaGoodz33: posts small blind $0.05
ironons: posts big blind $0.10
*** HOLE CARDS ***
Dealt to PlayTheBlues4U [Jh Td]
mellneazy: raises $0.20 to $0.30
Ribeye63: folds
PlayTheBlues4U: calls $0.30
StarsAccount1: calls $0.30
DaGoodz33: calls $0.25
ironons: calls $0.20
*** FLOP *** [Jc 2c 5d]
DaGoodz33: checks
ironons: checks
mellneazy: checks
PlayTheBlues4U: bets $0.90
StarsAccount1: folds
DaGoodz33: folds
DaGoodz33 leaves the table
ironons: folds
mellneazy: raises $1.60 to $2.50
PlayTheBlues4U: calls $1.60
*** TURN *** [Jc 2c 5d] [Ad]
mellneazy: bets $2
PlayTheBlues4U: folds
Uncalled bet ($2) returned to mellneazy
mellneazy collected $6.18 from pot
mellneazy: doesn't show hand
*** SUMMARY ***
Total pot $6.50 | Rake $0.32
Board [Jc 2c 5d Ad]
Seat 1: DaGoodz33 (small blind) folded on the Flop
Seat 2: ironons (big blind) folded on the Flop
Seat 3: mellneazy collected ($6.18)
Seat 4: Ribeye63 folded before Flop (didn't bet)
Seat 5: PlayTheBlues4U folded on the Turn
Seat 6: StarsAccount1 (button) folded on the Flop


PokerStars Hand #203998484024:  Hold'em No Limit ($0.05/$0.10 USD) - 2019/09/26 22:21:59 ET
Table 'Delphinus' 6-max Seat #3 is the button
Seat 2: maxplans323 ($7.05 in chips)
Seat 3: joncruise ($7.62 in chips)
Seat 4: 921zhaopeng ($12.88 in chips)
Seat 5: SuWasup ($9.86 in chips)
Seat 6: PlayTheBlues4U ($11.37 in chips)
921zhaopeng: posts small blind $0.05
SuWasup: posts big blind $0.10
daughterstuitio: sits out
*** HOLE CARDS ***
Dealt to PlayTheBlues4U [7h 7s]
PlayTheBlues4U: calls $0.10
maxplans323: raises $0.20 to $0.30
joncruise: folds
921zhaopeng: folds
SuWasup: folds
PlayTheBlues4U: calls $0.20
*** FLOP *** [Jc 5s 2c]
PlayTheBlues4U: checks
maxplans323: checks
*** TURN *** [Jc 5s 2c] [Tc]
PlayTheBlues4U: checks
maxplans323: checks
*** RIVER *** [Jc 5s 2c Tc] [Kd]
PlayTheBlues4U: bets $0.40
maxplans323: folds
Uncalled bet ($0.40) returned to PlayTheBlues4U
PlayTheBlues4U collected $0.71 from pot
PlayTheBlues4U: doesn't show hand
*** SUMMARY ***
Total pot $0.75 | Rake $0.04
Board [Jc 5s 2c Tc Kd]
Seat 2: maxplans323 folded on the River
Seat 3: joncruise (button) folded before Flop (didn't bet)
Seat 4: 921zhaopeng (small blind) folded before Flop
Seat 5: SuWasup (big blind) folded before Flop
Seat 6: PlayTheBlues4U collected ($0.71)


PokerStars Hand #203998483883:  Hold'em No Limit ($0.05/$0.10 USD) - 2019/09/26 22:21:19 ET
Table 'Delphinus' 6-max Seat #2 is the button
Seat 2: maxplans323 ($7.35 in chips)
Seat 3: joncruise ($7.92 in chips)
Seat 4: 921zhaopeng ($12.98 in chips)
Seat 5: SuWasup ($9.21 in chips)
Seat 6: PlayTheBlues4U ($11.37 in chips)
joncruise: posts small blind $0.05
921zhaopeng: posts big blind $0.10
daughterstuitio: sits out
*** HOLE CARDS ***
Dealt to PlayTheBlues4U [3h 9d]
SuWasup: raises $0.20 to $0.30
PlayTheBlues4U: folds
maxplans323: calls $0.30
joncruise: calls $0.25
921zhaopeng: folds
*** FLOP *** [5d Qd 6s]
joncruise: checks
SuWasup: bets $0.40
maxplans323: folds
joncruise: folds
Uncalled bet ($0.40) returned to SuWasup
SuWasup collected $0.95 from pot
SuWasup: doesn't show hand
*** SUMMARY ***
Total pot $1 | Rake $0.05
Board [5d Qd 6s]
Seat 2: maxplans323 (button) folded on the Flop
Seat 3: joncruise (small blind) folded on the Flop
Seat 4: 921zhaopeng (big blind) folded before Flop
Seat 5: SuWasup collected ($0.95)
Seat 6: PlayTheBlues4U folded before Flop (didn't bet)


PokerStars Hand #203998483750:  Hold'em No Limit ($0.05/$0.10 USD) - 2019/09/26 22:20:32 ET
Table 'Lynx' 6-max Seat #5 is the button
Seat 1: DaGoodz33 ($14.34 in chips)
Seat 2: ironons ($5.76 in chips)
Seat 3: mellneazy ($16.42 in chips)
Seat 4: Ribeye63 ($9.50 in chips)
Seat 5: PlayTheBlues4U ($7.85 in chips)
Seat 6: StarsAccount1 ($2.46 in chips)
StarsAccount1: posts small blind $0.05
DaGoodz33: posts big blind $0.10
*** HOLE CARDS ***
Dealt to PlayTheBlues4U [Tc Td]
ironons: folds
mellneazy: raises $0.20 to $0.30
Ribeye63: folds
PlayTheBlues4U: raises $0.50 to $0.80
StarsAccount1: folds
DaGoodz33: calls $0.70
mellneazy: calls $0.50
*** FLOP *** [9c 4s Kh]
DaGoodz33: checks
mellneazy: checks
PlayTheBlues4U: bets $1.30
DaGoodz33: calls $1.30
mellneazy: calls $1.30
*** TURN *** [9c 4s Kh] [Jh]
DaGoodz33: checks
mellneazy: checks
PlayTheBlues4U: checks
*** RIVER *** [9c 4s Kh Jh] [Jc]
DaGoodz33: checks
mellneazy: checks
PlayTheBlues4U: checks
*** SHOW DOWN ***
DaGoodz33: shows [9h 8h] (two pair, Jacks and Nines)
mellneazy: shows [9s 8c] (two pair, Jacks and Nines)
PlayTheBlues4U: shows [Tc Td] (two pair, Jacks and Tens)
PlayTheBlues4U collected $6.03 from pot
*** SUMMARY ***
Total pot $6.35 | Rake $0.32
Board [9c 4s Kh Jh Jc]
Seat 1: DaGoodz33 (big blind) showed [9h 8h] and lost with two pair, Jacks and Nines
Seat 2: ironons folded before Flop (didn't bet)
Seat 3: mellneazy showed [9s 8c] and lost with two pair, Jacks and Nines
Seat 4: Ribeye63 folded before Flop (didn't bet)
Seat 5: PlayTheBlues4U (button) showed [Tc Td] and won ($6.03) with two pair, Jacks and Tens
Seat 6: StarsAccount1 (small blind) folded before Flop


PokerStars Hand #203998483724:  Hold'em No Limit ($0.05/$0.10 USD) - 2019/09/26 22:20:25 ET
Table 'Delphinus' 6-max Seat #6 is the button
Seat 2: maxplans323 ($7.40 in chips)
Seat 3: joncruise ($8.02 in chips)
Seat 4: 921zhaopeng ($12.98 in chips)
Seat 5: SuWasup ($9.51 in chips)
Seat 6: PlayTheBlues4U ($10.96 in chips)
daughterstuitio will be allowed to play after the button
maxplans323: posts small blind $0.05
joncruise: posts big blind $0.10
*** HOLE CARDS ***
Dealt to PlayTheBlues4U [8s 8c]
921zhaopeng: folds
SuWasup: raises $0.20 to $0.30
PlayTheBlues4U: calls $0.30
maxplans323: folds
joncruise: folds
*** FLOP *** [As 9c Ks]
SuWasup: checks
PlayTheBlues4U: checks
*** TURN *** [As 9c Ks] [2s]
SuWasup: checks
PlayTheBlues4U: checks
*** RIVER *** [As 9c Ks 2s] [Ts]
SuWasup: checks
PlayTheBlues4U: checks
*** SHOW DOWN ***
SuWasup: shows [Ad Td] (two pair, Aces and Tens)
PlayTheBlues4U: shows [8s 8c] (a flush, Ace high)
PlayTheBlues4U collected $0.71 from pot
*** SUMMARY ***
Total pot $0.75 | Rake $0.04
Board [As 9c Ks 2s Ts]
Seat 2: maxplans323 (small blind) folded before Flop
Seat 3: joncruise (big blind) folded before Flop
Seat 4: 921zhaopeng folded before Flop (didn't bet)
Seat 5: SuWasup showed [Ad Td] and lost with two pair, Aces and Tens
Seat 6: PlayTheBlues4U (button) showed [8s 8c] and won ($0.71) with a flush, Ace high


PokerStars Hand #203995379849:  Hold'em No Limit ($0.05/$0.10 USD) - 2019/09/26 22:19:30 ET
Table 'Delphinus' 6-max Seat #5 is the button
Seat 2: maxplans323 ($7.50 in chips)
Seat 3: joncruise ($8.02 in chips)
Seat 4: 921zhaopeng ($15.08 in chips)
Seat 5: SuWasup ($7.48 in chips)
Seat 6: PlayTheBlues4U ($11.01 in chips)
PlayTheBlues4U: posts small blind $0.05
maxplans323: posts big blind $0.10
*** HOLE CARDS ***
Dealt to PlayTheBlues4U [4h Ts]
joncruise: folds
921zhaopeng: raises $0.20 to $0.30
SuWasup: raises $0.60 to $0.90
PlayTheBlues4U: folds
maxplans323: folds
921zhaopeng: calls $0.60
*** FLOP *** [8s 6d Ac]
921zhaopeng: bets $0.10
SuWasup: calls $0.10
*** TURN *** [8s 6d Ac] [Qs]
daughterstuitio joins the table at seat #1
921zhaopeng: bets $0.10
SuWasup: calls $0.10
*** RIVER *** [8s 6d Ac Qs] [9c]
921zhaopeng: bets $0.10
SuWasup: raises $0.90 to $1
921zhaopeng: calls $0.90
*** SHOW DOWN ***
SuWasup: shows [As Jh] (a pair of Aces)
921zhaopeng: mucks hand
SuWasup collected $4.13 from pot
*** SUMMARY ***
Total pot $4.35 | Rake $0.22
Board [8s 6d Ac Qs 9c]
Seat 2: maxplans323 (big blind) folded before Flop
Seat 3: joncruise folded before Flop (didn't bet)
Seat 4: 921zhaopeng mucked [Qd Tc]
Seat 5: SuWasup (button) showed [As Jh] and won ($4.13) with a pair of Aces
Seat 6: PlayTheBlues4U (small blind) folded before Flop


PokerStars Hand #203995379825:  Hold'em No Limit ($0.05/$0.10 USD) - 2019/09/26 22:19:24 ET
Table 'Lynx' 6-max Seat #4 is the button
Seat 1: DaGoodz33 ($15.24 in chips)
Seat 2: ironons ($6.06 in chips)
Seat 3: mellneazy ($14.38 in chips)
Seat 4: Ribeye63 ($9.50 in chips)
Seat 5: PlayTheBlues4U ($7.95 in chips)
Seat 6: StarsAccount1 ($3.36 in chips)
PlayTheBlues4U: posts small blind $0.05
StarsAccount1: posts big blind $0.10
*** HOLE CARDS ***
Dealt to PlayTheBlues4U [6c 7d]
DaGoodz33: calls $0.10
ironons: calls $0.10
mellneazy: calls $0.10
Ribeye63: folds
PlayTheBlues4U: calls $0.05
StarsAccount1: raises $0.20 to $0.30
DaGoodz33: calls $0.20
ironons: calls $0.20
mellneazy: calls $0.20
PlayTheBlues4U: folds
*** FLOP *** [Kd Js 4h]
StarsAccount1: checks
DaGoodz33: checks
ironons: checks
mellneazy: bets $0.60
StarsAccount1: calls $0.60
DaGoodz33: calls $0.60
ironons: folds
*** TURN *** [Kd Js 4h] [Ks]
StarsAccount1: checks
DaGoodz33: checks
mellneazy: checks
*** RIVER *** [Kd Js 4h Ks] [4s]
StarsAccount1: checks
DaGoodz33: checks
mellneazy: checks
*** SHOW DOWN ***
StarsAccount1: shows [As Ad] (two pair, Aces and Kings)
DaGoodz33: mucks hand
mellneazy: shows [Qh 4c] (a full house, Fours full of Kings)
mellneazy collected $2.94 from pot
*** SUMMARY ***
Total pot $3.10 | Rake $0.16
Board [Kd Js 4h Ks 4s]
Seat 1: DaGoodz33 mucked [Th Qc]
Seat 2: ironons folded on the Flop
Seat 3: mellneazy showed [Qh 4c] and won ($2.94) with a full house, Fours full of Kings
Seat 4: Ribeye63 (button) folded before Flop (didn't bet)
Seat 5: PlayTheBlues4U (small blind) folded before Flop
Seat 6: StarsAccount1 (big blind) showed [As Ad] and lost with two pair, Aces and Kings


PokerStars Hand #203995379728:  Hold'em No Limit ($0.05/$0.10 USD) - 2019/09/26 22:18:50 ET
Table 'Lynx' 6-max Seat #3 is the button
Seat 1: DaGoodz33 ($15.24 in chips)
Seat 2: ironons ($7.01 in chips)
Seat 3: mellneazy ($13.38 in chips)
Seat 4: Ribeye63 ($9.55 in chips)
Seat 5: PlayTheBlues4U ($8.05 in chips)
Seat 6: StarsAccount1 ($3.36 in chips)
Ribeye63: posts small blind $0.05
PlayTheBlues4U: posts big blind $0.10
*** HOLE CARDS ***
Dealt to PlayTheBlues4U [9d 3h]
StarsAccount1: folds
DaGoodz33: folds
ironons: calls $0.10
mellneazy: raises $0.35 to $0.45
Ribeye63: folds
PlayTheBlues4U: folds
ironons: calls $0.35
*** FLOP *** [6h Kd 7s]
ironons: checks
mellneazy: bets $0.50
ironons: calls $0.50
*** TURN *** [6h Kd 7s] [8c]
ironons: checks
mellneazy: checks
*** RIVER *** [6h Kd 7s 8c] [Ks]
ironons: checks
mellneazy: checks
*** SHOW DOWN ***
ironons: shows [3s 6s] (two pair, Kings and Sixes)
mellneazy: shows [7d Ac] (two pair, Kings and Sevens)
mellneazy collected $1.95 from pot
*** SUMMARY ***
Total pot $2.05 | Rake $0.10
Board [6h Kd 7s 8c Ks]
Seat 1: DaGoodz33 folded before Flop (didn't bet)
Seat 2: ironons showed [3s 6s] and lost with two pair, Kings and Sixes
Seat 3: mellneazy (button) showed [7d Ac] and won ($1.95) with two pair, Kings and Sevens
Seat 4: Ribeye63 (small blind) folded before Flop
Seat 5: PlayTheBlues4U (big blind) folded before Flop
Seat 6: StarsAccount1 folded before Flop (didn't bet)


PokerStars Hand #203995379643:  Hold'em No Limit ($0.05/$0.10 USD) - 2019/09/26 22:18:22 ET
Table 'Delphinus' 6-max Seat #4 is the button
Seat 1: SourShoes9 ($20.05 in chips)
Seat 2: maxplans323 ($8.25 in chips)
Seat 3: joncruise ($8.02 in chips)
Seat 4: 921zhaopeng ($15.08 in chips)
Seat 5: SuWasup ($7.53 in chips)
Seat 6: PlayTheBlues4U ($10 in chips)
SuWasup: posts small blind $0.05
PlayTheBlues4U: posts big blind $0.10
*** HOLE CARDS ***
Dealt to PlayTheBlues4U [Js Ah]
SourShoes9: calls $0.10
joncruise said, "hahaha sweating that out"
maxplans323: raises $0.20 to $0.30
joncruise: folds
921zhaopeng: folds
SuWasup: folds
PlayTheBlues4U: calls $0.20
SourShoes9: calls $0.20
*** FLOP *** [Qc 2h 3d]
joncruise said, "never easy ever"
PlayTheBlues4U: checks
SourShoes9: checks
maxplans323: bets $0.45
PlayTheBlues4U: calls $0.45
SourShoes9: folds
*** TURN *** [Qc 2h 3d] [Ad]
SourShoes9 leaves the table
PlayTheBlues4U: checks
maxplans323: checks
*** RIVER *** [Qc 2h 3d Ad] [2s]
PlayTheBlues4U: checks
maxplans323: checks
*** SHOW DOWN ***
PlayTheBlues4U: shows [Js Ah] (two pair, Aces and Deuces)
maxplans323: mucks hand
PlayTheBlues4U collected $1.76 from pot
*** SUMMARY ***
Total pot $1.85 | Rake $0.09
Board [Qc 2h 3d Ad 2s]
Seat 1: SourShoes9 folded on the Flop
Seat 2: maxplans323 mucked [9d 9h]
Seat 3: joncruise folded before Flop (didn't bet)
Seat 4: 921zhaopeng (button) folded before Flop (didn't bet)
Seat 5: SuWasup (small blind) folded before Flop
Seat 6: PlayTheBlues4U (big blind) showed [Js Ah] and won ($1.76) with two pair, Aces and Deuces


PokerStars Hand #203995379631:  Hold'em No Limit ($0.05/$0.10 USD) - 2019/09/26 22:18:17 ET
Table 'Lynx' 6-max Seat #2 is the button
Seat 1: DaGoodz33 ($15.24 in chips)
Seat 2: ironons ($8.27 in chips)
Seat 3: mellneazy ($12.15 in chips)
Seat 4: Ribeye63 ($9.65 in chips)
Seat 5: PlayTheBlues4U ($8.05 in chips)
Seat 6: StarsAccount1 ($3.36 in chips)
mellneazy: posts small blind $0.05
Ribeye63: posts big blind $0.10
*** HOLE CARDS ***
Dealt to PlayTheBlues4U [6d 4h]
PlayTheBlues4U: folds
StarsAccount1: folds
DaGoodz33: folds
ironons: calls $0.10
mellneazy: raises $0.30 to $0.40
Ribeye63: folds
ironons: calls $0.30
*** FLOP *** [8c 5c 4c]
mellneazy: checks
ironons: bets $0.86
mellneazy: calls $0.86
*** TURN *** [8c 5c 4c] [8h]
mellneazy: checks
ironons: checks
*** RIVER *** [8c 5c 4c 8h] [7h]
mellneazy: checks
ironons: checks
*** SHOW DOWN ***
mellneazy: shows [Qh 8s] (three of a kind, Eights)
ironons: mucks hand
mellneazy collected $2.49 from pot
*** SUMMARY ***
Total pot $2.62 | Rake $0.13
Board [8c 5c 4c 8h 7h]
Seat 1: DaGoodz33 folded before Flop (didn't bet)
Seat 2: ironons (button) mucked [5d Kc]
Seat 3: mellneazy (small blind) showed [Qh 8s] and won ($2.49) with three of a kind, Eights
Seat 4: Ribeye63 (big blind) folded before Flop
Seat 5: PlayTheBlues4U folded before Flop (didn't bet)
Seat 6: StarsAccount1 folded before Flop (didn't bet)


PokerStars Hand #203995379471:  Hold'em No Limit ($0.05/$0.10 USD) - 2019/09/26 22:17:24 ET
Table 'Lynx' 6-max Seat #1 is the button
Seat 1: DaGoodz33 ($15.24 in chips)
Seat 2: ironons ($9.54 in chips)
Seat 3: mellneazy ($10.44 in chips)
Seat 4: Ribeye63 ($9.65 in chips)
Seat 5: PlayTheBlues4U ($8.35 in chips)
Seat 6: StarsAccount1 ($3.66 in chips)
ironons: posts small blind $0.05
mellneazy: posts big blind $0.10
*** HOLE CARDS ***
Dealt to PlayTheBlues4U [4s As]
Ribeye63: folds
PlayTheBlues4U: raises $0.20 to $0.30
StarsAccount1: calls $0.30
DaGoodz33: folds
ironons: calls $0.25
mellneazy: calls $0.20
*** FLOP *** [Ts 6h 4h]
ironons: checks
mellneazy: checks
PlayTheBlues4U: checks
StarsAccount1: checks
*** TURN *** [Ts 6h 4h] [5d]
ironons: bets $0.57
mellneazy: calls $0.57
PlayTheBlues4U: folds
StarsAccount1: folds
*** RIVER *** [Ts 6h 4h 5d] [9h]
ironons: bets $0.40
mellneazy: calls $0.40
*** SHOW DOWN ***
ironons: shows [6s 7c] (a pair of Sixes)
mellneazy: shows [8s Td] (a pair of Tens)
mellneazy collected $2.98 from pot
*** SUMMARY ***
Total pot $3.14 | Rake $0.16
Board [Ts 6h 4h 5d 9h]
Seat 1: DaGoodz33 (button) folded before Flop (didn't bet)
Seat 2: ironons (small blind) showed [6s 7c] and lost with a pair of Sixes
Seat 3: mellneazy (big blind) showed [8s Td] and won ($2.98) with a pair of Tens
Seat 4: Ribeye63 folded before Flop (didn't bet)
Seat 5: PlayTheBlues4U folded on the Turn
Seat 6: StarsAccount1 folded on the Turn


PokerStars Hand #203995379385:  Hold'em No Limit ($0.05/$0.10 USD) - 2019/09/26 22:16:55 ET
Table 'Lynx' 6-max Seat #6 is the button
Seat 1: DaGoodz33 ($15.29 in chips)
Seat 2: ironons ($9.22 in chips)
Seat 3: mellneazy ($10.44 in chips)
Seat 4: Ribeye63 ($9.65 in chips)
Seat 5: PlayTheBlues4U ($8.65 in chips)
Seat 6: StarsAccount1 ($3.66 in chips)
DaGoodz33: posts small blind $0.05
ironons: posts big blind $0.10
*** HOLE CARDS ***
Dealt to PlayTheBlues4U [7h 6h]
mellneazy: folds
Ribeye63: folds
PlayTheBlues4U: raises $0.20 to $0.30
StarsAccount1: folds
DaGoodz33: folds
ironons: calls $0.20
*** FLOP *** [Ts 9d 4s]
ironons: checks
PlayTheBlues4U: checks
*** TURN *** [Ts 9d 4s] [Td]
ironons: bets $0.31
PlayTheBlues4U: folds
Uncalled bet ($0.31) returned to ironons
ironons collected $0.62 from pot
ironons: doesn't show hand
*** SUMMARY ***
Total pot $0.65 | Rake $0.03
Board [Ts 9d 4s Td]
Seat 1: DaGoodz33 (small blind) folded before Flop
Seat 2: ironons (big blind) collected ($0.62)
Seat 3: mellneazy folded before Flop (didn't bet)
Seat 4: Ribeye63 folded before Flop (didn't bet)
Seat 5: PlayTheBlues4U folded on the Turn
Seat 6: StarsAccount1 (button) folded before Flop (didn't bet)


PokerStars Hand #203995379325:  Hold'em No Limit ($0.05/$0.10 USD) - 2019/09/26 22:16:32 ET
Table 'Delphinus' 6-max Seat #2 is the button
Seat 1: SourShoes9 ($10.69 in chips)
Seat 2: maxplans323 ($8.75 in chips)
Seat 3: joncruise ($8.07 in chips)
Seat 4: 921zhaopeng ($14.64 in chips)
Seat 5: SuWasup ($7.63 in chips)
Seat 6: PlayTheBlues4U ($10.24 in chips)
joncruise: posts small blind $0.05
921zhaopeng: posts big blind $0.10
*** HOLE CARDS ***
Dealt to PlayTheBlues4U [Qc Kc]
SuWasup: folds
PlayTheBlues4U: raises $0.20 to $0.30
SourShoes9: raises $0.85 to $1.15
maxplans323: folds
joncruise: folds
921zhaopeng: folds
PlayTheBlues4U: calls $0.85
*** FLOP *** [Jh 4c 7c]
PlayTheBlues4U: checks
SourShoes9: bets $2.20
PlayTheBlues4U: raises $3.60 to $5.80
SourShoes9: raises $3.74 to $9.54 and is all-in
PlayTheBlues4U: calls $3.29 and is all-in
Uncalled bet ($0.45) returned to SourShoes9
*** TURN *** [Jh 4c 7c] [Js]
*** RIVER *** [Jh 4c 7c Js] [4h]
*** SHOW DOWN ***
PlayTheBlues4U: shows [Qc Kc] (two pair, Jacks and Fours)
SourShoes9: shows [Kd Kh] (two pair, Kings and Jacks)
SourShoes9 collected $19.60 from pot
*** SUMMARY ***
Total pot $20.63 | Rake $1.03
Board [Jh 4c 7c Js 4h]
Seat 1: SourShoes9 showed [Kd Kh] and won ($19.60) with two pair, Kings and Jacks
Seat 2: maxplans323 (button) folded before Flop (didn't bet)
Seat 3: joncruise (small blind) folded before Flop
Seat 4: 921zhaopeng (big blind) folded before Flop
Seat 5: SuWasup folded before Flop (didn't bet)
Seat 6: PlayTheBlues4U showed [Qc Kc] and lost with two pair, Jacks and Fours


PokerStars Hand #203995379236:  Hold'em No Limit ($0.05/$0.10 USD) - 2019/09/26 22:15:58 ET
Table 'Lynx' 6-max Seat #5 is the button
Seat 1: DaGoodz33 ($15.39 in chips)
Seat 2: ironons ($9.22 in chips)
Seat 3: mellneazy ($8.86 in chips)
Seat 4: Ribeye63 ($9.65 in chips)
Seat 5: PlayTheBlues4U ($10.25 in chips)
Seat 6: StarsAccount1 ($3.71 in chips)
StarsAccount1: posts small blind $0.05
DaGoodz33: posts big blind $0.10
*** HOLE CARDS ***
Dealt to PlayTheBlues4U [8h Ts]
ironons: folds
mellneazy: raises $0.20 to $0.30
Ribeye63: folds
PlayTheBlues4U: calls $0.30
StarsAccount1: folds
DaGoodz33: folds
*** FLOP *** [Qs Qd 2d]
mellneazy: bets $0.40
PlayTheBlues4U: calls $0.40
*** TURN *** [Qs Qd 2d] [Ah]
mellneazy: checks
PlayTheBlues4U: bets $0.90
mellneazy: calls $0.90
*** RIVER *** [Qs Qd 2d Ah] [4s]
mellneazy: checks
PlayTheBlues4U: checks
*** SHOW DOWN ***
mellneazy: shows [Qh Kc] (three of a kind, Queens)
PlayTheBlues4U: mucks hand
mellneazy collected $3.18 from pot
*** SUMMARY ***
Total pot $3.35 | Rake $0.17
Board [Qs Qd 2d Ah 4s]
Seat 1: DaGoodz33 (big blind) folded before Flop
Seat 2: ironons folded before Flop (didn't bet)
Seat 3: mellneazy showed [Qh Kc] and won ($3.18) with three of a kind, Queens
Seat 4: Ribeye63 folded before Flop (didn't bet)
Seat 5: PlayTheBlues4U (button) mucked [8h Ts]
Seat 6: StarsAccount1 (small blind) folded before Flop


PokerStars Hand #203995379144:  Hold'em No Limit ($0.05/$0.10 USD) - 2019/09/26 22:15:27 ET
Table 'Delphinus' 6-max Seat #1 is the button
Seat 1: SourShoes9 ($10.69 in chips)
Seat 2: maxplans323 ($8.80 in chips)
Seat 3: joncruise ($8.17 in chips)
Seat 4: 921zhaopeng ($13.33 in chips)
Seat 5: SuWasup ($8.93 in chips)
Seat 6: PlayTheBlues4U ($10.24 in chips)
maxplans323: posts small blind $0.05
joncruise: posts big blind $0.10
*** HOLE CARDS ***
Dealt to PlayTheBlues4U [9s 6c]
921zhaopeng: calls $0.10
SuWasup: raises $0.30 to $0.40
PlayTheBlues4U: folds
SourShoes9: folds
maxplans323: folds
joncruise: folds
921zhaopeng: calls $0.30
*** FLOP *** [Kd 7d Jh]
921zhaopeng: bets $0.90
SuWasup: calls $0.90
*** TURN *** [Kd 7d Jh] [2s]
921zhaopeng: bets $1.30
SuWasup: folds
Uncalled bet ($1.30) returned to 921zhaopeng
921zhaopeng collected $2.61 from pot
921zhaopeng: doesn't show hand
*** SUMMARY ***
Total pot $2.75 | Rake $0.14
Board [Kd 7d Jh 2s]
Seat 1: SourShoes9 (button) folded before Flop (didn't bet)
Seat 2: maxplans323 (small blind) folded before Flop
Seat 3: joncruise (big blind) folded before Flop
Seat 4: 921zhaopeng collected ($2.61)
Seat 5: SuWasup folded on the Turn
Seat 6: PlayTheBlues4U folded before Flop (didn't bet)


PokerStars Hand #203995379107:  Hold'em No Limit ($0.05/$0.10 USD) - 2019/09/26 22:15:13 ET
Table 'Lynx' 6-max Seat #4 is the button
Seat 1: DaGoodz33 ($14.59 in chips)
Seat 2: ironons ($9.32 in chips)
Seat 3: mellneazy ($9.41 in chips)
Seat 4: Ribeye63 ($9.65 in chips)
Seat 5: PlayTheBlues4U ($10.30 in chips)
Seat 6: StarsAccount1 ($3.81 in chips)
PlayTheBlues4U: posts small blind $0.05
StarsAccount1: posts big blind $0.10
*** HOLE CARDS ***
Dealt to PlayTheBlues4U [3d 5d]
DaGoodz33: calls $0.10
ironons: calls $0.10
mellneazy: raises $0.45 to $0.55
Ribeye63: folds
PlayTheBlues4U: folds
StarsAccount1: folds
DaGoodz33: raises $2.10 to $2.65
ironons: folds
mellneazy: folds
Uncalled bet ($2.10) returned to DaGoodz33
DaGoodz33 collected $1.35 from pot
DaGoodz33: doesn't show hand
*** SUMMARY ***
Total pot $1.35 | Rake $0
Seat 1: DaGoodz33 collected ($1.35)
Seat 2: ironons folded before Flop
Seat 3: mellneazy folded before Flop
Seat 4: Ribeye63 (button) folded before Flop (didn't bet)
Seat 5: PlayTheBlues4U (small blind) folded before Flop
Seat 6: StarsAccount1 (big blind) folded before Flop


PokerStars Hand #203995378997:  Hold'em No Limit ($0.05/$0.10 USD) - 2019/09/26 22:14:40 ET
Table 'Lynx' 6-max Seat #3 is the button
Seat 1: DaGoodz33 ($14.59 in chips)
Seat 2: ironons ($8.91 in chips)
Seat 3: mellneazy ($9.41 in chips)
Seat 4: Ribeye63 ($9.70 in chips)
Seat 5: PlayTheBlues4U ($10.40 in chips)
Seat 6: StarsAccount1 ($4.11 in chips)
Ribeye63: posts small blind $0.05
PlayTheBlues4U: posts big blind $0.10
*** HOLE CARDS ***
Dealt to PlayTheBlues4U [7c Kh]
StarsAccount1: calls $0.10
DaGoodz33: folds
ironons: raises $0.20 to $0.30
mellneazy: folds
Ribeye63: folds
PlayTheBlues4U: folds
StarsAccount1: calls $0.20
*** FLOP *** [3s 8s 8d]
StarsAccount1: checks
ironons: bets $0.36
StarsAccount1: folds
Uncalled bet ($0.36) returned to ironons
ironons collected $0.71 from pot
ironons: doesn't show hand
*** SUMMARY ***
Total pot $0.75 | Rake $0.04
Board [3s 8s 8d]
Seat 1: DaGoodz33 folded before Flop (didn't bet)
Seat 2: ironons collected ($0.71)
Seat 3: mellneazy (button) folded before Flop (didn't bet)
Seat 4: Ribeye63 (small blind) folded before Flop
Seat 5: PlayTheBlues4U (big blind) folded before Flop
Seat 6: StarsAccount1 folded on the Flop


PokerStars Hand #203995378907:  Hold'em No Limit ($0.05/$0.10 USD) - 2019/09/26 22:14:12 ET
Table 'Lynx' 6-max Seat #2 is the button
Seat 1: DaGoodz33 ($14.89 in chips)
Seat 2: ironons ($8.91 in chips)
Seat 3: mellneazy ($9.46 in chips)
Seat 4: Ribeye63 ($10 in chips)
Seat 5: PlayTheBlues4U ($9.80 in chips)
Seat 6: StarsAccount1 ($4.11 in chips)
mellneazy: posts small blind $0.05
Ribeye63: posts big blind $0.10
*** HOLE CARDS ***
Dealt to PlayTheBlues4U [Qd Kh]
PlayTheBlues4U: raises $0.20 to $0.30
StarsAccount1: folds
DaGoodz33: calls $0.30
ironons: folds
mellneazy: folds
Ribeye63: calls $0.20
*** FLOP *** [8s Ks 4s]
Ribeye63: checks
PlayTheBlues4U: bets $0.60
DaGoodz33: folds
Ribeye63: folds
Uncalled bet ($0.60) returned to PlayTheBlues4U
PlayTheBlues4U collected $0.90 from pot
PlayTheBlues4U: doesn't show hand
*** SUMMARY ***
Total pot $0.95 | Rake $0.05
Board [8s Ks 4s]
Seat 1: DaGoodz33 folded on the Flop
Seat 2: ironons (button) folded before Flop (didn't bet)
Seat 3: mellneazy (small blind) folded before Flop
Seat 4: Ribeye63 (big blind) folded on the Flop
Seat 5: PlayTheBlues4U collected ($0.90)
Seat 6: StarsAccount1 folded before Flop (didn't bet)


PokerStars Hand #203995378872:  Hold'em No Limit ($0.05/$0.10 USD) - 2019/09/26 22:14:03 ET
Table 'Delphinus' 6-max Seat #6 is the button
Seat 1: SourShoes9 ($9.95 in chips)
Seat 2: maxplans323 ($8.90 in chips)
Seat 3: joncruise ($8.17 in chips)
Seat 4: 921zhaopeng ($13.83 in chips)
Seat 5: SuWasup ($9.13 in chips)
Seat 6: PlayTheBlues4U ($10.24 in chips)
SourShoes9: posts small blind $0.05
maxplans323: posts big blind $0.10
*** HOLE CARDS ***
Dealt to PlayTheBlues4U [5h 2h]
joncruise: folds
921zhaopeng: raises $0.10 to $0.20
SuWasup: calls $0.20
PlayTheBlues4U: folds
SourShoes9: calls $0.15
maxplans323: folds
*** FLOP *** [7d Qs 8c]
SourShoes9: checks
921zhaopeng: checks
SuWasup: checks
*** TURN *** [7d Qs 8c] [Qd]
SourShoes9: bets $0.30
921zhaopeng: calls $0.30
SuWasup: folds
*** RIVER *** [7d Qs 8c Qd] [7s]
SourShoes9: bets $1.10
921zhaopeng: folds
Uncalled bet ($1.10) returned to SourShoes9
SourShoes9 collected $1.24 from pot
SourShoes9: doesn't show hand
*** SUMMARY ***
Total pot $1.30 | Rake $0.06
Board [7d Qs 8c Qd 7s]
Seat 1: SourShoes9 (small blind) collected ($1.24)
Seat 2: maxplans323 (big blind) folded before Flop
Seat 3: joncruise folded before Flop (didn't bet)
Seat 4: 921zhaopeng folded on the River
Seat 5: SuWasup folded on the Turn
Seat 6: PlayTheBlues4U (button) folded before Flop (didn't bet)


PokerStars Hand #203995378801:  Hold'em No Limit ($0.05/$0.10 USD) - 2019/09/26 22:13:42 ET
Table 'Lynx' 6-max Seat #1 is the button
Seat 1: DaGoodz33 ($14.89 in chips)
Seat 2: ironons ($8.65 in chips)
Seat 3: mellneazy ($9.75 in chips)
Seat 4: LeanLamar2233 ($7.99 in chips)
Seat 5: PlayTheBlues4U ($9.80 in chips)
Seat 6: StarsAccount1 ($4.11 in chips)
ironons: posts small blind $0.05
mellneazy: posts big blind $0.10
*** HOLE CARDS ***
Dealt to PlayTheBlues4U [8h 9d]
LeanLamar2233: folds
PlayTheBlues4U: folds
StarsAccount1: folds
DaGoodz33: folds
ironons: calls $0.05
mellneazy: checks
*** FLOP *** [Jh 4h 6s]
LeanLamar2233 leaves the table
ironons: bets $0.19
mellneazy: calls $0.19
*** TURN *** [Jh 4h 6s] [Qs]
ironons: bets $0.28
Ribeye63 joins the table at seat #4
mellneazy: folds
Uncalled bet ($0.28) returned to ironons
ironons collected $0.55 from pot
ironons: doesn't show hand
*** SUMMARY ***
Total pot $0.58 | Rake $0.03
Board [Jh 4h 6s Qs]
Seat 1: DaGoodz33 (button) folded before Flop (didn't bet)
Seat 2: ironons (small blind) collected ($0.55)
Seat 3: mellneazy (big blind) folded on the Turn
Seat 4: LeanLamar2233 folded before Flop (didn't bet)
Seat 5: PlayTheBlues4U folded before Flop (didn't bet)
Seat 6: StarsAccount1 folded before Flop (didn't bet)


PokerStars Hand #203995378684:  Hold'em No Limit ($0.05/$0.10 USD) - 2019/09/26 22:13:04 ET
Table 'Lynx' 6-max Seat #6 is the button
Seat 1: DaGoodz33 ($14.94 in chips)
Seat 2: ironons ($7.44 in chips)
Seat 3: mellneazy ($9.75 in chips)
Seat 4: LeanLamar2233 ($8.97 in chips)
Seat 5: PlayTheBlues4U ($9.80 in chips)
Seat 6: StarsAccount1 ($4.41 in chips)
DaGoodz33: posts small blind $0.05
ironons: posts big blind $0.10
*** HOLE CARDS ***
Dealt to PlayTheBlues4U [4s Kh]
mellneazy: folds
LeanLamar2233: raises $0.20 to $0.30
PlayTheBlues4U: folds
StarsAccount1: calls $0.30
DaGoodz33: folds
ironons: calls $0.20
*** FLOP *** [9h 8c 5s]
ironons: checks
LeanLamar2233: bets $0.68
StarsAccount1: folds
ironons: calls $0.68
*** TURN *** [9h 8c 5s] [3h]
ironons: checks
LeanLamar2233: checks
*** RIVER *** [9h 8c 5s 3h] [6d]
ironons: bets $1.10
LeanLamar2233: folds
Uncalled bet ($1.10) returned to ironons
ironons collected $2.19 from pot
ironons: doesn't show hand
*** SUMMARY ***
Total pot $2.31 | Rake $0.12
Board [9h 8c 5s 3h 6d]
Seat 1: DaGoodz33 (small blind) folded before Flop
Seat 2: ironons (big blind) collected ($2.19)
Seat 3: mellneazy folded before Flop (didn't bet)
Seat 4: LeanLamar2233 folded on the River
Seat 5: PlayTheBlues4U folded before Flop (didn't bet)
Seat 6: StarsAccount1 (button) folded on the Flop


PokerStars Hand #203995378664:  Hold'em No Limit ($0.05/$0.10 USD) - 2019/09/26 22:12:56 ET
Table 'Delphinus' 6-max Seat #5 is the button
Seat 1: SourShoes9 ($10.55 in chips)
Seat 2: maxplans323 ($8.90 in chips)
Seat 3: joncruise ($8.27 in chips)
Seat 4: 921zhaopeng ($13.83 in chips)
Seat 5: SuWasup ($9.13 in chips)
Seat 6: PlayTheBlues4U ($9.60 in chips)
PlayTheBlues4U: posts small blind $0.05
SourShoes9: posts big blind $0.10
*** HOLE CARDS ***
Dealt to PlayTheBlues4U [7h 7d]
maxplans323: folds
joncruise: calls $0.10
921zhaopeng: folds
SuWasup: folds
PlayTheBlues4U: calls $0.05
SourShoes9: checks
*** FLOP *** [Js 3c Jd]
PlayTheBlues4U: checks
SourShoes9: bets $0.20
joncruise: folds
PlayTheBlues4U: calls $0.20
*** TURN *** [Js 3c Jd] [4c]
PlayTheBlues4U: checks
SourShoes9: bets $0.30
PlayTheBlues4U: calls $0.30
*** RIVER *** [Js 3c Jd 4c] [Kh]
PlayTheBlues4U: bets $0.70
SourShoes9: folds
Uncalled bet ($0.70) returned to PlayTheBlues4U
PlayTheBlues4U collected $1.24 from pot
PlayTheBlues4U: doesn't show hand
*** SUMMARY ***
Total pot $1.30 | Rake $0.06
Board [Js 3c Jd 4c Kh]
Seat 1: SourShoes9 (big blind) folded on the River
Seat 2: maxplans323 folded before Flop (didn't bet)
Seat 3: joncruise folded on the Flop
Seat 4: 921zhaopeng folded before Flop (didn't bet)
Seat 5: SuWasup (button) folded before Flop (didn't bet)
Seat 6: PlayTheBlues4U (small blind) collected ($1.24)


PokerStars Hand #203995378459:  Hold'em No Limit ($0.05/$0.10 USD) - 2019/09/26 22:11:49 ET
Table 'Delphinus' 6-max Seat #4 is the button
Seat 1: SourShoes9 ($10.55 in chips)
Seat 2: maxplans323 ($8.90 in chips)
Seat 3: joncruise ($8.27 in chips)
Seat 4: 921zhaopeng ($15.03 in chips)
Seat 5: SuWasup ($7.95 in chips)
Seat 6: PlayTheBlues4U ($9.70 in chips)
SuWasup: posts small blind $0.05
PlayTheBlues4U: posts big blind $0.10
*** HOLE CARDS ***
Dealt to PlayTheBlues4U [5c 6d]
SourShoes9: folds
maxplans323: folds
joncruise: folds
921zhaopeng: raises $0.20 to $0.30
SourShoes9 said, "knew it"
SuWasup: calls $0.25
SourShoes9 said, "hated thar Q"
PlayTheBlues4U: folds
*** FLOP *** [Ah 4c Td]
SuWasup: checks
921zhaopeng: bets $0.30
joncruise said, "lol tough"
PlayTheBlues4U said, "I had pair too"
SuWasup: calls $0.30
*** TURN *** [Ah 4c Td] [6h]
SuWasup: checks
921zhaopeng: bets $0.60
SuWasup: calls $0.60
*** RIVER *** [Ah 4c Td 6h] [Jd]
SuWasup: checks
921zhaopeng: checks
*** SHOW DOWN ***
SuWasup: shows [Qd Kh] (a straight, Ten to Ace)
921zhaopeng: mucks hand
SuWasup collected $2.38 from pot
*** SUMMARY ***
Total pot $2.50 | Rake $0.12
Board [Ah 4c Td 6h Jd]
Seat 1: SourShoes9 folded before Flop (didn't bet)
Seat 2: maxplans323 folded before Flop (didn't bet)
Seat 3: joncruise folded before Flop (didn't bet)
Seat 4: 921zhaopeng (button) mucked [Kc Ad]
Seat 5: SuWasup (small blind) showed [Qd Kh] and won ($2.38) with a straight, Ten to Ace
Seat 6: PlayTheBlues4U (big blind) folded before Flop


PokerStars Hand #203995378445:  Hold'em No Limit ($0.05/$0.10 USD) - 2019/09/26 22:11:44 ET
Table 'Lynx' 6-max Seat #5 is the button
Seat 1: DaGoodz33 ($12.97 in chips)
Seat 2: ironons ($7.68 in chips)
Seat 3: mellneazy ($9.75 in chips)
Seat 4: LeanLamar2233 ($8.97 in chips)
Seat 5: PlayTheBlues4U ($9.80 in chips)
Seat 6: StarsAccount1 ($6.35 in chips)
StarsAccount1: posts small blind $0.05
DaGoodz33: posts big blind $0.10
*** HOLE CARDS ***
Dealt to PlayTheBlues4U [Ad 2h]
ironons: calls $0.10
mellneazy: folds
LeanLamar2233: folds
PlayTheBlues4U: folds
StarsAccount1: calls $0.05
DaGoodz33: checks
*** FLOP *** [Jd Ac 6s]
StarsAccount1: checks
DaGoodz33: checks
ironons: checks
*** TURN *** [Jd Ac 6s] [3d]
StarsAccount1: bets $0.14
DaGoodz33: calls $0.14
ironons: calls $0.14
*** RIVER *** [Jd Ac 6s 3d] [Qh]
StarsAccount1: bets $0.34
DaGoodz33: raises $1.36 to $1.70
ironons: folds
StarsAccount1: calls $1.36
*** SHOW DOWN ***
DaGoodz33: shows [Kc Ts] (a straight, Ten to Ace)
StarsAccount1: mucks hand
DaGoodz33 collected $3.91 from pot
*** SUMMARY ***
Total pot $4.12 | Rake $0.21
Board [Jd Ac 6s 3d Qh]
Seat 1: DaGoodz33 (big blind) showed [Kc Ts] and won ($3.91) with a straight, Ten to Ace
Seat 2: ironons folded on the River
Seat 3: mellneazy folded before Flop (didn't bet)
Seat 4: LeanLamar2233 folded before Flop (didn't bet)
Seat 5: PlayTheBlues4U (button) folded before Flop (didn't bet)
Seat 6: StarsAccount1 (small blind) mucked [Jh 6h]


PokerStars Hand #203995378285:  Hold'em No Limit ($0.05/$0.10 USD) - 2019/09/26 22:10:47 ET
Table 'Delphinus' 6-max Seat #3 is the button
Seat 1: SourShoes9 ($13.21 in chips)
Seat 2: maxplans323 ($6.08 in chips)
Seat 3: joncruise ($8.27 in chips)
Seat 4: 921zhaopeng ($15.08 in chips)
Seat 5: SuWasup ($8.05 in chips)
Seat 6: PlayTheBlues4U ($10 in chips)
921zhaopeng: posts small blind $0.05
SuWasup: posts big blind $0.10
*** HOLE CARDS ***
Dealt to PlayTheBlues4U [Ah 2h]
PlayTheBlues4U: raises $0.20 to $0.30
SourShoes9: raises $0.75 to $1.05
maxplans323: calls $1.05
joncruise: folds
921zhaopeng: folds
SuWasup: folds
PlayTheBlues4U: folds
*** FLOP *** [3s 4c Ac]
SourShoes9: checks
maxplans323: checks
*** TURN *** [3s 4c Ac] [7s]
SourShoes9: checks
maxplans323: checks
*** RIVER *** [3s 4c Ac 7s] [Qd]
SourShoes9: checks
maxplans323: bets $1.61
SourShoes9: calls $1.61
*** SHOW DOWN ***
maxplans323: shows [Qs Qh] (three of a kind, Queens)
SourShoes9: mucks hand
maxplans323 collected $5.48 from pot
*** SUMMARY ***
Total pot $5.77 | Rake $0.29
Board [3s 4c Ac 7s Qd]
Seat 1: SourShoes9 mucked [Kd Ks]
Seat 2: maxplans323 showed [Qs Qh] and won ($5.48) with three of a kind, Queens
Seat 3: joncruise (button) folded before Flop (didn't bet)
Seat 4: 921zhaopeng (small blind) folded before Flop
Seat 5: SuWasup (big blind) folded before Flop
Seat 6: PlayTheBlues4U folded before Flop


PokerStars Hand #203995378260:  Hold'em No Limit ($0.05/$0.10 USD) - 2019/09/26 22:10:37 ET
Table 'Lynx' 6-max Seat #4 is the button
Seat 1: DaGoodz33 ($12.97 in chips)
Seat 2: ironons ($8.77 in chips)
Seat 3: mellneazy ($9.75 in chips)
Seat 4: LeanLamar2233 ($7.80 in chips)
Seat 5: PlayTheBlues4U ($9.90 in chips)
Seat 6: StarsAccount1 ($6.45 in chips)
PlayTheBlues4U: posts small blind $0.05
StarsAccount1: posts big blind $0.10
*** HOLE CARDS ***
Dealt to PlayTheBlues4U [9d 6d]
DaGoodz33: folds
ironons: calls $0.10
mellneazy: folds
LeanLamar2233: calls $0.10
PlayTheBlues4U: calls $0.05
StarsAccount1: checks
*** FLOP *** [Kc Tc 9s]
PlayTheBlues4U: checks
StarsAccount1: checks
ironons: checks
LeanLamar2233: bets $0.29
PlayTheBlues4U: folds
StarsAccount1: folds
ironons: calls $0.29
*** TURN *** [Kc Tc 9s] [4s]
ironons: checks
LeanLamar2233: bets $0.70
ironons: calls $0.70
*** RIVER *** [Kc Tc 9s 4s] [4d]
ironons: checks
LeanLamar2233: bets $1.13
ironons: folds
Uncalled bet ($1.13) returned to LeanLamar2233
LeanLamar2233 collected $2.26 from pot
*** SUMMARY ***
Total pot $2.38 | Rake $0.12
Board [Kc Tc 9s 4s 4d]
Seat 1: DaGoodz33 folded before Flop (didn't bet)
Seat 2: ironons folded on the River
Seat 3: mellneazy folded before Flop (didn't bet)
Seat 4: LeanLamar2233 (button) collected ($2.26)
Seat 5: PlayTheBlues4U (small blind) folded on the Flop
Seat 6: StarsAccount1 (big blind) folded on the Flop


PokerStars Hand #203995378206:  Hold'em No Limit ($0.05/$0.10 USD) - 2019/09/26 22:10:15 ET
Table 'Lynx' 6-max Seat #3 is the button
Seat 1: DaGoodz33 ($12.97 in chips)
Seat 2: ironons ($8.77 in chips)
Seat 3: mellneazy ($9.75 in chips)
Seat 4: LeanLamar2233 ($7.85 in chips)
Seat 5: PlayTheBlues4U ($10 in chips)
Seat 6: StarsAccount1 ($6.30 in chips)
LeanLamar2233: posts small blind $0.05
PlayTheBlues4U: posts big blind $0.10
*** HOLE CARDS ***
Dealt to PlayTheBlues4U [9s 6s]
StarsAccount1: raises $0.30 to $0.40
DaGoodz33: folds
ironons: folds
mellneazy: folds
LeanLamar2233: folds
PlayTheBlues4U: folds
Uncalled bet ($0.30) returned to StarsAccount1
StarsAccount1 collected $0.25 from pot
StarsAccount1: doesn't show hand
*** SUMMARY ***
Total pot $0.25 | Rake $0
Seat 1: DaGoodz33 folded before Flop (didn't bet)
Seat 2: ironons folded before Flop (didn't bet)
Seat 3: mellneazy (button) folded before Flop (didn't bet)
Seat 4: LeanLamar2233 (small blind) folded before Flop
Seat 5: PlayTheBlues4U (big blind) folded before Flop
Seat 6: StarsAccount1 collected ($0.25)


PokerStars Hand #203995378174:  Hold'em No Limit ($0.05/$0.10 USD) - 2019/09/26 22:10:03 ET
Table 'Delphinus' 6-max Seat #2 is the button
Seat 1: SourShoes9 ($13.21 in chips)
Seat 2: maxplans323 ($6.08 in chips)
Seat 3: joncruise ($9.77 in chips)
Seat 4: 921zhaopeng ($13.73 in chips)
Seat 5: SuWasup ($8.05 in chips)
Seat 6: PlayTheBlues4U ($10 in chips)
joncruise: posts small blind $0.05
921zhaopeng: posts big blind $0.10
*** HOLE CARDS ***
Dealt to PlayTheBlues4U [Ks Th]
SuWasup: folds
PlayTheBlues4U: folds
SourShoes9: folds
maxplans323: folds
joncruise: calls $0.05
921zhaopeng: checks
*** FLOP *** [4c 6c Tc]
joncruise: checks
921zhaopeng: bets $0.20
joncruise: calls $0.20
*** TURN *** [4c 6c Tc] [6d]
joncruise: checks
921zhaopeng: checks
*** RIVER *** [4c 6c Tc 6d] [4s]
joncruise: bets $0.60
921zhaopeng: raises $0.60 to $1.20
joncruise: calls $0.60
*** SHOW DOWN ***
921zhaopeng: shows [2h 4d] (a full house, Fours full of Sixes)
joncruise: mucks hand
921zhaopeng collected $2.85 from pot
*** SUMMARY ***
Total pot $3 | Rake $0.15
Board [4c 6c Tc 6d 4s]
Seat 1: SourShoes9 folded before Flop (didn't bet)
Seat 2: maxplans323 (button) folded before Flop (didn't bet)
Seat 3: joncruise (small blind) mucked [5c 5h]
Seat 4: 921zhaopeng (big blind) showed [2h 4d] and won ($2.85) with a full house, Fours full of Sixes
Seat 5: SuWasup folded before Flop (didn't bet)
Seat 6: PlayTheBlues4U folded before Flop (didn't bet)


PokerStars Hand #203995377992:  Hold'em No Limit ($0.05/$0.10 USD) - 2019/09/26 22:08:57 ET
Table 'Delphinus' 6-max Seat #1 is the button
Seat 1: SourShoes9 ($13.21 in chips)
Seat 2: maxplans323 ($6.13 in chips)
Seat 3: joncruise ($9.87 in chips)
Seat 4: 921zhaopeng ($12.78 in chips)
Seat 5: SuWasup ($8.95 in chips)
Seat 6: PlayTheBlues4U ($7.12 in chips)
maxplans323: posts small blind $0.05
joncruise: posts big blind $0.10
*** HOLE CARDS ***
Dealt to PlayTheBlues4U [Kc 7s]
921zhaopeng: calls $0.10
SuWasup: raises $0.20 to $0.30
PlayTheBlues4U: folds
SourShoes9: folds
921zhaopeng said, "nh"
maxplans323: folds
joncruise: folds
921zhaopeng: calls $0.20
*** FLOP *** [Qh 9h Jh]
921zhaopeng: checks
SourShoes9 said, "thx"
SuWasup: bets $0.30
921zhaopeng: raises $0.30 to $0.60
SuWasup: calls $0.30
*** TURN *** [Qh 9h Jh] [7c]
921zhaopeng: bets $0.90
SuWasup: folds
Uncalled bet ($0.90) returned to 921zhaopeng
921zhaopeng collected $1.85 from pot
921zhaopeng: doesn't show hand
*** SUMMARY ***
Total pot $1.95 | Rake $0.10
Board [Qh 9h Jh 7c]
Seat 1: SourShoes9 (button) folded before Flop (didn't bet)
Seat 2: maxplans323 (small blind) folded before Flop
Seat 3: joncruise (big blind) folded before Flop
Seat 4: 921zhaopeng collected ($1.85)
Seat 5: SuWasup folded on the Turn
Seat 6: PlayTheBlues4U folded before Flop (didn't bet)


PokerStars Hand #203995377825:  Hold'em No Limit ($0.05/$0.10 USD) - 2019/09/26 22:07:56 ET
Table 'Delphinus' 6-max Seat #6 is the button
Seat 1: SourShoes9 ($11.13 in chips)
Seat 2: maxplans323 ($6.43 in chips)
Seat 3: joncruise ($9.87 in chips)
Seat 4: 921zhaopeng ($12.78 in chips)
Seat 5: SuWasup ($8.95 in chips)
Seat 6: PlayTheBlues4U ($9.12 in chips)
SourShoes9: posts small blind $0.05
maxplans323: posts big blind $0.10
*** HOLE CARDS ***
Dealt to PlayTheBlues4U [Kd 6h]
joncruise: folds
921zhaopeng: folds
SuWasup: folds
PlayTheBlues4U: raises $0.20 to $0.30
SourShoes9: calls $0.25
maxplans323: calls $0.20
*** FLOP *** [3s 4c 8d]
SourShoes9: checks
maxplans323: checks
PlayTheBlues4U: bets $0.50
SourShoes9: calls $0.50
maxplans323: folds
*** TURN *** [3s 4c 8d] [Jh]
SourShoes9: checks
PlayTheBlues4U: checks
*** RIVER *** [3s 4c 8d Jh] [5s]
SourShoes9: checks
PlayTheBlues4U: bets $1.20
SourShoes9: calls $1.20
*** SHOW DOWN ***
PlayTheBlues4U: shows [Kd 6h] (high card King)
SourShoes9: shows [Ad 9d] (high card Ace)
SourShoes9 collected $4.08 from pot
*** SUMMARY ***
Total pot $4.30 | Rake $0.22
Board [3s 4c 8d Jh 5s]
Seat 1: SourShoes9 (small blind) showed [Ad 9d] and won ($4.08) with high card Ace
Seat 2: maxplans323 (big blind) folded on the Flop
Seat 3: joncruise folded before Flop (didn't bet)
Seat 4: 921zhaopeng folded before Flop (didn't bet)
Seat 5: SuWasup folded before Flop (didn't bet)
Seat 6: PlayTheBlues4U (button) showed [Kd 6h] and lost with high card King


PokerStars Hand #203995377727:  Hold'em No Limit ($0.05/$0.10 USD) - 2019/09/26 22:07:22 ET
Table 'Delphinus' 6-max Seat #5 is the button
Seat 1: SourShoes9 ($11.23 in chips)
Seat 2: maxplans323 ($6.43 in chips)
Seat 3: joncruise ($9.87 in chips)
Seat 4: 921zhaopeng ($12.37 in chips)
Seat 5: SuWasup ($9.25 in chips)
Seat 6: PlayTheBlues4U ($9.17 in chips)
PlayTheBlues4U: posts small blind $0.05
SourShoes9: posts big blind $0.10
*** HOLE CARDS ***
Dealt to PlayTheBlues4U [Js 6h]
maxplans323: folds
joncruise: folds
921zhaopeng: raises $0.20 to $0.30
SuWasup: calls $0.30
PlayTheBlues4U: folds
SourShoes9: folds
*** FLOP *** [2h 7d 4d]
921zhaopeng: bets $0.40
SuWasup: folds
Uncalled bet ($0.40) returned to 921zhaopeng
921zhaopeng collected $0.71 from pot
921zhaopeng: doesn't show hand
*** SUMMARY ***
Total pot $0.75 | Rake $0.04
Board [2h 7d 4d]
Seat 1: SourShoes9 (big blind) folded before Flop
Seat 2: maxplans323 folded before Flop (didn't bet)
Seat 3: joncruise folded before Flop (didn't bet)
Seat 4: 921zhaopeng collected ($0.71)
Seat 5: SuWasup (button) folded on the Flop
Seat 6: PlayTheBlues4U (small blind) folded before Flop


PokerStars Hand #203995377592:  Hold'em No Limit ($0.05/$0.10 USD) - 2019/09/26 22:06:39 ET
Table 'Delphinus' 6-max Seat #4 is the button
Seat 1: SourShoes9 ($11.23 in chips)
Seat 2: maxplans323 ($5.69 in chips)
Seat 3: joncruise ($10.53 in chips)
Seat 4: 921zhaopeng ($12.37 in chips)
Seat 5: SuWasup ($9.30 in chips)
Seat 6: PlayTheBlues4U ($9.27 in chips)
SuWasup: posts small blind $0.05
PlayTheBlues4U: posts big blind $0.10
*** HOLE CARDS ***
Dealt to PlayTheBlues4U [2s 8s]
SourShoes9: folds
maxplans323: raises $0.20 to $0.30
joncruise: calls $0.30
921zhaopeng: folds
SuWasup: folds
PlayTheBlues4U: folds
*** FLOP *** [6c Qd 2h]
maxplans323: checks
joncruise: checks
*** TURN *** [6c Qd 2h] [8h]
maxplans323: bets $0.36
joncruise: calls $0.36
*** RIVER *** [6c Qd 2h 8h] [Ah]
maxplans323: checks
joncruise: checks
*** SHOW DOWN ***
maxplans323: shows [9d 8d] (a pair of Eights)
joncruise: mucks hand
maxplans323 collected $1.40 from pot
*** SUMMARY ***
Total pot $1.47 | Rake $0.07
Board [6c Qd 2h 8h Ah]
Seat 1: SourShoes9 folded before Flop (didn't bet)
Seat 2: maxplans323 showed [9d 8d] and won ($1.40) with a pair of Eights
Seat 3: joncruise mucked [6d 4d]
Seat 4: 921zhaopeng (button) folded before Flop (didn't bet)
Seat 5: SuWasup (small blind) folded before Flop
Seat 6: PlayTheBlues4U (big blind) folded before Flop


PokerStars Hand #203995377443:  Hold'em No Limit ($0.05/$0.10 USD) - 2019/09/26 22:05:49 ET
Table 'Delphinus' 6-max Seat #3 is the button
Seat 1: SourShoes9 ($11.73 in chips)
Seat 2: maxplans323 ($5.69 in chips)
Seat 3: joncruise ($10.53 in chips)
Seat 4: 921zhaopeng ($12.42 in chips)
Seat 5: SuWasup ($8.80 in chips)
Seat 6: PlayTheBlues4U ($9.27 in chips)
921zhaopeng: posts small blind $0.05
SuWasup: posts big blind $0.10
*** HOLE CARDS ***
Dealt to PlayTheBlues4U [6s 5h]
PlayTheBlues4U: folds
SourShoes9: raises $0.20 to $0.30
maxplans323: folds
joncruise: folds
921zhaopeng: folds
SuWasup: calls $0.20
*** FLOP *** [Jd 8c Kc]
SuWasup: checks
SourShoes9: checks
*** TURN *** [Jd 8c Kc] [Qh]
SuWasup: bets $0.20
SourShoes9: calls $0.20
*** RIVER *** [Jd 8c Kc Qh] [2c]
SuWasup: bets $0.50
SourShoes9: folds
Uncalled bet ($0.50) returned to SuWasup
SuWasup collected $1 from pot
SuWasup: doesn't show hand
*** SUMMARY ***
Total pot $1.05 | Rake $0.05
Board [Jd 8c Kc Qh 2c]
Seat 1: SourShoes9 folded on the River
Seat 2: maxplans323 folded before Flop (didn't bet)
Seat 3: joncruise (button) folded before Flop (didn't bet)
Seat 4: 921zhaopeng (small blind) folded before Flop
Seat 5: SuWasup (big blind) collected ($1)
Seat 6: PlayTheBlues4U folded before Flop (didn't bet)


PokerStars Hand #203995377360:  Hold'em No Limit ($0.05/$0.10 USD) - 2019/09/26 22:05:22 ET
Table 'Delphinus' 6-max Seat #2 is the button
Seat 1: SourShoes9 ($11.37 in chips)
Seat 2: maxplans323 ($5.69 in chips)
Seat 3: joncruise ($10.58 in chips)
Seat 4: 921zhaopeng ($12.77 in chips)
Seat 5: SuWasup ($8.80 in chips)
Seat 6: PlayTheBlues4U ($9.27 in chips)
joncruise: posts small blind $0.05
921zhaopeng: posts big blind $0.10
*** HOLE CARDS ***
Dealt to PlayTheBlues4U [Tc Qh]
SuWasup: folds
PlayTheBlues4U: folds
SourShoes9: raises $0.25 to $0.35
maxplans323: folds
joncruise: folds
921zhaopeng: calls $0.25
*** FLOP *** [3s Kc 6d]
921zhaopeng: checks
SourShoes9: bets $0.60
921zhaopeng: folds
Uncalled bet ($0.60) returned to SourShoes9
SourShoes9 collected $0.71 from pot
SourShoes9: doesn't show hand
*** SUMMARY ***
Total pot $0.75 | Rake $0.04
Board [3s Kc 6d]
Seat 1: SourShoes9 collected ($0.71)
Seat 2: maxplans323 (button) folded before Flop (didn't bet)
Seat 3: joncruise (small blind) folded before Flop
Seat 4: 921zhaopeng (big blind) folded on the Flop
Seat 5: SuWasup folded before Flop (didn't bet)
Seat 6: PlayTheBlues4U folded before Flop (didn't bet)


PokerStars Hand #203995377260:  Hold'em No Limit ($0.05/$0.10 USD) - 2019/09/26 22:04:47 ET
Table 'Delphinus' 6-max Seat #1 is the button
Seat 1: SourShoes9 ($11.77 in chips)
Seat 2: maxplans323 ($5.23 in chips)
Seat 3: joncruise ($10.68 in chips)
Seat 4: 921zhaopeng ($12.77 in chips)
Seat 5: SuWasup ($8.80 in chips)
Seat 6: PlayTheBlues4U ($9.27 in chips)
maxplans323: posts small blind $0.05
joncruise: posts big blind $0.10
*** HOLE CARDS ***
Dealt to PlayTheBlues4U [Ts Jc]
921zhaopeng: folds
SuWasup: folds
PlayTheBlues4U: folds
SourShoes9: calls $0.10
maxplans323: calls $0.05
joncruise: checks
*** FLOP *** [4d 7c 2c]
maxplans323: checks
joncruise: checks
SourShoes9: bets $0.30
maxplans323: calls $0.30
joncruise: folds
*** TURN *** [4d 7c 2c] [Kc]
maxplans323: checks
SourShoes9: checks
*** RIVER *** [4d 7c 2c Kc] [8d]
maxplans323: checks
SourShoes9: checks
*** SHOW DOWN ***
maxplans323: shows [6d 5d] (a straight, Four to Eight)
SourShoes9: mucks hand
maxplans323 collected $0.86 from pot
*** SUMMARY ***
Total pot $0.90 | Rake $0.04
Board [4d 7c 2c Kc 8d]
Seat 1: SourShoes9 (button) mucked [9h 8h]
Seat 2: maxplans323 (small blind) showed [6d 5d] and won ($0.86) with a straight, Four to Eight
Seat 3: joncruise (big blind) folded on the Flop
Seat 4: 921zhaopeng folded before Flop (didn't bet)
Seat 5: SuWasup folded before Flop (didn't bet)
Seat 6: PlayTheBlues4U folded before Flop (didn't bet)


PokerStars Hand #203995377103:  Hold'em No Limit ($0.05/$0.10 USD) - 2019/09/26 22:04:00 ET
Table 'Delphinus' 6-max Seat #6 is the button
Seat 1: SourShoes9 ($11.82 in chips)
Seat 2: maxplans323 ($5.33 in chips)
Seat 3: joncruise ($10.78 in chips)
Seat 4: 921zhaopeng ($11.81 in chips)
Seat 5: SuWasup ($9.60 in chips)
Seat 6: PlayTheBlues4U ($9.27 in chips)
SourShoes9: posts small blind $0.05
maxplans323: posts big blind $0.10
*** HOLE CARDS ***
Dealt to PlayTheBlues4U [9h 5h]
joncruise: calls $0.10
921zhaopeng: raises $0.20 to $0.30
SuWasup: raises $0.50 to $0.80
PlayTheBlues4U: folds
SourShoes9: folds
maxplans323: folds
joncruise: folds
921zhaopeng: calls $0.50
*** FLOP *** [4c 4h 9s]
921zhaopeng: bets $0.90
SuWasup: folds
Uncalled bet ($0.90) returned to 921zhaopeng
921zhaopeng collected $1.76 from pot
921zhaopeng: doesn't show hand
*** SUMMARY ***
Total pot $1.85 | Rake $0.09
Board [4c 4h 9s]
Seat 1: SourShoes9 (small blind) folded before Flop
Seat 2: maxplans323 (big blind) folded before Flop
Seat 3: joncruise folded before Flop
Seat 4: 921zhaopeng collected ($1.76)
Seat 5: SuWasup folded on the Flop
Seat 6: PlayTheBlues4U (button) folded before Flop (didn't bet)


PokerStars Hand #203995377037:  Hold'em No Limit ($0.05/$0.10 USD) - 2019/09/26 22:03:43 ET
Table 'Delphinus' 6-max Seat #5 is the button
Seat 1: SourShoes9 ($11.92 in chips)
Seat 2: maxplans323 ($5.33 in chips)
Seat 3: joncruise ($10.78 in chips)
Seat 4: 921zhaopeng ($11.81 in chips)
Seat 5: SuWasup ($9.45 in chips)
Seat 6: PlayTheBlues4U ($9.32 in chips)
PlayTheBlues4U: posts small blind $0.05
SourShoes9: posts big blind $0.10
*** HOLE CARDS ***
Dealt to PlayTheBlues4U [4d Jd]
maxplans323: folds
joncruise: folds
921zhaopeng: folds
SuWasup: raises $0.30 to $0.40
PlayTheBlues4U: folds
SourShoes9: folds
Uncalled bet ($0.30) returned to SuWasup
SuWasup collected $0.25 from pot
SuWasup: doesn't show hand
*** SUMMARY ***
Total pot $0.25 | Rake $0
Seat 1: SourShoes9 (big blind) folded before Flop
Seat 2: maxplans323 folded before Flop (didn't bet)
Seat 3: joncruise folded before Flop (didn't bet)
Seat 4: 921zhaopeng folded before Flop (didn't bet)
Seat 5: SuWasup (button) collected ($0.25)
Seat 6: PlayTheBlues4U (small blind) folded before Flop


PokerStars Hand #203995376930:  Hold'em No Limit ($0.05/$0.10 USD) - 2019/09/26 22:03:11 ET
Table 'Delphinus' 6-max Seat #4 is the button
Seat 1: SourShoes9 ($12.92 in chips)
Seat 2: maxplans323 ($5.33 in chips)
Seat 3: joncruise ($10.98 in chips)
Seat 4: 921zhaopeng ($10.48 in chips)
Seat 5: SuWasup ($9.50 in chips)
Seat 6: PlayTheBlues4U ($9.52 in chips)
SuWasup: posts small blind $0.05
PlayTheBlues4U: posts big blind $0.10
*** HOLE CARDS ***
Dealt to PlayTheBlues4U [Kh 6c]
SourShoes9: raises $0.10 to $0.20
maxplans323: folds
joncruise: calls $0.20
921zhaopeng: calls $0.20
SuWasup: folds
PlayTheBlues4U: calls $0.10
*** FLOP *** [8h 5s 9s]
PlayTheBlues4U: checks
SourShoes9: checks
joncruise: checks
921zhaopeng: bets $0.80
PlayTheBlues4U: folds
SourShoes9: calls $0.80
joncruise: folds
*** TURN *** [8h 5s 9s] [5h]
SourShoes9: checks
921zhaopeng: bets $2.30
SourShoes9: folds
Uncalled bet ($2.30) returned to 921zhaopeng
921zhaopeng collected $2.33 from pot
921zhaopeng: doesn't show hand
*** SUMMARY ***
Total pot $2.45 | Rake $0.12
Board [8h 5s 9s 5h]
Seat 1: SourShoes9 folded on the Turn
Seat 2: maxplans323 folded before Flop (didn't bet)
Seat 3: joncruise folded on the Flop
Seat 4: 921zhaopeng (button) collected ($2.33)
Seat 5: SuWasup (small blind) folded before Flop
Seat 6: PlayTheBlues4U (big blind) folded on the Flop


PokerStars Hand #203995376885:  Hold'em No Limit ($0.05/$0.10 USD) - 2019/09/26 22:02:54 ET
Table 'Delphinus' 6-max Seat #3 is the button
Seat 1: SourShoes9 ($12.77 in chips)
Seat 2: maxplans323 ($5.33 in chips)
Seat 3: joncruise ($10.98 in chips)
Seat 4: 921zhaopeng ($10.53 in chips)
Seat 5: SuWasup ($9.60 in chips)
Seat 6: PlayTheBlues4U ($9.52 in chips)
921zhaopeng: posts small blind $0.05
SuWasup: posts big blind $0.10
*** HOLE CARDS ***
Dealt to PlayTheBlues4U [4h 3s]
PlayTheBlues4U: folds
SourShoes9: raises $0.35 to $0.45
maxplans323: folds
joncruise: folds
921zhaopeng: folds
SuWasup: folds
Uncalled bet ($0.35) returned to SourShoes9
SourShoes9 collected $0.25 from pot
SourShoes9: doesn't show hand
*** SUMMARY ***
Total pot $0.25 | Rake $0
Seat 1: SourShoes9 collected ($0.25)
Seat 2: maxplans323 folded before Flop (didn't bet)
Seat 3: joncruise (button) folded before Flop (didn't bet)
Seat 4: 921zhaopeng (small blind) folded before Flop
Seat 5: SuWasup (big blind) folded before Flop
Seat 6: PlayTheBlues4U folded before Flop (didn't bet)


PokerStars Hand #203995376742:  Hold'em No Limit ($0.05/$0.10 USD) - 2019/09/26 22:02:05 ET
Table 'Delphinus' 6-max Seat #2 is the button
Seat 1: SourShoes9 ($12.77 in chips)
Seat 2: maxplans323 ($5.33 in chips)
Seat 3: joncruise ($11.28 in chips)
Seat 4: 921zhaopeng ($9.61 in chips)
Seat 5: SuWasup ($9.60 in chips)
Seat 6: PlayTheBlues4U ($10.22 in chips)
joncruise: posts small blind $0.05
921zhaopeng: posts big blind $0.10
*** HOLE CARDS ***
Dealt to PlayTheBlues4U [6h 3h]
SuWasup: folds
PlayTheBlues4U: raises $0.20 to $0.30
SourShoes9: folds
maxplans323: folds
joncruise: calls $0.25
921zhaopeng: calls $0.20
*** FLOP *** [4s 5d 9c]
joncruise: checks
921zhaopeng: bets $0.40
PlayTheBlues4U: calls $0.40
joncruise: folds
*** TURN *** [4s 5d 9c] [5s]
921zhaopeng: bets $1
PlayTheBlues4U: folds
Uncalled bet ($1) returned to 921zhaopeng
921zhaopeng collected $1.62 from pot
921zhaopeng: doesn't show hand
*** SUMMARY ***
Total pot $1.70 | Rake $0.08
Board [4s 5d 9c 5s]
Seat 1: SourShoes9 folded before Flop (didn't bet)
Seat 2: maxplans323 (button) folded before Flop (didn't bet)
Seat 3: joncruise (small blind) folded on the Flop
Seat 4: 921zhaopeng (big blind) collected ($1.62)
Seat 5: SuWasup folded before Flop (didn't bet)
Seat 6: PlayTheBlues4U folded on the Turn


PokerStars Hand #203995376617:  Hold'em No Limit ($0.05/$0.10 USD) - 2019/09/26 22:01:23 ET
Table 'Delphinus' 6-max Seat #1 is the button
Seat 1: SourShoes9 ($13.17 in chips)
Seat 2: maxplans323 ($5.38 in chips)
Seat 3: joncruise ($10.49 in chips)
Seat 4: 921zhaopeng ($10.01 in chips)
Seat 5: SuWasup ($9.60 in chips)
Seat 6: PlayTheBlues4U ($10.22 in chips)
maxplans323: posts small blind $0.05
joncruise: posts big blind $0.10
*** HOLE CARDS ***
Dealt to PlayTheBlues4U [Qd 3c]
921zhaopeng: raises $0.20 to $0.30
SuWasup: folds
PlayTheBlues4U: folds
SourShoes9: calls $0.30
maxplans323: folds
joncruise: calls $0.20
*** FLOP *** [5h 6d Jh]
joncruise: checks
921zhaopeng: checks
SourShoes9: checks
*** TURN *** [5h 6d Jh] [9d]
joncruise: bets $0.10
921zhaopeng: calls $0.10
SourShoes9: calls $0.10
*** RIVER *** [5h 6d Jh 9d] [3h]
joncruise: bets $0.60
921zhaopeng: folds
SourShoes9: folds
Uncalled bet ($0.60) returned to joncruise
joncruise collected $1.19 from pot
joncruise: doesn't show hand
*** SUMMARY ***
Total pot $1.25 | Rake $0.06
Board [5h 6d Jh 9d 3h]
Seat 1: SourShoes9 (button) folded on the River
Seat 2: maxplans323 (small blind) folded before Flop
Seat 3: joncruise (big blind) collected ($1.19)
Seat 4: 921zhaopeng folded on the River
Seat 5: SuWasup folded before Flop (didn't bet)
Seat 6: PlayTheBlues4U folded before Flop (didn't bet)


PokerStars Hand #203995376534:  Hold'em No Limit ($0.05/$0.10 USD) - 2019/09/26 22:00:50 ET
Table 'Delphinus' 6-max Seat #6 is the button
Seat 1: SourShoes9 ($13.22 in chips)
Seat 2: maxplans323 ($5.48 in chips)
Seat 3: joncruise ($10.59 in chips)
Seat 4: 921zhaopeng ($9.68 in chips)
Seat 5: SuWasup ($9.60 in chips)
Seat 6: PlayTheBlues4U ($10.32 in chips)
SourShoes9: posts small blind $0.05
maxplans323: posts big blind $0.10
*** HOLE CARDS ***
Dealt to PlayTheBlues4U [7h Th]
joncruise: calls $0.10
921zhaopeng: calls $0.10
SuWasup: folds
PlayTheBlues4U: calls $0.10
SourShoes9: folds
maxplans323: checks
*** FLOP *** [Ah As Kd]
maxplans323: checks
joncruise: checks
921zhaopeng: bets $0.20
PlayTheBlues4U: folds
maxplans323: folds
joncruise: folds
Uncalled bet ($0.20) returned to 921zhaopeng
921zhaopeng collected $0.43 from pot
921zhaopeng: doesn't show hand
*** SUMMARY ***
Total pot $0.45 | Rake $0.02
Board [Ah As Kd]
Seat 1: SourShoes9 (small blind) folded before Flop
Seat 2: maxplans323 (big blind) folded on the Flop
Seat 3: joncruise folded on the Flop
Seat 4: 921zhaopeng collected ($0.43)
Seat 5: SuWasup folded before Flop (didn't bet)
Seat 6: PlayTheBlues4U (button) folded on the Flop


PokerStars Hand #203995376403:  Hold'em No Limit ($0.05/$0.10 USD) - 2019/09/26 22:00:08 ET
Table 'Delphinus' 6-max Seat #5 is the button
Seat 1: SourShoes9 ($12.66 in chips)
Seat 2: maxplans323 ($5.48 in chips)
Seat 3: joncruise ($10.59 in chips)
Seat 4: 921zhaopeng ($9.68 in chips)
Seat 5: SuWasup ($9.90 in chips)
Seat 6: PlayTheBlues4U ($10.62 in chips)
PlayTheBlues4U: posts small blind $0.05
SourShoes9: posts big blind $0.10
*** HOLE CARDS ***
Dealt to PlayTheBlues4U [Ac 3d]
maxplans323: folds
joncruise: folds
921zhaopeng: folds
SuWasup: raises $0.20 to $0.30
PlayTheBlues4U: calls $0.25
SourShoes9: calls $0.20
*** FLOP *** [6d 4s 6s]
PlayTheBlues4U: checks
SourShoes9: bets $0.40
SuWasup: folds
PlayTheBlues4U: folds
Uncalled bet ($0.40) returned to SourShoes9
SourShoes9 collected $0.86 from pot
SourShoes9: doesn't show hand
*** SUMMARY ***
Total pot $0.90 | Rake $0.04
Board [6d 4s 6s]
Seat 1: SourShoes9 (big blind) collected ($0.86)
Seat 2: maxplans323 folded before Flop (didn't bet)
Seat 3: joncruise folded before Flop (didn't bet)
Seat 4: 921zhaopeng folded before Flop (didn't bet)
Seat 5: SuWasup (button) folded on the Flop
Seat 6: PlayTheBlues4U (small blind) folded on the Flop


PokerStars Hand #203995376378:  Hold'em No Limit ($0.05/$0.10 USD) - 2019/09/26 21:59:56 ET
Table 'Delphinus' 6-max Seat #4 is the button
Seat 1: SourShoes9 ($12.66 in chips)
Seat 2: maxplans323 ($5.33 in chips)
Seat 3: joncruise ($10.59 in chips)
Seat 4: 921zhaopeng ($9.68 in chips)
Seat 5: SuWasup ($9.95 in chips)
Seat 6: PlayTheBlues4U ($10.72 in chips)
SuWasup: posts small blind $0.05
PlayTheBlues4U: posts big blind $0.10
*** HOLE CARDS ***
Dealt to PlayTheBlues4U [4h 2c]
SourShoes9: folds
maxplans323: raises $0.20 to $0.30
joncruise: folds
921zhaopeng: folds
SuWasup: folds
PlayTheBlues4U: folds
Uncalled bet ($0.20) returned to maxplans323
maxplans323 collected $0.25 from pot
maxplans323: doesn't show hand
*** SUMMARY ***
Total pot $0.25 | Rake $0
Seat 1: SourShoes9 folded before Flop (didn't bet)
Seat 2: maxplans323 collected ($0.25)
Seat 3: joncruise folded before Flop (didn't bet)
Seat 4: 921zhaopeng (button) folded before Flop (didn't bet)
Seat 5: SuWasup (small blind) folded before Flop
Seat 6: PlayTheBlues4U (big blind) folded before Flop


PokerStars Hand #203995376174:  Hold'em No Limit ($0.05/$0.10 USD) - 2019/09/26 21:58:12 ET
Table 'Delphinus' 6-max Seat #3 is the button
Seat 1: SourShoes9 ($11.89 in chips)
Seat 2: maxplans323 ($5.33 in chips)
Seat 3: joncruise ($10.59 in chips)
Seat 4: 921zhaopeng ($9.73 in chips)
Seat 5: SuWasup ($10.75 in chips)
Seat 6: PlayTheBlues4U ($10.72 in chips)
921zhaopeng: posts small blind $0.05
SuWasup: posts big blind $0.10
*** HOLE CARDS ***
Dealt to PlayTheBlues4U [Qh 7d]
PlayTheBlues4U: folds
SourShoes9: calls $0.10
maxplans323: folds
joncruise: folds
921zhaopeng: folds
SuWasup: raises $0.30 to $0.40
SourShoes9: calls $0.30
*** FLOP *** [As Jc Th]
SuWasup: checks
SourShoes9: checks
*** TURN *** [As Jc Th] [8d]
SuWasup: bets $0.40
SourShoes9: calls $0.40
*** RIVER *** [As Jc Th 8d] [6s]
SuWasup: checks
SourShoes9: bets $1.50
SuWasup: folds
Uncalled bet ($1.50) returned to SourShoes9
SourShoes9 collected $1.57 from pot
SourShoes9: doesn't show hand
*** SUMMARY ***
Total pot $1.65 | Rake $0.08
Board [As Jc Th 8d 6s]
Seat 1: SourShoes9 collected ($1.57)
Seat 2: maxplans323 folded before Flop (didn't bet)
Seat 3: joncruise (button) folded before Flop (didn't bet)
Seat 4: 921zhaopeng (small blind) folded before Flop
Seat 5: SuWasup (big blind) folded on the River
Seat 6: PlayTheBlues4U folded before Flop (didn't bet)


PokerStars Hand #203995376132:  Hold'em No Limit ($0.05/$0.10 USD) - 2019/09/26 21:57:49 ET
Table 'Delphinus' 6-max Seat #2 is the button
Seat 1: SourShoes9 ($11.89 in chips)
Seat 2: maxplans323 ($5.33 in chips)
Seat 3: joncruise ($10.89 in chips)
Seat 4: 921zhaopeng ($9.83 in chips)
Seat 5: SuWasup ($10.75 in chips)
Seat 6: PlayTheBlues4U ($10.36 in chips)
joncruise: posts small blind $0.05
921zhaopeng: posts big blind $0.10
*** HOLE CARDS ***
Dealt to PlayTheBlues4U [Tc Td]
SuWasup: folds
PlayTheBlues4U: raises $0.20 to $0.30
SourShoes9: folds
maxplans323: folds
joncruise: calls $0.25
921zhaopeng: folds
*** FLOP *** [Ts 7d Kd]
joncruise: checks
PlayTheBlues4U: bets $0.50
joncruise: folds
Uncalled bet ($0.50) returned to PlayTheBlues4U
PlayTheBlues4U collected $0.66 from pot
PlayTheBlues4U: doesn't show hand
*** SUMMARY ***
Total pot $0.70 | Rake $0.04
Board [Ts 7d Kd]
Seat 1: SourShoes9 folded before Flop (didn't bet)
Seat 2: maxplans323 (button) folded before Flop (didn't bet)
Seat 3: joncruise (small blind) folded on the Flop
Seat 4: 921zhaopeng (big blind) folded before Flop
Seat 5: SuWasup folded before Flop (didn't bet)
Seat 6: PlayTheBlues4U collected ($0.66)


PokerStars Hand #203995376061:  Hold'em No Limit ($0.05/$0.10 USD) - 2019/09/26 21:57:22 ET
Table 'Delphinus' 6-max Seat #1 is the button
Seat 1: SourShoes9 ($11.89 in chips)
Seat 2: maxplans323 ($5.63 in chips)
Seat 3: joncruise ($10.99 in chips)
Seat 4: 921zhaopeng ($9.83 in chips)
Seat 5: SuWasup ($10.75 in chips)
Seat 6: PlayTheBlues4U ($10 in chips)
maxplans323: posts small blind $0.05
joncruise: posts big blind $0.10
*** HOLE CARDS ***
Dealt to PlayTheBlues4U [As 7s]
921zhaopeng: folds
SuWasup: folds
PlayTheBlues4U: raises $0.20 to $0.30
SourShoes9: folds
maxplans323: calls $0.25
joncruise: folds
*** FLOP *** [3c 7d 6h]
maxplans323: checks
PlayTheBlues4U: bets $0.40
maxplans323: folds
Uncalled bet ($0.40) returned to PlayTheBlues4U
PlayTheBlues4U collected $0.66 from pot
PlayTheBlues4U: doesn't show hand
*** SUMMARY ***
Total pot $0.70 | Rake $0.04
Board [3c 7d 6h]
Seat 1: SourShoes9 (button) folded before Flop (didn't bet)
Seat 2: maxplans323 (small blind) folded on the Flop
Seat 3: joncruise (big blind) folded before Flop
Seat 4: 921zhaopeng folded before Flop (didn't bet)
Seat 5: SuWasup folded before Flop (didn't bet)
Seat 6: PlayTheBlues4U collected ($0.66)


PokerStars Hand #203995375876:  Hold'em No Limit ($0.05/$0.10 USD) - 2019/09/26 21:55:48 ET
Table 'Delphinus' 6-max Seat #6 is the button
Seat 1: SourShoes9 ($11.94 in chips)
Seat 2: maxplans323 ($6.63 in chips)
Seat 3: joncruise ($10.99 in chips)
Seat 4: 921zhaopeng ($9.83 in chips)
Seat 5: SuWasup ($9.80 in chips)
Seat 6: PlayTheBlues4U ($8.55 in chips)
SourShoes9: posts small blind $0.05
maxplans323: posts big blind $0.10
*** HOLE CARDS ***
Dealt to PlayTheBlues4U [6c 7s]
joncruise: folds
921zhaopeng: folds
SuWasup: raises $0.20 to $0.30
PlayTheBlues4U: folds
SourShoes9: folds
maxplans323: calls $0.20
*** FLOP *** [As Kc Kh]
maxplans323: checks
SuWasup: bets $0.20
maxplans323: calls $0.20
*** TURN *** [As Kc Kh] [6h]
maxplans323: checks
SuWasup: bets $0.50
maxplans323: calls $0.50
*** RIVER *** [As Kc Kh 6h] [4d]
maxplans323: checks
SuWasup: bets $1.20
maxplans323: folds
Uncalled bet ($1.20) returned to SuWasup
SuWasup collected $1.95 from pot
SuWasup: doesn't show hand
*** SUMMARY ***
Total pot $2.05 | Rake $0.10
Board [As Kc Kh 6h 4d]
Seat 1: SourShoes9 (small blind) folded before Flop
Seat 2: maxplans323 (big blind) folded on the River
Seat 3: joncruise folded before Flop (didn't bet)
Seat 4: 921zhaopeng folded before Flop (didn't bet)
Seat 5: SuWasup collected ($1.95)
Seat 6: PlayTheBlues4U (button) folded before Flop (didn't bet)


PokerStars Hand #203995375703:  Hold'em No Limit ($0.05/$0.10 USD) - 2019/09/26 21:54:27 ET
Table 'Delphinus' 6-max Seat #5 is the button
Seat 1: SourShoes9 ($11.47 in chips)
Seat 2: maxplans323 ($6.63 in chips)
Seat 3: joncruise ($11.79 in chips)
Seat 4: 921zhaopeng ($9.37 in chips)
Seat 5: SuWasup ($10 in chips)
Seat 6: PlayTheBlues4U ($8.75 in chips)
PlayTheBlues4U: posts small blind $0.05
SourShoes9: posts big blind $0.10
*** HOLE CARDS ***
Dealt to PlayTheBlues4U [9d Jc]
maxplans323: folds
joncruise: raises $0.10 to $0.20
921zhaopeng: calls $0.20
SuWasup: calls $0.20
PlayTheBlues4U: calls $0.15
SourShoes9: calls $0.10
*** FLOP *** [Qh 4d Kc]
PlayTheBlues4U: checks
SourShoes9: bets $0.60
joncruise: calls $0.60
921zhaopeng: calls $0.60
SuWasup: folds
PlayTheBlues4U: folds
*** TURN *** [Qh 4d Kc] [Ts]
SourShoes9: checks
joncruise: checks
921zhaopeng: bets $1.30
SourShoes9: calls $1.30
joncruise: folds
*** RIVER *** [Qh 4d Kc Ts] [3h]
SourShoes9: checks
921zhaopeng: checks
*** SHOW DOWN ***
SourShoes9: shows [Ks 9s] (a pair of Kings)
921zhaopeng: shows [Kh 9h] (a pair of Kings)
SourShoes9 collected $2.57 from pot
921zhaopeng collected $2.56 from pot
*** SUMMARY ***
Total pot $5.40 | Rake $0.27
Board [Qh 4d Kc Ts 3h]
Seat 1: SourShoes9 (big blind) showed [Ks 9s] and won ($2.57) with a pair of Kings
Seat 2: maxplans323 folded before Flop (didn't bet)
Seat 3: joncruise folded on the Turn
Seat 4: 921zhaopeng showed [Kh 9h] and won ($2.56) with a pair of Kings
Seat 5: SuWasup (button) folded on the Flop
Seat 6: PlayTheBlues4U (small blind) folded on the Flop


PokerStars Hand #203995375628:  Hold'em No Limit ($0.05/$0.10 USD) - 2019/09/26 21:54:01 ET
Table 'Delphinus' 6-max Seat #4 is the button
Seat 1: SourShoes9 ($11.57 in chips)
Seat 2: maxplans323 ($6.38 in chips)
Seat 3: joncruise ($11.79 in chips)
Seat 4: 921zhaopeng ($9.37 in chips)
Seat 5: SuWasup ($10.05 in chips)
Seat 6: PlayTheBlues4U ($8.85 in chips)
SuWasup: posts small blind $0.05
PlayTheBlues4U: posts big blind $0.10
*** HOLE CARDS ***
Dealt to PlayTheBlues4U [2d 4s]
SourShoes9: calls $0.10
maxplans323: raises $0.35 to $0.45
joncruise: folds
921zhaopeng: folds
SuWasup: folds
PlayTheBlues4U: folds
SourShoes9: folds
Uncalled bet ($0.35) returned to maxplans323
maxplans323 collected $0.35 from pot
maxplans323: doesn't show hand
*** SUMMARY ***
Total pot $0.35 | Rake $0
Seat 1: SourShoes9 folded before Flop
Seat 2: maxplans323 collected ($0.35)
Seat 3: joncruise folded before Flop (didn't bet)
Seat 4: 921zhaopeng (button) folded before Flop (didn't bet)
Seat 5: SuWasup (small blind) folded before Flop
Seat 6: PlayTheBlues4U (big blind) folded before Flop


PokerStars Hand #203995375599:  Hold'em No Limit ($0.05/$0.10 USD) - 2019/09/26 21:53:51 ET
Table 'Delphinus' 6-max Seat #3 is the button
Seat 1: SourShoes9 ($11.57 in chips)
Seat 2: maxplans323 ($6.38 in chips)
Seat 3: joncruise ($11.79 in chips)
Seat 4: 921zhaopeng ($9.42 in chips)
Seat 5: SuWasup ($10 in chips)
Seat 6: PlayTheBlues4U ($8.85 in chips)
921zhaopeng: posts small blind $0.05
SuWasup: posts big blind $0.10
*** HOLE CARDS ***
Dealt to PlayTheBlues4U [6c Kc]
PlayTheBlues4U: folds
SourShoes9: folds
maxplans323: folds
joncruise: folds
921zhaopeng: folds
Uncalled bet ($0.05) returned to SuWasup
SuWasup collected $0.10 from pot
SuWasup: doesn't show hand
*** SUMMARY ***
Total pot $0.10 | Rake $0
Seat 1: SourShoes9 folded before Flop (didn't bet)
Seat 2: maxplans323 folded before Flop (didn't bet)
Seat 3: joncruise (button) folded before Flop (didn't bet)
Seat 4: 921zhaopeng (small blind) folded before Flop
Seat 5: SuWasup (big blind) collected ($0.10)
Seat 6: PlayTheBlues4U folded before Flop (didn't bet)


PokerStars Hand #203995375441:  Hold'em No Limit ($0.05/$0.10 USD) - 2019/09/26 21:52:59 ET
Table 'Delphinus' 6-max Seat #2 is the button
Seat 1: SourShoes9 ($11.57 in chips)
Seat 2: maxplans323 ($4.91 in chips)
Seat 3: joncruise ($12.09 in chips)
Seat 4: 921zhaopeng ($9.72 in chips)
Seat 5: SuWasup ($10 in chips)
Seat 6: PlayTheBlues4U ($9.85 in chips)
joncruise: posts small blind $0.05
921zhaopeng: posts big blind $0.10
*** HOLE CARDS ***
Dealt to PlayTheBlues4U [Jh Ah]
SuWasup: folds
PlayTheBlues4U: raises $0.20 to $0.30
SourShoes9: folds
maxplans323: calls $0.30
joncruise: calls $0.25
921zhaopeng: calls $0.20
*** FLOP *** [6h 6d 8d]
joncruise: checks
921zhaopeng: checks
PlayTheBlues4U: bets $0.70
maxplans323: calls $0.70
joncruise: folds
921zhaopeng: folds
*** TURN *** [6h 6d 8d] [4d]
PlayTheBlues4U: checks
maxplans323: bets $1.24
PlayTheBlues4U: folds
Uncalled bet ($1.24) returned to maxplans323
maxplans323 collected $2.47 from pot
maxplans323: doesn't show hand
*** SUMMARY ***
Total pot $2.60 | Rake $0.13
Board [6h 6d 8d 4d]
Seat 1: SourShoes9 folded before Flop (didn't bet)
Seat 2: maxplans323 (button) collected ($2.47)
Seat 3: joncruise (small blind) folded on the Flop
Seat 4: 921zhaopeng (big blind) folded on the Flop
Seat 5: SuWasup folded before Flop (didn't bet)
Seat 6: PlayTheBlues4U folded on the Turn


PokerStars Hand #203995375340:  Hold'em No Limit ($0.05/$0.10 USD) - 2019/09/26 21:52:21 ET
Table 'Delphinus' 6-max Seat #1 is the button
Seat 1: SourShoes9 ($10.48 in chips)
Seat 2: maxplans323 ($4.96 in chips)
Seat 3: joncruise ($12.19 in chips)
Seat 4: 921zhaopeng ($10.77 in chips)
Seat 5: SuWasup ($10 in chips)
Seat 6: PlayTheBlues4U ($9.85 in chips)
maxplans323: posts small blind $0.05
joncruise: posts big blind $0.10
*** HOLE CARDS ***
Dealt to PlayTheBlues4U [8s 4s]
921zhaopeng: raises $0.20 to $0.30
SuWasup: folds
PlayTheBlues4U: folds
SourShoes9: raises $0.75 to $1.05
maxplans323: folds
joncruise: folds
921zhaopeng: calls $0.75
*** FLOP *** [4d 6c Kc]
921zhaopeng: checks
SourShoes9: bets $1.80
921zhaopeng: folds
Uncalled bet ($1.80) returned to SourShoes9
SourShoes9 collected $2.14 from pot
SourShoes9: doesn't show hand
*** SUMMARY ***
Total pot $2.25 | Rake $0.11
Board [4d 6c Kc]
Seat 1: SourShoes9 (button) collected ($2.14)
Seat 2: maxplans323 (small blind) folded before Flop
Seat 3: joncruise (big blind) folded before Flop
Seat 4: 921zhaopeng folded on the Flop
Seat 5: SuWasup folded before Flop (didn't bet)
Seat 6: PlayTheBlues4U folded before Flop (didn't bet)


PokerStars Hand #203995375283:  Hold'em No Limit ($0.05/$0.10 USD) - 2019/09/26 21:52:03 ET
Table 'Delphinus' 6-max Seat #6 is the button
Seat 1: SourShoes9 ($10.53 in chips)
Seat 2: maxplans323 ($5.06 in chips)
Seat 3: joncruise ($12.05 in chips)
Seat 4: 921zhaopeng ($10.77 in chips)
Seat 5: SuWasup ($10 in chips)
Seat 6: PlayTheBlues4U ($9.85 in chips)
SourShoes9: posts small blind $0.05
maxplans323: posts big blind $0.10
*** HOLE CARDS ***
Dealt to PlayTheBlues4U [Qc 6d]
joncruise: calls $0.10
921zhaopeng: folds
SuWasup: folds
PlayTheBlues4U: folds
SourShoes9: folds
maxplans323: checks
*** FLOP *** [Qd Kh Kc]
maxplans323: checks
joncruise: bets $0.10
maxplans323: folds
Uncalled bet ($0.10) returned to joncruise
joncruise collected $0.24 from pot
joncruise: doesn't show hand
*** SUMMARY ***
Total pot $0.25 | Rake $0.01
Board [Qd Kh Kc]
Seat 1: SourShoes9 (small blind) folded before Flop
Seat 2: maxplans323 (big blind) folded on the Flop
Seat 3: joncruise collected ($0.24)
Seat 4: 921zhaopeng folded before Flop (didn't bet)
Seat 5: SuWasup folded before Flop (didn't bet)
Seat 6: PlayTheBlues4U (button) folded before Flop (didn't bet)


PokerStars Hand #203995375250:  Hold'em No Limit ($0.05/$0.10 USD) - 2019/09/26 21:51:46 ET
Table 'Delphinus' 6-max Seat #5 is the button
Seat 1: SourShoes9 ($10.63 in chips)
Seat 2: maxplans323 ($5.06 in chips)
Seat 3: joncruise ($12.05 in chips)
Seat 4: 921zhaopeng ($10.77 in chips)
Seat 5: SuWasup ($9.85 in chips)
Seat 6: PlayTheBlues4U ($9.90 in chips)
PlayTheBlues4U: posts small blind $0.05
SourShoes9: posts big blind $0.10
*** HOLE CARDS ***
Dealt to PlayTheBlues4U [Kc 4h]
maxplans323: folds
joncruise: folds
921zhaopeng: folds
SuWasup: raises $0.30 to $0.40
PlayTheBlues4U: folds
SourShoes9: folds
Uncalled bet ($0.30) returned to SuWasup
SuWasup collected $0.25 from pot
SuWasup: doesn't show hand
*** SUMMARY ***
Total pot $0.25 | Rake $0
Seat 1: SourShoes9 (big blind) folded before Flop
Seat 2: maxplans323 folded before Flop (didn't bet)
Seat 3: joncruise folded before Flop (didn't bet)
Seat 4: 921zhaopeng folded before Flop (didn't bet)
Seat 5: SuWasup (button) collected ($0.25)
Seat 6: PlayTheBlues4U (small blind) folded before Flop


PokerStars Hand #203995375194:  Hold'em No Limit ($0.05/$0.10 USD) - 2019/09/26 21:51:27 ET
Table 'Delphinus' 6-max Seat #4 is the button
Seat 1: SourShoes9 ($10.63 in chips)
Seat 2: maxplans323 ($5.06 in chips)
Seat 3: joncruise ($12.25 in chips)
Seat 4: 921zhaopeng ($10.45 in chips)
Seat 5: SuWasup ($9.90 in chips)
Seat 6: PlayTheBlues4U ($10 in chips)
SuWasup: posts small blind $0.05
PlayTheBlues4U: posts big blind $0.10
*** HOLE CARDS ***
Dealt to PlayTheBlues4U [3h 9c]
SourShoes9: folds
maxplans323: folds
joncruise: calls $0.10
921zhaopeng: raises $0.10 to $0.20
SuWasup: folds
PlayTheBlues4U: folds
joncruise: calls $0.10
*** FLOP *** [3d 7d 3s]
joncruise: checks
921zhaopeng: bets $0.30
joncruise: folds
Uncalled bet ($0.30) returned to 921zhaopeng
921zhaopeng collected $0.52 from pot
921zhaopeng: doesn't show hand
*** SUMMARY ***
Total pot $0.55 | Rake $0.03
Board [3d 7d 3s]
Seat 1: SourShoes9 folded before Flop (didn't bet)
Seat 2: maxplans323 folded before Flop (didn't bet)
Seat 3: joncruise folded on the Flop
Seat 4: 921zhaopeng (button) collected ($0.52)
Seat 5: SuWasup (small blind) folded before Flop
Seat 6: PlayTheBlues4U (big blind) folded before Flop


PokerStars Hand #203945144425:  Hold'em No Limit ($0.05/$0.10 USD) - 2019/09/24 23:47:01 ET
Table 'Botein' 6-max Seat #6 is the button
Seat 1: trumpcaddy ($11.90 in chips)
Seat 2: KeithTurbo48 ($9.15 in chips)
Seat 3: PlayTheBlues4U ($5.10 in chips)
Seat 4: traderneal ($11.25 in chips)
Seat 5: NBoula ($21.85 in chips)
Seat 6: Aikido85 ($7.97 in chips)
trumpcaddy: posts small blind $0.05
KeithTurbo48: posts big blind $0.10
*** HOLE CARDS ***
Dealt to PlayTheBlues4U [Kc 8d]
PlayTheBlues4U: folds
traderneal: folds
PlayTheBlues4U leaves the table
NBoula: folds
Aikido85: calls $0.10
trumpcaddy: folds
KeithTurbo48: checks
*** FLOP *** [Ts 7d 9c]
KeithTurbo48: checks
Aikido85: checks
*** TURN *** [Ts 7d 9c] [3d]
KeithTurbo48: bets $0.20
Aikido85: folds
Uncalled bet ($0.20) returned to KeithTurbo48
KeithTurbo48 collected $0.24 from pot
KeithTurbo48: doesn't show hand
*** SUMMARY ***
Total pot $0.25 | Rake $0.01
Board [Ts 7d 9c 3d]
Seat 1: trumpcaddy (small blind) folded before Flop
Seat 2: KeithTurbo48 (big blind) collected ($0.24)
Seat 3: PlayTheBlues4U folded before Flop (didn't bet)
Seat 4: traderneal folded before Flop (didn't bet)
Seat 5: NBoula folded before Flop (didn't bet)
Seat 6: Aikido85 (button) folded on the Turn


PokerStars Hand #203945144328:  Hold'em No Limit ($0.05/$0.10 USD) - 2019/09/24 23:46:27 ET
Table 'Botein' 6-max Seat #5 is the button
Seat 1: trumpcaddy ($12 in chips)
Seat 2: KeithTurbo48 ($9.40 in chips)
Seat 3: PlayTheBlues4U ($5.10 in chips)
Seat 4: traderneal ($11.25 in chips)
Seat 5: NBoula ($21.85 in chips)
Seat 6: Aikido85 ($7.65 in chips)
Aikido85: posts small blind $0.05
trumpcaddy: posts big blind $0.10
*** HOLE CARDS ***
Dealt to PlayTheBlues4U [9s 2c]
KeithTurbo48: raises $0.15 to $0.25
PlayTheBlues4U: folds
traderneal: folds
NBoula: folds
Aikido85: calls $0.20
trumpcaddy: folds
*** FLOP *** [9c 8d 8c]
Aikido85: bets $0.30
KeithTurbo48: folds
Uncalled bet ($0.30) returned to Aikido85
Aikido85 collected $0.57 from pot
Aikido85: doesn't show hand
*** SUMMARY ***
Total pot $0.60 | Rake $0.03
Board [9c 8d 8c]
Seat 1: trumpcaddy (big blind) folded before Flop
Seat 2: KeithTurbo48 folded on the Flop
Seat 3: PlayTheBlues4U folded before Flop (didn't bet)
Seat 4: traderneal folded before Flop (didn't bet)
Seat 5: NBoula (button) folded before Flop (didn't bet)
Seat 6: Aikido85 (small blind) collected ($0.57)


PokerStars Hand #203945144288:  Hold'em No Limit ($0.05/$0.10 USD) - 2019/09/24 23:46:15 ET
Table 'Botein' 6-max Seat #4 is the button
Seat 1: trumpcaddy ($12 in chips)
Seat 2: KeithTurbo48 ($9.40 in chips)
Seat 3: PlayTheBlues4U ($5.10 in chips)
Seat 4: traderneal ($11.25 in chips)
Seat 5: NBoula ($21.90 in chips)
Seat 6: Aikido85 ($7.60 in chips)
NBoula: posts small blind $0.05
Aikido85: posts big blind $0.10
*** HOLE CARDS ***
Dealt to PlayTheBlues4U [4c 6s]
trumpcaddy: folds
KeithTurbo48: folds
PlayTheBlues4U: folds
traderneal: folds
NBoula: folds
Uncalled bet ($0.05) returned to Aikido85
Aikido85 collected $0.10 from pot
Aikido85: doesn't show hand
*** SUMMARY ***
Total pot $0.10 | Rake $0
Seat 1: trumpcaddy folded before Flop (didn't bet)
Seat 2: KeithTurbo48 folded before Flop (didn't bet)
Seat 3: PlayTheBlues4U folded before Flop (didn't bet)
Seat 4: traderneal (button) folded before Flop (didn't bet)
Seat 5: NBoula (small blind) folded before Flop
Seat 6: Aikido85 (big blind) collected ($0.10)


PokerStars Hand #203945144157:  Hold'em No Limit ($0.05/$0.10 USD) - 2019/09/24 23:45:21 ET
Table 'Botein' 6-max Seat #3 is the button
Seat 1: trumpcaddy ($12 in chips)
Seat 2: KeithTurbo48 ($9.40 in chips)
Seat 3: PlayTheBlues4U ($5.10 in chips)
Seat 4: traderneal ($11.30 in chips)
Seat 5: NBoula ($22 in chips)
Seat 6: Aikido85 ($7.46 in chips)
traderneal: posts small blind $0.05
NBoula: posts big blind $0.10
*** HOLE CARDS ***
Dealt to PlayTheBlues4U [9h Jc]
Aikido85: calls $0.10
trumpcaddy: folds
KeithTurbo48: folds
PlayTheBlues4U: folds
traderneal: folds
NBoula: checks
*** FLOP *** [Kh 5c 6d]
NBoula: checks
Aikido85: checks
*** TURN *** [Kh 5c 6d] [2d]
NBoula: checks
Aikido85: checks
*** RIVER *** [Kh 5c 6d 2d] [Jd]
NBoula: checks
Aikido85: bets $0.30
NBoula: folds
Uncalled bet ($0.30) returned to Aikido85
Aikido85 collected $0.24 from pot
Aikido85: doesn't show hand
*** SUMMARY ***
Total pot $0.25 | Rake $0.01
Board [Kh 5c 6d 2d Jd]
Seat 1: trumpcaddy folded before Flop (didn't bet)
Seat 2: KeithTurbo48 folded before Flop (didn't bet)
Seat 3: PlayTheBlues4U (button) folded before Flop (didn't bet)
Seat 4: traderneal (small blind) folded before Flop
Seat 5: NBoula (big blind) folded on the River
Seat 6: Aikido85 collected ($0.24)


PokerStars Hand #203945144064:  Hold'em No Limit ($0.05/$0.10 USD) - 2019/09/24 23:44:42 ET
Table 'Botein' 6-max Seat #2 is the button
Seat 1: trumpcaddy ($12 in chips)
Seat 2: KeithTurbo48 ($10.35 in chips)
Seat 3: PlayTheBlues4U ($5.35 in chips)
Seat 4: traderneal ($10.21 in chips)
Seat 5: NBoula ($22 in chips)
Seat 6: Aikido85 ($7.46 in chips)
PlayTheBlues4U: posts small blind $0.05
traderneal: posts big blind $0.10
*** HOLE CARDS ***
Dealt to PlayTheBlues4U [7c 6c]
NBoula: folds
Aikido85: folds
trumpcaddy: folds
KeithTurbo48: raises $0.15 to $0.25
PlayTheBlues4U: calls $0.20
traderneal: calls $0.15
*** FLOP *** [Qs 3h 9d]
PlayTheBlues4U: checks
traderneal: checks
KeithTurbo48: checks
*** TURN *** [Qs 3h 9d] [Ac]
PlayTheBlues4U: checks
traderneal: checks
Aikido85 said, "who?"
KeithTurbo48: checks
*** RIVER *** [Qs 3h 9d Ac] [4d]
PlayTheBlues4U: checks
traderneal: bets $0.70
KeithTurbo48: calls $0.70
PlayTheBlues4U: folds
*** SHOW DOWN ***
traderneal: shows [4h 3d] (two pair, Fours and Threes)
KeithTurbo48: mucks hand
traderneal collected $2.04 from pot
*** SUMMARY ***
Total pot $2.15 | Rake $0.11
Board [Qs 3h 9d Ac 4d]
Seat 1: trumpcaddy folded before Flop (didn't bet)
Seat 2: KeithTurbo48 (button) mucked [9s 8h]
Seat 3: PlayTheBlues4U (small blind) folded on the River
Seat 4: traderneal (big blind) showed [4h 3d] and won ($2.04) with two pair, Fours and Threes
Seat 5: NBoula folded before Flop (didn't bet)
Seat 6: Aikido85 folded before Flop (didn't bet)


PokerStars Hand #203945143936:  Hold'em No Limit ($0.05/$0.10 USD) - 2019/09/24 23:43:51 ET
Table 'Botein' 6-max Seat #1 is the button
Seat 1: trumpcaddy ($12.50 in chips)
Seat 2: KeithTurbo48 ($10.45 in chips)
Seat 3: PlayTheBlues4U ($4.33 in chips)
Seat 4: traderneal ($10.71 in chips)
Seat 5: NBoula ($22 in chips)
Seat 6: Aikido85 ($7.46 in chips)
KeithTurbo48: posts small blind $0.05
PlayTheBlues4U: posts big blind $0.10
*** HOLE CARDS ***
Dealt to PlayTheBlues4U [Ts Th]
traderneal: calls $0.10
NBoula: folds
Aikido85: folds
trumpcaddy: calls $0.10
KeithTurbo48: calls $0.05
PlayTheBlues4U: raises $0.40 to $0.50
traderneal: calls $0.40
trumpcaddy: calls $0.40
KeithTurbo48: folds
*** FLOP *** [Qd 7h 7s]
PlayTheBlues4U: bets $0.90
traderneal: folds
trumpcaddy: folds
Uncalled bet ($0.90) returned to PlayTheBlues4U
PlayTheBlues4U collected $1.52 from pot
PlayTheBlues4U: doesn't show hand
*** SUMMARY ***
Total pot $1.60 | Rake $0.08
Board [Qd 7h 7s]
Seat 1: trumpcaddy (button) folded on the Flop
Seat 2: KeithTurbo48 (small blind) folded before Flop
Seat 3: PlayTheBlues4U (big blind) collected ($1.52)
Seat 4: traderneal folded on the Flop
Seat 5: NBoula folded before Flop (didn't bet)
Seat 6: Aikido85 folded before Flop (didn't bet)


PokerStars Hand #203945143830:  Hold'em No Limit ($0.05/$0.10 USD) - 2019/09/24 23:43:10 ET
Table 'Botein' 6-max Seat #6 is the button
Seat 1: trumpcaddy ($12.55 in chips)
Seat 2: KeithTurbo48 ($10.55 in chips)
Seat 3: PlayTheBlues4U ($4.33 in chips)
Seat 4: traderneal ($10.71 in chips)
Seat 5: NBoula ($22 in chips)
Seat 6: Aikido85 ($7.32 in chips)
trumpcaddy: posts small blind $0.05
KeithTurbo48: posts big blind $0.10
*** HOLE CARDS ***
Dealt to PlayTheBlues4U [Td 2s]
PlayTheBlues4U: folds
traderneal: folds
NBoula: folds
PlayTheBlues4U said, "can't. beat this guy lol"
Aikido85: calls $0.10
trumpcaddy: folds
KeithTurbo48: checks
*** FLOP *** [6c 6h As]
KeithTurbo48: checks
Aikido85: bets $0.30
KeithTurbo48: folds
Uncalled bet ($0.30) returned to Aikido85
Aikido85 collected $0.24 from pot
Aikido85: doesn't show hand
*** SUMMARY ***
Total pot $0.25 | Rake $0.01
Board [6c 6h As]
Seat 1: trumpcaddy (small blind) folded before Flop
Seat 2: KeithTurbo48 (big blind) folded on the Flop
Seat 3: PlayTheBlues4U folded before Flop (didn't bet)
Seat 4: traderneal folded before Flop (didn't bet)
Seat 5: NBoula folded before Flop (didn't bet)
Seat 6: Aikido85 (button) collected ($0.24)


PokerStars Hand #203945143676:  Hold'em No Limit ($0.05/$0.10 USD) - 2019/09/24 23:42:14 ET
Table 'Botein' 6-max Seat #5 is the button
Seat 1: trumpcaddy ($12.65 in chips)
Seat 2: KeithTurbo48 ($10.55 in chips)
Seat 3: PlayTheBlues4U ($7.68 in chips)
Seat 4: traderneal ($10.71 in chips)
Seat 5: NBoula ($22.90 in chips)
Seat 6: Aikido85 ($3.35 in chips)
Aikido85: posts small blind $0.05
trumpcaddy: posts big blind $0.10
*** HOLE CARDS ***
Dealt to PlayTheBlues4U [Ac Jd]
KeithTurbo48: folds
PlayTheBlues4U: raises $0.20 to $0.30
traderneal: folds
NBoula: calls $0.30
Aikido85: calls $0.25
trumpcaddy: folds
*** FLOP *** [4s As Qh]
Aikido85: checks
PlayTheBlues4U: bets $0.60
NBoula: calls $0.60
Aikido85: calls $0.60
*** TURN *** [4s As Qh] [5d]
Aikido85: bets $0.50
PlayTheBlues4U: raises $1.80 to $2.30
NBoula: folds
Aikido85: raises $0.15 to $2.45 and is all-in
PlayTheBlues4U: calls $0.15
*** RIVER *** [4s As Qh 5d] [8c]
*** SHOW DOWN ***
Aikido85: shows [Qd Ad] (two pair, Aces and Queens)
PlayTheBlues4U: shows [Ac Jd] (a pair of Aces)
Aikido85 collected $7.32 from pot
*** SUMMARY ***
Total pot $7.70 | Rake $0.38
Board [4s As Qh 5d 8c]
Seat 1: trumpcaddy (big blind) folded before Flop
Seat 2: KeithTurbo48 folded before Flop (didn't bet)
Seat 3: PlayTheBlues4U showed [Ac Jd] and lost with a pair of Aces
Seat 4: traderneal folded before Flop (didn't bet)
Seat 5: NBoula (button) folded on the Turn
Seat 6: Aikido85 (small blind) showed [Qd Ad] and won ($7.32) with two pair, Aces and Queens


PokerStars Hand #203945143563:  Hold'em No Limit ($0.05/$0.10 USD) - 2019/09/24 23:41:29 ET
Table 'Botein' 6-max Seat #4 is the button
Seat 1: trumpcaddy ($12.65 in chips)
Seat 2: KeithTurbo48 ($10.55 in chips)
Seat 3: PlayTheBlues4U ($7.68 in chips)
Seat 4: traderneal ($10.71 in chips)
Seat 5: NBoula ($23.10 in chips)
Seat 6: Aikido85 ($3.17 in chips)
NBoula: posts small blind $0.05
Aikido85: posts big blind $0.10
*** HOLE CARDS ***
Dealt to PlayTheBlues4U [2c Kd]
trumpcaddy: folds
KeithTurbo48: folds
PlayTheBlues4U: folds
traderneal: folds
NBoula: raises $0.10 to $0.20
Aikido85: calls $0.10
*** FLOP *** [Kh 3s Qs]
NBoula: checks
Aikido85: bets $0.30
NBoula: folds
Uncalled bet ($0.30) returned to Aikido85
Aikido85 collected $0.38 from pot
Aikido85: doesn't show hand
*** SUMMARY ***
Total pot $0.40 | Rake $0.02
Board [Kh 3s Qs]
Seat 1: trumpcaddy folded before Flop (didn't bet)
Seat 2: KeithTurbo48 folded before Flop (didn't bet)
Seat 3: PlayTheBlues4U folded before Flop (didn't bet)
Seat 4: traderneal (button) folded before Flop (didn't bet)
Seat 5: NBoula (small blind) folded on the Flop
Seat 6: Aikido85 (big blind) collected ($0.38)


PokerStars Hand #203945143464:  Hold'em No Limit ($0.05/$0.10 USD) - 2019/09/24 23:40:52 ET
Table 'Botein' 6-max Seat #3 is the button
Seat 1: trumpcaddy ($12.65 in chips)
Seat 2: KeithTurbo48 ($10.55 in chips)
Seat 3: PlayTheBlues4U ($7.68 in chips)
Seat 4: traderneal ($10.81 in chips)
Seat 5: NBoula ($23.20 in chips)
Seat 6: Aikido85 ($2.99 in chips)
traderneal: posts small blind $0.05
NBoula: posts big blind $0.10
*** HOLE CARDS ***
Dealt to PlayTheBlues4U [Jh 6d]
Aikido85: calls $0.10
trumpcaddy: folds
KeithTurbo48: folds
PlayTheBlues4U: folds
traderneal: calls $0.05
NBoula: checks
*** FLOP *** [2h Qc 5s]
traderneal: checks
NBoula: checks
Aikido85: checks
*** TURN *** [2h Qc 5s] [Qd]
traderneal: checks
NBoula: checks
Aikido85: bets $0.30
traderneal: folds
NBoula: folds
Uncalled bet ($0.30) returned to Aikido85
Aikido85 collected $0.28 from pot
Aikido85: doesn't show hand
*** SUMMARY ***
Total pot $0.30 | Rake $0.02
Board [2h Qc 5s Qd]
Seat 1: trumpcaddy folded before Flop (didn't bet)
Seat 2: KeithTurbo48 folded before Flop (didn't bet)
Seat 3: PlayTheBlues4U (button) folded before Flop (didn't bet)
Seat 4: traderneal (small blind) folded on the Turn
Seat 5: NBoula (big blind) folded on the Turn
Seat 6: Aikido85 collected ($0.28)


PokerStars Hand #203945143343:  Hold'em No Limit ($0.05/$0.10 USD) - 2019/09/24 23:40:04 ET
Table 'Camilla' 6-max Seat #5 is the button
Seat 2: yuni80 ($12.63 in chips)
Seat 4: SeaofLove ($19.42 in chips)
Seat 5: PlayTheBlues4U ($16.79 in chips)
yuni80: posts small blind $0.05
SeaofLove: posts big blind $0.10
*** HOLE CARDS ***
Dealt to PlayTheBlues4U [Kc 4c]
PlayTheBlues4U: folds
yuni80: calls $0.05
SeaofLove: checks
*** FLOP *** [3s Ah Qs]
yuni80: checks
SeaofLove: checks
*** TURN *** [3s Ah Qs] [6d]
yuni80: checks
SeaofLove: checks
*** RIVER *** [3s Ah Qs 6d] [5s]
yuni80: bets $2.10
SeaofLove: folds
Uncalled bet ($2.10) returned to yuni80
yuni80 collected $0.19 from pot
yuni80: doesn't show hand
*** SUMMARY ***
Total pot $0.20 | Rake $0.01
Board [3s Ah Qs 6d 5s]
Seat 2: yuni80 (small blind) collected ($0.19)
Seat 4: SeaofLove (big blind) folded on the River
Seat 5: PlayTheBlues4U (button) folded before Flop (didn't bet)


PokerStars Hand #203945143339:  Hold'em No Limit ($0.05/$0.10 USD) - 2019/09/24 23:40:02 ET
Table 'Botein' 6-max Seat #2 is the button
Seat 1: trumpcaddy ($13.85 in chips)
Seat 2: KeithTurbo48 ($10.55 in chips)
Seat 3: PlayTheBlues4U ($7.73 in chips)
Seat 4: traderneal ($9.40 in chips)
Seat 5: NBoula ($23.20 in chips)
Seat 6: Aikido85 ($3.29 in chips)
PlayTheBlues4U: posts small blind $0.05
traderneal: posts big blind $0.10
*** HOLE CARDS ***
Dealt to PlayTheBlues4U [Qs 8h]
NBoula: folds
Aikido85: calls $0.10
trumpcaddy: calls $0.10
KeithTurbo48: folds
PlayTheBlues4U: folds
traderneal: raises $0.20 to $0.30
Aikido85: calls $0.20
trumpcaddy: calls $0.20
*** FLOP *** [2s Ks 7c]
traderneal: bets $0.90
Aikido85: folds
trumpcaddy: calls $0.90
*** TURN *** [2s Ks 7c] [Jc]
traderneal: bets $1.30
trumpcaddy: folds
Uncalled bet ($1.30) returned to traderneal
traderneal collected $2.61 from pot
traderneal: doesn't show hand
*** SUMMARY ***
Total pot $2.75 | Rake $0.14
Board [2s Ks 7c Jc]
Seat 1: trumpcaddy folded on the Turn
Seat 2: KeithTurbo48 (button) folded before Flop (didn't bet)
Seat 3: PlayTheBlues4U (small blind) folded before Flop
Seat 4: traderneal (big blind) collected ($2.61)
Seat 5: NBoula folded before Flop (didn't bet)
Seat 6: Aikido85 folded on the Flop


PokerStars Hand #203945143287:  Hold'em No Limit ($0.05/$0.10 USD) - 2019/09/24 23:39:43 ET
Table 'Botein' 6-max Seat #1 is the button
Seat 1: trumpcaddy ($13.85 in chips)
Seat 2: KeithTurbo48 ($10.60 in chips)
Seat 3: PlayTheBlues4U ($7.83 in chips)
Seat 4: traderneal ($9.40 in chips)
Seat 5: NBoula ($23.05 in chips)
Seat 6: Aikido85 ($3.29 in chips)
KeithTurbo48: posts small blind $0.05
PlayTheBlues4U: posts big blind $0.10
*** HOLE CARDS ***
Dealt to PlayTheBlues4U [9s Jh]
traderneal: folds
NBoula: raises $0.20 to $0.30
Aikido85: folds
trumpcaddy: folds
KeithTurbo48: folds
PlayTheBlues4U: folds
Uncalled bet ($0.20) returned to NBoula
NBoula collected $0.25 from pot
NBoula: doesn't show hand
*** SUMMARY ***
Total pot $0.25 | Rake $0
Seat 1: trumpcaddy (button) folded before Flop (didn't bet)
Seat 2: KeithTurbo48 (small blind) folded before Flop
Seat 3: PlayTheBlues4U (big blind) folded before Flop
Seat 4: traderneal folded before Flop (didn't bet)
Seat 5: NBoula collected ($0.25)
Seat 6: Aikido85 folded before Flop (didn't bet)


PokerStars Hand #203945143285:  Hold'em No Limit ($0.05/$0.10 USD) - 2019/09/24 23:39:43 ET
Table 'Camilla' 6-max Seat #4 is the button
Seat 2: yuni80 ($12.54 in chips)
Seat 4: SeaofLove ($19.42 in chips)
Seat 5: PlayTheBlues4U ($16.89 in chips)
PlayTheBlues4U: posts small blind $0.05
yuni80: posts big blind $0.10
*** HOLE CARDS ***
Dealt to PlayTheBlues4U [8d 9d]
SeaofLove: folds
PlayTheBlues4U: calls $0.05
yuni80: checks
*** FLOP *** [6h Kh 5c]
PlayTheBlues4U: checks
yuni80: checks
*** TURN *** [6h Kh 5c] [2s]
PlayTheBlues4U: checks
yuni80: checks
*** RIVER *** [6h Kh 5c 2s] [3d]
PlayTheBlues4U: checks
yuni80: bets $0.10
PlayTheBlues4U: folds
Uncalled bet ($0.10) returned to yuni80
yuni80 collected $0.19 from pot
yuni80: doesn't show hand
*** SUMMARY ***
Total pot $0.20 | Rake $0.01
Board [6h Kh 5c 2s 3d]
Seat 2: yuni80 (big blind) collected ($0.19)
Seat 4: SeaofLove (button) folded before Flop (didn't bet)
Seat 5: PlayTheBlues4U (small blind) folded on the River


PokerStars Hand #203945143229:  Hold'em No Limit ($0.05/$0.10 USD) - 2019/09/24 23:39:22 ET
Table 'Camilla' 6-max Seat #2 is the button
Seat 2: yuni80 ($12.64 in chips)
Seat 4: SeaofLove ($19.47 in chips)
Seat 5: PlayTheBlues4U ($16.75 in chips)
SeaofLove: posts small blind $0.05
PlayTheBlues4U: posts big blind $0.10
*** HOLE CARDS ***
Dealt to PlayTheBlues4U [6c Js]
yuni80: calls $0.10
SeaofLove: folds
PlayTheBlues4U: checks
*** FLOP *** [Th Jh 3s]
PlayTheBlues4U: checks
yuni80: checks
*** TURN *** [Th Jh 3s] [4s]
PlayTheBlues4U: bets $0.20
yuni80: folds
Uncalled bet ($0.20) returned to PlayTheBlues4U
PlayTheBlues4U collected $0.24 from pot
PlayTheBlues4U: doesn't show hand
*** SUMMARY ***
Total pot $0.25 | Rake $0.01
Board [Th Jh 3s 4s]
Seat 2: yuni80 (button) folded on the Turn
Seat 4: SeaofLove (small blind) folded before Flop
Seat 5: PlayTheBlues4U (big blind) collected ($0.24)


PokerStars Hand #203945143184:  Hold'em No Limit ($0.05/$0.10 USD) - 2019/09/24 23:39:00 ET
Table 'Camilla' 6-max Seat #5 is the button
Seat 2: yuni80 ($12.94 in chips)
Seat 4: SeaofLove ($19.57 in chips)
Seat 5: PlayTheBlues4U ($16.39 in chips)
yuni80: posts small blind $0.05
SeaofLove: posts big blind $0.10
*** HOLE CARDS ***
Dealt to PlayTheBlues4U [Ah Kd]
PlayTheBlues4U: raises $0.20 to $0.30
yuni80: calls $0.25
SeaofLove: folds
*** FLOP *** [3s Js 3d]
yuni80: checks
PlayTheBlues4U: checks
*** TURN *** [3s Js 3d] [Jc]
yuni80: checks
PlayTheBlues4U: checks
*** RIVER *** [3s Js 3d Jc] [8d]
yuni80: checks
PlayTheBlues4U: checks
*** SHOW DOWN ***
yuni80: shows [Th 5h] (two pair, Jacks and Threes)
PlayTheBlues4U: shows [Ah Kd] (two pair, Jacks and Threes - Ace kicker)
PlayTheBlues4U collected $0.66 from pot
*** SUMMARY ***
Total pot $0.70 | Rake $0.04
Board [3s Js 3d Jc 8d]
Seat 2: yuni80 (small blind) showed [Th 5h] and lost with two pair, Jacks and Threes
Seat 4: SeaofLove (big blind) folded before Flop
Seat 5: PlayTheBlues4U (button) showed [Ah Kd] and won ($0.66) with two pair, Jacks and Threes


PokerStars Hand #203945143179:  Hold'em No Limit ($0.05/$0.10 USD) - 2019/09/24 23:38:58 ET
Table 'Botein' 6-max Seat #6 is the button
Seat 1: trumpcaddy ($13.90 in chips)
Seat 2: KeithTurbo48 ($10.70 in chips)
Seat 3: PlayTheBlues4U ($7.83 in chips)
Seat 4: traderneal ($9.40 in chips)
Seat 5: NBoula ($23.05 in chips)
Seat 6: Aikido85 ($3.15 in chips)
trumpcaddy: posts small blind $0.05
KeithTurbo48: posts big blind $0.10
*** HOLE CARDS ***
Dealt to PlayTheBlues4U [8c 5s]
PlayTheBlues4U: folds
traderneal: folds
NBoula: folds
Aikido85: calls $0.10
trumpcaddy: folds
KeithTurbo48: checks
*** FLOP *** [8d 5h Ts]
KeithTurbo48: checks
Aikido85: checks
*** TURN *** [8d 5h Ts] [As]
KeithTurbo48: checks
Aikido85: bets $0.10
KeithTurbo48: folds
Uncalled bet ($0.10) returned to Aikido85
Aikido85 collected $0.24 from pot
Aikido85: doesn't show hand
*** SUMMARY ***
Total pot $0.25 | Rake $0.01
Board [8d 5h Ts As]
Seat 1: trumpcaddy (small blind) folded before Flop
Seat 2: KeithTurbo48 (big blind) folded on the Turn
Seat 3: PlayTheBlues4U folded before Flop (didn't bet)
Seat 4: traderneal folded before Flop (didn't bet)
Seat 5: NBoula folded before Flop (didn't bet)
Seat 6: Aikido85 (button) collected ($0.24)


PokerStars Hand #203945143147:  Hold'em No Limit ($0.05/$0.10 USD) - 2019/09/24 23:38:49 ET
Table 'Camilla' 6-max Seat #4 is the button
Seat 2: yuni80 ($12.89 in chips)
Seat 4: SeaofLove ($19.57 in chips)
Seat 5: PlayTheBlues4U ($16.44 in chips)
PlayTheBlues4U: posts small blind $0.05
yuni80: posts big blind $0.10
*** HOLE CARDS ***
Dealt to PlayTheBlues4U [4d 8s]
SeaofLove: folds
PlayTheBlues4U: folds
Uncalled bet ($0.05) returned to yuni80
yuni80 collected $0.10 from pot
yuni80: doesn't show hand
*** SUMMARY ***
Total pot $0.10 | Rake $0
Seat 2: yuni80 (big blind) collected ($0.10)
Seat 4: SeaofLove (button) folded before Flop (didn't bet)
Seat 5: PlayTheBlues4U (small blind) folded before Flop


PokerStars Hand #203945143093:  Hold'em No Limit ($0.05/$0.10 USD) - 2019/09/24 23:38:30 ET
Table 'Camilla' 6-max Seat #2 is the button
Seat 2: yuni80 ($12.99 in chips)
Seat 4: SeaofLove ($19.62 in chips)
Seat 5: PlayTheBlues4U ($16.30 in chips)
SeaofLove: posts small blind $0.05
PlayTheBlues4U: posts big blind $0.10
*** HOLE CARDS ***
Dealt to PlayTheBlues4U [Kc 8h]
yuni80: calls $0.10
SeaofLove: folds
PlayTheBlues4U: checks
*** FLOP *** [5c Kd 7h]
PlayTheBlues4U: bets $0.10
yuni80: folds
Uncalled bet ($0.10) returned to PlayTheBlues4U
PlayTheBlues4U collected $0.24 from pot
PlayTheBlues4U: doesn't show hand
*** SUMMARY ***
Total pot $0.25 | Rake $0.01
Board [5c Kd 7h]
Seat 2: yuni80 (button) folded on the Flop
Seat 4: SeaofLove (small blind) folded before Flop
Seat 5: PlayTheBlues4U (big blind) collected ($0.24)


PokerStars Hand #203945143010:  Hold'em No Limit ($0.05/$0.10 USD) - 2019/09/24 23:38:03 ET
Table 'Botein' 6-max Seat #5 is the button
Seat 1: trumpcaddy ($14 in chips)
Seat 2: KeithTurbo48 ($10.70 in chips)
Seat 3: PlayTheBlues4U ($8.13 in chips)
Seat 4: traderneal ($8.46 in chips)
Seat 5: NBoula ($23.35 in chips)
Seat 6: Aikido85 ($3.45 in chips)
Aikido85: posts small blind $0.05
trumpcaddy: posts big blind $0.10
*** HOLE CARDS ***
Dealt to PlayTheBlues4U [9h As]
KeithTurbo48: folds
PlayTheBlues4U: calls $0.10
traderneal: calls $0.10
NBoula: raises $0.20 to $0.30
Aikido85: calls $0.25
trumpcaddy: folds
PlayTheBlues4U: calls $0.20
traderneal: calls $0.20
*** FLOP *** [4d 4s Qc]
Aikido85: checks
PlayTheBlues4U: checks
traderneal: bets $0.30
NBoula: folds
Aikido85: folds
PlayTheBlues4U: folds
Uncalled bet ($0.30) returned to traderneal
traderneal collected $1.24 from pot
traderneal: doesn't show hand
*** SUMMARY ***
Total pot $1.30 | Rake $0.06
Board [4d 4s Qc]
Seat 1: trumpcaddy (big blind) folded before Flop
Seat 2: KeithTurbo48 folded before Flop (didn't bet)
Seat 3: PlayTheBlues4U folded on the Flop
Seat 4: traderneal collected ($1.24)
Seat 5: NBoula (button) folded on the Flop
Seat 6: Aikido85 (small blind) folded on the Flop


PokerStars Hand #203945143008:  Hold'em No Limit ($0.05/$0.10 USD) - 2019/09/24 23:38:02 ET
Table 'Camilla' 6-max Seat #5 is the button
Seat 2: yuni80 ($12.90 in chips)
Seat 4: SeaofLove ($19.72 in chips)
Seat 5: PlayTheBlues4U ($16.30 in chips)
yuni80: posts small blind $0.05
SeaofLove: posts big blind $0.10
*** HOLE CARDS ***
Dealt to PlayTheBlues4U [5d Th]
PlayTheBlues4U: folds
yuni80: calls $0.05
SeaofLove: checks
*** FLOP *** [7s 8d 4c]
yuni80: checks
SeaofLove: checks
*** TURN *** [7s 8d 4c] [2h]
yuni80: checks
SeaofLove: checks
*** RIVER *** [7s 8d 4c 2h] [9c]
yuni80: checks
SeaofLove: checks
*** SHOW DOWN ***
yuni80: shows [9h Ah] (a pair of Nines)
SeaofLove: mucks hand
yuni80 collected $0.19 from pot
*** SUMMARY ***
Total pot $0.20 | Rake $0.01
Board [7s 8d 4c 2h 9c]
Seat 2: yuni80 (small blind) showed [9h Ah] and won ($0.19) with a pair of Nines
Seat 4: SeaofLove (big blind) mucked [4h 5c]
Seat 5: PlayTheBlues4U (button) folded before Flop (didn't bet)


PokerStars Hand #203945142881:  Hold'em No Limit ($0.05/$0.10 USD) - 2019/09/24 23:37:21 ET
Table 'Botein' 6-max Seat #4 is the button
Seat 1: trumpcaddy ($14 in chips)
Seat 2: KeithTurbo48 ($10.70 in chips)
Seat 3: PlayTheBlues4U ($8.13 in chips)
Seat 4: traderneal ($10.86 in chips)
Seat 5: NBoula ($21.09 in chips)
Seat 6: Aikido85 ($3.55 in chips)
NBoula: posts small blind $0.05
Aikido85: posts big blind $0.10
*** HOLE CARDS ***
Dealt to PlayTheBlues4U [7h Kh]
trumpcaddy: folds
KeithTurbo48: folds
PlayTheBlues4U: folds
traderneal: calls $0.10
NBoula: raises $0.20 to $0.30
Aikido85: folds
traderneal: calls $0.20
*** FLOP *** [8s 8c Ts]
NBoula: bets $0.30
traderneal: calls $0.30
*** TURN *** [8s 8c Ts] [9d]
NBoula: checks
traderneal: bets $0.60
NBoula: calls $0.60
*** RIVER *** [8s 8c Ts 9d] [5h]
NBoula: checks
traderneal: bets $1.20
NBoula: calls $1.20
*** SHOW DOWN ***
traderneal: shows [9h 7d] (two pair, Nines and Eights)
NBoula: shows [Ah Th] (two pair, Tens and Eights)
NBoula collected $4.66 from pot
*** SUMMARY ***
Total pot $4.90 | Rake $0.24
Board [8s 8c Ts 9d 5h]
Seat 1: trumpcaddy folded before Flop (didn't bet)
Seat 2: KeithTurbo48 folded before Flop (didn't bet)
Seat 3: PlayTheBlues4U folded before Flop (didn't bet)
Seat 4: traderneal (button) showed [9h 7d] and lost with two pair, Nines and Eights
Seat 5: NBoula (small blind) showed [Ah Th] and won ($4.66) with two pair, Tens and Eights
Seat 6: Aikido85 (big blind) folded before Flop


PokerStars Hand #203945142877:  Hold'em No Limit ($0.05/$0.10 USD) - 2019/09/24 23:37:18 ET
Table 'Camilla' 6-max Seat #4 is the button
Seat 2: yuni80 ($12.72 in chips)
Seat 3: KeithTurbo48 ($22.19 in chips)
Seat 4: SeaofLove ($19.72 in chips)
Seat 5: PlayTheBlues4U ($16.50 in chips)
PlayTheBlues4U: posts small blind $0.05
yuni80: posts big blind $0.10
*** HOLE CARDS ***
Dealt to PlayTheBlues4U [9s Qd]
KeithTurbo48: folds
KeithTurbo48 leaves the table
SeaofLove: folds
PlayTheBlues4U: calls $0.05
yuni80: checks
*** FLOP *** [Jh 7s Jc]
PlayTheBlues4U: checks
yuni80: checks
*** TURN *** [Jh 7s Jc] [8s]
PlayTheBlues4U: checks
yuni80: checks
*** RIVER *** [Jh 7s Jc 8s] [9h]
PlayTheBlues4U: bets $0.10
yuni80: raises $1.50 to $1.60
PlayTheBlues4U: folds
Uncalled bet ($1.50) returned to yuni80
yuni80 collected $0.38 from pot
yuni80: doesn't show hand
*** SUMMARY ***
Total pot $0.40 | Rake $0.02
Board [Jh 7s Jc 8s 9h]
Seat 2: yuni80 (big blind) collected ($0.38)
Seat 3: KeithTurbo48 folded before Flop (didn't bet)
Seat 4: SeaofLove (button) folded before Flop (didn't bet)
Seat 5: PlayTheBlues4U (small blind) folded on the River


PokerStars Hand #203945142645:  Hold'em No Limit ($0.05/$0.10 USD) - 2019/09/24 23:36:03 ET
Table 'Camilla' 6-max Seat #3 is the button
Seat 2: yuni80 ($16.52 in chips)
Seat 3: KeithTurbo48 ($25.99 in chips)
Seat 4: SeaofLove ($20.12 in chips)
Seat 5: PlayTheBlues4U ($9.09 in chips)
SeaofLove: posts small blind $0.05
PlayTheBlues4U: posts big blind $0.10
*** HOLE CARDS ***
Dealt to PlayTheBlues4U [Ah Kd]
yuni80: calls $0.10
KeithTurbo48: raises $0.30 to $0.40
SeaofLove: calls $0.35
PlayTheBlues4U: raises $0.60 to $1
yuni80: calls $0.90
KeithTurbo48: raises $2.80 to $3.80
SeaofLove: folds
PlayTheBlues4U: calls $2.80
yuni80: calls $2.80
*** FLOP *** [Td Qd 2d]
PlayTheBlues4U: checks
yuni80: checks
KeithTurbo48: checks
*** TURN *** [Td Qd 2d] [5h]
PlayTheBlues4U: bets $5.29 and is all-in
yuni80: folds
KeithTurbo48: folds
Uncalled bet ($5.29) returned to PlayTheBlues4U
PlayTheBlues4U collected $11.21 from pot
PlayTheBlues4U: doesn't show hand
*** SUMMARY ***
Total pot $11.80 | Rake $0.59
Board [Td Qd 2d 5h]
Seat 2: yuni80 folded on the Turn
Seat 3: KeithTurbo48 (button) folded on the Turn
Seat 4: SeaofLove (small blind) folded before Flop
Seat 5: PlayTheBlues4U (big blind) collected ($11.21)


PokerStars Hand #203945142579:  Hold'em No Limit ($0.05/$0.10 USD) - 2019/09/24 23:35:41 ET
Table 'Botein' 6-max Seat #3 is the button
Seat 1: trumpcaddy ($14 in chips)
Seat 2: KeithTurbo48 ($10.90 in chips)
Seat 3: PlayTheBlues4U ($8.13 in chips)
Seat 4: traderneal ($10.96 in chips)
Seat 5: NBoula ($20.81 in chips)
Seat 6: Aikido85 ($3.55 in chips)
traderneal: posts small blind $0.05
NBoula: posts big blind $0.10
KeithTurbo48: posts big blind $0.10
*** HOLE CARDS ***
Dealt to PlayTheBlues4U [2c 9d]
Aikido85: folds
trumpcaddy: folds
KeithTurbo48: checks
PlayTheBlues4U: folds
traderneal: calls $0.05
NBoula: checks
*** FLOP *** [Qh Tc 7s]
traderneal: checks
NBoula: bets $0.10
KeithTurbo48: calls $0.10
traderneal: folds
*** TURN *** [Qh Tc 7s] [Ad]
NBoula: checks
KeithTurbo48: checks
*** RIVER *** [Qh Tc 7s Ad] [As]
NBoula: checks
KeithTurbo48: checks
*** SHOW DOWN ***
NBoula: shows [4c Th] (two pair, Aces and Tens)
KeithTurbo48: mucks hand
NBoula collected $0.48 from pot
*** SUMMARY ***
Total pot $0.50 | Rake $0.02
Board [Qh Tc 7s Ad As]
Seat 1: trumpcaddy folded before Flop (didn't bet)
Seat 2: KeithTurbo48 mucked [6s 8h]
Seat 3: PlayTheBlues4U (button) folded before Flop (didn't bet)
Seat 4: traderneal (small blind) folded on the Flop
Seat 5: NBoula (big blind) showed [4c Th] and won ($0.48) with two pair, Aces and Tens
Seat 6: Aikido85 folded before Flop (didn't bet)


PokerStars Hand #203945142573:  Hold'em No Limit ($0.05/$0.10 USD) - 2019/09/24 23:35:40 ET
Table 'Camilla' 6-max Seat #2 is the button
Seat 2: yuni80 ($16.62 in chips)
Seat 3: KeithTurbo48 ($25.81 in chips)
Seat 4: SeaofLove ($20.22 in chips)
Seat 5: PlayTheBlues4U ($9.09 in chips)
KeithTurbo48: posts small blind $0.05
SeaofLove: posts big blind $0.10
*** HOLE CARDS ***
Dealt to PlayTheBlues4U [Jd 5d]
PlayTheBlues4U: folds
yuni80: calls $0.10
KeithTurbo48: calls $0.05
SeaofLove: checks
*** FLOP *** [4c 6h 2d]
KeithTurbo48: checks
SeaofLove: checks
yuni80: checks
*** TURN *** [4c 6h 2d] [Ks]
KeithTurbo48: checks
SeaofLove: checks
yuni80: checks
*** RIVER *** [4c 6h 2d Ks] [9s]
KeithTurbo48: checks
SeaofLove: checks
yuni80: checks
*** SHOW DOWN ***
KeithTurbo48: shows [9c 8h] (a pair of Nines)
SeaofLove: mucks hand
yuni80: mucks hand
KeithTurbo48 collected $0.28 from pot
*** SUMMARY ***
Total pot $0.30 | Rake $0.02
Board [4c 6h 2d Ks 9s]
Seat 2: yuni80 (button) mucked [6s Qc]
Seat 3: KeithTurbo48 (small blind) showed [9c 8h] and won ($0.28) with a pair of Nines
Seat 4: SeaofLove (big blind) mucked [7s 3c]
Seat 5: PlayTheBlues4U folded before Flop (didn't bet)


PokerStars Hand #203945142474:  Hold'em No Limit ($0.05/$0.10 USD) - 2019/09/24 23:35:06 ET
Table 'Camilla' 6-max Seat #5 is the button
Seat 2: yuni80 ($16.17 in chips)
Seat 3: KeithTurbo48 ($26.31 in chips)
Seat 4: SeaofLove ($20.22 in chips)
Seat 5: PlayTheBlues4U ($9.09 in chips)
yuni80: posts small blind $0.05
KeithTurbo48: posts big blind $0.10
*** HOLE CARDS ***
Dealt to PlayTheBlues4U [5s 8d]
SeaofLove: folds
PlayTheBlues4U: folds
yuni80: calls $0.05
KeithTurbo48: raises $0.20 to $0.30
yuni80: calls $0.20
*** FLOP *** [Td 5d As]
yuni80: checks
KeithTurbo48: checks
*** TURN *** [Td 5d As] [Ac]
yuni80: checks
KeithTurbo48: bets $0.20
yuni80: calls $0.20
*** RIVER *** [Td 5d As Ac] [8c]
yuni80: checks
KeithTurbo48: checks
*** SHOW DOWN ***
yuni80: shows [Ts 3s] (two pair, Aces and Tens)
KeithTurbo48: mucks hand
yuni80 collected $0.95 from pot
*** SUMMARY ***
Total pot $1 | Rake $0.05
Board [Td 5d As Ac 8c]
Seat 2: yuni80 (small blind) showed [Ts 3s] and won ($0.95) with two pair, Aces and Tens
Seat 3: KeithTurbo48 (big blind) mucked [9h Kd]
Seat 4: SeaofLove folded before Flop (didn't bet)
Seat 5: PlayTheBlues4U (button) folded before Flop (didn't bet)


PokerStars Hand #203945142454:  Hold'em No Limit ($0.05/$0.10 USD) - 2019/09/24 23:34:57 ET
Table 'Botein' 6-max Seat #1 is the button
Seat 1: trumpcaddy ($14 in chips)
Seat 3: PlayTheBlues4U ($8.18 in chips)
Seat 4: traderneal ($10 in chips)
Seat 5: NBoula ($21.51 in chips)
Seat 6: Aikido85 ($3.85 in chips)
KeithTurbo48 will be allowed to play after the button
PlayTheBlues4U: posts small blind $0.05
traderneal: posts big blind $0.10
*** HOLE CARDS ***
Dealt to PlayTheBlues4U [3s Qc]
NBoula: raises $0.20 to $0.30
Aikido85: calls $0.30
trumpcaddy: folds
PlayTheBlues4U: folds
traderneal: calls $0.20
*** FLOP *** [9s 8s 6h]
traderneal: checks
NBoula: bets $0.40
Aikido85: folds
traderneal: calls $0.40
*** TURN *** [9s 8s 6h] [Ad]
traderneal: checks
NBoula: checks
*** RIVER *** [9s 8s 6h Ad] [4h]
traderneal: bets $1.70
NBoula: folds
Uncalled bet ($1.70) returned to traderneal
traderneal collected $1.66 from pot
traderneal: doesn't show hand
*** SUMMARY ***
Total pot $1.75 | Rake $0.09
Board [9s 8s 6h Ad 4h]
Seat 1: trumpcaddy (button) folded before Flop (didn't bet)
Seat 3: PlayTheBlues4U (small blind) folded before Flop
Seat 4: traderneal (big blind) collected ($1.66)
Seat 5: NBoula folded on the River
Seat 6: Aikido85 folded on the Flop


PokerStars Hand #203945142408:  Hold'em No Limit ($0.05/$0.10 USD) - 2019/09/24 23:34:40 ET
Table 'Camilla' 6-max Seat #4 is the button
Seat 2: yuni80 ($16.42 in chips)
Seat 3: KeithTurbo48 ($26.31 in chips)
Seat 4: SeaofLove ($20.47 in chips)
Seat 5: PlayTheBlues4U ($8.63 in chips)
PlayTheBlues4U: posts small blind $0.05
yuni80: posts big blind $0.10
*** HOLE CARDS ***
Dealt to PlayTheBlues4U [2d 2s]
KeithTurbo48: folds
SeaofLove: raises $0.15 to $0.25
PlayTheBlues4U: calls $0.20
yuni80: calls $0.15
*** FLOP *** [3d 9h Qd]
PlayTheBlues4U: checks
yuni80: checks
SeaofLove: checks
*** TURN *** [3d 9h Qd] [9c]
PlayTheBlues4U: bets $0.40
yuni80: folds
SeaofLove: folds
Uncalled bet ($0.40) returned to PlayTheBlues4U
PlayTheBlues4U collected $0.71 from pot
PlayTheBlues4U: doesn't show hand
*** SUMMARY ***
Total pot $0.75 | Rake $0.04
Board [3d 9h Qd 9c]
Seat 2: yuni80 (big blind) folded on the Turn
Seat 3: KeithTurbo48 folded before Flop (didn't bet)
Seat 4: SeaofLove (button) folded on the Turn
Seat 5: PlayTheBlues4U (small blind) collected ($0.71)


PokerStars Hand #203945142347:  Hold'em No Limit ($0.05/$0.10 USD) - 2019/09/24 23:34:17 ET
Table 'Botein' 6-max Seat #6 is the button
Seat 1: trumpcaddy ($14.05 in chips)
Seat 3: PlayTheBlues4U ($8.04 in chips)
Seat 4: traderneal ($10 in chips)
Seat 5: NBoula ($21.51 in chips)
Seat 6: Aikido85 ($3.95 in chips)
trumpcaddy: posts small blind $0.05
Pezant: is sitting out
PlayTheBlues4U: posts big blind $0.10
*** HOLE CARDS ***
Dealt to PlayTheBlues4U [5h 8s]
traderneal: folds
Pezant leaves the table
NBoula: folds
KeithTurbo48 joins the table at seat #2
Aikido85: calls $0.10
trumpcaddy: folds
PlayTheBlues4U: checks
*** FLOP *** [5d Ts Tc]
PlayTheBlues4U: checks
Aikido85: checks
*** TURN *** [5d Ts Tc] [2s]
PlayTheBlues4U: bets $0.20
Aikido85: folds
Uncalled bet ($0.20) returned to PlayTheBlues4U
PlayTheBlues4U collected $0.24 from pot
PlayTheBlues4U: doesn't show hand
*** SUMMARY ***
Total pot $0.25 | Rake $0.01
Board [5d Ts Tc 2s]
Seat 1: trumpcaddy (small blind) folded before Flop
Seat 3: PlayTheBlues4U (big blind) collected ($0.24)
Seat 4: traderneal folded before Flop (didn't bet)
Seat 5: NBoula folded before Flop (didn't bet)
Seat 6: Aikido85 (button) folded on the Turn


PokerStars Hand #203945142290:  Hold'em No Limit ($0.05/$0.10 USD) - 2019/09/24 23:34:00 ET
Table 'Camilla' 6-max Seat #3 is the button
Seat 2: yuni80 ($16.42 in chips)
Seat 3: KeithTurbo48 ($26.31 in chips)
Seat 4: SeaofLove ($19.86 in chips)
Seat 5: PlayTheBlues4U ($9.31 in chips)
SeaofLove: posts small blind $0.05
PlayTheBlues4U: posts big blind $0.10
*** HOLE CARDS ***
Dealt to PlayTheBlues4U [7c Kh]
yuni80: folds
KeithTurbo48: folds
SeaofLove: raises $0.20 to $0.30
PlayTheBlues4U: calls $0.20
*** FLOP *** [2s 5c 7h]
SeaofLove: bets $0.38
PlayTheBlues4U: calls $0.38
*** TURN *** [2s 5c 7h] [As]
SeaofLove: bets $0.70
PlayTheBlues4U: folds
Uncalled bet ($0.70) returned to SeaofLove
SeaofLove collected $1.29 from pot
SeaofLove: doesn't show hand
*** SUMMARY ***
Total pot $1.36 | Rake $0.07
Board [2s 5c 7h As]
Seat 2: yuni80 folded before Flop (didn't bet)
Seat 3: KeithTurbo48 (button) folded before Flop (didn't bet)
Seat 4: SeaofLove (small blind) collected ($1.29)
Seat 5: PlayTheBlues4U (big blind) folded on the Turn


PokerStars Hand #203945142287:  Hold'em No Limit ($0.05/$0.10 USD) - 2019/09/24 23:34:00 ET
Table 'Botein' 6-max Seat #5 is the button
Seat 1: trumpcaddy ($14.15 in chips)
Seat 2: Pezant ($10.68 in chips)
Seat 3: PlayTheBlues4U ($8.04 in chips)
Seat 5: NBoula ($21.36 in chips)
Seat 6: Aikido85 ($4 in chips)
Aikido85: posts small blind $0.05
trumpcaddy: posts big blind $0.10
*** HOLE CARDS ***
Dealt to PlayTheBlues4U [6d 8h]
Pezant: folds
PlayTheBlues4U: folds
NBoula: raises $0.20 to $0.30
Aikido85: folds
trumpcaddy: folds
Uncalled bet ($0.20) returned to NBoula
NBoula collected $0.25 from pot
NBoula: doesn't show hand
*** SUMMARY ***
Total pot $0.25 | Rake $0
Seat 1: trumpcaddy (big blind) folded before Flop
Seat 2: Pezant folded before Flop (didn't bet)
Seat 3: PlayTheBlues4U folded before Flop (didn't bet)
Seat 5: NBoula (button) collected ($0.25)
Seat 6: Aikido85 (small blind) folded before Flop


PokerStars Hand #203945142228:  Hold'em No Limit ($0.05/$0.10 USD) - 2019/09/24 23:33:38 ET
Table 'Camilla' 6-max Seat #2 is the button
Seat 2: yuni80 ($16.72 in chips)
Seat 3: KeithTurbo48 ($26.36 in chips)
Seat 4: SeaofLove ($19.96 in chips)
Seat 5: PlayTheBlues4U ($8.90 in chips)
KeithTurbo48: posts small blind $0.05
SeaofLove: posts big blind $0.10
*** HOLE CARDS ***
Dealt to PlayTheBlues4U [Td 7d]
PlayTheBlues4U: raises $0.20 to $0.30
yuni80: calls $0.30
KeithTurbo48: folds
SeaofLove: folds
*** FLOP *** [8c 8h 3s]
PlayTheBlues4U: bets $0.40
yuni80: folds
Uncalled bet ($0.40) returned to PlayTheBlues4U
PlayTheBlues4U collected $0.71 from pot
PlayTheBlues4U: doesn't show hand
*** SUMMARY ***
Total pot $0.75 | Rake $0.04
Board [8c 8h 3s]
Seat 2: yuni80 (button) folded on the Flop
Seat 3: KeithTurbo48 (small blind) folded before Flop
Seat 4: SeaofLove (big blind) folded before Flop
Seat 5: PlayTheBlues4U collected ($0.71)


PokerStars Hand #203945142163:  Hold'em No Limit ($0.05/$0.10 USD) - 2019/09/24 23:33:10 ET
Table 'Botein' 6-max Seat #3 is the button
Seat 1: trumpcaddy ($14.15 in chips)
Seat 2: Pezant ($10.95 in chips)
Seat 3: PlayTheBlues4U ($8.04 in chips)
Seat 4: traderneal ($9.70 in chips)
Seat 5: NBoula ($12.37 in chips)
Seat 6: Aikido85 ($4 in chips)
traderneal: posts small blind $0.05
NBoula: posts big blind $0.10
*** HOLE CARDS ***
Dealt to PlayTheBlues4U [3d Js]
Aikido85: folds
trumpcaddy: folds
Pezant: raises $0.17 to $0.27
PlayTheBlues4U: folds
traderneal: raises $0.64 to $0.91
NBoula: calls $0.81
Pezant: folds
*** FLOP *** [Ks Kd 8c]
traderneal: checks
NBoula: bets $1
traderneal: calls $1
*** TURN *** [Ks Kd 8c] [Qc]
traderneal: bets $1.90
NBoula: calls $1.90
*** RIVER *** [Ks Kd 8c Qc] [Kh]
traderneal: bets $5.89 and is all-in
NBoula: calls $5.89
*** SHOW DOWN ***
traderneal: shows [Th Ts] (a full house, Kings full of Tens)
NBoula: shows [Ad Qd] (a full house, Kings full of Queens)
NBoula collected $18.69 from pot
*** SUMMARY ***
Total pot $19.67 | Rake $0.98
Board [Ks Kd 8c Qc Kh]
Seat 1: trumpcaddy folded before Flop (didn't bet)
Seat 2: Pezant folded before Flop
Seat 3: PlayTheBlues4U (button) folded before Flop (didn't bet)
Seat 4: traderneal (small blind) showed [Th Ts] and lost with a full house, Kings full of Tens
Seat 5: NBoula (big blind) showed [Ad Qd] and won ($18.69) with a full house, Kings full of Queens
Seat 6: Aikido85 folded before Flop (didn't bet)


PokerStars Hand #203945142103:  Hold'em No Limit ($0.05/$0.10 USD) - 2019/09/24 23:32:50 ET
Table 'Camilla' 6-max Seat #5 is the button
Seat 2: yuni80 ($15.90 in chips)
Seat 3: KeithTurbo48 ($27.06 in chips)
Seat 4: SeaofLove ($19.96 in chips)
Seat 5: PlayTheBlues4U ($9.10 in chips)
yuni80: posts small blind $0.05
KeithTurbo48: posts big blind $0.10
*** HOLE CARDS ***
Dealt to PlayTheBlues4U [Kd 6s]
SeaofLove: folds
PlayTheBlues4U: raises $0.10 to $0.20
yuni80: calls $0.15
KeithTurbo48: calls $0.10
*** FLOP *** [5d Qs 3d]
yuni80: checks
KeithTurbo48: checks
PlayTheBlues4U: checks
*** TURN *** [5d Qs 3d] [2c]
yuni80: bets $0.10
KeithTurbo48: raises $0.40 to $0.50
PlayTheBlues4U: folds
yuni80: calls $0.40
*** RIVER *** [5d Qs 3d 2c] [7c]
yuni80: checks
KeithTurbo48: checks
*** SHOW DOWN ***
yuni80: shows [Qh 6h] (a pair of Queens)
KeithTurbo48: mucks hand
yuni80 collected $1.52 from pot
*** SUMMARY ***
Total pot $1.60 | Rake $0.08
Board [5d Qs 3d 2c 7c]
Seat 2: yuni80 (small blind) showed [Qh 6h] and won ($1.52) with a pair of Queens
Seat 3: KeithTurbo48 (big blind) mucked [Qc 4c]
Seat 4: SeaofLove folded before Flop (didn't bet)
Seat 5: PlayTheBlues4U (button) folded on the Turn


PokerStars Hand #203942559939:  Hold'em No Limit ($0.05/$0.10 USD) - 2019/09/24 23:32:28 ET
Table 'Botein' 6-max Seat #2 is the button
Seat 1: trumpcaddy ($14.15 in chips)
Seat 2: Pezant ($10.95 in chips)
Seat 3: PlayTheBlues4U ($8.09 in chips)
Seat 4: traderneal ($10 in chips)
Seat 5: NBoula ($12.05 in chips)
Seat 6: Aikido85 ($4 in chips)
PlayTheBlues4U: posts small blind $0.05
traderneal: posts big blind $0.10
*** HOLE CARDS ***
Dealt to PlayTheBlues4U [8h Tc]
NBoula: raises $0.20 to $0.30
Aikido85: folds
trumpcaddy: folds
Pezant: folds
PlayTheBlues4U: folds
traderneal: calls $0.20
*** FLOP *** [As Qh 9h]
traderneal: checks
NBoula: checks
*** TURN *** [As Qh 9h] [8s]
traderneal: checks
NBoula: bets $0.30
traderneal: folds
Uncalled bet ($0.30) returned to NBoula
NBoula collected $0.62 from pot
NBoula: doesn't show hand
*** SUMMARY ***
Total pot $0.65 | Rake $0.03
Board [As Qh 9h 8s]
Seat 1: trumpcaddy folded before Flop (didn't bet)
Seat 2: Pezant (button) folded before Flop (didn't bet)
Seat 3: PlayTheBlues4U (small blind) folded before Flop
Seat 4: traderneal (big blind) folded on the Turn
Seat 5: NBoula collected ($0.62)
Seat 6: Aikido85 folded before Flop (didn't bet)


PokerStars Hand #203942559912:  Hold'em No Limit ($0.05/$0.10 USD) - 2019/09/24 23:32:19 ET
Table 'Camilla' 6-max Seat #4 is the button
Seat 2: yuni80 ($16.15 in chips)
Seat 3: KeithTurbo48 ($26.79 in chips)
Seat 4: SeaofLove ($19.96 in chips)
Seat 5: PlayTheBlues4U ($9.15 in chips)
PlayTheBlues4U: posts small blind $0.05
yuni80: posts big blind $0.10
*** HOLE CARDS ***
Dealt to PlayTheBlues4U [7d Qc]
KeithTurbo48: raises $0.15 to $0.25
SeaofLove: folds
PlayTheBlues4U: folds
yuni80: calls $0.15
*** FLOP *** [2h 3c As]
yuni80: checks
KeithTurbo48: checks
*** TURN *** [2h 3c As] [Qs]
yuni80: checks
KeithTurbo48: bets $0.30
yuni80: folds
Uncalled bet ($0.30) returned to KeithTurbo48
KeithTurbo48 collected $0.52 from pot
KeithTurbo48: doesn't show hand
*** SUMMARY ***
Total pot $0.55 | Rake $0.03
Board [2h 3c As Qs]
Seat 2: yuni80 (big blind) folded on the Turn
Seat 3: KeithTurbo48 collected ($0.52)
Seat 4: SeaofLove (button) folded before Flop (didn't bet)
Seat 5: PlayTheBlues4U (small blind) folded before Flop


PokerStars Hand #203942559800:  Hold'em No Limit ($0.05/$0.10 USD) - 2019/09/24 23:31:38 ET
Table 'Camilla' 6-max Seat #3 is the button
Seat 2: yuni80 ($16.55 in chips)
Seat 3: KeithTurbo48 ($26.29 in chips)
Seat 4: SeaofLove ($20.01 in chips)
Seat 5: PlayTheBlues4U ($9.25 in chips)
Seat 6: pokerfacerr5 ($24.11 in chips)
SeaofLove: posts small blind $0.05
PlayTheBlues4U: posts big blind $0.10
*** HOLE CARDS ***
Dealt to PlayTheBlues4U [4c 2h]
pokerfacerr5: folds
pokerfacerr5 leaves the table
yuni80: calls $0.10
KeithTurbo48: raises $0.30 to $0.40
SeaofLove: folds
PlayTheBlues4U: folds
yuni80: calls $0.30
*** FLOP *** [5s 5c 3s]
yuni80: checks
KeithTurbo48: checks
*** TURN *** [5s 5c 3s] [Ac]
yuni80: checks
KeithTurbo48: checks
*** RIVER *** [5s 5c 3s Ac] [Qd]
yuni80: checks
KeithTurbo48: bets $0.67
yuni80: folds
Uncalled bet ($0.67) returned to KeithTurbo48
KeithTurbo48 collected $0.90 from pot
KeithTurbo48: doesn't show hand
*** SUMMARY ***
Total pot $0.95 | Rake $0.05
Board [5s 5c 3s Ac Qd]
Seat 2: yuni80 folded on the River
Seat 3: KeithTurbo48 (button) collected ($0.90)
Seat 4: SeaofLove (small blind) folded before Flop
Seat 5: PlayTheBlues4U (big blind) folded before Flop
Seat 6: pokerfacerr5 folded before Flop (didn't bet)


PokerStars Hand #203942559750:  Hold'em No Limit ($0.05/$0.10 USD) - 2019/09/24 23:31:19 ET
Table 'Camilla' 6-max Seat #2 is the button
Seat 2: yuni80 ($16.55 in chips)
Seat 3: KeithTurbo48 ($26.34 in chips)
Seat 4: SeaofLove ($20.11 in chips)
Seat 5: PlayTheBlues4U ($9.55 in chips)
Seat 6: pokerfacerr5 ($23.66 in chips)
KeithTurbo48: posts small blind $0.05
SeaofLove: posts big blind $0.10
*** HOLE CARDS ***
Dealt to PlayTheBlues4U [Ts 9s]
PlayTheBlues4U: raises $0.20 to $0.30
pokerfacerr5: raises $3.80 to $4.10
yuni80: folds
KeithTurbo48: folds
SeaofLove: folds
PlayTheBlues4U: folds
Uncalled bet ($3.80) returned to pokerfacerr5
pokerfacerr5 collected $0.75 from pot
pokerfacerr5: doesn't show hand
*** SUMMARY ***
Total pot $0.75 | Rake $0
Seat 2: yuni80 (button) folded before Flop (didn't bet)
Seat 3: KeithTurbo48 (small blind) folded before Flop
Seat 4: SeaofLove (big blind) folded before Flop
Seat 5: PlayTheBlues4U folded before Flop
Seat 6: pokerfacerr5 collected ($0.75)


PokerStars Hand #203942559736:  Hold'em No Limit ($0.05/$0.10 USD) - 2019/09/24 23:31:14 ET
Table 'Botein' 6-max Seat #1 is the button
Seat 1: trumpcaddy ($19.01 in chips)
Seat 2: Pezant ($11 in chips)
Seat 3: PlayTheBlues4U ($8.19 in chips)
Seat 4: traderneal ($4.86 in chips)
Seat 5: NBoula ($12.05 in chips)
Seat 6: Aikido85 ($4 in chips)
Pezant: posts small blind $0.05
PlayTheBlues4U: posts big blind $0.10
*** HOLE CARDS ***
Dealt to PlayTheBlues4U [Jh 7c]
traderneal: calls $0.10
NBoula: folds
Aikido85: folds
trumpcaddy: raises $0.40 to $0.50
Pezant: folds
PlayTheBlues4U: folds
traderneal: calls $0.40
*** FLOP *** [4c Qh 4d]
traderneal: checks
trumpcaddy: bets $1
traderneal: calls $1
*** TURN *** [4c Qh 4d] [Td]
traderneal: checks
trumpcaddy: bets $3.40
traderneal: calls $3.36 and is all-in
Uncalled bet ($0.04) returned to trumpcaddy
*** RIVER *** [4c Qh 4d Td] [7s]
*** SHOW DOWN ***
traderneal: shows [4h 3d] (three of a kind, Fours)
trumpcaddy: shows [Ah Ad] (two pair, Aces and Fours)
traderneal collected $9.38 from pot
*** SUMMARY ***
Total pot $9.87 | Rake $0.49
Board [4c Qh 4d Td 7s]
Seat 1: trumpcaddy (button) showed [Ah Ad] and lost with two pair, Aces and Fours
Seat 2: Pezant (small blind) folded before Flop
Seat 3: PlayTheBlues4U (big blind) folded before Flop
Seat 4: traderneal showed [4h 3d] and won ($9.38) with three of a kind, Fours
Seat 5: NBoula folded before Flop (didn't bet)
Seat 6: Aikido85 folded before Flop (didn't bet)


PokerStars Hand #203942559646:  Hold'em No Limit ($0.05/$0.10 USD) - 2019/09/24 23:30:45 ET
Table 'Camilla' 6-max Seat #6 is the button
Seat 2: yuni80 ($8.56 in chips)
Seat 3: KeithTurbo48 ($26.64 in chips)
Seat 4: SeaofLove ($20.11 in chips)
Seat 5: PlayTheBlues4U ($9.55 in chips)
Seat 6: pokerfacerr5 ($32.22 in chips)
yuni80: posts small blind $0.05
KeithTurbo48: posts big blind $0.10
*** HOLE CARDS ***
Dealt to PlayTheBlues4U [5c 4h]
SeaofLove: folds
PlayTheBlues4U: folds
pokerfacerr5: raises $0.20 to $0.30
yuni80: calls $0.25
KeithTurbo48: calls $0.20
*** FLOP *** [8s 5s Js]
yuni80: checks
KeithTurbo48: checks
pokerfacerr5: bets $0.86
yuni80: raises $0.86 to $1.72
KeithTurbo48: folds
pokerfacerr5: raises $30.20 to $31.92 and is all-in
yuni80: calls $6.54 and is all-in
Uncalled bet ($23.66) returned to pokerfacerr5
*** TURN *** [8s 5s Js] [Qd]
*** RIVER *** [8s 5s Js Qd] [Jh]
*** SHOW DOWN ***
yuni80: shows [Qs 6s] (a flush, Queen high)
pokerfacerr5: shows [5d 8d] (two pair, Jacks and Eights)
yuni80 collected $16.55 from pot
*** SUMMARY ***
Total pot $17.42 | Rake $0.87
Board [8s 5s Js Qd Jh]
Seat 2: yuni80 (small blind) showed [Qs 6s] and won ($16.55) with a flush, Queen high
Seat 3: KeithTurbo48 (big blind) folded on the Flop
Seat 4: SeaofLove folded before Flop (didn't bet)
Seat 5: PlayTheBlues4U folded before Flop (didn't bet)
Seat 6: pokerfacerr5 (button) showed [5d 8d] and lost with two pair, Jacks and Eights


PokerStars Hand #203942559571:  Hold'em No Limit ($0.05/$0.10 USD) - 2019/09/24 23:30:23 ET
Table 'Botein' 6-max Seat #6 is the button
Seat 1: trumpcaddy ($19.36 in chips)
Seat 2: Pezant ($11.10 in chips)
Seat 3: PlayTheBlues4U ($8.19 in chips)
Seat 4: traderneal ($7.91 in chips)
Seat 5: NBoula ($8.88 in chips)
Seat 6: Aikido85 ($4 in chips)
trumpcaddy: posts small blind $0.05
Pezant: posts big blind $0.10
*** HOLE CARDS ***
Dealt to PlayTheBlues4U [Ah Ad]
PlayTheBlues4U: folds
traderneal: raises $0.25 to $0.35
NBoula: calls $0.35
Aikido85: folds
trumpcaddy: calls $0.30
Pezant: folds
*** FLOP *** [Kd 7c 3s]
trumpcaddy: checks
traderneal: bets $1.10
NBoula: calls $1.10
trumpcaddy: folds
*** TURN *** [Kd 7c 3s] [Kh]
traderneal: checks
NBoula: bets $1.60
traderneal: calls $1.60
*** RIVER *** [Kd 7c 3s Kh] [5h]
traderneal: checks
NBoula: bets $5.83 and is all-in
traderneal: folds
Uncalled bet ($5.83) returned to NBoula
NBoula collected $6.22 from pot
NBoula: doesn't show hand
*** SUMMARY ***
Total pot $6.55 | Rake $0.33
Board [Kd 7c 3s Kh 5h]
Seat 1: trumpcaddy (small blind) folded on the Flop
Seat 2: Pezant (big blind) folded before Flop
Seat 3: PlayTheBlues4U folded before Flop (didn't bet)
Seat 4: traderneal folded on the River
Seat 5: NBoula collected ($6.22)
Seat 6: Aikido85 (button) folded before Flop (didn't bet)


PokerStars Hand #203942559562:  Hold'em No Limit ($0.05/$0.10 USD) - 2019/09/24 23:30:18 ET
Table 'Camilla' 6-max Seat #5 is the button
Seat 2: yuni80 ($9.52 in chips)
Seat 3: KeithTurbo48 ($26.89 in chips)
Seat 4: SeaofLove ($20.11 in chips)
Seat 5: PlayTheBlues4U ($9.55 in chips)
Seat 6: pokerfacerr5 ($31.12 in chips)
pokerfacerr5: posts small blind $0.05
yuni80: posts big blind $0.10
*** HOLE CARDS ***
Dealt to PlayTheBlues4U [9h 7s]
KeithTurbo48: raises $0.15 to $0.25
SeaofLove: folds
PlayTheBlues4U: folds
pokerfacerr5: calls $0.20
yuni80: calls $0.15
*** FLOP *** [3c 9s 2s]
pokerfacerr5: bets $0.71
yuni80: calls $0.71
KeithTurbo48: folds
*** TURN *** [3c 9s 2s] [Ac]
pokerfacerr5: checks
yuni80: checks
*** RIVER *** [3c 9s 2s Ac] [8c]
pokerfacerr5: checks
yuni80: checks
*** SHOW DOWN ***
pokerfacerr5: shows [9d Jc] (a pair of Nines)
yuni80: mucks hand
pokerfacerr5 collected $2.06 from pot
*** SUMMARY ***
Total pot $2.17 | Rake $0.11
Board [3c 9s 2s Ac 8c]
Seat 2: yuni80 (big blind) mucked [Qc Ks]
Seat 3: KeithTurbo48 folded on the Flop
Seat 4: SeaofLove folded before Flop (didn't bet)
Seat 5: PlayTheBlues4U (button) folded before Flop (didn't bet)
Seat 6: pokerfacerr5 (small blind) showed [9d Jc] and won ($2.06) with a pair of Nines


PokerStars Hand #203942559528:  Hold'em No Limit ($0.05/$0.10 USD) - 2019/09/24 23:30:07 ET
Table 'Botein' 6-max Seat #5 is the button
Seat 1: trumpcaddy ($19.31 in chips)
Seat 2: Pezant ($11.10 in chips)
Seat 3: PlayTheBlues4U ($8.19 in chips)
Seat 4: traderneal ($7.91 in chips)
Seat 5: NBoula ($8.88 in chips)
Seat 6: Aikido85 ($4.05 in chips)
Aikido85: posts small blind $0.05
trumpcaddy: posts big blind $0.10
*** HOLE CARDS ***
Dealt to PlayTheBlues4U [6h 4h]
Pezant: folds
PlayTheBlues4U: folds
traderneal: folds
NBoula: folds
Aikido85: folds
Uncalled bet ($0.05) returned to trumpcaddy
trumpcaddy collected $0.10 from pot
trumpcaddy: doesn't show hand
*** SUMMARY ***
Total pot $0.10 | Rake $0
Seat 1: trumpcaddy (big blind) collected ($0.10)
Seat 2: Pezant folded before Flop (didn't bet)
Seat 3: PlayTheBlues4U folded before Flop (didn't bet)
Seat 4: traderneal folded before Flop (didn't bet)
Seat 5: NBoula (button) folded before Flop (didn't bet)
Seat 6: Aikido85 (small blind) folded before Flop


PokerStars Hand #203942559407:  Hold'em No Limit ($0.05/$0.10 USD) - 2019/09/24 23:29:26 ET
Table 'Camilla' 6-max Seat #4 is the button
Seat 2: yuni80 ($10.39 in chips)
Seat 3: KeithTurbo48 ($27.19 in chips)
Seat 4: SeaofLove ($20.11 in chips)
Seat 5: PlayTheBlues4U ($9.85 in chips)
Seat 6: pokerfacerr5 ($29.77 in chips)
PlayTheBlues4U: posts small blind $0.05
pokerfacerr5: posts big blind $0.10
*** HOLE CARDS ***
Dealt to PlayTheBlues4U [9h Ah]
yuni80: calls $0.10
KeithTurbo48: calls $0.10
SeaofLove: folds
PlayTheBlues4U: calls $0.05
pokerfacerr5: raises $0.20 to $0.30
yuni80: calls $0.20
KeithTurbo48: calls $0.20
PlayTheBlues4U: calls $0.20
*** FLOP *** [8d Qh 3c]
PlayTheBlues4U: checks
pokerfacerr5: bets $0.57
yuni80: calls $0.57
KeithTurbo48: folds
PlayTheBlues4U: folds
*** TURN *** [8d Qh 3c] [Ts]
pokerfacerr5: checks
yuni80: checks
*** RIVER *** [8d Qh 3c Ts] [6h]
pokerfacerr5: checks
yuni80: checks
*** SHOW DOWN ***
pokerfacerr5: shows [9s 8h] (a pair of Eights)
yuni80: mucks hand
pokerfacerr5 collected $2.22 from pot
*** SUMMARY ***
Total pot $2.34 | Rake $0.12
Board [8d Qh 3c Ts 6h]
Seat 2: yuni80 mucked [Ks Ac]
Seat 3: KeithTurbo48 folded on the Flop
Seat 4: SeaofLove (button) folded before Flop (didn't bet)
Seat 5: PlayTheBlues4U (small blind) folded on the Flop
Seat 6: pokerfacerr5 (big blind) showed [9s 8h] and won ($2.22) with a pair of Eights


PokerStars Hand #203942559380:  Hold'em No Limit ($0.05/$0.10 USD) - 2019/09/24 23:29:18 ET
Table 'Botein' 6-max Seat #4 is the button
Seat 1: trumpcaddy ($19.31 in chips)
Seat 2: Pezant ($11.37 in chips)
Seat 3: PlayTheBlues4U ($8.19 in chips)
Seat 4: traderneal ($7.52 in chips)
Seat 5: NBoula ($8.93 in chips)
Seat 6: Aikido85 ($4.15 in chips)
NBoula: posts small blind $0.05
Aikido85: posts big blind $0.10
*** HOLE CARDS ***
Dealt to PlayTheBlues4U [4s 7c]
trumpcaddy: folds
Pezant: raises $0.17 to $0.27
PlayTheBlues4U: folds
traderneal: calls $0.27
NBoula: folds
Aikido85: folds
*** FLOP *** [Kd 9c 7h]
Pezant: checks
traderneal: checks
*** TURN *** [Kd 9c 7h] [Js]
Pezant: checks
traderneal: bets $0.70
Pezant: folds
Uncalled bet ($0.70) returned to traderneal
traderneal collected $0.66 from pot
traderneal: doesn't show hand
*** SUMMARY ***
Total pot $0.69 | Rake $0.03
Board [Kd 9c 7h Js]
Seat 1: trumpcaddy folded before Flop (didn't bet)
Seat 2: Pezant folded on the Turn
Seat 3: PlayTheBlues4U folded before Flop (didn't bet)
Seat 4: traderneal (button) collected ($0.66)
Seat 5: NBoula (small blind) folded before Flop
Seat 6: Aikido85 (big blind) folded before Flop


PokerStars Hand #203942559333:  Hold'em No Limit ($0.05/$0.10 USD) - 2019/09/24 23:28:58 ET
Table 'Botein' 6-max Seat #3 is the button
Seat 1: trumpcaddy ($19.31 in chips)
Seat 2: Pezant ($11.37 in chips)
Seat 3: PlayTheBlues4U ($8.19 in chips)
Seat 4: traderneal ($7.43 in chips)
Seat 5: NBoula ($9.03 in chips)
Seat 6: Aikido85 ($4.15 in chips)
traderneal: posts small blind $0.05
NBoula: posts big blind $0.10
*** HOLE CARDS ***
Dealt to PlayTheBlues4U [6c Jh]
Aikido85: folds
trumpcaddy: folds
Pezant: folds
PlayTheBlues4U: folds
traderneal: calls $0.05
NBoula: checks
*** FLOP *** [Qd 5d 6h]
traderneal: checks
NBoula: checks
*** TURN *** [Qd 5d 6h] [3c]
traderneal: checks
NBoula: checks
*** RIVER *** [Qd 5d 6h 3c] [9c]
traderneal: checks
NBoula: checks
*** SHOW DOWN ***
traderneal: shows [5h Ac] (a pair of Fives)
NBoula: mucks hand
traderneal collected $0.19 from pot
*** SUMMARY ***
Total pot $0.20 | Rake $0.01
Board [Qd 5d 6h 3c 9c]
Seat 1: trumpcaddy folded before Flop (didn't bet)
Seat 2: Pezant folded before Flop (didn't bet)
Seat 3: PlayTheBlues4U (button) folded before Flop (didn't bet)
Seat 4: traderneal (small blind) showed [5h Ac] and won ($0.19) with a pair of Fives
Seat 5: NBoula (big blind) mucked [Kc 8h]
Seat 6: Aikido85 folded before Flop (didn't bet)


PokerStars Hand #203942559328:  Hold'em No Limit ($0.05/$0.10 USD) - 2019/09/24 23:28:57 ET
Table 'Camilla' 6-max Seat #3 is the button
Seat 2: yuni80 ($11.95 in chips)
Seat 3: KeithTurbo48 ($27.19 in chips)
Seat 4: SeaofLove ($20.16 in chips)
Seat 5: PlayTheBlues4U ($9.95 in chips)
Seat 6: pokerfacerr5 ($28.22 in chips)
SeaofLove: posts small blind $0.05
PlayTheBlues4U: posts big blind $0.10
*** HOLE CARDS ***
Dealt to PlayTheBlues4U [Qs 9h]
pokerfacerr5: raises $0.25 to $0.35
yuni80: calls $0.35
KeithTurbo48: folds
SeaofLove: folds
PlayTheBlues4U: folds
*** FLOP *** [Th 3d 2c]
pokerfacerr5: bets $0.41
yuni80: calls $0.41
*** TURN *** [Th 3d 2c] [Jd]
pokerfacerr5: bets $0.80
yuni80: calls $0.80
*** RIVER *** [Th 3d 2c Jd] [Ad]
pokerfacerr5: checks
yuni80: checks
*** SHOW DOWN ***
pokerfacerr5: shows [Jh 9d] (a pair of Jacks)
yuni80: mucks hand
pokerfacerr5 collected $3.11 from pot
*** SUMMARY ***
Total pot $3.27 | Rake $0.16
Board [Th 3d 2c Jd Ad]
Seat 2: yuni80 mucked [6h 4h]
Seat 3: KeithTurbo48 (button) folded before Flop (didn't bet)
Seat 4: SeaofLove (small blind) folded before Flop
Seat 5: PlayTheBlues4U (big blind) folded before Flop
Seat 6: pokerfacerr5 showed [Jh 9d] and won ($3.11) with a pair of Jacks


PokerStars Hand #203942559284:  Hold'em No Limit ($0.05/$0.10 USD) - 2019/09/24 23:28:42 ET
Table 'Camilla' 6-max Seat #2 is the button
Seat 2: yuni80 ($11.95 in chips)
Seat 3: KeithTurbo48 ($27.24 in chips)
Seat 4: SeaofLove ($20.26 in chips)
Seat 5: PlayTheBlues4U ($9.95 in chips)
Seat 6: pokerfacerr5 ($28.07 in chips)
KeithTurbo48: posts small blind $0.05
SeaofLove: posts big blind $0.10
*** HOLE CARDS ***
Dealt to PlayTheBlues4U [2s 8s]
PlayTheBlues4U: folds
pokerfacerr5: raises $0.25 to $0.35
yuni80: folds
KeithTurbo48: folds
SeaofLove: folds
Uncalled bet ($0.25) returned to pokerfacerr5
pokerfacerr5 collected $0.25 from pot
pokerfacerr5: doesn't show hand
*** SUMMARY ***
Total pot $0.25 | Rake $0
Seat 2: yuni80 (button) folded before Flop (didn't bet)
Seat 3: KeithTurbo48 (small blind) folded before Flop
Seat 4: SeaofLove (big blind) folded before Flop
Seat 5: PlayTheBlues4U folded before Flop (didn't bet)
Seat 6: pokerfacerr5 collected ($0.25)


PokerStars Hand #203942559233:  Hold'em No Limit ($0.05/$0.10 USD) - 2019/09/24 23:28:25 ET
Table 'Botein' 6-max Seat #2 is the button
Seat 1: trumpcaddy ($19.31 in chips)
Seat 2: Pezant ($11.37 in chips)
Seat 3: PlayTheBlues4U ($8.24 in chips)
Seat 4: traderneal ($7.28 in chips)
Seat 5: NBoula ($9.03 in chips)
Seat 6: Aikido85 ($4.25 in chips)
PlayTheBlues4U: posts small blind $0.05
traderneal: posts big blind $0.10
*** HOLE CARDS ***
Dealt to PlayTheBlues4U [Tc 8d]
NBoula: folds
Aikido85: calls $0.10
trumpcaddy: folds
Pezant: folds
PlayTheBlues4U: folds
traderneal: raises $0.50 to $0.60
Aikido85: folds
Uncalled bet ($0.50) returned to traderneal
traderneal collected $0.25 from pot
traderneal: doesn't show hand
*** SUMMARY ***
Total pot $0.25 | Rake $0
Seat 1: trumpcaddy folded before Flop (didn't bet)
Seat 2: Pezant (button) folded before Flop (didn't bet)
Seat 3: PlayTheBlues4U (small blind) folded before Flop
Seat 4: traderneal (big blind) collected ($0.25)
Seat 5: NBoula folded before Flop (didn't bet)
Seat 6: Aikido85 folded before Flop


PokerStars Hand #203942559177:  Hold'em No Limit ($0.05/$0.10 USD) - 2019/09/24 23:28:09 ET
Table 'Camilla' 6-max Seat #6 is the button
Seat 2: yuni80 ($12.05 in chips)
Seat 3: KeithTurbo48 ($27.15 in chips)
Seat 4: SeaofLove ($20.26 in chips)
Seat 5: PlayTheBlues4U ($9.95 in chips)
Seat 6: pokerfacerr5 ($28.07 in chips)
yuni80: posts small blind $0.05
KeithTurbo48: posts big blind $0.10
*** HOLE CARDS ***
Dealt to PlayTheBlues4U [Jc 4h]
SeaofLove: folds
PlayTheBlues4U: folds
pokerfacerr5: folds
yuni80: calls $0.05
KeithTurbo48: checks
*** FLOP *** [7d 7c 5c]
yuni80: checks
KeithTurbo48: checks
*** TURN *** [7d 7c 5c] [9d]
yuni80: checks
KeithTurbo48: checks
*** RIVER *** [7d 7c 5c 9d] [As]
yuni80: checks
KeithTurbo48: bets $0.10
yuni80: folds
Uncalled bet ($0.10) returned to KeithTurbo48
KeithTurbo48 collected $0.19 from pot
KeithTurbo48: doesn't show hand
*** SUMMARY ***
Total pot $0.20 | Rake $0.01
Board [7d 7c 5c 9d As]
Seat 2: yuni80 (small blind) folded on the River
Seat 3: KeithTurbo48 (big blind) collected ($0.19)
Seat 4: SeaofLove folded before Flop (didn't bet)
Seat 5: PlayTheBlues4U folded before Flop (didn't bet)
Seat 6: pokerfacerr5 (button) folded before Flop (didn't bet)


PokerStars Hand #203942559018:  Hold'em No Limit ($0.05/$0.10 USD) - 2019/09/24 23:27:20 ET
Table 'Camilla' 6-max Seat #5 is the button
Seat 2: yuni80 ($11.09 in chips)
Seat 3: KeithTurbo48 ($28.16 in chips)
Seat 4: SeaofLove ($20.26 in chips)
Seat 5: PlayTheBlues4U ($9.95 in chips)
Seat 6: pokerfacerr5 ($28.12 in chips)
pokerfacerr5: posts small blind $0.05
yuni80: posts big blind $0.10
*** HOLE CARDS ***
Dealt to PlayTheBlues4U [4d Tc]
KeithTurbo48: raises $0.15 to $0.25
SeaofLove: folds
PlayTheBlues4U: folds
pokerfacerr5: folds
yuni80: calls $0.15
*** FLOP *** [Kc Ac 7s]
yuni80: checks
KeithTurbo48: checks
*** TURN *** [Kc Ac 7s] [2h]
yuni80: checks
KeithTurbo48: bets $0.38
yuni80: raises $0.38 to $0.76
KeithTurbo48: calls $0.38
*** RIVER *** [Kc Ac 7s 2h] [9s]
yuni80: bets $3.80
KeithTurbo48: folds
Uncalled bet ($3.80) returned to yuni80
yuni80 collected $1.97 from pot
yuni80: doesn't show hand
*** SUMMARY ***
Total pot $2.07 | Rake $0.10
Board [Kc Ac 7s 2h 9s]
Seat 2: yuni80 (big blind) collected ($1.97)
Seat 3: KeithTurbo48 folded on the River
Seat 4: SeaofLove folded before Flop (didn't bet)
Seat 5: PlayTheBlues4U (button) folded before Flop (didn't bet)
Seat 6: pokerfacerr5 (small blind) folded before Flop


PokerStars Hand #203942558938:  Hold'em No Limit ($0.05/$0.10 USD) - 2019/09/24 23:26:57 ET
Table 'Botein' 6-max Seat #1 is the button
Seat 1: trumpcaddy ($19.41 in chips)
Seat 2: Pezant ($11.42 in chips)
Seat 3: PlayTheBlues4U ($8.34 in chips)
Seat 4: traderneal ($9.39 in chips)
Seat 5: NBoula ($9.03 in chips)
Seat 6: Aikido85 ($2.11 in chips)
Pezant: posts small blind $0.05
PlayTheBlues4U: posts big blind $0.10
*** HOLE CARDS ***
Dealt to PlayTheBlues4U [Qs Ts]
traderneal: calls $0.10
NBoula: folds
Aikido85: calls $0.10
trumpcaddy: calls $0.10
Pezant: folds
PlayTheBlues4U: checks
*** FLOP *** [Ah 2h 5s]
PlayTheBlues4U: checks
traderneal: checks
Aikido85: checks
trumpcaddy: checks
*** TURN *** [Ah 2h 5s] [6s]
PlayTheBlues4U: checks
traderneal: bets $0.50
Aikido85: calls $0.50
trumpcaddy: folds
PlayTheBlues4U: folds
*** RIVER *** [Ah 2h 5s 6s] [9c]
traderneal: bets $1.60
Aikido85: calls $1.51 and is all-in
Uncalled bet ($0.09) returned to traderneal
*** SHOW DOWN ***
traderneal: shows [6h 5c] (two pair, Sixes and Fives)
Aikido85: shows [5h 5d] (three of a kind, Fives)
Aikido85 collected $4.25 from pot
*** SUMMARY ***
Total pot $4.47 | Rake $0.22
Board [Ah 2h 5s 6s 9c]
Seat 1: trumpcaddy (button) folded on the Turn
Seat 2: Pezant (small blind) folded before Flop
Seat 3: PlayTheBlues4U (big blind) folded on the Turn
Seat 4: traderneal showed [6h 5c] and lost with two pair, Sixes and Fives
Seat 5: NBoula folded before Flop (didn't bet)
Seat 6: Aikido85 showed [5h 5d] and won ($4.25) with three of a kind, Fives


PokerStars Hand #203942558900:  Hold'em No Limit ($0.05/$0.10 USD) - 2019/09/24 23:26:44 ET
Table 'Camilla' 6-max Seat #4 is the button
Seat 2: yuni80 ($11.49 in chips)
Seat 3: KeithTurbo48 ($29.75 in chips)
Seat 4: SeaofLove ($20.26 in chips)
Seat 5: PlayTheBlues4U ($10 in chips)
Seat 6: pokerfacerr5 ($26.26 in chips)
PlayTheBlues4U: posts small blind $0.05
pokerfacerr5: posts big blind $0.10
*** HOLE CARDS ***
Dealt to PlayTheBlues4U [Qs 7c]
yuni80: calls $0.10
KeithTurbo48: raises $0.30 to $0.40
SeaofLove: folds
PlayTheBlues4U: folds
pokerfacerr5: calls $0.30
yuni80: calls $0.30
*** FLOP *** [6h 2d 8s]
pokerfacerr5: bets $1.19
yuni80: folds
KeithTurbo48: calls $1.19
*** TURN *** [6h 2d 8s] [4h]
pokerfacerr5: bets $1.73
KeithTurbo48: folds
Uncalled bet ($1.73) returned to pokerfacerr5
pokerfacerr5 collected $3.45 from pot
pokerfacerr5: doesn't show hand
*** SUMMARY ***
Total pot $3.63 | Rake $0.18
Board [6h 2d 8s 4h]
Seat 2: yuni80 folded on the Flop
Seat 3: KeithTurbo48 folded on the Turn
Seat 4: SeaofLove (button) folded before Flop (didn't bet)
Seat 5: PlayTheBlues4U (small blind) folded before Flop
Seat 6: pokerfacerr5 (big blind) collected ($3.45)


PokerStars Hand #203942558854:  Hold'em No Limit ($0.05/$0.10 USD) - 2019/09/24 23:26:28 ET
Table 'Botein' 6-max Seat #6 is the button
Seat 1: trumpcaddy ($19.46 in chips)
Seat 2: Pezant ($11.82 in chips)
Seat 3: PlayTheBlues4U ($8.34 in chips)
Seat 4: traderneal ($8.98 in chips)
Seat 5: NBoula ($9.03 in chips)
Seat 6: Aikido85 ($2.11 in chips)
trumpcaddy: posts small blind $0.05
Pezant: posts big blind $0.10
*** HOLE CARDS ***
Dealt to PlayTheBlues4U [4c 9s]
PlayTheBlues4U: folds
traderneal: raises $0.30 to $0.40
NBoula: folds
Aikido85: folds
trumpcaddy: folds
Pezant: calls $0.30
*** FLOP *** [4h Ts Kh]
Pezant: checks
traderneal: bets $0.80
Pezant: folds
Uncalled bet ($0.80) returned to traderneal
traderneal collected $0.81 from pot
traderneal: doesn't show hand
*** SUMMARY ***
Total pot $0.85 | Rake $0.04
Board [4h Ts Kh]
Seat 1: trumpcaddy (small blind) folded before Flop
Seat 2: Pezant (big blind) folded on the Flop
Seat 3: PlayTheBlues4U folded before Flop (didn't bet)
Seat 4: traderneal collected ($0.81)
Seat 5: NBoula folded before Flop (didn't bet)
Seat 6: Aikido85 (button) folded before Flop (didn't bet)


PokerStars Hand #203942558822:  Hold'em No Limit ($0.05/$0.10 USD) - 2019/09/24 23:26:16 ET
Table 'Camilla' 6-max Seat #3 is the button
Seat 2: yuni80 ($11.59 in chips)
Seat 3: KeithTurbo48 ($29.75 in chips)
Seat 4: SeaofLove ($20.31 in chips)
Seat 5: PlayTheBlues4U ($2.50 in chips)
Seat 6: pokerfacerr5 ($26.26 in chips)
SeaofLove: posts small blind $0.05
PlayTheBlues4U: posts big blind $0.10
*** HOLE CARDS ***
Dealt to PlayTheBlues4U [7h 4s]
pokerfacerr5: folds
yuni80: calls $0.10
KeithTurbo48: folds
SeaofLove: folds
PlayTheBlues4U: checks
*** FLOP *** [4h Ts Qd]
PlayTheBlues4U: checks
yuni80: checks
*** TURN *** [4h Ts Qd] [Js]
PlayTheBlues4U: checks
yuni80: checks
*** RIVER *** [4h Ts Qd Js] [6c]
PlayTheBlues4U: checks
yuni80: checks
*** SHOW DOWN ***
PlayTheBlues4U: shows [7h 4s] (a pair of Fours)
yuni80: mucks hand
PlayTheBlues4U collected $0.24 from pot
*** SUMMARY ***
Total pot $0.25 | Rake $0.01
Board [4h Ts Qd Js 6c]
Seat 2: yuni80 mucked [9d Ah]
Seat 3: KeithTurbo48 (button) folded before Flop (didn't bet)
Seat 4: SeaofLove (small blind) folded before Flop
Seat 5: PlayTheBlues4U (big blind) showed [7h 4s] and won ($0.24) with a pair of Fours
Seat 6: pokerfacerr5 folded before Flop (didn't bet)


PokerStars Hand #204146578609:  Hold'em No Limit ($0.05/$0.10 USD) - 2019/10/01 22:54:19 ET
Table 'Klytia' 6-max Seat #2 is the button
Seat 1: OliveXC ($16.31 in chips) 
Seat 2: Pezant ($12.63 in chips) 
Seat 3: ng2414 ($9.90 in chips) 
Seat 4: prettybigtuna ($8.51 in chips) 
Seat 5: PlayTheBlues4U ($11.95 in chips) 
Seat 6: efreay11 ($27.80 in chips) 
ng2414: posts small blind $0.05
prettybigtuna: posts big blind $0.10
*** HOLE CARDS ***
Dealt to PlayTheBlues4U [As 2d]
PlayTheBlues4U: folds 
PlayTheBlues4U said, "ggs nite"
efreay11: calls $0.10
OliveXC: folds 
Pezant: folds 
PlayTheBlues4U leaves the table
ng2414: calls $0.05
prettybigtuna: checks 
*** FLOP *** [4s Kd Tc]
ng2414: checks 
prettybigtuna: checks 
efreay11: bets $0.30
ng2414: calls $0.30
prettybigtuna: folds 
*** TURN *** [4s Kd Tc] [6s]
ng2414: checks 
efreay11: checks 
*** RIVER *** [4s Kd Tc 6s] [8h]
ng2414: checks 
efreay11: checks 
*** SHOW DOWN ***
ng2414: shows [9d Ks] (a pair of Kings)
efreay11: mucks hand 
ng2414 collected $0.86 from pot
*** SUMMARY ***
Total pot $0.90 | Rake $0.04 
Board [4s Kd Tc 6s 8h]
Seat 1: OliveXC folded before Flop (didn't bet)
Seat 2: Pezant (button) folded before Flop (didn't bet)
Seat 3: ng2414 (small blind) showed [9d Ks] and won ($0.86) with a pair of Kings
Seat 4: prettybigtuna (big blind) folded on the Flop
Seat 5: PlayTheBlues4U folded before Flop (didn't bet)
Seat 6: efreay11 mucked [Qh Jh]


PokerStars Hand #204146578482:  Hold'em No Limit ($0.05/$0.10 USD) - 2019/10/01 22:53:35 ET
Table 'Klytia' 6-max Seat #1 is the button
Seat 1: OliveXC ($17.11 in chips) 
Seat 2: Pezant ($12.68 in chips) 
Seat 3: ng2414 ($10 in chips) 
Seat 4: prettybigtuna ($6.89 in chips) 
Seat 5: PlayTheBlues4U ($11.95 in chips) 
Seat 6: efreay11 ($28.60 in chips) 
Pezant: posts small blind $0.05
ng2414: posts big blind $0.10
*** HOLE CARDS ***
Dealt to PlayTheBlues4U [7c Td]
prettybigtuna: raises $0.10 to $0.20
PlayTheBlues4U: folds 
efreay11: calls $0.20
OliveXC: raises $0.60 to $0.80
Pezant: folds 
ng2414: folds 
prettybigtuna: calls $0.60
efreay11: calls $0.60
*** FLOP *** [6s 8h Ks]
prettybigtuna: bets $1.20
efreay11: folds 
OliveXC: folds 
Uncalled bet ($1.20) returned to prettybigtuna
prettybigtuna collected $2.42 from pot
prettybigtuna: doesn't show hand 
*** SUMMARY ***
Total pot $2.55 | Rake $0.13 
Board [6s 8h Ks]
Seat 1: OliveXC (button) folded on the Flop
Seat 2: Pezant (small blind) folded before Flop
Seat 3: ng2414 (big blind) folded before Flop
Seat 4: prettybigtuna collected ($2.42)
Seat 5: PlayTheBlues4U folded before Flop (didn't bet)
Seat 6: efreay11 folded on the Flop


PokerStars Hand #204146578378:  Hold'em No Limit ($0.05/$0.10 USD) - 2019/10/01 22:52:59 ET
Table 'Klytia' 6-max Seat #6 is the button
Seat 1: OliveXC ($17.16 in chips) 
Seat 2: Pezant ($12.78 in chips) 
Seat 3: ng2414 ($10 in chips) 
Seat 4: prettybigtuna ($6.66 in chips) 
Seat 5: PlayTheBlues4U ($11.95 in chips) 
Seat 6: efreay11 ($28.70 in chips) 
OliveXC: posts small blind $0.05
Pezant: posts big blind $0.10
*** HOLE CARDS ***
Dealt to PlayTheBlues4U [5s 8d]
ng2414: folds 
prettybigtuna: calls $0.10
PlayTheBlues4U: folds 
efreay11: calls $0.10
OliveXC: folds 
Pezant: checks 
*** FLOP *** [5d 3d 5c]
Pezant: checks 
prettybigtuna: bets $0.20
efreay11: folds 
Pezant: folds 
Uncalled bet ($0.20) returned to prettybigtuna
prettybigtuna collected $0.33 from pot
prettybigtuna: doesn't show hand 
*** SUMMARY ***
Total pot $0.35 | Rake $0.02 
Board [5d 3d 5c]
Seat 1: OliveXC (small blind) folded before Flop
Seat 2: Pezant (big blind) folded on the Flop
Seat 3: ng2414 folded before Flop (didn't bet)
Seat 4: prettybigtuna collected ($0.33)
Seat 5: PlayTheBlues4U folded before Flop (didn't bet)
Seat 6: efreay11 (button) folded on the Flop


PokerStars Hand #204146578239:  Hold'em No Limit ($0.05/$0.10 USD) - 2019/10/01 22:52:11 ET
Table 'Klytia' 6-max Seat #5 is the button
Seat 1: OliveXC ($17.26 in chips) 
Seat 2: Pezant ($12.78 in chips) 
Seat 3: ng2414 ($10 in chips) 
Seat 4: prettybigtuna ($6.66 in chips) 
Seat 5: PlayTheBlues4U ($11.95 in chips) 
Seat 6: efreay11 ($28.61 in chips) 
efreay11: posts small blind $0.05
OliveXC: posts big blind $0.10
*** HOLE CARDS ***
Dealt to PlayTheBlues4U [8c 3s]
Pezant: folds 
ng2414: folds 
prettybigtuna: folds 
PlayTheBlues4U: folds 
efreay11: calls $0.05
OliveXC: checks 
*** FLOP *** [Ah Kc Js]
efreay11: checks 
OliveXC: checks 
*** TURN *** [Ah Kc Js] [5d]
efreay11: checks 
OliveXC: checks 
*** RIVER *** [Ah Kc Js 5d] [3d]
efreay11: checks 
OliveXC: checks 
*** SHOW DOWN ***
efreay11: shows [7c Qd] (high card Ace)
OliveXC: mucks hand 
efreay11 collected $0.19 from pot
*** SUMMARY ***
Total pot $0.20 | Rake $0.01 
Board [Ah Kc Js 5d 3d]
Seat 1: OliveXC (big blind) mucked [9s 7d]
Seat 2: Pezant folded before Flop (didn't bet)
Seat 3: ng2414 folded before Flop (didn't bet)
Seat 4: prettybigtuna folded before Flop (didn't bet)
Seat 5: PlayTheBlues4U (button) folded before Flop (didn't bet)
Seat 6: efreay11 (small blind) showed [7c Qd] and won ($0.19) with high card Ace


PokerStars Hand #204146578165:  Hold'em No Limit ($0.05/$0.10 USD) - 2019/10/01 22:51:44 ET
Table 'Klytia' 6-max Seat #4 is the button
Seat 1: OliveXC ($17.26 in chips) 
Seat 2: Pezant ($12.78 in chips) 
Seat 3: ng2414 ($10 in chips) 
Seat 4: prettybigtuna ($6.66 in chips) 
Seat 5: PlayTheBlues4U ($12 in chips) 
Seat 6: efreay11 ($28.56 in chips) 
PlayTheBlues4U: posts small blind $0.05
efreay11: posts big blind $0.10
*** HOLE CARDS ***
Dealt to PlayTheBlues4U [Ts 4d]
OliveXC: folds 
Pezant: folds 
ng2414: folds 
prettybigtuna: folds 
PlayTheBlues4U: folds 
Uncalled bet ($0.05) returned to efreay11
efreay11 collected $0.10 from pot
efreay11: doesn't show hand 
*** SUMMARY ***
Total pot $0.10 | Rake $0 
Seat 1: OliveXC folded before Flop (didn't bet)
Seat 2: Pezant folded before Flop (didn't bet)
Seat 3: ng2414 folded before Flop (didn't bet)
Seat 4: prettybigtuna (button) folded before Flop (didn't bet)
Seat 5: PlayTheBlues4U (small blind) folded before Flop
Seat 6: efreay11 (big blind) collected ($0.10)


PokerStars Hand #204146578145:  Hold'em No Limit ($0.02/$0.05 USD) - 2019/10/01 22:51:37 ET
Table 'Corvus' 6-max Seat #2 is the button
Seat 1: Trratata ($5.03 in chips) 
Seat 2: REDRUM192 ($2.60 in chips) 
Seat 3: hbw28 ($1.76 in chips) 
Seat 5: luckydeigs ($5.12 in chips) 
Seat 6: PlayTheBlues4U ($9.48 in chips) 
hbw28: posts small blind $0.02
luckydeigs: posts big blind $0.05
*** HOLE CARDS ***
Dealt to PlayTheBlues4U [3h 5s]
PlayTheBlues4U: folds 
Trratata: folds 
REDRUM192: raises $0.25 to $0.30
hbw28: folds 
luckydeigs: folds 
Uncalled bet ($0.25) returned to REDRUM192
REDRUM192 collected $0.12 from pot
REDRUM192: doesn't show hand 
*** SUMMARY ***
Total pot $0.12 | Rake $0 
Seat 1: Trratata folded before Flop (didn't bet)
Seat 2: REDRUM192 (button) collected ($0.12)
Seat 3: hbw28 (small blind) folded before Flop
Seat 5: luckydeigs (big blind) folded before Flop
Seat 6: PlayTheBlues4U folded before Flop (didn't bet)


PokerStars Hand #204146578031:  Hold'em No Limit ($0.02/$0.05 USD) - 2019/10/01 22:50:59 ET
Table 'Corvus' 6-max Seat #1 is the button
Seat 1: Trratata ($5.03 in chips) 
Seat 2: REDRUM192 ($2.62 in chips) 
Seat 3: hbw28 ($1.70 in chips) 
Seat 4: artbone30 ($1.44 in chips) 
Seat 5: luckydeigs ($5.12 in chips) 
Seat 6: PlayTheBlues4U ($9.48 in chips) 
REDRUM192: posts small blind $0.02
hbw28: posts big blind $0.05
*** HOLE CARDS ***
Dealt to PlayTheBlues4U [Kc 6d]
artbone30: calls $0.05
luckydeigs: folds 
PlayTheBlues4U: folds 
Trratata: folds 
REDRUM192: folds 
hbw28: checks 
*** FLOP *** [7c 8h 3s]
hbw28: bets $0.10
artbone30 has timed out
artbone30: folds 
Uncalled bet ($0.10) returned to hbw28
hbw28 collected $0.11 from pot
hbw28: doesn't show hand 
*** SUMMARY ***
Total pot $0.12 | Rake $0.01 
Board [7c 8h 3s]
Seat 1: Trratata (button) folded before Flop (didn't bet)
Seat 2: REDRUM192 (small blind) folded before Flop
Seat 3: hbw28 (big blind) collected ($0.11)
Seat 4: artbone30 folded on the Flop
Seat 5: luckydeigs folded before Flop (didn't bet)
Seat 6: PlayTheBlues4U folded before Flop (didn't bet)


PokerStars Hand #204146577997:  Hold'em No Limit ($0.05/$0.10 USD) - 2019/10/01 22:50:46 ET
Table 'Klytia' 6-max Seat #3 is the button
Seat 1: OliveXC ($17.26 in chips) 
Seat 2: Pezant ($12.78 in chips) 
Seat 3: ng2414 ($10 in chips) 
Seat 4: prettybigtuna ($6.76 in chips) 
Seat 5: PlayTheBlues4U ($12.10 in chips) 
Seat 6: efreay11 ($28.38 in chips) 
prettybigtuna: posts small blind $0.05
PlayTheBlues4U: posts big blind $0.10
*** HOLE CARDS ***
Dealt to PlayTheBlues4U [7c Th]
efreay11: calls $0.10
OliveXC: folds 
Pezant: folds 
ng2414: folds 
prettybigtuna: calls $0.05
PlayTheBlues4U: checks 
*** FLOP *** [4c Jc Kd]
prettybigtuna: checks 
PlayTheBlues4U: checks 
efreay11: checks 
*** TURN *** [4c Jc Kd] [3c]
prettybigtuna: checks 
PlayTheBlues4U: checks 
efreay11: checks 
*** RIVER *** [4c Jc Kd 3c] [6h]
prettybigtuna: checks 
PlayTheBlues4U: checks 
efreay11: checks 
*** SHOW DOWN ***
prettybigtuna: shows [9h 2c] (high card King)
PlayTheBlues4U: shows [7c Th] (high card King - Jack+Ten kicker)
efreay11: shows [Ts Tc] (a pair of Tens)
efreay11 collected $0.28 from pot
*** SUMMARY ***
Total pot $0.30 | Rake $0.02 
Board [4c Jc Kd 3c 6h]
Seat 1: OliveXC folded before Flop (didn't bet)
Seat 2: Pezant folded before Flop (didn't bet)
Seat 3: ng2414 (button) folded before Flop (didn't bet)
Seat 4: prettybigtuna (small blind) showed [9h 2c] and lost with high card King
Seat 5: PlayTheBlues4U (big blind) showed [7c Th] and lost with high card King
Seat 6: efreay11 showed [Ts Tc] and won ($0.28) with a pair of Tens


PokerStars Hand #204146577900:  Hold'em No Limit ($0.02/$0.05 USD) - 2019/10/01 22:50:11 ET
Table 'Corvus' 6-max Seat #6 is the button
Seat 1: Trratata ($5.05 in chips) 
Seat 2: REDRUM192 ($3.37 in chips) 
Seat 3: hbw28 ($1.70 in chips) 
Seat 5: luckydeigs ($5.12 in chips) 
Seat 6: PlayTheBlues4U ($8.79 in chips) 
Trratata: posts small blind $0.02
REDRUM192: posts big blind $0.05
*** HOLE CARDS ***
Dealt to PlayTheBlues4U [7c Qd]
hbw28: folds 
luckydeigs: folds 
PlayTheBlues4U: raises $0.10 to $0.15
Trratata: folds 
REDRUM192: calls $0.10
*** FLOP *** [2c 3c Qc]
REDRUM192: checks 
PlayTheBlues4U: bets $0.20
REDRUM192: calls $0.20
*** TURN *** [2c 3c Qc] [3h]
REDRUM192: checks 
PlayTheBlues4U: bets $0.40
REDRUM192: calls $0.40
*** RIVER *** [2c 3c Qc 3h] [4c]
REDRUM192: checks 
PlayTheBlues4U: checks 
*** SHOW DOWN ***
REDRUM192: shows [Qh Th] (two pair, Queens and Threes)
PlayTheBlues4U: shows [7c Qd] (a flush, Queen high)
PlayTheBlues4U collected $1.44 from pot
*** SUMMARY ***
Total pot $1.52 | Rake $0.08 
Board [2c 3c Qc 3h 4c]
Seat 1: Trratata (small blind) folded before Flop
Seat 2: REDRUM192 (big blind) showed [Qh Th] and lost with two pair, Queens and Threes
Seat 3: hbw28 folded before Flop (didn't bet)
Seat 5: luckydeigs folded before Flop (didn't bet)
Seat 6: PlayTheBlues4U (button) showed [7c Qd] and won ($1.44) with a flush, Queen high


PokerStars Hand #204146577856:  Hold'em No Limit ($0.02/$0.05 USD) - 2019/10/01 22:49:56 ET
Table 'Corvus' 6-max Seat #5 is the button
Seat 1: Trratata ($5.03 in chips) 
Seat 2: REDRUM192 ($3.37 in chips) 
Seat 3: hbw28 ($1.70 in chips) 
Seat 5: luckydeigs ($5.12 in chips) 
Seat 6: PlayTheBlues4U ($8.81 in chips) 
PlayTheBlues4U: posts small blind $0.02
Trratata: posts big blind $0.05
*** HOLE CARDS ***
Dealt to PlayTheBlues4U [Kh 2d]
REDRUM192: folds 
hbw28: folds 
luckydeigs: folds 
PlayTheBlues4U: folds 
Uncalled bet ($0.03) returned to Trratata
Trratata collected $0.04 from pot
Trratata: doesn't show hand 
*** SUMMARY ***
Total pot $0.04 | Rake $0 
Seat 1: Trratata (big blind) collected ($0.04)
Seat 2: REDRUM192 folded before Flop (didn't bet)
Seat 3: hbw28 folded before Flop (didn't bet)
Seat 5: luckydeigs (button) folded before Flop (didn't bet)
Seat 6: PlayTheBlues4U (small blind) folded before Flop


PokerStars Hand #204146577814:  Hold'em No Limit ($0.05/$0.10 USD) - 2019/10/01 22:49:43 ET
Table 'Klytia' 6-max Seat #2 is the button
Seat 1: OliveXC ($17.26 in chips) 
Seat 2: Pezant ($11.14 in chips) 
Seat 3: ng2414 ($2.73 in chips) 
Seat 4: prettybigtuna ($8 in chips) 
Seat 5: PlayTheBlues4U ($12.10 in chips) 
Seat 6: efreay11 ($28.88 in chips) 
ng2414: posts small blind $0.05
prettybigtuna: posts big blind $0.10
*** HOLE CARDS ***
Dealt to PlayTheBlues4U [7c 4d]
PlayTheBlues4U: folds 
efreay11: calls $0.10
OliveXC: folds 
Pezant: raises $0.40 to $0.50
ng2414: folds 
prettybigtuna: calls $0.40
efreay11: calls $0.40
*** FLOP *** [Ks Ts 5s]
prettybigtuna: checks 
efreay11: checks 
Pezant: bets $0.74
prettybigtuna: calls $0.74
efreay11: folds 
*** TURN *** [Ks Ts 5s] [3d]
prettybigtuna: checks 
Pezant: bets $1.44
prettybigtuna: folds 
Uncalled bet ($1.44) returned to Pezant
Pezant collected $2.88 from pot
Pezant: doesn't show hand 
*** SUMMARY ***
Total pot $3.03 | Rake $0.15 
Board [Ks Ts 5s 3d]
Seat 1: OliveXC folded before Flop (didn't bet)
Seat 2: Pezant (button) collected ($2.88)
Seat 3: ng2414 (small blind) folded before Flop
Seat 4: prettybigtuna (big blind) folded on the Turn
Seat 5: PlayTheBlues4U folded before Flop (didn't bet)
Seat 6: efreay11 folded on the Flop


PokerStars Hand #204146577690:  Hold'em No Limit ($0.02/$0.05 USD) - 2019/10/01 22:49:02 ET
Table 'Corvus' 6-max Seat #4 is the button
Seat 1: Trratata ($5.03 in chips) 
Seat 2: REDRUM192 ($3.37 in chips) 
Seat 3: hbw28 ($1.70 in chips) 
Seat 4: artbone30 ($1.49 in chips) 
Seat 5: luckydeigs ($5.14 in chips) 
Seat 6: PlayTheBlues4U ($8.74 in chips) 
luckydeigs: posts small blind $0.02
PlayTheBlues4U: posts big blind $0.05
*** HOLE CARDS ***
Dealt to PlayTheBlues4U [9c 9s]
Trratata: folds 
REDRUM192: folds 
hbw28: folds 
artbone30: calls $0.05
luckydeigs: folds 
PlayTheBlues4U: raises $0.10 to $0.15
artbone30 has timed out
artbone30: folds 
Uncalled bet ($0.10) returned to PlayTheBlues4U
PlayTheBlues4U collected $0.12 from pot
PlayTheBlues4U: doesn't show hand 
*** SUMMARY ***
Total pot $0.12 | Rake $0 
Seat 1: Trratata folded before Flop (didn't bet)
Seat 2: REDRUM192 folded before Flop (didn't bet)
Seat 3: hbw28 folded before Flop (didn't bet)
Seat 4: artbone30 (button) folded before Flop
Seat 5: luckydeigs (small blind) folded before Flop
Seat 6: PlayTheBlues4U (big blind) collected ($0.12)


PokerStars Hand #204146577592:  Hold'em No Limit ($0.05/$0.10 USD) - 2019/10/01 22:48:29 ET
Table 'Klytia' 6-max Seat #1 is the button
Seat 1: OliveXC ($17.26 in chips) 
Seat 2: Pezant ($11.10 in chips) 
Seat 3: ng2414 ($2.83 in chips) 
Seat 5: PlayTheBlues4U ($12.10 in chips) 
Seat 6: efreay11 ($28.84 in chips) 
Pezant: posts small blind $0.05
ng2414: posts big blind $0.10
prettybigtuna: sits out 
*** HOLE CARDS ***
Dealt to PlayTheBlues4U [As 7c]
PlayTheBlues4U: folds 
efreay11: calls $0.10
OliveXC: folds 
Pezant: calls $0.05
PlayTheBlues4U said, "close enough"
ng2414: checks 
*** FLOP *** [9d Kh Ts]
Pezant: checks 
ng2414: checks 
PlayTheBlues4U said, "I probably call there too"
PlayTheBlues4U said, "lots of draws miss"
efreay11: bets $0.10
Pezant: calls $0.10
ng2414: folds 
*** TURN *** [9d Kh Ts] [8s]
Pezant: checks 
efreay11: checks 
*** RIVER *** [9d Kh Ts 8s] [8h]
Pezant: checks 
efreay11: checks 
*** SHOW DOWN ***
Pezant: shows [Td Jh] (two pair, Tens and Eights)
efreay11: shows [Tc 7s] (two pair, Tens and Eights)
Pezant collected $0.24 from pot
efreay11 collected $0.24 from pot
*** SUMMARY ***
Total pot $0.50 | Rake $0.02 
Board [9d Kh Ts 8s 8h]
Seat 1: OliveXC (button) folded before Flop (didn't bet)
Seat 2: Pezant (small blind) showed [Td Jh] and won ($0.24) with two pair, Tens and Eights
Seat 3: ng2414 (big blind) folded on the Flop
Seat 5: PlayTheBlues4U folded before Flop (didn't bet)
Seat 6: efreay11 showed [Tc 7s] and won ($0.24) with two pair, Tens and Eights


PokerStars Hand #204146577583:  Hold'em No Limit ($0.02/$0.05 USD) - 2019/10/01 22:48:27 ET
Table 'Corvus' 6-max Seat #3 is the button
Seat 1: Trratata ($5.03 in chips) 
Seat 2: REDRUM192 ($3.37 in chips) 
Seat 3: hbw28 ($1.80 in chips) 
Seat 4: artbone30 ($1.54 in chips) 
Seat 5: luckydeigs ($5 in chips) 
Seat 6: PlayTheBlues4U ($8.74 in chips) 
artbone30: posts small blind $0.02
luckydeigs: posts big blind $0.05
*** HOLE CARDS ***
Dealt to PlayTheBlues4U [Qs 8c]
PlayTheBlues4U: folds 
Trratata: folds 
REDRUM192: folds 
hbw28: calls $0.05
artbone30: calls $0.03
luckydeigs: checks 
*** FLOP *** [9h Ts 6d]
artbone30: checks 
luckydeigs: checks 
hbw28: checks 
*** TURN *** [9h Ts 6d] [Th]
artbone30: checks 
luckydeigs: checks 
hbw28: bets $0.05
artbone30: folds 
luckydeigs: calls $0.05
*** RIVER *** [9h Ts 6d Th] [Ad]
luckydeigs: bets $0.12
hbw28: folds 
Uncalled bet ($0.12) returned to luckydeigs
luckydeigs collected $0.24 from pot
luckydeigs: doesn't show hand 
*** SUMMARY ***
Total pot $0.25 | Rake $0.01 
Board [9h Ts 6d Th Ad]
Seat 1: Trratata folded before Flop (didn't bet)
Seat 2: REDRUM192 folded before Flop (didn't bet)
Seat 3: hbw28 (button) folded on the River
Seat 4: artbone30 (small blind) folded on the Turn
Seat 5: luckydeigs (big blind) collected ($0.24)
Seat 6: PlayTheBlues4U folded before Flop (didn't bet)


PokerStars Hand #204146577460:  Hold'em No Limit ($0.02/$0.05 USD) - 2019/10/01 22:47:52 ET
Table 'Corvus' 6-max Seat #2 is the button
Seat 1: Trratata ($5.03 in chips) 
Seat 2: REDRUM192 ($3.37 in chips) 
Seat 3: hbw28 ($1.75 in chips) 
Seat 4: artbone30 ($1.59 in chips) 
Seat 5: luckydeigs ($5 in chips) 
Seat 6: PlayTheBlues4U ($8.74 in chips) 
hbw28: posts small blind $0.02
artbone30: posts big blind $0.05
*** HOLE CARDS ***
Dealt to PlayTheBlues4U [Qc 7s]
luckydeigs: folds 
PlayTheBlues4U: folds 
Trratata: folds 
REDRUM192: folds 
hbw28: calls $0.03
artbone30: checks 
*** FLOP *** [9c 2h Jh]
hbw28: checks 
artbone30: checks 
*** TURN *** [9c 2h Jh] [Jd]
hbw28: checks 
artbone30: checks 
*** RIVER *** [9c 2h Jh Jd] [2c]
hbw28: checks 
artbone30: checks 
*** SHOW DOWN ***
hbw28: shows [3d Kd] (two pair, Jacks and Deuces)
artbone30: mucks hand 
hbw28 collected $0.10 from pot
*** SUMMARY ***
Total pot $0.10 | Rake $0 
Board [9c 2h Jh Jd 2c]
Seat 1: Trratata folded before Flop (didn't bet)
Seat 2: REDRUM192 (button) folded before Flop (didn't bet)
Seat 3: hbw28 (small blind) showed [3d Kd] and won ($0.10) with two pair, Jacks and Deuces
Seat 4: artbone30 (big blind) mucked [5h Ts]
Seat 5: luckydeigs folded before Flop (didn't bet)
Seat 6: PlayTheBlues4U folded before Flop (didn't bet)


PokerStars Hand #204146577416:  Hold'em No Limit ($0.02/$0.05 USD) - 2019/10/01 22:47:37 ET
Table 'Corvus' 6-max Seat #1 is the button
Seat 1: Trratata ($5.03 in chips) 
Seat 2: REDRUM192 ($3.39 in chips) 
Seat 3: hbw28 ($1.80 in chips) 
Seat 4: artbone30 ($1.59 in chips) 
Seat 5: luckydeigs ($4.93 in chips) 
Seat 6: PlayTheBlues4U ($8.74 in chips) 
REDRUM192: posts small blind $0.02
hbw28: posts big blind $0.05
*** HOLE CARDS ***
Dealt to PlayTheBlues4U [Kd 5d]
artbone30: folds 
luckydeigs: raises $0.10 to $0.15
PlayTheBlues4U: folds 
Trratata: folds 
REDRUM192: folds 
hbw28: folds 
Uncalled bet ($0.10) returned to luckydeigs
luckydeigs collected $0.12 from pot
luckydeigs: doesn't show hand 
*** SUMMARY ***
Total pot $0.12 | Rake $0 
Seat 1: Trratata (button) folded before Flop (didn't bet)
Seat 2: REDRUM192 (small blind) folded before Flop
Seat 3: hbw28 (big blind) folded before Flop
Seat 4: artbone30 folded before Flop (didn't bet)
Seat 5: luckydeigs collected ($0.12)
Seat 6: PlayTheBlues4U folded before Flop (didn't bet)


PokerStars Hand #204146577310:  Hold'em No Limit ($0.02/$0.05 USD) - 2019/10/01 22:47:01 ET
Table 'Corvus' 6-max Seat #6 is the button
Seat 1: Trratata ($4.80 in chips) 
Seat 2: REDRUM192 ($3.44 in chips) 
Seat 3: hbw28 ($1.95 in chips) 
Seat 4: artbone30 ($1.64 in chips) 
Seat 5: luckydeigs ($4.93 in chips) 
Seat 6: PlayTheBlues4U ($8.74 in chips) 
Trratata: posts small blind $0.02
REDRUM192: posts big blind $0.05
*** HOLE CARDS ***
Dealt to PlayTheBlues4U [2c 7s]
hbw28: calls $0.05
artbone30: calls $0.05
luckydeigs: folds 
PlayTheBlues4U: folds 
Trratata: calls $0.03
REDRUM192: checks 
*** FLOP *** [8h Jd Ad]
Trratata: bets $0.10
REDRUM192: folds 
hbw28: calls $0.10
artbone30: folds 
*** TURN *** [8h Jd Ad] [As]
Trratata: bets $0.15
hbw28: folds 
Uncalled bet ($0.15) returned to Trratata
Trratata collected $0.38 from pot
Trratata: doesn't show hand 
*** SUMMARY ***
Total pot $0.40 | Rake $0.02 
Board [8h Jd Ad As]
Seat 1: Trratata (small blind) collected ($0.38)
Seat 2: REDRUM192 (big blind) folded on the Flop
Seat 3: hbw28 folded on the Turn
Seat 4: artbone30 folded on the Flop
Seat 5: luckydeigs folded before Flop (didn't bet)
Seat 6: PlayTheBlues4U (button) folded before Flop (didn't bet)


PokerStars Hand #204146577272:  Hold'em No Limit ($0.02/$0.05 USD) - 2019/10/01 22:46:45 ET
Table 'Corvus' 6-max Seat #5 is the button
Seat 1: Trratata ($4.85 in chips) 
Seat 2: REDRUM192 ($3.44 in chips) 
Seat 3: hbw28 ($1.95 in chips) 
Seat 4: artbone30 ($1.57 in chips) 
Seat 5: luckydeigs ($4.93 in chips) 
Seat 6: PlayTheBlues4U ($8.76 in chips) 
PlayTheBlues4U: posts small blind $0.02
Trratata: posts big blind $0.05
*** HOLE CARDS ***
Dealt to PlayTheBlues4U [Kd 5h]
REDRUM192: folds 
hbw28: folds 
artbone30: raises $1.52 to $1.57 and is all-in
luckydeigs: folds 
PlayTheBlues4U: folds 
Trratata: folds 
Uncalled bet ($1.52) returned to artbone30
artbone30 collected $0.12 from pot
artbone30: doesn't show hand 
*** SUMMARY ***
Total pot $0.12 | Rake $0 
Seat 1: Trratata (big blind) folded before Flop
Seat 2: REDRUM192 folded before Flop (didn't bet)
Seat 3: hbw28 folded before Flop (didn't bet)
Seat 4: artbone30 collected ($0.12)
Seat 5: luckydeigs (button) folded before Flop (didn't bet)
Seat 6: PlayTheBlues4U (small blind) folded before Flop


PokerStars Hand #204146577206:  Hold'em No Limit ($0.02/$0.05 USD) - 2019/10/01 22:46:24 ET
Table 'Corvus' 6-max Seat #4 is the button
Seat 1: Trratata ($4.85 in chips) 
Seat 2: REDRUM192 ($3.44 in chips) 
Seat 3: hbw28 ($2 in chips) 
Seat 4: artbone30 ($1.45 in chips) 
Seat 5: luckydeigs ($4.95 in chips) 
Seat 6: PlayTheBlues4U ($8.81 in chips) 
luckydeigs: posts small blind $0.02
PlayTheBlues4U: posts big blind $0.05
hbw28: posts big blind $0.05
*** HOLE CARDS ***
Dealt to PlayTheBlues4U [As 4c]
Trratata: folds 
REDRUM192: folds 
hbw28: checks 
artbone30: raises $0.05 to $0.10
luckydeigs: folds 
PlayTheBlues4U: folds 
hbw28: folds 
Uncalled bet ($0.05) returned to artbone30
artbone30 collected $0.17 from pot
artbone30: doesn't show hand 
*** SUMMARY ***
Total pot $0.17 | Rake $0 
Seat 1: Trratata folded before Flop (didn't bet)
Seat 2: REDRUM192 folded before Flop (didn't bet)
Seat 3: hbw28 folded before Flop (didn't bet)
Seat 4: artbone30 (button) collected ($0.17)
Seat 5: luckydeigs (small blind) folded before Flop
Seat 6: PlayTheBlues4U (big blind) folded before Flop


PokerStars Hand #204146577121:  Hold'em No Limit ($0.02/$0.05 USD) - 2019/10/01 22:45:55 ET
Table 'Corvus' 6-max Seat #2 is the button
Seat 1: Trratata ($4.65 in chips) 
Seat 2: REDRUM192 ($3.44 in chips) 
Seat 4: artbone30 ($1.62 in chips) 
Seat 5: luckydeigs ($5 in chips) 
Seat 6: PlayTheBlues4U ($8.81 in chips) 
hbw28 will be allowed to play after the button
artbone30: posts small blind $0.02
luckydeigs: posts big blind $0.05
*** HOLE CARDS ***
Dealt to PlayTheBlues4U [3h Qh]
PlayTheBlues4U: folds 
Trratata: raises $0.12 to $0.17
REDRUM192: folds 
artbone30: calls $0.15
luckydeigs: folds 
*** FLOP *** [3s Jd 5s]
artbone30: checks 
Trratata: bets $0.19
artbone30: folds 
Uncalled bet ($0.19) returned to Trratata
Trratata collected $0.37 from pot
Trratata: doesn't show hand 
*** SUMMARY ***
Total pot $0.39 | Rake $0.02 
Board [3s Jd 5s]
Seat 1: Trratata collected ($0.37)
Seat 2: REDRUM192 (button) folded before Flop (didn't bet)
Seat 4: artbone30 (small blind) folded on the Flop
Seat 5: luckydeigs (big blind) folded before Flop
Seat 6: PlayTheBlues4U folded before Flop (didn't bet)


PokerStars Hand #204146577098:  Hold'em No Limit ($0.05/$0.10 USD) - 2019/10/01 22:45:47 ET
Table 'Klytia' 6-max Seat #6 is the button
Seat 1: OliveXC ($17.31 in chips) 
Seat 2: Pezant ($11.20 in chips) 
Seat 3: ng2414 ($7.91 in chips) 
Seat 5: PlayTheBlues4U ($7.39 in chips) 
Seat 6: efreay11 ($28.84 in chips) 
OliveXC: posts small blind $0.05
Pezant: posts big blind $0.10
*** HOLE CARDS ***
Dealt to PlayTheBlues4U [8c 8s]
ng2414: raises $0.20 to $0.30
PlayTheBlues4U: calls $0.30
efreay11: folds 
OliveXC: folds 
Pezant: folds 
*** FLOP *** [5d Th 3h]
ng2414: checks 
PlayTheBlues4U: bets $0.40
ng2414: calls $0.40
*** TURN *** [5d Th 3h] [8d]
ng2414: bets $0.74
PlayTheBlues4U: raises $1.24 to $1.98
ng2414: calls $1.24
*** RIVER *** [5d Th 3h 8d] [6s]
prettybigtuna joins the table at seat #4 
ng2414: checks 
PlayTheBlues4U: bets $2.40
ng2414 said, "U have 55?"
ng2414 said, "meh"
ng2414: calls $2.40
*** SHOW DOWN ***
PlayTheBlues4U: shows [8c 8s] (three of a kind, Eights)
ng2414: mucks hand 
PlayTheBlues4U collected $9.79 from pot
*** SUMMARY ***
Total pot $10.31 | Rake $0.52 
Board [5d Th 3h 8d 6s]
Seat 1: OliveXC (small blind) folded before Flop
Seat 2: Pezant (big blind) folded before Flop
Seat 3: ng2414 mucked [Jc Jh]
Seat 5: PlayTheBlues4U showed [8c 8s] and won ($9.79) with three of a kind, Eights
Seat 6: efreay11 (button) folded before Flop (didn't bet)


PokerStars Hand #204146577066:  Hold'em No Limit ($0.02/$0.05 USD) - 2019/10/01 22:45:37 ET
Table 'Corvus' 6-max Seat #1 is the button
Seat 1: Trratata ($4.65 in chips) 
Seat 2: REDRUM192 ($3.46 in chips) 
Seat 4: artbone30 ($1.67 in chips) 
Seat 5: luckydeigs ($4.93 in chips) 
Seat 6: PlayTheBlues4U ($8.81 in chips) 
REDRUM192: posts small blind $0.02
artbone30: posts big blind $0.05
*** HOLE CARDS ***
Dealt to PlayTheBlues4U [5c 4s]
hbw28 joins the table at seat #3 
luckydeigs: raises $0.10 to $0.15
PlayTheBlues4U: folds 
Trratata: folds 
REDRUM192: folds 
artbone30: folds 
Uncalled bet ($0.10) returned to luckydeigs
luckydeigs collected $0.12 from pot
luckydeigs: doesn't show hand 
*** SUMMARY ***
Total pot $0.12 | Rake $0 
Seat 1: Trratata (button) folded before Flop (didn't bet)
Seat 2: REDRUM192 (small blind) folded before Flop
Seat 4: artbone30 (big blind) folded before Flop
Seat 5: luckydeigs collected ($0.12)
Seat 6: PlayTheBlues4U folded before Flop (didn't bet)


PokerStars Hand #204146576912:  Hold'em No Limit ($0.05/$0.10 USD) - 2019/10/01 22:44:40 ET
Table 'Klytia' 6-max Seat #5 is the button
Seat 1: OliveXC ($16.45 in chips) 
Seat 2: Pezant ($11.20 in chips) 
Seat 3: ng2414 ($7.91 in chips) 
Seat 5: PlayTheBlues4U ($8.29 in chips) 
Seat 6: efreay11 ($28.89 in chips) 
efreay11: posts small blind $0.05
OliveXC: posts big blind $0.10
*** HOLE CARDS ***
Dealt to PlayTheBlues4U [Kh Ah]
Pezant: folds 
ng2414: folds 
PlayTheBlues4U: raises $0.20 to $0.30
efreay11: folds 
OliveXC: calls $0.20
*** FLOP *** [2d Js 5h]
OliveXC: checks 
PlayTheBlues4U: bets $0.30
OliveXC: calls $0.30
*** TURN *** [2d Js 5h] [3d]
OliveXC: checks 
PlayTheBlues4U: checks 
*** RIVER *** [2d Js 5h 3d] [5s]
OliveXC: bets $0.30
BaldEagleStar leaves the table
PlayTheBlues4U: calls $0.30
*** SHOW DOWN ***
OliveXC: shows [Ks Jc] (two pair, Jacks and Fives)
PlayTheBlues4U: mucks hand 
OliveXC collected $1.76 from pot
*** SUMMARY ***
Total pot $1.85 | Rake $0.09 
Board [2d Js 5h 3d 5s]
Seat 1: OliveXC (big blind) showed [Ks Jc] and won ($1.76) with two pair, Jacks and Fives
Seat 2: Pezant folded before Flop (didn't bet)
Seat 3: ng2414 folded before Flop (didn't bet)
Seat 5: PlayTheBlues4U (button) mucked [Kh Ah]
Seat 6: efreay11 (small blind) folded before Flop


PokerStars Hand #204146576873:  Hold'em No Limit ($0.05/$0.10 USD) - 2019/10/01 22:44:23 ET
Table 'Klytia' 6-max Seat #3 is the button
Seat 1: OliveXC ($16.30 in chips) 
Seat 2: Pezant ($11.20 in chips) 
Seat 3: ng2414 ($7.91 in chips) 
Seat 5: PlayTheBlues4U ($8.34 in chips) 
Seat 6: efreay11 ($28.99 in chips) 
PlayTheBlues4U: posts small blind $0.05
efreay11: posts big blind $0.10
*** HOLE CARDS ***
Dealt to PlayTheBlues4U [4s 7h]
OliveXC: raises $0.20 to $0.30
Pezant: folds 
ng2414: folds 
PlayTheBlues4U: folds 
efreay11: folds 
Uncalled bet ($0.20) returned to OliveXC
OliveXC collected $0.25 from pot
OliveXC: doesn't show hand 
*** SUMMARY ***
Total pot $0.25 | Rake $0 
Seat 1: OliveXC collected ($0.25)
Seat 2: Pezant folded before Flop (didn't bet)
Seat 3: ng2414 (button) folded before Flop (didn't bet)
Seat 5: PlayTheBlues4U (small blind) folded before Flop
Seat 6: efreay11 (big blind) folded before Flop


PokerStars Hand #204146576748:  Hold'em No Limit ($0.05/$0.10 USD) - 2019/10/01 22:43:38 ET
Table 'Klytia' 6-max Seat #2 is the button
Seat 1: OliveXC ($16.30 in chips) 
Seat 2: Pezant ($10.61 in chips) 
Seat 3: ng2414 ($7.96 in chips) 
Seat 5: PlayTheBlues4U ($8.44 in chips) 
Seat 6: efreay11 ($29.49 in chips) 
ng2414: posts small blind $0.05
PlayTheBlues4U: posts big blind $0.10
*** HOLE CARDS ***
Dealt to PlayTheBlues4U [9c 7h]
efreay11: calls $0.10
OliveXC: folds 
Pezant: raises $0.40 to $0.50
ng2414: folds 
PlayTheBlues4U: folds 
efreay11: calls $0.40
*** FLOP *** [Ks Qh 2d]
efreay11: checks 
Pezant: bets $0.55
efreay11: folds 
Uncalled bet ($0.55) returned to Pezant
Pezant collected $1.09 from pot
Pezant: doesn't show hand 
*** SUMMARY ***
Total pot $1.15 | Rake $0.06 
Board [Ks Qh 2d]
Seat 1: OliveXC folded before Flop (didn't bet)
Seat 2: Pezant (button) collected ($1.09)
Seat 3: ng2414 (small blind) folded before Flop
Seat 5: PlayTheBlues4U (big blind) folded before Flop
Seat 6: efreay11 folded on the Flop


PokerStars Hand #204146576687:  Hold'em No Limit ($0.02/$0.05 USD) - 2019/10/01 22:43:14 ET
Table 'Corvus' 6-max Seat #6 is the button
Seat 1: Trratata ($5.10 in chips) 
Seat 2: REDRUM192 ($2.96 in chips) 
Seat 3: IvanMakeBasket ($1.14 in chips) 
Seat 4: artbone30 ($1.72 in chips) 
Seat 5: luckydeigs ($4.93 in chips) 
Seat 6: PlayTheBlues4U ($8.81 in chips) 
Trratata: posts small blind $0.02
REDRUM192: posts big blind $0.05
*** HOLE CARDS ***
Dealt to PlayTheBlues4U [4s 2s]
IvanMakeBasket: calls $0.05
artbone30: calls $0.05
luckydeigs: folds 
PlayTheBlues4U: folds 
Trratata: calls $0.03
REDRUM192: checks 
*** FLOP *** [4d 3d 3s]
Trratata: checks 
REDRUM192: checks 
IvanMakeBasket: checks 
artbone30 has timed out
artbone30: checks 
*** TURN *** [4d 3d 3s] [5d]
Trratata: bets $0.10
REDRUM192: raises $0.30 to $0.40
IvanMakeBasket: folds 
artbone30: folds 
Trratata: calls $0.30
*** RIVER *** [4d 3d 3s 5d] [7s]
Trratata: checks 
IvanMakeBasket leaves the table
REDRUM192: bets $0.55
Trratata: folds 
Uncalled bet ($0.55) returned to REDRUM192
REDRUM192 collected $0.95 from pot
REDRUM192: doesn't show hand 
*** SUMMARY ***
Total pot $1 | Rake $0.05 
Board [4d 3d 3s 5d 7s]
Seat 1: Trratata (small blind) folded on the River
Seat 2: REDRUM192 (big blind) collected ($0.95)
Seat 3: IvanMakeBasket folded on the Turn
Seat 4: artbone30 folded on the Turn
Seat 5: luckydeigs folded before Flop (didn't bet)
Seat 6: PlayTheBlues4U (button) folded before Flop (didn't bet)


PokerStars Hand #204146576615:  Hold'em No Limit ($0.05/$0.10 USD) - 2019/10/01 22:42:48 ET
Table 'Klytia' 6-max Seat #1 is the button
Seat 1: OliveXC ($16.30 in chips) 
Seat 2: Pezant ($10.66 in chips) 
Seat 3: ng2414 ($8.06 in chips) 
Seat 5: PlayTheBlues4U ($8.44 in chips) 
Seat 6: efreay11 ($29.35 in chips) 
Pezant: posts small blind $0.05
ng2414: posts big blind $0.10
*** HOLE CARDS ***
Dealt to PlayTheBlues4U [5s 2s]
BaldEagleStar is disconnected 
PlayTheBlues4U has timed out
PlayTheBlues4U: folds 
efreay11: calls $0.10
OliveXC: folds 
Pezant: folds 
ng2414: checks 
*** FLOP *** [7s 8d 4s]
ng2414: checks 
efreay11: checks 
*** TURN *** [7s 8d 4s] [Qs]
ng2414: checks 
efreay11: checks 
*** RIVER *** [7s 8d 4s Qs] [6c]
ng2414: checks 
efreay11: checks 
*** SHOW DOWN ***
ng2414: shows [2c 9h] (high card Queen)
efreay11: shows [9s Kd] (high card King)
efreay11 collected $0.24 from pot
*** SUMMARY ***
Total pot $0.25 | Rake $0.01 
Board [7s 8d 4s Qs 6c]
Seat 1: OliveXC (button) folded before Flop (didn't bet)
Seat 2: Pezant (small blind) folded before Flop
Seat 3: ng2414 (big blind) showed [2c 9h] and lost with high card Queen
Seat 5: PlayTheBlues4U folded before Flop (didn't bet)
Seat 6: efreay11 showed [9s Kd] and won ($0.24) with high card King


PokerStars Hand #204146576566:  Hold'em No Limit ($0.05/$0.10 USD) - 2019/10/01 22:42:33 ET
Table 'Klytia' 6-max Seat #6 is the button
Seat 1: OliveXC ($16.35 in chips) 
Seat 2: Pezant ($10.76 in chips) 
Seat 3: ng2414 ($8.06 in chips) 
Seat 5: PlayTheBlues4U ($8.29 in chips) 
Seat 6: efreay11 ($29.35 in chips) 
OliveXC: posts small blind $0.05
Pezant: posts big blind $0.10
*** HOLE CARDS ***
Dealt to PlayTheBlues4U [Kh Kd]
ng2414: folds 
PlayTheBlues4U: raises $0.20 to $0.30
efreay11: folds 
OliveXC: folds 
Pezant: folds 
Uncalled bet ($0.20) returned to PlayTheBlues4U
PlayTheBlues4U collected $0.25 from pot
PlayTheBlues4U: doesn't show hand 
*** SUMMARY ***
Total pot $0.25 | Rake $0 
Seat 1: OliveXC (small blind) folded before Flop
Seat 2: Pezant (big blind) folded before Flop
Seat 3: ng2414 folded before Flop (didn't bet)
Seat 5: PlayTheBlues4U collected ($0.25)
Seat 6: efreay11 (button) folded before Flop (didn't bet)


PokerStars Hand #204146576452:  Hold'em No Limit ($0.05/$0.10 USD) - 2019/10/01 22:41:55 ET
Table 'Klytia' 6-max Seat #5 is the button
Seat 1: OliveXC ($16.45 in chips) 
Seat 2: Pezant ($10.76 in chips) 
Seat 3: ng2414 ($8.06 in chips) 
Seat 5: PlayTheBlues4U ($8.29 in chips) 
Seat 6: efreay11 ($29.26 in chips) 
efreay11: posts small blind $0.05
OliveXC: posts big blind $0.10
*** HOLE CARDS ***
Dealt to PlayTheBlues4U [8h 9c]
Pezant: folds 
ng2414: folds 
PlayTheBlues4U: folds 
efreay11: calls $0.05
OliveXC: checks 
*** FLOP *** [7d 7c Ah]
efreay11: bets $0.10
OliveXC: folds 
Uncalled bet ($0.10) returned to efreay11
efreay11 collected $0.19 from pot
efreay11: doesn't show hand 
*** SUMMARY ***
Total pot $0.20 | Rake $0.01 
Board [7d 7c Ah]
Seat 1: OliveXC (big blind) folded on the Flop
Seat 2: Pezant folded before Flop (didn't bet)
Seat 3: ng2414 folded before Flop (didn't bet)
Seat 5: PlayTheBlues4U (button) folded before Flop (didn't bet)
Seat 6: efreay11 (small blind) collected ($0.19)


PokerStars Hand #204146576415:  Hold'em No Limit ($0.02/$0.05 USD) - 2019/10/01 22:41:45 ET
Table 'Corvus' 6-max Seat #5 is the button
Seat 1: Trratata ($5.15 in chips) 
Seat 2: REDRUM192 ($2.96 in chips) 
Seat 3: IvanMakeBasket ($4.26 in chips) 
Seat 4: artbone30 ($1.72 in chips) 
Seat 5: luckydeigs ($4.93 in chips) 
Seat 6: PlayTheBlues4U ($5.95 in chips) 
PlayTheBlues4U: posts small blind $0.02
Trratata: posts big blind $0.05
*** HOLE CARDS ***
Dealt to PlayTheBlues4U [Tc Td]
REDRUM192: folds 
IvanMakeBasket: raises $0.05 to $0.10
artbone30: folds 
luckydeigs: folds 
PlayTheBlues4U: raises $0.05 to $0.15
Trratata: folds 
IvanMakeBasket: calls $0.05
*** FLOP *** [9d Jd 7h]
PlayTheBlues4U: bets $0.20
IvanMakeBasket: calls $0.20
*** TURN *** [9d Jd 7h] [5s]
PlayTheBlues4U: checks 
IvanMakeBasket: bets $0.71
PlayTheBlues4U: calls $0.71
*** RIVER *** [9d Jd 7h 5s] [3h]
PlayTheBlues4U: checks 
IvanMakeBasket: bets $2.06
PlayTheBlues4U: calls $2.06
*** SHOW DOWN ***
IvanMakeBasket: shows [Th Qd] (high card Queen)
PlayTheBlues4U: shows [Tc Td] (a pair of Tens)
PlayTheBlues4U collected $5.98 from pot
*** SUMMARY ***
Total pot $6.29 | Rake $0.31 
Board [9d Jd 7h 5s 3h]
Seat 1: Trratata (big blind) folded before Flop
Seat 2: REDRUM192 folded before Flop (didn't bet)
Seat 3: IvanMakeBasket showed [Th Qd] and lost with high card Queen
Seat 4: artbone30 folded before Flop (didn't bet)
Seat 5: luckydeigs (button) folded before Flop (didn't bet)
Seat 6: PlayTheBlues4U (small blind) showed [Tc Td] and won ($5.98) with a pair of Tens


PokerStars Hand #204146576332:  Hold'em No Limit ($0.02/$0.05 USD) - 2019/10/01 22:41:20 ET
Table 'Corvus' 6-max Seat #4 is the button
Seat 1: Trratata ($5.15 in chips) 
Seat 2: REDRUM192 ($2.89 in chips) 
Seat 3: IvanMakeBasket ($4.26 in chips) 
Seat 4: artbone30 ($1.72 in chips) 
Seat 5: luckydeigs ($4.95 in chips) 
Seat 6: PlayTheBlues4U ($6 in chips) 
luckydeigs: posts small blind $0.02
PlayTheBlues4U: posts big blind $0.05
*** HOLE CARDS ***
Dealt to PlayTheBlues4U [2s 7h]
Trratata: folds 
REDRUM192: raises $0.25 to $0.30
IvanMakeBasket: folds 
artbone30: folds 
luckydeigs: folds 
PlayTheBlues4U: folds 
Uncalled bet ($0.25) returned to REDRUM192
REDRUM192 collected $0.12 from pot
REDRUM192: doesn't show hand 
*** SUMMARY ***
Total pot $0.12 | Rake $0 
Seat 1: Trratata folded before Flop (didn't bet)
Seat 2: REDRUM192 collected ($0.12)
Seat 3: IvanMakeBasket folded before Flop (didn't bet)
Seat 4: artbone30 (button) folded before Flop (didn't bet)
Seat 5: luckydeigs (small blind) folded before Flop
Seat 6: PlayTheBlues4U (big blind) folded before Flop


PokerStars Hand #204146576291:  Hold'em No Limit ($0.05/$0.10 USD) - 2019/10/01 22:41:05 ET
Table 'Klytia' 6-max Seat #3 is the button
Seat 1: OliveXC ($15.04 in chips) 
Seat 2: Pezant ($10.76 in chips) 
Seat 3: ng2414 ($8.06 in chips) 
Seat 4: BaldEagleStar ($1.35 in chips) 
Seat 5: PlayTheBlues4U ($8.39 in chips) 
Seat 6: efreay11 ($29.36 in chips) 
BaldEagleStar: posts small blind $0.05
PlayTheBlues4U: posts big blind $0.10
*** HOLE CARDS ***
Dealt to PlayTheBlues4U [6d 8s]
PlayTheBlues4U said, "king high good?"
efreay11: calls $0.10
OliveXC: raises $0.50 to $0.60
Pezant: folds 
ng2414: folds 
BaldEagleStar: raises $0.50 to $1.10
PlayTheBlues4U: folds 
BaldEagleStar said, "pair"
efreay11: folds 
OliveXC: raises $0.50 to $1.60
BaldEagleStar: calls $0.25 and is all-in
Uncalled bet ($0.25) returned to OliveXC
*** FLOP *** [3h Qc 4d]
*** TURN *** [3h Qc 4d] [6h]
*** RIVER *** [3h Qc 4d 6h] [Ah]
*** SHOW DOWN ***
BaldEagleStar: shows [8h 8d] (a pair of Eights)
OliveXC: shows [Jd Js] (a pair of Jacks)
OliveXC collected $2.76 from pot
*** SUMMARY ***
Total pot $2.90 | Rake $0.14 
Board [3h Qc 4d 6h Ah]
Seat 1: OliveXC showed [Jd Js] and won ($2.76) with a pair of Jacks
Seat 2: Pezant folded before Flop (didn't bet)
Seat 3: ng2414 (button) folded before Flop (didn't bet)
Seat 4: BaldEagleStar (small blind) showed [8h 8d] and lost with a pair of Eights
Seat 5: PlayTheBlues4U (big blind) folded before Flop
Seat 6: efreay11 folded before Flop


PokerStars Hand #204146576178:  Hold'em No Limit ($0.02/$0.05 USD) - 2019/10/01 22:40:23 ET
Table 'Corvus' 6-max Seat #3 is the button
Seat 1: Trratata ($5.15 in chips) 
Seat 2: REDRUM192 ($2.64 in chips) 
Seat 3: IvanMakeBasket ($4.46 in chips) 
Seat 4: artbone30 ($1.74 in chips) 
Seat 5: luckydeigs ($5 in chips) 
Seat 6: PlayTheBlues4U ($6 in chips) 
artbone30: posts small blind $0.02
luckydeigs: posts big blind $0.05
*** HOLE CARDS ***
Dealt to PlayTheBlues4U [8h 3c]
PlayTheBlues4U: folds 
Trratata: folds 
REDRUM192: calls $0.05
IvanMakeBasket: calls $0.05
artbone30: folds 
luckydeigs: checks 
*** FLOP *** [8c Jd 7c]
luckydeigs: checks 
REDRUM192: bets $0.15
IvanMakeBasket: calls $0.15
luckydeigs: folds 
*** TURN *** [8c Jd 7c] [9c]
REDRUM192: bets $0.23
IvanMakeBasket: folds 
Uncalled bet ($0.23) returned to REDRUM192
REDRUM192 collected $0.45 from pot
REDRUM192: doesn't show hand 
*** SUMMARY ***
Total pot $0.47 | Rake $0.02 
Board [8c Jd 7c 9c]
Seat 1: Trratata folded before Flop (didn't bet)
Seat 2: REDRUM192 collected ($0.45)
Seat 3: IvanMakeBasket (button) folded on the Turn
Seat 4: artbone30 (small blind) folded before Flop
Seat 5: luckydeigs (big blind) folded on the Flop
Seat 6: PlayTheBlues4U folded before Flop (didn't bet)


PokerStars Hand #204146576113:  Hold'em No Limit ($0.05/$0.10 USD) - 2019/10/01 22:40:00 ET
Table 'Klytia' 6-max Seat #2 is the button
Seat 1: OliveXC ($15.04 in chips) 
Seat 2: Pezant ($10.76 in chips) 
Seat 3: ng2414 ($8.11 in chips) 
Seat 4: BaldEagleStar ($1.03 in chips) 
Seat 5: PlayTheBlues4U ($8.69 in chips) 
Seat 6: efreay11 ($29.36 in chips) 
ng2414: posts small blind $0.05
BaldEagleStar: posts big blind $0.10
*** HOLE CARDS ***
Dealt to PlayTheBlues4U [Kd Jh]
PlayTheBlues4U: raises $0.20 to $0.30
efreay11: folds 
OliveXC: folds 
Pezant: folds 
ng2414: folds 
BaldEagleStar: calls $0.20
*** FLOP *** [9h 8h 6h]
BaldEagleStar: checks 
PlayTheBlues4U: checks 
*** TURN *** [9h 8h 6h] [5s]
BaldEagleStar: checks 
PlayTheBlues4U: checks 
*** RIVER *** [9h 8h 6h 5s] [2c]
BaldEagleStar: bets $0.10
PlayTheBlues4U: folds 
Uncalled bet ($0.10) returned to BaldEagleStar
BaldEagleStar collected $0.62 from pot
BaldEagleStar: doesn't show hand 
*** SUMMARY ***
Total pot $0.65 | Rake $0.03 
Board [9h 8h 6h 5s 2c]
Seat 1: OliveXC folded before Flop (didn't bet)
Seat 2: Pezant (button) folded before Flop (didn't bet)
Seat 3: ng2414 (small blind) folded before Flop
Seat 4: BaldEagleStar (big blind) collected ($0.62)
Seat 5: PlayTheBlues4U folded on the River
Seat 6: efreay11 folded before Flop (didn't bet)


PokerStars Hand #204146576025:  Hold'em No Limit ($0.02/$0.05 USD) - 2019/10/01 22:39:31 ET
Table 'Corvus' 6-max Seat #2 is the button
Seat 1: Trratata ($5 in chips) 
Seat 2: REDRUM192 ($2.64 in chips) 
Seat 3: IvanMakeBasket ($4.48 in chips) 
Seat 4: artbone30 ($1.89 in chips) 
Seat 6: PlayTheBlues4U ($6 in chips) 
IvanMakeBasket: posts small blind $0.02
artbone30: posts big blind $0.05
luckydeigs: sits out 
*** HOLE CARDS ***
Dealt to PlayTheBlues4U [2h 4d]
PlayTheBlues4U: folds 
Trratata: raises $0.10 to $0.15
REDRUM192: folds 
IvanMakeBasket: folds 
artbone30: calls $0.10
*** FLOP *** [6s 9s Ah]
artbone30: checks 
Trratata: bets $0.15
artbone30: folds 
Uncalled bet ($0.15) returned to Trratata
Trratata collected $0.30 from pot
Trratata: doesn't show hand 
*** SUMMARY ***
Total pot $0.32 | Rake $0.02 
Board [6s 9s Ah]
Seat 1: Trratata collected ($0.30)
Seat 2: REDRUM192 (button) folded before Flop (didn't bet)
Seat 3: IvanMakeBasket (small blind) folded before Flop
Seat 4: artbone30 (big blind) folded on the Flop
Seat 6: PlayTheBlues4U folded before Flop (didn't bet)


PokerStars Hand #204146575955:  Hold'em No Limit ($0.05/$0.10 USD) - 2019/10/01 22:39:06 ET
Table 'Klytia' 6-max Seat #1 is the button
Seat 1: OliveXC ($16.14 in chips) 
Seat 2: Pezant ($10.81 in chips) 
Seat 3: ng2414 ($8.21 in chips) 
Seat 4: BaldEagleStar ($1.03 in chips) 
Seat 5: PlayTheBlues4U ($8.69 in chips) 
Seat 6: efreay11 ($28.23 in chips) 
Pezant: posts small blind $0.05
ng2414: posts big blind $0.10
*** HOLE CARDS ***
Dealt to PlayTheBlues4U [Qc 4h]
BaldEagleStar: folds 
PlayTheBlues4U: folds 
efreay11: calls $0.10
OliveXC: raises $0.40 to $0.50
Pezant: folds 
ng2414: folds 
efreay11: calls $0.40
*** FLOP *** [8s 9s 2s]
efreay11: checks 
OliveXC: bets $0.60
efreay11: calls $0.60
*** TURN *** [8s 9s 2s] [Js]
efreay11: checks 
OliveXC: checks 
*** RIVER *** [8s 9s 2s Js] [3h]
efreay11: checks 
OliveXC: checks 
*** SHOW DOWN ***
efreay11: shows [Jd Qd] (a pair of Jacks)
OliveXC: mucks hand 
efreay11 collected $2.23 from pot
*** SUMMARY ***
Total pot $2.35 | Rake $0.12 
Board [8s 9s 2s Js 3h]
Seat 1: OliveXC (button) mucked [Kh Ad]
Seat 2: Pezant (small blind) folded before Flop
Seat 3: ng2414 (big blind) folded before Flop
Seat 4: BaldEagleStar folded before Flop (didn't bet)
Seat 5: PlayTheBlues4U folded before Flop (didn't bet)
Seat 6: efreay11 showed [Jd Qd] and won ($2.23) with a pair of Jacks


PokerStars Hand #204146575830:  Hold'em No Limit ($0.02/$0.05 USD) - 2019/10/01 22:38:25 ET
Table 'Corvus' 6-max Seat #1 is the button
Seat 1: Trratata ($4.02 in chips) 
Seat 2: REDRUM192 ($2.66 in chips) 
Seat 3: IvanMakeBasket ($4.53 in chips) 
Seat 4: artbone30 ($1.83 in chips) 
Seat 6: PlayTheBlues4U ($6 in chips) 
REDRUM192: posts small blind $0.02
IvanMakeBasket: posts big blind $0.05
luckydeigs: sits out 
*** HOLE CARDS ***
Dealt to PlayTheBlues4U [6d 5c]
artbone30: calls $0.05
PlayTheBlues4U: folds 
Trratata: folds 
REDRUM192: folds 
IvanMakeBasket: checks 
*** FLOP *** [8c Qc 7s]
IvanMakeBasket: checks 
artbone30: checks 
*** TURN *** [8c Qc 7s] [2d]
IvanMakeBasket: checks 
artbone30: checks 
*** RIVER *** [8c Qc 7s 2d] [Ac]
IvanMakeBasket: checks 
artbone30: checks 
*** SHOW DOWN ***
IvanMakeBasket: shows [2c 9h] (a pair of Deuces)
artbone30: shows [7h 5h] (a pair of Sevens)
artbone30 collected $0.11 from pot
*** SUMMARY ***
Total pot $0.12 | Rake $0.01 
Board [8c Qc 7s 2d Ac]
Seat 1: Trratata (button) folded before Flop (didn't bet)
Seat 2: REDRUM192 (small blind) folded before Flop
Seat 3: IvanMakeBasket (big blind) showed [2c 9h] and lost with a pair of Deuces
Seat 4: artbone30 showed [7h 5h] and won ($0.11) with a pair of Sevens
Seat 6: PlayTheBlues4U folded before Flop (didn't bet)


PokerStars Hand #204146575703:  Hold'em No Limit ($0.05/$0.10 USD) - 2019/10/01 22:37:42 ET
Table 'Klytia' 6-max Seat #6 is the button
Seat 1: OliveXC ($16.24 in chips) 
Seat 2: Pezant ($10.53 in chips) 
Seat 3: ng2414 ($8.21 in chips) 
Seat 4: BaldEagleStar ($1.13 in chips) 
Seat 5: PlayTheBlues4U ($8.69 in chips) 
Seat 6: efreay11 ($28.33 in chips) 
OliveXC: posts small blind $0.05
Pezant: posts big blind $0.10
*** HOLE CARDS ***
Dealt to PlayTheBlues4U [4d 6d]
ng2414: folds 
BaldEagleStar: calls $0.10
PlayTheBlues4U: folds 
efreay11: calls $0.10
OliveXC: calls $0.05
Pezant: checks 
*** FLOP *** [5s 8c Ts]
OliveXC: checks 
Pezant: checks 
BaldEagleStar: checks 
efreay11: checks 
*** TURN *** [5s 8c Ts] [5c]
OliveXC: checks 
Pezant: checks 
BaldEagleStar: checks 
efreay11: checks 
*** RIVER *** [5s 8c Ts 5c] [7d]
OliveXC: checks 
Pezant: checks 
BaldEagleStar: checks 
efreay11: checks 
*** SHOW DOWN ***
OliveXC: shows [Jh 6h] (a pair of Fives)
Pezant: shows [2s 7h] (two pair, Sevens and Fives)
BaldEagleStar: mucks hand 
efreay11: mucks hand 
Pezant collected $0.38 from pot
*** SUMMARY ***
Total pot $0.40 | Rake $0.02 
Board [5s 8c Ts 5c 7d]
Seat 1: OliveXC (small blind) showed [Jh 6h] and lost with a pair of Fives
Seat 2: Pezant (big blind) showed [2s 7h] and won ($0.38) with two pair, Sevens and Fives
Seat 3: ng2414 folded before Flop (didn't bet)
Seat 4: BaldEagleStar mucked [9s Qs]
Seat 5: PlayTheBlues4U folded before Flop (didn't bet)
Seat 6: efreay11 (button) mucked [6c Jc]


PokerStars Hand #204146575641:  Hold'em No Limit ($0.02/$0.05 USD) - 2019/10/01 22:37:20 ET
Table 'Corvus' 6-max Seat #6 is the button
Seat 1: Trratata ($4.62 in chips) 
Seat 2: REDRUM192 ($2.71 in chips) 
Seat 3: IvanMakeBasket ($4.53 in chips) 
Seat 4: artbone30 ($1.83 in chips) 
Seat 6: PlayTheBlues4U ($5.41 in chips) 
Trratata: posts small blind $0.02
REDRUM192: posts big blind $0.05
luckydeigs: sits out 
*** HOLE CARDS ***
Dealt to PlayTheBlues4U [8d 8h]
IvanMakeBasket: folds 
artbone30: folds 
PlayTheBlues4U: raises $0.10 to $0.15
Trratata: calls $0.13
REDRUM192: folds 
*** FLOP *** [5h Qc 3h]
Trratata: checks 
PlayTheBlues4U: bets $0.15
Trratata: calls $0.15
*** TURN *** [5h Qc 3h] [Ah]
Trratata: checks 
PlayTheBlues4U: checks 
*** RIVER *** [5h Qc 3h Ah] [Qd]
Trratata: bets $0.30
PlayTheBlues4U: calls $0.30
*** SHOW DOWN ***
Trratata: shows [Kd Js] (a pair of Queens)
PlayTheBlues4U: shows [8d 8h] (two pair, Queens and Eights)
PlayTheBlues4U collected $1.19 from pot
*** SUMMARY ***
Total pot $1.25 | Rake $0.06 
Board [5h Qc 3h Ah Qd]
Seat 1: Trratata (small blind) showed [Kd Js] and lost with a pair of Queens
Seat 2: REDRUM192 (big blind) folded before Flop
Seat 3: IvanMakeBasket folded before Flop (didn't bet)
Seat 4: artbone30 folded before Flop (didn't bet)
Seat 6: PlayTheBlues4U (button) showed [8d 8h] and won ($1.19) with two pair, Queens and Eights


PokerStars Hand #204146575566:  Hold'em No Limit ($0.02/$0.05 USD) - 2019/10/01 22:36:51 ET
Table 'Corvus' 6-max Seat #5 is the button
Seat 1: Trratata ($4.67 in chips) 
Seat 2: REDRUM192 ($2.71 in chips) 
Seat 3: IvanMakeBasket ($4.53 in chips) 
Seat 4: artbone30 ($1.83 in chips) 
Seat 5: 7noodles ($6.32 in chips) 
Seat 6: PlayTheBlues4U ($5.36 in chips) 
PlayTheBlues4U: posts small blind $0.02
Trratata: posts big blind $0.05
*** HOLE CARDS ***
Dealt to PlayTheBlues4U [4h 5h]
REDRUM192: folds 
IvanMakeBasket: folds 
artbone30: folds 
7noodles: folds 
7noodles leaves the table
PlayTheBlues4U: raises $0.07 to $0.12
luckydeigs joins the table at seat #5 
Trratata: folds [Th 3d]
Uncalled bet ($0.07) returned to PlayTheBlues4U
PlayTheBlues4U collected $0.10 from pot
PlayTheBlues4U: doesn't show hand 
*** SUMMARY ***
Total pot $0.10 | Rake $0 
Seat 1: Trratata (big blind) folded before Flop
Seat 2: REDRUM192 folded before Flop (didn't bet)
Seat 3: IvanMakeBasket folded before Flop (didn't bet)
Seat 4: artbone30 folded before Flop (didn't bet)
Seat 5: 7noodles (button) folded before Flop (didn't bet)
Seat 6: PlayTheBlues4U (small blind) collected ($0.10)


PokerStars Hand #204146575497:  Hold'em No Limit ($0.02/$0.05 USD) - 2019/10/01 22:36:26 ET
Table 'Corvus' 6-max Seat #4 is the button
Seat 1: Trratata ($4.67 in chips) 
Seat 2: REDRUM192 ($2.71 in chips) 
Seat 3: IvanMakeBasket ($4.53 in chips) 
Seat 4: artbone30 ($1.83 in chips) 
Seat 5: 7noodles ($6.27 in chips) 
Seat 6: PlayTheBlues4U ($5.41 in chips) 
7noodles: posts small blind $0.02
PlayTheBlues4U: posts big blind $0.05
*** HOLE CARDS ***
Dealt to PlayTheBlues4U [Jd 2c]
Trratata: folds 
REDRUM192: folds 
IvanMakeBasket: folds 
artbone30: folds 
7noodles: raises $0.07 to $0.12
PlayTheBlues4U: folds 
Uncalled bet ($0.07) returned to 7noodles
7noodles collected $0.10 from pot
7noodles: doesn't show hand 
*** SUMMARY ***
Total pot $0.10 | Rake $0 
Seat 1: Trratata folded before Flop (didn't bet)
Seat 2: REDRUM192 folded before Flop (didn't bet)
Seat 3: IvanMakeBasket folded before Flop (didn't bet)
Seat 4: artbone30 (button) folded before Flop (didn't bet)
Seat 5: 7noodles (small blind) collected ($0.10)
Seat 6: PlayTheBlues4U (big blind) folded before Flop


PokerStars Hand #204146575487:  Hold'em No Limit ($0.05/$0.10 USD) - 2019/10/01 22:36:19 ET
Table 'Klytia' 6-max Seat #5 is the button
Seat 1: OliveXC ($15.64 in chips) 
Seat 2: Pezant ($10.53 in chips) 
Seat 3: ng2414 ($8.51 in chips) 
Seat 4: BaldEagleStar ($1.13 in chips) 
Seat 5: PlayTheBlues4U ($8.99 in chips) 
Seat 6: efreay11 ($28.38 in chips) 
efreay11: posts small blind $0.05
OliveXC: posts big blind $0.10
*** HOLE CARDS ***
Dealt to PlayTheBlues4U [As Td]
Pezant: folds 
ng2414: raises $0.20 to $0.30
BaldEagleStar: folds 
PlayTheBlues4U: calls $0.30
efreay11: folds 
OliveXC: calls $0.20
*** FLOP *** [Kd 2s Th]
OliveXC: checks 
ng2414: checks 
PlayTheBlues4U: checks 
*** TURN *** [Kd 2s Th] [Jh]
OliveXC: bets $0.60
ng2414: folds 
PlayTheBlues4U: folds 
Uncalled bet ($0.60) returned to OliveXC
OliveXC collected $0.90 from pot
OliveXC: doesn't show hand 
*** SUMMARY ***
Total pot $0.95 | Rake $0.05 
Board [Kd 2s Th Jh]
Seat 1: OliveXC (big blind) collected ($0.90)
Seat 2: Pezant folded before Flop (didn't bet)
Seat 3: ng2414 folded on the Turn
Seat 4: BaldEagleStar folded before Flop (didn't bet)
Seat 5: PlayTheBlues4U (button) folded on the Turn
Seat 6: efreay11 (small blind) folded before Flop


PokerStars Hand #204146575432:  Hold'em No Limit ($0.02/$0.05 USD) - 2019/10/01 22:35:59 ET
Table 'Corvus' 6-max Seat #3 is the button
Seat 1: Trratata ($4.67 in chips) 
Seat 2: REDRUM192 ($2.71 in chips) 
Seat 3: IvanMakeBasket ($4.63 in chips) 
Seat 4: artbone30 ($1.85 in chips) 
Seat 5: 7noodles ($6.15 in chips) 
Seat 6: PlayTheBlues4U ($5.41 in chips) 
artbone30: posts small blind $0.02
7noodles: posts big blind $0.05
*** HOLE CARDS ***
Dealt to PlayTheBlues4U [Js 2c]
PlayTheBlues4U: folds 
Trratata: folds 
REDRUM192: folds 
IvanMakeBasket: raises $0.05 to $0.10
artbone30: folds 
7noodles: raises $0.30 to $0.40
IvanMakeBasket: folds 
Uncalled bet ($0.30) returned to 7noodles
7noodles collected $0.22 from pot
7noodles: doesn't show hand 
*** SUMMARY ***
Total pot $0.22 | Rake $0 
Seat 1: Trratata folded before Flop (didn't bet)
Seat 2: REDRUM192 folded before Flop (didn't bet)
Seat 3: IvanMakeBasket (button) folded before Flop
Seat 4: artbone30 (small blind) folded before Flop
Seat 5: 7noodles (big blind) collected ($0.22)
Seat 6: PlayTheBlues4U folded before Flop (didn't bet)


PokerStars Hand #204146575376:  Hold'em No Limit ($0.05/$0.10 USD) - 2019/10/01 22:35:39 ET
Table 'Klytia' 6-max Seat #4 is the button
Seat 1: OliveXC ($15.64 in chips) 
Seat 2: Pezant ($10.53 in chips) 
Seat 3: ng2414 ($8.51 in chips) 
Seat 4: BaldEagleStar ($1.43 in chips) 
Seat 5: PlayTheBlues4U ($8.43 in chips) 
Seat 6: efreay11 ($28.68 in chips) 
PlayTheBlues4U: posts small blind $0.05
efreay11: posts big blind $0.10
*** HOLE CARDS ***
Dealt to PlayTheBlues4U [8d Ah]
OliveXC: folds 
Pezant: folds 
ng2414: folds 
BaldEagleStar: calls $0.10
PlayTheBlues4U: raises $0.20 to $0.30
efreay11: calls $0.20
BaldEagleStar: calls $0.20
*** FLOP *** [9s Ac 8c]
PlayTheBlues4U: bets $0.60
efreay11: folds 
BaldEagleStar: folds 
Uncalled bet ($0.60) returned to PlayTheBlues4U
PlayTheBlues4U collected $0.86 from pot
PlayTheBlues4U: doesn't show hand 
*** SUMMARY ***
Total pot $0.90 | Rake $0.04 
Board [9s Ac 8c]
Seat 1: OliveXC folded before Flop (didn't bet)
Seat 2: Pezant folded before Flop (didn't bet)
Seat 3: ng2414 folded before Flop (didn't bet)
Seat 4: BaldEagleStar (button) folded on the Flop
Seat 5: PlayTheBlues4U (small blind) collected ($0.86)
Seat 6: efreay11 (big blind) folded on the Flop


PokerStars Hand #204146575316:  Hold'em No Limit ($0.05/$0.10 USD) - 2019/10/01 22:35:18 ET
Table 'Klytia' 6-max Seat #3 is the button
Seat 1: OliveXC ($15.64 in chips) 
Seat 2: Pezant ($10.53 in chips) 
Seat 3: ng2414 ($8.51 in chips) 
Seat 4: BaldEagleStar ($1.23 in chips) 
Seat 5: PlayTheBlues4U ($8.53 in chips) 
Seat 6: efreay11 ($28.78 in chips) 
BaldEagleStar: posts small blind $0.05
PlayTheBlues4U: posts big blind $0.10
*** HOLE CARDS ***
Dealt to PlayTheBlues4U [8d Jh]
efreay11: calls $0.10
OliveXC: folds 
Pezant: folds 
ng2414: folds 
BaldEagleStar: raises $0.60 to $0.70
PlayTheBlues4U: folds 
efreay11: folds 
Uncalled bet ($0.60) returned to BaldEagleStar
BaldEagleStar collected $0.30 from pot
BaldEagleStar: doesn't show hand 
*** SUMMARY ***
Total pot $0.30 | Rake $0 
Seat 1: OliveXC folded before Flop (didn't bet)
Seat 2: Pezant folded before Flop (didn't bet)
Seat 3: ng2414 (button) folded before Flop (didn't bet)
Seat 4: BaldEagleStar (small blind) collected ($0.30)
Seat 5: PlayTheBlues4U (big blind) folded before Flop
Seat 6: efreay11 folded before Flop


PokerStars Hand #204146575307:  Hold'em No Limit ($0.02/$0.05 USD) - 2019/10/01 22:35:13 ET
Table 'Corvus' 6-max Seat #2 is the button
Seat 1: Trratata ($4.67 in chips) 
Seat 2: REDRUM192 ($2.71 in chips) 
Seat 3: IvanMakeBasket ($4.50 in chips) 
Seat 4: artbone30 ($2 in chips) 
Seat 5: 7noodles ($6.15 in chips) 
Seat 6: PlayTheBlues4U ($5.41 in chips) 
IvanMakeBasket: posts small blind $0.02
artbone30: posts big blind $0.05
*** HOLE CARDS ***
Dealt to PlayTheBlues4U [6c 7s]
7noodles: folds 
PlayTheBlues4U: folds 
Trratata: folds 
REDRUM192: folds 
IvanMakeBasket: calls $0.03
artbone30: raises $0.05 to $0.10
IvanMakeBasket: calls $0.05
*** FLOP *** [8h Ac Th]
IvanMakeBasket: checks 
artbone30: bets $0.05
IvanMakeBasket: calls $0.05
*** TURN *** [8h Ac Th] [2h]
IvanMakeBasket: checks 
artbone30: checks 
*** RIVER *** [8h Ac Th 2h] [Ah]
IvanMakeBasket: bets $0.05
artbone30: folds 
Uncalled bet ($0.05) returned to IvanMakeBasket
IvanMakeBasket collected $0.28 from pot
IvanMakeBasket: doesn't show hand 
*** SUMMARY ***
Total pot $0.30 | Rake $0.02 
Board [8h Ac Th 2h Ah]
Seat 1: Trratata folded before Flop (didn't bet)
Seat 2: REDRUM192 (button) folded before Flop (didn't bet)
Seat 3: IvanMakeBasket (small blind) collected ($0.28)
Seat 4: artbone30 (big blind) folded on the River
Seat 5: 7noodles folded before Flop (didn't bet)
Seat 6: PlayTheBlues4U folded before Flop (didn't bet)


PokerStars Hand #204146575255:  Hold'em No Limit ($0.02/$0.05 USD) - 2019/10/01 22:34:59 ET
Table 'Corvus' 6-max Seat #1 is the button
Seat 1: Trratata ($4.67 in chips) 
Seat 2: REDRUM192 ($2.66 in chips) 
Seat 3: IvanMakeBasket ($4.55 in chips) 
Seat 5: 7noodles ($6.15 in chips) 
Seat 6: PlayTheBlues4U ($5.41 in chips) 
REDRUM192: posts small blind $0.02
IvanMakeBasket: posts big blind $0.05
artbone30: sits out 
*** HOLE CARDS ***
Dealt to PlayTheBlues4U [7h Qs]
7noodles: folds 
PlayTheBlues4U: folds 
Trratata: folds 
REDRUM192: raises $0.15 to $0.20
IvanMakeBasket: folds 
Uncalled bet ($0.15) returned to REDRUM192
REDRUM192 collected $0.10 from pot
REDRUM192: doesn't show hand 
*** SUMMARY ***
Total pot $0.10 | Rake $0 
Seat 1: Trratata (button) folded before Flop (didn't bet)
Seat 2: REDRUM192 (small blind) collected ($0.10)
Seat 3: IvanMakeBasket (big blind) folded before Flop
Seat 5: 7noodles folded before Flop (didn't bet)
Seat 6: PlayTheBlues4U folded before Flop (didn't bet)


PokerStars Hand #204146575133:  Hold'em No Limit ($0.05/$0.10 USD) - 2019/10/01 22:34:23 ET
Table 'Klytia' 6-max Seat #2 is the button
Seat 1: OliveXC ($15.64 in chips) 
Seat 2: Pezant ($10.53 in chips) 
Seat 3: ng2414 ($8.61 in chips) 
Seat 4: BaldEagleStar ($1.14 in chips) 
Seat 5: PlayTheBlues4U ($8.53 in chips) 
Seat 6: efreay11 ($28.78 in chips) 
ng2414: posts small blind $0.05
BaldEagleStar: posts big blind $0.10
*** HOLE CARDS ***
Dealt to PlayTheBlues4U [5d 2c]
PlayTheBlues4U: folds 
efreay11 has timed out
efreay11: folds 
OliveXC: folds 
Pezant: folds 
ng2414: calls $0.05
BaldEagleStar: checks 
*** FLOP *** [2d 3s 5s]
ng2414: checks 
BaldEagleStar: bets $0.20
ng2414: folds 
Uncalled bet ($0.20) returned to BaldEagleStar
BaldEagleStar collected $0.19 from pot
BaldEagleStar: doesn't show hand 
*** SUMMARY ***
Total pot $0.20 | Rake $0.01 
Board [2d 3s 5s]
Seat 1: OliveXC folded before Flop (didn't bet)
Seat 2: Pezant (button) folded before Flop (didn't bet)
Seat 3: ng2414 (small blind) folded on the Flop
Seat 4: BaldEagleStar (big blind) collected ($0.19)
Seat 5: PlayTheBlues4U folded before Flop (didn't bet)
Seat 6: efreay11 folded before Flop (didn't bet)


PokerStars Hand #204146574949:  Hold'em No Limit ($0.02/$0.05 USD) - 2019/10/01 22:33:28 ET
Table 'Corvus' 6-max Seat #6 is the button
Seat 1: Trratata ($4.97 in chips) 
Seat 2: REDRUM192 ($3.41 in chips) 
Seat 3: IvanMakeBasket ($4.55 in chips) 
Seat 5: 7noodles ($5.19 in chips) 
Seat 6: PlayTheBlues4U ($5.41 in chips) 
Trratata: posts small blind $0.02
REDRUM192: posts big blind $0.05
*** HOLE CARDS ***
Dealt to PlayTheBlues4U [3s 5c]
IvanMakeBasket: folds 
7noodles: raises $0.07 to $0.12
PlayTheBlues4U: folds 
Trratata: raises $0.18 to $0.30
REDRUM192: calls $0.25
7noodles: raises $0.45 to $0.75
Trratata: folds 
REDRUM192: calls $0.45
*** FLOP *** [4c 9d Tc]
REDRUM192: checks 
artbone30 joins the table at seat #4 
7noodles: checks 
*** TURN *** [4c 9d Tc] [7d]
REDRUM192: checks 
7noodles: bets $0.86
REDRUM192: folds 
Uncalled bet ($0.86) returned to 7noodles
7noodles collected $1.71 from pot
7noodles: doesn't show hand 
*** SUMMARY ***
Total pot $1.80 | Rake $0.09 
Board [4c 9d Tc 7d]
Seat 1: Trratata (small blind) folded before Flop
Seat 2: REDRUM192 (big blind) folded on the Turn
Seat 3: IvanMakeBasket folded before Flop (didn't bet)
Seat 5: 7noodles collected ($1.71)
Seat 6: PlayTheBlues4U (button) folded before Flop (didn't bet)


PokerStars Hand #204146574919:  Hold'em No Limit ($0.05/$0.10 USD) - 2019/10/01 22:33:20 ET
Table 'Klytia' 6-max Seat #1 is the button
Seat 1: OliveXC ($15.64 in chips) 
Seat 2: Pezant ($10.83 in chips) 
Seat 3: ng2414 ($8.34 in chips) 
Seat 4: BaldEagleStar ($1.14 in chips) 
Seat 5: PlayTheBlues4U ($8.53 in chips) 
Seat 6: efreay11 ($28.78 in chips) 
Pezant: posts small blind $0.05
ng2414: posts big blind $0.10
*** HOLE CARDS ***
Dealt to PlayTheBlues4U [5c Kh]
BaldEagleStar: folds 
PlayTheBlues4U: folds 
efreay11 has timed out
efreay11: folds 
OliveXC: folds 
Pezant: raises $0.20 to $0.30
ng2414: calls $0.20
*** FLOP *** [Jh 6h Kc]
Pezant: checks 
ng2414: checks 
*** TURN *** [Jh 6h Kc] [5s]
Pezant: checks 
ng2414: bets $0.40
Pezant: folds 
Uncalled bet ($0.40) returned to ng2414
ng2414 collected $0.57 from pot
*** SUMMARY ***
Total pot $0.60 | Rake $0.03 
Board [Jh 6h Kc 5s]
Seat 1: OliveXC (button) folded before Flop (didn't bet)
Seat 2: Pezant (small blind) folded on the Turn
Seat 3: ng2414 (big blind) collected ($0.57)
Seat 4: BaldEagleStar folded before Flop (didn't bet)
Seat 5: PlayTheBlues4U folded before Flop (didn't bet)
Seat 6: efreay11 folded before Flop (didn't bet)


PokerStars Hand #204146574917:  Hold'em No Limit ($0.02/$0.05 USD) - 2019/10/01 22:33:19 ET
Table 'Corvus' 6-max Seat #5 is the button
Seat 1: Trratata ($4.95 in chips) 
Seat 2: REDRUM192 ($3.41 in chips) 
Seat 3: IvanMakeBasket ($4.55 in chips) 
Seat 5: 7noodles ($5.19 in chips) 
Seat 6: PlayTheBlues4U ($5.43 in chips) 
PlayTheBlues4U: posts small blind $0.02
Trratata: posts big blind $0.05
*** HOLE CARDS ***
Dealt to PlayTheBlues4U [3d Ks]
REDRUM192: folds 
IvanMakeBasket: folds 
7noodles: folds 
PlayTheBlues4U: folds 
Uncalled bet ($0.03) returned to Trratata
Trratata collected $0.04 from pot
Trratata: doesn't show hand 
*** SUMMARY ***
Total pot $0.04 | Rake $0 
Seat 1: Trratata (big blind) collected ($0.04)
Seat 2: REDRUM192 folded before Flop (didn't bet)
Seat 3: IvanMakeBasket folded before Flop (didn't bet)
Seat 5: 7noodles (button) folded before Flop (didn't bet)
Seat 6: PlayTheBlues4U (small blind) folded before Flop


PokerStars Hand #204146574852:  Hold'em No Limit ($0.02/$0.05 USD) - 2019/10/01 22:33:01 ET
Table 'Corvus' 6-max Seat #3 is the button
Seat 1: Trratata ($4.95 in chips) 
Seat 2: REDRUM192 ($3.34 in chips) 
Seat 3: IvanMakeBasket ($4.55 in chips) 
Seat 5: 7noodles ($5.21 in chips) 
Seat 6: PlayTheBlues4U ($5.48 in chips) 
7noodles: posts small blind $0.02
PlayTheBlues4U: posts big blind $0.05
*** HOLE CARDS ***
Dealt to PlayTheBlues4U [9d 4c]
Trratata: folds 
REDRUM192: raises $0.10 to $0.15
IvanMakeBasket: folds 
7noodles: folds 
PlayTheBlues4U: folds 
Uncalled bet ($0.10) returned to REDRUM192
REDRUM192 collected $0.12 from pot
REDRUM192: doesn't show hand 
*** SUMMARY ***
Total pot $0.12 | Rake $0 
Seat 1: Trratata folded before Flop (didn't bet)
Seat 2: REDRUM192 collected ($0.12)
Seat 3: IvanMakeBasket (button) folded before Flop (didn't bet)
Seat 5: 7noodles (small blind) folded before Flop
Seat 6: PlayTheBlues4U (big blind) folded before Flop


PokerStars Hand #204146574833:  Hold'em No Limit ($0.05/$0.10 USD) - 2019/10/01 22:32:54 ET
Table 'Klytia' 6-max Seat #6 is the button
Seat 1: OliveXC ($15.69 in chips) 
Seat 2: Pezant ($10.93 in chips) 
Seat 3: ng2414 ($7.93 in chips) 
Seat 4: BaldEagleStar ($1.14 in chips) 
Seat 5: PlayTheBlues4U ($8.53 in chips) 
Seat 6: efreay11 ($29.08 in chips) 
OliveXC: posts small blind $0.05
Pezant: posts big blind $0.10
*** HOLE CARDS ***
Dealt to PlayTheBlues4U [7d 9c]
ng2414: raises $0.20 to $0.30
BaldEagleStar: folds 
PlayTheBlues4U: folds 
efreay11: calls $0.30
OliveXC: folds 
Pezant: folds 
*** FLOP *** [9d 4h 7h]
ng2414: bets $0.30
efreay11: folds 
Uncalled bet ($0.30) returned to ng2414
ng2414 collected $0.71 from pot
*** SUMMARY ***
Total pot $0.75 | Rake $0.04 
Board [9d 4h 7h]
Seat 1: OliveXC (small blind) folded before Flop
Seat 2: Pezant (big blind) folded before Flop
Seat 3: ng2414 collected ($0.71)
Seat 4: BaldEagleStar folded before Flop (didn't bet)
Seat 5: PlayTheBlues4U folded before Flop (didn't bet)
Seat 6: efreay11 (button) folded on the Flop


PokerStars Hand #204146574800:  Hold'em No Limit ($0.02/$0.05 USD) - 2019/10/01 22:32:46 ET
Table 'Corvus' 6-max Seat #2 is the button
Seat 1: Trratata ($4.95 in chips) 
Seat 2: REDRUM192 ($3.34 in chips) 
Seat 3: IvanMakeBasket ($4.57 in chips) 
Seat 5: 7noodles ($5.19 in chips) 
Seat 6: PlayTheBlues4U ($5.48 in chips) 
IvanMakeBasket: posts small blind $0.02
7noodles: posts big blind $0.05
*** HOLE CARDS ***
Dealt to PlayTheBlues4U [7d Td]
PlayTheBlues4U: folds 
Trratata: folds 
REDRUM192: folds 
IvanMakeBasket: folds 
Uncalled bet ($0.03) returned to 7noodles
7noodles collected $0.04 from pot
MozenMo was removed from the table for failing to post
MozenMo leaves the table
*** SUMMARY ***
Total pot $0.04 | Rake $0 
Seat 1: Trratata folded before Flop (didn't bet)
Seat 2: REDRUM192 (button) folded before Flop (didn't bet)
Seat 3: IvanMakeBasket (small blind) folded before Flop
Seat 5: 7noodles (big blind) collected ($0.04)
Seat 6: PlayTheBlues4U folded before Flop (didn't bet)


PokerStars Hand #204146574770:  Hold'em No Limit ($0.02/$0.05 USD) - 2019/10/01 22:32:36 ET
Table 'Corvus' 6-max Seat #1 is the button
Seat 1: Trratata ($4.95 in chips) 
Seat 2: REDRUM192 ($3.36 in chips) 
Seat 3: IvanMakeBasket ($4.55 in chips) 
Seat 5: 7noodles ($5.19 in chips) 
Seat 6: PlayTheBlues4U ($5.48 in chips) 
REDRUM192: posts small blind $0.02
IvanMakeBasket: posts big blind $0.05
*** HOLE CARDS ***
Dealt to PlayTheBlues4U [3h 5d]
7noodles: folds 
PlayTheBlues4U: folds 
Trratata: folds 
REDRUM192: folds 
Uncalled bet ($0.03) returned to IvanMakeBasket
IvanMakeBasket collected $0.04 from pot
IvanMakeBasket: doesn't show hand 
*** SUMMARY ***
Total pot $0.04 | Rake $0 
Seat 1: Trratata (button) folded before Flop (didn't bet)
Seat 2: REDRUM192 (small blind) folded before Flop
Seat 3: IvanMakeBasket (big blind) collected ($0.04)
Seat 5: 7noodles folded before Flop (didn't bet)
Seat 6: PlayTheBlues4U folded before Flop (didn't bet)


PokerStars Hand #204146574722:  Hold'em No Limit ($0.02/$0.05 USD) - 2019/10/01 22:32:20 ET
Table 'Corvus' 6-max Seat #6 is the button
Seat 1: Trratata ($4.97 in chips) 
Seat 2: REDRUM192 ($3.41 in chips) 
Seat 3: IvanMakeBasket ($4.48 in chips) 
Seat 5: 7noodles ($5.19 in chips) 
Seat 6: PlayTheBlues4U ($5.48 in chips) 
Trratata: posts small blind $0.02
REDRUM192: posts big blind $0.05
*** HOLE CARDS ***
Dealt to PlayTheBlues4U [6s Ad]
IvanMakeBasket: raises $0.05 to $0.10
7noodles: folds 
PlayTheBlues4U: folds 
Trratata: folds 
REDRUM192: folds 
Uncalled bet ($0.05) returned to IvanMakeBasket
IvanMakeBasket collected $0.12 from pot
IvanMakeBasket: doesn't show hand 
*** SUMMARY ***
Total pot $0.12 | Rake $0 
Seat 1: Trratata (small blind) folded before Flop
Seat 2: REDRUM192 (big blind) folded before Flop
Seat 3: IvanMakeBasket collected ($0.12)
Seat 5: 7noodles folded before Flop (didn't bet)
Seat 6: PlayTheBlues4U (button) folded before Flop (didn't bet)


PokerStars Hand #204146574553:  Hold'em No Limit ($0.02/$0.05 USD) - 2019/10/01 22:31:27 ET
Table 'Corvus' 6-max Seat #5 is the button
Seat 1: Trratata ($5.22 in chips) 
Seat 2: REDRUM192 ($3.41 in chips) 
Seat 3: IvanMakeBasket ($4.48 in chips) 
Seat 5: 7noodles ($4.95 in chips) 
Seat 6: PlayTheBlues4U ($5.50 in chips) 
PlayTheBlues4U: posts small blind $0.02
Trratata: posts big blind $0.05
*** HOLE CARDS ***
Dealt to PlayTheBlues4U [3c 2s]
REDRUM192: folds 
IvanMakeBasket: folds 
7noodles: raises $0.07 to $0.12
PlayTheBlues4U: folds 
Trratata: calls $0.07
*** FLOP *** [Qh Qs Kd]
Trratata: checks 
7noodles: checks 
*** TURN *** [Qh Qs Kd] [Jd]
Trratata: checks 
7noodles: bets $0.13
Trratata: calls $0.13
*** RIVER *** [Qh Qs Kd Jd] [6d]
Trratata: checks 
7noodles: checks 
*** SHOW DOWN ***
Trratata: shows [9h Ad] (a pair of Queens)
7noodles: shows [Ks 8c] (two pair, Kings and Queens)
7noodles collected $0.49 from pot
*** SUMMARY ***
Total pot $0.52 | Rake $0.03 
Board [Qh Qs Kd Jd 6d]
Seat 1: Trratata (big blind) showed [9h Ad] and lost with a pair of Queens
Seat 2: REDRUM192 folded before Flop (didn't bet)
Seat 3: IvanMakeBasket folded before Flop (didn't bet)
Seat 5: 7noodles (button) showed [Ks 8c] and won ($0.49) with two pair, Kings and Queens
Seat 6: PlayTheBlues4U (small blind) folded before Flop


PokerStars Hand #204146574503:  Hold'em No Limit ($0.05/$0.10 USD) - 2019/10/01 22:31:15 ET
Table 'Klytia' 6-max Seat #5 is the button
Seat 1: OliveXC ($16.53 in chips) 
Seat 2: Pezant ($13.27 in chips) 
Seat 3: ng2414 ($8.20 in chips) 
Seat 4: BaldEagleStar ($1.41 in chips) 
Seat 5: PlayTheBlues4U ($8.53 in chips) 
Seat 6: efreay11 ($25.66 in chips) 
efreay11: posts small blind $0.05
OliveXC: posts big blind $0.10
*** HOLE CARDS ***
Dealt to PlayTheBlues4U [8c 2c]
Pezant: raises $0.17 to $0.27
ng2414: calls $0.27
BaldEagleStar: calls $0.27
PlayTheBlues4U: folds 
efreay11: calls $0.22
OliveXC: calls $0.17
*** FLOP *** [Kh Jc Td]
efreay11: checks 
OliveXC: checks 
Pezant: bets $0.57
ng2414: folds 
BaldEagleStar: folds 
efreay11: calls $0.57
OliveXC: calls $0.57
*** TURN *** [Kh Jc Td] [Jh]
efreay11: checks 
OliveXC: checks 
Pezant: checks 
*** RIVER *** [Kh Jc Td Jh] [6h]
efreay11: bets $1.50
OliveXC: folds 
Pezant: calls $1.50
*** SHOW DOWN ***
efreay11: shows [7h 8h] (a flush, King high)
Pezant: mucks hand 
efreay11 collected $5.76 from pot
*** SUMMARY ***
Total pot $6.06 | Rake $0.30 
Board [Kh Jc Td Jh 6h]
Seat 1: OliveXC (big blind) folded on the River
Seat 2: Pezant mucked [Qc Ad]
Seat 3: ng2414 folded on the Flop
Seat 4: BaldEagleStar folded on the Flop
Seat 5: PlayTheBlues4U (button) folded before Flop (didn't bet)
Seat 6: efreay11 (small blind) showed [7h 8h] and won ($5.76) with a flush, King high


PokerStars Hand #204146574442:  Hold'em No Limit ($0.02/$0.05 USD) - 2019/10/01 22:30:56 ET
Table 'Corvus' 6-max Seat #3 is the button
Seat 1: Trratata ($5.22 in chips) 
Seat 2: REDRUM192 ($3.41 in chips) 
Seat 3: IvanMakeBasket ($4.48 in chips) 
Seat 5: 7noodles ($4.97 in chips) 
Seat 6: PlayTheBlues4U ($5.48 in chips) 
7noodles: posts small blind $0.02
PlayTheBlues4U: posts big blind $0.05
*** HOLE CARDS ***
Dealt to PlayTheBlues4U [8h Jc]
Trratata: folds 
REDRUM192: folds 
IvanMakeBasket: folds 
7noodles: folds 
Uncalled bet ($0.03) returned to PlayTheBlues4U
PlayTheBlues4U collected $0.04 from pot
PlayTheBlues4U: doesn't show hand 
*** SUMMARY ***
Total pot $0.04 | Rake $0 
Seat 1: Trratata folded before Flop (didn't bet)
Seat 2: REDRUM192 folded before Flop (didn't bet)
Seat 3: IvanMakeBasket (button) folded before Flop (didn't bet)
Seat 5: 7noodles (small blind) folded before Flop
Seat 6: PlayTheBlues4U (big blind) collected ($0.04)


PokerStars Hand #204146574414:  Hold'em No Limit ($0.05/$0.10 USD) - 2019/10/01 22:30:47 ET
Table 'Klytia' 6-max Seat #4 is the button
Seat 1: OliveXC ($16.53 in chips) 
Seat 2: Pezant ($13.27 in chips) 
Seat 3: ng2414 ($8.20 in chips) 
Seat 4: BaldEagleStar ($1.71 in chips) 
Seat 5: PlayTheBlues4U ($8.58 in chips) 
Seat 6: efreay11 ($25.34 in chips) 
PlayTheBlues4U: posts small blind $0.05
efreay11: posts big blind $0.10
*** HOLE CARDS ***
Dealt to PlayTheBlues4U [2d 4h]
OliveXC: folds 
Pezant: folds 
ng2414: folds 
BaldEagleStar: calls $0.10
PlayTheBlues4U: folds 
efreay11: raises $0.20 to $0.30
BaldEagleStar: calls $0.20
*** FLOP *** [Tc 3h 6s]
efreay11: checks 
BaldEagleStar: checks 
*** TURN *** [Tc 3h 6s] [Jd]
efreay11: bets $0.30
BaldEagleStar: folds 
Uncalled bet ($0.30) returned to efreay11
efreay11 collected $0.62 from pot
efreay11: doesn't show hand 
*** SUMMARY ***
Total pot $0.65 | Rake $0.03 
Board [Tc 3h 6s Jd]
Seat 1: OliveXC folded before Flop (didn't bet)
Seat 2: Pezant folded before Flop (didn't bet)
Seat 3: ng2414 folded before Flop (didn't bet)
Seat 4: BaldEagleStar (button) folded on the Turn
Seat 5: PlayTheBlues4U (small blind) folded before Flop
Seat 6: efreay11 (big blind) collected ($0.62)


PokerStars Hand #204146574368:  Hold'em No Limit ($0.02/$0.05 USD) - 2019/10/01 22:30:34 ET
Table 'Corvus' 6-max Seat #2 is the button
Seat 1: Trratata ($5.22 in chips) 
Seat 2: REDRUM192 ($3.41 in chips) 
Seat 3: IvanMakeBasket ($4.50 in chips) 
Seat 5: 7noodles ($5.02 in chips) 
Seat 6: PlayTheBlues4U ($5.41 in chips) 
IvanMakeBasket: posts small blind $0.02
7noodles: posts big blind $0.05
*** HOLE CARDS ***
Dealt to PlayTheBlues4U [4s 4c]
PlayTheBlues4U: raises $0.10 to $0.15
Trratata: folds 
REDRUM192: folds 
IvanMakeBasket: folds 
7noodles: folds 
Uncalled bet ($0.10) returned to PlayTheBlues4U
PlayTheBlues4U collected $0.12 from pot
PlayTheBlues4U: doesn't show hand 
*** SUMMARY ***
Total pot $0.12 | Rake $0 
Seat 1: Trratata folded before Flop (didn't bet)
Seat 2: REDRUM192 (button) folded before Flop (didn't bet)
Seat 3: IvanMakeBasket (small blind) folded before Flop
Seat 5: 7noodles (big blind) folded before Flop
Seat 6: PlayTheBlues4U collected ($0.12)


PokerStars Hand #204146574318:  Hold'em No Limit ($0.02/$0.05 USD) - 2019/10/01 22:30:19 ET
Table 'Corvus' 6-max Seat #1 is the button
Seat 1: Trratata ($5.22 in chips) 
Seat 2: REDRUM192 ($3.43 in chips) 
Seat 3: IvanMakeBasket ($4.48 in chips) 
Seat 5: 7noodles ($5.02 in chips) 
Seat 6: PlayTheBlues4U ($5.41 in chips) 
REDRUM192: posts small blind $0.02
IvanMakeBasket: posts big blind $0.05
*** HOLE CARDS ***
Dealt to PlayTheBlues4U [5c 6s]
7noodles: folds 
PlayTheBlues4U: folds 
Trratata: folds 
REDRUM192: folds 
Uncalled bet ($0.03) returned to IvanMakeBasket
IvanMakeBasket collected $0.04 from pot
IvanMakeBasket: doesn't show hand 
*** SUMMARY ***
Total pot $0.04 | Rake $0 
Seat 1: Trratata (button) folded before Flop (didn't bet)
Seat 2: REDRUM192 (small blind) folded before Flop
Seat 3: IvanMakeBasket (big blind) collected ($0.04)
Seat 5: 7noodles folded before Flop (didn't bet)
Seat 6: PlayTheBlues4U folded before Flop (didn't bet)


PokerStars Hand #204146574231:  Hold'em No Limit ($0.05/$0.10 USD) - 2019/10/01 22:29:56 ET
Table 'Klytia' 6-max Seat #3 is the button
Seat 1: OliveXC ($16.53 in chips) 
Seat 2: Pezant ($13.27 in chips) 
Seat 3: ng2414 ($8.30 in chips) 
Seat 4: BaldEagleStar ($1.81 in chips) 
Seat 5: PlayTheBlues4U ($8.68 in chips) 
Seat 6: efreay11 ($25.06 in chips) 
BaldEagleStar: posts small blind $0.05
PlayTheBlues4U: posts big blind $0.10
*** HOLE CARDS ***
Dealt to PlayTheBlues4U [9s 2s]
efreay11: calls $0.10
OliveXC: folds 
Pezant: folds 
ng2414: calls $0.10
BaldEagleStar: calls $0.05
PlayTheBlues4U: checks 
*** FLOP *** [7c Ah As]
BaldEagleStar: checks 
PlayTheBlues4U: checks 
efreay11: checks 
ng2414: checks 
*** TURN *** [7c Ah As] [5c]
BaldEagleStar: checks 
PlayTheBlues4U: checks 
efreay11: bets $0.40
ng2414: folds 
BaldEagleStar: folds 
PlayTheBlues4U: folds 
Uncalled bet ($0.40) returned to efreay11
efreay11 collected $0.38 from pot
efreay11: doesn't show hand 
*** SUMMARY ***
Total pot $0.40 | Rake $0.02 
Board [7c Ah As 5c]
Seat 1: OliveXC folded before Flop (didn't bet)
Seat 2: Pezant folded before Flop (didn't bet)
Seat 3: ng2414 (button) folded on the Turn
Seat 4: BaldEagleStar (small blind) folded on the Turn
Seat 5: PlayTheBlues4U (big blind) folded on the Turn
Seat 6: efreay11 collected ($0.38)


PokerStars Hand #204146574193:  Hold'em No Limit ($0.02/$0.05 USD) - 2019/10/01 22:29:45 ET
Table 'Corvus' 6-max Seat #6 is the button
Seat 1: Trratata ($4.95 in chips) 
Seat 2: REDRUM192 ($3.73 in chips) 
Seat 3: IvanMakeBasket ($4.48 in chips) 
Seat 5: 7noodles ($5.02 in chips) 
Seat 6: PlayTheBlues4U ($5.41 in chips) 
Trratata: posts small blind $0.02
REDRUM192: posts big blind $0.05
*** HOLE CARDS ***
Dealt to PlayTheBlues4U [Kc 2s]
IvanMakeBasket: folds 
7noodles: folds 
PlayTheBlues4U: folds 
Trratata: raises $0.10 to $0.15
REDRUM192: calls $0.10
*** FLOP *** [2c 2d Jd]
Trratata: bets $0.15
REDRUM192: calls $0.15
*** TURN *** [2c 2d Jd] [Ks]
Trratata: bets $0.25
REDRUM192: folds 
Uncalled bet ($0.25) returned to Trratata
Trratata collected $0.57 from pot
Trratata: doesn't show hand 
*** SUMMARY ***
Total pot $0.60 | Rake $0.03 
Board [2c 2d Jd Ks]
Seat 1: Trratata (small blind) collected ($0.57)
Seat 2: REDRUM192 (big blind) folded on the Turn
Seat 3: IvanMakeBasket folded before Flop (didn't bet)
Seat 5: 7noodles folded before Flop (didn't bet)
Seat 6: PlayTheBlues4U (button) folded before Flop (didn't bet)


PokerStars Hand #204146574162:  Hold'em No Limit ($0.05/$0.10 USD) - 2019/10/01 22:29:36 ET
Table 'Klytia' 6-max Seat #2 is the button
Seat 1: OliveXC ($16.53 in chips) 
Seat 2: Pezant ($13.27 in chips) 
Seat 3: ng2414 ($8 in chips) 
Seat 4: BaldEagleStar ($1.91 in chips) 
Seat 5: PlayTheBlues4U ($8.68 in chips) 
Seat 6: efreay11 ($25.26 in chips) 
ng2414: posts small blind $0.05
BaldEagleStar: posts big blind $0.10
*** HOLE CARDS ***
Dealt to PlayTheBlues4U [6d 9h]
PlayTheBlues4U: folds 
efreay11: raises $0.10 to $0.20
OliveXC: folds 
Pezant: folds 
ng2414: raises $0.50 to $0.70
BaldEagleStar: folds 
efreay11: folds 
Uncalled bet ($0.50) returned to ng2414
ng2414 collected $0.50 from pot
*** SUMMARY ***
Total pot $0.50 | Rake $0 
Seat 1: OliveXC folded before Flop (didn't bet)
Seat 2: Pezant (button) folded before Flop (didn't bet)
Seat 3: ng2414 (small blind) collected ($0.50)
Seat 4: BaldEagleStar (big blind) folded before Flop
Seat 5: PlayTheBlues4U folded before Flop (didn't bet)
Seat 6: efreay11 folded before Flop


PokerStars Hand #204146574160:  Hold'em No Limit ($0.02/$0.05 USD) - 2019/10/01 22:29:35 ET
Table 'Corvus' 6-max Seat #5 is the button
Seat 1: Trratata ($4.93 in chips) 
Seat 2: REDRUM192 ($3.73 in chips) 
Seat 3: IvanMakeBasket ($4.48 in chips) 
Seat 5: 7noodles ($5.02 in chips) 
Seat 6: PlayTheBlues4U ($5.43 in chips) 
PlayTheBlues4U: posts small blind $0.02
Trratata: posts big blind $0.05
*** HOLE CARDS ***
Dealt to PlayTheBlues4U [4s 9h]
REDRUM192: folds 
IvanMakeBasket: folds 
7noodles: folds 
PlayTheBlues4U: folds 
Uncalled bet ($0.03) returned to Trratata
Trratata collected $0.04 from pot
Trratata: doesn't show hand 
*** SUMMARY ***
Total pot $0.04 | Rake $0 
Seat 1: Trratata (big blind) collected ($0.04)
Seat 2: REDRUM192 folded before Flop (didn't bet)
Seat 3: IvanMakeBasket folded before Flop (didn't bet)
Seat 5: 7noodles (button) folded before Flop (didn't bet)
Seat 6: PlayTheBlues4U (small blind) folded before Flop


PokerStars Hand #204146574092:  Hold'em No Limit ($0.02/$0.05 USD) - 2019/10/01 22:29:18 ET
Table 'Corvus' 6-max Seat #3 is the button
Seat 1: Trratata ($4.93 in chips) 
Seat 2: REDRUM192 ($3.73 in chips) 
Seat 3: IvanMakeBasket ($4.48 in chips) 
Seat 5: 7noodles ($5.04 in chips) 
Seat 6: PlayTheBlues4U ($5.41 in chips) 
7noodles: posts small blind $0.02
PlayTheBlues4U: posts big blind $0.05
*** HOLE CARDS ***
Dealt to PlayTheBlues4U [9c 3d]
Trratata: folds 
REDRUM192: folds 
IvanMakeBasket: folds 
7noodles: folds 
Uncalled bet ($0.03) returned to PlayTheBlues4U
PlayTheBlues4U collected $0.04 from pot
PlayTheBlues4U: doesn't show hand 
*** SUMMARY ***
Total pot $0.04 | Rake $0 
Seat 1: Trratata folded before Flop (didn't bet)
Seat 2: REDRUM192 folded before Flop (didn't bet)
Seat 3: IvanMakeBasket (button) folded before Flop (didn't bet)
Seat 5: 7noodles (small blind) folded before Flop
Seat 6: PlayTheBlues4U (big blind) collected ($0.04)


PokerStars Hand #204146574091:  Hold'em No Limit ($0.05/$0.10 USD) - 2019/10/01 22:29:18 ET
Table 'Klytia' 6-max Seat #1 is the button
Seat 1: OliveXC ($16.53 in chips) 
Seat 2: Pezant ($13.32 in chips) 
Seat 3: ng2414 ($8.10 in chips) 
Seat 4: BaldEagleStar ($1.91 in chips) 
Seat 5: PlayTheBlues4U ($8.68 in chips) 
Seat 6: efreay11 ($25.11 in chips) 
Pezant: posts small blind $0.05
ng2414: posts big blind $0.10
*** HOLE CARDS ***
Dealt to PlayTheBlues4U [9h 2c]
BaldEagleStar: folds 
PlayTheBlues4U: folds 
efreay11: raises $0.20 to $0.30
OliveXC: folds 
Pezant: folds 
ng2414: folds 
Uncalled bet ($0.20) returned to efreay11
efreay11 collected $0.25 from pot
efreay11: doesn't show hand 
*** SUMMARY ***
Total pot $0.25 | Rake $0 
Seat 1: OliveXC (button) folded before Flop (didn't bet)
Seat 2: Pezant (small blind) folded before Flop
Seat 3: ng2414 (big blind) folded before Flop
Seat 4: BaldEagleStar folded before Flop (didn't bet)
Seat 5: PlayTheBlues4U folded before Flop (didn't bet)
Seat 6: efreay11 collected ($0.25)


PokerStars Hand #204146574045:  Hold'em No Limit ($0.02/$0.05 USD) - 2019/10/01 22:29:05 ET
Table 'Corvus' 6-max Seat #2 is the button
Seat 1: Trratata ($4.93 in chips) 
Seat 2: REDRUM192 ($3.73 in chips) 
Seat 3: IvanMakeBasket ($4.50 in chips) 
Seat 5: 7noodles ($5.02 in chips) 
Seat 6: PlayTheBlues4U ($5.41 in chips) 
IvanMakeBasket: posts small blind $0.02
7noodles: posts big blind $0.05
*** HOLE CARDS ***
Dealt to PlayTheBlues4U [6h 2d]
PlayTheBlues4U: folds 
Trratata: folds 
REDRUM192: folds 
IvanMakeBasket: folds 
Uncalled bet ($0.03) returned to 7noodles
7noodles collected $0.04 from pot
7noodles: doesn't show hand 
*** SUMMARY ***
Total pot $0.04 | Rake $0 
Seat 1: Trratata folded before Flop (didn't bet)
Seat 2: REDRUM192 (button) folded before Flop (didn't bet)
Seat 3: IvanMakeBasket (small blind) folded before Flop
Seat 5: 7noodles (big blind) collected ($0.04)
Seat 6: PlayTheBlues4U folded before Flop (didn't bet)


PokerStars Hand #204146574017:  Hold'em No Limit ($0.02/$0.05 USD) - 2019/10/01 22:28:54 ET
Table 'Corvus' 6-max Seat #1 is the button
Seat 1: Trratata ($4.93 in chips) 
Seat 2: REDRUM192 ($3.75 in chips) 
Seat 3: IvanMakeBasket ($4.48 in chips) 
Seat 6: PlayTheBlues4U ($5.41 in chips) 
REDRUM192: posts small blind $0.02
IvanMakeBasket: posts big blind $0.05
7noodles: sits out 
*** HOLE CARDS ***
Dealt to PlayTheBlues4U [4s Ad]
PlayTheBlues4U: folds 
Trratata: folds 
REDRUM192: folds 
Uncalled bet ($0.03) returned to IvanMakeBasket
IvanMakeBasket collected $0.04 from pot
IvanMakeBasket: doesn't show hand 
*** SUMMARY ***
Total pot $0.04 | Rake $0 
Seat 1: Trratata (button) folded before Flop (didn't bet)
Seat 2: REDRUM192 (small blind) folded before Flop
Seat 3: IvanMakeBasket (big blind) collected ($0.04)
Seat 6: PlayTheBlues4U folded before Flop (didn't bet)


PokerStars Hand #204146573952:  Hold'em No Limit ($0.02/$0.05 USD) - 2019/10/01 22:28:38 ET
Table 'Corvus' 6-max Seat #6 is the button
Seat 1: Trratata ($4.95 in chips) 
Seat 2: REDRUM192 ($3.80 in chips) 
Seat 3: IvanMakeBasket ($4.41 in chips) 
Seat 6: PlayTheBlues4U ($5.41 in chips) 
Trratata: posts small blind $0.02
REDRUM192: posts big blind $0.05
7noodles: sits out 
*** HOLE CARDS ***
Dealt to PlayTheBlues4U [4h 3d]
IvanMakeBasket: raises $0.05 to $0.10
PlayTheBlues4U: folds 
Trratata: folds 
REDRUM192: folds 
Uncalled bet ($0.05) returned to IvanMakeBasket
IvanMakeBasket collected $0.12 from pot
IvanMakeBasket: doesn't show hand 
*** SUMMARY ***
Total pot $0.12 | Rake $0 
Seat 1: Trratata (small blind) folded before Flop
Seat 2: REDRUM192 (big blind) folded before Flop
Seat 3: IvanMakeBasket collected ($0.12)
Seat 6: PlayTheBlues4U (button) folded before Flop (didn't bet)


PokerStars Hand #204146573885:  Hold'em No Limit ($0.02/$0.05 USD) - 2019/10/01 22:28:20 ET
Table 'Corvus' 6-max Seat #3 is the button
Seat 1: Trratata ($5 in chips) 
Seat 2: REDRUM192 ($3.80 in chips) 
Seat 3: IvanMakeBasket ($4.34 in chips) 
Seat 6: PlayTheBlues4U ($5.43 in chips) 
7noodles will be allowed to play after the button
PlayTheBlues4U: posts small blind $0.02
Trratata: posts big blind $0.05
*** HOLE CARDS ***
Dealt to PlayTheBlues4U [Ts Kh]
REDRUM192: folds 
IvanMakeBasket: raises $0.05 to $0.10
PlayTheBlues4U: folds 
Trratata: folds 
Uncalled bet ($0.05) returned to IvanMakeBasket
IvanMakeBasket collected $0.12 from pot
IvanMakeBasket: doesn't show hand 
*** SUMMARY ***
Total pot $0.12 | Rake $0 
Seat 1: Trratata (big blind) folded before Flop
Seat 2: REDRUM192 folded before Flop (didn't bet)
Seat 3: IvanMakeBasket (button) collected ($0.12)
Seat 6: PlayTheBlues4U (small blind) folded before Flop


PokerStars Hand #204146573737:  Hold'em No Limit ($0.05/$0.10 USD) - 2019/10/01 22:27:36 ET
Table 'Klytia' 6-max Seat #6 is the button
Seat 1: OliveXC ($16.58 in chips) 
Seat 2: Pezant ($13.42 in chips) 
Seat 3: ng2414 ($9.40 in chips) 
Seat 4: BaldEagleStar ($1.91 in chips) 
Seat 5: PlayTheBlues4U ($9.18 in chips) 
Seat 6: efreay11 ($23.32 in chips) 
OliveXC: posts small blind $0.05
Pezant: posts big blind $0.10
*** HOLE CARDS ***
Dealt to PlayTheBlues4U [Jd Qh]
ng2414: raises $0.20 to $0.30
BaldEagleStar: folds 
PlayTheBlues4U: calls $0.30
efreay11: raises $0.20 to $0.50
OliveXC: folds 
Pezant: folds 
ng2414: calls $0.20
PlayTheBlues4U: calls $0.20
*** FLOP *** [7h 6c 4c]
ng2414: checks 
PlayTheBlues4U: checks 
efreay11: bets $0.80
ng2414: calls $0.80
PlayTheBlues4U: folds 
*** TURN *** [7h 6c 4c] [Qs]
ng2414: checks 
efreay11: checks 
*** RIVER *** [7h 6c 4c Qs] [9h]
ng2414: checks 
efreay11: checks 
*** SHOW DOWN ***
ng2414: shows [Jc Kc] (high card King)
efreay11: shows [Ad 7d] (a pair of Sevens)
efreay11 collected $3.09 from pot
*** SUMMARY ***
Total pot $3.25 | Rake $0.16 
Board [7h 6c 4c Qs 9h]
Seat 1: OliveXC (small blind) folded before Flop
Seat 2: Pezant (big blind) folded before Flop
Seat 3: ng2414 showed [Jc Kc] and lost with high card King
Seat 4: BaldEagleStar folded before Flop (didn't bet)
Seat 5: PlayTheBlues4U folded on the Flop
Seat 6: efreay11 (button) showed [Ad 7d] and won ($3.09) with a pair of Sevens


PokerStars Hand #204146573687:  Hold'em No Limit ($0.02/$0.05 USD) - 2019/10/01 22:27:18 ET
Table 'Corvus' 6-max Seat #2 is the button
Seat 2: REDRUM192 ($3.80 in chips) 
Seat 3: IvanMakeBasket ($4.79 in chips) 
Seat 6: PlayTheBlues4U ($5.02 in chips) 
IvanMakeBasket: posts small blind $0.02
PlayTheBlues4U: posts big blind $0.05
Trratata: sits out 
*** HOLE CARDS ***
Dealt to PlayTheBlues4U [8d Th]
REDRUM192: folds 
IvanMakeBasket: raises $0.10 to $0.15
PlayTheBlues4U: calls $0.10
*** FLOP *** [Ks Ah Ts]
IvanMakeBasket: bets $0.10
PlayTheBlues4U: calls $0.10
*** TURN *** [Ks Ah Ts] [7s]
IvanMakeBasket: bets $0.20
PlayTheBlues4U: calls $0.20
*** RIVER *** [Ks Ah Ts 7s] [Js]
IvanMakeBasket: checks 
PlayTheBlues4U: bets $0.60
IvanMakeBasket: folds 
Uncalled bet ($0.60) returned to PlayTheBlues4U
PlayTheBlues4U collected $0.86 from pot
PlayTheBlues4U: doesn't show hand 
*** SUMMARY ***
Total pot $0.90 | Rake $0.04 
Board [Ks Ah Ts 7s Js]
Seat 2: REDRUM192 (button) folded before Flop (didn't bet)
Seat 3: IvanMakeBasket (small blind) folded on the River
Seat 6: PlayTheBlues4U (big blind) collected ($0.86)


PokerStars Hand #204146573611:  Hold'em No Limit ($0.05/$0.10 USD) - 2019/10/01 22:26:53 ET
Table 'Klytia' 6-max Seat #5 is the button
Seat 1: OliveXC ($16.18 in chips) 
Seat 2: Pezant ($13.42 in chips) 
Seat 3: ng2414 ($9.40 in chips) 
Seat 4: BaldEagleStar ($2.11 in chips) 
Seat 5: PlayTheBlues4U ($9.18 in chips) 
Seat 6: efreay11 ($23.52 in chips) 
efreay11: posts small blind $0.05
OliveXC: posts big blind $0.10
*** HOLE CARDS ***
Dealt to PlayTheBlues4U [Qc 6h]
Pezant: folds 
ng2414: folds 
BaldEagleStar: raises $0.10 to $0.20
PlayTheBlues4U: folds 
efreay11: calls $0.15
OliveXC: raises $0.90 to $1.10
BaldEagleStar: folds 
efreay11: folds 
Uncalled bet ($0.90) returned to OliveXC
OliveXC collected $0.60 from pot
OliveXC: doesn't show hand 
*** SUMMARY ***
Total pot $0.60 | Rake $0 
Seat 1: OliveXC (big blind) collected ($0.60)
Seat 2: Pezant folded before Flop (didn't bet)
Seat 3: ng2414 folded before Flop (didn't bet)
Seat 4: BaldEagleStar folded before Flop
Seat 5: PlayTheBlues4U (button) folded before Flop (didn't bet)
Seat 6: efreay11 (small blind) folded before Flop


PokerStars Hand #204146573516:  Hold'em No Limit ($0.02/$0.05 USD) - 2019/10/01 22:26:22 ET
Table 'Corvus' 6-max Seat #6 is the button
Seat 2: REDRUM192 ($3.95 in chips) 
Seat 3: IvanMakeBasket ($4.31 in chips) 
Seat 6: PlayTheBlues4U ($5.39 in chips) 
REDRUM192: posts small blind $0.02
Trratata joins the table at seat #1 
IvanMakeBasket: posts big blind $0.05
*** HOLE CARDS ***
Dealt to PlayTheBlues4U [Kd Jc]
PlayTheBlues4U: raises $0.10 to $0.15
REDRUM192: calls $0.13
IvanMakeBasket: calls $0.10
*** FLOP *** [6s 8c 3c]
REDRUM192: checks 
IvanMakeBasket: bets $0.22
PlayTheBlues4U: calls $0.22
REDRUM192: folds 
*** TURN *** [6s 8c 3c] [2d]
IvanMakeBasket: bets $1.25
PlayTheBlues4U: folds 
Uncalled bet ($1.25) returned to IvanMakeBasket
IvanMakeBasket collected $0.85 from pot
IvanMakeBasket: doesn't show hand 
*** SUMMARY ***
Total pot $0.89 | Rake $0.04 
Board [6s 8c 3c 2d]
Seat 2: REDRUM192 (small blind) folded on the Flop
Seat 3: IvanMakeBasket (big blind) collected ($0.85)
Seat 6: PlayTheBlues4U (button) folded on the Turn


PokerStars Hand #204146573466:  Hold'em No Limit ($0.02/$0.05 USD) - 2019/10/01 22:26:09 ET
Table 'Corvus' 6-max Seat #5 is the button
Seat 2: REDRUM192 ($4 in chips) 
Seat 3: IvanMakeBasket ($4.24 in chips) 
Seat 5: 7noodles ($5.02 in chips) 
Seat 6: PlayTheBlues4U ($5.41 in chips) 
PlayTheBlues4U: posts small blind $0.02
REDRUM192: posts big blind $0.05
*** HOLE CARDS ***
Dealt to PlayTheBlues4U [Js 6h]
IvanMakeBasket: raises $0.05 to $0.10
7noodles: folds 
PlayTheBlues4U: folds 
REDRUM192: folds 
Uncalled bet ($0.05) returned to IvanMakeBasket
IvanMakeBasket collected $0.12 from pot
IvanMakeBasket: doesn't show hand 
*** SUMMARY ***
Total pot $0.12 | Rake $0 
Seat 2: REDRUM192 (big blind) folded before Flop
Seat 3: IvanMakeBasket collected ($0.12)
Seat 5: 7noodles (button) folded before Flop (didn't bet)
Seat 6: PlayTheBlues4U (small blind) folded before Flop


PokerStars Hand #204146573450:  Hold'em No Limit ($0.05/$0.10 USD) - 2019/10/01 22:26:04 ET
Table 'Klytia' 6-max Seat #4 is the button
Seat 1: OliveXC ($16.18 in chips) 
Seat 2: Pezant ($13.42 in chips) 
Seat 3: ng2414 ($9.40 in chips) 
Seat 4: BaldEagleStar ($2.61 in chips) 
Seat 5: PlayTheBlues4U ($9.38 in chips) 
Seat 6: efreay11 ($22.88 in chips) 
PlayTheBlues4U: posts small blind $0.05
efreay11: posts big blind $0.10
*** HOLE CARDS ***
Dealt to PlayTheBlues4U [6h 6d]
OliveXC: folds 
Pezant: folds 
ng2414: folds 
BaldEagleStar: calls $0.10
PlayTheBlues4U: calls $0.05
efreay11: raises $0.10 to $0.20
BaldEagleStar: calls $0.10
PlayTheBlues4U: calls $0.10
*** FLOP *** [5d 4h Ac]
PlayTheBlues4U: checks 
efreay11: bets $0.30
BaldEagleStar: calls $0.30
PlayTheBlues4U: folds 
*** TURN *** [5d 4h Ac] [Jh]
efreay11: bets $0.60
BaldEagleStar: folds 
Uncalled bet ($0.60) returned to efreay11
efreay11 collected $1.14 from pot
efreay11: doesn't show hand 
*** SUMMARY ***
Total pot $1.20 | Rake $0.06 
Board [5d 4h Ac Jh]
Seat 1: OliveXC folded before Flop (didn't bet)
Seat 2: Pezant folded before Flop (didn't bet)
Seat 3: ng2414 folded before Flop (didn't bet)
Seat 4: BaldEagleStar (button) folded on the Turn
Seat 5: PlayTheBlues4U (small blind) folded on the Flop
Seat 6: efreay11 (big blind) collected ($1.14)


PokerStars Hand #204146573417:  Hold'em No Limit ($0.02/$0.05 USD) - 2019/10/01 22:25:57 ET
Table 'Corvus' 6-max Seat #3 is the button
Seat 2: REDRUM192 ($4 in chips) 
Seat 3: IvanMakeBasket ($4.24 in chips) 
Seat 5: 7noodles ($5.04 in chips) 
Seat 6: PlayTheBlues4U ($5.39 in chips) 
7noodles: posts small blind $0.02
PlayTheBlues4U: posts big blind $0.05
*** HOLE CARDS ***
Dealt to PlayTheBlues4U [Qs 3s]
REDRUM192: folds 
IvanMakeBasket: folds 
7noodles: folds 
Uncalled bet ($0.03) returned to PlayTheBlues4U
TyPeters13nj leaves the table
PlayTheBlues4U collected $0.04 from pot
PlayTheBlues4U: doesn't show hand 
*** SUMMARY ***
Total pot $0.04 | Rake $0 
Seat 2: REDRUM192 folded before Flop (didn't bet)
Seat 3: IvanMakeBasket (button) folded before Flop (didn't bet)
Seat 5: 7noodles (small blind) folded before Flop
Seat 6: PlayTheBlues4U (big blind) collected ($0.04)


PokerStars Hand #204146573346:  Hold'em No Limit ($0.02/$0.05 USD) - 2019/10/01 22:25:36 ET
Table 'Corvus' 6-max Seat #2 is the button
Seat 2: REDRUM192 ($3.93 in chips) 
Seat 3: IvanMakeBasket ($4.26 in chips) 
Seat 5: 7noodles ($5.09 in chips) 
Seat 6: PlayTheBlues4U ($5.39 in chips) 
IvanMakeBasket: posts small blind $0.02
7noodles: posts big blind $0.05
*** HOLE CARDS ***
Dealt to PlayTheBlues4U [Kc 4s]
PlayTheBlues4U: folds 
REDRUM192: raises $0.15 to $0.20
IvanMakeBasket: folds 
7noodles: folds 
Uncalled bet ($0.15) returned to REDRUM192
REDRUM192 collected $0.12 from pot
REDRUM192: doesn't show hand 
*** SUMMARY ***
Total pot $0.12 | Rake $0 
Seat 2: REDRUM192 (button) collected ($0.12)
Seat 3: IvanMakeBasket (small blind) folded before Flop
Seat 5: 7noodles (big blind) folded before Flop
Seat 6: PlayTheBlues4U folded before Flop (didn't bet)


PokerStars Hand #204146573296:  Hold'em No Limit ($0.05/$0.10 USD) - 2019/10/01 22:25:25 ET
Table 'Klytia' 6-max Seat #3 is the button
Seat 1: OliveXC ($16.18 in chips) 
Seat 2: Pezant ($13.42 in chips) 
Seat 3: ng2414 ($9.40 in chips) 
Seat 4: BaldEagleStar ($3.21 in chips) 
Seat 5: PlayTheBlues4U ($9.48 in chips) 
Seat 6: efreay11 ($22.24 in chips) 
BaldEagleStar: posts small blind $0.05
PlayTheBlues4U: posts big blind $0.10
*** HOLE CARDS ***
Dealt to PlayTheBlues4U [3c 8h]
efreay11: raises $0.20 to $0.30
OliveXC: folds 
Pezant: folds 
ng2414: folds 
BaldEagleStar: calls $0.25
PlayTheBlues4U: folds 
*** FLOP *** [Jh 9s 9c]
BaldEagleStar: checks 
efreay11: bets $0.30
BaldEagleStar: calls $0.30
*** TURN *** [Jh 9s 9c] [Ad]
BaldEagleStar: checks 
efreay11: bets $0.60
BaldEagleStar: folds 
Uncalled bet ($0.60) returned to efreay11
efreay11 collected $1.24 from pot
efreay11: doesn't show hand 
*** SUMMARY ***
Total pot $1.30 | Rake $0.06 
Board [Jh 9s 9c Ad]
Seat 1: OliveXC folded before Flop (didn't bet)
Seat 2: Pezant folded before Flop (didn't bet)
Seat 3: ng2414 (button) folded before Flop (didn't bet)
Seat 4: BaldEagleStar (small blind) folded on the Turn
Seat 5: PlayTheBlues4U (big blind) folded before Flop
Seat 6: efreay11 collected ($1.24)


PokerStars Hand #204146573290:  Hold'em No Limit ($0.02/$0.05 USD) - 2019/10/01 22:25:23 ET
Table 'Corvus' 6-max Seat #6 is the button
Seat 2: REDRUM192 ($3.95 in chips) 
Seat 3: IvanMakeBasket ($4.31 in chips) 
Seat 5: 7noodles ($5.09 in chips) 
Seat 6: PlayTheBlues4U ($5.32 in chips) 
REDRUM192: posts small blind $0.02
IvanMakeBasket: posts big blind $0.05
*** HOLE CARDS ***
Dealt to PlayTheBlues4U [Th Qd]
7noodles: folds 
PlayTheBlues4U: raises $0.10 to $0.15
REDRUM192: folds 
IvanMakeBasket: folds 
Uncalled bet ($0.10) returned to PlayTheBlues4U
PlayTheBlues4U collected $0.12 from pot
PlayTheBlues4U: doesn't show hand 
*** SUMMARY ***
Total pot $0.12 | Rake $0 
Seat 2: REDRUM192 (small blind) folded before Flop
Seat 3: IvanMakeBasket (big blind) folded before Flop
Seat 5: 7noodles folded before Flop (didn't bet)
Seat 6: PlayTheBlues4U (button) collected ($0.12)


PokerStars Hand #204146573245:  Hold'em No Limit ($0.05/$0.10 USD) - 2019/10/01 22:25:13 ET
Table 'Klytia' 6-max Seat #2 is the button
Seat 1: OliveXC ($16.18 in chips) 
Seat 2: Pezant ($13.27 in chips) 
Seat 3: ng2414 ($9.45 in chips) 
Seat 4: BaldEagleStar ($3.31 in chips) 
Seat 5: PlayTheBlues4U ($9.48 in chips) 
Seat 6: efreay11 ($22.24 in chips) 
ng2414: posts small blind $0.05
BaldEagleStar: posts big blind $0.10
*** HOLE CARDS ***
Dealt to PlayTheBlues4U [7c 6c]
PlayTheBlues4U: folds 
efreay11: folds 
OliveXC: folds 
Pezant: raises $0.13 to $0.23
ng2414: folds 
BaldEagleStar: folds 
Uncalled bet ($0.13) returned to Pezant
Pezant collected $0.25 from pot
Pezant: doesn't show hand 
*** SUMMARY ***
Total pot $0.25 | Rake $0 
Seat 1: OliveXC folded before Flop (didn't bet)
Seat 2: Pezant (button) collected ($0.25)
Seat 3: ng2414 (small blind) folded before Flop
Seat 4: BaldEagleStar (big blind) folded before Flop
Seat 5: PlayTheBlues4U folded before Flop (didn't bet)
Seat 6: efreay11 folded before Flop (didn't bet)


PokerStars Hand #204146573197:  Hold'em No Limit ($0.02/$0.05 USD) - 2019/10/01 22:25:01 ET
Table 'Corvus' 6-max Seat #5 is the button
Seat 2: REDRUM192 ($4 in chips) 
Seat 3: IvanMakeBasket ($4.31 in chips) 
Seat 5: 7noodles ($5.02 in chips) 
Seat 6: PlayTheBlues4U ($5.34 in chips) 
PlayTheBlues4U: posts small blind $0.02
REDRUM192: posts big blind $0.05
*** HOLE CARDS ***
Dealt to PlayTheBlues4U [Ts 7c]
IvanMakeBasket: folds 
7noodles: raises $0.07 to $0.12
TyPeters13nj is disconnected 
PlayTheBlues4U: folds 
REDRUM192: folds 
Uncalled bet ($0.07) returned to 7noodles
7noodles collected $0.12 from pot
*** SUMMARY ***
Total pot $0.12 | Rake $0 
Seat 2: REDRUM192 (big blind) folded before Flop
Seat 3: IvanMakeBasket folded before Flop (didn't bet)
Seat 5: 7noodles (button) collected ($0.12)
Seat 6: PlayTheBlues4U (small blind) folded before Flop


PokerStars Hand #204146573127:  Hold'em No Limit ($0.05/$0.10 USD) - 2019/10/01 22:24:35 ET
Table 'Klytia' 6-max Seat #1 is the button
Seat 1: OliveXC ($16.18 in chips) 
Seat 2: Pezant ($13.32 in chips) 
Seat 3: ng2414 ($9.55 in chips) 
Seat 4: BaldEagleStar ($1.64 in chips) 
Seat 5: PlayTheBlues4U ($9.48 in chips) 
Seat 6: efreay11 ($23.93 in chips) 
Pezant: posts small blind $0.05
ng2414: posts big blind $0.10
efreay11: posts small & big blinds $0.15
*** HOLE CARDS ***
Dealt to PlayTheBlues4U [7s Qc]
BaldEagleStar: calls $0.10
PlayTheBlues4U: folds 
efreay11: raises $0.20 to $0.30
OliveXC: folds 
Pezant: folds 
ng2414: folds 
BaldEagleStar: raises $0.40 to $0.70
efreay11: calls $0.40
*** FLOP *** [7h 2h 9c]
BaldEagleStar: bets $0.94 and is all-in
efreay11: calls $0.94
*** TURN *** [7h 2h 9c] [As]
*** RIVER *** [7h 2h 9c As] [5c]
*** SHOW DOWN ***
BaldEagleStar: shows [Ac Ad] (three of a kind, Aces)
efreay11: shows [Ah 8h] (a pair of Aces)
BaldEagleStar collected $3.31 from pot
*** SUMMARY ***
Total pot $3.48 | Rake $0.17 
Board [7h 2h 9c As 5c]
Seat 1: OliveXC (button) folded before Flop (didn't bet)
Seat 2: Pezant (small blind) folded before Flop
Seat 3: ng2414 (big blind) folded before Flop
Seat 4: BaldEagleStar showed [Ac Ad] and won ($3.31) with three of a kind, Aces
Seat 5: PlayTheBlues4U folded before Flop (didn't bet)
Seat 6: efreay11 showed [Ah 8h] and lost with a pair of Aces


PokerStars Hand #204146573077:  Hold'em No Limit ($0.02/$0.05 USD) - 2019/10/01 22:24:19 ET
Table 'Corvus' 6-max Seat #3 is the button
Seat 3: IvanMakeBasket ($4.31 in chips) 
Seat 5: 7noodles ($5.22 in chips) 
Seat 6: PlayTheBlues4U ($5.16 in chips) 
7noodles: posts small blind $0.02
PlayTheBlues4U: posts big blind $0.05
REDRUM192: sits out 
*** HOLE CARDS ***
Dealt to PlayTheBlues4U [Kh Qh]
IvanMakeBasket: folds 
7noodles: raises $0.07 to $0.12
PlayTheBlues4U: calls $0.07
*** FLOP *** [Kc Jc 3s]
7noodles: bets $0.08
PlayTheBlues4U: raises $0.23 to $0.31
7noodles: folds 
Uncalled bet ($0.23) returned to PlayTheBlues4U
PlayTheBlues4U collected $0.38 from pot
PlayTheBlues4U: doesn't show hand 
*** SUMMARY ***
Total pot $0.40 | Rake $0.02 
Board [Kc Jc 3s]
Seat 3: IvanMakeBasket (button) folded before Flop (didn't bet)
Seat 5: 7noodles (small blind) folded on the Flop
Seat 6: PlayTheBlues4U (big blind) collected ($0.38)


PokerStars Hand #204146573046:  Hold'em No Limit ($0.05/$0.10 USD) - 2019/10/01 22:24:10 ET
Table 'Klytia' 6-max Seat #5 is the button
Seat 1: OliveXC ($16.08 in chips) 
Seat 2: Pezant ($13.42 in chips) 
Seat 3: ng2414 ($9.55 in chips) 
Seat 4: BaldEagleStar ($1.64 in chips) 
Seat 5: PlayTheBlues4U ($9.48 in chips) 
efreay11 will be allowed to play after the button
OliveXC: posts small blind $0.05
Pezant: posts big blind $0.10
*** HOLE CARDS ***
Dealt to PlayTheBlues4U [6c 9s]
ng2414: folds 
BaldEagleStar: folds 
PlayTheBlues4U: folds 
OliveXC: raises $0.20 to $0.30
Pezant: folds 
Uncalled bet ($0.20) returned to OliveXC
OliveXC collected $0.20 from pot
OliveXC: doesn't show hand 
*** SUMMARY ***
Total pot $0.20 | Rake $0 
Seat 1: OliveXC (small blind) collected ($0.20)
Seat 2: Pezant (big blind) folded before Flop
Seat 3: ng2414 folded before Flop (didn't bet)
Seat 4: BaldEagleStar folded before Flop (didn't bet)
Seat 5: PlayTheBlues4U (button) folded before Flop (didn't bet)


PokerStars Hand #204146572997:  Hold'em No Limit ($0.02/$0.05 USD) - 2019/10/01 22:23:53 ET
Table 'Corvus' 6-max Seat #1 is the button
Seat 1: TyPeters13nj ($4.01 in chips) 
Seat 3: IvanMakeBasket ($4.26 in chips) 
Seat 4: MozenMo ($2.71 in chips) 
Seat 5: 7noodles ($5.22 in chips) 
Seat 6: PlayTheBlues4U ($5.16 in chips) 
REDRUM192 will be allowed to play after the button
IvanMakeBasket: posts small blind $0.02
MozenMo: posts big blind $0.05
*** HOLE CARDS ***
Dealt to PlayTheBlues4U [9d Jh]
7noodles: folds 
PlayTheBlues4U: folds 
TyPeters13nj: folds 
IvanMakeBasket: raises $0.10 to $0.15
MozenMo: folds 
Uncalled bet ($0.10) returned to IvanMakeBasket
IvanMakeBasket collected $0.10 from pot
IvanMakeBasket: doesn't show hand 
*** SUMMARY ***
Total pot $0.10 | Rake $0 
Seat 1: TyPeters13nj (button) folded before Flop (didn't bet)
Seat 3: IvanMakeBasket (small blind) collected ($0.10)
Seat 4: MozenMo (big blind) folded before Flop
Seat 5: 7noodles folded before Flop (didn't bet)
Seat 6: PlayTheBlues4U folded before Flop (didn't bet)


PokerStars Hand #204146572857:  Hold'em No Limit ($0.05/$0.10 USD) - 2019/10/01 22:23:04 ET
Table 'Klytia' 6-max Seat #4 is the button
Seat 1: OliveXC ($16.18 in chips) 
Seat 2: Pezant ($13.42 in chips) 
Seat 3: ng2414 ($9.55 in chips) 
Seat 4: BaldEagleStar ($1.64 in chips) 
Seat 5: PlayTheBlues4U ($9.39 in chips) 
PlayTheBlues4U: posts small blind $0.05
efreay11 has timed out
efreay11: is sitting out 
OliveXC: posts big blind $0.10
*** HOLE CARDS ***
Dealt to PlayTheBlues4U [5d 7d]
Pezant has timed out
Pezant: folds 
ng2414: folds 
BaldEagleStar: folds 
PlayTheBlues4U: calls $0.05
OliveXC: checks 
*** FLOP *** [Qd Ks 9s]
PlayTheBlues4U: checks 
OliveXC: checks 
*** TURN *** [Qd Ks 9s] [9c]
PlayTheBlues4U: bets $0.10
OliveXC: folds 
Uncalled bet ($0.10) returned to PlayTheBlues4U
PlayTheBlues4U collected $0.19 from pot
PlayTheBlues4U: doesn't show hand 
*** SUMMARY ***
Total pot $0.20 | Rake $0.01 
Board [Qd Ks 9s 9c]
Seat 1: OliveXC (big blind) folded on the Turn
Seat 2: Pezant folded before Flop (didn't bet)
Seat 3: ng2414 folded before Flop (didn't bet)
Seat 4: BaldEagleStar (button) folded before Flop (didn't bet)
Seat 5: PlayTheBlues4U (small blind) collected ($0.19)


PokerStars Hand #204146572801:  Hold'em No Limit ($0.02/$0.05 USD) - 2019/10/01 22:22:49 ET
Table 'Corvus' 6-max Seat #6 is the button
Seat 1: TyPeters13nj ($3.42 in chips) 
Seat 3: IvanMakeBasket ($4.31 in chips) 
Seat 4: MozenMo ($3.31 in chips) 
Seat 5: 7noodles ($5.22 in chips) 
Seat 6: PlayTheBlues4U ($5.16 in chips) 
TyPeters13nj: posts small blind $0.02
maxplans323: is sitting out 
IvanMakeBasket: posts big blind $0.05
*** HOLE CARDS ***
Dealt to PlayTheBlues4U [4d 8d]
PlayTheBlues4U said, "nh"
maxplans323 leaves the table
MozenMo: calls $0.05
7noodles: folds 
PlayTheBlues4U: folds 
TyPeters13nj: calls $0.03
REDRUM192 joins the table at seat #2 
IvanMakeBasket: checks 
*** FLOP *** [2c 6d 6c]
TyPeters13nj: bets $0.05
IvanMakeBasket: folds 
MozenMo: raises $0.25 to $0.30
TyPeters13nj: raises $0.25 to $0.55
MozenMo: calls $0.25
*** TURN *** [2c 6d 6c] [5h]
TyPeters13nj: bets $0.95
MozenMo: folds 
Uncalled bet ($0.95) returned to TyPeters13nj
TyPeters13nj collected $1.19 from pot
TyPeters13nj: doesn't show hand 
*** SUMMARY ***
Total pot $1.25 | Rake $0.06 
Board [2c 6d 6c 5h]
Seat 1: TyPeters13nj (small blind) collected ($1.19)
Seat 3: IvanMakeBasket (big blind) folded on the Flop
Seat 4: MozenMo folded on the Turn
Seat 5: 7noodles folded before Flop (didn't bet)
Seat 6: PlayTheBlues4U (button) folded before Flop (didn't bet)


PokerStars Hand #204144609915:  Hold'em No Limit ($0.02/$0.05 USD) - 2019/10/01 22:21:52 ET
Table 'Corvus' 6-max Seat #5 is the button
Seat 1: TyPeters13nj ($3.47 in chips) 
Seat 2: maxplans323 ($2.73 in chips) 
Seat 3: IvanMakeBasket ($4.31 in chips) 
Seat 4: MozenMo ($3.31 in chips) 
Seat 5: 7noodles ($5.21 in chips) 
Seat 6: PlayTheBlues4U ($5.15 in chips) 
PlayTheBlues4U: posts small blind $0.02
TyPeters13nj: posts big blind $0.05
*** HOLE CARDS ***
Dealt to PlayTheBlues4U [Ts Kc]
maxplans323: folds 
IvanMakeBasket: folds 
MozenMo: folds 
7noodles: raises $0.07 to $0.12
PlayTheBlues4U: calls $0.10
TyPeters13nj: folds 
*** FLOP *** [9d Kd 8h]
PlayTheBlues4U: checks 
7noodles: bets $0.19
PlayTheBlues4U: calls $0.19
*** TURN *** [9d Kd 8h] [8c]
PlayTheBlues4U: checks 
7noodles: checks 
*** RIVER *** [9d Kd 8h 8c] [Qd]
PlayTheBlues4U: checks 
7noodles: checks 
*** SHOW DOWN ***
PlayTheBlues4U: shows [Ts Kc] (two pair, Kings and Eights)
7noodles: shows [Th Ks] (two pair, Kings and Eights)
PlayTheBlues4U collected $0.32 from pot
7noodles collected $0.32 from pot
*** SUMMARY ***
Total pot $0.67 | Rake $0.03 
Board [9d Kd 8h 8c Qd]
Seat 1: TyPeters13nj (big blind) folded before Flop
Seat 2: maxplans323 folded before Flop (didn't bet)
Seat 3: IvanMakeBasket folded before Flop (didn't bet)
Seat 4: MozenMo folded before Flop (didn't bet)
Seat 5: 7noodles (button) showed [Th Ks] and won ($0.32) with two pair, Kings and Eights
Seat 6: PlayTheBlues4U (small blind) showed [Ts Kc] and won ($0.32) with two pair, Kings and Eights


PokerStars Hand #204144609844:  Hold'em No Limit ($0.05/$0.10 USD) - 2019/10/01 22:21:29 ET
Table 'Klytia' 6-max Seat #3 is the button
Seat 1: OliveXC ($16.18 in chips) 
Seat 2: Pezant ($12.53 in chips) 
Seat 3: ng2414 ($9.85 in chips) 
Seat 4: BaldEagleStar ($1.69 in chips) 
Seat 5: PlayTheBlues4U ($9.69 in chips) 
Seat 6: efreay11 ($24.23 in chips) 
BaldEagleStar: posts small blind $0.05
PlayTheBlues4U: posts big blind $0.10
*** HOLE CARDS ***
Dealt to PlayTheBlues4U [6h 5h]
efreay11: raises $0.20 to $0.30
OliveXC: folds 
Pezant: calls $0.30
ng2414: calls $0.30
BaldEagleStar: folds 
PlayTheBlues4U: calls $0.20
*** FLOP *** [Js Ks Jd]
PlayTheBlues4U: checks 
efreay11: checks 
Pezant: checks 
ng2414: checks 
*** TURN *** [Js Ks Jd] [6s]
PlayTheBlues4U: checks 
efreay11: checks 
Pezant: checks 
ng2414: checks 
*** RIVER *** [Js Ks Jd 6s] [8s]
PlayTheBlues4U: checks 
efreay11: checks 
Pezant: checks 
ng2414: checks 
*** SHOW DOWN ***
PlayTheBlues4U: shows [6h 5h] (two pair, Jacks and Sixes)
efreay11: mucks hand 
Pezant: shows [Td Ts] (a flush, King high)
ng2414: mucks hand 
Pezant collected $1.19 from pot
*** SUMMARY ***
Total pot $1.25 | Rake $0.06 
Board [Js Ks Jd 6s 8s]
Seat 1: OliveXC folded before Flop (didn't bet)
Seat 2: Pezant showed [Td Ts] and won ($1.19) with a flush, King high
Seat 3: ng2414 (button) mucked [Ah 9h]
Seat 4: BaldEagleStar (small blind) folded before Flop
Seat 5: PlayTheBlues4U (big blind) showed [6h 5h] and lost with two pair, Jacks and Sixes
Seat 6: efreay11 mucked [Qc 7c]


PokerStars Hand #204144609794:  Hold'em No Limit ($0.05/$0.10 USD) - 2019/10/01 22:21:09 ET
Table 'Klytia' 6-max Seat #2 is the button
Seat 1: OliveXC ($16.18 in chips) 
Seat 2: Pezant ($12.53 in chips) 
Seat 3: ng2414 ($9.90 in chips) 
Seat 4: BaldEagleStar ($1.54 in chips) 
Seat 5: PlayTheBlues4U ($9.69 in chips) 
Seat 6: efreay11 ($24.33 in chips) 
ng2414: posts small blind $0.05
BaldEagleStar: posts big blind $0.10
*** HOLE CARDS ***
Dealt to PlayTheBlues4U [7c Ah]
PlayTheBlues4U: folds 
efreay11: calls $0.10
OliveXC: folds 
Pezant: folds 
ng2414: folds 
BaldEagleStar: raises $0.50 to $0.60
efreay11: folds 
Uncalled bet ($0.50) returned to BaldEagleStar
BaldEagleStar collected $0.25 from pot
BaldEagleStar: doesn't show hand 
*** SUMMARY ***
Total pot $0.25 | Rake $0 
Seat 1: OliveXC folded before Flop (didn't bet)
Seat 2: Pezant (button) folded before Flop (didn't bet)
Seat 3: ng2414 (small blind) folded before Flop
Seat 4: BaldEagleStar (big blind) collected ($0.25)
Seat 5: PlayTheBlues4U folded before Flop (didn't bet)
Seat 6: efreay11 folded before Flop


PokerStars Hand #204144609791:  Hold'em No Limit ($0.02/$0.05 USD) - 2019/10/01 22:21:08 ET
Table 'Corvus' 6-max Seat #4 is the button
Seat 1: TyPeters13nj ($3.52 in chips) 
Seat 2: maxplans323 ($2.73 in chips) 
Seat 3: IvanMakeBasket ($4.31 in chips) 
Seat 4: MozenMo ($3.36 in chips) 
Seat 5: 7noodles ($5.26 in chips) 
Seat 6: PlayTheBlues4U ($5 in chips) 
7noodles: posts small blind $0.02
PlayTheBlues4U: posts big blind $0.05
*** HOLE CARDS ***
Dealt to PlayTheBlues4U [Jh Jd]
TyPeters13nj: calls $0.05
maxplans323: folds 
IvanMakeBasket: folds 
MozenMo: calls $0.05
7noodles: calls $0.03
PlayTheBlues4U: raises $0.20 to $0.25
TyPeters13nj: folds 
MozenMo: folds 
7noodles: folds 
Uncalled bet ($0.20) returned to PlayTheBlues4U
PlayTheBlues4U collected $0.20 from pot
PlayTheBlues4U: doesn't show hand 
*** SUMMARY ***
Total pot $0.20 | Rake $0 
Seat 1: TyPeters13nj folded before Flop
Seat 2: maxplans323 folded before Flop (didn't bet)
Seat 3: IvanMakeBasket folded before Flop (didn't bet)
Seat 4: MozenMo (button) folded before Flop
Seat 5: 7noodles (small blind) folded before Flop
Seat 6: PlayTheBlues4U (big blind) collected ($0.20)


PokerStars Hand #204144609543:  Hold'em No Limit ($0.05/$0.10 USD) - 2019/10/01 22:19:48 ET
Table 'Klytia' 6-max Seat #1 is the button
Seat 1: OliveXC ($19.88 in chips) 
Seat 2: Pezant ($12.58 in chips) 
Seat 3: ng2414 ($10 in chips) 
Seat 4: BaldEagleStar ($1.54 in chips) 
Seat 5: PlayTheBlues4U ($9.99 in chips) 
Seat 6: efreay11 ($20.57 in chips) 
Pezant: posts small blind $0.05
ng2414: posts big blind $0.10
*** HOLE CARDS ***
Dealt to PlayTheBlues4U [7h 7c]
BaldEagleStar: folds 
PlayTheBlues4U: raises $0.20 to $0.30
efreay11: calls $0.30
OliveXC: calls $0.30
Pezant: folds 
ng2414: folds 
*** FLOP *** [Jd Jh Qh]
PlayTheBlues4U: checks 
efreay11: checks 
OliveXC: bets $0.80
PlayTheBlues4U: folds 
efreay11: calls $0.80
*** TURN *** [Jd Jh Qh] [9c]
efreay11: bets $1.30
OliveXC: raises $1.30 to $2.60
efreay11: calls $1.30
*** RIVER *** [Jd Jh Qh 9c] [9d]
efreay11: bets $3.70
OliveXC: folds 
Uncalled bet ($3.70) returned to efreay11
efreay11 collected $7.46 from pot
efreay11: doesn't show hand 
*** SUMMARY ***
Total pot $7.85 | Rake $0.39 
Board [Jd Jh Qh 9c 9d]
Seat 1: OliveXC (button) folded on the River
Seat 2: Pezant (small blind) folded before Flop
Seat 3: ng2414 (big blind) folded before Flop
Seat 4: BaldEagleStar folded before Flop (didn't bet)
Seat 5: PlayTheBlues4U folded on the Flop
Seat 6: efreay11 collected ($7.46)


PokerStars Hand #204144609330:  Hold'em No Limit ($0.05/$0.10 USD) - 2019/10/01 22:18:43 ET
Table 'Klytia' 6-max Seat #6 is the button
Seat 1: OliveXC ($19.33 in chips) 
Seat 2: Pezant ($12.68 in chips) 
Seat 3: ng2414 ($9.10 in chips) 
Seat 4: BaldEagleStar ($1.64 in chips) 
Seat 5: PlayTheBlues4U ($9.99 in chips) 
Seat 6: efreay11 ($20.97 in chips) 
OliveXC: posts small blind $0.05
Pezant: posts big blind $0.10
*** HOLE CARDS ***
Dealt to PlayTheBlues4U [6d Qc]
ng2414: folds 
BaldEagleStar: calls $0.10
PlayTheBlues4U: folds 
efreay11: calls $0.10
OliveXC: calls $0.05
Pezant: checks 
*** FLOP *** [4s 3h Kd]
OliveXC: checks 
Pezant: checks 
BaldEagleStar: checks 
efreay11: checks 
*** TURN *** [4s 3h Kd] [3d]
OliveXC: bets $0.30
Pezant: folds 
BaldEagleStar: folds 
efreay11: calls $0.30
*** RIVER *** [4s 3h Kd 3d] [8h]
OliveXC: checks 
efreay11: checks 
*** SHOW DOWN ***
OliveXC: shows [Qd 4d] (two pair, Fours and Threes)
efreay11: mucks hand 
OliveXC collected $0.95 from pot
*** SUMMARY ***
Total pot $1 | Rake $0.05 
Board [4s 3h Kd 3d 8h]
Seat 1: OliveXC (small blind) showed [Qd 4d] and won ($0.95) with two pair, Fours and Threes
Seat 2: Pezant (big blind) folded on the Turn
Seat 3: ng2414 folded before Flop (didn't bet)
Seat 4: BaldEagleStar folded on the Turn
Seat 5: PlayTheBlues4U folded before Flop (didn't bet)
Seat 6: efreay11 (button) mucked [9d Td]


PokerStars Hand #204144609091:  Hold'em No Limit ($0.05/$0.10 USD) - 2019/10/01 22:17:33 ET
Table 'Klytia' 6-max Seat #5 is the button
Seat 1: OliveXC ($19.63 in chips) 
Seat 2: Pezant ($12.68 in chips) 
Seat 3: ng2414 ($10 in chips) 
Seat 4: BaldEagleStar ($1.94 in chips) 
Seat 5: PlayTheBlues4U ($9.99 in chips) 
Seat 6: efreay11 ($19.59 in chips) 
efreay11: posts small blind $0.05
OliveXC: posts big blind $0.10
*** HOLE CARDS ***
Dealt to PlayTheBlues4U [7c 8d]
Pezant: folds 
ng2414: raises $0.20 to $0.30
BaldEagleStar: calls $0.30
PlayTheBlues4U: folds 
efreay11: calls $0.25
OliveXC: calls $0.20
*** FLOP *** [Kd 2d Ad]
efreay11: bets $0.60
OliveXC: folds 
ng2414: calls $0.60
BaldEagleStar: folds 
*** TURN *** [Kd 2d Ad] [5h]
efreay11: checks 
ng2414: checks 
*** RIVER *** [Kd 2d Ad 5h] [8c]
efreay11: checks 
ng2414: checks 
*** SHOW DOWN ***
efreay11: shows [Jd Ac] (a pair of Aces)
ng2414: mucks hand 
efreay11 collected $2.28 from pot
*** SUMMARY ***
Total pot $2.40 | Rake $0.12 
Board [Kd 2d Ad 5h 8c]
Seat 1: OliveXC (big blind) folded on the Flop
Seat 2: Pezant folded before Flop (didn't bet)
Seat 3: ng2414 mucked [Qh Qd]
Seat 4: BaldEagleStar folded on the Flop
Seat 5: PlayTheBlues4U (button) folded before Flop (didn't bet)
Seat 6: efreay11 (small blind) showed [Jd Ac] and won ($2.28) with a pair of Aces


PokerStars Hand #204144608937:  Hold'em No Limit ($0.05/$0.10 USD) - 2019/10/01 22:16:48 ET
Table 'Klytia' 6-max Seat #4 is the button
Seat 1: OliveXC ($19.63 in chips) 
Seat 2: Pezant ($12.68 in chips) 
Seat 3: ng2414 ($8.74 in chips) 
Seat 4: BaldEagleStar ($1.94 in chips) 
Seat 5: PlayTheBlues4U ($9.90 in chips) 
Seat 6: efreay11 ($19.69 in chips) 
PlayTheBlues4U: posts small blind $0.05
efreay11: posts big blind $0.10
*** HOLE CARDS ***
Dealt to PlayTheBlues4U [6d 7s]
OliveXC: folds 
Pezant: folds 
ng2414: folds 
BaldEagleStar: folds 
PlayTheBlues4U: calls $0.05
efreay11: checks 
*** FLOP *** [4s Kh 8s]
PlayTheBlues4U: checks 
efreay11: checks 
*** TURN *** [4s Kh 8s] [5s]
PlayTheBlues4U: bets $0.20
efreay11: folds 
Uncalled bet ($0.20) returned to PlayTheBlues4U
PlayTheBlues4U collected $0.19 from pot
PlayTheBlues4U: doesn't show hand 
*** SUMMARY ***
Total pot $0.20 | Rake $0.01 
Board [4s Kh 8s 5s]
Seat 1: OliveXC folded before Flop (didn't bet)
Seat 2: Pezant folded before Flop (didn't bet)
Seat 3: ng2414 folded before Flop (didn't bet)
Seat 4: BaldEagleStar (button) folded before Flop (didn't bet)
Seat 5: PlayTheBlues4U (small blind) collected ($0.19)
Seat 6: efreay11 (big blind) folded on the Turn


PokerStars Hand #204144608828:  Hold'em No Limit ($0.05/$0.10 USD) - 2019/10/01 22:16:10 ET
Table 'Klytia' 6-max Seat #3 is the button
Seat 1: OliveXC ($19.63 in chips) 
Seat 2: Pezant ($11.84 in chips) 
Seat 3: ng2414 ($8.74 in chips) 
Seat 4: BaldEagleStar ($2.34 in chips) 
Seat 5: PlayTheBlues4U ($10 in chips) 
Seat 6: efreay11 ($20.09 in chips) 
BaldEagleStar: posts small blind $0.05
PlayTheBlues4U: posts big blind $0.10
*** HOLE CARDS ***
Dealt to PlayTheBlues4U [Qd Tc]
efreay11: calls $0.10
OliveXC: folds 
Pezant: raises $0.30 to $0.40
ng2414: folds 
BaldEagleStar: calls $0.35
PlayTheBlues4U: folds 
efreay11: calls $0.30
*** FLOP *** [2h 5h 5c]
BaldEagleStar: checks 
efreay11: checks 
Pezant: bets $0.41
BaldEagleStar: folds 
efreay11: folds 
Uncalled bet ($0.41) returned to Pezant
Pezant collected $1.24 from pot
Pezant: doesn't show hand 
*** SUMMARY ***
Total pot $1.30 | Rake $0.06 
Board [2h 5h 5c]
Seat 1: OliveXC folded before Flop (didn't bet)
Seat 2: Pezant collected ($1.24)
Seat 3: ng2414 (button) folded before Flop (didn't bet)
Seat 4: BaldEagleStar (small blind) folded on the Flop
Seat 5: PlayTheBlues4U (big blind) folded before Flop
Seat 6: efreay11 folded on the Flop


PokerStars Hand #204132323263:  Hold'em No Limit ($0.05/$0.10 USD) - 2019/10/01 7:20:47 ET
Table 'Tabit' 6-max Seat #1 is the button
Seat 1: PlayTheBlues4U ($12.69 in chips) 
Seat 2: okwon ($7.59 in chips) 
Seat 5: hunteeer 05 ($14.14 in chips) 
Seat 6: chips1614 ($11.64 in chips) 
okwon: posts small blind $0.05
hunteeer 05: posts big blind $0.10
*** HOLE CARDS ***
Dealt to PlayTheBlues4U [8d Ks]
chips1614: folds 
PlayTheBlues4U: folds 
okwon: calls $0.05
hunteeer 05: raises $0.10 to $0.20
okwon: calls $0.10
*** FLOP *** [Kh 9h Qd]
okwon: bets $0.20
hunteeer 05: calls $0.20
*** TURN *** [Kh 9h Qd] [2s]
chips1614 leaves the table
okwon: bets $0.40
hunteeer 05: folds 
Uncalled bet ($0.40) returned to okwon
okwon collected $0.76 from pot
okwon: doesn't show hand 
*** SUMMARY ***
Total pot $0.80 | Rake $0.04 
Board [Kh 9h Qd 2s]
Seat 1: PlayTheBlues4U (button) folded before Flop (didn't bet)
Seat 2: okwon (small blind) collected ($0.76)
Seat 5: hunteeer 05 (big blind) folded on the Turn
Seat 6: chips1614 folded before Flop (didn't bet)


PokerStars Hand #204132323246:  Hold'em No Limit ($0.05/$0.10 USD) - 2019/10/01 7:20:05 ET
Table 'Tabit' 6-max Seat #6 is the button
Seat 1: PlayTheBlues4U ($12.74 in chips) 
Seat 2: okwon ($8.09 in chips) 
Seat 5: hunteeer 05 ($14.34 in chips) 
Seat 6: chips1614 ($10.95 in chips) 
PlayTheBlues4U: posts small blind $0.05
okwon: posts big blind $0.10
*** HOLE CARDS ***
Dealt to PlayTheBlues4U [Qs 6h]
hunteeer 05: raises $0.10 to $0.20
chips1614: calls $0.20
PlayTheBlues4U: folds 
okwon: calls $0.10
*** FLOP *** [Ac 3h Ad]
okwon: checks 
hunteeer 05: checks 
chips1614: checks 
*** TURN *** [Ac 3h Ad] [9s]
okwon: checks 
hunteeer 05: checks 
chips1614: checks 
*** RIVER *** [Ac 3h Ad 9s] [7d]
okwon: bets $0.30
hunteeer 05: folds 
chips1614: calls $0.30
*** SHOW DOWN ***
okwon: shows [5c Ts] (a pair of Aces)
chips1614: shows [Ks 3s] (two pair, Aces and Threes)
chips1614 collected $1.19 from pot
*** SUMMARY ***
Total pot $1.25 | Rake $0.06 
Board [Ac 3h Ad 9s 7d]
Seat 1: PlayTheBlues4U (small blind) folded before Flop
Seat 2: okwon (big blind) showed [5c Ts] and lost with a pair of Aces
Seat 5: hunteeer 05 folded on the River
Seat 6: chips1614 (button) showed [Ks 3s] and won ($1.19) with two pair, Aces and Threes


PokerStars Hand #204132323234:  Hold'em No Limit ($0.05/$0.10 USD) - 2019/10/01 7:19:25 ET
Table 'Tabit' 6-max Seat #5 is the button
Seat 1: PlayTheBlues4U ($11.10 in chips) 
Seat 2: okwon ($9.59 in chips) 
Seat 5: hunteeer 05 ($14.34 in chips) 
Seat 6: chips1614 ($11.25 in chips) 
chips1614: posts small blind $0.05
PlayTheBlues4U: posts big blind $0.10
*** HOLE CARDS ***
Dealt to PlayTheBlues4U [9d Ks]
okwon: raises $0.20 to $0.30
hunteeer 05: folds 
chips1614: calls $0.25
PlayTheBlues4U: calls $0.20
*** FLOP *** [Qh Kc 2c]
chips1614: checks 
PlayTheBlues4U: checks 
okwon: bets $0.40
chips1614: folds 
PlayTheBlues4U: calls $0.40
*** TURN *** [Qh Kc 2c] [Th]
PlayTheBlues4U: checks 
okwon: bets $0.80
PlayTheBlues4U: calls $0.80
*** RIVER *** [Qh Kc 2c Th] [Jh]
PlayTheBlues4U: checks 
okwon: checks 
*** SHOW DOWN ***
PlayTheBlues4U: shows [9d Ks] (a straight, Nine to King)
okwon: mucks hand 
PlayTheBlues4U collected $3.14 from pot
*** SUMMARY ***
Total pot $3.30 | Rake $0.16 
Board [Qh Kc 2c Th Jh]
Seat 1: PlayTheBlues4U (big blind) showed [9d Ks] and won ($3.14) with a straight, Nine to King
Seat 2: okwon mucked [5d Kh]
Seat 5: hunteeer 05 (button) folded before Flop (didn't bet)
Seat 6: chips1614 (small blind) folded on the Flop


PokerStars Hand #204132323230:  Hold'em No Limit ($0.05/$0.10 USD) - 2019/10/01 7:19:12 ET
Table 'Tabit' 6-max Seat #2 is the button
Seat 1: PlayTheBlues4U ($11.10 in chips) 
Seat 2: okwon ($9.89 in chips) 
Seat 5: hunteeer 05 ($14.39 in chips) 
Seat 6: chips1614 ($10.90 in chips) 
hunteeer 05: posts small blind $0.05
chips1614: posts big blind $0.10
*** HOLE CARDS ***
Dealt to PlayTheBlues4U [8c 2d]
PlayTheBlues4U: folds 
okwon: raises $0.20 to $0.30
hunteeer 05: folds 
chips1614: raises $10.60 to $10.90 and is all-in
okwon: folds 
Uncalled bet ($10.60) returned to chips1614
chips1614 collected $0.65 from pot
chips1614: doesn't show hand 
*** SUMMARY ***
Total pot $0.65 | Rake $0 
Seat 1: PlayTheBlues4U folded before Flop (didn't bet)
Seat 2: okwon (button) folded before Flop
Seat 5: hunteeer 05 (small blind) folded before Flop
Seat 6: chips1614 (big blind) collected ($0.65)


PokerStars Hand #204132323226:  Hold'em No Limit ($0.05/$0.10 USD) - 2019/10/01 7:19:00 ET
Table 'Tabit' 6-max Seat #1 is the button
Seat 1: PlayTheBlues4U ($10.95 in chips) 
Seat 2: okwon ($9.94 in chips) 
Seat 5: hunteeer 05 ($14.49 in chips) 
Seat 6: chips1614 ($10.90 in chips) 
okwon: posts small blind $0.05
hunteeer 05: posts big blind $0.10
*** HOLE CARDS ***
Dealt to PlayTheBlues4U [2s Ad]
chips1614: folds 
PlayTheBlues4U: raises $0.20 to $0.30
okwon: folds 
hunteeer 05: folds 
Uncalled bet ($0.20) returned to PlayTheBlues4U
PlayTheBlues4U collected $0.25 from pot
PlayTheBlues4U: doesn't show hand 
*** SUMMARY ***
Total pot $0.25 | Rake $0 
Seat 1: PlayTheBlues4U (button) collected ($0.25)
Seat 2: okwon (small blind) folded before Flop
Seat 5: hunteeer 05 (big blind) folded before Flop
Seat 6: chips1614 folded before Flop (didn't bet)


PokerStars Hand #204132323217:  Hold'em No Limit ($0.05/$0.10 USD) - 2019/10/01 7:18:27 ET
Table 'Tabit' 6-max Seat #6 is the button
Seat 1: PlayTheBlues4U ($11.85 in chips) 
Seat 2: okwon ($10.04 in chips) 
Seat 5: hunteeer 05 ($14.49 in chips) 
Seat 6: chips1614 ($9.90 in chips) 
PlayTheBlues4U: posts small blind $0.05
okwon: posts big blind $0.10
*** HOLE CARDS ***
Dealt to PlayTheBlues4U [Ah 5h]
hunteeer 05: folds 
chips1614: raises $0.25 to $0.35
PlayTheBlues4U: raises $0.55 to $0.90
okwon: folds 
chips1614: raises $9 to $9.90 and is all-in
PlayTheBlues4U: folds 
Uncalled bet ($9) returned to chips1614
chips1614 collected $1.90 from pot
chips1614: doesn't show hand 
*** SUMMARY ***
Total pot $1.90 | Rake $0 
Seat 1: PlayTheBlues4U (small blind) folded before Flop
Seat 2: okwon (big blind) folded before Flop
Seat 5: hunteeer 05 folded before Flop (didn't bet)
Seat 6: chips1614 (button) collected ($1.90)


PokerStars Hand #204132323191:  Hold'em No Limit ($0.05/$0.10 USD) - 2019/10/01 7:17:27 ET
Table 'Tabit' 6-max Seat #5 is the button
Seat 1: PlayTheBlues4U ($11.76 in chips) 
Seat 2: okwon ($10.04 in chips) 
Seat 4: SuWasup ($10.50 in chips) 
Seat 5: hunteeer 05 ($14.49 in chips) 
Seat 6: chips1614 ($10 in chips) 
chips1614: posts small blind $0.05
PlayTheBlues4U: posts big blind $0.10
*** HOLE CARDS ***
Dealt to PlayTheBlues4U [3c 8s]
okwon: folds 
SuWasup: folds 
hunteeer 05: folds 
SuWasup leaves the table
chips1614: calls $0.05
PlayTheBlues4U: checks 
*** FLOP *** [9d 4h 6d]
chips1614: checks 
PlayTheBlues4U: checks 
*** TURN *** [9d 4h 6d] [5h]
chips1614: checks 
PlayTheBlues4U: bets $0.10
chips1614: folds 
Uncalled bet ($0.10) returned to PlayTheBlues4U
PlayTheBlues4U collected $0.19 from pot
PlayTheBlues4U: doesn't show hand 
*** SUMMARY ***
Total pot $0.20 | Rake $0.01 
Board [9d 4h 6d 5h]
Seat 1: PlayTheBlues4U (big blind) collected ($0.19)
Seat 2: okwon folded before Flop (didn't bet)
Seat 4: SuWasup folded before Flop (didn't bet)
Seat 5: hunteeer 05 (button) folded before Flop (didn't bet)
Seat 6: chips1614 (small blind) folded on the Turn


PokerStars Hand #204132323170:  Hold'em No Limit ($0.05/$0.10 USD) - 2019/10/01 7:16:29 ET
Table 'Tabit' 6-max Seat #4 is the button
Seat 1: PlayTheBlues4U ($11.76 in chips) 
Seat 2: okwon ($10.04 in chips) 
Seat 4: SuWasup ($11 in chips) 
Seat 5: hunteeer 05 ($13.95 in chips) 
Seat 6: chips1614 ($5.81 in chips) 
hunteeer 05: posts small blind $0.05
chips1614: posts big blind $0.10
*** HOLE CARDS ***
Dealt to PlayTheBlues4U [5c 2h]
PlayTheBlues4U: folds 
okwon: folds 
SuWasup: raises $0.20 to $0.30
hunteeer 05: raises $0.20 to $0.50
chips1614: folds 
SuWasup: calls $0.20
*** FLOP *** [7h 9h 8c]
hunteeer 05: checks 
SuWasup: checks 
*** TURN *** [7h 9h 8c] [2c]
hunteeer 05: checks 
SuWasup: checks 
*** RIVER *** [7h 9h 8c 2c] [5h]
hunteeer 05: checks 
SuWasup: checks 
*** SHOW DOWN ***
hunteeer 05: shows [As Qs] (high card Ace)
SuWasup: mucks hand 
hunteeer 05 collected $1.04 from pot
*** SUMMARY ***
Total pot $1.10 | Rake $0.06 
Board [7h 9h 8c 2c 5h]
Seat 1: PlayTheBlues4U folded before Flop (didn't bet)
Seat 2: okwon folded before Flop (didn't bet)
Seat 4: SuWasup (button) mucked [Td Qd]
Seat 5: hunteeer 05 (small blind) showed [As Qs] and won ($1.04) with high card Ace
Seat 6: chips1614 (big blind) folded before Flop


PokerStars Hand #204132323148:  Hold'em No Limit ($0.05/$0.10 USD) - 2019/10/01 7:15:53 ET
Table 'Tabit' 6-max Seat #2 is the button
Seat 1: PlayTheBlues4U ($9.40 in chips) 
Seat 2: okwon ($10.04 in chips) 
Seat 4: SuWasup ($11.05 in chips) 
Seat 5: hunteeer 05 ($14.05 in chips) 
Seat 6: chips1614 ($8.27 in chips) 
SuWasup: posts small blind $0.05
hunteeer 05: posts big blind $0.10
*** HOLE CARDS ***
Dealt to PlayTheBlues4U [8d Ac]
chips1614: raises $0.20 to $0.30
PlayTheBlues4U: calls $0.30
okwon: folds 
SuWasup: folds 
hunteeer 05: folds 
*** FLOP *** [8s 3s 6d]
chips1614: checks 
PlayTheBlues4U: bets $0.50
chips1614: calls $0.50
*** TURN *** [8s 3s 6d] [2c]
chips1614: checks 
PlayTheBlues4U: checks 
*** RIVER *** [8s 3s 6d 2c] [Ad]
chips1614: bets $1.66
PlayTheBlues4U: calls $1.66
*** SHOW DOWN ***
chips1614: shows [As 5c] (a pair of Aces)
PlayTheBlues4U: shows [8d Ac] (two pair, Aces and Eights)
PlayTheBlues4U collected $4.82 from pot
*** SUMMARY ***
Total pot $5.07 | Rake $0.25 
Board [8s 3s 6d 2c Ad]
Seat 1: PlayTheBlues4U showed [8d Ac] and won ($4.82) with two pair, Aces and Eights
Seat 2: okwon (button) folded before Flop (didn't bet)
Seat 4: SuWasup (small blind) folded before Flop
Seat 5: hunteeer 05 (big blind) folded before Flop
Seat 6: chips1614 showed [As 5c] and lost with a pair of Aces


PokerStars Hand #204132323135:  Hold'em No Limit ($0.05/$0.10 USD) - 2019/10/01 7:15:28 ET
Table 'Tabit' 6-max Seat #1 is the button
Seat 1: PlayTheBlues4U ($9.70 in chips) 
Seat 2: okwon ($9.39 in chips) 
Seat 4: SuWasup ($11.15 in chips) 
Seat 5: hunteeer 05 ($14.05 in chips) 
Seat 6: chips1614 ($4.57 in chips) 
okwon: posts small blind $0.05
SuWasup: posts big blind $0.10
*** HOLE CARDS ***
Dealt to PlayTheBlues4U [3d 4h]
hunteeer 05: folds 
chips1614: raises $0.10 to $0.20
PlayTheBlues4U: calls $0.20
okwon: raises $0.10 to $0.30
SuWasup: folds 
chips1614: calls $0.10
PlayTheBlues4U: calls $0.10
*** FLOP *** [Qs Jc 2c]
okwon: bets $0.50
chips1614: folds 
PlayTheBlues4U: folds 
Uncalled bet ($0.50) returned to okwon
okwon collected $0.95 from pot
okwon: doesn't show hand 
*** SUMMARY ***
Total pot $1 | Rake $0.05 
Board [Qs Jc 2c]
Seat 1: PlayTheBlues4U (button) folded on the Flop
Seat 2: okwon (small blind) collected ($0.95)
Seat 4: SuWasup (big blind) folded before Flop
Seat 5: hunteeer 05 folded before Flop (didn't bet)
Seat 6: chips1614 folded on the Flop


PokerStars Hand #204132323107:  Hold'em No Limit ($0.05/$0.10 USD) - 2019/10/01 7:14:43 ET
Table 'Tabit' 6-max Seat #6 is the button
Seat 1: PlayTheBlues4U ($9.75 in chips) 
Seat 2: okwon ($9.49 in chips) 
Seat 5: hunteeer 05 ($7.32 in chips) 
Seat 6: chips1614 ($11.89 in chips) 
PlayTheBlues4U: posts small blind $0.05
okwon: posts big blind $0.10
SuWasup: sits out 
*** HOLE CARDS ***
Dealt to PlayTheBlues4U [Kc Jc]
hunteeer 05: raises $0.20 to $0.30
chips1614: raises $0.40 to $0.70
PlayTheBlues4U: folds 
okwon: folds 
hunteeer 05: raises $6.62 to $7.32 and is all-in
chips1614: calls $6.62
*** FLOP *** [Jd Qc Ts]
*** TURN *** [Jd Qc Ts] [5s]
*** RIVER *** [Jd Qc Ts 5s] [2c]
*** SHOW DOWN ***
hunteeer 05: shows [Jh Ah] (a pair of Jacks)
chips1614: shows [6h 6d] (a pair of Sixes)
hunteeer 05 collected $14.05 from pot
*** SUMMARY ***
Total pot $14.79 | Rake $0.74 
Board [Jd Qc Ts 5s 2c]
Seat 1: PlayTheBlues4U (small blind) folded before Flop
Seat 2: okwon (big blind) folded before Flop
Seat 5: hunteeer 05 showed [Jh Ah] and won ($14.05) with a pair of Jacks
Seat 6: chips1614 (button) showed [6h 6d] and lost with a pair of Sixes


PokerStars Hand #204132323094:  Hold'em No Limit ($0.05/$0.10 USD) - 2019/10/01 7:14:27 ET
Table 'Tabit' 6-max Seat #5 is the button
Seat 1: PlayTheBlues4U ($9.85 in chips) 
Seat 2: okwon ($9.13 in chips) 
Seat 5: hunteeer 05 ($7.32 in chips) 
Seat 6: chips1614 ($12.19 in chips) 
chips1614: posts small blind $0.05
PlayTheBlues4U: posts big blind $0.10
SuWasup: sits out 
*** HOLE CARDS ***
Dealt to PlayTheBlues4U [Qd 5h]
okwon: raises $0.20 to $0.30
hunteeer 05: folds 
chips1614: calls $0.25
PlayTheBlues4U: folds 
*** FLOP *** [8c Td 4s]
chips1614: checks 
okwon: bets $0.30
chips1614: folds 
Uncalled bet ($0.30) returned to okwon
okwon collected $0.66 from pot
okwon: doesn't show hand 
*** SUMMARY ***
Total pot $0.70 | Rake $0.04 
Board [8c Td 4s]
Seat 1: PlayTheBlues4U (big blind) folded before Flop
Seat 2: okwon collected ($0.66)
Seat 5: hunteeer 05 (button) folded before Flop (didn't bet)
Seat 6: chips1614 (small blind) folded on the Flop


PokerStars Hand #204132323076:  Hold'em No Limit ($0.05/$0.10 USD) - 2019/10/01 7:13:52 ET
Table 'Tabit' 6-max Seat #2 is the button
Seat 1: PlayTheBlues4U ($9.85 in chips) 
Seat 2: okwon ($10.23 in chips) 
Seat 5: hunteeer 05 ($7.37 in chips) 
Seat 6: chips1614 ($11.15 in chips) 
hunteeer 05: posts small blind $0.05
chips1614: posts big blind $0.10
*** HOLE CARDS ***
Dealt to PlayTheBlues4U [Jc 2h]
PlayTheBlues4U: folds 
okwon: raises $0.20 to $0.30
hunteeer 05: folds 
chips1614: calls $0.20
*** FLOP *** [2c 7h 5h]
chips1614: checks 
okwon: bets $0.40
chips1614: raises $0.40 to $0.80
okwon: calls $0.40
*** TURN *** [2c 7h 5h] [8h]
chips1614: bets $2.14
okwon: folds 
Uncalled bet ($2.14) returned to chips1614
chips1614 collected $2.14 from pot
chips1614: doesn't show hand 
*** SUMMARY ***
Total pot $2.25 | Rake $0.11 
Board [2c 7h 5h 8h]
Seat 1: PlayTheBlues4U folded before Flop (didn't bet)
Seat 2: okwon (button) folded on the Turn
Seat 5: hunteeer 05 (small blind) folded before Flop
Seat 6: chips1614 (big blind) collected ($2.14)


PokerStars Hand #204132323059:  Hold'em No Limit ($0.05/$0.10 USD) - 2019/10/01 7:13:24 ET
Table 'Tabit' 6-max Seat #1 is the button
Seat 1: PlayTheBlues4U ($9.85 in chips) 
Seat 2: okwon ($10.13 in chips) 
Seat 3: iasillo1989 ($21.51 in chips) 
Seat 4: SuWasup ($11.15 in chips) 
Seat 5: hunteeer 05 ($7.37 in chips) 
Seat 6: chips1614 ($11.15 in chips) 
okwon: posts small blind $0.05
iasillo1989: posts big blind $0.10
*** HOLE CARDS ***
Dealt to PlayTheBlues4U [Td 4h]
SuWasup has timed out
SuWasup: folds 
hunteeer 05: folds 
chips1614: folds 
PlayTheBlues4U: folds 
okwon: calls $0.05
iasillo1989: folds 
iasillo1989 leaves the table
okwon collected $0.20 from pot
okwon: doesn't show hand 
*** SUMMARY ***
Total pot $0.20 | Rake $0 
Seat 1: PlayTheBlues4U (button) folded before Flop (didn't bet)
Seat 2: okwon (small blind) collected ($0.20)
Seat 3: iasillo1989 (big blind) folded before Flop
Seat 4: SuWasup folded before Flop (didn't bet)
Seat 5: hunteeer 05 folded before Flop (didn't bet)
Seat 6: chips1614 folded before Flop (didn't bet)


PokerStars Hand #204132323052:  Hold'em No Limit ($0.05/$0.10 USD) - 2019/10/01 7:13:08 ET
Table 'Tabit' 6-max Seat #6 is the button
Seat 1: PlayTheBlues4U ($9.90 in chips) 
Seat 2: okwon ($10.23 in chips) 
Seat 3: iasillo1989 ($21.36 in chips) 
Seat 4: SuWasup ($11.15 in chips) 
Seat 5: hunteeer 05 ($7.37 in chips) 
Seat 6: chips1614 ($11.15 in chips) 
PlayTheBlues4U: posts small blind $0.05
okwon: posts big blind $0.10
*** HOLE CARDS ***
Dealt to PlayTheBlues4U [9c 8s]
iasillo1989: raises $0.90 to $1
SuWasup: folds 
hunteeer 05: folds 
chips1614: folds 
PlayTheBlues4U: folds 
okwon: folds 
Uncalled bet ($0.90) returned to iasillo1989
iasillo1989 collected $0.25 from pot
iasillo1989: doesn't show hand 
*** SUMMARY ***
Total pot $0.25 | Rake $0 
Seat 1: PlayTheBlues4U (small blind) folded before Flop
Seat 2: okwon (big blind) folded before Flop
Seat 3: iasillo1989 collected ($0.25)
Seat 4: SuWasup folded before Flop (didn't bet)
Seat 5: hunteeer 05 folded before Flop (didn't bet)
Seat 6: chips1614 (button) folded before Flop (didn't bet)


PokerStars Hand #204132323031:  Hold'em No Limit ($0.05/$0.10 USD) - 2019/10/01 7:12:39 ET
Table 'Tabit' 6-max Seat #5 is the button
Seat 1: PlayTheBlues4U ($10 in chips) 
Seat 2: okwon ($10.23 in chips) 
Seat 3: iasillo1989 ($20.64 in chips) 
Seat 4: SuWasup ($11.15 in chips) 
Seat 5: hunteeer 05 ($3.37 in chips) 
Seat 6: chips1614 ($11.85 in chips) 
chips1614: posts small blind $0.05
PlayTheBlues4U: posts big blind $0.10
*** HOLE CARDS ***
Dealt to PlayTheBlues4U [2h 6s]
okwon: folds 
iasillo1989: calls $0.10
SuWasup: folds 
hunteeer 05: folds 
chips1614: raises $0.30 to $0.40
PlayTheBlues4U: folds 
iasillo1989: raises $0.30 to $0.70
chips1614: calls $0.30
*** FLOP *** [9h 4d 7d]
chips1614: checks 
iasillo1989: bets $2
chips1614: folds 
Uncalled bet ($2) returned to iasillo1989
iasillo1989 collected $1.42 from pot
iasillo1989: doesn't show hand 
*** SUMMARY ***
Total pot $1.50 | Rake $0.08 
Board [9h 4d 7d]
Seat 1: PlayTheBlues4U (big blind) folded before Flop
Seat 2: okwon folded before Flop (didn't bet)
Seat 3: iasillo1989 collected ($1.42)
Seat 4: SuWasup folded before Flop (didn't bet)
Seat 5: hunteeer 05 (button) folded before Flop (didn't bet)
Seat 6: chips1614 (small blind) folded on the Flop


PokerStars Hand #204119682675:  Hold'em No Limit ($0.05/$0.10 USD) - 2019/09/30 22:49:52 ET
Table 'Tabit' 6-max Seat #4 is the button
Seat 2: DaGoodz33 ($7.68 in chips) 
Seat 4: PlayTheBlues4U ($13.10 in chips) 
Seat 6: davetass ($13.47 in chips) 
davetass: posts small blind $0.05
DaGoodz33: posts big blind $0.10
*** HOLE CARDS ***
Dealt to PlayTheBlues4U [Qs 3c]
PlayTheBlues4U: folds 
davetass: calls $0.05
PlayTheBlues4U leaves the table
DaGoodz33: checks 
*** FLOP *** [5d 3d Ks]
davetass: checks 
DaGoodz33: bets $0.19
davetass: calls $0.19
*** TURN *** [5d 3d Ks] [7c]
davetass: checks 
DaGoodz33: checks 
*** RIVER *** [5d 3d Ks 7c] [9s]
davetass: bets $0.28
DaGoodz33: folds 
Uncalled bet ($0.28) returned to davetass
davetass collected $0.55 from pot
davetass: doesn't show hand 
*** SUMMARY ***
Total pot $0.58 | Rake $0.03 
Board [5d 3d Ks 7c 9s]
Seat 2: DaGoodz33 (big blind) folded on the River
Seat 4: PlayTheBlues4U (button) folded before Flop (didn't bet)
Seat 6: davetass (small blind) collected ($0.55)


PokerStars Hand #204119682600:  Hold'em No Limit ($0.05/$0.10 USD) - 2019/09/30 22:49:21 ET
Table 'Tabit' 6-max Seat #2 is the button
Seat 2: DaGoodz33 ($7.68 in chips) 
Seat 4: PlayTheBlues4U ($13.69 in chips) 
Seat 6: davetass ($12.94 in chips) 
PlayTheBlues4U: posts small blind $0.05
davetass: posts big blind $0.10
*** HOLE CARDS ***
Dealt to PlayTheBlues4U [Ac Kh]
DaGoodz33: folds 
PlayTheBlues4U: raises $0.20 to $0.30
davetass: calls $0.20
*** FLOP *** [5s 2d 8h]
PlayTheBlues4U: checks 
davetass: bets $0.29
PlayTheBlues4U: calls $0.29
*** TURN *** [5s 2d 8h] [7h]
PlayTheBlues4U: checks 
davetass: bets $0.56
PlayTheBlues4U: folds 
Uncalled bet ($0.56) returned to davetass
davetass collected $1.12 from pot
davetass: doesn't show hand 
*** SUMMARY ***
Total pot $1.18 | Rake $0.06 
Board [5s 2d 8h 7h]
Seat 2: DaGoodz33 (button) folded before Flop (didn't bet)
Seat 4: PlayTheBlues4U (small blind) folded on the Turn
Seat 6: davetass (big blind) collected ($1.12)


PokerStars Hand #204119682511:  Hold'em No Limit ($0.05/$0.10 USD) - 2019/09/30 22:48:46 ET
Table 'Tabit' 6-max Seat #6 is the button
Seat 2: DaGoodz33 ($7.78 in chips) 
Seat 4: PlayTheBlues4U ($13.60 in chips) 
Seat 5: KingBoy0519 ($7.44 in chips) 
Seat 6: davetass ($12.94 in chips) 
DaGoodz33: posts small blind $0.05
PlayTheBlues4U: posts big blind $0.10
*** HOLE CARDS ***
Dealt to PlayTheBlues4U [6s Td]
KingBoy0519: folds 
KingBoy0519 leaves the table
davetass: folds 
DaGoodz33: calls $0.05
PlayTheBlues4U: checks 
*** FLOP *** [2s As Ks]
DaGoodz33: checks 
PlayTheBlues4U: checks 
*** TURN *** [2s As Ks] [Qc]
DaGoodz33: checks 
PlayTheBlues4U: checks 
*** RIVER *** [2s As Ks Qc] [3h]
DaGoodz33: checks 
PlayTheBlues4U: checks 
*** SHOW DOWN ***
DaGoodz33: shows [Th 4h] (high card Ace)
PlayTheBlues4U: shows [6s Td] (high card Ace - King+Queen+Ten+Six kicker)
PlayTheBlues4U collected $0.19 from pot
*** SUMMARY ***
Total pot $0.20 | Rake $0.01 
Board [2s As Ks Qc 3h]
Seat 2: DaGoodz33 (small blind) showed [Th 4h] and lost with high card Ace
Seat 4: PlayTheBlues4U (big blind) showed [6s Td] and won ($0.19) with high card Ace
Seat 5: KingBoy0519 folded before Flop (didn't bet)
Seat 6: davetass (button) folded before Flop (didn't bet)


PokerStars Hand #204119682496:  Hold'em No Limit ($0.05/$0.10 USD) - 2019/09/30 22:48:39 ET
Table 'Tabit' 6-max Seat #5 is the button
Seat 2: DaGoodz33 ($7.73 in chips) 
Seat 4: PlayTheBlues4U ($13.60 in chips) 
Seat 5: KingBoy0519 ($7.44 in chips) 
Seat 6: davetass ($12.99 in chips) 
davetass: posts small blind $0.05
DaGoodz33: posts big blind $0.10
*** HOLE CARDS ***
Dealt to PlayTheBlues4U [3s 5s]
PlayTheBlues4U: folds 
KingBoy0519: folds 
davetass: folds 
Uncalled bet ($0.05) returned to DaGoodz33
DaGoodz33 collected $0.10 from pot
DaGoodz33: doesn't show hand 
*** SUMMARY ***
Total pot $0.10 | Rake $0 
Seat 2: DaGoodz33 (big blind) collected ($0.10)
Seat 4: PlayTheBlues4U folded before Flop (didn't bet)
Seat 5: KingBoy0519 (button) folded before Flop (didn't bet)
Seat 6: davetass (small blind) folded before Flop


PokerStars Hand #204119682375:  Hold'em No Limit ($0.05/$0.10 USD) - 2019/09/30 22:47:50 ET
Table 'Tabit' 6-max Seat #4 is the button
Seat 2: DaGoodz33 ($8.03 in chips) 
Seat 4: PlayTheBlues4U ($13.19 in chips) 
Seat 5: KingBoy0519 ($7.49 in chips) 
Seat 6: davetass ($13.09 in chips) 
KingBoy0519: posts small blind $0.05
davetass: posts big blind $0.10
*** HOLE CARDS ***
Dealt to PlayTheBlues4U [Th 9c]
slgu1201 leaves the table
DaGoodz33: calls $0.10
PlayTheBlues4U: raises $0.20 to $0.30
KingBoy0519: folds 
davetass: folds 
DaGoodz33: calls $0.20
*** FLOP *** [7h 5s 9d]
DaGoodz33: checks 
PlayTheBlues4U: bets $0.50
DaGoodz33: folds 
Uncalled bet ($0.50) returned to PlayTheBlues4U
PlayTheBlues4U collected $0.71 from pot
PlayTheBlues4U: doesn't show hand 
*** SUMMARY ***
Total pot $0.75 | Rake $0.04 
Board [7h 5s 9d]
Seat 2: DaGoodz33 folded on the Flop
Seat 4: PlayTheBlues4U (button) collected ($0.71)
Seat 5: KingBoy0519 (small blind) folded before Flop
Seat 6: davetass (big blind) folded before Flop


PokerStars Hand #204119682312:  Hold'em No Limit ($0.05/$0.10 USD) - 2019/09/30 22:47:24 ET
Table 'Tabit' 6-max Seat #2 is the button
Seat 1: slgu1201 ($12.28 in chips) 
Seat 2: DaGoodz33 ($8.03 in chips) 
Seat 4: PlayTheBlues4U ($13.24 in chips) 
Seat 5: KingBoy0519 ($7.17 in chips) 
Seat 6: davetass ($13.09 in chips) 
PlayTheBlues4U: posts small blind $0.05
KingBoy0519: posts big blind $0.10
*** HOLE CARDS ***
Dealt to PlayTheBlues4U [8s 5d]
davetass: folds 
slgu1201: calls $0.10
DaGoodz33: folds 
PlayTheBlues4U: folds 
KingBoy0519: raises $0.20 to $0.30
slgu1201: calls $0.20
*** FLOP *** [Ah Tc 7h]
KingBoy0519: bets $0.40
slgu1201: folds 
Uncalled bet ($0.40) returned to KingBoy0519
KingBoy0519 collected $0.62 from pot
KingBoy0519: doesn't show hand 
*** SUMMARY ***
Total pot $0.65 | Rake $0.03 
Board [Ah Tc 7h]
Seat 1: slgu1201 folded on the Flop
Seat 2: DaGoodz33 (button) folded before Flop (didn't bet)
Seat 4: PlayTheBlues4U (small blind) folded before Flop
Seat 5: KingBoy0519 (big blind) collected ($0.62)
Seat 6: davetass folded before Flop (didn't bet)


PokerStars Hand #204119682215:  Hold'em No Limit ($0.05/$0.10 USD) - 2019/09/30 22:46:49 ET
Table 'Tabit' 6-max Seat #1 is the button
Seat 1: slgu1201 ($11.51 in chips) 
Seat 2: DaGoodz33 ($8.08 in chips) 
Seat 4: PlayTheBlues4U ($14.04 in chips) 
Seat 5: KingBoy0519 ($7.17 in chips) 
Seat 6: davetass ($13.09 in chips) 
DaGoodz33: posts small blind $0.05
PlayTheBlues4U: posts big blind $0.10
*** HOLE CARDS ***
Dealt to PlayTheBlues4U [Ts Jc]
KingBoy0519: folds 
davetass: folds 
slgu1201: calls $0.10
DaGoodz33: folds 
PlayTheBlues4U: checks 
*** FLOP *** [5c 9d 2h]
PlayTheBlues4U: checks 
slgu1201: bets $0.10
PlayTheBlues4U: calls $0.10
*** TURN *** [5c 9d 2h] [Td]
PlayTheBlues4U: checks 
slgu1201: bets $0.20
PlayTheBlues4U: calls $0.20
*** RIVER *** [5c 9d 2h Td] [Kc]
PlayTheBlues4U: checks 
slgu1201: bets $0.40
PlayTheBlues4U: calls $0.40
*** SHOW DOWN ***
slgu1201: shows [9s Tc] (two pair, Tens and Nines)
PlayTheBlues4U: mucks hand 
slgu1201 collected $1.57 from pot
*** SUMMARY ***
Total pot $1.65 | Rake $0.08 
Board [5c 9d 2h Td Kc]
Seat 1: slgu1201 (button) showed [9s Tc] and won ($1.57) with two pair, Tens and Nines
Seat 2: DaGoodz33 (small blind) folded before Flop
Seat 4: PlayTheBlues4U (big blind) mucked [Ts Jc]
Seat 5: KingBoy0519 folded before Flop (didn't bet)
Seat 6: davetass folded before Flop (didn't bet)


PokerStars Hand #204119682086:  Hold'em No Limit ($0.05/$0.10 USD) - 2019/09/30 22:45:59 ET
Table 'Tabit' 6-max Seat #6 is the button
Seat 1: slgu1201 ($11.61 in chips) 
Seat 2: DaGoodz33 ($7.98 in chips) 
Seat 3: rkk7777 ($15.55 in chips) 
Seat 4: PlayTheBlues4U ($14.04 in chips) 
Seat 5: KingBoy0519 ($7.17 in chips) 
Seat 6: davetass ($13.09 in chips) 
slgu1201: posts small blind $0.05
DaGoodz33: posts big blind $0.10
*** HOLE CARDS ***
Dealt to PlayTheBlues4U [Js 6h]
rkk7777: folds 
PlayTheBlues4U: folds 
KingBoy0519: folds 
davetass: folds 
slgu1201: calls $0.05
rkk7777 leaves the table
DaGoodz33: raises $0.20 to $0.30
slgu1201: folds 
Uncalled bet ($0.20) returned to DaGoodz33
DaGoodz33 collected $0.20 from pot
DaGoodz33: doesn't show hand 
*** SUMMARY ***
Total pot $0.20 | Rake $0 
Seat 1: slgu1201 (small blind) folded before Flop
Seat 2: DaGoodz33 (big blind) collected ($0.20)
Seat 3: rkk7777 folded before Flop (didn't bet)
Seat 4: PlayTheBlues4U folded before Flop (didn't bet)
Seat 5: KingBoy0519 folded before Flop (didn't bet)
Seat 6: davetass (button) folded before Flop (didn't bet)


PokerStars Hand #204119681987:  Hold'em No Limit ($0.05/$0.10 USD) - 2019/09/30 22:45:22 ET
Table 'Tabit' 6-max Seat #5 is the button
Seat 1: slgu1201 ($11.71 in chips) 
Seat 2: DaGoodz33 ($7.98 in chips) 
Seat 3: rkk7777 ($15.55 in chips) 
Seat 4: PlayTheBlues4U ($14.04 in chips) 
Seat 5: KingBoy0519 ($7.03 in chips) 
Seat 6: davetass ($13.14 in chips) 
davetass: posts small blind $0.05
slgu1201: posts big blind $0.10
*** HOLE CARDS ***
Dealt to PlayTheBlues4U [4h 6h]
DaGoodz33: folds 
rkk7777: folds 
PlayTheBlues4U: folds 
KingBoy0519: calls $0.10
davetass: folds 
slgu1201: checks 
*** FLOP *** [Ac 6d 8d]
slgu1201: checks 
KingBoy0519: bets $0.20
slgu1201: folds 
Uncalled bet ($0.20) returned to KingBoy0519
KingBoy0519 collected $0.24 from pot
KingBoy0519: doesn't show hand 
*** SUMMARY ***
Total pot $0.25 | Rake $0.01 
Board [Ac 6d 8d]
Seat 1: slgu1201 (big blind) folded on the Flop
Seat 2: DaGoodz33 folded before Flop (didn't bet)
Seat 3: rkk7777 folded before Flop (didn't bet)
Seat 4: PlayTheBlues4U folded before Flop (didn't bet)
Seat 5: KingBoy0519 (button) collected ($0.24)
Seat 6: davetass (small blind) folded before Flop


PokerStars Hand #204119681895:  Hold'em No Limit ($0.05/$0.10 USD) - 2019/09/30 22:44:46 ET
Table 'Tabit' 6-max Seat #4 is the button
Seat 1: slgu1201 ($8.71 in chips) 
Seat 2: DaGoodz33 ($7.98 in chips) 
Seat 3: rkk7777 ($15.85 in chips) 
Seat 4: PlayTheBlues4U ($14.04 in chips) 
Seat 5: KingBoy0519 ($7.33 in chips) 
Seat 6: davetass ($15.84 in chips) 
KingBoy0519: posts small blind $0.05
davetass: posts big blind $0.10
*** HOLE CARDS ***
Dealt to PlayTheBlues4U [5s 8d]
slgu1201: raises $0.20 to $0.30
DaGoodz33: folds 
rkk7777: calls $0.30
PlayTheBlues4U: folds 
KingBoy0519: calls $0.25
davetass: raises $1.20 to $1.50
slgu1201: raises $1.20 to $2.70
rkk7777: folds 
KingBoy0519: folds 
davetass: calls $1.20
*** FLOP *** [7c 2s 6c]
davetass: checks 
slgu1201: bets $6.01 and is all-in
davetass: folds [Ad Kd]
Uncalled bet ($6.01) returned to slgu1201
slgu1201 collected $5.70 from pot
slgu1201: doesn't show hand 
*** SUMMARY ***
Total pot $6 | Rake $0.30 
Board [7c 2s 6c]
Seat 1: slgu1201 collected ($5.70)
Seat 2: DaGoodz33 folded before Flop (didn't bet)
Seat 3: rkk7777 folded before Flop
Seat 4: PlayTheBlues4U (button) folded before Flop (didn't bet)
Seat 5: KingBoy0519 (small blind) folded before Flop
Seat 6: davetass (big blind) folded on the Flop


PokerStars Hand #204119681736:  Hold'em No Limit ($0.05/$0.10 USD) - 2019/09/30 22:43:52 ET
Table 'Tabit' 6-max Seat #3 is the button
Seat 1: slgu1201 ($8.71 in chips) 
Seat 2: DaGoodz33 ($8.33 in chips) 
Seat 3: rkk7777 ($15.16 in chips) 
Seat 4: PlayTheBlues4U ($14.09 in chips) 
Seat 5: KingBoy0519 ($7.68 in chips) 
Seat 6: davetass ($15.84 in chips) 
PlayTheBlues4U: posts small blind $0.05
KingBoy0519: posts big blind $0.10
*** HOLE CARDS ***
Dealt to PlayTheBlues4U [4h Jc]
davetass: folds 
slgu1201: folds 
DaGoodz33: raises $0.25 to $0.35
rkk7777: calls $0.35
PlayTheBlues4U: folds 
KingBoy0519: calls $0.25
*** FLOP *** [8d 3h 8c]
KingBoy0519: checks 
DaGoodz33: checks 
rkk7777: checks 
*** TURN *** [8d 3h 8c] [7d]
KingBoy0519: checks 
DaGoodz33: checks 
rkk7777: checks 
*** RIVER *** [8d 3h 8c 7d] [9c]
KingBoy0519: checks 
DaGoodz33: checks 
rkk7777: bets $0.40
KingBoy0519: folds 
DaGoodz33: folds 
Uncalled bet ($0.40) returned to rkk7777
rkk7777 collected $1.04 from pot
*** SUMMARY ***
Total pot $1.10 | Rake $0.06 
Board [8d 3h 8c 7d 9c]
Seat 1: slgu1201 folded before Flop (didn't bet)
Seat 2: DaGoodz33 folded on the River
Seat 3: rkk7777 (button) collected ($1.04)
Seat 4: PlayTheBlues4U (small blind) folded before Flop
Seat 5: KingBoy0519 (big blind) folded on the River
Seat 6: davetass folded before Flop (didn't bet)


PokerStars Hand #204119681597:  Hold'em No Limit ($0.05/$0.10 USD) - 2019/09/30 22:43:04 ET
Table 'Tabit' 6-max Seat #2 is the button
Seat 1: slgu1201 ($8.71 in chips) 
Seat 2: DaGoodz33 ($8.33 in chips) 
Seat 3: rkk7777 ($15.26 in chips) 
Seat 4: PlayTheBlues4U ($13.73 in chips) 
Seat 5: KingBoy0519 ($7.98 in chips) 
Seat 6: davetass ($15.84 in chips) 
rkk7777: posts small blind $0.05
PlayTheBlues4U: posts big blind $0.10
*** HOLE CARDS ***
Dealt to PlayTheBlues4U [9h 8c]
davetass said, "nh"
KingBoy0519: calls $0.10
davetass: folds 
slgu1201: folds 
DaGoodz33: folds 
rkk7777: calls $0.05
PlayTheBlues4U: checks 
*** FLOP *** [As 8d Qc]
rkk7777: checks 
PlayTheBlues4U: checks 
rkk7777 said, "ty"
KingBoy0519: checks 
*** TURN *** [As 8d Qc] [9s]
rkk7777: checks 
PlayTheBlues4U: bets $0.20
KingBoy0519: calls $0.20
rkk7777: folds 
*** RIVER *** [As 8d Qc 9s] [2s]
PlayTheBlues4U: bets $0.40
KingBoy0519: folds 
Uncalled bet ($0.40) returned to PlayTheBlues4U
PlayTheBlues4U collected $0.66 from pot
PlayTheBlues4U: doesn't show hand 
*** SUMMARY ***
Total pot $0.70 | Rake $0.04 
Board [As 8d Qc 9s 2s]
Seat 1: slgu1201 folded before Flop (didn't bet)
Seat 2: DaGoodz33 (button) folded before Flop (didn't bet)
Seat 3: rkk7777 (small blind) folded on the Turn
Seat 4: PlayTheBlues4U (big blind) collected ($0.66)
Seat 5: KingBoy0519 folded on the River
Seat 6: davetass folded before Flop (didn't bet)


PokerStars Hand #204119681451:  Hold'em No Limit ($0.05/$0.10 USD) - 2019/09/30 22:42:12 ET
Table 'Tabit' 6-max Seat #1 is the button
Seat 1: slgu1201 ($9.01 in chips) 
Seat 2: DaGoodz33 ($8.38 in chips) 
Seat 3: rkk7777 ($14.12 in chips) 
Seat 4: PlayTheBlues4U ($13.73 in chips) 
Seat 5: KingBoy0519 ($7.98 in chips) 
Seat 6: davetass ($16.74 in chips) 
DaGoodz33: posts small blind $0.05
rkk7777: posts big blind $0.10
*** HOLE CARDS ***
Dealt to PlayTheBlues4U [8d 9d]
PlayTheBlues4U: folds 
KingBoy0519: folds 
davetass: raises $0.20 to $0.30
slgu1201: calls $0.30
DaGoodz33: folds 
rkk7777: calls $0.20
*** FLOP *** [9c Ks Jh]
rkk7777: checks 
davetass: checks 
slgu1201: checks 
*** TURN *** [9c Ks Jh] [5h]
rkk7777: bets $0.40
davetass: calls $0.40
slgu1201: folds 
*** RIVER *** [9c Ks Jh 5h] [3c]
rkk7777: bets $0.20
davetass: calls $0.20
*** SHOW DOWN ***
rkk7777: shows [Ts Kc] (a pair of Kings)
davetass: mucks hand 
rkk7777 collected $2.04 from pot
*** SUMMARY ***
Total pot $2.15 | Rake $0.11 
Board [9c Ks Jh 5h 3c]
Seat 1: slgu1201 (button) folded on the Turn
Seat 2: DaGoodz33 (small blind) folded before Flop
Seat 3: rkk7777 (big blind) showed [Ts Kc] and won ($2.04) with a pair of Kings
Seat 4: PlayTheBlues4U folded before Flop (didn't bet)
Seat 5: KingBoy0519 folded before Flop (didn't bet)
Seat 6: davetass mucked [Qc Ac]


PokerStars Hand #204119681333:  Hold'em No Limit ($0.05/$0.10 USD) - 2019/09/30 22:41:30 ET
Table 'Tabit' 6-max Seat #6 is the button
Seat 1: slgu1201 ($8.73 in chips) 
Seat 2: DaGoodz33 ($8.48 in chips) 
Seat 3: rkk7777 ($14.22 in chips) 
Seat 4: PlayTheBlues4U ($13.73 in chips) 
Seat 5: KingBoy0519 ($7.98 in chips) 
Seat 6: davetass ($16.84 in chips) 
slgu1201: posts small blind $0.05
DaGoodz33: posts big blind $0.10
*** HOLE CARDS ***
Dealt to PlayTheBlues4U [7d 5c]
rkk7777: calls $0.10
PlayTheBlues4U: folds 
KingBoy0519: folds 
davetass: calls $0.10
slgu1201: calls $0.05
DaGoodz33: checks 
*** FLOP *** [Th Jd Kh]
slgu1201: bets $0.20
DaGoodz33: folds 
rkk7777: folds 
davetass: folds 
Uncalled bet ($0.20) returned to slgu1201
slgu1201 collected $0.38 from pot
slgu1201: doesn't show hand 
*** SUMMARY ***
Total pot $0.40 | Rake $0.02 
Board [Th Jd Kh]
Seat 1: slgu1201 (small blind) collected ($0.38)
Seat 2: DaGoodz33 (big blind) folded on the Flop
Seat 3: rkk7777 folded on the Flop
Seat 4: PlayTheBlues4U folded before Flop (didn't bet)
Seat 5: KingBoy0519 folded before Flop (didn't bet)
Seat 6: davetass (button) folded on the Flop


PokerStars Hand #204119681243:  Hold'em No Limit ($0.05/$0.10 USD) - 2019/09/30 22:40:56 ET
Table 'Tabit' 6-max Seat #5 is the button
Seat 1: slgu1201 ($8.83 in chips) 
Seat 2: DaGoodz33 ($8.48 in chips) 
Seat 3: rkk7777 ($14.07 in chips) 
Seat 4: PlayTheBlues4U ($13.73 in chips) 
Seat 5: KingBoy0519 ($7.98 in chips) 
Seat 6: davetass ($16.89 in chips) 
davetass: posts small blind $0.05
slgu1201: posts big blind $0.10
*** HOLE CARDS ***
Dealt to PlayTheBlues4U [Ac 2h]
DaGoodz33: folds 
rkk7777: raises $0.20 to $0.30
PlayTheBlues4U: folds 
KingBoy0519: folds 
davetass: folds 
slgu1201: folds 
Uncalled bet ($0.20) returned to rkk7777
rkk7777 collected $0.25 from pot
*** SUMMARY ***
Total pot $0.25 | Rake $0 
Seat 1: slgu1201 (big blind) folded before Flop
Seat 2: DaGoodz33 folded before Flop (didn't bet)
Seat 3: rkk7777 collected ($0.25)
Seat 4: PlayTheBlues4U folded before Flop (didn't bet)
Seat 5: KingBoy0519 (button) folded before Flop (didn't bet)
Seat 6: davetass (small blind) folded before Flop


PokerStars Hand #204119681191:  Hold'em No Limit ($0.05/$0.10 USD) - 2019/09/30 22:40:37 ET
Table 'Tabit' 6-max Seat #4 is the button
Seat 1: slgu1201 ($8.83 in chips) 
Seat 2: DaGoodz33 ($8.48 in chips) 
Seat 3: rkk7777 ($14.07 in chips) 
Seat 4: PlayTheBlues4U ($13.73 in chips) 
Seat 5: KingBoy0519 ($7.88 in chips) 
Seat 6: davetass ($16.99 in chips) 
KingBoy0519: posts small blind $0.05
davetass: posts big blind $0.10
*** HOLE CARDS ***
Dealt to PlayTheBlues4U [8c 6d]
PlayTheBlues4U said, "last hand"
slgu1201: folds 
DaGoodz33: folds 
rkk7777: folds 
PlayTheBlues4U: folds 
KingBoy0519: raises $0.20 to $0.30
davetass: folds 
Uncalled bet ($0.20) returned to KingBoy0519
KingBoy0519 collected $0.20 from pot
KingBoy0519: doesn't show hand 
*** SUMMARY ***
Total pot $0.20 | Rake $0 
Seat 1: slgu1201 folded before Flop (didn't bet)
Seat 2: DaGoodz33 folded before Flop (didn't bet)
Seat 3: rkk7777 folded before Flop (didn't bet)
Seat 4: PlayTheBlues4U (button) folded before Flop (didn't bet)
Seat 5: KingBoy0519 (small blind) collected ($0.20)
Seat 6: davetass (big blind) folded before Flop


PokerStars Hand #204119681114:  Hold'em No Limit ($0.05/$0.10 USD) - 2019/09/30 22:40:09 ET
Table 'Tabit' 6-max Seat #3 is the button
Seat 1: slgu1201 ($8.83 in chips) 
Seat 2: DaGoodz33 ($8.48 in chips) 
Seat 3: rkk7777 ($14.27 in chips) 
Seat 4: PlayTheBlues4U ($13.78 in chips) 
Seat 5: KingBoy0519 ($7.65 in chips) 
Seat 6: davetass ($16.99 in chips) 
PlayTheBlues4U: posts small blind $0.05
KingBoy0519: posts big blind $0.10
*** HOLE CARDS ***
Dealt to PlayTheBlues4U [6h Kd]
davetass: folds 
slgu1201: folds 
DaGoodz33: folds 
rkk7777: calls $0.10
PlayTheBlues4U: folds 
KingBoy0519: checks 
*** FLOP *** [2s 4c Td]
KingBoy0519: checks 
rkk7777: bets $0.10
KingBoy0519: calls $0.10
*** TURN *** [2s 4c Td] [Ts]
KingBoy0519: checks 
rkk7777: checks 
*** RIVER *** [2s 4c Td Ts] [4s]
KingBoy0519: bets $0.40
PlayTheBlues4U said, "I folded the A5ss"
rkk7777: folds 
Uncalled bet ($0.40) returned to KingBoy0519
KingBoy0519 collected $0.43 from pot
KingBoy0519: doesn't show hand 
*** SUMMARY ***
Total pot $0.45 | Rake $0.02 
Board [2s 4c Td Ts 4s]
Seat 1: slgu1201 folded before Flop (didn't bet)
Seat 2: DaGoodz33 folded before Flop (didn't bet)
Seat 3: rkk7777 (button) folded on the River
Seat 4: PlayTheBlues4U (small blind) folded before Flop
Seat 5: KingBoy0519 (big blind) collected ($0.43)
Seat 6: davetass folded before Flop (didn't bet)


PokerStars Hand #204119681004:  Hold'em No Limit ($0.05/$0.10 USD) - 2019/09/30 22:39:30 ET
Table 'Tabit' 6-max Seat #2 is the button
Seat 1: slgu1201 ($9.13 in chips) 
Seat 2: DaGoodz33 ($11.91 in chips) 
Seat 3: rkk7777 ($10.80 in chips) 
Seat 4: PlayTheBlues4U ($13.88 in chips) 
Seat 5: KingBoy0519 ($7.65 in chips) 
Seat 6: davetass ($16.99 in chips) 
rkk7777: posts small blind $0.05
PlayTheBlues4U: posts big blind $0.10
*** HOLE CARDS ***
Dealt to PlayTheBlues4U [5s As]
KingBoy0519: folds 
davetass: folds 
slgu1201: raises $0.20 to $0.30
DaGoodz33: raises $0.75 to $1.05
rkk7777: calls $1
PlayTheBlues4U: folds 
slgu1201: folds 
*** FLOP *** [7s 8s 4c]
rkk7777: checks 
DaGoodz33: bets $2.38
rkk7777: raises $2.98 to $5.36
DaGoodz33: folds 
Uncalled bet ($2.98) returned to rkk7777
rkk7777 collected $6.90 from pot
*** SUMMARY ***
Total pot $7.26 | Rake $0.36 
Board [7s 8s 4c]
Seat 1: slgu1201 folded before Flop
Seat 2: DaGoodz33 (button) folded on the Flop
Seat 3: rkk7777 (small blind) collected ($6.90)
Seat 4: PlayTheBlues4U (big blind) folded before Flop
Seat 5: KingBoy0519 folded before Flop (didn't bet)
Seat 6: davetass folded before Flop (didn't bet)


PokerStars Hand #204119680901:  Hold'em No Limit ($0.05/$0.10 USD) - 2019/09/30 22:38:56 ET
Table 'Tabit' 6-max Seat #1 is the button
Seat 1: slgu1201 ($8 in chips) 
Seat 2: DaGoodz33 ($11.96 in chips) 
Seat 3: rkk7777 ($12 in chips) 
Seat 4: PlayTheBlues4U ($13.88 in chips) 
Seat 5: KingBoy0519 ($7.65 in chips) 
Seat 6: davetass ($16.99 in chips) 
DaGoodz33: posts small blind $0.05
rkk7777: posts big blind $0.10
*** HOLE CARDS ***
Dealt to PlayTheBlues4U [Td Jh]
PlayTheBlues4U: folds 
KingBoy0519: folds 
davetass: folds 
slgu1201: raises $0.20 to $0.30
DaGoodz33: folds 
rkk7777: calls $0.20
*** FLOP *** [9h 2s 8d]
rkk7777: checks 
slgu1201: bets $0.30
rkk7777: calls $0.30
*** TURN *** [9h 2s 8d] [3c]
rkk7777: checks 
slgu1201: bets $0.60
rkk7777: calls $0.60
*** RIVER *** [9h 2s 8d 3c] [6h]
rkk7777: checks 
slgu1201: bets $1.20
rkk7777: folds 
Uncalled bet ($1.20) returned to slgu1201
slgu1201 collected $2.33 from pot
slgu1201: doesn't show hand 
*** SUMMARY ***
Total pot $2.45 | Rake $0.12 
Board [9h 2s 8d 3c 6h]
Seat 1: slgu1201 (button) collected ($2.33)
Seat 2: DaGoodz33 (small blind) folded before Flop
Seat 3: rkk7777 (big blind) folded on the River
Seat 4: PlayTheBlues4U folded before Flop (didn't bet)
Seat 5: KingBoy0519 folded before Flop (didn't bet)
Seat 6: davetass folded before Flop (didn't bet)


PokerStars Hand #204114099978:  Hold'em No Limit ($0.05/$0.10 USD) - 2019/09/30 22:38:12 ET
Table 'Tabit' 6-max Seat #6 is the button
Seat 1: slgu1201 ($8.10 in chips) 
Seat 2: DaGoodz33 ($10.78 in chips) 
Seat 3: rkk7777 ($13.20 in chips) 
Seat 4: PlayTheBlues4U ($13.88 in chips) 
Seat 5: KingBoy0519 ($7.65 in chips) 
Seat 6: davetass ($16.99 in chips) 
slgu1201: posts small blind $0.05
DaGoodz33: posts big blind $0.10
*** HOLE CARDS ***
Dealt to PlayTheBlues4U [Ad 6s]
rkk7777: calls $0.10
PlayTheBlues4U: folds 
KingBoy0519: folds 
davetass: folds 
slgu1201: calls $0.05
DaGoodz33: checks 
*** FLOP *** [Tc 7d Qh]
slgu1201: checks 
DaGoodz33: bets $0.28
rkk7777: calls $0.28
slgu1201: folds 
*** TURN *** [Tc 7d Qh] [Qd]
DaGoodz33: bets $0.82
rkk7777: calls $0.82
*** RIVER *** [Tc 7d Qh Qd] [7c]
DaGoodz33: checks 
rkk7777: checks 
*** SHOW DOWN ***
DaGoodz33: shows [Qc Jh] (a full house, Queens full of Sevens)
rkk7777: mucks hand 
DaGoodz33 collected $2.38 from pot
*** SUMMARY ***
Total pot $2.50 | Rake $0.12 
Board [Tc 7d Qh Qd 7c]
Seat 1: slgu1201 (small blind) folded on the Flop
Seat 2: DaGoodz33 (big blind) showed [Qc Jh] and won ($2.38) with a full house, Queens full of Sevens
Seat 3: rkk7777 mucked [9d Td]
Seat 4: PlayTheBlues4U folded before Flop (didn't bet)
Seat 5: KingBoy0519 folded before Flop (didn't bet)
Seat 6: davetass (button) folded before Flop (didn't bet)


PokerStars Hand #204114099898:  Hold'em No Limit ($0.05/$0.10 USD) - 2019/09/30 22:37:47 ET
Table 'Tabit' 6-max Seat #5 is the button
Seat 1: slgu1201 ($8.20 in chips) 
Seat 2: DaGoodz33 ($10.78 in chips) 
Seat 3: rkk7777 ($13.20 in chips) 
Seat 4: PlayTheBlues4U ($13.88 in chips) 
Seat 5: KingBoy0519 ($8.09 in chips) 
Seat 6: davetass ($16.50 in chips) 
davetass: posts small blind $0.05
slgu1201: posts big blind $0.10
*** HOLE CARDS ***
Dealt to PlayTheBlues4U [2c 4c]
DaGoodz33: folds 
rkk7777: folds 
PlayTheBlues4U: folds 
KingBoy0519: raises $0.10 to $0.20
davetass: calls $0.15
slgu1201: folds 
*** FLOP *** [6c 4d 9s]
davetass: bets $0.24
KingBoy0519: calls $0.24
*** TURN *** [6c 4d 9s] [6d]
davetass: bets $0.47
KingBoy0519: folds 
Uncalled bet ($0.47) returned to davetass
davetass collected $0.93 from pot
davetass: doesn't show hand 
*** SUMMARY ***
Total pot $0.98 | Rake $0.05 
Board [6c 4d 9s 6d]
Seat 1: slgu1201 (big blind) folded before Flop
Seat 2: DaGoodz33 folded before Flop (didn't bet)
Seat 3: rkk7777 folded before Flop (didn't bet)
Seat 4: PlayTheBlues4U folded before Flop (didn't bet)
Seat 5: KingBoy0519 (button) folded on the Turn
Seat 6: davetass (small blind) collected ($0.93)


PokerStars Hand #204114099814:  Hold'em No Limit ($0.05/$0.10 USD) - 2019/09/30 22:37:17 ET
Table 'Tabit' 6-max Seat #4 is the button
Seat 1: slgu1201 ($8.90 in chips) 
Seat 2: DaGoodz33 ($10.78 in chips) 
Seat 3: rkk7777 ($12.43 in chips) 
Seat 4: PlayTheBlues4U ($13.88 in chips) 
Seat 5: KingBoy0519 ($8.14 in chips) 
Seat 6: davetass ($16.60 in chips) 
KingBoy0519: posts small blind $0.05
davetass: posts big blind $0.10
*** HOLE CARDS ***
Dealt to PlayTheBlues4U [4s 8c]
slgu1201: raises $0.20 to $0.30
DaGoodz33: folds 
rkk7777: calls $0.30
PlayTheBlues4U: folds 
KingBoy0519: folds 
davetass: folds 
*** FLOP *** [6d Jd Jh]
slgu1201: checks 
rkk7777: checks 
*** TURN *** [6d Jd Jh] [2d]
slgu1201: bets $0.40
rkk7777: calls $0.40
*** RIVER *** [6d Jd Jh 2d] [9d]
slgu1201: checks 
rkk7777: bets $1.80
slgu1201: folds 
Uncalled bet ($1.80) returned to rkk7777
rkk7777 collected $1.47 from pot
*** SUMMARY ***
Total pot $1.55 | Rake $0.08 
Board [6d Jd Jh 2d 9d]
Seat 1: slgu1201 folded on the River
Seat 2: DaGoodz33 folded before Flop (didn't bet)
Seat 3: rkk7777 collected ($1.47)
Seat 4: PlayTheBlues4U (button) folded before Flop (didn't bet)
Seat 5: KingBoy0519 (small blind) folded before Flop
Seat 6: davetass (big blind) folded before Flop


PokerStars Hand #204114099681:  Hold'em No Limit ($0.05/$0.10 USD) - 2019/09/30 22:36:31 ET
Table 'Tabit' 6-max Seat #3 is the button
Seat 1: slgu1201 ($9 in chips) 
Seat 2: DaGoodz33 ($10.40 in chips) 
Seat 3: rkk7777 ($12.53 in chips) 
Seat 4: PlayTheBlues4U ($13.98 in chips) 
Seat 5: KingBoy0519 ($8.24 in chips) 
Seat 6: davetass ($16.60 in chips) 
PlayTheBlues4U: posts small blind $0.05
KingBoy0519: posts big blind $0.10
*** HOLE CARDS ***
Dealt to PlayTheBlues4U [4c 4s]
davetass: folds 
slgu1201: calls $0.10
DaGoodz33: calls $0.10
rkk7777: calls $0.10
PlayTheBlues4U: calls $0.05
KingBoy0519: checks 
*** FLOP *** [3h 2h 2d]
PlayTheBlues4U: checks 
KingBoy0519: checks 
slgu1201: checks 
DaGoodz33: checks 
rkk7777: checks 
*** TURN *** [3h 2h 2d] [Kd]
PlayTheBlues4U: checks 
KingBoy0519: checks 
slgu1201: checks 
DaGoodz33: bets $0.48
rkk7777: folds 
PlayTheBlues4U: folds 
KingBoy0519: folds 
slgu1201: folds 
Uncalled bet ($0.48) returned to DaGoodz33
DaGoodz33 collected $0.48 from pot
DaGoodz33: doesn't show hand 
*** SUMMARY ***
Total pot $0.50 | Rake $0.02 
Board [3h 2h 2d Kd]
Seat 1: slgu1201 folded on the Turn
Seat 2: DaGoodz33 collected ($0.48)
Seat 3: rkk7777 (button) folded on the Turn
Seat 4: PlayTheBlues4U (small blind) folded on the Turn
Seat 5: KingBoy0519 (big blind) folded on the Turn
Seat 6: davetass folded before Flop (didn't bet)


PokerStars Hand #204114099581:  Hold'em No Limit ($0.05/$0.10 USD) - 2019/09/30 22:35:55 ET
Table 'Tabit' 6-max Seat #2 is the button
Seat 1: slgu1201 ($9 in chips) 
Seat 2: DaGoodz33 ($10.40 in chips) 
Seat 3: rkk7777 ($11.99 in chips) 
Seat 4: PlayTheBlues4U ($14.58 in chips) 
Seat 5: KingBoy0519 ($8.24 in chips) 
Seat 6: davetass ($16.60 in chips) 
rkk7777: posts small blind $0.05
PlayTheBlues4U: posts big blind $0.10
*** HOLE CARDS ***
Dealt to PlayTheBlues4U [6d Ac]
KingBoy0519: folds 
davetass: folds 
slgu1201: folds 
DaGoodz33: folds 
rkk7777: calls $0.05
PlayTheBlues4U: raises $0.20 to $0.30
rkk7777: calls $0.20
*** FLOP *** [Kd Kc 4c]
rkk7777: checks 
PlayTheBlues4U: checks 
*** TURN *** [Kd Kc 4c] [Qc]
rkk7777: checks 
PlayTheBlues4U: bets $0.30
rkk7777: calls $0.30
*** RIVER *** [Kd Kc 4c Qc] [Jd]
rkk7777: checks 
PlayTheBlues4U: checks 
*** SHOW DOWN ***
rkk7777: shows [Qs 5d] (two pair, Kings and Queens)
PlayTheBlues4U: mucks hand 
rkk7777 collected $1.14 from pot
*** SUMMARY ***
Total pot $1.20 | Rake $0.06 
Board [Kd Kc 4c Qc Jd]
Seat 1: slgu1201 folded before Flop (didn't bet)
Seat 2: DaGoodz33 (button) folded before Flop (didn't bet)
Seat 3: rkk7777 (small blind) showed [Qs 5d] and won ($1.14) with two pair, Kings and Queens
Seat 4: PlayTheBlues4U (big blind) mucked [6d Ac]
Seat 5: KingBoy0519 folded before Flop (didn't bet)
Seat 6: davetass folded before Flop (didn't bet)


PokerStars Hand #204114099501:  Hold'em No Limit ($0.05/$0.10 USD) - 2019/09/30 22:35:27 ET
Table 'Tabit' 6-max Seat #1 is the button
Seat 1: slgu1201 ($8.59 in chips) 
Seat 2: DaGoodz33 ($10.45 in chips) 
Seat 3: rkk7777 ($12.09 in chips) 
Seat 4: PlayTheBlues4U ($14.58 in chips) 
Seat 5: KingBoy0519 ($8.54 in chips) 
Seat 6: davetass ($16.60 in chips) 
DaGoodz33: posts small blind $0.05
rkk7777: posts big blind $0.10
*** HOLE CARDS ***
Dealt to PlayTheBlues4U [7s 4h]
PlayTheBlues4U: folds 
KingBoy0519: calls $0.10
davetass: folds 
slgu1201: raises $0.20 to $0.30
DaGoodz33: folds 
rkk7777: folds 
KingBoy0519: calls $0.20
*** FLOP *** [8d Ah 8h]
KingBoy0519: checks 
slgu1201: bets $0.40
KingBoy0519: folds 
Uncalled bet ($0.40) returned to slgu1201
slgu1201 collected $0.71 from pot
slgu1201: doesn't show hand 
*** SUMMARY ***
Total pot $0.75 | Rake $0.04 
Board [8d Ah 8h]
Seat 1: slgu1201 (button) collected ($0.71)
Seat 2: DaGoodz33 (small blind) folded before Flop
Seat 3: rkk7777 (big blind) folded before Flop
Seat 4: PlayTheBlues4U folded before Flop (didn't bet)
Seat 5: KingBoy0519 folded on the Flop
Seat 6: davetass folded before Flop (didn't bet)


PokerStars Hand #204114099406:  Hold'em No Limit ($0.05/$0.10 USD) - 2019/09/30 22:34:54 ET
Table 'Tabit' 6-max Seat #6 is the button
Seat 1: slgu1201 ($8.64 in chips) 
Seat 2: DaGoodz33 ($10 in chips) 
Seat 3: rkk7777 ($12.29 in chips) 
Seat 4: PlayTheBlues4U ($14.58 in chips) 
Seat 5: KingBoy0519 ($8.54 in chips) 
Seat 6: davetass ($16.80 in chips) 
slgu1201: posts small blind $0.05
DaGoodz33: posts big blind $0.10
*** HOLE CARDS ***
Dealt to PlayTheBlues4U [Ts 7s]
rkk7777: raises $0.10 to $0.20
PlayTheBlues4U: folds 
KingBoy0519: folds 
davetass: calls $0.20
slgu1201: folds 
DaGoodz33: raises $1.80 to $2
rkk7777: folds 
davetass: folds 
Uncalled bet ($1.80) returned to DaGoodz33
DaGoodz33 collected $0.65 from pot
DaGoodz33: doesn't show hand 
*** SUMMARY ***
Total pot $0.65 | Rake $0 
Seat 1: slgu1201 (small blind) folded before Flop
Seat 2: DaGoodz33 (big blind) collected ($0.65)
Seat 3: rkk7777 folded before Flop
Seat 4: PlayTheBlues4U folded before Flop (didn't bet)
Seat 5: KingBoy0519 folded before Flop (didn't bet)
Seat 6: davetass (button) folded before Flop


PokerStars Hand #204114099318:  Hold'em No Limit ($0.05/$0.10 USD) - 2019/09/30 22:34:24 ET
Table 'Tabit' 6-max Seat #5 is the button
Seat 1: slgu1201 ($8.41 in chips) 
Seat 3: rkk7777 ($12.29 in chips) 
Seat 4: PlayTheBlues4U ($14.58 in chips) 
Seat 5: KingBoy0519 ($8.74 in chips) 
Seat 6: davetass ($16.85 in chips) 
davetass: posts small blind $0.05
slgu1201: posts big blind $0.10
*** HOLE CARDS ***
Dealt to PlayTheBlues4U [6d 3h]
rkk7777: folds 
DaGoodz33 joins the table at seat #2 
PlayTheBlues4U: folds 
KingBoy0519: calls $0.10
davetass: folds 
slgu1201: checks 
*** FLOP *** [9c 4d 7d]
slgu1201: bets $0.10
KingBoy0519: calls $0.10
*** TURN *** [9c 4d 7d] [6c]
slgu1201: checks 
KingBoy0519: checks 
*** RIVER *** [9c 4d 7d 6c] [Qs]
slgu1201: checks 
KingBoy0519: checks 
*** SHOW DOWN ***
slgu1201: shows [Th 9d] (a pair of Nines)
KingBoy0519: mucks hand 
slgu1201 collected $0.43 from pot
*** SUMMARY ***
Total pot $0.45 | Rake $0.02 
Board [9c 4d 7d 6c Qs]
Seat 1: slgu1201 (big blind) showed [Th 9d] and won ($0.43) with a pair of Nines
Seat 3: rkk7777 folded before Flop (didn't bet)
Seat 4: PlayTheBlues4U folded before Flop (didn't bet)
Seat 5: KingBoy0519 (button) mucked [Tc Jd]
Seat 6: davetass (small blind) folded before Flop


PokerStars Hand #204114099264:  Hold'em No Limit ($0.05/$0.10 USD) - 2019/09/30 22:34:05 ET
Table 'Tabit' 6-max Seat #4 is the button
Seat 1: slgu1201 ($8.05 in chips) 
Seat 3: rkk7777 ($12.29 in chips) 
Seat 4: PlayTheBlues4U ($14.58 in chips) 
Seat 5: KingBoy0519 ($9.04 in chips) 
Seat 6: davetass ($16.95 in chips) 
KingBoy0519: posts small blind $0.05
davetass: posts big blind $0.10
*** HOLE CARDS ***
Dealt to PlayTheBlues4U [3c Th]
slgu1201: raises $0.20 to $0.30
rkk7777: folds 
PlayTheBlues4U: folds 
KingBoy0519: calls $0.25
davetass: folds 
*** FLOP *** [8c 4c 5d]
KingBoy0519: checks 
slgu1201: bets $0.70
KingBoy0519: folds 
Uncalled bet ($0.70) returned to slgu1201
slgu1201 collected $0.66 from pot
slgu1201: doesn't show hand 
*** SUMMARY ***
Total pot $0.70 | Rake $0.04 
Board [8c 4c 5d]
Seat 1: slgu1201 collected ($0.66)
Seat 3: rkk7777 folded before Flop (didn't bet)
Seat 4: PlayTheBlues4U (button) folded before Flop (didn't bet)
Seat 5: KingBoy0519 (small blind) folded on the Flop
Seat 6: davetass (big blind) folded before Flop


PokerStars Hand #204114099148:  Hold'em No Limit ($0.05/$0.10 USD) - 2019/09/30 22:33:25 ET
Table 'Tabit' 6-max Seat #3 is the button
Seat 1: slgu1201 ($8.05 in chips) 
Seat 3: rkk7777 ($13.39 in chips) 
Seat 4: PlayTheBlues4U ($14.63 in chips) 
Seat 5: KingBoy0519 ($8 in chips) 
Seat 6: davetass ($16.95 in chips) 
PlayTheBlues4U: posts small blind $0.05
KingBoy0519: posts big blind $0.10
*** HOLE CARDS ***
Dealt to PlayTheBlues4U [Ts 6d]
davetass: folds 
slgu1201: folds 
rkk7777: raises $0.20 to $0.30
PlayTheBlues4U: folds 
KingBoy0519: calls $0.20
*** FLOP *** [Ac 4s 3h]
KingBoy0519: checks 
rkk7777: bets $0.10
KingBoy0519: calls $0.10
*** TURN *** [Ac 4s 3h] [6c]
KingBoy0519: checks 
rkk7777: bets $0.30
KingBoy0519: raises $0.40 to $0.70
rkk7777: calls $0.40
*** RIVER *** [Ac 4s 3h 6c] [8c]
KingBoy0519: checks 
rkk7777: checks 
*** SHOW DOWN ***
KingBoy0519: shows [4d 4c] (three of a kind, Fours)
rkk7777: mucks hand 
KingBoy0519 collected $2.14 from pot
*** SUMMARY ***
Total pot $2.25 | Rake $0.11 
Board [Ac 4s 3h 6c 8c]
Seat 1: slgu1201 folded before Flop (didn't bet)
Seat 3: rkk7777 (button) mucked [Ah Kd]
Seat 4: PlayTheBlues4U (small blind) folded before Flop
Seat 5: KingBoy0519 (big blind) showed [4d 4c] and won ($2.14) with three of a kind, Fours
Seat 6: davetass folded before Flop (didn't bet)


PokerStars Hand #204114098958:  Hold'em No Limit ($0.05/$0.10 USD) - 2019/09/30 22:32:22 ET
Table 'Tabit' 6-max Seat #2 is the button
Seat 1: slgu1201 ($8.85 in chips) 
Seat 2: jerry71345 ($7.18 in chips) 
Seat 3: rkk7777 ($13.69 in chips) 
Seat 4: PlayTheBlues4U ($14.73 in chips) 
Seat 5: KingBoy0519 ($6.90 in chips) 
Seat 6: davetass ($16.95 in chips) 
rkk7777: posts small blind $0.05
PlayTheBlues4U: posts big blind $0.10
*** HOLE CARDS ***
Dealt to PlayTheBlues4U [4c 7c]
KingBoy0519: calls $0.10
davetass: folds 
slgu1201: calls $0.10
jerry71345: folds 
rkk7777: calls $0.05
PlayTheBlues4U: checks 
*** FLOP *** [3s 8h Ac]
rkk7777: checks 
PlayTheBlues4U: checks 
KingBoy0519: checks 
jerry71345 leaves the table
slgu1201: bets $0.20
rkk7777: calls $0.20
PlayTheBlues4U: folds 
KingBoy0519: calls $0.20
*** TURN *** [3s 8h Ac] [Qc]
rkk7777: checks 
KingBoy0519: checks 
slgu1201: bets $0.50
rkk7777: folds 
KingBoy0519: raises $1.10 to $1.60
slgu1201: folds 
Uncalled bet ($1.10) returned to KingBoy0519
KingBoy0519 collected $1.90 from pot
KingBoy0519: doesn't show hand 
*** SUMMARY ***
Total pot $2 | Rake $0.10 
Board [3s 8h Ac Qc]
Seat 1: slgu1201 folded on the Turn
Seat 2: jerry71345 (button) folded before Flop (didn't bet)
Seat 3: rkk7777 (small blind) folded on the Turn
Seat 4: PlayTheBlues4U (big blind) folded on the Flop
Seat 5: KingBoy0519 collected ($1.90)
Seat 6: davetass folded before Flop (didn't bet)


PokerStars Hand #204114098822:  Hold'em No Limit ($0.05/$0.10 USD) - 2019/09/30 22:31:34 ET
Table 'Tabit' 6-max Seat #1 is the button
Seat 1: slgu1201 ($7.75 in chips) 
Seat 2: jerry71345 ($7.48 in chips) 
Seat 3: rkk7777 ($13.79 in chips) 
Seat 4: PlayTheBlues4U ($15.53 in chips) 
Seat 5: KingBoy0519 ($6.90 in chips) 
Seat 6: davetass ($16.95 in chips) 
jerry71345: posts small blind $0.05
rkk7777: posts big blind $0.10
*** HOLE CARDS ***
Dealt to PlayTheBlues4U [Jd As]
PlayTheBlues4U: raises $0.20 to $0.30
KingBoy0519: folds 
davetass: folds 
slgu1201: calls $0.30
jerry71345: calls $0.25
rkk7777: folds 
*** FLOP *** [3s 6h 5c]
jerry71345: checks 
PlayTheBlues4U: bets $0.50
slgu1201: calls $0.50
jerry71345: folds 
*** TURN *** [3s 6h 5c] [7c]
PlayTheBlues4U: checks 
slgu1201: bets $0.90
PlayTheBlues4U: folds 
Uncalled bet ($0.90) returned to slgu1201
slgu1201 collected $1.90 from pot
slgu1201: doesn't show hand 
*** SUMMARY ***
Total pot $2 | Rake $0.10 
Board [3s 6h 5c 7c]
Seat 1: slgu1201 (button) collected ($1.90)
Seat 2: jerry71345 (small blind) folded on the Flop
Seat 3: rkk7777 (big blind) folded before Flop
Seat 4: PlayTheBlues4U folded on the Turn
Seat 5: KingBoy0519 folded before Flop (didn't bet)
Seat 6: davetass folded before Flop (didn't bet)


PokerStars Hand #204114098714:  Hold'em No Limit ($0.05/$0.10 USD) - 2019/09/30 22:30:59 ET
Table 'Tabit' 6-max Seat #6 is the button
Seat 1: slgu1201 ($7.80 in chips) 
Seat 2: jerry71345 ($7.58 in chips) 
Seat 3: rkk7777 ($13.11 in chips) 
Seat 4: PlayTheBlues4U ($15.53 in chips) 
Seat 5: KingBoy0519 ($7.50 in chips) 
Seat 6: davetass ($16.95 in chips) 
slgu1201: posts small blind $0.05
jerry71345: posts big blind $0.10
*** HOLE CARDS ***
Dealt to PlayTheBlues4U [8h Jd]
rkk7777: raises $0.20 to $0.30
PlayTheBlues4U: folds 
KingBoy0519: calls $0.30
davetass: folds 
slgu1201: folds 
jerry71345: folds 
*** FLOP *** [9s 3d Qc]
rkk7777: bets $0.20
KingBoy0519: calls $0.20
*** TURN *** [9s 3d Qc] [5d]
rkk7777: bets $0.10
KingBoy0519: calls $0.10
*** RIVER *** [9s 3d Qc 5d] [9d]
rkk7777: checks 
KingBoy0519: checks 
*** SHOW DOWN ***
rkk7777: shows [7s As] (a pair of Nines)
KingBoy0519: mucks hand 
rkk7777 collected $1.28 from pot
*** SUMMARY ***
Total pot $1.35 | Rake $0.07 
Board [9s 3d Qc 5d 9d]
Seat 1: slgu1201 (small blind) folded before Flop
Seat 2: jerry71345 (big blind) folded before Flop
Seat 3: rkk7777 showed [7s As] and won ($1.28) with a pair of Nines
Seat 4: PlayTheBlues4U folded before Flop (didn't bet)
Seat 5: KingBoy0519 mucked [2c Ac]
Seat 6: davetass (button) folded before Flop (didn't bet)


PokerStars Hand #204114098602:  Hold'em No Limit ($0.05/$0.10 USD) - 2019/09/30 22:30:21 ET
Table 'Tabit' 6-max Seat #5 is the button
Seat 1: slgu1201 ($8 in chips) 
Seat 2: jerry71345 ($5.66 in chips) 
Seat 3: rkk7777 ($13.31 in chips) 
Seat 4: PlayTheBlues4U ($15.53 in chips) 
Seat 5: KingBoy0519 ($7.50 in chips) 
Seat 6: davetass ($18.66 in chips) 
davetass: posts small blind $0.05
slgu1201: posts big blind $0.10
*** HOLE CARDS ***
Dealt to PlayTheBlues4U [2d As]
jerry71345: calls $0.10
rkk7777: calls $0.10
PlayTheBlues4U: folds 
KingBoy0519: folds 
davetass: calls $0.05
slgu1201: checks 
*** FLOP *** [3s Qh 7h]
davetass: checks 
slgu1201: checks 
jerry71345: bets $0.10
rkk7777: calls $0.10
davetass: calls $0.10
slgu1201: calls $0.10
*** TURN *** [3s Qh 7h] [Jd]
davetass: checks 
slgu1201: checks 
jerry71345: bets $0.10
rkk7777: folds 
davetass: raises $0.48 to $0.58
slgu1201: folds 
jerry71345: calls $0.48
*** RIVER *** [3s Qh 7h Jd] [Ac]
davetass: bets $0.93
jerry71345: calls $0.93
*** SHOW DOWN ***
davetass: shows [7d Td] (a pair of Sevens)
jerry71345: shows [Ts Qs] (a pair of Queens)
jerry71345 collected $3.63 from pot
*** SUMMARY ***
Total pot $3.82 | Rake $0.19 
Board [3s Qh 7h Jd Ac]
Seat 1: slgu1201 (big blind) folded on the Turn
Seat 2: jerry71345 showed [Ts Qs] and won ($3.63) with a pair of Queens
Seat 3: rkk7777 folded on the Turn
Seat 4: PlayTheBlues4U folded before Flop (didn't bet)
Seat 5: KingBoy0519 (button) folded before Flop (didn't bet)
Seat 6: davetass (small blind) showed [7d Td] and lost with a pair of Sevens


PokerStars Hand #204114098531:  Hold'em No Limit ($0.05/$0.10 USD) - 2019/09/30 22:29:58 ET
Table 'Tabit' 6-max Seat #4 is the button
Seat 2: jerry71345 ($5.66 in chips) 
Seat 3: rkk7777 ($13.31 in chips) 
Seat 4: PlayTheBlues4U ($15.53 in chips) 
Seat 5: KingBoy0519 ($7.41 in chips) 
Seat 6: davetass ($18.76 in chips) 
KingBoy0519: posts small blind $0.05
davetass: posts big blind $0.10
slgu1201: sits out 
*** HOLE CARDS ***
Dealt to PlayTheBlues4U [Kd 5c]
davetass said, "yea"
jerry71345: folds 
rkk7777: folds 
davetass said, "must be"
PlayTheBlues4U: folds 
KingBoy0519: calls $0.05
davetass: checks 
*** FLOP *** [4h 2h Ac]
KingBoy0519: bets $0.30
davetass: folds 
Uncalled bet ($0.30) returned to KingBoy0519
KingBoy0519 collected $0.19 from pot
KingBoy0519: doesn't show hand 
*** SUMMARY ***
Total pot $0.20 | Rake $0.01 
Board [4h 2h Ac]
Seat 2: jerry71345 folded before Flop (didn't bet)
Seat 3: rkk7777 folded before Flop (didn't bet)
Seat 4: PlayTheBlues4U (button) folded before Flop (didn't bet)
Seat 5: KingBoy0519 (small blind) collected ($0.19)
Seat 6: davetass (big blind) folded on the Flop


PokerStars Hand #204114098345:  Hold'em No Limit ($0.05/$0.10 USD) - 2019/09/30 22:28:56 ET
Table 'Tabit' 6-max Seat #3 is the button
Seat 2: jerry71345 ($5.24 in chips) 
Seat 3: rkk7777 ($13.51 in chips) 
Seat 4: PlayTheBlues4U ($15.58 in chips) 
Seat 5: KingBoy0519 ($7.61 in chips) 
Seat 6: davetass ($18.76 in chips) 
PlayTheBlues4U: posts small blind $0.05
KingBoy0519: posts big blind $0.10
*** HOLE CARDS ***
Dealt to PlayTheBlues4U [4h 7h]
davetass: folds 
jerry71345: calls $0.10
rkk7777: calls $0.10
PlayTheBlues4U: folds 
davetass said, "well played"
KingBoy0519: checks 
*** FLOP *** [6c 9c As]
KingBoy0519: checks 
PlayTheBlues4U said, "hmm"
PlayTheBlues4U said, "4.5%"
jerry71345: checks 
rkk7777: bets $0.10
davetass said, "if that"
KingBoy0519: calls $0.10
jerry71345: calls $0.10
*** TURN *** [6c 9c As] [4c]
davetass said, "well played"
slgu1201 joins the table at seat #1 
KingBoy0519: checks 
jerry71345: checks 
rkk7777: checks 
*** RIVER *** [6c 9c As 4c] [Jc]
PlayTheBlues4U said, "outskilled"
KingBoy0519: checks 
jerry71345: checks 
rkk7777: checks 
*** SHOW DOWN ***
KingBoy0519: shows [Kd 9d] (a pair of Nines)
jerry71345: shows [Js 8s] (a pair of Jacks)
rkk7777: mucks hand 
jerry71345 collected $0.62 from pot
*** SUMMARY ***
Total pot $0.65 | Rake $0.03 
Board [6c 9c As 4c Jc]
Seat 2: jerry71345 showed [Js 8s] and won ($0.62) with a pair of Jacks
Seat 3: rkk7777 (button) mucked [7d 6d]
Seat 4: PlayTheBlues4U (small blind) folded before Flop
Seat 5: KingBoy0519 (big blind) showed [Kd 9d] and lost with a pair of Nines
Seat 6: davetass folded before Flop (didn't bet)


PokerStars Hand #204114098156:  Hold'em No Limit ($0.05/$0.10 USD) - 2019/09/30 22:27:48 ET
Table 'Tabit' 6-max Seat #2 is the button
Seat 2: jerry71345 ($5.24 in chips) 
Seat 3: rkk7777 ($13.81 in chips) 
Seat 4: PlayTheBlues4U ($8.05 in chips) 
Seat 5: KingBoy0519 ($7.61 in chips) 
Seat 6: davetass ($26.81 in chips) 
rkk7777: posts small blind $0.05
PlayTheBlues4U: posts big blind $0.10
*** HOLE CARDS ***
Dealt to PlayTheBlues4U [Jd Js]
KingBoy0519: folds 
davetass: raises $0.20 to $0.30
jerry71345: folds 
rkk7777: calls $0.25
PlayTheBlues4U: raises $0.50 to $0.80
davetass: raises $1.90 to $2.70
rkk7777: folds 
PlayTheBlues4U: raises $2.10 to $4.80
davetass: raises $22.01 to $26.81 and is all-in
PlayTheBlues4U: calls $3.25 and is all-in
Uncalled bet ($18.76) returned to davetass
*** FLOP *** [2d 5h Ad]
*** TURN *** [2d 5h Ad] [9d]
*** RIVER *** [2d 5h Ad 9d] [Qd]
*** SHOW DOWN ***
PlayTheBlues4U: shows [Jd Js] (a flush, Ace high)
davetass: shows [As Ah] (three of a kind, Aces)
PlayTheBlues4U collected $15.58 from pot
*** SUMMARY ***
Total pot $16.40 | Rake $0.82 
Board [2d 5h Ad 9d Qd]
Seat 2: jerry71345 (button) folded before Flop (didn't bet)
Seat 3: rkk7777 (small blind) folded before Flop
Seat 4: PlayTheBlues4U (big blind) showed [Jd Js] and won ($15.58) with a flush, Ace high
Seat 5: KingBoy0519 folded before Flop (didn't bet)
Seat 6: davetass showed [As Ah] and lost with three of a kind, Aces


PokerStars Hand #204114098029:  Hold'em No Limit ($0.05/$0.10 USD) - 2019/09/30 22:27:02 ET
Table 'Tabit' 6-max Seat #6 is the button
Seat 1: axex6 ($8.36 in chips) 
Seat 2: jerry71345 ($5.74 in chips) 
Seat 3: rkk7777 ($13.81 in chips) 
Seat 4: PlayTheBlues4U ($8.05 in chips) 
Seat 5: KingBoy0519 ($8.01 in chips) 
Seat 6: davetass ($26.81 in chips) 
axex6: posts small blind $0.05
jerry71345: posts big blind $0.10
*** HOLE CARDS ***
Dealt to PlayTheBlues4U [Th 5h]
rkk7777: folds 
PlayTheBlues4U: folds 
KingBoy0519: calls $0.10
davetass: folds 
axex6: calls $0.05
jerry71345: checks 
*** FLOP *** [Qs Td 4s]
axex6: checks 
jerry71345: bets $0.10
KingBoy0519: calls $0.10
axex6: calls $0.10
*** TURN *** [Qs Td 4s] [7c]
axex6: checks 
jerry71345: bets $0.10
KingBoy0519: calls $0.10
axex6: raises $0.10 to $0.20
jerry71345: calls $0.10
KingBoy0519: calls $0.10
*** RIVER *** [Qs Td 4s 7c] [2s]
axex6: bets $0.10
jerry71345: calls $0.10
KingBoy0519: folds 
*** SHOW DOWN ***
axex6: shows [4c Qc] (two pair, Queens and Fours)
jerry71345: mucks hand 
axex6 collected $1.33 from pot
*** SUMMARY ***
Total pot $1.40 | Rake $0.07 
Board [Qs Td 4s 7c 2s]
Seat 1: axex6 (small blind) showed [4c Qc] and won ($1.33) with two pair, Queens and Fours
Seat 2: jerry71345 (big blind) mucked [Qd 6h]
Seat 3: rkk7777 folded before Flop (didn't bet)
Seat 4: PlayTheBlues4U folded before Flop (didn't bet)
Seat 5: KingBoy0519 folded on the River
Seat 6: davetass (button) folded before Flop (didn't bet)


PokerStars Hand #204114097758:  Hold'em No Limit ($0.05/$0.10 USD) - 2019/09/30 22:25:29 ET
Table 'Tabit' 6-max Seat #5 is the button
Seat 1: axex6 ($7.68 in chips) 
Seat 2: jerry71345 ($5.74 in chips) 
Seat 3: rkk7777 ($14.51 in chips) 
Seat 4: PlayTheBlues4U ($8.05 in chips) 
Seat 5: KingBoy0519 ($8.01 in chips) 
Seat 6: davetass ($26.86 in chips) 
davetass: posts small blind $0.05
axex6: posts big blind $0.10
*** HOLE CARDS ***
Dealt to PlayTheBlues4U [3d Ts]
jerry71345: folds 
rkk7777: raises $0.20 to $0.30
KingBoy0519 said, "bad bluff"
PlayTheBlues4U: folds 
KingBoy0519: folds 
davetass: folds 
davetass said, "i guess"
PlayTheBlues4U said, "what ever makes you happy"
davetass said, "no no different hand"
axex6: calls $0.20
*** FLOP *** [6s 6d 7s]
axex6: bets $0.10
rkk7777: raises $0.20 to $0.30
axex6: calls $0.20
*** TURN *** [6s 6d 7s] [Jd]
axex6: checks 
rkk7777: checks 
*** RIVER *** [6s 6d 7s Jd] [5s]
axex6: bets $0.10
rkk7777: calls $0.10
*** SHOW DOWN ***
axex6: shows [Tc 7c] (two pair, Sevens and Sixes)
rkk7777: mucks hand 
axex6 collected $1.38 from pot
*** SUMMARY ***
Total pot $1.45 | Rake $0.07 
Board [6s 6d 7s Jd 5s]
Seat 1: axex6 (big blind) showed [Tc 7c] and won ($1.38) with two pair, Sevens and Sixes
Seat 2: jerry71345 folded before Flop (didn't bet)
Seat 3: rkk7777 mucked [4c 4d]
Seat 4: PlayTheBlues4U folded before Flop (didn't bet)
Seat 5: KingBoy0519 (button) folded before Flop (didn't bet)
Seat 6: davetass (small blind) folded before Flop


PokerStars Hand #204114097601:  Hold'em No Limit ($0.05/$0.10 USD) - 2019/09/30 22:24:42 ET
Table 'Tabit' 6-max Seat #4 is the button
Seat 1: axex6 ($7.68 in chips) 
Seat 2: jerry71345 ($5.74 in chips) 
Seat 3: rkk7777 ($14.61 in chips) 
Seat 4: PlayTheBlues4U ($9.85 in chips) 
Seat 5: KingBoy0519 ($6.20 in chips) 
Seat 6: davetass ($26.96 in chips) 
KingBoy0519: posts small blind $0.05
davetass: posts big blind $0.10
*** HOLE CARDS ***
Dealt to PlayTheBlues4U [Kh 7c]
axex6: folds 
jerry71345: folds 
rkk7777: calls $0.10
PlayTheBlues4U: raises $0.20 to $0.30
KingBoy0519: calls $0.25
davetass: folds 
rkk7777: folds 
*** FLOP *** [2d Jh Tc]
KingBoy0519: checks 
PlayTheBlues4U: bets $0.40
KingBoy0519: calls $0.40
*** TURN *** [2d Jh Tc] [3c]
KingBoy0519: checks 
PlayTheBlues4U: checks 
*** RIVER *** [2d Jh Tc 3c] [Ah]
KingBoy0519: checks 
PlayTheBlues4U: bets $1.10
KingBoy0519: calls $1.10
*** SHOW DOWN ***
PlayTheBlues4U: shows [Kh 7c] (high card Ace)
KingBoy0519: shows [Qh Ac] (a pair of Aces)
KingBoy0519 collected $3.61 from pot
*** SUMMARY ***
Total pot $3.80 | Rake $0.19 
Board [2d Jh Tc 3c Ah]
Seat 1: axex6 folded before Flop (didn't bet)
Seat 2: jerry71345 folded before Flop (didn't bet)
Seat 3: rkk7777 folded before Flop
Seat 4: PlayTheBlues4U (button) showed [Kh 7c] and lost with high card Ace
Seat 5: KingBoy0519 (small blind) showed [Qh Ac] and won ($3.61) with a pair of Aces
Seat 6: davetass (big blind) folded before Flop


PokerStars Hand #204114097467:  Hold'em No Limit ($0.05/$0.10 USD) - 2019/09/30 22:24:02 ET
Table 'Tabit' 6-max Seat #3 is the button
Seat 1: axex6 ($7.68 in chips) 
Seat 2: jerry71345 ($5.84 in chips) 
Seat 3: rkk7777 ($14.81 in chips) 
Seat 4: PlayTheBlues4U ($9.90 in chips) 
Seat 5: KingBoy0519 ($5.88 in chips) 
Seat 6: davetass ($26.96 in chips) 
PlayTheBlues4U: posts small blind $0.05
KingBoy0519: posts big blind $0.10
*** HOLE CARDS ***
Dealt to PlayTheBlues4U [4h Qd]
davetass: folds 
axex6: folds 
jerry71345: calls $0.10
rkk7777: calls $0.10
PlayTheBlues4U: folds 
KingBoy0519: checks 
*** FLOP *** [7s Jc 8c]
KingBoy0519: checks 
jerry71345: checks 
rkk7777: bets $0.10
KingBoy0519: calls $0.10
jerry71345: folds 
*** TURN *** [7s Jc 8c] [6c]
KingBoy0519: checks 
rkk7777: checks 
*** RIVER *** [7s Jc 8c 6c] [3s]
KingBoy0519: checks 
rkk7777: checks 
*** SHOW DOWN ***
KingBoy0519: shows [5h 8s] (a pair of Eights)
rkk7777: mucks hand 
KingBoy0519 collected $0.52 from pot
*** SUMMARY ***
Total pot $0.55 | Rake $0.03 
Board [7s Jc 8c 6c 3s]
Seat 1: axex6 folded before Flop (didn't bet)
Seat 2: jerry71345 folded on the Flop
Seat 3: rkk7777 (button) mucked [7h 2d]
Seat 4: PlayTheBlues4U (small blind) folded before Flop
Seat 5: KingBoy0519 (big blind) showed [5h 8s] and won ($0.52) with a pair of Eights
Seat 6: davetass folded before Flop (didn't bet)


PokerStars Hand #204114097314:  Hold'em No Limit ($0.05/$0.10 USD) - 2019/09/30 22:23:16 ET
Table 'Tabit' 6-max Seat #2 is the button
Seat 1: axex6 ($3.94 in chips) 
Seat 2: jerry71345 ($9.78 in chips) 
Seat 3: rkk7777 ($14.91 in chips) 
Seat 4: PlayTheBlues4U ($10 in chips) 
Seat 5: KingBoy0519 ($5.88 in chips) 
Seat 6: davetass ($26.96 in chips) 
rkk7777: posts small blind $0.05
PlayTheBlues4U: posts big blind $0.10
*** HOLE CARDS ***
Dealt to PlayTheBlues4U [2d 7d]
KingBoy0519: folds 
davetass: folds 
axex6: calls $0.10
jerry71345: calls $0.10
rkk7777: calls $0.05
PlayTheBlues4U: checks 
*** FLOP *** [9h Ad 9s]
rkk7777: checks 
PlayTheBlues4U: checks 
axex6: bets $0.10
jerry71345: raises $0.10 to $0.20
rkk7777: folds 
PlayTheBlues4U: folds 
axex6: calls $0.10
*** TURN *** [9h Ad 9s] [4c]
axex6: checks 
jerry71345: bets $0.20
axex6: raises $1.16 to $1.36
jerry71345: calls $1.16
*** RIVER *** [9h Ad 9s 4c] [4d]
axex6: bets $2.28 and is all-in
jerry71345: calls $2.28
*** SHOW DOWN ***
axex6: shows [9c Kh] (a full house, Nines full of Fours)
jerry71345: shows [6d 6h] (two pair, Nines and Sixes)
axex6 collected $7.68 from pot
*** SUMMARY ***
Total pot $8.08 | Rake $0.40 
Board [9h Ad 9s 4c 4d]
Seat 1: axex6 showed [9c Kh] and won ($7.68) with a full house, Nines full of Fours
Seat 2: jerry71345 (button) showed [6d 6h] and lost with two pair, Nines and Sixes
Seat 3: rkk7777 (small blind) folded on the Flop
Seat 4: PlayTheBlues4U (big blind) folded on the Flop
Seat 5: KingBoy0519 folded before Flop (didn't bet)
Seat 6: davetass folded before Flop (didn't bet)

PokerStars Hand #204330103607:  Hold'em No Limit ($0.02/$0.05 USD) - 2019/10/07 20:32:46 ET
Table 'Sculptor' 6-max Seat #4 is the button
Seat 1: cladams73 ($3.22 in chips)
Seat 3: skillzplumber ($7.34 in chips)
Seat 4: PlayTheBlues4U ($5 in chips)
Seat 5: Wooly510 ($7.82 in chips)
Seat 6: DemolishIT ($9 in chips)
Wooly510: posts small blind $0.02
DemolishIT: posts big blind $0.05
DaGoodz33: sits out
*** HOLE CARDS ***
Dealt to PlayTheBlues4U [8c 8d]
cladams73: calls $0.05
skillzplumber: folds
PlayTheBlues4U: raises $0.10 to $0.15
Wooly510: raises $0.40 to $0.55
DemolishIT: folds
cladams73: calls $0.50
PlayTheBlues4U: calls $0.40
*** FLOP *** [3h Kc 2h]
Wooly510: bets $1.22
cladams73: raises $1.22 to $2.44
PlayTheBlues4U: folds
PlayTheBlues4U leaves the table
Wooly510: raises $1.22 to $3.66
cladams73: calls $0.23 and is all-in
Uncalled bet ($0.99) returned to Wooly510
*** TURN *** [3h Kc 2h] [4h]
*** RIVER *** [3h Kc 2h 4h] [9s]
*** SHOW DOWN ***
Wooly510: shows [Kd Kh] (three of a kind, Kings)
cladams73: shows [Jh 6h] (a flush, Jack high)
cladams73 collected $6.69 from pot
*** SUMMARY ***
Total pot $7.04 | Rake $0.35
Board [3h Kc 2h 4h 9s]
Seat 1: cladams73 showed [Jh 6h] and won ($6.69) with a flush, Jack high
Seat 3: skillzplumber folded before Flop (didn't bet)
Seat 4: PlayTheBlues4U (button) folded on the Flop
Seat 5: Wooly510 (small blind) showed [Kd Kh] and lost with three of a kind, Kings
Seat 6: DemolishIT (big blind) folded before Flop


PokerStars Hand #204330103480:  Hold'em No Limit ($0.02/$0.05 USD) - 2019/10/07 20:32:06 ET
Table 'Fides' 6-max Seat #5 is the button
Seat 1: KooKballs ($7.79 in chips)
Seat 2: Wooly510 ($4.83 in chips)
Seat 3: dcami_nj ($10.06 in chips)
Seat 4: DaGoodz33 ($6.53 in chips)
Seat 5: stock501402 ($8.49 in chips)
Seat 6: PlayTheBlues4U ($5.96 in chips)
PlayTheBlues4U: posts small blind $0.02
KooKballs: posts big blind $0.05
*** HOLE CARDS ***
Dealt to PlayTheBlues4U [9d 6c]
Wooly510: folds
dcami_nj: folds
DaGoodz33: folds
stock501402: calls $0.05
PlayTheBlues4U: folds
PlayTheBlues4U is disconnected
KooKballs: checks
*** FLOP *** [Js Qh Tc]
PlayTheBlues4U leaves the table
KooKballs: bets $0.10
stock501402: folds
Uncalled bet ($0.10) returned to KooKballs
KooKballs collected $0.11 from pot
KooKballs: doesn't show hand
*** SUMMARY ***
Total pot $0.12 | Rake $0.01
Board [Js Qh Tc]
Seat 1: KooKballs (big blind) collected ($0.11)
Seat 2: Wooly510 folded before Flop (didn't bet)
Seat 3: dcami_nj folded before Flop (didn't bet)
Seat 4: DaGoodz33 folded before Flop (didn't bet)
Seat 5: stock501402 (button) folded on the Flop
Seat 6: PlayTheBlues4U (small blind) folded before Flop


PokerStars Hand #204330103412:  Hold'em No Limit ($0.02/$0.05 USD) - 2019/10/07 20:31:43 ET
Table 'Sculptor' 6-max Seat #3 is the button
Seat 1: cladams73 ($3.87 in chips)
Seat 3: skillzplumber ($7.34 in chips)
Seat 4: PlayTheBlues4U ($1.54 in chips)
Seat 5: Wooly510 ($7.87 in chips)
Seat 6: DemolishIT ($9.15 in chips)
PlayTheBlues4U: posts small blind $0.02
Wooly510: posts big blind $0.05
*** HOLE CARDS ***
Dealt to PlayTheBlues4U [9c Kc]
DemolishIT: calls $0.05
skillzplumber said, "nh"
cladams73: raises $0.10 to $0.15
R@ngers94 leaves the table
skillzplumber: folds
DemolishIT said, "ty"
DaGoodz33 joins the table at seat #2
PlayTheBlues4U: calls $0.13
Wooly510: folds
DemolishIT: calls $0.10
*** FLOP *** [3s 2c 3c]
PlayTheBlues4U: checks
DemolishIT: checks
cladams73: bets $0.50
PlayTheBlues4U: raises $0.89 to $1.39 and is all-in
DemolishIT: folds
cladams73: folds
Uncalled bet ($0.89) returned to PlayTheBlues4U
PlayTheBlues4U collected $1.42 from pot
PlayTheBlues4U: doesn't show hand
*** SUMMARY ***
Total pot $1.50 | Rake $0.08
Board [3s 2c 3c]
Seat 1: cladams73 folded on the Flop
Seat 3: skillzplumber (button) folded before Flop (didn't bet)
Seat 4: PlayTheBlues4U (small blind) collected ($1.42)
Seat 5: Wooly510 (big blind) folded before Flop
Seat 6: DemolishIT folded on the Flop


PokerStars Hand #204330103400:  Hold'em No Limit ($0.01/$0.02 USD) - 2019/10/07 20:31:39 ET
Table 'Ara' 6-max Seat #5 is the button
Seat 2: Wooly510 ($2.01 in chips)
Seat 5: kevkevmoney ($3.09 in chips)
Seat 6: PlayTheBlues4U ($1.98 in chips)
PlayTheBlues4U: posts small blind $0.01
Wooly510: posts big blind $0.02
delm44: sits out
*** HOLE CARDS ***
Dealt to PlayTheBlues4U [8c 4d]
kevkevmoney: calls $0.02
PlayTheBlues4U: folds
Wooly510: checks
*** FLOP *** [5h 7h 3d]
PlayTheBlues4U leaves the table
Wooly510: bets $0.03
kevkevmoney: raises $0.03 to $0.06
DaGoodz33 joins the table at seat #6
Wooly510: calls $0.03
*** TURN *** [5h 7h 3d] [2c]
Wooly510: bets $0.02
kevkevmoney: calls $0.02
*** RIVER *** [5h 7h 3d 2c] [6s]
Wooly510: checks
kevkevmoney: checks
*** SHOW DOWN ***
Wooly510: shows [7d Kc] (a pair of Sevens)
kevkevmoney: mucks hand
Wooly510 collected $0.20 from pot
*** SUMMARY ***
Total pot $0.21 | Rake $0.01
Board [5h 7h 3d 2c 6s]
Seat 2: Wooly510 (big blind) showed [7d Kc] and won ($0.20) with a pair of Sevens
Seat 5: kevkevmoney (button) mucked [5c Ts]
Seat 6: PlayTheBlues4U (small blind) folded before Flop


PokerStars Hand #204330103262:  Hold'em No Limit ($0.02/$0.05 USD) - 2019/10/07 20:30:53 ET
Table 'Fides' 6-max Seat #4 is the button
Seat 1: KooKballs ($7.99 in chips)
Seat 2: Wooly510 ($4.83 in chips)
Seat 3: dcami_nj ($10.06 in chips)
Seat 4: DaGoodz33 ($6.68 in chips)
Seat 5: stock501402 ($8.03 in chips)
Seat 6: PlayTheBlues4U ($6.11 in chips)
stock501402: posts small blind $0.02
PlayTheBlues4U: posts big blind $0.05
*** HOLE CARDS ***
Dealt to PlayTheBlues4U [Th Ac]
KooKballs: raises $0.10 to $0.15
Wooly510: folds
dcami_nj: folds
DaGoodz33: calls $0.15
stock501402: calls $0.13
PlayTheBlues4U: calls $0.10
*** FLOP *** [Jc Jh Qh]
stock501402: bets $0.05
PlayTheBlues4U: folds
KooKballs: calls $0.05
DaGoodz33: folds
*** TURN *** [Jc Jh Qh] [4c]
stock501402: checks
KooKballs: checks
*** RIVER *** [Jc Jh Qh 4c] [Qc]
stock501402: checks
KooKballs: checks
*** SHOW DOWN ***
stock501402: shows [Js 4h] (a full house, Jacks full of Queens)
KooKballs: mucks hand
stock501402 collected $0.66 from pot
*** SUMMARY ***
Total pot $0.70 | Rake $0.04
Board [Jc Jh Qh 4c Qc]
Seat 1: KooKballs mucked [7d 7s]
Seat 2: Wooly510 folded before Flop (didn't bet)
Seat 3: dcami_nj folded before Flop (didn't bet)
Seat 4: DaGoodz33 (button) folded on the Flop
Seat 5: stock501402 (small blind) showed [Js 4h] and won ($0.66) with a full house, Jacks full of Queens
Seat 6: PlayTheBlues4U (big blind) folded on the Flop


PokerStars Hand #204330103254:  Hold'em No Limit ($0.02/$0.05 USD) - 2019/10/07 20:30:50 ET
Table 'Sculptor' 6-max Seat #1 is the button
Seat 1: cladams73 ($3.87 in chips)
Seat 2: R@ngers94 ($1.40 in chips)
Seat 3: skillzplumber ($7.39 in chips)
Seat 4: PlayTheBlues4U ($5.52 in chips)
Seat 5: Wooly510 ($8.07 in chips)
Seat 6: DemolishIT ($4 in chips)
R@ngers94: posts small blind $0.02
skillzplumber: posts big blind $0.05
DemolishIT: posts small blind $0.02
*** HOLE CARDS ***
Dealt to PlayTheBlues4U [Jd Jh]
PlayTheBlues4U: raises $0.15 to $0.20
Wooly510: calls $0.20
DemolishIT: raises $0.85 to $1.05
cladams73: folds
R@ngers94: raises $0.35 to $1.40 and is all-in
skillzplumber: folds
PlayTheBlues4U: raises $4.12 to $5.52 and is all-in
Wooly510: folds
DemolishIT: calls $2.93 and is all-in
Uncalled bet ($1.54) returned to PlayTheBlues4U
*** FLOP *** [5h Kd 7d]
*** TURN *** [5h Kd 7d] [Th]
*** RIVER *** [5h Kd 7d Th] [2h]
*** SHOW DOWN ***
PlayTheBlues4U: shows [Jd Jh] (a pair of Jacks)
DemolishIT: shows [Kh Ah] (a flush, Ace high)
DemolishIT collected $4.90 from side pot
R@ngers94: shows [7h 7c] (three of a kind, Sevens)
DemolishIT collected $4.25 from main pot
*** SUMMARY ***
Total pot $9.63 Main pot $4.25. Side pot $4.90. | Rake $0.48
Board [5h Kd 7d Th 2h]
Seat 1: cladams73 (button) folded before Flop (didn't bet)
Seat 2: R@ngers94 (small blind) showed [7h 7c] and lost with three of a kind, Sevens
Seat 3: skillzplumber (big blind) folded before Flop
Seat 4: PlayTheBlues4U showed [Jd Jh] and lost with a pair of Jacks
Seat 5: Wooly510 folded before Flop
Seat 6: DemolishIT showed [Kh Ah] and won ($9.15) with a flush, Ace high


PokerStars Hand #204330103251:  Hold'em No Limit ($0.01/$0.02 USD) - 2019/10/07 20:30:48 ET
Table 'Ara' 6-max Seat #4 is the button
Seat 2: Wooly510 ($2.01 in chips)
Seat 4: GTMuldoon ($1.29 in chips)
Seat 5: kevkevmoney ($3.07 in chips)
Seat 6: PlayTheBlues4U ($2 in chips)
kevkevmoney: posts small blind $0.01
PlayTheBlues4U: posts big blind $0.02
*** HOLE CARDS ***
Dealt to PlayTheBlues4U [Ks 5h]
Wooly510: folds
GTMuldoon: folds
kevkevmoney: calls $0.01
PlayTheBlues4U: checks
*** FLOP *** [Jh 5s 2c]
kevkevmoney: bets $0.05
GTMuldoon leaves the table
delm44 joins the table at seat #4
PlayTheBlues4U: folds
Uncalled bet ($0.05) returned to kevkevmoney
kevkevmoney collected $0.04 from pot
kevkevmoney: doesn't show hand
*** SUMMARY ***
Total pot $0.04 | Rake $0
Board [Jh 5s 2c]
Seat 2: Wooly510 folded before Flop (didn't bet)
Seat 4: GTMuldoon (button) folded before Flop (didn't bet)
Seat 5: kevkevmoney (small blind) collected ($0.04)
Seat 6: PlayTheBlues4U (big blind) folded on the Flop


PokerStars Hand #204330103168:  Hold'em No Limit ($0.02/$0.05 USD) - 2019/10/07 20:30:19 ET
Table 'Sculptor' 6-max Seat #5 is the button
Seat 1: cladams73 ($4.17 in chips)
Seat 2: R@ngers94 ($1.13 in chips)
Seat 3: skillzplumber ($7.39 in chips)
Seat 4: PlayTheBlues4U ($5.52 in chips)
Seat 5: Wooly510 ($8.07 in chips)
cladams73: posts small blind $0.02
R@ngers94: posts big blind $0.05
*** HOLE CARDS ***
Dealt to PlayTheBlues4U [5d 8s]
skillzplumber: folds
PlayTheBlues4U: folds
Wooly510: folds
cladams73: calls $0.03
R@ngers94: raises $0.10 to $0.15
cladams73: calls $0.10
*** FLOP *** [Ts 8h Ac]
cladams73: checks
R@ngers94: bets $0.15
cladams73: calls $0.15
*** TURN *** [Ts 8h Ac] [9d]
cladams73: checks
R@ngers94: bets $0.83 and is all-in
cladams73: folds
Uncalled bet ($0.83) returned to R@ngers94
R@ngers94 collected $0.57 from pot
R@ngers94: doesn't show hand
*** SUMMARY ***
Total pot $0.60 | Rake $0.03
Board [Ts 8h Ac 9d]
Seat 1: cladams73 (small blind) folded on the Turn
Seat 2: R@ngers94 (big blind) collected ($0.57)
Seat 3: skillzplumber folded before Flop (didn't bet)
Seat 4: PlayTheBlues4U folded before Flop (didn't bet)
Seat 5: Wooly510 (button) folded before Flop (didn't bet)


PokerStars Hand #204330103109:  Hold'em No Limit ($0.02/$0.05 USD) - 2019/10/07 20:29:59 ET
Table 'Sculptor' 6-max Seat #4 is the button
Seat 1: cladams73 ($4.17 in chips)
Seat 2: R@ngers94 ($1.18 in chips)
Seat 3: skillzplumber ($5.91 in chips)
Seat 4: PlayTheBlues4U ($5.52 in chips)
Seat 5: Wooly510 ($8.09 in chips)
Seat 6: DemolishIT ($1.57 in chips)
Wooly510: posts small blind $0.02
DemolishIT: posts big blind $0.05
*** HOLE CARDS ***
Dealt to PlayTheBlues4U [5s 9h]
cladams73: folds
R@ngers94: calls $0.05
skillzplumber: raises $5.86 to $5.91 and is all-in
PlayTheBlues4U: folds
Wooly510: folds
DemolishIT: calls $1.52 and is all-in
R@ngers94: folds
Uncalled bet ($4.34) returned to skillzplumber
*** FLOP *** [3c 6c 4h]
*** TURN *** [3c 6c 4h] [2s]
*** RIVER *** [3c 6c 4h 2s] [Jc]
*** SHOW DOWN ***
DemolishIT: shows [9d Ad] (high card Ace)
skillzplumber: shows [Td Th] (a pair of Tens)
skillzplumber collected $3.05 from pot
*** SUMMARY ***
Total pot $3.21 | Rake $0.16
Board [3c 6c 4h 2s Jc]
Seat 1: cladams73 folded before Flop (didn't bet)
Seat 2: R@ngers94 folded before Flop
Seat 3: skillzplumber showed [Td Th] and won ($3.05) with a pair of Tens
Seat 4: PlayTheBlues4U (button) folded before Flop (didn't bet)
Seat 5: Wooly510 (small blind) folded before Flop
Seat 6: DemolishIT (big blind) showed [9d Ad] and lost with high card Ace


PokerStars Hand #204330103102:  Hold'em No Limit ($0.02/$0.05 USD) - 2019/10/07 20:29:57 ET
Table 'Fides' 6-max Seat #3 is the button
Seat 1: KooKballs ($8.74 in chips)
Seat 2: Wooly510 ($4.83 in chips)
Seat 3: dcami_nj ($9.32 in chips)
Seat 4: DaGoodz33 ($6.70 in chips)
Seat 5: stock501402 ($8.08 in chips)
Seat 6: PlayTheBlues4U ($6.11 in chips)
DaGoodz33: posts small blind $0.02
stock501402: posts big blind $0.05
*** HOLE CARDS ***
Dealt to PlayTheBlues4U [4h Jd]
PlayTheBlues4U: folds
KooKballs: raises $0.10 to $0.15
Wooly510: folds
dcami_nj: calls $0.15
DaGoodz33: folds
stock501402: folds
*** FLOP *** [5d 7c 5c]
KooKballs: bets $0.20
dcami_nj: calls $0.20
*** TURN *** [5d 7c 5c] [Qs]
KooKballs: checks
dcami_nj: bets $0.40
KooKballs: calls $0.40
*** RIVER *** [5d 7c 5c Qs] [8s]
KooKballs: checks
dcami_nj: bets $0.75
KooKballs: folds
Uncalled bet ($0.75) returned to dcami_nj
dcami_nj collected $1.49 from pot
dcami_nj: doesn't show hand
*** SUMMARY ***
Total pot $1.57 | Rake $0.08
Board [5d 7c 5c Qs 8s]
Seat 1: KooKballs folded on the River
Seat 2: Wooly510 folded before Flop (didn't bet)
Seat 3: dcami_nj (button) collected ($1.49)
Seat 4: DaGoodz33 (small blind) folded before Flop
Seat 5: stock501402 (big blind) folded before Flop
Seat 6: PlayTheBlues4U folded before Flop (didn't bet)


PokerStars Hand #204330103042:  Hold'em No Limit ($0.02/$0.05 USD) - 2019/10/07 20:29:36 ET
Table 'Fides' 6-max Seat #2 is the button
Seat 1: KooKballs ($8.74 in chips)
Seat 2: Wooly510 ($4.76 in chips)
Seat 3: dcami_nj ($9.34 in chips)
Seat 4: DaGoodz33 ($6.75 in chips)
Seat 6: PlayTheBlues4U ($6.11 in chips)
dcami_nj: posts small blind $0.02
DaGoodz33: posts big blind $0.05
*** HOLE CARDS ***
Dealt to PlayTheBlues4U [7h 8h]
PlayTheBlues4U: folds
KooKballs: folds
Wooly510: raises $0.10 to $0.15
dcami_nj: folds
DaGoodz33: folds
Uncalled bet ($0.10) returned to Wooly510
Wooly510 collected $0.12 from pot
Wooly510: doesn't show hand
*** SUMMARY ***
Total pot $0.12 | Rake $0
Seat 1: KooKballs folded before Flop (didn't bet)
Seat 2: Wooly510 (button) collected ($0.12)
Seat 3: dcami_nj (small blind) folded before Flop
Seat 4: DaGoodz33 (big blind) folded before Flop
Seat 6: PlayTheBlues4U folded before Flop (didn't bet)


PokerStars Hand #204330102974:  Hold'em No Limit ($0.02/$0.05 USD) - 2019/10/07 20:29:10 ET
Table 'Sculptor' 6-max Seat #3 is the button
Seat 1: cladams73 ($4.03 in chips)
Seat 2: R@ngers94 ($1.18 in chips)
Seat 3: skillzplumber ($5.96 in chips)
Seat 4: PlayTheBlues4U ($5.57 in chips)
Seat 5: Wooly510 ($8.14 in chips)
Seat 6: DemolishIT ($1.57 in chips)
PlayTheBlues4U: posts small blind $0.02
Wooly510: posts big blind $0.05
*** HOLE CARDS ***
Dealt to PlayTheBlues4U [6d 9d]
DemolishIT: folds
cladams73: calls $0.05
R@ngers94: folds
skillzplumber: calls $0.05
PlayTheBlues4U: calls $0.03
Wooly510: checks
*** FLOP *** [Ac 5c Td]
PlayTheBlues4U: checks
Wooly510: checks
cladams73: checks
skillzplumber: checks
*** TURN *** [Ac 5c Td] [Ah]
PlayTheBlues4U: checks
Wooly510: checks
cladams73: bets $0.20
skillzplumber: folds
PlayTheBlues4U: folds
Wooly510: folds
Uncalled bet ($0.20) returned to cladams73
cladams73 collected $0.19 from pot
*** SUMMARY ***
Total pot $0.20 | Rake $0.01
Board [Ac 5c Td Ah]
Seat 1: cladams73 collected ($0.19)
Seat 2: R@ngers94 folded before Flop (didn't bet)
Seat 3: skillzplumber (button) folded on the Turn
Seat 4: PlayTheBlues4U (small blind) folded on the Turn
Seat 5: Wooly510 (big blind) folded on the Turn
Seat 6: DemolishIT folded before Flop (didn't bet)


PokerStars Hand #204330102900:  Hold'em No Limit ($0.02/$0.05 USD) - 2019/10/07 20:28:45 ET
Table 'Sculptor' 6-max Seat #2 is the button
Seat 1: cladams73 ($4.03 in chips)
Seat 2: R@ngers94 ($1.18 in chips)
Seat 3: skillzplumber ($5.98 in chips)
Seat 4: PlayTheBlues4U ($5.51 in chips)
Seat 5: Wooly510 ($8.14 in chips)
Seat 6: DemolishIT ($1.62 in chips)
skillzplumber: posts small blind $0.02
PlayTheBlues4U: posts big blind $0.05
*** HOLE CARDS ***
Dealt to PlayTheBlues4U [5h Ac]
Wooly510: folds
DemolishIT: calls $0.05
cladams73: folds
R@ngers94: folds
skillzplumber: folds
PlayTheBlues4U: checks
*** FLOP *** [Kh 2s 7d]
PlayTheBlues4U: checks
DemolishIT: checks
*** TURN *** [Kh 2s 7d] [Kc]
PlayTheBlues4U: checks
DemolishIT: checks
*** RIVER *** [Kh 2s 7d Kc] [9c]
PlayTheBlues4U: checks
skillzplumber said, "these fuc. king str8s"
DemolishIT: checks
*** SHOW DOWN ***
PlayTheBlues4U: shows [5h Ac] (a pair of Kings)
DemolishIT: mucks hand
PlayTheBlues4U collected $0.11 from pot
*** SUMMARY ***
Total pot $0.12 | Rake $0.01
Board [Kh 2s 7d Kc 9c]
Seat 1: cladams73 folded before Flop (didn't bet)
Seat 2: R@ngers94 (button) folded before Flop (didn't bet)
Seat 3: skillzplumber (small blind) folded before Flop
Seat 4: PlayTheBlues4U (big blind) showed [5h Ac] and won ($0.11) with a pair of Kings
Seat 5: Wooly510 folded before Flop (didn't bet)
Seat 6: DemolishIT mucked [Tc Qh]


PokerStars Hand #204330102819:  Hold'em No Limit ($0.02/$0.05 USD) - 2019/10/07 20:28:18 ET
Table 'Fides' 6-max Seat #1 is the button
Seat 1: KooKballs ($9.04 in chips)
Seat 2: Wooly510 ($4.78 in chips)
Seat 3: dcami_nj ($9.05 in chips)
Seat 5: stock501402 ($8.08 in chips)
Seat 6: PlayTheBlues4U ($6.11 in chips)
Wooly510: posts small blind $0.02
dcami_nj: posts big blind $0.05
*** HOLE CARDS ***
Dealt to PlayTheBlues4U [9c 3c]
DaGoodz33 joins the table at seat #4
stock501402 has timed out while being disconnected
stock501402: folds
PlayTheBlues4U: folds
stock501402 is disconnected
KooKballs: raises $0.10 to $0.15
Wooly510: folds
dcami_nj: calls $0.10
*** FLOP *** [9h 8c Qh]
dcami_nj: checks
KooKballs: checks
*** TURN *** [9h 8c Qh] [8h]
dcami_nj: bets $0.15
KooKballs: calls $0.15
*** RIVER *** [9h 8c Qh 8h] [5d]
dcami_nj: bets $0.40
KooKballs: folds
Uncalled bet ($0.40) returned to dcami_nj
dcami_nj collected $0.59 from pot
dcami_nj: doesn't show hand
*** SUMMARY ***
Total pot $0.62 | Rake $0.03
Board [9h 8c Qh 8h 5d]
Seat 1: KooKballs (button) folded on the River
Seat 2: Wooly510 (small blind) folded before Flop
Seat 3: dcami_nj (big blind) collected ($0.59)
Seat 5: stock501402 folded before Flop (didn't bet)
Seat 6: PlayTheBlues4U folded before Flop (didn't bet)


PokerStars Hand #204330102784:  Hold'em No Limit ($0.02/$0.05 USD) - 2019/10/07 20:28:07 ET
Table 'Fides' 6-max Seat #6 is the button
Seat 1: KooKballs ($8.99 in chips)
Seat 2: Wooly510 ($4.83 in chips)
Seat 3: dcami_nj ($9.05 in chips)
Seat 5: stock501402 ($8.08 in chips)
Seat 6: PlayTheBlues4U ($6.11 in chips)
KooKballs: posts small blind $0.02
Wooly510: posts big blind $0.05
*** HOLE CARDS ***
Dealt to PlayTheBlues4U [4s 5d]
dcami_nj: folds
stock501402: folds
PlayTheBlues4U: folds
KooKballs: raises $0.10 to $0.15
Wooly510: folds
Uncalled bet ($0.10) returned to KooKballs
KooKballs collected $0.10 from pot
KooKballs: doesn't show hand
*** SUMMARY ***
Total pot $0.10 | Rake $0
Seat 1: KooKballs (small blind) collected ($0.10)
Seat 2: Wooly510 (big blind) folded before Flop
Seat 3: dcami_nj folded before Flop (didn't bet)
Seat 5: stock501402 folded before Flop (didn't bet)
Seat 6: PlayTheBlues4U (button) folded before Flop (didn't bet)


PokerStars Hand #204330102738:  Hold'em No Limit ($0.02/$0.05 USD) - 2019/10/07 20:27:51 ET
Table 'Sculptor' 6-max Seat #1 is the button
Seat 1: cladams73 ($3.57 in chips)
Seat 2: R@ngers94 ($1.28 in chips)
Seat 3: skillzplumber ($6.38 in chips)
Seat 4: PlayTheBlues4U ($5.51 in chips)
Seat 5: Wooly510 ($8.14 in chips)
Seat 6: DemolishIT ($1.62 in chips)
R@ngers94: posts small blind $0.02
skillzplumber: posts big blind $0.05
*** HOLE CARDS ***
Dealt to PlayTheBlues4U [Js Td]
PlayTheBlues4U: folds
Wooly510: folds
DemolishIT: folds
cladams73: calls $0.05
R@ngers94: calls $0.03
skillzplumber: checks
*** FLOP *** [Ks Jh 9h]
R@ngers94: bets $0.05
skillzplumber: calls $0.05
cladams73: calls $0.05
*** TURN *** [Ks Jh 9h] [Tc]
R@ngers94: checks
skillzplumber: checks
cladams73: bets $0.30
R@ngers94: folds
skillzplumber: calls $0.30
*** RIVER *** [Ks Jh 9h Tc] [4h]
skillzplumber: checks
cladams73: checks
*** SHOW DOWN ***
skillzplumber: shows [Kc 8s] (a pair of Kings)
cladams73: shows [Qh Jd] (a straight, Nine to King)
cladams73 collected $0.86 from pot
*** SUMMARY ***
Total pot $0.90 | Rake $0.04
Board [Ks Jh 9h Tc 4h]
Seat 1: cladams73 (button) showed [Qh Jd] and won ($0.86) with a straight, Nine to King
Seat 2: R@ngers94 (small blind) folded on the Turn
Seat 3: skillzplumber (big blind) showed [Kc 8s] and lost with a pair of Kings
Seat 4: PlayTheBlues4U folded before Flop (didn't bet)
Seat 5: Wooly510 folded before Flop (didn't bet)
Seat 6: DemolishIT folded before Flop (didn't bet)


PokerStars Hand #204330102661:  Hold'em No Limit ($0.02/$0.05 USD) - 2019/10/07 20:27:26 ET
Table 'Sculptor' 6-max Seat #6 is the button
Seat 1: cladams73 ($3.72 in chips)
Seat 2: R@ngers94 ($1.33 in chips)
Seat 3: skillzplumber ($6.38 in chips)
Seat 4: PlayTheBlues4U ($5.51 in chips)
Seat 5: Wooly510 ($8.14 in chips)
Seat 6: DemolishIT ($1.44 in chips)
cladams73: posts small blind $0.02
R@ngers94: posts big blind $0.05
*** HOLE CARDS ***
Dealt to PlayTheBlues4U [5c 9s]
skillzplumber: folds
PlayTheBlues4U: folds
Wooly510: folds
DemolishIT: raises $0.10 to $0.15
cladams73: calls $0.13
R@ngers94: folds
*** FLOP *** [Qd 6d 4s]
cladams73: checks
DemolishIT: checks
*** TURN *** [Qd 6d 4s] [6s]
cladams73: checks
DemolishIT: bets $0.33
cladams73: folds
Uncalled bet ($0.33) returned to DemolishIT
DemolishIT collected $0.33 from pot
DemolishIT: doesn't show hand
*** SUMMARY ***
Total pot $0.35 | Rake $0.02
Board [Qd 6d 4s 6s]
Seat 1: cladams73 (small blind) folded on the Turn
Seat 2: R@ngers94 (big blind) folded before Flop
Seat 3: skillzplumber folded before Flop (didn't bet)
Seat 4: PlayTheBlues4U folded before Flop (didn't bet)
Seat 5: Wooly510 folded before Flop (didn't bet)
Seat 6: DemolishIT (button) collected ($0.33)


PokerStars Hand #204330102643:  Hold'em No Limit ($0.02/$0.05 USD) - 2019/10/07 20:27:19 ET
Table 'Fides' 6-max Seat #5 is the button
Seat 1: KooKballs ($9.14 in chips)
Seat 2: Wooly510 ($4.83 in chips)
Seat 3: dcami_nj ($7.45 in chips)
Seat 5: stock501402 ($9.68 in chips)
Seat 6: PlayTheBlues4U ($6.13 in chips)
PlayTheBlues4U: posts small blind $0.02
KooKballs: posts big blind $0.05
*** HOLE CARDS ***
Dealt to PlayTheBlues4U [8h Kc]
Wooly510: folds
dcami_nj: raises $0.10 to $0.15
stock501402: calls $0.15
PlayTheBlues4U: folds
KooKballs: calls $0.10
*** FLOP *** [8s 7h 7s]
KooKballs: checks
dcami_nj: bets $0.35
stock501402: calls $0.35
KooKballs: folds
*** TURN *** [8s 7h 7s] [Ad]
dcami_nj: bets $0.55
stock501402: raises $0.55 to $1.10
dcami_nj: calls $0.55
*** RIVER *** [8s 7h 7s Ad] [2c]
dcami_nj: checks
stock501402: checks
*** SHOW DOWN ***
dcami_nj: shows [9s Ac] (two pair, Aces and Sevens)
stock501402: mucks hand
dcami_nj collected $3.20 from pot
*** SUMMARY ***
Total pot $3.37 | Rake $0.17
Board [8s 7h 7s Ad 2c]
Seat 1: KooKballs (big blind) folded on the Flop
Seat 2: Wooly510 folded before Flop (didn't bet)
Seat 3: dcami_nj showed [9s Ac] and won ($3.20) with two pair, Aces and Sevens
Seat 5: stock501402 (button) mucked [Ts 6s]
Seat 6: PlayTheBlues4U (small blind) folded before Flop


PokerStars Hand #204330102533:  Hold'em No Limit ($0.02/$0.05 USD) - 2019/10/07 20:26:41 ET
Table 'Fides' 6-max Seat #4 is the button
Seat 1: KooKballs ($9.14 in chips)
Seat 2: Wooly510 ($4.83 in chips)
Seat 3: dcami_nj ($7.30 in chips)
Seat 4: richy5742 ($4.03 in chips)
Seat 5: stock501402 ($9.70 in chips)
Seat 6: PlayTheBlues4U ($6.28 in chips)
stock501402: posts small blind $0.02
PlayTheBlues4U: posts big blind $0.05
*** HOLE CARDS ***
Dealt to PlayTheBlues4U [2h 5h]
KooKballs: folds
Wooly510: folds
dcami_nj: raises $0.10 to $0.15
richy5742: folds
stock501402: folds
richy5742 leaves the table
PlayTheBlues4U: calls $0.10
*** FLOP *** [Jc Ah 3c]
PlayTheBlues4U: checks
dcami_nj: bets $0.20
PlayTheBlues4U: folds
Uncalled bet ($0.20) returned to dcami_nj
dcami_nj collected $0.30 from pot
dcami_nj: doesn't show hand
*** SUMMARY ***
Total pot $0.32 | Rake $0.02
Board [Jc Ah 3c]
Seat 1: KooKballs folded before Flop (didn't bet)
Seat 2: Wooly510 folded before Flop (didn't bet)
Seat 3: dcami_nj collected ($0.30)
Seat 4: richy5742 (button) folded before Flop (didn't bet)
Seat 5: stock501402 (small blind) folded before Flop
Seat 6: PlayTheBlues4U (big blind) folded on the Flop


PokerStars Hand #204330102513:  Hold'em No Limit ($0.02/$0.05 USD) - 2019/10/07 20:26:34 ET
Table 'Sculptor' 6-max Seat #5 is the button
Seat 1: cladams73 ($3.89 in chips)
Seat 2: R@ngers94 ($1.50 in chips)
Seat 3: skillzplumber ($6.38 in chips)
Seat 4: PlayTheBlues4U ($5.51 in chips)
Seat 5: Wooly510 ($7.37 in chips)
Seat 6: DemolishIT ($1.94 in chips)
DemolishIT: posts small blind $0.02
cladams73: posts big blind $0.05
*** HOLE CARDS ***
Dealt to PlayTheBlues4U [9h 7h]
R@ngers94: raises $0.12 to $0.17
skillzplumber: folds
PlayTheBlues4U: folds
Wooly510: calls $0.17
DemolishIT: calls $0.15
cladams73: calls $0.12
*** FLOP *** [Jc 5s Qh]
DemolishIT: checks
cladams73: checks
R@ngers94: checks
Wooly510: checks
*** TURN *** [Jc 5s Qh] [8s]
DemolishIT: checks
cladams73: checks
R@ngers94: checks
Wooly510: bets $0.33
DemolishIT: calls $0.33
cladams73: folds
R@ngers94: folds
*** RIVER *** [Jc 5s Qh 8s] [2c]
DemolishIT: checks
Wooly510: checks
*** SHOW DOWN ***
DemolishIT: shows [9c 8d] (a pair of Eights)
Wooly510: shows [Ac Jh] (a pair of Jacks)
Wooly510 collected $1.27 from pot
*** SUMMARY ***
Total pot $1.34 | Rake $0.07
Board [Jc 5s Qh 8s 2c]
Seat 1: cladams73 (big blind) folded on the Turn
Seat 2: R@ngers94 folded on the Turn
Seat 3: skillzplumber folded before Flop (didn't bet)
Seat 4: PlayTheBlues4U folded before Flop (didn't bet)
Seat 5: Wooly510 (button) showed [Ac Jh] and won ($1.27) with a pair of Jacks
Seat 6: DemolishIT (small blind) showed [9c 8d] and lost with a pair of Eights


PokerStars Hand #204330102454:  Hold'em No Limit ($0.02/$0.05 USD) - 2019/10/07 20:26:08 ET
Table 'Sculptor' 6-max Seat #4 is the button
Seat 1: cladams73 ($3.94 in chips)
Seat 2: R@ngers94 ($4.80 in chips)
Seat 3: skillzplumber ($3.30 in chips)
Seat 4: PlayTheBlues4U ($5.51 in chips)
Seat 5: Wooly510 ($7.39 in chips)
Seat 6: DemolishIT ($1.99 in chips)
Wooly510: posts small blind $0.02
DemolishIT: posts big blind $0.05
*** HOLE CARDS ***
Dealt to PlayTheBlues4U [Jd 7c]
cladams73: calls $0.05
R@ngers94: raises $0.10 to $0.15
skillzplumber: raises $3.15 to $3.30 and is all-in
PlayTheBlues4U: folds
Wooly510: folds
DemolishIT: folds
skillzplumber said, "legoo"
cladams73: folds
R@ngers94: calls $3.15
*** FLOP *** [Ks 5d 3s]
*** TURN *** [Ks 5d 3s] [9d]
*** RIVER *** [Ks 5d 3s 9d] [4h]
*** SHOW DOWN ***
R@ngers94: shows [Jh Ah] (high card Ace)
skillzplumber: shows [7d 7h] (a pair of Sevens)
skillzplumber collected $6.38 from pot
*** SUMMARY ***
Total pot $6.72 | Rake $0.34
Board [Ks 5d 3s 9d 4h]
Seat 1: cladams73 folded before Flop
Seat 2: R@ngers94 showed [Jh Ah] and lost with high card Ace
Seat 3: skillzplumber showed [7d 7h] and won ($6.38) with a pair of Sevens
Seat 4: PlayTheBlues4U (button) folded before Flop (didn't bet)
Seat 5: Wooly510 (small blind) folded before Flop
Seat 6: DemolishIT (big blind) folded before Flop


PokerStars Hand #204330102399:  Hold'em No Limit ($0.02/$0.05 USD) - 2019/10/07 20:25:43 ET
Table 'Sculptor' 6-max Seat #3 is the button
Seat 1: cladams73 ($3.94 in chips)
Seat 2: R@ngers94 ($4.80 in chips)
Seat 3: skillzplumber ($3.94 in chips)
Seat 4: PlayTheBlues4U ($5.53 in chips)
Seat 5: Wooly510 ($7.44 in chips)
Seat 6: DemolishIT ($1.01 in chips)
PlayTheBlues4U: posts small blind $0.02
Wooly510: posts big blind $0.05
*** HOLE CARDS ***
Dealt to PlayTheBlues4U [Qs 8d]
DemolishIT: raises $0.20 to $0.25
cladams73: folds
R@ngers94: folds
skillzplumber: raises $3.69 to $3.94 and is all-in
PlayTheBlues4U: folds
Wooly510: folds
DemolishIT: calls $0.76 and is all-in
Uncalled bet ($2.93) returned to skillzplumber
*** FLOP *** [Jd 7d Tc]
*** TURN *** [Jd 7d Tc] [Ks]
*** RIVER *** [Jd 7d Tc Ks] [9d]
*** SHOW DOWN ***
DemolishIT: shows [Qc Ad] (a straight, Ten to Ace)
skillzplumber: shows [5c 5d] (a pair of Fives)
DemolishIT collected $1.99 from pot
*** SUMMARY ***
Total pot $2.09 | Rake $0.10
Board [Jd 7d Tc Ks 9d]
Seat 1: cladams73 folded before Flop (didn't bet)
Seat 2: R@ngers94 folded before Flop (didn't bet)
Seat 3: skillzplumber (button) showed [5c 5d] and lost with a pair of Fives
Seat 4: PlayTheBlues4U (small blind) folded before Flop
Seat 5: Wooly510 (big blind) folded before Flop
Seat 6: DemolishIT showed [Qc Ad] and won ($1.99) with a straight, Ten to Ace


PokerStars Hand #204330102344:  Hold'em No Limit ($0.02/$0.05 USD) - 2019/10/07 20:25:20 ET
Table 'Sculptor' 6-max Seat #2 is the button
Seat 1: cladams73 ($3.80 in chips)
Seat 2: R@ngers94 ($4.85 in chips)
Seat 3: skillzplumber ($3.99 in chips)
Seat 4: PlayTheBlues4U ($5.58 in chips)
Seat 5: Wooly510 ($7.44 in chips)
Seat 6: DemolishIT ($1.01 in chips)
skillzplumber: posts small blind $0.02
PlayTheBlues4U: posts big blind $0.05
*** HOLE CARDS ***
Dealt to PlayTheBlues4U [Qs 2s]
Wooly510: folds
DemolishIT: folds
PlayTheBlues4U said, "always nice to flop the straight"
cladams73: calls $0.05
R@ngers94: calls $0.05
skillzplumber: calls $0.03
PlayTheBlues4U: checks
*** FLOP *** [3s 8c Jh]
skillzplumber: checks
PlayTheBlues4U: checks
cladams73: bets $0.20
R@ngers94: folds
skillzplumber: folds
PlayTheBlues4U: folds
Uncalled bet ($0.20) returned to cladams73
cladams73 collected $0.19 from pot
*** SUMMARY ***
Total pot $0.20 | Rake $0.01
Board [3s 8c Jh]
Seat 1: cladams73 collected ($0.19)
Seat 2: R@ngers94 (button) folded on the Flop
Seat 3: skillzplumber (small blind) folded on the Flop
Seat 4: PlayTheBlues4U (big blind) folded on the Flop
Seat 5: Wooly510 folded before Flop (didn't bet)
Seat 6: DemolishIT folded before Flop (didn't bet)


PokerStars Hand #204330102302:  Hold'em No Limit ($0.02/$0.05 USD) - 2019/10/07 20:25:03 ET
Table 'Sculptor' 6-max Seat #1 is the button
Seat 1: cladams73 ($3.85 in chips)
Seat 2: R@ngers94 ($4.90 in chips)
Seat 3: skillzplumber ($3.89 in chips)
Seat 4: PlayTheBlues4U ($5.58 in chips)
Seat 5: Wooly510 ($7.44 in chips)
Seat 6: DemolishIT ($1.01 in chips)
R@ngers94: posts small blind $0.02
skillzplumber: posts big blind $0.05
*** HOLE CARDS ***
Dealt to PlayTheBlues4U [2d Ac]
PlayTheBlues4U: folds
Wooly510: folds
DemolishIT: folds
cladams73: calls $0.05
R@ngers94: calls $0.03
skillzplumber: raises $3.84 to $3.89 and is all-in
cladams73: folds
R@ngers94: folds
Uncalled bet ($3.84) returned to skillzplumber
skillzplumber collected $0.15 from pot
skillzplumber: doesn't show hand
*** SUMMARY ***
Total pot $0.15 | Rake $0
Seat 1: cladams73 (button) folded before Flop
Seat 2: R@ngers94 (small blind) folded before Flop
Seat 3: skillzplumber (big blind) collected ($0.15)
Seat 4: PlayTheBlues4U folded before Flop (didn't bet)
Seat 5: Wooly510 folded before Flop (didn't bet)
Seat 6: DemolishIT folded before Flop (didn't bet)


PokerStars Hand #204330102295:  Hold'em No Limit ($0.02/$0.05 USD) - 2019/10/07 20:25:01 ET
Table 'Fides' 6-max Seat #3 is the button
Seat 1: KooKballs ($9.14 in chips)
Seat 2: Wooly510 ($4.83 in chips)
Seat 3: dcami_nj ($6.39 in chips)
Seat 4: richy5742 ($4.23 in chips)
Seat 5: stock501402 ($10.50 in chips)
Seat 6: PlayTheBlues4U ($6.28 in chips)
richy5742: posts small blind $0.02
stock501402: posts big blind $0.05
*** HOLE CARDS ***
Dealt to PlayTheBlues4U [4s Js]
PlayTheBlues4U: folds
KooKballs: folds
Wooly510: folds
dcami_nj: raises $0.10 to $0.15
richy5742: calls $0.13
stock501402: calls $0.10
*** FLOP *** [Ad 6s Jd]
richy5742: checks
stock501402: bets $0.05
dcami_nj: calls $0.05
richy5742: calls $0.05
*** TURN *** [Ad 6s Jd] [Ks]
richy5742: checks
stock501402: checks
dcami_nj: bets $0.55
richy5742: folds
stock501402: calls $0.55
*** RIVER *** [Ad 6s Jd Ks] [Qs]
stock501402: bets $0.05
dcami_nj: calls $0.05
*** SHOW DOWN ***
stock501402: shows [Kh 8s] (a pair of Kings)
dcami_nj: shows [Kd Jc] (two pair, Kings and Jacks)
dcami_nj collected $1.71 from pot
*** SUMMARY ***
Total pot $1.80 | Rake $0.09
Board [Ad 6s Jd Ks Qs]
Seat 1: KooKballs folded before Flop (didn't bet)
Seat 2: Wooly510 folded before Flop (didn't bet)
Seat 3: dcami_nj (button) showed [Kd Jc] and won ($1.71) with two pair, Kings and Jacks
Seat 4: richy5742 (small blind) folded on the Turn
Seat 5: stock501402 (big blind) showed [Kh 8s] and lost with a pair of Kings
Seat 6: PlayTheBlues4U folded before Flop (didn't bet)


PokerStars Hand #204330102226:  Hold'em No Limit ($0.02/$0.05 USD) - 2019/10/07 20:24:35 ET
Table 'Sculptor' 6-max Seat #6 is the button
Seat 1: cladams73 ($2 in chips)
Seat 2: R@ngers94 ($4.95 in chips)
Seat 3: skillzplumber ($5.89 in chips)
Seat 4: PlayTheBlues4U ($5.58 in chips)
Seat 5: Wooly510 ($7.44 in chips)
Seat 6: DemolishIT ($1.01 in chips)
cladams73: posts small blind $0.02
R@ngers94: posts big blind $0.05
*** HOLE CARDS ***
Dealt to PlayTheBlues4U [Th Kd]
skillzplumber: raises $0.20 to $0.25
PlayTheBlues4U: folds
Wooly510: folds
DemolishIT: folds
cladams73: calls $0.23
R@ngers94: folds
*** FLOP *** [5c 4d 6d]
cladams73: bets $1.75 and is all-in
skillzplumber: calls $1.75
*** TURN *** [5c 4d 6d] [9s]
*** RIVER *** [5c 4d 6d 9s] [Ah]
*** SHOW DOWN ***
cladams73: shows [2d 3s] (a straight, Deuce to Six)
skillzplumber: shows [8c 8d] (a pair of Eights)
cladams73 collected $3.85 from pot
*** SUMMARY ***
Total pot $4.05 | Rake $0.20
Board [5c 4d 6d 9s Ah]
Seat 1: cladams73 (small blind) showed [2d 3s] and won ($3.85) with a straight, Deuce to Six
Seat 2: R@ngers94 (big blind) folded before Flop
Seat 3: skillzplumber showed [8c 8d] and lost with a pair of Eights
Seat 4: PlayTheBlues4U folded before Flop (didn't bet)
Seat 5: Wooly510 folded before Flop (didn't bet)
Seat 6: DemolishIT (button) folded before Flop (didn't bet)


PokerStars Hand #204330102128:  Hold'em No Limit ($0.02/$0.05 USD) - 2019/10/07 20:23:59 ET
Table 'Fides' 6-max Seat #2 is the button
Seat 1: KooKballs ($9.14 in chips)
Seat 2: Wooly510 ($4.83 in chips)
Seat 3: dcami_nj ($4.99 in chips)
Seat 4: richy5742 ($4.28 in chips)
Seat 5: stock501402 ($12 in chips)
Seat 6: PlayTheBlues4U ($6.28 in chips)
dcami_nj: posts small blind $0.02
richy5742: posts big blind $0.05
*** HOLE CARDS ***
Dealt to PlayTheBlues4U [3c Qc]
stock501402: calls $0.05
PlayTheBlues4U: folds
KooKballs: folds
Wooly510: folds
dcami_nj: calls $0.03
richy5742: checks
*** FLOP *** [3d 4c 3h]
dcami_nj: checks
richy5742: checks
stock501402: bets $0.05
dcami_nj: calls $0.05
richy5742: folds
*** TURN *** [3d 4c 3h] [9d]
dcami_nj: checks
stock501402: bets $0.10
dcami_nj: raises $0.30 to $0.40
stock501402: calls $0.30
*** RIVER *** [3d 4c 3h 9d] [Kc]
dcami_nj: bets $1
stock501402: calls $1
*** SHOW DOWN ***
dcami_nj: shows [3s 6d] (three of a kind, Threes)
stock501402: mucks hand
dcami_nj collected $2.90 from pot
*** SUMMARY ***
Total pot $3.05 | Rake $0.15
Board [3d 4c 3h 9d Kc]
Seat 1: KooKballs folded before Flop (didn't bet)
Seat 2: Wooly510 (button) folded before Flop (didn't bet)
Seat 3: dcami_nj (small blind) showed [3s 6d] and won ($2.90) with three of a kind, Threes
Seat 4: richy5742 (big blind) folded on the Flop
Seat 5: stock501402 mucked [Tc Th]
Seat 6: PlayTheBlues4U folded before Flop (didn't bet)


PokerStars Hand #204330102095:  Hold'em No Limit ($0.02/$0.05 USD) - 2019/10/07 20:23:46 ET
Table 'Sculptor' 6-max Seat #5 is the button
Seat 1: cladams73 ($2.15 in chips)
Seat 2: R@ngers94 ($5 in chips)
Seat 3: skillzplumber ($5.89 in chips)
Seat 4: PlayTheBlues4U ($4.55 in chips)
Seat 5: Wooly510 ($7.59 in chips)
Seat 6: DemolishIT ($1.78 in chips)
DemolishIT: posts small blind $0.02
cladams73: posts big blind $0.05
R@ngers94: posts big blind $0.05
*** HOLE CARDS ***
Dealt to PlayTheBlues4U [Td Th]
R@ngers94: checks
skillzplumber: folds
PlayTheBlues4U: raises $0.10 to $0.15
Wooly510: calls $0.15
DemolishIT: calls $0.13
cladams73: calls $0.10
R@ngers94: folds
*** FLOP *** [4s 6h 8c]
DemolishIT: bets $0.62
cladams73: folds
PlayTheBlues4U: calls $0.62
Wooly510: folds
*** TURN *** [4s 6h 8c] [2d]
DemolishIT: checks
PlayTheBlues4U: bets $1.80
DemolishIT: folds
Uncalled bet ($1.80) returned to PlayTheBlues4U
PlayTheBlues4U collected $1.80 from pot
PlayTheBlues4U: doesn't show hand
*** SUMMARY ***
Total pot $1.89 | Rake $0.09
Board [4s 6h 8c 2d]
Seat 1: cladams73 (big blind) folded on the Flop
Seat 2: R@ngers94 folded before Flop (didn't bet)
Seat 3: skillzplumber folded before Flop (didn't bet)
Seat 4: PlayTheBlues4U collected ($1.80)
Seat 5: Wooly510 (button) folded on the Flop
Seat 6: DemolishIT (small blind) folded on the Turn


PokerStars Hand #204330102040:  Hold'em No Limit ($0.02/$0.05 USD) - 2019/10/07 20:23:22 ET
Table 'Sculptor' 6-max Seat #4 is the button
Seat 1: cladams73 ($2.15 in chips)
Seat 3: skillzplumber ($5.89 in chips)
Seat 4: PlayTheBlues4U ($4.70 in chips)
Seat 5: Wooly510 ($7.61 in chips)
Seat 6: DemolishIT ($1.63 in chips)
Wooly510: posts small blind $0.02
DemolishIT: posts big blind $0.05
*** HOLE CARDS ***
Dealt to PlayTheBlues4U [Ad 4c]
cladams73: folds
skillzplumber: folds
R@ngers94 joins the table at seat #2
PlayTheBlues4U: raises $0.10 to $0.15
Wooly510: folds
DemolishIT: calls $0.10
*** FLOP *** [Kd Qc Th]
DemolishIT: checks
PlayTheBlues4U: checks
*** TURN *** [Kd Qc Th] [Td]
DemolishIT: checks
PlayTheBlues4U: checks
*** RIVER *** [Kd Qc Th Td] [5c]
DemolishIT: checks
PlayTheBlues4U: checks
*** SHOW DOWN ***
DemolishIT: shows [Qd 7d] (two pair, Queens and Tens)
PlayTheBlues4U: mucks hand
DemolishIT collected $0.30 from pot
*** SUMMARY ***
Total pot $0.32 | Rake $0.02
Board [Kd Qc Th Td 5c]
Seat 1: cladams73 folded before Flop (didn't bet)
Seat 3: skillzplumber folded before Flop (didn't bet)
Seat 4: PlayTheBlues4U (button) mucked [Ad 4c]
Seat 5: Wooly510 (small blind) folded before Flop
Seat 6: DemolishIT (big blind) showed [Qd 7d] and won ($0.30) with two pair, Queens and Tens


PokerStars Hand #204330101962:  Hold'em No Limit ($0.02/$0.05 USD) - 2019/10/07 20:22:51 ET
Table 'Fides' 6-max Seat #1 is the button
Seat 1: KooKballs ($8.82 in chips)
Seat 2: Wooly510 ($4.88 in chips)
Seat 3: dcami_nj ($5.09 in chips)
Seat 4: richy5742 ($4.28 in chips)
Seat 5: stock501402 ($12.20 in chips)
Seat 6: PlayTheBlues4U ($6.28 in chips)
Wooly510: posts small blind $0.02
dcami_nj: posts big blind $0.05
*** HOLE CARDS ***
Dealt to PlayTheBlues4U [7c Jd]
richy5742: folds
stock501402: calls $0.05
PlayTheBlues4U: folds
KooKballs: calls $0.05
Wooly510: calls $0.03
dcami_nj: checks
*** FLOP *** [2s 3d Jc]
Wooly510: checks
dcami_nj: checks
stock501402: checks
KooKballs: bets $0.05
Wooly510: folds
dcami_nj: calls $0.05
stock501402: calls $0.05
*** TURN *** [2s 3d Jc] [Jh]
dcami_nj: checks
stock501402: checks
KooKballs: bets $0.10
dcami_nj: folds
stock501402: calls $0.10
*** RIVER *** [2s 3d Jc Jh] [Kd]
stock501402: checks
KooKballs: checks
*** SHOW DOWN ***
stock501402: shows [5c 7d] (a pair of Jacks)
KooKballs: shows [3s Ah] (two pair, Jacks and Threes)
KooKballs collected $0.52 from pot
*** SUMMARY ***
Total pot $0.55 | Rake $0.03
Board [2s 3d Jc Jh Kd]
Seat 1: KooKballs (button) showed [3s Ah] and won ($0.52) with two pair, Jacks and Threes
Seat 2: Wooly510 (small blind) folded on the Flop
Seat 3: dcami_nj (big blind) folded on the Turn
Seat 4: richy5742 folded before Flop (didn't bet)
Seat 5: stock501402 showed [5c 7d] and lost with a pair of Jacks
Seat 6: PlayTheBlues4U folded before Flop (didn't bet)


PokerStars Hand #204330101931:  Hold'em No Limit ($0.02/$0.05 USD) - 2019/10/07 20:22:38 ET
Table 'Sculptor' 6-max Seat #3 is the button
Seat 1: cladams73 ($2.15 in chips)
Seat 3: skillzplumber ($5.89 in chips)
Seat 4: PlayTheBlues4U ($4.72 in chips)
Seat 5: Wooly510 ($7.71 in chips)
Seat 6: DemolishIT ($1.52 in chips)
PlayTheBlues4U: posts small blind $0.02
Wooly510: posts big blind $0.05
*** HOLE CARDS ***
Dealt to PlayTheBlues4U [2c 4d]
DemolishIT: calls $0.05
cladams73: folds
skillzplumber: folds
PlayTheBlues4U: folds
Wooly510: checks
*** FLOP *** [Ac Qs 3d]
Wooly510: checks
DemolishIT: checks
*** TURN *** [Ac Qs 3d] [Ad]
Wooly510: checks
DemolishIT: checks
*** RIVER *** [Ac Qs 3d Ad] [As]
Wooly510: bets $0.05
DemolishIT: raises $0.10 to $0.15
Wooly510: folds
Uncalled bet ($0.10) returned to DemolishIT
DemolishIT collected $0.21 from pot
DemolishIT: doesn't show hand
*** SUMMARY ***
Total pot $0.22 | Rake $0.01
Board [Ac Qs 3d Ad As]
Seat 1: cladams73 folded before Flop (didn't bet)
Seat 3: skillzplumber (button) folded before Flop (didn't bet)
Seat 4: PlayTheBlues4U (small blind) folded before Flop
Seat 5: Wooly510 (big blind) folded on the River
Seat 6: DemolishIT collected ($0.21)


PokerStars Hand #204330101839:  Hold'em No Limit ($0.02/$0.05 USD) - 2019/10/07 20:22:02 ET
Table 'Sculptor' 6-max Seat #1 is the button
Seat 1: cladams73 ($2.15 in chips)
Seat 3: skillzplumber ($6.04 in chips)
Seat 4: PlayTheBlues4U ($4.77 in chips)
Seat 5: Wooly510 ($7.38 in chips)
Seat 6: DemolishIT ($1.67 in chips)
skillzplumber: posts small blind $0.02
PlayTheBlues4U: posts big blind $0.05
*** HOLE CARDS ***
Dealt to PlayTheBlues4U [Ks Ad]
Wooly510: raises $0.10 to $0.15
DemolishIT: calls $0.15
cladams73: folds
skillzplumber: calls $0.13
PlayTheBlues4U: folds
*** FLOP *** [9s 6c Qs]
skillzplumber: checks
Wooly510: bets $0.36
DemolishIT: folds
skillzplumber: folds
Uncalled bet ($0.36) returned to Wooly510
Wooly510 collected $0.48 from pot
Wooly510: doesn't show hand
*** SUMMARY ***
Total pot $0.50 | Rake $0.02
Board [9s 6c Qs]
Seat 1: cladams73 (button) folded before Flop (didn't bet)
Seat 3: skillzplumber (small blind) folded on the Flop
Seat 4: PlayTheBlues4U (big blind) folded before Flop
Seat 5: Wooly510 collected ($0.48)
Seat 6: DemolishIT folded on the Flop


PokerStars Hand #204330101818:  Hold'em No Limit ($0.02/$0.05 USD) - 2019/10/07 20:21:55 ET
Table 'Sculptor' 6-max Seat #6 is the button
Seat 1: cladams73 ($2.17 in chips)
Seat 3: skillzplumber ($6.02 in chips)
Seat 4: PlayTheBlues4U ($4.77 in chips)
Seat 5: Wooly510 ($7.38 in chips)
Seat 6: DemolishIT ($1.67 in chips)
cladams73: posts small blind $0.02
skillzplumber: posts big blind $0.05
*** HOLE CARDS ***
Dealt to PlayTheBlues4U [6s 2h]
PlayTheBlues4U: folds
Wooly510: folds
DemolishIT: folds
cladams73: folds
Uncalled bet ($0.03) returned to skillzplumber
skillzplumber collected $0.04 from pot
*** SUMMARY ***
Total pot $0.04 | Rake $0
Seat 1: cladams73 (small blind) folded before Flop
Seat 3: skillzplumber (big blind) collected ($0.04)
Seat 4: PlayTheBlues4U folded before Flop (didn't bet)
Seat 5: Wooly510 folded before Flop (didn't bet)
Seat 6: DemolishIT (button) folded before Flop (didn't bet)


PokerStars Hand #204330101781:  Hold'em No Limit ($0.02/$0.05 USD) - 2019/10/07 20:21:41 ET
Table 'Fides' 6-max Seat #6 is the button
Seat 1: KooKballs ($8.59 in chips)
Seat 2: Wooly510 ($4.93 in chips)
Seat 3: dcami_nj ($5.09 in chips)
Seat 4: richy5742 ($4.28 in chips)
Seat 5: stock501402 ($12.35 in chips)
Seat 6: PlayTheBlues4U ($6.33 in chips)
KooKballs: posts small blind $0.02
Wooly510: posts big blind $0.05
*** HOLE CARDS ***
Dealt to PlayTheBlues4U [Kh 8h]
dcami_nj: folds
richy5742: folds
stock501402: calls $0.05
PlayTheBlues4U: calls $0.05
KooKballs: calls $0.03
Wooly510: checks
*** FLOP *** [Td 6c Tc]
KooKballs: checks
Wooly510: checks
stock501402: checks
PlayTheBlues4U: checks
*** TURN *** [Td 6c Tc] [Qh]
KooKballs: bets $0.05
Wooly510: folds
stock501402: calls $0.05
PlayTheBlues4U: folds
*** RIVER *** [Td 6c Tc Qh] [9c]
KooKballs: bets $0.05
stock501402: calls $0.05
*** SHOW DOWN ***
KooKballs: shows [Qs Kd] (two pair, Queens and Tens)
stock501402: mucks hand
KooKballs collected $0.38 from pot
*** SUMMARY ***
Total pot $0.40 | Rake $0.02
Board [Td 6c Tc Qh 9c]
Seat 1: KooKballs (small blind) showed [Qs Kd] and won ($0.38) with two pair, Queens and Tens
Seat 2: Wooly510 (big blind) folded on the Turn
Seat 3: dcami_nj folded before Flop (didn't bet)
Seat 4: richy5742 folded before Flop (didn't bet)
Seat 5: stock501402 mucked [5h 2h]
Seat 6: PlayTheBlues4U (button) folded on the Turn


PokerStars Hand #204330101676:  Hold'em No Limit ($0.02/$0.05 USD) - 2019/10/07 20:21:03 ET
Table 'Sculptor' 6-max Seat #5 is the button
Seat 1: cladams73 ($2.22 in chips)
Seat 3: skillzplumber ($6.17 in chips)
Seat 4: PlayTheBlues4U ($4.77 in chips)
Seat 5: Wooly510 ($5.95 in chips)
Seat 6: DemolishIT ($3.05 in chips)
DemolishIT: posts small blind $0.02
cladams73: posts big blind $0.05
*** HOLE CARDS ***
Dealt to PlayTheBlues4U [Td Ac]
skillzplumber: raises $0.10 to $0.15
PlayTheBlues4U: folds
Wooly510: calls $0.15
DemolishIT: calls $0.13
cladams73: folds
*** FLOP *** [Jh As Kc]
DemolishIT: checks
skillzplumber: checks
Wooly510: bets $0.36
DemolishIT: calls $0.36
skillzplumber: folds
*** TURN *** [Jh As Kc] [6c]
DemolishIT: checks
Wooly510: bets $0.87
DemolishIT: calls $0.87
*** RIVER *** [Jh As Kc 6c] [5d]
DemolishIT: checks
Wooly510: bets $1.41
DemolishIT: folds
Uncalled bet ($1.41) returned to Wooly510
Wooly510 collected $2.81 from pot
Wooly510: doesn't show hand
*** SUMMARY ***
Total pot $2.96 | Rake $0.15
Board [Jh As Kc 6c 5d]
Seat 1: cladams73 (big blind) folded before Flop
Seat 3: skillzplumber folded on the Flop
Seat 4: PlayTheBlues4U folded before Flop (didn't bet)
Seat 5: Wooly510 (button) collected ($2.81)
Seat 6: DemolishIT (small blind) folded on the River


PokerStars Hand #204330101626:  Hold'em No Limit ($0.02/$0.05 USD) - 2019/10/07 20:20:46 ET
Table 'Fides' 6-max Seat #5 is the button
Seat 1: KooKballs ($8 in chips)
Seat 3: dcami_nj ($5.09 in chips)
Seat 4: richy5742 ($4.28 in chips)
Seat 5: stock501402 ($12.35 in chips)
Seat 6: PlayTheBlues4U ($6.98 in chips)
PlayTheBlues4U: posts small blind $0.02
KooKballs: posts big blind $0.05
Wooly510: sits out
*** HOLE CARDS ***
Dealt to PlayTheBlues4U [7s Ac]
dcami_nj: folds
richy5742: folds
stock501402: folds
PlayTheBlues4U: raises $0.10 to $0.15
KooKballs: calls $0.10
*** FLOP *** [3c Ts Jc]
PlayTheBlues4U: checks
KooKballs: bets $0.15
PlayTheBlues4U: calls $0.15
*** TURN *** [3c Ts Jc] [5s]
PlayTheBlues4U: checks
KooKballs: checks
*** RIVER *** [3c Ts Jc 5s] [Js]
PlayTheBlues4U: bets $0.35
KooKballs: calls $0.35
*** SHOW DOWN ***
PlayTheBlues4U: shows [7s Ac] (a pair of Jacks)
KooKballs: shows [2h 3d] (two pair, Jacks and Threes)
KooKballs collected $1.24 from pot
*** SUMMARY ***
Total pot $1.30 | Rake $0.06
Board [3c Ts Jc 5s Js]
Seat 1: KooKballs (big blind) showed [2h 3d] and won ($1.24) with two pair, Jacks and Threes
Seat 3: dcami_nj folded before Flop (didn't bet)
Seat 4: richy5742 folded before Flop (didn't bet)
Seat 5: stock501402 (button) folded before Flop (didn't bet)
Seat 6: PlayTheBlues4U (small blind) showed [7s Ac] and lost with a pair of Jacks


PokerStars Hand #204330101581:  Hold'em No Limit ($0.02/$0.05 USD) - 2019/10/07 20:20:29 ET
Table 'Sculptor' 6-max Seat #4 is the button
Seat 1: cladams73 ($1.93 in chips)
Seat 3: skillzplumber ($6.17 in chips)
Seat 4: PlayTheBlues4U ($5.02 in chips)
Seat 5: Wooly510 ($5.97 in chips)
Seat 6: DemolishIT ($3.10 in chips)
Wooly510: posts small blind $0.02
DemolishIT: posts big blind $0.05
*** HOLE CARDS ***
Dealt to PlayTheBlues4U [Qh Ah]
cladams73: calls $0.05
skillzplumber: folds
PlayTheBlues4U: raises $0.15 to $0.20
Wooly510: folds
DemolishIT: folds
cladams73: calls $0.15
*** FLOP *** [4s 5c 6c]
cladams73: bets $0.05
PlayTheBlues4U: calls $0.05
*** TURN *** [4s 5c 6c] [Js]
cladams73: bets $0.15
PlayTheBlues4U: folds
Uncalled bet ($0.15) returned to cladams73
cladams73 collected $0.54 from pot
cladams73: doesn't show hand
*** SUMMARY ***
Total pot $0.57 | Rake $0.03
Board [4s 5c 6c Js]
Seat 1: cladams73 collected ($0.54)
Seat 3: skillzplumber folded before Flop (didn't bet)
Seat 4: PlayTheBlues4U (button) folded on the Turn
Seat 5: Wooly510 (small blind) folded before Flop
Seat 6: DemolishIT (big blind) folded before Flop


PokerStars Hand #204330101539:  Hold'em No Limit ($0.02/$0.05 USD) - 2019/10/07 20:20:13 ET
Table 'Sculptor' 6-max Seat #3 is the button
Seat 1: cladams73 ($1.86 in chips)
Seat 2: Star6543 ($4.52 in chips)
Seat 3: skillzplumber ($6.17 in chips)
Seat 4: PlayTheBlues4U ($5.04 in chips)
Seat 5: Wooly510 ($6.02 in chips)
Seat 6: DemolishIT ($3.10 in chips)
PlayTheBlues4U: posts small blind $0.02
Wooly510: posts big blind $0.05
*** HOLE CARDS ***
Dealt to PlayTheBlues4U [7s 3c]
DemolishIT: folds
cladams73: raises $0.10 to $0.15
Star6543: folds
Star6543 leaves the table
skillzplumber: folds
PlayTheBlues4U: folds
Wooly510: folds
Uncalled bet ($0.10) returned to cladams73
cladams73 collected $0.12 from pot
*** SUMMARY ***
Total pot $0.12 | Rake $0
Seat 1: cladams73 collected ($0.12)
Seat 2: Star6543 folded before Flop (didn't bet)
Seat 3: skillzplumber (button) folded before Flop (didn't bet)
Seat 4: PlayTheBlues4U (small blind) folded before Flop
Seat 5: Wooly510 (big blind) folded before Flop
Seat 6: DemolishIT folded before Flop (didn't bet)


PokerStars Hand #204330101460:  Hold'em No Limit ($0.02/$0.05 USD) - 2019/10/07 20:19:44 ET
Table 'Fides' 6-max Seat #4 is the button
Seat 1: KooKballs ($8 in chips)
Seat 3: dcami_nj ($5.09 in chips)
Seat 4: richy5742 ($4.43 in chips)
Seat 5: stock501402 ($12.37 in chips)
Seat 6: PlayTheBlues4U ($6.83 in chips)
stock501402: posts small blind $0.02
PlayTheBlues4U: posts big blind $0.05
*** HOLE CARDS ***
Dealt to PlayTheBlues4U [Qs Jh]
KooKballs: folds
dcami_nj has timed out
dcami_nj: folds
richy5742: calls $0.05
stock501402: folds
PlayTheBlues4U: checks
*** FLOP *** [9d Td Ac]
PlayTheBlues4U: checks
richy5742: bets $0.10
PlayTheBlues4U: calls $0.10
*** TURN *** [9d Td Ac] [4c]
PlayTheBlues4U: checks
richy5742: checks
*** RIVER *** [9d Td Ac 4c] [Js]
PlayTheBlues4U: checks
richy5742: checks
*** SHOW DOWN ***
PlayTheBlues4U: shows [Qs Jh] (a pair of Jacks)
richy5742: mucks hand
PlayTheBlues4U collected $0.30 from pot
*** SUMMARY ***
Total pot $0.32 | Rake $0.02
Board [9d Td Ac 4c Js]
Seat 1: KooKballs folded before Flop (didn't bet)
Seat 3: dcami_nj folded before Flop (didn't bet)
Seat 4: richy5742 (button) mucked [7h 4h]
Seat 5: stock501402 (small blind) folded before Flop
Seat 6: PlayTheBlues4U (big blind) showed [Qs Jh] and won ($0.30) with a pair of Jacks


PokerStars Hand #204330101451:  Hold'em No Limit ($0.02/$0.05 USD) - 2019/10/07 20:19:40 ET
Table 'Sculptor' 6-max Seat #2 is the button
Seat 1: cladams73 ($1.86 in chips)
Seat 2: Star6543 ($4.19 in chips)
Seat 3: skillzplumber ($6.19 in chips)
Seat 4: PlayTheBlues4U ($5.39 in chips)
Seat 6: DemolishIT ($3.10 in chips)
skillzplumber: posts small blind $0.02
PlayTheBlues4U: posts big blind $0.05
*** HOLE CARDS ***
Dealt to PlayTheBlues4U [8h 6c]
DemolishIT: folds
cladams73: folds
Star6543: calls $0.05
skillzplumber: folds
PlayTheBlues4U: checks
*** FLOP *** [9s 9c 3h]
PlayTheBlues4U: bets $0.10
Star6543: calls $0.10
*** TURN *** [9s 9c 3h] [Qd]
PlayTheBlues4U: bets $0.20
Star6543: raises $0.20 to $0.40
PlayTheBlues4U: folds
Uncalled bet ($0.20) returned to Star6543
Star6543 collected $0.68 from pot
Star6543: doesn't show hand
*** SUMMARY ***
Total pot $0.72 | Rake $0.04
Board [9s 9c 3h Qd]
Seat 1: cladams73 folded before Flop (didn't bet)
Seat 2: Star6543 (button) collected ($0.68)
Seat 3: skillzplumber (small blind) folded before Flop
Seat 4: PlayTheBlues4U (big blind) folded on the Turn
Seat 6: DemolishIT folded before Flop (didn't bet)


PokerStars Hand #204330101413:  Hold'em No Limit ($0.02/$0.05 USD) - 2019/10/07 20:19:26 ET
Table 'Sculptor' 6-max Seat #1 is the button
Seat 1: cladams73 ($1.86 in chips)
Seat 2: Star6543 ($4.14 in chips)
Seat 3: skillzplumber ($6.24 in chips)
Seat 4: PlayTheBlues4U ($5.39 in chips)
Seat 6: DemolishIT ($3.10 in chips)
Star6543: posts small blind $0.02
skillzplumber: posts big blind $0.05
*** HOLE CARDS ***
Dealt to PlayTheBlues4U [5h Kd]
PlayTheBlues4U: folds
DemolishIT: folds
cladams73: folds
Star6543: calls $0.03
skillzplumber: checks
*** FLOP *** [9s 2h Qs]
Star6543: bets $0.05
skillzplumber: folds
Uncalled bet ($0.05) returned to Star6543
Star6543 collected $0.10 from pot
Star6543: doesn't show hand
*** SUMMARY ***
Total pot $0.10 | Rake $0
Board [9s 2h Qs]
Seat 1: cladams73 (button) folded before Flop (didn't bet)
Seat 2: Star6543 (small blind) collected ($0.10)
Seat 3: skillzplumber (big blind) folded on the Flop
Seat 4: PlayTheBlues4U folded before Flop (didn't bet)
Seat 6: DemolishIT folded before Flop (didn't bet)


PokerStars Hand #204330101397:  Hold'em No Limit ($0.02/$0.05 USD) - 2019/10/07 20:19:19 ET
Table 'Fides' 6-max Seat #3 is the button
Seat 1: KooKballs ($8 in chips)
Seat 3: dcami_nj ($5.09 in chips)
Seat 4: richy5742 ($4.48 in chips)
Seat 5: stock501402 ($12.32 in chips)
Seat 6: PlayTheBlues4U ($6.83 in chips)
richy5742: posts small blind $0.02
stock501402: posts big blind $0.05
*** HOLE CARDS ***
Dealt to PlayTheBlues4U [7s Qd]
PlayTheBlues4U: folds
KooKballs: folds
dcami_nj: folds
richy5742: calls $0.03
stock501402: checks
*** FLOP *** [5s Qc 5d]
richy5742: checks
stock501402: bets $0.05
richy5742: folds
Uncalled bet ($0.05) returned to stock501402
stock501402 collected $0.10 from pot
stock501402: doesn't show hand
*** SUMMARY ***
Total pot $0.10 | Rake $0
Board [5s Qc 5d]
Seat 1: KooKballs folded before Flop (didn't bet)
Seat 3: dcami_nj (button) folded before Flop (didn't bet)
Seat 4: richy5742 (small blind) folded on the Flop
Seat 5: stock501402 (big blind) collected ($0.10)
Seat 6: PlayTheBlues4U folded before Flop (didn't bet)


PokerStars Hand #204330101387:  Hold'em No Limit ($0.02/$0.05 USD) - 2019/10/07 20:19:16 ET
Table 'Sculptor' 6-max Seat #6 is the button
Seat 1: cladams73 ($1.81 in chips)
Seat 2: Star6543 ($4.19 in chips)
Seat 3: skillzplumber ($6.24 in chips)
Seat 4: PlayTheBlues4U ($5.39 in chips)
Seat 6: DemolishIT ($3.10 in chips)
cladams73: posts small blind $0.02
Star6543: posts big blind $0.05
*** HOLE CARDS ***
Dealt to PlayTheBlues4U [5h 3s]
skillzplumber: folds
PlayTheBlues4U: folds
DemolishIT: folds
cladams73: raises $0.10 to $0.15
Star6543: folds
Uncalled bet ($0.10) returned to cladams73
cladams73 collected $0.10 from pot
*** SUMMARY ***
Total pot $0.10 | Rake $0
Seat 1: cladams73 (small blind) collected ($0.10)
Seat 2: Star6543 (big blind) folded before Flop
Seat 3: skillzplumber folded before Flop (didn't bet)
Seat 4: PlayTheBlues4U folded before Flop (didn't bet)
Seat 6: DemolishIT (button) folded before Flop (didn't bet)


PokerStars Hand #204330101312:  Hold'em No Limit ($0.02/$0.05 USD) - 2019/10/07 20:18:43 ET
Table 'Fides' 6-max Seat #1 is the button
Seat 1: KooKballs ($7.93 in chips)
Seat 3: dcami_nj ($5.11 in chips)
Seat 4: richy5742 ($4.53 in chips)
Seat 5: stock501402 ($12.32 in chips)
Seat 6: PlayTheBlues4U ($6.83 in chips)
dcami_nj: posts small blind $0.02
richy5742: posts big blind $0.05
*** HOLE CARDS ***
Dealt to PlayTheBlues4U [9h 3s]
stock501402 has timed out
stock501402: folds
PlayTheBlues4U: folds
KooKballs: raises $0.10 to $0.15
dcami_nj: folds
richy5742: folds
Uncalled bet ($0.10) returned to KooKballs
KooKballs collected $0.12 from pot
KooKballs: doesn't show hand
*** SUMMARY ***
Total pot $0.12 | Rake $0
Seat 1: KooKballs (button) collected ($0.12)
Seat 3: dcami_nj (small blind) folded before Flop
Seat 4: richy5742 (big blind) folded before Flop
Seat 5: stock501402 folded before Flop (didn't bet)
Seat 6: PlayTheBlues4U folded before Flop (didn't bet)


PokerStars Hand #204330101230:  Hold'em No Limit ($0.02/$0.05 USD) - 2019/10/07 20:18:14 ET
Table 'Sculptor' 6-max Seat #4 is the button
Seat 1: cladams73 ($2.16 in chips)
Seat 2: Star6543 ($4.24 in chips)
Seat 3: skillzplumber ($6.94 in chips)
Seat 4: PlayTheBlues4U ($5.74 in chips)
Seat 6: DemolishIT ($1.76 in chips)
DemolishIT: posts small blind $0.02
cladams73: posts big blind $0.05
*** HOLE CARDS ***
Dealt to PlayTheBlues4U [Ac 5c]
Star6543: calls $0.05
skillzplumber: raises $0.10 to $0.15
PlayTheBlues4U: calls $0.15
DemolishIT: calls $0.13
cladams73: raises $0.20 to $0.35
Star6543: folds
skillzplumber: calls $0.20
PlayTheBlues4U: calls $0.20
DemolishIT: calls $0.20
*** FLOP *** [8h 7h 2h]
DemolishIT: checks
cladams73: checks
skillzplumber: checks
PlayTheBlues4U: checks
*** TURN *** [8h 7h 2h] [4c]
DemolishIT: checks
cladams73: checks
skillzplumber: bets $0.35
PlayTheBlues4U: folds
DemolishIT: calls $0.35
cladams73: folds
*** RIVER *** [8h 7h 2h 4c] [5h]
DemolishIT: checks
skillzplumber: checks
*** SHOW DOWN ***
DemolishIT: shows [Kh 9d] (a flush, King high)
skillzplumber: mucks hand
DemolishIT collected $2.04 from pot
*** SUMMARY ***
Total pot $2.15 | Rake $0.11
Board [8h 7h 2h 4c 5h]
Seat 1: cladams73 (big blind) folded on the Turn
Seat 2: Star6543 folded before Flop
Seat 3: skillzplumber mucked [3s 3d]
Seat 4: PlayTheBlues4U (button) folded on the Turn
Seat 6: DemolishIT (small blind) showed [Kh 9d] and won ($2.04) with a flush, King high


PokerStars Hand #204330101222:  Hold'em No Limit ($0.02/$0.05 USD) - 2019/10/07 20:18:10 ET
Table 'Fides' 6-max Seat #6 is the button
Seat 1: KooKballs ($7.95 in chips)
Seat 3: dcami_nj ($5 in chips)
Seat 4: richy5742 ($4.63 in chips)
Seat 5: stock501402 ($12.32 in chips)
Seat 6: PlayTheBlues4U ($6.83 in chips)
KooKballs: posts small blind $0.02
dcami_nj: posts big blind $0.05
*** HOLE CARDS ***
Dealt to PlayTheBlues4U [2s 3d]
richy5742: raises $0.05 to $0.10
stock501402: folds
PlayTheBlues4U: folds
KooKballs: folds
dcami_nj: calls $0.05
*** FLOP *** [6s Td 2h]
dcami_nj: checks
richy5742: checks
*** TURN *** [6s Td 2h] [Th]
dcami_nj: bets $0.20
richy5742: folds
Uncalled bet ($0.20) returned to dcami_nj
dcami_nj collected $0.21 from pot
dcami_nj: doesn't show hand
*** SUMMARY ***
Total pot $0.22 | Rake $0.01
Board [6s Td 2h Th]
Seat 1: KooKballs (small blind) folded before Flop
Seat 3: dcami_nj (big blind) collected ($0.21)
Seat 4: richy5742 folded on the Turn
Seat 5: stock501402 folded before Flop (didn't bet)
Seat 6: PlayTheBlues4U (button) folded before Flop (didn't bet)


PokerStars Hand #204330101173:  Hold'em No Limit ($0.02/$0.05 USD) - 2019/10/07 20:17:50 ET
Table 'Fides' 6-max Seat #5 is the button
Seat 1: KooKballs ($7.93 in chips)
Seat 3: dcami_nj ($1.41 in chips)
Seat 4: richy5742 ($4.63 in chips)
Seat 5: stock501402 ($12.32 in chips)
Seat 6: PlayTheBlues4U ($6.85 in chips)
PlayTheBlues4U: posts small blind $0.02
KooKballs: posts big blind $0.05
*** HOLE CARDS ***
Dealt to PlayTheBlues4U [6d 8h]
dcami_nj: folds
richy5742: folds
stock501402: folds
PlayTheBlues4U: folds
Uncalled bet ($0.03) returned to KooKballs
KooKballs collected $0.04 from pot
KooKballs: doesn't show hand
*** SUMMARY ***
Total pot $0.04 | Rake $0
Seat 1: KooKballs (big blind) collected ($0.04)
Seat 3: dcami_nj folded before Flop (didn't bet)
Seat 4: richy5742 folded before Flop (didn't bet)
Seat 5: stock501402 (button) folded before Flop (didn't bet)
Seat 6: PlayTheBlues4U (small blind) folded before Flop


PokerStars Hand #204330101148:  Hold'em No Limit ($0.02/$0.05 USD) - 2019/10/07 20:17:40 ET
Table 'Sculptor' 6-max Seat #3 is the button
Seat 1: cladams73 ($2.41 in chips)
Seat 2: Star6543 ($4.49 in chips)
Seat 3: skillzplumber ($6.94 in chips)
Seat 4: PlayTheBlues4U ($5.23 in chips)
Seat 6: DemolishIT ($1.81 in chips)
PlayTheBlues4U: posts small blind $0.02
DemolishIT: posts big blind $0.05
*** HOLE CARDS ***
Dealt to PlayTheBlues4U [Jd Jh]
cladams73: calls $0.05
Star6543: raises $0.05 to $0.10
skillzplumber: folds
PlayTheBlues4U: raises $0.15 to $0.25
DemolishIT: folds
cladams73: calls $0.20
Star6543: calls $0.15
*** FLOP *** [3d Th 8c]
PlayTheBlues4U: bets $0.60
cladams73: folds
Star6543: folds
Uncalled bet ($0.60) returned to PlayTheBlues4U
PlayTheBlues4U collected $0.76 from pot
PlayTheBlues4U: doesn't show hand
*** SUMMARY ***
Total pot $0.80 | Rake $0.04
Board [3d Th 8c]
Seat 1: cladams73 folded on the Flop
Seat 2: Star6543 folded on the Flop
Seat 3: skillzplumber (button) folded before Flop (didn't bet)
Seat 4: PlayTheBlues4U (small blind) collected ($0.76)
Seat 6: DemolishIT (big blind) folded before Flop


PokerStars Hand #204330101124:  Hold'em No Limit ($0.02/$0.05 USD) - 2019/10/07 20:17:26 ET
Table 'Sculptor' 6-max Seat #2 is the button
Seat 1: cladams73 ($2.61 in chips)
Seat 2: Star6543 ($4.49 in chips)
Seat 3: skillzplumber ($6.71 in chips)
Seat 4: PlayTheBlues4U ($5.28 in chips)
Seat 6: DemolishIT ($1.81 in chips)
skillzplumber: posts small blind $0.02
PlayTheBlues4U: posts big blind $0.05
*** HOLE CARDS ***
Dealt to PlayTheBlues4U [Th Jc]
DemolishIT: folds
cladams73: calls $0.05
Star6543: folds
skillzplumber: raises $0.15 to $0.20
PlayTheBlues4U: folds
cladams73: calls $0.15
*** FLOP *** [Ts 4d As]
skillzplumber: bets $0.35
cladams73: folds
Uncalled bet ($0.35) returned to skillzplumber
skillzplumber collected $0.43 from pot
skillzplumber: doesn't show hand
*** SUMMARY ***
Total pot $0.45 | Rake $0.02
Board [Ts 4d As]
Seat 1: cladams73 folded on the Flop
Seat 2: Star6543 (button) folded before Flop (didn't bet)
Seat 3: skillzplumber (small blind) collected ($0.43)
Seat 4: PlayTheBlues4U (big blind) folded before Flop
Seat 6: DemolishIT folded before Flop (didn't bet)


PokerStars Hand #204330101099:  Hold'em No Limit ($0.02/$0.05 USD) - 2019/10/07 20:17:17 ET
Table 'Sculptor' 6-max Seat #1 is the button
Seat 1: cladams73 ($2.61 in chips)
Seat 2: Star6543 ($4.54 in chips)
Seat 3: skillzplumber ($6.66 in chips)
Seat 4: PlayTheBlues4U ($5.28 in chips)
Seat 6: DemolishIT ($1.81 in chips)
Star6543: posts small blind $0.02
skillzplumber: posts big blind $0.05
*** HOLE CARDS ***
Dealt to PlayTheBlues4U [6c 2d]
PlayTheBlues4U: folds
DemolishIT: folds
cladams73: folds
Star6543: calls $0.03
skillzplumber: raises $6.61 to $6.66 and is all-in
Star6543: folds
Uncalled bet ($6.61) returned to skillzplumber
skillzplumber collected $0.10 from pot
skillzplumber: doesn't show hand
*** SUMMARY ***
Total pot $0.10 | Rake $0
Seat 1: cladams73 (button) folded before Flop (didn't bet)
Seat 2: Star6543 (small blind) folded before Flop
Seat 3: skillzplumber (big blind) collected ($0.10)
Seat 4: PlayTheBlues4U folded before Flop (didn't bet)
Seat 6: DemolishIT folded before Flop (didn't bet)


PokerStars Hand #204330101012:  Hold'em No Limit ($0.02/$0.05 USD) - 2019/10/07 20:16:38 ET
Table 'Sculptor' 6-max Seat #6 is the button
Seat 1: cladams73 ($2.91 in chips)
Seat 2: Star6543 ($4.84 in chips)
Seat 3: skillzplumber ($6.66 in chips)
Seat 4: PlayTheBlues4U ($5.28 in chips)
Seat 6: DemolishIT ($1.25 in chips)
cladams73: posts small blind $0.02
Star6543: posts big blind $0.05
*** HOLE CARDS ***
Dealt to PlayTheBlues4U [Ks 4d]
skillzplumber: folds
PlayTheBlues4U: folds
DemolishIT: raises $0.15 to $0.20
cladams73: calls $0.18
Star6543: calls $0.15
*** FLOP *** [6c 5s 5c]
cladams73: checks
Star6543: bets $0.10
DemolishIT: calls $0.10
cladams73: calls $0.10
*** TURN *** [6c 5s 5c] [8h]
cladams73: checks
Star6543: checks
DemolishIT: bets $0.86
cladams73: folds
Star6543: folds [Tc Ac]
Uncalled bet ($0.86) returned to DemolishIT
DemolishIT collected $0.86 from pot
*** SUMMARY ***
Total pot $0.90 | Rake $0.04
Board [6c 5s 5c 8h]
Seat 1: cladams73 (small blind) folded on the Turn
Seat 2: Star6543 (big blind) folded on the Turn
Seat 3: skillzplumber folded before Flop (didn't bet)
Seat 4: PlayTheBlues4U folded before Flop (didn't bet)
Seat 6: DemolishIT (button) collected ($0.86)


PokerStars Hand #204330101009:  Hold'em No Limit ($0.02/$0.05 USD) - 2019/10/07 20:16:37 ET
Table 'Fides' 6-max Seat #4 is the button
Seat 1: KooKballs ($3.95 in chips)
Seat 3: dcami_nj ($5.36 in chips)
Seat 4: richy5742 ($4.63 in chips)
Seat 5: stock501402 ($12.72 in chips)
Seat 6: PlayTheBlues4U ($6.90 in chips)
stock501402: posts small blind $0.02
PlayTheBlues4U: posts big blind $0.05
*** HOLE CARDS ***
Dealt to PlayTheBlues4U [5c Td]
KooKballs: raises $0.10 to $0.15
dcami_nj: raises $0.25 to $0.40
richy5742: folds
stock501402: calls $0.38
PlayTheBlues4U: folds
KooKballs: calls $0.25
*** FLOP *** [3h 2c Qd]
stock501402: checks
KooKballs: bets $0.75
dcami_nj: calls $0.75
stock501402: folds
*** TURN *** [3h 2c Qd] [Kd]
KooKballs: bets $2.60
dcami_nj: calls $2.60
*** RIVER *** [3h 2c Qd Kd] [5h]
KooKballs: bets $0.20 and is all-in
dcami_nj: calls $0.20
*** SHOW DOWN ***
KooKballs: shows [Qs Ks] (two pair, Kings and Queens)
dcami_nj: shows [Qh Ah] (a pair of Queens)
KooKballs collected $7.93 from pot
*** SUMMARY ***
Total pot $8.35 | Rake $0.42
Board [3h 2c Qd Kd 5h]
Seat 1: KooKballs showed [Qs Ks] and won ($7.93) with two pair, Kings and Queens
Seat 3: dcami_nj showed [Qh Ah] and lost with a pair of Queens
Seat 4: richy5742 (button) folded before Flop (didn't bet)
Seat 5: stock501402 (small blind) folded on the Flop
Seat 6: PlayTheBlues4U (big blind) folded before Flop


PokerStars Hand #204330100958:  Hold'em No Limit ($0.02/$0.05 USD) - 2019/10/07 20:16:15 ET
Table 'Sculptor' 6-max Seat #4 is the button
Seat 1: cladams73 ($2.96 in chips)
Seat 2: Star6543 ($4.84 in chips)
Seat 3: skillzplumber ($6.81 in chips)
Seat 4: PlayTheBlues4U ($5.08 in chips)
Seat 6: DemolishIT ($1.27 in chips)
DemolishIT: posts small blind $0.02
cladams73: posts big blind $0.05
*** HOLE CARDS ***
Dealt to PlayTheBlues4U [9d Jd]
Star6543: folds
skillzplumber: calls $0.05
PlayTheBlues4U: raises $0.10 to $0.15
DemolishIT: folds
cladams73: folds
skillzplumber: calls $0.10
*** FLOP *** [7d Ks 2c]
skillzplumber: checks
PlayTheBlues4U: bets $0.25
skillzplumber: folds
Uncalled bet ($0.25) returned to PlayTheBlues4U
PlayTheBlues4U collected $0.35 from pot
PlayTheBlues4U: doesn't show hand
*** SUMMARY ***
Total pot $0.37 | Rake $0.02
Board [7d Ks 2c]
Seat 1: cladams73 (big blind) folded before Flop
Seat 2: Star6543 folded before Flop (didn't bet)
Seat 3: skillzplumber folded on the Flop
Seat 4: PlayTheBlues4U (button) collected ($0.35)
Seat 6: DemolishIT (small blind) folded before Flop


PokerStars Hand #204330100927:  Hold'em No Limit ($0.02/$0.05 USD) - 2019/10/07 20:16:02 ET
Table 'Fides' 6-max Seat #3 is the button
Seat 1: KooKballs ($4 in chips)
Seat 3: dcami_nj ($5.36 in chips)
Seat 4: richy5742 ($4.68 in chips)
Seat 5: stock501402 ($12.62 in chips)
Seat 6: PlayTheBlues4U ($6.90 in chips)
richy5742: posts small blind $0.02
stock501402: posts big blind $0.05
KooKballs: posts big blind $0.05
*** HOLE CARDS ***
Dealt to PlayTheBlues4U [7c 9c]
PlayTheBlues4U: folds
KooKballs: checks
dcami_nj: folds
richy5742: calls $0.03
stock501402: raises $0.10 to $0.15
KooKballs: folds
richy5742: folds
Uncalled bet ($0.10) returned to stock501402
stock501402 collected $0.15 from pot
stock501402: doesn't show hand
*** SUMMARY ***
Total pot $0.15 | Rake $0
Seat 1: KooKballs folded before Flop (didn't bet)
Seat 3: dcami_nj (button) folded before Flop (didn't bet)
Seat 4: richy5742 (small blind) folded before Flop
Seat 5: stock501402 (big blind) collected ($0.15)
Seat 6: PlayTheBlues4U folded before Flop (didn't bet)


PokerStars Hand #204330100873:  Hold'em No Limit ($0.02/$0.05 USD) - 2019/10/07 20:15:37 ET
Table 'Fides' 6-max Seat #6 is the button
Seat 2: Wooly510 ($4.95 in chips)
Seat 3: dcami_nj ($5.41 in chips)
Seat 4: richy5742 ($4.68 in chips)
Seat 5: stock501402 ($12.62 in chips)
Seat 6: PlayTheBlues4U ($6.83 in chips)
KooKballs will be allowed to play after the button
Wooly510: posts small blind $0.02
dcami_nj: posts big blind $0.05
*** HOLE CARDS ***
Dealt to PlayTheBlues4U [8s 5s]
richy5742: folds
stock501402: folds
PlayTheBlues4U: raises $0.10 to $0.15
Wooly510: folds
dcami_nj: folds
Uncalled bet ($0.10) returned to PlayTheBlues4U
PlayTheBlues4U collected $0.12 from pot
PlayTheBlues4U: doesn't show hand
*** SUMMARY ***
Total pot $0.12 | Rake $0
Seat 2: Wooly510 (small blind) folded before Flop
Seat 3: dcami_nj (big blind) folded before Flop
Seat 4: richy5742 folded before Flop (didn't bet)
Seat 5: stock501402 folded before Flop (didn't bet)
Seat 6: PlayTheBlues4U (button) collected ($0.12)


PokerStars Hand #204330100826:  Hold'em No Limit ($0.02/$0.05 USD) - 2019/10/07 20:15:20 ET
Table 'Sculptor' 6-max Seat #3 is the button
Seat 1: cladams73 ($2.96 in chips)
Seat 2: Star6543 ($5.77 in chips)
Seat 3: skillzplumber ($5.67 in chips)
Seat 4: PlayTheBlues4U ($5.10 in chips)
Seat 5: Wooly510 ($6.07 in chips)
Seat 6: DemolishIT ($1.52 in chips)
PlayTheBlues4U: posts small blind $0.02
Wooly510: posts big blind $0.05
*** HOLE CARDS ***
Dealt to PlayTheBlues4U [7h 4s]
DemolishIT: calls $0.05
cladams73: folds
Star6543: calls $0.05
skillzplumber: raises $0.20 to $0.25
PlayTheBlues4U: folds
Wooly510: folds
DemolishIT: calls $0.20
Star6543: calls $0.20
*** FLOP *** [6d 5s 9c]
DemolishIT: checks
Star6543: bets $0.05
skillzplumber: calls $0.05
DemolishIT: folds
*** TURN *** [6d 5s 9c] [Tc]
Star6543: bets $0.10
skillzplumber: calls $0.10
*** RIVER *** [6d 5s 9c Tc] [Ad]
Star6543: bets $0.53
skillzplumber: calls $0.53
*** SHOW DOWN ***
Star6543: shows [Jd Ks] (high card Ace)
skillzplumber: shows [Jc Ac] (a pair of Aces)
skillzplumber collected $2.07 from pot
*** SUMMARY ***
Total pot $2.18 | Rake $0.11
Board [6d 5s 9c Tc Ad]
Seat 1: cladams73 folded before Flop (didn't bet)
Seat 2: Star6543 showed [Jd Ks] and lost with high card Ace
Seat 3: skillzplumber (button) showed [Jc Ac] and won ($2.07) with a pair of Aces
Seat 4: PlayTheBlues4U (small blind) folded before Flop
Seat 5: Wooly510 (big blind) folded before Flop
Seat 6: DemolishIT folded on the Flop


PokerStars Hand #204330100762:  Hold'em No Limit ($0.02/$0.05 USD) - 2019/10/07 20:14:52 ET
Table 'Sculptor' 6-max Seat #2 is the button
Seat 1: cladams73 ($3.11 in chips)
Seat 2: Star6543 ($5.57 in chips)
Seat 3: skillzplumber ($5.69 in chips)
Seat 4: PlayTheBlues4U ($5.15 in chips)
Seat 5: Wooly510 ($6.07 in chips)
Seat 6: DemolishIT ($1.52 in chips)
skillzplumber: posts small blind $0.02
PlayTheBlues4U: posts big blind $0.05
*** HOLE CARDS ***
Dealt to PlayTheBlues4U [Kc Tc]
Wooly510: folds
DemolishIT: folds
cladams73: calls $0.05
Star6543: calls $0.05
skillzplumber: folds
PlayTheBlues4U: checks
*** FLOP *** [3d 7s 5d]
PlayTheBlues4U: checks
cladams73: bets $0.10
Star6543: calls $0.10
PlayTheBlues4U: folds
*** TURN *** [3d 7s 5d] [4c]
cladams73: checks
Star6543: checks
*** RIVER *** [3d 7s 5d 4c] [8s]
cladams73: checks
Star6543: checks
*** SHOW DOWN ***
cladams73: shows [3s Ac] (a pair of Threes)
Star6543: shows [9s 4s] (a pair of Fours)
Star6543 collected $0.35 from pot
*** SUMMARY ***
Total pot $0.37 | Rake $0.02
Board [3d 7s 5d 4c 8s]
Seat 1: cladams73 showed [3s Ac] and lost with a pair of Threes
Seat 2: Star6543 (button) showed [9s 4s] and won ($0.35) with a pair of Fours
Seat 3: skillzplumber (small blind) folded before Flop
Seat 4: PlayTheBlues4U (big blind) folded on the Flop
Seat 5: Wooly510 folded before Flop (didn't bet)
Seat 6: DemolishIT folded before Flop (didn't bet)


PokerStars Hand #204330100718:  Hold'em No Limit ($0.02/$0.05 USD) - 2019/10/07 20:14:33 ET
Table 'Fides' 6-max Seat #5 is the button
Seat 2: Wooly510 ($5 in chips)
Seat 3: dcami_nj ($5.41 in chips)
Seat 4: richy5742 ($4.27 in chips)
Seat 5: stock501402 ($12.77 in chips)
Seat 6: PlayTheBlues4U ($7.08 in chips)
PlayTheBlues4U: posts small blind $0.02
Wooly510: posts big blind $0.05
*** HOLE CARDS ***
Dealt to PlayTheBlues4U [6d 6h]
dcami_nj: folds
richy5742: raises $0.05 to $0.10
stock501402: calls $0.10
PlayTheBlues4U: calls $0.08
Wooly510: folds
*** FLOP *** [3h As 4d]
PlayTheBlues4U: checks
richy5742: checks
stock501402: bets $0.05
PlayTheBlues4U: calls $0.05
richy5742: calls $0.05
*** TURN *** [3h As 4d] [3d]
KooKballs joins the table at seat #1
PlayTheBlues4U: checks
richy5742: checks
stock501402: checks
*** RIVER *** [3h As 4d 3d] [8s]
PlayTheBlues4U: checks
richy5742: bets $0.10
stock501402: folds
PlayTheBlues4U: calls $0.10
*** SHOW DOWN ***
richy5742: shows [Ad 5c] (two pair, Aces and Threes)
PlayTheBlues4U: mucks hand
richy5742 collected $0.66 from pot
*** SUMMARY ***
Total pot $0.70 | Rake $0.04
Board [3h As 4d 3d 8s]
Seat 2: Wooly510 (big blind) folded before Flop
Seat 3: dcami_nj folded before Flop (didn't bet)
Seat 4: richy5742 showed [Ad 5c] and won ($0.66) with two pair, Aces and Threes
Seat 5: stock501402 (button) folded on the River
Seat 6: PlayTheBlues4U (small blind) mucked [6d 6h]


PokerStars Hand #204330100710:  Hold'em No Limit ($0.02/$0.05 USD) - 2019/10/07 20:14:30 ET
Table 'Sculptor' 6-max Seat #1 is the button
Seat 1: cladams73 ($3.26 in chips)
Seat 2: Star6543 ($5.77 in chips)
Seat 3: skillzplumber ($5.74 in chips)
Seat 4: PlayTheBlues4U ($4.78 in chips)
Seat 5: Wooly510 ($6.07 in chips)
Seat 6: DemolishIT ($1.52 in chips)
Star6543: posts small blind $0.02
skillzplumber: posts big blind $0.05
*** HOLE CARDS ***
Dealt to PlayTheBlues4U [Kd Jd]
PlayTheBlues4U: raises $0.10 to $0.15
Wooly510: folds
DemolishIT: folds
cladams73: calls $0.15
Star6543: calls $0.13
skillzplumber: folds
*** FLOP *** [Ks 5c 7s]
Star6543: bets $0.05
skillzplumber said, "whatever  tht means"
PlayTheBlues4U: raises $0.35 to $0.40
cladams73: folds
Star6543: folds
Uncalled bet ($0.35) returned to PlayTheBlues4U
PlayTheBlues4U collected $0.57 from pot
PlayTheBlues4U: doesn't show hand
*** SUMMARY ***
Total pot $0.60 | Rake $0.03
Board [Ks 5c 7s]
Seat 1: cladams73 (button) folded on the Flop
Seat 2: Star6543 (small blind) folded on the Flop
Seat 3: skillzplumber (big blind) folded before Flop
Seat 4: PlayTheBlues4U collected ($0.57)
Seat 5: Wooly510 folded before Flop (didn't bet)
Seat 6: DemolishIT folded before Flop (didn't bet)


PokerStars Hand #204330100619:  Hold'em No Limit ($0.02/$0.05 USD) - 2019/10/07 20:13:51 ET
Table 'Sculptor' 6-max Seat #6 is the button
Seat 1: cladams73 ($3.61 in chips)
Seat 2: Star6543 ($6.22 in chips)
Seat 3: skillzplumber ($5 in chips)
Seat 4: PlayTheBlues4U ($4.78 in chips)
Seat 5: Wooly510 ($6.07 in chips)
Seat 6: DemolishIT ($1.52 in chips)
cladams73: posts small blind $0.02
Star6543: posts big blind $0.05
*** HOLE CARDS ***
Dealt to PlayTheBlues4U [Qs 4d]
Star6543 said, "trying suckout it hurts"
skillzplumber: calls $0.05
PlayTheBlues4U: folds
Wooly510: folds
DemolishIT: folds
cladams73: raises $0.10 to $0.15
Star6543: calls $0.10
skillzplumber: calls $0.10
*** FLOP *** [3h 8s Ts]
cladams73: bets $0.20
Star6543: calls $0.20
skillzplumber: calls $0.20
*** TURN *** [3h 8s Ts] [Qh]
cladams73: checks
Star6543: bets $0.10
skillzplumber: raises $0.50 to $0.60
cladams73: folds
Star6543: folds [8d]
Uncalled bet ($0.50) returned to skillzplumber
skillzplumber collected $1.19 from pot
skillzplumber: doesn't show hand
*** SUMMARY ***
Total pot $1.25 | Rake $0.06
Board [3h 8s Ts Qh]
Seat 1: cladams73 (small blind) folded on the Turn
Seat 2: Star6543 (big blind) folded on the Turn
Seat 3: skillzplumber collected ($1.19)
Seat 4: PlayTheBlues4U folded before Flop (didn't bet)
Seat 5: Wooly510 folded before Flop (didn't bet)
Seat 6: DemolishIT (button) folded before Flop (didn't bet)


PokerStars Hand #204330100580:  Hold'em No Limit ($0.02/$0.05 USD) - 2019/10/07 20:13:33 ET
Table 'Sculptor' 6-max Seat #5 is the button
Seat 1: cladams73 ($3.66 in chips)
Seat 2: Star6543 ($6.22 in chips)
Seat 3: skillzplumber ($5 in chips)
Seat 4: PlayTheBlues4U ($4.78 in chips)
Seat 5: Wooly510 ($6.07 in chips)
Seat 6: DemolishIT ($1.47 in chips)
DemolishIT: posts small blind $0.02
cladams73: posts big blind $0.05
*** HOLE CARDS ***
Dealt to PlayTheBlues4U [3d 5h]
Star6543: folds
skillzplumber: folds
PlayTheBlues4U: folds
Wooly510: folds
DemolishIT: raises $0.15 to $0.20
cladams73: folds
Uncalled bet ($0.15) returned to DemolishIT
DemolishIT collected $0.10 from pot
*** SUMMARY ***
Total pot $0.10 | Rake $0
Seat 1: cladams73 (big blind) folded before Flop
Seat 2: Star6543 folded before Flop (didn't bet)
Seat 3: skillzplumber folded before Flop (didn't bet)
Seat 4: PlayTheBlues4U folded before Flop (didn't bet)
Seat 5: Wooly510 (button) folded before Flop (didn't bet)
Seat 6: DemolishIT (small blind) collected ($0.10)


PokerStars Hand #204330100498:  Hold'em No Limit ($0.02/$0.05 USD) - 2019/10/07 20:13:00 ET
Table 'Sculptor' 6-max Seat #4 is the button
Seat 1: cladams73 ($3.41 in chips)
Seat 2: Star6543 ($6.42 in chips)
Seat 3: skillzplumber ($5 in chips)
Seat 4: PlayTheBlues4U ($4.78 in chips)
Seat 5: Wooly510 ($6.09 in chips)
Seat 6: DemolishIT ($1.52 in chips)
Wooly510: posts small blind $0.02
DemolishIT: posts big blind $0.05
*** HOLE CARDS ***
Dealt to PlayTheBlues4U [Ks 4d]
Star6543 said, "why did you check at turn"
cladams73: raises $0.15 to $0.20
Star6543 said, "go allin with strtaght"
Star6543: calls $0.20
skillzplumber: folds
PlayTheBlues4U: folds
skillzplumber is disconnected
Wooly510: folds
DemolishIT: folds
*** FLOP *** [2s 7d 3c]
cladams73: checks
Star6543: checks
*** TURN *** [2s 7d 3c] [7c]
cladams73: checks
Star6543: checks
*** RIVER *** [2s 7d 3c 7c] [3s]
skillzplumber said, "lol thanks"
cladams73: bets $0.25
Star6543: folds
Uncalled bet ($0.25) returned to cladams73
cladams73 collected $0.45 from pot
cladams73: doesn't show hand
*** SUMMARY ***
Total pot $0.47 | Rake $0.02
Board [2s 7d 3c 7c 3s]
Seat 1: cladams73 collected ($0.45)
Seat 2: Star6543 folded on the River
Seat 3: skillzplumber folded before Flop (didn't bet)
Seat 4: PlayTheBlues4U (button) folded before Flop (didn't bet)
Seat 5: Wooly510 (small blind) folded before Flop
Seat 6: DemolishIT (big blind) folded before Flop


PokerStars Hand #204330100441:  Hold'em No Limit ($0.02/$0.05 USD) - 2019/10/07 20:12:37 ET
Table 'Fides' 6-max Seat #4 is the button
Seat 3: dcami_nj ($5.41 in chips)
Seat 4: richy5742 ($4.37 in chips)
Seat 5: stock501402 ($14.97 in chips)
Seat 6: PlayTheBlues4U ($5 in chips)
stock501402: posts small blind $0.02
PlayTheBlues4U: posts big blind $0.05
Wooly510: sits out
*** HOLE CARDS ***
Dealt to PlayTheBlues4U [Qh Kh]
dcami_nj has timed out
dcami_nj: folds
richy5742: raises $0.05 to $0.10
stock501402: calls $0.08
PlayTheBlues4U: raises $0.30 to $0.40
richy5742: folds
stock501402: calls $0.30
*** FLOP *** [7c 3c 8s]
stock501402: checks
PlayTheBlues4U: bets $0.60
stock501402: calls $0.60
*** TURN *** [7c 3c 8s] [Ks]
stock501402: bets $0.05
PlayTheBlues4U: raises $1.10 to $1.15
stock501402: calls $1.10
*** RIVER *** [7c 3c 8s Ks] [4s]
stock501402: bets $0.05
PlayTheBlues4U: calls $0.05
*** SHOW DOWN ***
stock501402: shows [Js 9c] (high card King)
PlayTheBlues4U: shows [Qh Kh] (a pair of Kings)
PlayTheBlues4U collected $4.28 from pot
*** SUMMARY ***
Total pot $4.50 | Rake $0.22
Board [7c 3c 8s Ks 4s]
Seat 3: dcami_nj folded before Flop (didn't bet)
Seat 4: richy5742 (button) folded before Flop
Seat 5: stock501402 (small blind) showed [Js 9c] and lost with high card King
Seat 6: PlayTheBlues4U (big blind) showed [Qh Kh] and won ($4.28) with a pair of Kings


PokerStars Hand #204329939977:  Hold'em No Limit ($0.02/$0.05 USD) - 2019/10/07 20:12:13 ET
Table 'Sculptor' 6-max Seat #3 is the button
Seat 1: cladams73 ($4.39 in chips)
Seat 2: Star6543 ($6.62 in chips)
Seat 3: skillzplumber ($2.26 in chips)
Seat 4: PlayTheBlues4U ($4.80 in chips)
Seat 5: Wooly510 ($5 in chips)
Seat 6: DemolishIT ($1.52 in chips)
PlayTheBlues4U: posts small blind $0.02
Wooly510: posts big blind $0.05
*** HOLE CARDS ***
Dealt to PlayTheBlues4U [5c 3h]
DemolishIT: folds
PlayTheBlues4U said, "oof"
cladams73: raises $0.15 to $0.20
Star6543: calls $0.20
skillzplumber: folds
PlayTheBlues4U: folds
Wooly510: calls $0.15
*** FLOP *** [Ts Th 2c]
skillzplumber said, "i knew it too"
Wooly510: checks
cladams73: bets $0.25
Star6543: folds
Wooly510: calls $0.25
*** TURN *** [Ts Th 2c] [5s]
Wooly510: bets $0.53
cladams73: calls $0.53
*** RIVER *** [Ts Th 2c 5s] [7h]
Wooly510: bets $1.04
cladams73: folds
Uncalled bet ($1.04) returned to Wooly510
Wooly510 collected $2.07 from pot
Wooly510: doesn't show hand
*** SUMMARY ***
Total pot $2.18 | Rake $0.11
Board [Ts Th 2c 5s 7h]
Seat 1: cladams73 folded on the River
Seat 2: Star6543 folded on the Flop
Seat 3: skillzplumber (button) folded before Flop (didn't bet)
Seat 4: PlayTheBlues4U (small blind) folded before Flop
Seat 5: Wooly510 (big blind) collected ($2.07)
Seat 6: DemolishIT folded before Flop (didn't bet)


PokerStars Hand #204329939790:  Hold'em No Limit ($0.02/$0.05 USD) - 2019/10/07 20:11:01 ET
Table 'Sculptor' 6-max Seat #2 is the button
Seat 1: cladams73 ($4.39 in chips)
Seat 2: Star6543 ($2.83 in chips)
Seat 3: skillzplumber ($5.09 in chips)
Seat 4: PlayTheBlues4U ($5 in chips)
Seat 6: DemolishIT ($2.63 in chips)
skillzplumber: posts small blind $0.02
PlayTheBlues4U: posts big blind $0.05
Wooly510: sits out
*** HOLE CARDS ***
Dealt to PlayTheBlues4U [8s 8h]
DemolishIT: calls $0.05
cladams73: folds
Star6543: calls $0.05
skillzplumber: raises $0.15 to $0.20
PlayTheBlues4U: calls $0.15
DemolishIT: calls $0.15
Star6543: calls $0.15
*** FLOP *** [3s Th Jh]
skillzplumber: checks
PlayTheBlues4U: checks
DemolishIT: bets $0.76
Star6543: calls $0.76
skillzplumber: calls $0.76
PlayTheBlues4U: folds
*** TURN *** [3s Th Jh] [Ac]
skillzplumber: checks
DemolishIT: checks
Star6543: checks
*** RIVER *** [3s Th Jh Ac] [2h]
skillzplumber: bets $0.15
DemolishIT: calls $0.15
Star6543: raises $1.72 to $1.87 and is all-in
skillzplumber: calls $1.72
DemolishIT: folds
*** SHOW DOWN ***
Star6543: shows [Qh 4h] (a flush, Queen high)
skillzplumber: shows [Kd Qs] (a straight, Ten to Ace)
Star6543 collected $6.62 from pot
*** SUMMARY ***
Total pot $6.97 | Rake $0.35
Board [3s Th Jh Ac 2h]
Seat 1: cladams73 folded before Flop (didn't bet)
Seat 2: Star6543 (button) showed [Qh 4h] and won ($6.62) with a flush, Queen high
Seat 3: skillzplumber (small blind) showed [Kd Qs] and lost with a straight, Ten to Ace
Seat 4: PlayTheBlues4U (big blind) folded on the Flop
Seat 6: DemolishIT folded on the River


PokerStars Hand #204209812319:  Hold'em No Limit ($0.02/$0.05 USD) - 2019/10/03 23:32:29 ET
Table 'Phoenix' 6-max Seat #2 is the button
Seat 1: smokestackinggg ($3.18 in chips)
Seat 2: 921zhaopeng ($4.19 in chips)
Seat 4: DnDManiac ($4.75 in chips)
Seat 5: 2sukar7 ($4.85 in chips)
Seat 6: PlayTheBlues4U ($12.18 in chips)
DnDManiac: posts small blind $0.02
2sukar7: posts big blind $0.05
*** HOLE CARDS ***
Dealt to PlayTheBlues4U [Qs Kd]
PlayTheBlues4U: raises $0.10 to $0.15
smokestackinggg: raises $0.10 to $0.25
921zhaopeng: folds
DnDManiac: folds
2sukar7: folds
PlayTheBlues4U: calls $0.10
*** FLOP *** [9s Ts Js]
PlayTheBlues4U: bets $0.50
smokestackinggg: calls $0.50
*** TURN *** [9s Ts Js] [6h]
PlayTheBlues4U: bets $11.43 and is all-in
smokestackinggg: calls $2.43 and is all-in
Uncalled bet ($9) returned to PlayTheBlues4U
*** RIVER *** [9s Ts Js 6h] [3s]
*** SHOW DOWN ***
PlayTheBlues4U: shows [Qs Kd] (a flush, Queen high)
smokestackinggg: shows [Qh Qc] (a pair of Queens)
PlayTheBlues4U collected $6.11 from pot
*** SUMMARY ***
Total pot $6.43 | Rake $0.32
Board [9s Ts Js 6h 3s]
Seat 1: smokestackinggg showed [Qh Qc] and lost with a pair of Queens
Seat 2: 921zhaopeng (button) folded before Flop (didn't bet)
Seat 4: DnDManiac (small blind) folded before Flop
Seat 5: 2sukar7 (big blind) folded before Flop
Seat 6: PlayTheBlues4U showed [Qs Kd] and won ($6.11) with a flush, Queen high


PokerStars Hand #204209812268:  Hold'em No Limit ($0.02/$0.05 USD) - 2019/10/03 23:32:00 ET
Table 'Phoenix' 6-max Seat #1 is the button
Seat 1: smokestackinggg ($3.23 in chips)
Seat 2: 921zhaopeng ($3.96 in chips)
Seat 4: DnDManiac ($4.95 in chips)
Seat 5: 2sukar7 ($4.85 in chips)
Seat 6: PlayTheBlues4U ($12.18 in chips)
921zhaopeng: posts small blind $0.02
DnDManiac: posts big blind $0.05
*** HOLE CARDS ***
Dealt to PlayTheBlues4U [4c Qs]
2sukar7: folds
PlayTheBlues4U: folds
smokestackinggg: calls $0.05
921zhaopeng: raises $0.15 to $0.20
DnDManiac: calls $0.15
smokestackinggg: folds
*** FLOP *** [7c 8h 7h]
921zhaopeng: bets $0.25
DnDManiac: folds
Uncalled bet ($0.25) returned to 921zhaopeng
921zhaopeng collected $0.43 from pot
921zhaopeng: doesn't show hand
*** SUMMARY ***
Total pot $0.45 | Rake $0.02
Board [7c 8h 7h]
Seat 1: smokestackinggg (button) folded before Flop
Seat 2: 921zhaopeng (small blind) collected ($0.43)
Seat 4: DnDManiac (big blind) folded on the Flop
Seat 5: 2sukar7 folded before Flop (didn't bet)
Seat 6: PlayTheBlues4U folded before Flop (didn't bet)


PokerStars Hand #204209812207:  Hold'em No Limit ($0.02/$0.05 USD) - 2019/10/03 23:31:23 ET
Table 'Phoenix' 6-max Seat #6 is the button
Seat 1: smokestackinggg ($3.28 in chips)
Seat 2: 921zhaopeng ($3.73 in chips)
Seat 4: DnDManiac ($5 in chips)
Seat 5: 2sukar7 ($5 in chips)
Seat 6: PlayTheBlues4U ($12.18 in chips)
smokestackinggg: posts small blind $0.02
921zhaopeng: posts big blind $0.05
DnDManiac: posts big blind $0.05
2sukar7: posts big blind $0.05
*** HOLE CARDS ***
Dealt to PlayTheBlues4U [8h 2d]
DnDManiac: checks
2sukar7: checks
PlayTheBlues4U: folds
smokestackinggg: calls $0.03
921zhaopeng: checks
*** FLOP *** [8c 9h 6c]
smokestackinggg: checks
921zhaopeng: bets $0.10
DnDManiac: folds
2sukar7: calls $0.10
smokestackinggg: folds
*** TURN *** [8c 9h 6c] [3c]
921zhaopeng: bets $0.20
2sukar7: folds
Uncalled bet ($0.20) returned to 921zhaopeng
921zhaopeng collected $0.38 from pot
921zhaopeng: doesn't show hand
*** SUMMARY ***
Total pot $0.40 | Rake $0.02
Board [8c 9h 6c 3c]
Seat 1: smokestackinggg (small blind) folded on the Flop
Seat 2: 921zhaopeng (big blind) collected ($0.38)
Seat 4: DnDManiac folded on the Flop (didn't bet)
Seat 5: 2sukar7 folded on the Turn
Seat 6: PlayTheBlues4U (button) folded before Flop (didn't bet)


PokerStars Hand #204209812188:  Hold'em No Limit ($0.02/$0.05 USD) - 2019/10/03 23:31:13 ET
Table 'Phoenix' 6-max Seat #2 is the button
Seat 1: smokestackinggg ($3.33 in chips)
Seat 2: 921zhaopeng ($3.73 in chips)
Seat 6: PlayTheBlues4U ($12.13 in chips)
DnDManiac will be allowed to play after the button
2sukar7 will be allowed to play after the button
PlayTheBlues4U: posts small blind $0.02
smokestackinggg: posts big blind $0.05
*** HOLE CARDS ***
Dealt to PlayTheBlues4U [Kc Qd]
921zhaopeng: folds
PlayTheBlues4U: raises $0.10 to $0.15
smokestackinggg: folds
Uncalled bet ($0.10) returned to PlayTheBlues4U
PlayTheBlues4U collected $0.10 from pot
PlayTheBlues4U: doesn't show hand
*** SUMMARY ***
Total pot $0.10 | Rake $0
Seat 1: smokestackinggg (big blind) folded before Flop
Seat 2: 921zhaopeng (button) folded before Flop (didn't bet)
Seat 6: PlayTheBlues4U (small blind) collected ($0.10)


PokerStars Hand #204209812114:  Hold'em No Limit ($0.02/$0.05 USD) - 2019/10/03 23:30:30 ET
Table 'Phoenix' 6-max Seat #1 is the button
Seat 1: smokestackinggg ($3.08 in chips)
Seat 2: 921zhaopeng ($3.95 in chips)
Seat 6: PlayTheBlues4U ($12.18 in chips)
921zhaopeng: posts small blind $0.02
PlayTheBlues4U: posts big blind $0.05
*** HOLE CARDS ***
Dealt to PlayTheBlues4U [As 3c]
DnDManiac joins the table at seat #4
smokestackinggg: calls $0.05
921zhaopeng: calls $0.03
PlayTheBlues4U: checks
*** FLOP *** [7s 4c Qc]
921zhaopeng: checks
PlayTheBlues4U: checks
smokestackinggg: checks
*** TURN *** [7s 4c Qc] [3s]
921zhaopeng: bets $0.05
PlayTheBlues4U: folds
smokestackinggg: raises $0.12 to $0.17
921zhaopeng: calls $0.12
*** RIVER *** [7s 4c Qc 3s] [5c]
921zhaopeng: checks
smokestackinggg: bets $0.24
2sukar7 joins the table at seat #5
921zhaopeng: folds
Uncalled bet ($0.24) returned to smokestackinggg
smokestackinggg collected $0.47 from pot
smokestackinggg: doesn't show hand
*** SUMMARY ***
Total pot $0.49 | Rake $0.02
Board [7s 4c Qc 3s 5c]
Seat 1: smokestackinggg (button) collected ($0.47)
Seat 2: 921zhaopeng (small blind) folded on the River
Seat 6: PlayTheBlues4U (big blind) folded on the Turn


PokerStars Hand #204209812072:  Hold'em No Limit ($0.02/$0.05 USD) - 2019/10/03 23:30:13 ET
Table 'Phoenix' 6-max Seat #6 is the button
Seat 1: smokestackinggg ($3.13 in chips)
Seat 2: 921zhaopeng ($3.90 in chips)
Seat 6: PlayTheBlues4U ($12.18 in chips)
smokestackinggg: posts small blind $0.02
921zhaopeng: posts big blind $0.05
*** HOLE CARDS ***
Dealt to PlayTheBlues4U [2s Jd]
PlayTheBlues4U: folds
smokestackinggg: calls $0.03
921zhaopeng: checks
*** FLOP *** [8s Qc Ks]
smokestackinggg: checks
921zhaopeng: bets $0.15
smokestackinggg: folds
Uncalled bet ($0.15) returned to 921zhaopeng
kysinjer leaves the table
921zhaopeng collected $0.10 from pot
921zhaopeng: doesn't show hand
*** SUMMARY ***
Total pot $0.10 | Rake $0
Board [8s Qc Ks]
Seat 1: smokestackinggg (small blind) folded on the Flop
Seat 2: 921zhaopeng (big blind) collected ($0.10)
Seat 6: PlayTheBlues4U (button) folded before Flop (didn't bet)


PokerStars Hand #204209812034:  Hold'em No Limit ($0.02/$0.05 USD) - 2019/10/03 23:29:50 ET
Table 'Phoenix' 6-max Seat #1 is the button
Seat 1: smokestackinggg ($3.18 in chips)
Seat 5: kysinjer ($2.85 in chips)
Seat 6: PlayTheBlues4U ($9.57 in chips)
921zhaopeng will be allowed to play after the button
kysinjer: posts small blind $0.02
PlayTheBlues4U: posts big blind $0.05
*** HOLE CARDS ***
Dealt to PlayTheBlues4U [Ac Ad]
smokestackinggg: calls $0.05
kysinjer: raises $2.80 to $2.85 and is all-in
PlayTheBlues4U: raises $6.72 to $9.57 and is all-in
smokestackinggg: folds
Uncalled bet ($6.72) returned to PlayTheBlues4U
*** FLOP *** [Kd 4c 9h]
kysinjer said, "LOL"
*** TURN *** [Kd 4c 9h] [4h]
*** RIVER *** [Kd 4c 9h 4h] [Kc]
*** SHOW DOWN ***
kysinjer: shows [Qs Qd] (two pair, Kings and Queens)
PlayTheBlues4U: shows [Ac Ad] (two pair, Aces and Kings)
PlayTheBlues4U collected $5.46 from pot
*** SUMMARY ***
Total pot $5.75 | Rake $0.29
Board [Kd 4c 9h 4h Kc]
Seat 1: smokestackinggg (button) folded before Flop
Seat 5: kysinjer (small blind) showed [Qs Qd] and lost with two pair, Kings and Queens
Seat 6: PlayTheBlues4U (big blind) showed [Ac Ad] and won ($5.46) with two pair, Aces and Kings


PokerStars Hand #204209812014:  Hold'em No Limit ($0.05/$0.10 USD) - 2019/10/03 23:29:38 ET
Table 'Pollux' 6-max Seat #2 is the button
Seat 1: mellneazy ($8.36 in chips)
Seat 2: Masonstone3 ($41.88 in chips)
Seat 3: Onannio ($10.66 in chips)
Seat 4: hand shuffle ($9.40 in chips)
Seat 5: PlayTheBlues4U ($11.50 in chips)
Seat 6: bbkid44 ($13.84 in chips)
Onannio: posts small blind $0.05
hand shuffle: posts big blind $0.10
*** HOLE CARDS ***
Dealt to PlayTheBlues4U [5s Qh]
PlayTheBlues4U has timed out
PlayTheBlues4U: folds
bbkid44: calls $0.10
mellneazy: folds
Masonstone3: folds
Onannio: calls $0.05
hand shuffle: checks
*** FLOP *** [3s As 5d]
Onannio: checks
hand shuffle: bets $0.10
bbkid44: folds
Onannio: folds
Uncalled bet ($0.10) returned to hand shuffle
hand shuffle collected $0.28 from pot
hand shuffle: doesn't show hand
*** SUMMARY ***
Total pot $0.30 | Rake $0.02
Board [3s As 5d]
Seat 1: mellneazy folded before Flop (didn't bet)
Seat 2: Masonstone3 (button) folded before Flop (didn't bet)
Seat 3: Onannio (small blind) folded on the Flop
Seat 4: hand shuffle (big blind) collected ($0.28)
Seat 5: PlayTheBlues4U folded before Flop (didn't bet)
Seat 6: bbkid44 folded on the Flop


PokerStars Hand #204209811915:  Hold'em No Limit ($0.05/$0.10 USD) - 2019/10/03 23:28:49 ET
Table 'Pollux' 6-max Seat #1 is the button
Seat 1: mellneazy ($8.81 in chips)
Seat 2: Masonstone3 ($41.93 in chips)
Seat 3: Onannio ($11.91 in chips)
Seat 4: hand shuffle ($9.40 in chips)
Seat 5: PlayTheBlues4U ($11.50 in chips)
Seat 6: bbkid44 ($12.24 in chips)
Masonstone3: posts small blind $0.05
Onannio: posts big blind $0.10
*** HOLE CARDS ***
Dealt to PlayTheBlues4U [7h 4h]
hand shuffle: folds
PlayTheBlues4U: folds
bbkid44: calls $0.10
mellneazy: raises $0.35 to $0.45
Masonstone3: folds
Onannio: calls $0.35
bbkid44: calls $0.35
*** FLOP *** [Js 4d Jd]
Onannio: checks
bbkid44: bets $0.80
mellneazy: folds
Onannio: calls $0.80
*** TURN *** [Js 4d Jd] [8s]
Onannio: checks
bbkid44: bets $1.43
Onannio: folds
Uncalled bet ($1.43) returned to bbkid44
bbkid44 collected $2.85 from pot
bbkid44: doesn't show hand
*** SUMMARY ***
Total pot $3 | Rake $0.15
Board [Js 4d Jd 8s]
Seat 1: mellneazy (button) folded on the Flop
Seat 2: Masonstone3 (small blind) folded before Flop
Seat 3: Onannio (big blind) folded on the Turn
Seat 4: hand shuffle folded before Flop (didn't bet)
Seat 5: PlayTheBlues4U folded before Flop (didn't bet)
Seat 6: bbkid44 collected ($2.85)


PokerStars Hand #204209811830:  Hold'em No Limit ($0.05/$0.10 USD) - 2019/10/03 23:28:09 ET
Table 'Pollux' 6-max Seat #6 is the button
Seat 1: mellneazy ($9.11 in chips)
Seat 2: Masonstone3 ($42.83 in chips)
Seat 3: Onannio ($10.81 in chips)
Seat 4: hand shuffle ($9.40 in chips)
Seat 5: PlayTheBlues4U ($11.50 in chips)
Seat 6: bbkid44 ($12.24 in chips)
mellneazy: posts small blind $0.05
Masonstone3: posts big blind $0.10
*** HOLE CARDS ***
Dealt to PlayTheBlues4U [4s 7c]
Onannio: calls $0.10
hand shuffle: folds
PlayTheBlues4U: folds
bbkid44: folds
mellneazy: calls $0.05
Masonstone3: checks
*** FLOP *** [8s Jc 9h]
mellneazy: checks
Masonstone3: checks
Onannio: checks
*** TURN *** [8s Jc 9h] [8h]
mellneazy: bets $0.20
Masonstone3: calls $0.20
Onannio: calls $0.20
*** RIVER *** [8s Jc 9h 8h] [Tc]
mellneazy: checks
Masonstone3: checks
Onannio: bets $0.60
mellneazy: folds
Masonstone3: calls $0.60
*** SHOW DOWN ***
Onannio: shows [Kc Qs] (a straight, Nine to King)
Masonstone3: mucks hand
Onannio collected $2 from pot
*** SUMMARY ***
Total pot $2.10 | Rake $0.10
Board [8s Jc 9h 8h Tc]
Seat 1: mellneazy (small blind) folded on the River
Seat 2: Masonstone3 (big blind) mucked [7d 9c]
Seat 3: Onannio showed [Kc Qs] and won ($2) with a straight, Nine to King
Seat 4: hand shuffle folded before Flop (didn't bet)
Seat 5: PlayTheBlues4U folded before Flop (didn't bet)
Seat 6: bbkid44 (button) folded before Flop (didn't bet)


PokerStars Hand #204209811777:  Hold'em No Limit ($0.05/$0.10 USD) - 2019/10/03 23:27:50 ET
Table 'Pollux' 6-max Seat #5 is the button
Seat 1: mellneazy ($9.21 in chips)
Seat 2: Masonstone3 ($42.83 in chips)
Seat 3: Onannio ($10.81 in chips)
Seat 4: hand shuffle ($9.40 in chips)
Seat 5: PlayTheBlues4U ($11.35 in chips)
Seat 6: bbkid44 ($12.29 in chips)
bbkid44: posts small blind $0.05
mellneazy: posts big blind $0.10
*** HOLE CARDS ***
Dealt to PlayTheBlues4U [2d Ad]
Masonstone3: folds
Onannio: folds
hand shuffle: folds
PlayTheBlues4U: raises $0.20 to $0.30
bbkid44: folds
mellneazy: folds
Uncalled bet ($0.20) returned to PlayTheBlues4U
PlayTheBlues4U collected $0.25 from pot
PlayTheBlues4U: doesn't show hand
*** SUMMARY ***
Total pot $0.25 | Rake $0
Seat 1: mellneazy (big blind) folded before Flop
Seat 2: Masonstone3 folded before Flop (didn't bet)
Seat 3: Onannio folded before Flop (didn't bet)
Seat 4: hand shuffle folded before Flop (didn't bet)
Seat 5: PlayTheBlues4U (button) collected ($0.25)
Seat 6: bbkid44 (small blind) folded before Flop


PokerStars Hand #204209811740:  Hold'em No Limit ($0.02/$0.05 USD) - 2019/10/03 23:27:26 ET
Table 'Phoenix' 6-max Seat #6 is the button
Seat 1: smokestackinggg ($3.20 in chips)
Seat 3: Smuggler1991 ($5.78 in chips)
Seat 4: trocchia79 ($4.44 in chips)
Seat 5: kysinjer ($7.85 in chips)
Seat 6: PlayTheBlues4U ($5 in chips)
smokestackinggg: posts small blind $0.02
rellerz: is sitting out
Smuggler1991: posts big blind $0.05
*** HOLE CARDS ***
Dealt to PlayTheBlues4U [Ah Ks]
trocchia79: folds
rellerz leaves the table
kysinjer: calls $0.05
921zhaopeng joins the table at seat #2
PlayTheBlues4U: raises $0.15 to $0.20
smokestackinggg: folds
Smuggler1991 has timed out
Smuggler1991: folds
kysinjer: raises $0.80 to $1
trocchia79 leaves the table
PlayTheBlues4U: calls $0.80
*** FLOP *** [Kh 6s Ts]
kysinjer: bets $6.85 and is all-in
PlayTheBlues4U: calls $4 and is all-in
Uncalled bet ($2.85) returned to kysinjer
*** TURN *** [Kh 6s Ts] [7h]
*** RIVER *** [Kh 6s Ts 7h] [9s]
*** SHOW DOWN ***
kysinjer: shows [4c 4s] (a pair of Fours)
PlayTheBlues4U: shows [Ah Ks] (a pair of Kings)
PlayTheBlues4U collected $9.57 from pot
*** SUMMARY ***
Total pot $10.07 | Rake $0.50
Board [Kh 6s Ts 7h 9s]
Seat 1: smokestackinggg (small blind) folded before Flop
Seat 3: Smuggler1991 (big blind) folded before Flop
Seat 4: trocchia79 folded before Flop (didn't bet)
Seat 5: kysinjer showed [4c 4s] and lost with a pair of Fours
Seat 6: PlayTheBlues4U (button) showed [Ah Ks] and won ($9.57) with a pair of Kings


PokerStars Hand #204209811706:  Hold'em No Limit ($0.05/$0.10 USD) - 2019/10/03 23:27:09 ET
Table 'Pollux' 6-max Seat #4 is the button
Seat 1: mellneazy ($9.21 in chips)
Seat 2: Masonstone3 ($43.33 in chips)
Seat 3: Onannio ($10.81 in chips)
Seat 4: hand shuffle ($9.40 in chips)
Seat 5: PlayTheBlues4U ($11.40 in chips)
Seat 6: bbkid44 ($11.79 in chips)
PlayTheBlues4U: posts small blind $0.05
bbkid44: posts big blind $0.10
*** HOLE CARDS ***
Dealt to PlayTheBlues4U [3c Qh]
mellneazy: folds
Masonstone3: raises $0.20 to $0.30
Onannio: folds
hand shuffle: folds
PlayTheBlues4U: folds
bbkid44: raises $0.20 to $0.50
Masonstone3: calls $0.20
*** FLOP *** [Jh Kh 8c]
bbkid44: bets $1.40
Masonstone3: folds
Uncalled bet ($1.40) returned to bbkid44
bbkid44 collected $1 from pot
bbkid44: doesn't show hand
*** SUMMARY ***
Total pot $1.05 | Rake $0.05
Board [Jh Kh 8c]
Seat 1: mellneazy folded before Flop (didn't bet)
Seat 2: Masonstone3 folded on the Flop
Seat 3: Onannio folded before Flop (didn't bet)
Seat 4: hand shuffle (button) folded before Flop (didn't bet)
Seat 5: PlayTheBlues4U (small blind) folded before Flop
Seat 6: bbkid44 (big blind) collected ($1)


PokerStars Hand #204209811607:  Hold'em No Limit ($0.02/$0.05 USD) - 2019/10/03 23:26:28 ET
Table 'Phoenix' 6-max Seat #5 is the button
Seat 1: smokestackinggg ($3.25 in chips)
Seat 2: rellerz ($3.61 in chips)
Seat 3: Smuggler1991 ($5.78 in chips)
Seat 4: trocchia79 ($5.09 in chips)
Seat 5: kysinjer ($7.85 in chips)
Seat 6: PlayTheBlues4U ($2.76 in chips)
PlayTheBlues4U: posts small blind $0.02
smokestackinggg: posts big blind $0.05
*** HOLE CARDS ***
Dealt to PlayTheBlues4U [7h Ts]
rellerz: calls $0.05
Smuggler1991: folds
trocchia79: calls $0.05
kysinjer: folds
PlayTheBlues4U: folds
smokestackinggg: checks
*** FLOP *** [4c 9d Kd]
smokestackinggg: checks
rellerz: bets $0.15
trocchia79: calls $0.15
smokestackinggg: folds
*** TURN *** [4c 9d Kd] [8c]
rellerz: bets $0.45
trocchia79: calls $0.45
*** RIVER *** [4c 9d Kd 8c] [3c]
rellerz: bets $1.30
trocchia79: folds
Uncalled bet ($1.30) returned to rellerz
rellerz collected $1.30 from pot
rellerz: doesn't show hand
*** SUMMARY ***
Total pot $1.37 | Rake $0.07
Board [4c 9d Kd 8c 3c]
Seat 1: smokestackinggg (big blind) folded on the Flop
Seat 2: rellerz collected ($1.30)
Seat 3: Smuggler1991 folded before Flop (didn't bet)
Seat 4: trocchia79 folded on the River
Seat 5: kysinjer (button) folded before Flop (didn't bet)
Seat 6: PlayTheBlues4U (small blind) folded before Flop


PokerStars Hand #204209811557:  Hold'em No Limit ($0.05/$0.10 USD) - 2019/10/03 23:25:59 ET
Table 'Pollux' 6-max Seat #3 is the button
Seat 1: mellneazy ($9.21 in chips)
Seat 2: Masonstone3 ($43.33 in chips)
Seat 3: Onannio ($10.81 in chips)
Seat 4: hand shuffle ($9.70 in chips)
Seat 5: PlayTheBlues4U ($10.48 in chips)
Seat 6: bbkid44 ($12.49 in chips)
hand shuffle: posts small blind $0.05
PlayTheBlues4U: posts big blind $0.10
*** HOLE CARDS ***
Dealt to PlayTheBlues4U [4c 6c]
bbkid44: raises $0.10 to $0.20
mellneazy: folds
Masonstone3: folds
Onannio: folds
hand shuffle: calls $0.15
PlayTheBlues4U: calls $0.10
*** FLOP *** [4d Ts 9s]
hand shuffle: bets $0.10
PlayTheBlues4U: raises $0.40 to $0.50
bbkid44: calls $0.50
hand shuffle: folds
*** TURN *** [4d Ts 9s] [6h]
PlayTheBlues4U: bets $1.10
bbkid44: folds
Uncalled bet ($1.10) returned to PlayTheBlues4U
PlayTheBlues4U collected $1.62 from pot
PlayTheBlues4U: doesn't show hand
*** SUMMARY ***
Total pot $1.70 | Rake $0.08
Board [4d Ts 9s 6h]
Seat 1: mellneazy folded before Flop (didn't bet)
Seat 2: Masonstone3 folded before Flop (didn't bet)
Seat 3: Onannio (button) folded before Flop (didn't bet)
Seat 4: hand shuffle (small blind) folded on the Flop
Seat 5: PlayTheBlues4U (big blind) collected ($1.62)
Seat 6: bbkid44 folded on the Turn


PokerStars Hand #204209811427:  Hold'em No Limit ($0.05/$0.10 USD) - 2019/10/03 23:24:57 ET
Table 'Pollux' 6-max Seat #2 is the button
Seat 1: mellneazy ($9.21 in chips)
Seat 2: Masonstone3 ($43.33 in chips)
Seat 3: Onannio ($10.91 in chips)
Seat 4: hand shuffle ($9.90 in chips)
Seat 5: PlayTheBlues4U ($10.48 in chips)
Seat 6: bbkid44 ($12.21 in chips)
Onannio: posts small blind $0.05
hand shuffle: posts big blind $0.10
*** HOLE CARDS ***
Dealt to PlayTheBlues4U [6s Kd]
PlayTheBlues4U: folds
bbkid44: calls $0.10
mellneazy: folds
Masonstone3: folds
Onannio: calls $0.05
hand shuffle: checks
*** FLOP *** [Js 2h 9h]
Onannio: checks
hand shuffle: bets $0.10
bbkid44: calls $0.10
Onannio: folds
*** TURN *** [Js 2h 9h] [2c]
hand shuffle: checks
bbkid44: checks
*** RIVER *** [Js 2h 9h 2c] [Ks]
hand shuffle: checks
bbkid44: bets $1
hand shuffle: folds
Uncalled bet ($1) returned to bbkid44
bbkid44 collected $0.48 from pot
bbkid44: doesn't show hand
*** SUMMARY ***
Total pot $0.50 | Rake $0.02
Board [Js 2h 9h 2c Ks]
Seat 1: mellneazy folded before Flop (didn't bet)
Seat 2: Masonstone3 (button) folded before Flop (didn't bet)
Seat 3: Onannio (small blind) folded on the Flop
Seat 4: hand shuffle (big blind) folded on the River
Seat 5: PlayTheBlues4U folded before Flop (didn't bet)
Seat 6: bbkid44 collected ($0.48)


PokerStars Hand #204209811321:  Hold'em No Limit ($0.02/$0.05 USD) - 2019/10/03 23:24:12 ET
Table 'Phoenix' 6-max Seat #4 is the button
Seat 1: smokestackinggg ($3.10 in chips)
Seat 2: rellerz ($3.61 in chips)
Seat 3: Smuggler1991 ($5.78 in chips)
Seat 4: trocchia79 ($5.88 in chips)
Seat 5: kysinjer ($5.13 in chips)
Seat 6: PlayTheBlues4U ($4.95 in chips)
kysinjer: posts small blind $0.02
PlayTheBlues4U: posts big blind $0.05
*** HOLE CARDS ***
Dealt to PlayTheBlues4U [Ts Qc]
smokestackinggg: folds
rellerz: folds
Smuggler1991: folds
trocchia79: calls $0.05
kysinjer: raises $0.10 to $0.15
PlayTheBlues4U: calls $0.10
trocchia79: calls $0.10
*** FLOP *** [5c Jd 9d]
kysinjer: bets $0.22
PlayTheBlues4U: raises $0.42 to $0.64
trocchia79: calls $0.64
kysinjer: calls $0.42
*** TURN *** [5c Jd 9d] [Qh]
kysinjer: checks
PlayTheBlues4U: bets $1.40
trocchia79: folds
kysinjer: calls $1.40
*** RIVER *** [5c Jd 9d Qh] [Th]
kysinjer: bets $2.94 and is all-in
PlayTheBlues4U: folds
Uncalled bet ($2.94) returned to kysinjer
kysinjer collected $4.91 from pot
kysinjer: doesn't show hand
*** SUMMARY ***
Total pot $5.17 | Rake $0.26
Board [5c Jd 9d Qh Th]
Seat 1: smokestackinggg folded before Flop (didn't bet)
Seat 2: rellerz folded before Flop (didn't bet)
Seat 3: Smuggler1991 folded before Flop (didn't bet)
Seat 4: trocchia79 (button) folded on the Turn
Seat 5: kysinjer (small blind) collected ($4.91)
Seat 6: PlayTheBlues4U (big blind) folded on the River


PokerStars Hand #204209811301:  Hold'em No Limit ($0.05/$0.10 USD) - 2019/10/03 23:24:01 ET
Table 'Pollux' 6-max Seat #1 is the button
Seat 1: mellneazy ($9.31 in chips)
Seat 2: Masonstone3 ($42.24 in chips)
Seat 3: Onannio ($11.01 in chips)
Seat 4: hand shuffle ($9.90 in chips)
Seat 5: PlayTheBlues4U ($10.48 in chips)
Seat 6: bbkid44 ($13.21 in chips)
Masonstone3: posts small blind $0.05
Onannio: posts big blind $0.10
*** HOLE CARDS ***
Dealt to PlayTheBlues4U [7h 3h]
hand shuffle: folds
PlayTheBlues4U: folds
bbkid44: calls $0.10
mellneazy: calls $0.10
Masonstone3: raises $0.40 to $0.50
Onannio: folds
bbkid44: calls $0.40
mellneazy: folds
*** FLOP *** [Qh 7s 3c]
Masonstone3: bets $0.50
bbkid44: calls $0.50
*** TURN *** [Qh 7s 3c] [2d]
Masonstone3: bets $1.90
bbkid44: folds
Uncalled bet ($1.90) returned to Masonstone3
Masonstone3 collected $2.09 from pot
Masonstone3: doesn't show hand
*** SUMMARY ***
Total pot $2.20 | Rake $0.11
Board [Qh 7s 3c 2d]
Seat 1: mellneazy (button) folded before Flop
Seat 2: Masonstone3 (small blind) collected ($2.09)
Seat 3: Onannio (big blind) folded before Flop
Seat 4: hand shuffle folded before Flop (didn't bet)
Seat 5: PlayTheBlues4U folded before Flop (didn't bet)
Seat 6: bbkid44 folded on the Turn


PokerStars Hand #204209811194:  Hold'em No Limit ($0.05/$0.10 USD) - 2019/10/03 23:23:15 ET
Table 'Pollux' 6-max Seat #6 is the button
Seat 1: mellneazy ($9.36 in chips)
Seat 2: Masonstone3 ($42.54 in chips)
Seat 3: Onannio ($11.51 in chips)
Seat 4: hand shuffle ($9.90 in chips)
Seat 5: PlayTheBlues4U ($9.70 in chips)
Seat 6: bbkid44 ($13.21 in chips)
mellneazy: posts small blind $0.05
Masonstone3: posts big blind $0.10
*** HOLE CARDS ***
Dealt to PlayTheBlues4U [9d 9c]
Onannio: calls $0.10
hand shuffle: folds
PlayTheBlues4U: raises $0.20 to $0.30
bbkid44: folds
mellneazy: folds
Masonstone3: calls $0.20
Onannio: calls $0.20
*** FLOP *** [2h 9h Kc]
Masonstone3: checks
Onannio: bets $0.20
PlayTheBlues4U: raises $0.50 to $0.70
Masonstone3: folds
Onannio: folds
Uncalled bet ($0.50) returned to PlayTheBlues4U
PlayTheBlues4U collected $1.28 from pot
PlayTheBlues4U: doesn't show hand
*** SUMMARY ***
Total pot $1.35 | Rake $0.07
Board [2h 9h Kc]
Seat 1: mellneazy (small blind) folded before Flop
Seat 2: Masonstone3 (big blind) folded on the Flop
Seat 3: Onannio folded on the Flop
Seat 4: hand shuffle folded before Flop (didn't bet)
Seat 5: PlayTheBlues4U collected ($1.28)
Seat 6: bbkid44 (button) folded before Flop (didn't bet)


PokerStars Hand #204209811185:  Hold'em No Limit ($0.02/$0.05 USD) - 2019/10/03 23:23:13 ET
Table 'Phoenix' 6-max Seat #3 is the button
Seat 1: smokestackinggg ($3.10 in chips)
Seat 2: rellerz ($3.61 in chips)
Seat 3: Smuggler1991 ($5.78 in chips)
Seat 4: trocchia79 ($6.03 in chips)
Seat 5: kysinjer ($5 in chips)
Seat 6: PlayTheBlues4U ($4.95 in chips)
trocchia79: posts small blind $0.02
kysinjer: posts big blind $0.05
*** HOLE CARDS ***
Dealt to PlayTheBlues4U [6d 8c]
PlayTheBlues4U: folds
smokestackinggg: folds
rellerz: folds
Smuggler1991: folds
trocchia79: calls $0.03
kysinjer: checks
*** FLOP *** [Jh 9s 8d]
trocchia79: bets $0.10
kysinjer: calls $0.10
*** TURN *** [Jh 9s 8d] [Jc]
trocchia79: checks
kysinjer: bets $0.28
trocchia79: folds
Uncalled bet ($0.28) returned to kysinjer
kysinjer collected $0.28 from pot
kysinjer: doesn't show hand
*** SUMMARY ***
Total pot $0.30 | Rake $0.02
Board [Jh 9s 8d Jc]
Seat 1: smokestackinggg folded before Flop (didn't bet)
Seat 2: rellerz folded before Flop (didn't bet)
Seat 3: Smuggler1991 (button) folded before Flop (didn't bet)
Seat 4: trocchia79 (small blind) folded on the Turn
Seat 5: kysinjer (big blind) collected ($0.28)
Seat 6: PlayTheBlues4U folded before Flop (didn't bet)


PokerStars Hand #204209811168:  Hold'em No Limit ($0.02/$0.05 USD) - 2019/10/03 23:23:05 ET
Table 'Phoenix' 6-max Seat #2 is the button
Seat 1: smokestackinggg ($3.10 in chips)
Seat 2: rellerz ($3.61 in chips)
Seat 3: Smuggler1991 ($5.80 in chips)
Seat 4: trocchia79 ($6.01 in chips)
Seat 6: PlayTheBlues4U ($4.95 in chips)
Smuggler1991: posts small blind $0.02
trocchia79: posts big blind $0.05
kysinjer: sits out
*** HOLE CARDS ***
Dealt to PlayTheBlues4U [8c As]
PlayTheBlues4U: folds
smokestackinggg: folds
rellerz: folds
Smuggler1991: folds
Uncalled bet ($0.03) returned to trocchia79
trocchia79 collected $0.04 from pot
trocchia79: doesn't show hand
*** SUMMARY ***
Total pot $0.04 | Rake $0
Seat 1: smokestackinggg folded before Flop (didn't bet)
Seat 2: rellerz (button) folded before Flop (didn't bet)
Seat 3: Smuggler1991 (small blind) folded before Flop
Seat 4: trocchia79 (big blind) collected ($0.04)
Seat 6: PlayTheBlues4U folded before Flop (didn't bet)


PokerStars Hand #204209811103:  Hold'em No Limit ($0.02/$0.05 USD) - 2019/10/03 23:22:39 ET
Table 'Phoenix' 6-max Seat #1 is the button
Seat 1: smokestackinggg ($3.20 in chips)
Seat 2: rellerz ($3.63 in chips)
Seat 3: Smuggler1991 ($5.63 in chips)
Seat 4: trocchia79 ($6.06 in chips)
Seat 6: PlayTheBlues4U ($4.95 in chips)
rellerz: posts small blind $0.02
Smuggler1991: posts big blind $0.05
kysinjer: sits out
*** HOLE CARDS ***
Dealt to PlayTheBlues4U [3s Qh]
trocchia79: calls $0.05
PlayTheBlues4U: folds
smokestackinggg: raises $0.05 to $0.10
rellerz: folds
Smuggler1991: raises $0.27 to $0.37
trocchia79: folds
smokestackinggg: folds
Uncalled bet ($0.27) returned to Smuggler1991
Smuggler1991 collected $0.27 from pot
Smuggler1991: doesn't show hand
*** SUMMARY ***
Total pot $0.27 | Rake $0
Seat 1: smokestackinggg (button) folded before Flop
Seat 2: rellerz (small blind) folded before Flop
Seat 3: Smuggler1991 (big blind) collected ($0.27)
Seat 4: trocchia79 folded before Flop
Seat 6: PlayTheBlues4U folded before Flop (didn't bet)


PokerStars Hand #204209811082:  Hold'em No Limit ($0.05/$0.10 USD) - 2019/10/03 23:22:29 ET
Table 'Pollux' 6-max Seat #5 is the button
Seat 1: mellneazy ($9.66 in chips)
Seat 2: Masonstone3 ($41.89 in chips)
Seat 3: Onannio ($11.51 in chips)
Seat 4: hand shuffle ($10 in chips)
Seat 5: PlayTheBlues4U ($9.70 in chips)
Seat 6: bbkid44 ($13.51 in chips)
bbkid44: posts small blind $0.05
mellneazy: posts big blind $0.10
hand shuffle: posts big blind $0.10
*** HOLE CARDS ***
Dealt to PlayTheBlues4U [8s Qs]
Masonstone3: raises $0.20 to $0.30
Onannio: folds
hand shuffle: folds
PlayTheBlues4U: folds
bbkid44: calls $0.25
mellneazy: calls $0.20
*** FLOP *** [9d 2s 2h]
bbkid44: checks
mellneazy: checks
Masonstone3: bets $0.70
bbkid44: folds
mellneazy: folds
Uncalled bet ($0.70) returned to Masonstone3
Masonstone3 collected $0.95 from pot
Masonstone3: doesn't show hand
*** SUMMARY ***
Total pot $1 | Rake $0.05
Board [9d 2s 2h]
Seat 1: mellneazy (big blind) folded on the Flop
Seat 2: Masonstone3 collected ($0.95)
Seat 3: Onannio folded before Flop (didn't bet)
Seat 4: hand shuffle folded before Flop (didn't bet)
Seat 5: PlayTheBlues4U (button) folded before Flop (didn't bet)
Seat 6: bbkid44 (small blind) folded on the Flop


PokerStars Hand #204209811041:  Hold'em No Limit ($0.02/$0.05 USD) - 2019/10/03 23:22:12 ET
Table 'Phoenix' 6-max Seat #6 is the button
Seat 1: smokestackinggg ($3.22 in chips)
Seat 2: rellerz ($3.68 in chips)
Seat 3: Smuggler1991 ($5.63 in chips)
Seat 4: trocchia79 ($6.06 in chips)
Seat 6: PlayTheBlues4U ($4.88 in chips)
smokestackinggg: posts small blind $0.02
rellerz: posts big blind $0.05
kysinjer: sits out
*** HOLE CARDS ***
Dealt to PlayTheBlues4U [6c 9d]
Smuggler1991: folds
trocchia79: folds
PlayTheBlues4U: raises $0.10 to $0.15
smokestackinggg: folds
rellerz: folds
Uncalled bet ($0.10) returned to PlayTheBlues4U
PlayTheBlues4U collected $0.12 from pot
PlayTheBlues4U: doesn't show hand
*** SUMMARY ***
Total pot $0.12 | Rake $0
Seat 1: smokestackinggg (small blind) folded before Flop
Seat 2: rellerz (big blind) folded before Flop
Seat 3: Smuggler1991 folded before Flop (didn't bet)
Seat 4: trocchia79 folded before Flop (didn't bet)
Seat 6: PlayTheBlues4U (button) collected ($0.12)


PokerStars Hand #204208139965:  Hold'em No Limit ($0.05/$0.10 USD) - 2019/10/03 23:21:43 ET
Table 'Pollux' 6-max Seat #3 is the button
Seat 1: mellneazy ($9.66 in chips)
Seat 2: Masonstone3 ($42.59 in chips)
Seat 3: Onannio ($11.51 in chips)
Seat 5: PlayTheBlues4U ($9.75 in chips)
Seat 6: bbkid44 ($12.83 in chips)
PlayTheBlues4U: posts small blind $0.05
bbkid44: posts big blind $0.10
*** HOLE CARDS ***
Dealt to PlayTheBlues4U [Qh 5s]
mellneazy: folds
Masonstone3: raises $0.20 to $0.30
joncruise leaves the table
Onannio: folds
PlayTheBlues4U: folds
bbkid44: calls $0.20
*** FLOP *** [Jh Kc 7d]
bbkid44: checks
Masonstone3: bets $0.40
bbkid44: calls $0.40
*** TURN *** [Jh Kc 7d] [9s]
hand shuffle joins the table at seat #4
bbkid44: checks
Masonstone3: checks
*** RIVER *** [Jh Kc 7d 9s] [9h]
bbkid44: bets $0.80
Masonstone3: folds
Uncalled bet ($0.80) returned to bbkid44
bbkid44 collected $1.38 from pot
bbkid44: doesn't show hand
*** SUMMARY ***
Total pot $1.45 | Rake $0.07
Board [Jh Kc 7d 9s 9h]
Seat 1: mellneazy folded before Flop (didn't bet)
Seat 2: Masonstone3 folded on the River
Seat 3: Onannio (button) folded before Flop (didn't bet)
Seat 5: PlayTheBlues4U (small blind) folded before Flop
Seat 6: bbkid44 (big blind) collected ($1.38)


PokerStars Hand #204208139873:  Hold'em No Limit ($0.05/$0.10 USD) - 2019/10/03 23:21:06 ET
Table 'Pollux' 6-max Seat #2 is the button
Seat 1: mellneazy ($9.66 in chips)
Seat 2: Masonstone3 ($42.59 in chips)
Seat 3: Onannio ($11.56 in chips)
Seat 5: PlayTheBlues4U ($9.85 in chips)
Seat 6: bbkid44 ($12.69 in chips)
Onannio: posts small blind $0.05
PlayTheBlues4U: posts big blind $0.10
*** HOLE CARDS ***
Dealt to PlayTheBlues4U [3c 7s]
bbkid44: calls $0.10
PlayTheBlues4U said, "whoa"
mellneazy: folds
Masonstone3: folds
Onannio: folds
PlayTheBlues4U: checks
*** FLOP *** [6c 8c Th]
PlayTheBlues4U: checks
joncruise said, "figures lol"
bbkid44: bets $0.24
PlayTheBlues4U: folds [3c 7s]
Uncalled bet ($0.24) returned to bbkid44
bbkid44 collected $0.24 from pot
bbkid44: doesn't show hand
*** SUMMARY ***
Total pot $0.25 | Rake $0.01
Board [6c 8c Th]
Seat 1: mellneazy folded before Flop (didn't bet)
Seat 2: Masonstone3 (button) folded before Flop (didn't bet)
Seat 3: Onannio (small blind) folded before Flop
Seat 5: PlayTheBlues4U (big blind) folded on the Flop
Seat 6: bbkid44 collected ($0.24)


PokerStars Hand #204208139833:  Hold'em No Limit ($0.02/$0.05 USD) - 2019/10/03 23:20:52 ET
Table 'Phoenix' 6-max Seat #4 is the button
Seat 1: smokestackinggg ($3.88 in chips)
Seat 2: rellerz ($3.73 in chips)
Seat 3: Smuggler1991 ($4.97 in chips)
Seat 4: trocchia79 ($6.06 in chips)
Seat 6: PlayTheBlues4U ($4.90 in chips)
kysinjer will be allowed to play after the button
PlayTheBlues4U: posts small blind $0.02
smokestackinggg: posts big blind $0.05
*** HOLE CARDS ***
Dealt to PlayTheBlues4U [Jd 3s]
rellerz: calls $0.05
Smuggler1991: calls $0.05
trocchia79: folds
PlayTheBlues4U: folds
smokestackinggg: checks
*** FLOP *** [Jh 8s 8c]
smokestackinggg: checks
rellerz: checks
Smuggler1991: checks
*** TURN *** [Jh 8s 8c] [9d]
smokestackinggg: bets $0.15
rellerz: folds
Smuggler1991: calls $0.15
*** RIVER *** [Jh 8s 8c 9d] [Kh]
smokestackinggg: bets $0.23
Smuggler1991: raises $0.23 to $0.46
smokestackinggg: calls $0.23
*** SHOW DOWN ***
Smuggler1991: shows [8h Ad] (three of a kind, Eights)
smokestackinggg: mucks hand
Smuggler1991 collected $1.32 from pot
*** SUMMARY ***
Total pot $1.39 | Rake $0.07
Board [Jh 8s 8c 9d Kh]
Seat 1: smokestackinggg (big blind) mucked [Qd 8d]
Seat 2: rellerz folded on the Turn
Seat 3: Smuggler1991 showed [8h Ad] and won ($1.32) with three of a kind, Eights
Seat 4: trocchia79 (button) folded before Flop (didn't bet)
Seat 6: PlayTheBlues4U (small blind) folded before Flop


PokerStars Hand #204208139708:  Hold'em No Limit ($0.02/$0.05 USD) - 2019/10/03 23:20:06 ET
Table 'Phoenix' 6-max Seat #3 is the button
Seat 1: smokestackinggg ($3.88 in chips)
Seat 2: rellerz ($3.78 in chips)
Seat 3: Smuggler1991 ($4.97 in chips)
Seat 4: trocchia79 ($6.21 in chips)
Seat 6: PlayTheBlues4U ($4.72 in chips)
trocchia79: posts small blind $0.02
PlayTheBlues4U: posts big blind $0.05
*** HOLE CARDS ***
Dealt to PlayTheBlues4U [6c 7s]
smokestackinggg: folds
rellerz: calls $0.05
kysinjer joins the table at seat #5
Smuggler1991: folds
trocchia79: calls $0.03
PlayTheBlues4U: checks
*** FLOP *** [8d 2c 9d]
trocchia79: checks
PlayTheBlues4U: bets $0.10
rellerz: folds
trocchia79: calls $0.10
*** TURN *** [8d 2c 9d] [Ah]
trocchia79: checks
PlayTheBlues4U: bets $0.20
trocchia79: folds
Uncalled bet ($0.20) returned to PlayTheBlues4U
PlayTheBlues4U collected $0.33 from pot
PlayTheBlues4U: doesn't show hand
*** SUMMARY ***
Total pot $0.35 | Rake $0.02
Board [8d 2c 9d Ah]
Seat 1: smokestackinggg folded before Flop (didn't bet)
Seat 2: rellerz folded on the Flop
Seat 3: Smuggler1991 (button) folded before Flop (didn't bet)
Seat 4: trocchia79 (small blind) folded on the Turn
Seat 6: PlayTheBlues4U (big blind) collected ($0.33)


PokerStars Hand #204208139660:  Hold'em No Limit ($0.05/$0.10 USD) - 2019/10/03 23:19:49 ET
Table 'Pollux' 6-max Seat #1 is the button
Seat 1: mellneazy ($9.76 in chips)
Seat 2: Masonstone3 ($30.98 in chips)
Seat 3: Onannio ($11.86 in chips)
Seat 4: joncruise ($12.48 in chips)
Seat 5: PlayTheBlues4U ($9.85 in chips)
Seat 6: bbkid44 ($12.69 in chips)
Masonstone3: posts small blind $0.05
Onannio: posts big blind $0.10
*** HOLE CARDS ***
Dealt to PlayTheBlues4U [6h 4d]
joncruise: calls $0.10
PlayTheBlues4U: folds
bbkid44: folds
mellneazy: calls $0.10
Masonstone3: calls $0.05
Onannio: checks
*** FLOP *** [Th Qc Qd]
Masonstone3: checks
Onannio: bets $0.20
joncruise: calls $0.20
mellneazy: folds
Masonstone3: calls $0.20
*** TURN *** [Th Qc Qd] [2h]
Masonstone3: checks
Onannio: checks
joncruise: bets $0.90
Masonstone3: calls $0.90
Onannio: folds
*** RIVER *** [Th Qc Qd 2h] [4c]
Masonstone3: bets $3.20
joncruise: raises $8.08 to $11.28 and is all-in
Masonstone3: calls $8.08
*** SHOW DOWN ***
joncruise: shows [Ks Qs] (three of a kind, Queens)
Masonstone3: shows [4s Qh] (a full house, Queens full of Fours)
Masonstone3 collected $24.09 from pot
*** SUMMARY ***
Total pot $25.36 | Rake $1.27
Board [Th Qc Qd 2h 4c]
Seat 1: mellneazy (button) folded on the Flop
Seat 2: Masonstone3 (small blind) showed [4s Qh] and won ($24.09) with a full house, Queens full of Fours
Seat 3: Onannio (big blind) folded on the Turn
Seat 4: joncruise showed [Ks Qs] and lost with three of a kind, Queens
Seat 5: PlayTheBlues4U folded before Flop (didn't bet)
Seat 6: bbkid44 folded before Flop (didn't bet)


PokerStars Hand #204208139619:  Hold'em No Limit ($0.02/$0.05 USD) - 2019/10/03 23:19:34 ET
Table 'Phoenix' 6-max Seat #2 is the button
Seat 1: smokestackinggg ($3.88 in chips)
Seat 2: rellerz ($3.78 in chips)
Seat 3: Smuggler1991 ($4.99 in chips)
Seat 4: trocchia79 ($6.26 in chips)
Seat 5: DemolishIT ($19.59 in chips)
Seat 6: PlayTheBlues4U ($4.65 in chips)
Smuggler1991: posts small blind $0.02
trocchia79: posts big blind $0.05
*** HOLE CARDS ***
Dealt to PlayTheBlues4U [Qs Qd]
DemolishIT: folds
PlayTheBlues4U: raises $0.10 to $0.15
smokestackinggg: folds
rellerz: folds
DemolishIT leaves the table
Smuggler1991: folds
trocchia79: folds
Uncalled bet ($0.10) returned to PlayTheBlues4U
PlayTheBlues4U collected $0.12 from pot
PlayTheBlues4U: doesn't show hand
*** SUMMARY ***
Total pot $0.12 | Rake $0
Seat 1: smokestackinggg folded before Flop (didn't bet)
Seat 2: rellerz (button) folded before Flop (didn't bet)
Seat 3: Smuggler1991 (small blind) folded before Flop
Seat 4: trocchia79 (big blind) folded before Flop
Seat 5: DemolishIT folded before Flop (didn't bet)
Seat 6: PlayTheBlues4U collected ($0.12)


PokerStars Hand #204208139602:  Hold'em No Limit ($0.05/$0.10 USD) - 2019/10/03 23:19:28 ET
Table 'Pollux' 6-max Seat #6 is the button
Seat 1: mellneazy ($9.86 in chips)
Seat 2: Masonstone3 ($31.08 in chips)
Seat 3: Onannio ($11.86 in chips)
Seat 4: joncruise ($12.48 in chips)
Seat 5: PlayTheBlues4U ($9.85 in chips)
Seat 6: bbkid44 ($12.51 in chips)
mellneazy: posts small blind $0.05
Masonstone3: posts big blind $0.10
*** HOLE CARDS ***
Dealt to PlayTheBlues4U [9h Qs]
Onannio: folds
joncruise: folds
PlayTheBlues4U: folds
bbkid44: calls $0.10
mellneazy: calls $0.05
Masonstone3: checks
*** FLOP *** [4c 3s 8c]
mellneazy: checks
Masonstone3: checks
bbkid44: bets $0.50
mellneazy: folds
Masonstone3: folds
Uncalled bet ($0.50) returned to bbkid44
bbkid44 collected $0.28 from pot
bbkid44: doesn't show hand
*** SUMMARY ***
Total pot $0.30 | Rake $0.02
Board [4c 3s 8c]
Seat 1: mellneazy (small blind) folded on the Flop
Seat 2: Masonstone3 (big blind) folded on the Flop
Seat 3: Onannio folded before Flop (didn't bet)
Seat 4: joncruise folded before Flop (didn't bet)
Seat 5: PlayTheBlues4U folded before Flop (didn't bet)
Seat 6: bbkid44 (button) collected ($0.28)


PokerStars Hand #204208139444:  Hold'em No Limit ($0.05/$0.10 USD) - 2019/10/03 23:18:28 ET
Table 'Pollux' 6-max Seat #5 is the button
Seat 1: mellneazy ($10.46 in chips)
Seat 2: Masonstone3 ($30.16 in chips)
Seat 3: Onannio ($11.86 in chips)
Seat 4: joncruise ($12.68 in chips)
Seat 5: PlayTheBlues4U ($9.85 in chips)
Seat 6: bbkid44 ($12.71 in chips)
bbkid44: posts small blind $0.05
mellneazy: posts big blind $0.10
*** HOLE CARDS ***
Dealt to PlayTheBlues4U [5h Ts]
Masonstone3: raises $0.10 to $0.20
Onannio: folds
joncruise: calls $0.20
PlayTheBlues4U: folds
bbkid44: calls $0.15
mellneazy: calls $0.10
*** FLOP *** [Qd 4h 6s]
bbkid44: checks
mellneazy: checks
Masonstone3: bets $0.40
joncruise: folds
bbkid44: folds
mellneazy: calls $0.40
*** TURN *** [Qd 4h 6s] [9h]
mellneazy: checks
Masonstone3: bets $1.30
mellneazy: folds
Uncalled bet ($1.30) returned to Masonstone3
Masonstone3 collected $1.52 from pot
Masonstone3: doesn't show hand
*** SUMMARY ***
Total pot $1.60 | Rake $0.08
Board [Qd 4h 6s 9h]
Seat 1: mellneazy (big blind) folded on the Turn
Seat 2: Masonstone3 collected ($1.52)
Seat 3: Onannio folded before Flop (didn't bet)
Seat 4: joncruise folded on the Flop
Seat 5: PlayTheBlues4U (button) folded before Flop (didn't bet)
Seat 6: bbkid44 (small blind) folded on the Flop


PokerStars Hand #204208139442:  Hold'em No Limit ($0.02/$0.05 USD) - 2019/10/03 23:18:27 ET
Table 'Phoenix' 6-max Seat #1 is the button
Seat 1: smokestackinggg ($3.88 in chips)
Seat 2: rellerz ($3.83 in chips)
Seat 3: Smuggler1991 ($5.04 in chips)
Seat 4: trocchia79 ($6.17 in chips)
Seat 5: DemolishIT ($19.59 in chips)
Seat 6: PlayTheBlues4U ($4.65 in chips)
rellerz: posts small blind $0.02
Smuggler1991: posts big blind $0.05
*** HOLE CARDS ***
Dealt to PlayTheBlues4U [2h Td]
trocchia79: calls $0.05
DemolishIT: folds
PlayTheBlues4U: folds
smokestackinggg: folds
rellerz: calls $0.03
Smuggler1991: checks
*** FLOP *** [5c Ad 5h]
rellerz: checks
Smuggler1991: checks
trocchia79: checks
*** TURN *** [5c Ad 5h] [9s]
rellerz: checks
Smuggler1991: checks
trocchia79: checks
*** RIVER *** [5c Ad 5h 9s] [Jh]
rellerz: checks
Smuggler1991: checks
trocchia79: checks
*** SHOW DOWN ***
rellerz: shows [4s Tc] (a pair of Fives)
Smuggler1991: shows [6c Ts] (a pair of Fives)
trocchia79: shows [Kh Qd] (a pair of Fives - Ace+King kicker)
trocchia79 collected $0.14 from pot
*** SUMMARY ***
Total pot $0.15 | Rake $0.01
Board [5c Ad 5h 9s Jh]
Seat 1: smokestackinggg (button) folded before Flop (didn't bet)
Seat 2: rellerz (small blind) showed [4s Tc] and lost with a pair of Fives
Seat 3: Smuggler1991 (big blind) showed [6c Ts] and lost with a pair of Fives
Seat 4: trocchia79 showed [Kh Qd] and won ($0.14) with a pair of Fives
Seat 5: DemolishIT folded before Flop (didn't bet)
Seat 6: PlayTheBlues4U folded before Flop (didn't bet)


PokerStars Hand #204208139296:  Hold'em No Limit ($0.02/$0.05 USD) - 2019/10/03 23:17:40 ET
Table 'Phoenix' 6-max Seat #6 is the button
Seat 1: smokestackinggg ($3.90 in chips)
Seat 2: rellerz ($3.79 in chips)
Seat 3: Smuggler1991 ($5.01 in chips)
Seat 4: trocchia79 ($6.22 in chips)
Seat 5: DemolishIT ($19.64 in chips)
Seat 6: PlayTheBlues4U ($4.70 in chips)
smokestackinggg: posts small blind $0.02
rellerz: posts big blind $0.05
*** HOLE CARDS ***
Dealt to PlayTheBlues4U [9s Js]
Smuggler1991: calls $0.05
trocchia79: calls $0.05
DemolishIT: calls $0.05
PlayTheBlues4U: calls $0.05
smokestackinggg: folds
rellerz: checks
*** FLOP *** [Ac Jh 6s]
rellerz: bets $0.05
Smuggler1991: raises $0.35 to $0.40
trocchia79: folds
DemolishIT: folds
PlayTheBlues4U: folds
rellerz: calls $0.35
*** TURN *** [Ac Jh 6s] [9d]
rellerz: checks
Smuggler1991: checks
*** RIVER *** [Ac Jh 6s 9d] [4s]
rellerz: bets $0.50
Smuggler1991: calls $0.50
*** SHOW DOWN ***
rellerz: shows [Ad 3d] (a pair of Aces)
Smuggler1991: shows [Ah 2d] (a pair of Aces)
rellerz collected $0.99 from pot
Smuggler1991 collected $0.98 from pot
*** SUMMARY ***
Total pot $2.07 | Rake $0.10
Board [Ac Jh 6s 9d 4s]
Seat 1: smokestackinggg (small blind) folded before Flop
Seat 2: rellerz (big blind) showed [Ad 3d] and won ($0.99) with a pair of Aces
Seat 3: Smuggler1991 showed [Ah 2d] and won ($0.98) with a pair of Aces
Seat 4: trocchia79 folded on the Flop
Seat 5: DemolishIT folded on the Flop
Seat 6: PlayTheBlues4U (button) folded on the Flop


PokerStars Hand #204208139252:  Hold'em No Limit ($0.05/$0.10 USD) - 2019/10/03 23:17:18 ET
Table 'Pollux' 6-max Seat #4 is the button
Seat 1: mellneazy ($10.76 in chips)
Seat 2: Masonstone3 ($30.46 in chips)
Seat 3: Onannio ($11.86 in chips)
Seat 4: joncruise ($6.35 in chips)
Seat 5: PlayTheBlues4U ($9.90 in chips)
Seat 6: bbkid44 ($19.06 in chips)
PlayTheBlues4U: posts small blind $0.05
bbkid44: posts big blind $0.10
*** HOLE CARDS ***
Dealt to PlayTheBlues4U [Td 3c]
mellneazy: raises $0.20 to $0.30
Masonstone3: calls $0.30
Onannio: folds
joncruise: calls $0.30
PlayTheBlues4U: folds
bbkid44: calls $0.20
*** FLOP *** [Qs 4s 6c]
bbkid44: checks
mellneazy: checks
Masonstone3: checks
joncruise: bets $0.60
bbkid44: calls $0.60
mellneazy: folds
Masonstone3: folds
*** TURN *** [Qs 4s 6c] [7d]
bbkid44: bets $0.70
joncruise: raises $4.75 to $5.45 and is all-in
bbkid44: calls $4.75
*** RIVER *** [Qs 4s 6c 7d] [7h]
*** SHOW DOWN ***
bbkid44: shows [5d 6s] (two pair, Sevens and Sixes)
joncruise: shows [7c Qc] (a full house, Sevens full of Queens)
joncruise collected $12.68 from pot
*** SUMMARY ***
Total pot $13.35 | Rake $0.67
Board [Qs 4s 6c 7d 7h]
Seat 1: mellneazy folded on the Flop
Seat 2: Masonstone3 folded on the Flop
Seat 3: Onannio folded before Flop (didn't bet)
Seat 4: joncruise (button) showed [7c Qc] and won ($12.68) with a full house, Sevens full of Queens
Seat 5: PlayTheBlues4U (small blind) folded before Flop
Seat 6: bbkid44 (big blind) showed [5d 6s] and lost with two pair, Sevens and Sixes


PokerStars Hand #204208139169:  Hold'em No Limit ($0.05/$0.10 USD) - 2019/10/03 23:16:47 ET
Table 'Pollux' 6-max Seat #3 is the button
Seat 1: mellneazy ($10.96 in chips)
Seat 2: Masonstone3 ($30.46 in chips)
Seat 3: Onannio ($12.26 in chips)
Seat 4: joncruise ($6.40 in chips)
Seat 5: PlayTheBlues4U ($10 in chips)
Seat 6: bbkid44 ($18.37 in chips)
joncruise: posts small blind $0.05
PlayTheBlues4U: posts big blind $0.10
*** HOLE CARDS ***
Dealt to PlayTheBlues4U [Qs 2c]
bbkid44: raises $0.10 to $0.20
mellneazy: calls $0.20
Masonstone3: folds
Onannio: calls $0.20
joncruise: folds
PlayTheBlues4U: folds
*** FLOP *** [Qd 2s Js]
bbkid44: checks
mellneazy: checks
Onannio: checks
*** TURN *** [Qd 2s Js] [Jd]
bbkid44: checks
mellneazy: checks
Onannio: bets $0.20
bbkid44: calls $0.20
mellneazy: folds
*** RIVER *** [Qd 2s Js Jd] [Ac]
Masonstone3 said, "big fold."
bbkid44: checks
Onannio: checks
*** SHOW DOWN ***
bbkid44: shows [Th Td] (two pair, Jacks and Tens)
Onannio: mucks hand
bbkid44 collected $1.09 from pot
*** SUMMARY ***
Total pot $1.15 | Rake $0.06
Board [Qd 2s Js Jd Ac]
Seat 1: mellneazy folded on the Turn
Seat 2: Masonstone3 folded before Flop (didn't bet)
Seat 3: Onannio (button) mucked [4d 5d]
Seat 4: joncruise (small blind) folded before Flop
Seat 5: PlayTheBlues4U (big blind) folded before Flop
Seat 6: bbkid44 showed [Th Td] and won ($1.09) with two pair, Jacks and Tens


PokerStars Hand #204208139152:  Hold'em No Limit ($0.02/$0.05 USD) - 2019/10/03 23:16:40 ET
Table 'Phoenix' 6-max Seat #5 is the button
Seat 1: smokestackinggg ($3.95 in chips)
Seat 2: rellerz ($3.79 in chips)
Seat 3: Smuggler1991 ($5.01 in chips)
Seat 4: trocchia79 ($6.22 in chips)
Seat 5: DemolishIT ($19.37 in chips)
Seat 6: PlayTheBlues4U ($4.95 in chips)
PlayTheBlues4U: posts small blind $0.02
smokestackinggg: posts big blind $0.05
*** HOLE CARDS ***
Dealt to PlayTheBlues4U [9s Kc]
rellerz: folds
Smuggler1991: folds
trocchia79: folds
DemolishIT: raises $0.20 to $0.25
PlayTheBlues4U: calls $0.23
smokestackinggg: folds
*** FLOP *** [3c 3h Ac]
PlayTheBlues4U: checks
DemolishIT: bets $0.52
PlayTheBlues4U: folds
Uncalled bet ($0.52) returned to DemolishIT
DemolishIT collected $0.52 from pot
*** SUMMARY ***
Total pot $0.55 | Rake $0.03
Board [3c 3h Ac]
Seat 1: smokestackinggg (big blind) folded before Flop
Seat 2: rellerz folded before Flop (didn't bet)
Seat 3: Smuggler1991 folded before Flop (didn't bet)
Seat 4: trocchia79 folded before Flop (didn't bet)
Seat 5: DemolishIT (button) collected ($0.52)
Seat 6: PlayTheBlues4U (small blind) folded on the Flop


PokerStars Hand #204208139081:  Hold'em No Limit ($0.01/$0.02 USD) - 2019/10/03 23:16:12 ET
Table 'Auriga' 6-max Seat #2 is the button
Seat 1: Smuggler1991 ($4.75 in chips)
Seat 2: smoothdram18 ($3.52 in chips)
Seat 3: LilCardSmith ($1.98 in chips)
Seat 4: evanb004 ($3.47 in chips)
Seat 5: PlayTheBlues4U ($1.93 in chips)
Seat 6: andreybhr ($3.77 in chips)
LilCardSmith: posts small blind $0.01
evanb004: posts big blind $0.02
*** HOLE CARDS ***
Dealt to PlayTheBlues4U [Ks Ah]
PlayTheBlues4U: raises $0.06 to $0.08
andreybhr is connected
andreybhr has timed out while disconnected
andreybhr: folds
Smuggler1991: raises $0.19 to $0.27
smoothdram18: folds
LilCardSmith: folds
evanb004: calls $0.25
PlayTheBlues4U: calls $0.19
*** FLOP *** [4s 5c Kd]
evanb004: checks
PlayTheBlues4U: checks
Smuggler1991: checks
*** TURN *** [4s 5c Kd] [8d]
evanb004: checks
PlayTheBlues4U: bets $0.48
andreybhr is disconnected
Smuggler1991: folds
evanb004: calls $0.48
*** RIVER *** [4s 5c Kd 8d] [Jc]
evanb004: checks
PlayTheBlues4U: bets $1.18 and is all-in
evanb004: folds
Uncalled bet ($1.18) returned to PlayTheBlues4U
PlayTheBlues4U collected $1.70 from pot
PlayTheBlues4U: doesn't show hand
*** SUMMARY ***
Total pot $1.78 | Rake $0.08
Board [4s 5c Kd 8d Jc]
Seat 1: Smuggler1991 folded on the Turn
Seat 2: smoothdram18 (button) folded before Flop (didn't bet)
Seat 3: LilCardSmith (small blind) folded before Flop
Seat 4: evanb004 (big blind) folded on the River
Seat 5: PlayTheBlues4U collected ($1.70)
Seat 6: andreybhr folded before Flop (didn't bet)


PokerStars Hand #204208139016:  Hold'em No Limit ($0.01/$0.02 USD) - 2019/10/03 23:15:45 ET
Table 'Auriga' 6-max Seat #1 is the button
Seat 1: Smuggler1991 ($4.75 in chips)
Seat 2: smoothdram18 ($3.53 in chips)
Seat 3: LilCardSmith ($2 in chips)
Seat 4: evanb004 ($3.44 in chips)
Seat 5: PlayTheBlues4U ($1.93 in chips)
Seat 6: andreybhr ($3.77 in chips)
smoothdram18: posts small blind $0.01
LilCardSmith: posts big blind $0.02
*** HOLE CARDS ***
Dealt to PlayTheBlues4U [Kh Tc]
evanb004: raises $0.05 to $0.07
PlayTheBlues4U: folds
andreybhr: folds
Smuggler1991: folds
smoothdram18: folds
LilCardSmith: folds
Uncalled bet ($0.05) returned to evanb004
evanb004 collected $0.05 from pot
evanb004: doesn't show hand
*** SUMMARY ***
Total pot $0.05 | Rake $0
Seat 1: Smuggler1991 (button) folded before Flop (didn't bet)
Seat 2: smoothdram18 (small blind) folded before Flop
Seat 3: LilCardSmith (big blind) folded before Flop
Seat 4: evanb004 collected ($0.05)
Seat 5: PlayTheBlues4U folded before Flop (didn't bet)
Seat 6: andreybhr folded before Flop (didn't bet)


PokerStars Hand #204208139012:  Hold'em No Limit ($0.02/$0.05 USD) - 2019/10/03 23:15:44 ET
Table 'Phoenix' 6-max Seat #4 is the button
Seat 1: smokestackinggg ($3.95 in chips)
Seat 2: rellerz ($4.44 in chips)
Seat 3: Smuggler1991 ($5.01 in chips)
Seat 4: trocchia79 ($5.57 in chips)
Seat 5: DemolishIT ($19.39 in chips)
Seat 6: PlayTheBlues4U ($5 in chips)
DemolishIT: posts small blind $0.02
PlayTheBlues4U: posts big blind $0.05
*** HOLE CARDS ***
Dealt to PlayTheBlues4U [9h 3c]
smokestackinggg: folds
rellerz: calls $0.05
Smuggler1991: folds
trocchia79: calls $0.05
DemolishIT: folds
PlayTheBlues4U: checks
*** FLOP *** [4h 7c Kc]
PlayTheBlues4U: checks
rellerz: checks
trocchia79: checks
*** TURN *** [4h 7c Kc] [Qc]
PlayTheBlues4U: checks
rellerz: checks
trocchia79: bets $0.15
PlayTheBlues4U: folds
rellerz: calls $0.15
*** RIVER *** [4h 7c Kc Qc] [8h]
rellerz: checks
trocchia79: bets $0.45
rellerz: calls $0.45
*** SHOW DOWN ***
trocchia79: shows [Qs 8d] (two pair, Queens and Eights)
rellerz: mucks hand
trocchia79 collected $1.30 from pot
*** SUMMARY ***
Total pot $1.37 | Rake $0.07
Board [4h 7c Kc Qc 8h]
Seat 1: smokestackinggg folded before Flop (didn't bet)
Seat 2: rellerz mucked [Ts Qh]
Seat 3: Smuggler1991 folded before Flop (didn't bet)
Seat 4: trocchia79 (button) showed [Qs 8d] and won ($1.30) with two pair, Queens and Eights
Seat 5: DemolishIT (small blind) folded before Flop
Seat 6: PlayTheBlues4U (big blind) folded on the Turn


PokerStars Hand #204208138789:  Hold'em No Limit ($0.01/$0.02 USD) - 2019/10/03 23:14:32 ET
Table 'Auriga' 6-max Seat #6 is the button
Seat 1: Smuggler1991 ($4.83 in chips)
Seat 2: smoothdram18 ($3.55 in chips)
Seat 4: evanb004 ($3.35 in chips)
Seat 5: PlayTheBlues4U ($1.93 in chips)
Seat 6: andreybhr ($3.77 in chips)
Smuggler1991: posts small blind $0.01
smoothdram18: posts big blind $0.02
LilCardSmith: sits out
*** HOLE CARDS ***
Dealt to PlayTheBlues4U [6c Qh]
evanb004: raises $0.06 to $0.08
PlayTheBlues4U: folds
andreybhr: folds
Smuggler1991: calls $0.07
smoothdram18: folds
*** FLOP *** [As Jh 2h]
Smuggler1991: checks
evanb004: checks
*** TURN *** [As Jh 2h] [7d]
Smuggler1991: checks
evanb004: bets $0.17
andreybhr is disconnected
Smuggler1991: folds
Uncalled bet ($0.17) returned to evanb004
evanb004 collected $0.17 from pot
evanb004: doesn't show hand
*** SUMMARY ***
Total pot $0.18 | Rake $0.01
Board [As Jh 2h 7d]
Seat 1: Smuggler1991 (small blind) folded on the Turn
Seat 2: smoothdram18 (big blind) folded before Flop
Seat 4: evanb004 collected ($0.17)
Seat 5: PlayTheBlues4U folded before Flop (didn't bet)
Seat 6: andreybhr (button) folded before Flop (didn't bet)


PokerStars Hand #204208138751:  Hold'em No Limit ($0.02/$0.05 USD) - 2019/10/03 23:14:18 ET
Table 'Phoenix' 6-max Seat #3 is the button
Seat 1: smokestackinggg ($3.95 in chips)
Seat 2: rellerz ($4.66 in chips)
Seat 3: Smuggler1991 ($5.23 in chips)
Seat 4: trocchia79 ($4.95 in chips)
Seat 5: DemolishIT ($19.61 in chips)
Seat 6: PlayTheBlues4U ($5 in chips)
trocchia79: posts small blind $0.02
DemolishIT: posts big blind $0.05
*** HOLE CARDS ***
Dealt to PlayTheBlues4U [Tc 3c]
PlayTheBlues4U: folds
smokestackinggg has timed out
smokestackinggg: folds
rellerz: calls $0.05
Smuggler1991: raises $0.17 to $0.22
trocchia79: calls $0.20
DemolishIT: calls $0.17
rellerz: calls $0.17
*** FLOP *** [Td 2h 4c]
trocchia79: checks
DemolishIT: checks
rellerz: checks
Smuggler1991: checks
*** TURN *** [Td 2h 4c] [Qs]
trocchia79: checks
DemolishIT: checks
rellerz: checks
Smuggler1991: checks
*** RIVER *** [Td 2h 4c Qs] [Js]
trocchia79: checks
DemolishIT: checks
rellerz: checks
Smuggler1991: checks
*** SHOW DOWN ***
trocchia79: shows [5c 5h] (a pair of Fives)
DemolishIT: mucks hand
rellerz: mucks hand
Smuggler1991: mucks hand
trocchia79 collected $0.84 from pot
*** SUMMARY ***
Total pot $0.88 | Rake $0.04
Board [Td 2h 4c Qs Js]
Seat 1: smokestackinggg folded before Flop (didn't bet)
Seat 2: rellerz mucked [7h 4h]
Seat 3: Smuggler1991 (button) mucked [As 9h]
Seat 4: trocchia79 (small blind) showed [5c 5h] and won ($0.84) with a pair of Fives
Seat 5: DemolishIT (big blind) mucked [2d Ah]
Seat 6: PlayTheBlues4U folded before Flop (didn't bet)


PokerStars Hand #204208138709:  Hold'em No Limit ($0.01/$0.02 USD) - 2019/10/03 23:14:03 ET
Table 'Auriga' 6-max Seat #5 is the button
Seat 1: Smuggler1991 ($4.85 in chips)
Seat 2: smoothdram18 ($3.55 in chips)
Seat 4: evanb004 ($3.35 in chips)
Seat 5: PlayTheBlues4U ($1.93 in chips)
Seat 6: andreybhr ($3.75 in chips)
andreybhr: posts small blind $0.01
Smuggler1991: posts big blind $0.02
LilCardSmith: sits out
*** HOLE CARDS ***
Dealt to PlayTheBlues4U [4c 8h]
smoothdram18: folds
evanb004: folds
PlayTheBlues4U: folds
andreybhr: calls $0.01
Smuggler1991: checks
*** FLOP *** [Th Js Ts]
andreybhr: checks
Smuggler1991: checks
*** TURN *** [Th Js Ts] [4h]
andreybhr: checks
Smuggler1991: checks
*** RIVER *** [Th Js Ts 4h] [7c]
andreybhr: checks
Smuggler1991: checks
*** SHOW DOWN ***
andreybhr: shows [3s 3d] (two pair, Tens and Threes)
Smuggler1991: mucks hand
andreybhr collected $0.04 from pot
*** SUMMARY ***
Total pot $0.04 | Rake $0
Board [Th Js Ts 4h 7c]
Seat 1: Smuggler1991 (big blind) mucked [5h 6s]
Seat 2: smoothdram18 folded before Flop (didn't bet)
Seat 4: evanb004 folded before Flop (didn't bet)
Seat 5: PlayTheBlues4U (button) folded before Flop (didn't bet)
Seat 6: andreybhr (small blind) showed [3s 3d] and won ($0.04) with two pair, Tens and Threes


PokerStars Hand #204208138525:  Hold'em No Limit ($0.01/$0.02 USD) - 2019/10/03 23:12:59 ET
Table 'Auriga' 6-max Seat #4 is the button
Seat 1: Smuggler1991 ($4.85 in chips)
Seat 2: smoothdram18 ($3.55 in chips)
Seat 4: evanb004 ($3.32 in chips)
Seat 5: PlayTheBlues4U ($1.94 in chips)
Seat 6: andreybhr ($3.77 in chips)
PlayTheBlues4U: posts small blind $0.01
andreybhr: posts big blind $0.02
*** HOLE CARDS ***
Dealt to PlayTheBlues4U [3s 4d]
Smuggler1991: folds
smoothdram18: folds
evanb004: raises $0.05 to $0.07
PlayTheBlues4U: folds
LilCardSmith joins the table at seat #3
andreybhr is disconnected
andreybhr is connected
andreybhr: folds
Uncalled bet ($0.05) returned to evanb004
evanb004 collected $0.05 from pot
evanb004: doesn't show hand
*** SUMMARY ***
Total pot $0.05 | Rake $0
Seat 1: Smuggler1991 folded before Flop (didn't bet)
Seat 2: smoothdram18 folded before Flop (didn't bet)
Seat 4: evanb004 (button) collected ($0.05)
Seat 5: PlayTheBlues4U (small blind) folded before Flop
Seat 6: andreybhr (big blind) folded before Flop


PokerStars Hand #204208138465:  Hold'em No Limit ($0.01/$0.02 USD) - 2019/10/03 23:12:38 ET
Table 'Auriga' 6-max Seat #2 is the button
Seat 1: Smuggler1991 ($4.85 in chips)
Seat 2: smoothdram18 ($3.52 in chips)
Seat 4: evanb004 ($3.33 in chips)
Seat 5: PlayTheBlues4U ($1.96 in chips)
Seat 6: andreybhr ($3.77 in chips)
evanb004: posts small blind $0.01
PlayTheBlues4U: posts big blind $0.02
*** HOLE CARDS ***
Dealt to PlayTheBlues4U [5d 2h]
andreybhr: folds
Smuggler1991: folds
smoothdram18: raises $0.05 to $0.07
evanb004: folds
PlayTheBlues4U: folds
Uncalled bet ($0.05) returned to smoothdram18
smoothdram18 collected $0.05 from pot
smoothdram18: doesn't show hand
*** SUMMARY ***
Total pot $0.05 | Rake $0
Seat 1: Smuggler1991 folded before Flop (didn't bet)
Seat 2: smoothdram18 (button) collected ($0.05)
Seat 4: evanb004 (small blind) folded before Flop
Seat 5: PlayTheBlues4U (big blind) folded before Flop
Seat 6: andreybhr folded before Flop (didn't bet)


PokerStars Hand #204208138402:  Hold'em No Limit ($0.02/$0.05 USD) - 2019/10/03 23:12:17 ET
Table 'Phoenix' 6-max Seat #6 is the button
Seat 2: rellerz ($4.68 in chips)
Seat 3: Smuggler1991 ($7.27 in chips)
Seat 5: DemolishIT ($10.50 in chips)
Seat 6: PlayTheBlues4U ($7.46 in chips)
rellerz: posts small blind $0.02
Smuggler1991: posts big blind $0.05
*** HOLE CARDS ***
Dealt to PlayTheBlues4U [Ah Qc]
DemolishIT: raises $0.15 to $0.20
PlayTheBlues4U: calls $0.20
rellerz: folds
Smuggler1991: raises $0.62 to $0.82
DemolishIT: calls $0.62
smokestackinggg joins the table at seat #1
PlayTheBlues4U: calls $0.62
*** FLOP *** [Ac 2s 5d]
Smuggler1991: bets $1.20
DemolishIT: calls $1.20
PlayTheBlues4U: calls $1.20
*** TURN *** [Ac 2s 5d] [7s]
Smuggler1991: checks
trocchia79 joins the table at seat #4
DemolishIT: bets $5.78
PlayTheBlues4U: calls $5.44 and is all-in
Smuggler1991: folds
Uncalled bet ($0.34) returned to DemolishIT
*** RIVER *** [Ac 2s 5d 7s] [Th]
*** SHOW DOWN ***
DemolishIT: shows [5c 7c] (two pair, Sevens and Fives)
PlayTheBlues4U: shows [Ah Qc] (a pair of Aces)
DemolishIT collected $16.46 from pot
*** SUMMARY ***
Total pot $16.96 | Rake $0.50
Board [Ac 2s 5d 7s Th]
Seat 2: rellerz (small blind) folded before Flop
Seat 3: Smuggler1991 (big blind) folded on the Turn
Seat 5: DemolishIT showed [5c 7c] and won ($16.46) with two pair, Sevens and Fives
Seat 6: PlayTheBlues4U (button) showed [Ah Qc] and lost with a pair of Aces


PokerStars Hand #204208138372:  Hold'em No Limit ($0.01/$0.02 USD) - 2019/10/03 23:12:05 ET
Table 'Auriga' 6-max Seat #1 is the button
Seat 1: Smuggler1991 ($4.80 in chips)
Seat 2: smoothdram18 ($3.53 in chips)
Seat 4: evanb004 ($3.35 in chips)
Seat 5: PlayTheBlues4U ($1.96 in chips)
Seat 6: andreybhr ($3.79 in chips)
smoothdram18: posts small blind $0.01
evanb004: posts big blind $0.02
andreybhr: posts big blind $0.02
*** HOLE CARDS ***
Dealt to PlayTheBlues4U [6d Ks]
PlayTheBlues4U: folds
andreybhr: checks
Smuggler1991: raises $0.07 to $0.09
smoothdram18: folds
evanb004: folds
andreybhr: folds
Uncalled bet ($0.07) returned to Smuggler1991
Smuggler1991 collected $0.07 from pot
Smuggler1991: doesn't show hand
*** SUMMARY ***
Total pot $0.07 | Rake $0
Seat 1: Smuggler1991 (button) collected ($0.07)
Seat 2: smoothdram18 (small blind) folded before Flop
Seat 4: evanb004 (big blind) folded before Flop
Seat 5: PlayTheBlues4U folded before Flop (didn't bet)
Seat 6: andreybhr folded before Flop (didn't bet)


PokerStars Hand #204208138360:  Hold'em No Limit ($0.02/$0.05 USD) - 2019/10/03 23:12:00 ET
Table 'Phoenix' 6-max Seat #5 is the button
Seat 2: rellerz ($4.73 in chips)
Seat 3: Smuggler1991 ($7.20 in chips)
Seat 5: DemolishIT ($10.50 in chips)
Seat 6: PlayTheBlues4U ($7.48 in chips)
PlayTheBlues4U: posts small blind $0.02
rellerz: posts big blind $0.05
*** HOLE CARDS ***
Dealt to PlayTheBlues4U [8h Ts]
Smuggler1991: raises $0.12 to $0.17
DemolishIT: folds
PlayTheBlues4U: folds
rellerz: folds
Uncalled bet ($0.12) returned to Smuggler1991
Smuggler1991 collected $0.12 from pot
Smuggler1991: doesn't show hand
*** SUMMARY ***
Total pot $0.12 | Rake $0
Seat 2: rellerz (big blind) folded before Flop
Seat 3: Smuggler1991 collected ($0.12)
Seat 5: DemolishIT (button) folded before Flop (didn't bet)
Seat 6: PlayTheBlues4U (small blind) folded before Flop


PokerStars Hand #204208138343:  Hold'em No Limit ($0.01/$0.02 USD) - 2019/10/03 23:11:55 ET
Table 'Auriga' 6-max Seat #5 is the button
Seat 1: Smuggler1991 ($4.81 in chips)
Seat 2: smoothdram18 ($3.52 in chips)
Seat 4: evanb004 ($3.35 in chips)
Seat 5: PlayTheBlues4U ($1.96 in chips)
andreybhr will be allowed to play after the button
Smuggler1991: posts small blind $0.01
smoothdram18: posts big blind $0.02
*** HOLE CARDS ***
Dealt to PlayTheBlues4U [Js 2d]
evanb004: folds
PlayTheBlues4U: folds
Smuggler1991: folds
Uncalled bet ($0.01) returned to smoothdram18
smoothdram18 collected $0.02 from pot
smoothdram18: doesn't show hand
*** SUMMARY ***
Total pot $0.02 | Rake $0
Seat 1: Smuggler1991 (small blind) folded before Flop
Seat 2: smoothdram18 (big blind) collected ($0.02)
Seat 4: evanb004 folded before Flop (didn't bet)
Seat 5: PlayTheBlues4U (button) folded before Flop (didn't bet)


PokerStars Hand #204208138248:  Hold'em No Limit ($0.02/$0.05 USD) - 2019/10/03 23:11:20 ET
Table 'Phoenix' 6-max Seat #3 is the button
Seat 2: rellerz ($3.85 in chips)
Seat 3: Smuggler1991 ($7.20 in chips)
Seat 4: smokestackinggg ($3.68 in chips)
Seat 5: DemolishIT ($11.42 in chips)
Seat 6: PlayTheBlues4U ($7.48 in chips)
smokestackinggg: posts small blind $0.02
DemolishIT: posts big blind $0.05
*** HOLE CARDS ***
Dealt to PlayTheBlues4U [Qc 9s]
PlayTheBlues4U: folds
rellerz: calls $0.05
Smuggler1991: folds
smokestackinggg: calls $0.03
DemolishIT: raises $0.25 to $0.30
rellerz: calls $0.25
smokestackinggg: folds
*** FLOP *** [Jd Ks 2h]
DemolishIT: bets $0.62
rellerz: raises $0.62 to $1.24
DemolishIT: folds
Uncalled bet ($0.62) returned to rellerz
rellerz collected $1.80 from pot
smokestackinggg leaves the table
rellerz: doesn't show hand
*** SUMMARY ***
Total pot $1.89 | Rake $0.09
Board [Jd Ks 2h]
Seat 2: rellerz collected ($1.80)
Seat 3: Smuggler1991 (button) folded before Flop (didn't bet)
Seat 4: smokestackinggg (small blind) folded before Flop
Seat 5: DemolishIT (big blind) folded on the Flop
Seat 6: PlayTheBlues4U folded before Flop (didn't bet)


PokerStars Hand #204208138207:  Hold'em No Limit ($0.02/$0.05 USD) - 2019/10/03 23:11:06 ET
Table 'Phoenix' 6-max Seat #2 is the button
Seat 1: DaGoodz33 ($4.67 in chips)
Seat 2: rellerz ($3.85 in chips)
Seat 3: Smuggler1991 ($7.22 in chips)
Seat 4: smokestackinggg ($3.66 in chips)
Seat 5: DemolishIT ($11.42 in chips)
Seat 6: PlayTheBlues4U ($7.48 in chips)
Smuggler1991: posts small blind $0.02
smokestackinggg: posts big blind $0.05
*** HOLE CARDS ***
Dealt to PlayTheBlues4U [Qs 4h]
DemolishIT: folds
PlayTheBlues4U: folds
DaGoodz33: folds
rellerz: folds
Smuggler1991: folds
Uncalled bet ($0.03) returned to smokestackinggg
DaGoodz33 leaves the table
smokestackinggg collected $0.04 from pot
smokestackinggg: doesn't show hand
*** SUMMARY ***
Total pot $0.04 | Rake $0
Seat 1: DaGoodz33 folded before Flop (didn't bet)
Seat 2: rellerz (button) folded before Flop (didn't bet)
Seat 3: Smuggler1991 (small blind) folded before Flop
Seat 4: smokestackinggg (big blind) collected ($0.04)
Seat 5: DemolishIT folded before Flop (didn't bet)
Seat 6: PlayTheBlues4U folded before Flop (didn't bet)


PokerStars Hand #204208138162:  Hold'em No Limit ($0.02/$0.05 USD) - 2019/10/03 23:10:50 ET
Table 'Phoenix' 6-max Seat #1 is the button
Seat 1: DaGoodz33 ($4.67 in chips)
Seat 2: rellerz ($3.87 in chips)
Seat 3: Smuggler1991 ($7.27 in chips)
Seat 4: smokestackinggg ($3.66 in chips)
Seat 5: DemolishIT ($11.42 in chips)
Seat 6: PlayTheBlues4U ($7.41 in chips)
rellerz: posts small blind $0.02
Smuggler1991: posts big blind $0.05
*** HOLE CARDS ***
Dealt to PlayTheBlues4U [Qh Kd]
smokestackinggg: folds
DemolishIT: folds
PlayTheBlues4U: raises $0.10 to $0.15
DaGoodz33: folds
rellerz: folds
Smuggler1991: folds
Uncalled bet ($0.10) returned to PlayTheBlues4U
PlayTheBlues4U collected $0.12 from pot
PlayTheBlues4U: doesn't show hand
*** SUMMARY ***
Total pot $0.12 | Rake $0
Seat 1: DaGoodz33 (button) folded before Flop (didn't bet)
Seat 2: rellerz (small blind) folded before Flop
Seat 3: Smuggler1991 (big blind) folded before Flop
Seat 4: smokestackinggg folded before Flop (didn't bet)
Seat 5: DemolishIT folded before Flop (didn't bet)
Seat 6: PlayTheBlues4U collected ($0.12)


PokerStars Hand #204208138111:  Hold'em No Limit ($0.01/$0.02 USD) - 2019/10/03 23:10:31 ET
Table 'Auriga' 6-max Seat #4 is the button
Seat 1: Smuggler1991 ($4.89 in chips)
Seat 2: smoothdram18 ($3.43 in chips)
Seat 3: DaGoodz33 ($1.65 in chips)
Seat 4: evanb004 ($3.35 in chips)
Seat 5: PlayTheBlues4U ($1.98 in chips)
PlayTheBlues4U: posts small blind $0.01
Smuggler1991: posts big blind $0.02
*** HOLE CARDS ***
Dealt to PlayTheBlues4U [8c 8d]
smoothdram18: calls $0.02
DaGoodz33: folds
DaGoodz33 leaves the table
evanb004: folds
PlayTheBlues4U: calls $0.01
Smuggler1991: checks
*** FLOP *** [Th Jd 3d]
PlayTheBlues4U: checks
andreybhr joins the table at seat #6
Smuggler1991: bets $0.02
smoothdram18: calls $0.02
PlayTheBlues4U: folds
*** TURN *** [Th Jd 3d] [3h]
Smuggler1991: bets $0.04
smoothdram18: calls $0.04
*** RIVER *** [Th Jd 3d 3h] [Ks]
Smuggler1991: checks
smoothdram18: bets $0.14
Smuggler1991: folds
Uncalled bet ($0.14) returned to smoothdram18
smoothdram18 collected $0.17 from pot
smoothdram18: doesn't show hand
*** SUMMARY ***
Total pot $0.18 | Rake $0.01
Board [Th Jd 3d 3h Ks]
Seat 1: Smuggler1991 (big blind) folded on the River
Seat 2: smoothdram18 collected ($0.17)
Seat 3: DaGoodz33 folded before Flop (didn't bet)
Seat 4: evanb004 (button) folded before Flop (didn't bet)
Seat 5: PlayTheBlues4U (small blind) folded on the Flop


PokerStars Hand #204208138011:  Hold'em No Limit ($0.01/$0.02 USD) - 2019/10/03 23:09:55 ET
Table 'Auriga' 6-max Seat #3 is the button
Seat 1: Smuggler1991 ($4.89 in chips)
Seat 2: smoothdram18 ($3.50 in chips)
Seat 3: DaGoodz33 ($1.65 in chips)
Seat 4: evanb004 ($3.26 in chips)
Seat 5: PlayTheBlues4U ($2 in chips)
evanb004: posts small blind $0.01
PlayTheBlues4U: posts big blind $0.02
*** HOLE CARDS ***
Dealt to PlayTheBlues4U [9h As]
Smuggler1991: folds
smoothdram18: raises $0.05 to $0.07
DaGoodz33: folds
evanb004: raises $0.21 to $0.28
PlayTheBlues4U: folds
smoothdram18: folds
Uncalled bet ($0.21) returned to evanb004
evanb004 collected $0.16 from pot
evanb004: doesn't show hand
*** SUMMARY ***
Total pot $0.16 | Rake $0
Seat 1: Smuggler1991 folded before Flop (didn't bet)
Seat 2: smoothdram18 folded before Flop
Seat 3: DaGoodz33 (button) folded before Flop (didn't bet)
Seat 4: evanb004 (small blind) collected ($0.16)
Seat 5: PlayTheBlues4U (big blind) folded before Flop


PokerStars Hand #204208137997:  Hold'em No Limit ($0.02/$0.05 USD) - 2019/10/03 23:09:49 ET
Table 'Phoenix' 6-max Seat #6 is the button
Seat 1: DaGoodz33 ($4.69 in chips)
Seat 2: rellerz ($4.04 in chips)
Seat 3: Smuggler1991 ($7.10 in chips)
Seat 4: smokestackinggg ($3.66 in chips)
Seat 5: DemolishIT ($11.42 in chips)
Seat 6: PlayTheBlues4U ($7.41 in chips)
DaGoodz33: posts small blind $0.02
rellerz: posts big blind $0.05
*** HOLE CARDS ***
Dealt to PlayTheBlues4U [4h 2h]
Smuggler1991: raises $0.12 to $0.17
smokestackinggg: folds
DemolishIT: folds
PlayTheBlues4U: folds
DaGoodz33: folds
rellerz: calls $0.12
*** FLOP *** [Qd 6h 4s]
rellerz: checks
Smuggler1991: bets $0.15
rellerz: folds
Uncalled bet ($0.15) returned to Smuggler1991
Smuggler1991 collected $0.34 from pot
Smuggler1991: doesn't show hand
*** SUMMARY ***
Total pot $0.36 | Rake $0.02
Board [Qd 6h 4s]
Seat 1: DaGoodz33 (small blind) folded before Flop
Seat 2: rellerz (big blind) folded on the Flop
Seat 3: Smuggler1991 collected ($0.34)
Seat 4: smokestackinggg folded before Flop (didn't bet)
Seat 5: DemolishIT folded before Flop (didn't bet)
Seat 6: PlayTheBlues4U (button) folded before Flop (didn't bet)


PokerStars Hand #204208137817:  Hold'em No Limit ($0.02/$0.05 USD) - 2019/10/03 23:08:41 ET
Table 'Phoenix' 6-max Seat #5 is the button
Seat 1: DaGoodz33 ($5.67 in chips)
Seat 2: rellerz ($4.04 in chips)
Seat 3: Smuggler1991 ($7.10 in chips)
Seat 4: smokestackinggg ($3.91 in chips)
Seat 5: DemolishIT ($10.28 in chips)
Seat 6: PlayTheBlues4U ($7.43 in chips)
PlayTheBlues4U: posts small blind $0.02
DaGoodz33: posts big blind $0.05
*** HOLE CARDS ***
Dealt to PlayTheBlues4U [2c Td]
rellerz: folds
Smuggler1991: folds
smokestackinggg: calls $0.05
DemolishIT: raises $0.20 to $0.25
PlayTheBlues4U: folds
DaGoodz33: calls $0.20
smokestackinggg: calls $0.20
*** FLOP *** [7s 8d Ts]
DaGoodz33: checks
smokestackinggg: checks
DemolishIT: checks
*** TURN *** [7s 8d Ts] [9h]
DaGoodz33: bets $0.73
smokestackinggg: folds
DemolishIT: calls $0.73
*** RIVER *** [7s 8d Ts 9h] [Ks]
DaGoodz33: checks
DemolishIT: checks
*** SHOW DOWN ***
DaGoodz33: shows [Qc Kc] (a pair of Kings)
DemolishIT: shows [7c 6c] (a straight, Six to Ten)
DemolishIT collected $2.12 from pot
*** SUMMARY ***
Total pot $2.23 | Rake $0.11
Board [7s 8d Ts 9h Ks]
Seat 1: DaGoodz33 (big blind) showed [Qc Kc] and lost with a pair of Kings
Seat 2: rellerz folded before Flop (didn't bet)
Seat 3: Smuggler1991 folded before Flop (didn't bet)
Seat 4: smokestackinggg folded on the Turn
Seat 5: DemolishIT (button) showed [7c 6c] and won ($2.12) with a straight, Six to Ten
Seat 6: PlayTheBlues4U (small blind) folded before Flop


PokerStars Hand #204208137699:  Hold'em No Limit ($0.02/$0.05 USD) - 2019/10/03 23:08:01 ET
Table 'Phoenix' 6-max Seat #4 is the button
Seat 1: DaGoodz33 ($5.67 in chips)
Seat 2: rellerz ($4.04 in chips)
Seat 3: Smuggler1991 ($7.10 in chips)
Seat 4: smokestackinggg ($3.91 in chips)
Seat 5: DemolishIT ($10.19 in chips)
Seat 6: PlayTheBlues4U ($7.53 in chips)
DemolishIT: posts small blind $0.02
PlayTheBlues4U: posts big blind $0.05
*** HOLE CARDS ***
Dealt to PlayTheBlues4U [4h 5c]
DaGoodz33: folds
rellerz: folds
Smuggler1991: folds
smokestackinggg: folds
DemolishIT: calls $0.03
PlayTheBlues4U: checks
*** FLOP *** [Ts 8d Kc]
DemolishIT: checks
PlayTheBlues4U: bets $0.05
DemolishIT: calls $0.05
*** TURN *** [Ts 8d Kc] [2h]
DemolishIT: checks
PlayTheBlues4U: checks
*** RIVER *** [Ts 8d Kc 2h] [7h]
DemolishIT: bets $0.20
PlayTheBlues4U: folds
Uncalled bet ($0.20) returned to DemolishIT
DemolishIT collected $0.19 from pot
DemolishIT: doesn't show hand
*** SUMMARY ***
Total pot $0.20 | Rake $0.01
Board [Ts 8d Kc 2h 7h]
Seat 1: DaGoodz33 folded before Flop (didn't bet)
Seat 2: rellerz folded before Flop (didn't bet)
Seat 3: Smuggler1991 folded before Flop (didn't bet)
Seat 4: smokestackinggg (button) folded before Flop (didn't bet)
Seat 5: DemolishIT (small blind) collected ($0.19)
Seat 6: PlayTheBlues4U (big blind) folded on the River


PokerStars Hand #204208137547:  Hold'em No Limit ($0.02/$0.05 USD) - 2019/10/03 23:07:04 ET
Table 'Phoenix' 6-max Seat #3 is the button
Seat 1: DaGoodz33 ($5.84 in chips)
Seat 2: rellerz ($3.82 in chips)
Seat 3: Smuggler1991 ($7.10 in chips)
Seat 4: smokestackinggg ($3.93 in chips)
Seat 5: DemolishIT ($10.24 in chips)
Seat 6: PlayTheBlues4U ($7.53 in chips)
smokestackinggg: posts small blind $0.02
DemolishIT: posts big blind $0.05
*** HOLE CARDS ***
Dealt to PlayTheBlues4U [Kh 2h]
PlayTheBlues4U: folds
DaGoodz33: raises $0.12 to $0.17
rellerz: calls $0.17
Smuggler1991: folds
smokestackinggg: folds
DemolishIT: folds
*** FLOP *** [Ks 6h As]
DaGoodz33: checks
rellerz: checks
*** TURN *** [Ks 6h As] [Td]
DaGoodz33: checks
rellerz: bets $0.20
DaGoodz33: folds
Uncalled bet ($0.20) returned to rellerz
rellerz collected $0.39 from pot
rellerz: doesn't show hand
*** SUMMARY ***
Total pot $0.41 | Rake $0.02
Board [Ks 6h As Td]
Seat 1: DaGoodz33 folded on the Turn
Seat 2: rellerz collected ($0.39)
Seat 3: Smuggler1991 (button) folded before Flop (didn't bet)
Seat 4: smokestackinggg (small blind) folded before Flop
Seat 5: DemolishIT (big blind) folded before Flop
Seat 6: PlayTheBlues4U folded before Flop (didn't bet)


PokerStars Hand #204207709892:  Hold'em No Limit ($0.02/$0.05 USD) - 2019/10/03 23:06:11 ET
Table 'Phoenix' 6-max Seat #2 is the button
Seat 1: DaGoodz33 ($5.84 in chips)
Seat 2: rellerz ($3.97 in chips)
Seat 3: Smuggler1991 ($7.12 in chips)
Seat 4: smokestackinggg ($3.98 in chips)
Seat 5: DemolishIT ($9.90 in chips)
Seat 6: PlayTheBlues4U ($7.68 in chips)
Smuggler1991: posts small blind $0.02
smokestackinggg: posts big blind $0.05
*** HOLE CARDS ***
Dealt to PlayTheBlues4U [Qc Jd]
DemolishIT: calls $0.05
PlayTheBlues4U: raises $0.10 to $0.15
DaGoodz33: folds
rellerz: calls $0.15
Smuggler1991: folds
smokestackinggg: folds
DemolishIT: calls $0.10
*** FLOP *** [3h 5d 2d]
DemolishIT: checks
PlayTheBlues4U: checks
rellerz: checks
*** TURN *** [3h 5d 2d] [4d]
DemolishIT: bets $0.49
PlayTheBlues4U: folds
rellerz: folds
Uncalled bet ($0.49) returned to DemolishIT
DemolishIT collected $0.49 from pot
*** SUMMARY ***
Total pot $0.52 | Rake $0.03
Board [3h 5d 2d 4d]
Seat 1: DaGoodz33 folded before Flop (didn't bet)
Seat 2: rellerz (button) folded on the Turn
Seat 3: Smuggler1991 (small blind) folded before Flop
Seat 4: smokestackinggg (big blind) folded before Flop
Seat 5: DemolishIT collected ($0.49)
Seat 6: PlayTheBlues4U folded on the Turn


PokerStars Hand #204207709678:  Hold'em No Limit ($0.02/$0.05 USD) - 2019/10/03 23:05:01 ET
Table 'Phoenix' 6-max Seat #6 is the button
Seat 1: DaGoodz33 ($5.86 in chips)
Seat 2: rellerz ($3.90 in chips)
Seat 3: Smuggler1991 ($7.17 in chips)
Seat 4: smokestackinggg ($3.98 in chips)
Seat 5: DemolishIT ($9.90 in chips)
Seat 6: PlayTheBlues4U ($7.68 in chips)
DaGoodz33: posts small blind $0.02
rellerz: posts big blind $0.05
*** HOLE CARDS ***
Dealt to PlayTheBlues4U [Qh Ks]
Smuggler1991: folds
smokestackinggg: folds
DemolishIT: folds
PlayTheBlues4U has timed out
PlayTheBlues4U: folds
DaGoodz33: folds
Uncalled bet ($0.03) returned to rellerz
rellerz collected $0.04 from pot
rellerz: doesn't show hand
*** SUMMARY ***
Total pot $0.04 | Rake $0
Seat 1: DaGoodz33 (small blind) folded before Flop
Seat 2: rellerz (big blind) collected ($0.04)
Seat 3: Smuggler1991 folded before Flop (didn't bet)
Seat 4: smokestackinggg folded before Flop (didn't bet)
Seat 5: DemolishIT folded before Flop (didn't bet)
Seat 6: PlayTheBlues4U (button) folded before Flop (didn't bet)


PokerStars Hand #204207709438:  Hold'em No Limit ($0.02/$0.05 USD) - 2019/10/03 23:03:41 ET
Table 'Phoenix' 6-max Seat #5 is the button
Seat 1: DaGoodz33 ($6.08 in chips)
Seat 2: rellerz ($3.95 in chips)
Seat 3: Smuggler1991 ($6.51 in chips)
Seat 4: smokestackinggg ($3.98 in chips)
Seat 5: DemolishIT ($10.12 in chips)
Seat 6: PlayTheBlues4U ($7.90 in chips)
PlayTheBlues4U: posts small blind $0.02
DaGoodz33: posts big blind $0.05
*** HOLE CARDS ***
Dealt to PlayTheBlues4U [3h 5h]
rellerz: calls $0.05
Smuggler1991: raises $0.17 to $0.22
smokestackinggg: folds
DemolishIT: calls $0.22
PlayTheBlues4U: calls $0.20
DaGoodz33: calls $0.17
rellerz: folds
*** FLOP *** [Qs 3s 2d]
PlayTheBlues4U: checks
DaGoodz33: checks
Smuggler1991: bets $0.90
DemolishIT: folds
PlayTheBlues4U: folds
DaGoodz33: folds
Uncalled bet ($0.90) returned to Smuggler1991
Smuggler1991 collected $0.88 from pot
Smuggler1991: doesn't show hand
*** SUMMARY ***
Total pot $0.93 | Rake $0.05
Board [Qs 3s 2d]
Seat 1: DaGoodz33 (big blind) folded on the Flop
Seat 2: rellerz folded before Flop
Seat 3: Smuggler1991 collected ($0.88)
Seat 4: smokestackinggg folded before Flop (didn't bet)
Seat 5: DemolishIT (button) folded on the Flop
Seat 6: PlayTheBlues4U (small blind) folded on the Flop


PokerStars Hand #204207709275:  Hold'em No Limit ($0.02/$0.05 USD) - 2019/10/03 23:02:45 ET
Table 'Phoenix' 6-max Seat #4 is the button
Seat 2: rellerz ($4 in chips)
Seat 3: Smuggler1991 ($6.51 in chips)
Seat 4: smokestackinggg ($3.98 in chips)
Seat 5: DemolishIT ($10.03 in chips)
Seat 6: PlayTheBlues4U ($7.95 in chips)
DemolishIT: posts small blind $0.02
PlayTheBlues4U: posts big blind $0.05
DaGoodz33: sits out
rellerz: posts big blind $0.05
*** HOLE CARDS ***
Dealt to PlayTheBlues4U [2c Td]
rellerz: checks
Smuggler1991: folds
smokestackinggg: folds
DemolishIT: calls $0.03
PlayTheBlues4U: checks
*** FLOP *** [Qc 8c Tc]
DemolishIT: checks
PlayTheBlues4U: checks
rellerz: checks
*** TURN *** [Qc 8c Tc] [Jd]
DemolishIT: bets $0.14
PlayTheBlues4U: folds
rellerz: folds
Uncalled bet ($0.14) returned to DemolishIT
DemolishIT collected $0.14 from pot
*** SUMMARY ***
Total pot $0.15 | Rake $0.01
Board [Qc 8c Tc Jd]
Seat 2: rellerz folded on the Turn (didn't bet)
Seat 3: Smuggler1991 folded before Flop (didn't bet)
Seat 4: smokestackinggg (button) folded before Flop (didn't bet)
Seat 5: DemolishIT (small blind) collected ($0.14)
Seat 6: PlayTheBlues4U (big blind) folded on the Turn


PokerStars Hand #204207709135:  Hold'em No Limit ($0.02/$0.05 USD) - 2019/10/03 23:01:53 ET
Table 'Phoenix' 6-max Seat #3 is the button
Seat 2: swammer1997 ($6.19 in chips)
Seat 3: Smuggler1991 ($6.98 in chips)
Seat 4: smokestackinggg ($4 in chips)
Seat 5: DemolishIT ($9.59 in chips)
Seat 6: PlayTheBlues4U ($7.95 in chips)
smokestackinggg: posts small blind $0.02
DemolishIT: posts big blind $0.05
DaGoodz33: sits out
*** HOLE CARDS ***
Dealt to PlayTheBlues4U [7d 9s]
PlayTheBlues4U: folds
swammer1997: folds
swammer1997 leaves the table
Smuggler1991: raises $0.12 to $0.17
smokestackinggg: folds
DemolishIT: calls $0.12
*** FLOP *** [9c 8c Kc]
DemolishIT: checks
Smuggler1991: bets $0.15
DemolishIT: raises $0.15 to $0.30
Smuggler1991: calls $0.15
*** TURN *** [9c 8c Kc] [Ac]
DemolishIT: checks
Smuggler1991: checks
*** RIVER *** [9c 8c Kc Ac] [8h]
DemolishIT: bets $0.91
rellerz joins the table at seat #2
Smuggler1991: folds
Uncalled bet ($0.91) returned to DemolishIT
DemolishIT collected $0.91 from pot
*** SUMMARY ***
Total pot $0.96 | Rake $0.05
Board [9c 8c Kc Ac 8h]
Seat 2: swammer1997 folded before Flop (didn't bet)
Seat 3: Smuggler1991 (button) folded on the River
Seat 4: smokestackinggg (small blind) folded before Flop
Seat 5: DemolishIT (big blind) collected ($0.91)
Seat 6: PlayTheBlues4U folded before Flop (didn't bet)


PokerStars Hand #204207709000:  Hold'em No Limit ($0.02/$0.05 USD) - 2019/10/03 23:01:04 ET
Table 'Phoenix' 6-max Seat #2 is the button
Seat 2: swammer1997 ($5 in chips)
Seat 3: Smuggler1991 ($7 in chips)
Seat 4: smokestackinggg ($4.05 in chips)
Seat 5: DemolishIT ($10.84 in chips)
Seat 6: PlayTheBlues4U ($7.95 in chips)
Smuggler1991: posts small blind $0.02
smokestackinggg: posts big blind $0.05
*** HOLE CARDS ***
Dealt to PlayTheBlues4U [6h Kd]
DemolishIT: raises $0.20 to $0.25
PlayTheBlues4U: folds
swammer1997: raises $0.20 to $0.45
Smuggler1991: folds
smokestackinggg: folds
DemolishIT: calls $0.20
*** FLOP *** [6d Ad 3d]
DaGoodz33 joins the table at seat #1
DemolishIT: checks
swammer1997: bets $0.80
DemolishIT: calls $0.80
*** TURN *** [6d Ad 3d] [7h]
DemolishIT: checks
swammer1997: checks
*** RIVER *** [6d Ad 3d 7h] [9s]
DemolishIT: checks
swammer1997: bets $1.15
DemolishIT: folds
Uncalled bet ($1.15) returned to swammer1997
swammer1997 collected $2.44 from pot
swammer1997: doesn't show hand
*** SUMMARY ***
Total pot $2.57 | Rake $0.13
Board [6d Ad 3d 7h 9s]
Seat 2: swammer1997 (button) collected ($2.44)
Seat 3: Smuggler1991 (small blind) folded before Flop
Seat 4: smokestackinggg (big blind) folded before Flop
Seat 5: DemolishIT folded on the River
Seat 6: PlayTheBlues4U folded before Flop (didn't bet)


PokerStars Hand #204207708932:  Hold'em No Limit ($0.02/$0.05 USD) - 2019/10/03 23:00:31 ET
Table 'Phoenix' 6-max Seat #6 is the button
Seat 2: swammer1997 ($5.15 in chips)
Seat 3: Smuggler1991 ($7.05 in chips)
Seat 5: DemolishIT ($10.99 in chips)
Seat 6: PlayTheBlues4U ($7.62 in chips)
swammer1997: posts small blind $0.02
Smuggler1991: posts big blind $0.05
smokestackinggg: sits out
*** HOLE CARDS ***
Dealt to PlayTheBlues4U [Kc Tc]
DemolishIT: calls $0.05
PlayTheBlues4U: raises $0.10 to $0.15
swammer1997: calls $0.13
Smuggler1991: folds
DemolishIT: calls $0.10
*** FLOP *** [7h Qd 5d]
swammer1997: checks
DemolishIT: checks
PlayTheBlues4U: bets $0.30
swammer1997: folds
DemolishIT: folds
Uncalled bet ($0.30) returned to PlayTheBlues4U
PlayTheBlues4U collected $0.48 from pot
PlayTheBlues4U: doesn't show hand
*** SUMMARY ***
Total pot $0.50 | Rake $0.02
Board [7h Qd 5d]
Seat 2: swammer1997 (small blind) folded on the Flop
Seat 3: Smuggler1991 (big blind) folded before Flop
Seat 5: DemolishIT folded on the Flop
Seat 6: PlayTheBlues4U (button) collected ($0.48)


PokerStars Hand #204207708897:  Hold'em No Limit ($0.02/$0.05 USD) - 2019/10/03 23:00:20 ET
Table 'Phoenix' 6-max Seat #5 is the button
Seat 1: skillzplumber ($0.24 in chips)
Seat 2: swammer1997 ($5.15 in chips)
Seat 3: Smuggler1991 ($7.05 in chips)
Seat 5: DemolishIT ($10.92 in chips)
Seat 6: PlayTheBlues4U ($7.64 in chips)
PlayTheBlues4U: posts small blind $0.02
skillzplumber: posts big blind $0.05
*** HOLE CARDS ***
Dealt to PlayTheBlues4U [3d Td]
swammer1997: folds
Smuggler1991: folds
DemolishIT: calls $0.05
PlayTheBlues4U: folds
skillzplumber: folds
skillzplumber leaves the table
smokestackinggg joins the table at seat #4
DemolishIT collected $0.12 from pot
*** SUMMARY ***
Total pot $0.12 | Rake $0
Seat 1: skillzplumber (big blind) folded before Flop
Seat 2: swammer1997 folded before Flop (didn't bet)
Seat 3: Smuggler1991 folded before Flop (didn't bet)
Seat 5: DemolishIT (button) collected ($0.12)
Seat 6: PlayTheBlues4U (small blind) folded before Flop


PokerStars Hand #204207708793:  Hold'em No Limit ($0.02/$0.05 USD) - 2019/10/03 22:59:30 ET
Table 'Phoenix' 6-max Seat #3 is the button
Seat 1: skillzplumber ($5.96 in chips)
Seat 2: swammer1997 ($5.15 in chips)
Seat 3: Smuggler1991 ($7.05 in chips)
Seat 5: DemolishIT ($5.72 in chips)
Seat 6: PlayTheBlues4U ($7.69 in chips)
DemolishIT: posts small blind $0.02
PlayTheBlues4U: posts big blind $0.05
*** HOLE CARDS ***
Dealt to PlayTheBlues4U [3s 2c]
skillzplumber: raises $0.20 to $0.25
swammer1997: folds
Smuggler1991: folds
DemolishIT: raises $0.70 to $0.95
PlayTheBlues4U: folds
skillzplumber: calls $0.70
*** FLOP *** [Qs As Th]
DemolishIT: bets $1.85
skillzplumber: raises $3.16 to $5.01 and is all-in
DemolishIT: calls $2.92 and is all-in
Uncalled bet ($0.24) returned to skillzplumber
*** TURN *** [Qs As Th] [Qh]
*** RIVER *** [Qs As Th Qh] [Jc]
*** SHOW DOWN ***
DemolishIT: shows [Ac Kd] (a straight, Ten to Ace)
skillzplumber: shows [6d Ad] (two pair, Aces and Queens)
DemolishIT collected $10.92 from pot
*** SUMMARY ***
Total pot $11.49 | Rake $0.57
Board [Qs As Th Qh Jc]
Seat 1: skillzplumber showed [6d Ad] and lost with two pair, Aces and Queens
Seat 2: swammer1997 folded before Flop (didn't bet)
Seat 3: Smuggler1991 (button) folded before Flop (didn't bet)
Seat 5: DemolishIT (small blind) showed [Ac Kd] and won ($10.92) with a straight, Ten to Ace
Seat 6: PlayTheBlues4U (big blind) folded before Flop


PokerStars Hand #204207708737:  Hold'em No Limit ($0.02/$0.05 USD) - 2019/10/03 22:59:08 ET
Table 'Phoenix' 6-max Seat #2 is the button
Seat 1: skillzplumber ($5.96 in chips)
Seat 2: swammer1997 ($5.09 in chips)
Seat 3: Smuggler1991 ($7.07 in chips)
Seat 5: DemolishIT ($5.77 in chips)
Seat 6: PlayTheBlues4U ($7.69 in chips)
Smuggler1991: posts small blind $0.02
Cake_Horn_14: is sitting out
DemolishIT: posts big blind $0.05
*** HOLE CARDS ***
Dealt to PlayTheBlues4U [4h 3d]
Cake_Horn_14 leaves the table
PlayTheBlues4U: folds
skillzplumber: folds
swammer1997: calls $0.05
Smuggler1991: folds
DemolishIT: checks
*** FLOP *** [Ks 3c 3s]
DemolishIT: checks
swammer1997: bets $0.10
DemolishIT: folds
Uncalled bet ($0.10) returned to swammer1997
swammer1997 collected $0.11 from pot
swammer1997: doesn't show hand
*** SUMMARY ***
Total pot $0.12 | Rake $0.01
Board [Ks 3c 3s]
Seat 1: skillzplumber folded before Flop (didn't bet)
Seat 2: swammer1997 (button) collected ($0.11)
Seat 3: Smuggler1991 (small blind) folded before Flop
Seat 5: DemolishIT (big blind) folded on the Flop
Seat 6: PlayTheBlues4U folded before Flop (didn't bet)


PokerStars Hand #204207708679:  Hold'em No Limit ($0.02/$0.05 USD) - 2019/10/03 22:58:37 ET
Table 'Phoenix' 6-max Seat #1 is the button
Seat 1: skillzplumber ($6.06 in chips)
Seat 2: swammer1997 ($4.95 in chips)
Seat 3: Smuggler1991 ($7.12 in chips)
Seat 4: Cake_Horn_14 ($5.39 in chips)
Seat 5: DemolishIT ($5.77 in chips)
Seat 6: PlayTheBlues4U ($7.69 in chips)
swammer1997: posts small blind $0.02
Smuggler1991: posts big blind $0.05
*** HOLE CARDS ***
Dealt to PlayTheBlues4U [Jh 5c]
Cake_Horn_14: folds
DemolishIT: folds
PlayTheBlues4U: folds
skillzplumber: calls $0.05
swammer1997: raises $0.05 to $0.10
Smuggler1991: folds
skillzplumber: calls $0.05
*** FLOP *** [8c 2d Ad]
swammer1997: bets $0.10
skillzplumber: folds
Uncalled bet ($0.10) returned to swammer1997
swammer1997 collected $0.24 from pot
swammer1997: doesn't show hand
*** SUMMARY ***
Total pot $0.25 | Rake $0.01
Board [8c 2d Ad]
Seat 1: skillzplumber (button) folded on the Flop
Seat 2: swammer1997 (small blind) collected ($0.24)
Seat 3: Smuggler1991 (big blind) folded before Flop
Seat 4: Cake_Horn_14 folded before Flop (didn't bet)
Seat 5: DemolishIT folded before Flop (didn't bet)
Seat 6: PlayTheBlues4U folded before Flop (didn't bet)


PokerStars Hand #204207708596:  Hold'em No Limit ($0.02/$0.05 USD) - 2019/10/03 22:58:04 ET
Table 'Phoenix' 6-max Seat #6 is the button
Seat 1: skillzplumber ($6.08 in chips)
Seat 2: swammer1997 ($5 in chips)
Seat 3: Smuggler1991 ($10.12 in chips)
Seat 4: Cake_Horn_14 ($5.39 in chips)
Seat 5: DemolishIT ($3 in chips)
Seat 6: PlayTheBlues4U ($7.69 in chips)
skillzplumber: posts small blind $0.02
swammer1997: posts big blind $0.05
*** HOLE CARDS ***
Dealt to PlayTheBlues4U [8h 2d]
Smuggler1991: raises $10.07 to $10.12 and is all-in
Cake_Horn_14: folds
DemolishIT: calls $3 and is all-in
PlayTheBlues4U: folds
skillzplumber: folds
swammer1997: folds
Uncalled bet ($7.12) returned to Smuggler1991
*** FLOP *** [Tc 6h 2c]
*** TURN *** [Tc 6h 2c] [Ah]
*** RIVER *** [Tc 6h 2c Ah] [Ad]
*** SHOW DOWN ***
Smuggler1991: shows [Td Jc] (two pair, Aces and Tens)
DemolishIT: shows [Qc Ac] (three of a kind, Aces)
DemolishIT collected $5.77 from pot
*** SUMMARY ***
Total pot $6.07 | Rake $0.30
Board [Tc 6h 2c Ah Ad]
Seat 1: skillzplumber (small blind) folded before Flop
Seat 2: swammer1997 (big blind) folded before Flop
Seat 3: Smuggler1991 showed [Td Jc] and lost with two pair, Aces and Tens
Seat 4: Cake_Horn_14 folded before Flop (didn't bet)
Seat 5: DemolishIT showed [Qc Ac] and won ($5.77) with three of a kind, Aces
Seat 6: PlayTheBlues4U (button) folded before Flop (didn't bet)


PokerStars Hand #204207708515:  Hold'em No Limit ($0.02/$0.05 USD) - 2019/10/03 22:57:26 ET
Table 'Phoenix' 6-max Seat #5 is the button
Seat 1: skillzplumber ($6.23 in chips)
Seat 3: Smuggler1991 ($10.12 in chips)
Seat 4: Cake_Horn_14 ($5.24 in chips)
Seat 5: DemolishIT ($3 in chips)
Seat 6: PlayTheBlues4U ($7.71 in chips)
PlayTheBlues4U: posts small blind $0.02
skillzplumber: posts big blind $0.05
swammer1997: sits out
*** HOLE CARDS ***
Dealt to PlayTheBlues4U [Jc 5s]
Smuggler1991: folds
Cake_Horn_14: raises $0.10 to $0.15
DemolishIT: folds
PlayTheBlues4U: folds
skillzplumber: calls $0.10
*** FLOP *** [6h 2c 9c]
skillzplumber: checks
Cake_Horn_14: checks
*** TURN *** [6h 2c 9c] [3d]
skillzplumber: checks
Cake_Horn_14: checks
*** RIVER *** [6h 2c 9c 3d] [2s]
skillzplumber: checks
Cake_Horn_14: checks
*** SHOW DOWN ***
skillzplumber: shows [8s Qs] (a pair of Deuces)
Cake_Horn_14: shows [Qc Ks] (a pair of Deuces - King kicker)
Cake_Horn_14 collected $0.30 from pot
*** SUMMARY ***
Total pot $0.32 | Rake $0.02
Board [6h 2c 9c 3d 2s]
Seat 1: skillzplumber (big blind) showed [8s Qs] and lost with a pair of Deuces
Seat 3: Smuggler1991 folded before Flop (didn't bet)
Seat 4: Cake_Horn_14 showed [Qc Ks] and won ($0.30) with a pair of Deuces
Seat 5: DemolishIT (button) folded before Flop (didn't bet)
Seat 6: PlayTheBlues4U (small blind) folded before Flop


PokerStars Hand #204207708513:  Hold'em No Limit ($0.05/$0.10 USD) - 2019/10/03 22:57:25 ET
Table 'Corvus' 6-max Seat #5 is the button
Seat 2: xd33zzr ($9.75 in chips)
Seat 4: polonusik ($24.94 in chips)
Seat 5: PlayTheBlues4U ($10.22 in chips)
xd33zzr: posts small blind $0.05
kid delaw731: is sitting out
polonusik: posts big blind $0.10
*** HOLE CARDS ***
Dealt to PlayTheBlues4U [4d 8s]
PlayTheBlues4U: folds
xd33zzr: calls $0.05
kid delaw731 leaves the table
polonusik: checks
*** FLOP *** [Qh Td 6c]
xd33zzr: checks
polonusik: checks
*** TURN *** [Qh Td 6c] [7c]
xd33zzr: checks
polonusik: bets $0.19
xd33zzr: calls $0.19
*** RIVER *** [Qh Td 6c 7c] [5d]
xd33zzr: checks
polonusik: checks
*** SHOW DOWN ***
xd33zzr: shows [4s 7s] (a pair of Sevens)
polonusik: shows [7d 2c] (a pair of Sevens)
xd33zzr collected $0.28 from pot
polonusik collected $0.27 from pot
*** SUMMARY ***
Total pot $0.58 | Rake $0.03
Board [Qh Td 6c 7c 5d]
Seat 2: xd33zzr (small blind) showed [4s 7s] and won ($0.28) with a pair of Sevens
Seat 4: polonusik (big blind) showed [7d 2c] and won ($0.27) with a pair of Sevens
Seat 5: PlayTheBlues4U (button) folded before Flop (didn't bet)


PokerStars Hand #204207708480:  Hold'em No Limit ($0.02/$0.05 USD) - 2019/10/03 22:57:09 ET
Table 'Phoenix' 6-max Seat #4 is the button
Seat 1: skillzplumber ($6.23 in chips)
Seat 3: Smuggler1991 ($10.12 in chips)
Seat 4: Cake_Horn_14 ($5.24 in chips)
Seat 5: DemolishIT ($2.95 in chips)
Seat 6: PlayTheBlues4U ($7.76 in chips)
DemolishIT: posts small blind $0.02
PlayTheBlues4U: posts big blind $0.05
swammer1997: sits out
*** HOLE CARDS ***
Dealt to PlayTheBlues4U [5c 9s]
skillzplumber: folds
Smuggler1991: folds
Cake_Horn_14: folds
DemolishIT: raises $0.20 to $0.25
PlayTheBlues4U: folds
Uncalled bet ($0.20) returned to DemolishIT
DemolishIT collected $0.10 from pot
*** SUMMARY ***
Total pot $0.10 | Rake $0
Seat 1: skillzplumber folded before Flop (didn't bet)
Seat 3: Smuggler1991 folded before Flop (didn't bet)
Seat 4: Cake_Horn_14 (button) folded before Flop (didn't bet)
Seat 5: DemolishIT (small blind) collected ($0.10)
Seat 6: PlayTheBlues4U (big blind) folded before Flop


PokerStars Hand #204207708444:  Hold'em No Limit ($0.05/$0.10 USD) - 2019/10/03 22:56:50 ET
Table 'Corvus' 6-max Seat #4 is the button
Seat 2: xd33zzr ($10 in chips)
Seat 3: kid delaw731 ($9.91 in chips)
Seat 4: polonusik ($24.94 in chips)
Seat 5: PlayTheBlues4U ($9.90 in chips)
PlayTheBlues4U: posts small blind $0.05
xd33zzr: posts big blind $0.10
*** HOLE CARDS ***
Dealt to PlayTheBlues4U [7s 5s]
kid delaw731: calls $0.10
polonusik: folds
PlayTheBlues4U: raises $0.15 to $0.25
xd33zzr: calls $0.15
kid delaw731: folds
*** FLOP *** [Js 6h 4h]
PlayTheBlues4U: bets $0.30
xd33zzr: folds
Uncalled bet ($0.30) returned to PlayTheBlues4U
PlayTheBlues4U collected $0.57 from pot
PlayTheBlues4U: doesn't show hand
*** SUMMARY ***
Total pot $0.60 | Rake $0.03
Board [Js 6h 4h]
Seat 2: xd33zzr (big blind) folded on the Flop
Seat 3: kid delaw731 folded before Flop
Seat 4: polonusik (button) folded before Flop (didn't bet)
Seat 5: PlayTheBlues4U (small blind) collected ($0.57)


PokerStars Hand #204207708411:  Hold'em No Limit ($0.05/$0.10 USD) - 2019/10/03 22:56:36 ET
Table 'Corvus' 6-max Seat #3 is the button
Seat 1: ng2414 ($32.91 in chips)
Seat 3: kid delaw731 ($9.76 in chips)
Seat 4: polonusik ($24.99 in chips)
Seat 5: PlayTheBlues4U ($10 in chips)
polonusik: posts small blind $0.05
PlayTheBlues4U: posts big blind $0.10
xd33zzr: sits out
*** HOLE CARDS ***
Dealt to PlayTheBlues4U [Tc 8d]
ng2414: folds
kid delaw731: raises $0.20 to $0.30
polonusik: folds
ng2414 leaves the table
PlayTheBlues4U: folds
Uncalled bet ($0.20) returned to kid delaw731
kid delaw731 collected $0.25 from pot
kid delaw731: doesn't show hand
*** SUMMARY ***
Total pot $0.25 | Rake $0
Seat 1: ng2414 folded before Flop (didn't bet)
Seat 3: kid delaw731 (button) collected ($0.25)
Seat 4: polonusik (small blind) folded before Flop
Seat 5: PlayTheBlues4U (big blind) folded before Flop


PokerStars Hand #204207708408:  Hold'em No Limit ($0.02/$0.05 USD) - 2019/10/03 22:56:34 ET
Table 'Phoenix' 6-max Seat #3 is the button
Seat 1: skillzplumber ($6.28 in chips)
Seat 3: Smuggler1991 ($10.34 in chips)
Seat 4: Cake_Horn_14 ($5.26 in chips)
Seat 5: DemolishIT ($2.66 in chips)
Seat 6: PlayTheBlues4U ($7.76 in chips)
Cake_Horn_14: posts small blind $0.02
DemolishIT: posts big blind $0.05
*** HOLE CARDS ***
Dealt to PlayTheBlues4U [6d 4d]
PlayTheBlues4U: folds
skillzplumber: calls $0.05
pie3210 leaves the table
skillzplumber said, "nh"
Smuggler1991: raises $0.17 to $0.22
Cake_Horn_14: folds
DemolishIT: raises $2.44 to $2.66 and is all-in
skillzplumber: folds
Smuggler1991: folds
Uncalled bet ($2.44) returned to DemolishIT
swammer1997 joins the table at seat #2
DemolishIT collected $0.51 from pot
*** SUMMARY ***
Total pot $0.51 | Rake $0
Seat 1: skillzplumber folded before Flop
Seat 3: Smuggler1991 (button) folded before Flop
Seat 4: Cake_Horn_14 (small blind) folded before Flop
Seat 5: DemolishIT (big blind) collected ($0.51)
Seat 6: PlayTheBlues4U folded before Flop (didn't bet)


PokerStars Hand #204207708283:  Hold'em No Limit ($0.02/$0.05 USD) - 2019/10/03 22:55:31 ET
Table 'Phoenix' 6-max Seat #1 is the button
Seat 1: skillzplumber ($9.35 in chips)
Seat 2: pie3210 ($2.47 in chips)
Seat 3: Smuggler1991 ($2.72 in chips)
Seat 4: Cake_Horn_14 ($5.26 in chips)
Seat 5: DemolishIT ($3.07 in chips)
Seat 6: PlayTheBlues4U ($8.01 in chips)
pie3210: posts small blind $0.02
Smuggler1991: posts big blind $0.05
*** HOLE CARDS ***
Dealt to PlayTheBlues4U [3c 3h]
Cake_Horn_14: folds
DemolishIT: raises $0.20 to $0.25
PlayTheBlues4U: calls $0.25
skillzplumber: raises $0.45 to $0.70
pie3210: raises $1.77 to $2.47 and is all-in
Smuggler1991: raises $0.25 to $2.72 and is all-in
DemolishIT: calls $2.47
PlayTheBlues4U: folds
skillzplumber: calls $2.02
*** FLOP *** [2h 7c Qs]
DemolishIT: checks
skillzplumber: bets $0.40
DemolishIT: calls $0.35 and is all-in
Uncalled bet ($0.05) returned to skillzplumber
*** TURN *** [2h 7c Qs] [4h]
*** RIVER *** [2h 7c Qs 4h] [Th]
*** SHOW DOWN ***
DemolishIT: shows [6d 7d] (a pair of Sevens)
skillzplumber: shows [Ad Kd] (high card Ace)
DemolishIT collected $0.66 from side pot-2
Smuggler1991: shows [Ah Kh] (a flush, Ace high)
Smuggler1991 collected $0.72 from side pot-1
pie3210: shows [As Qh] (a pair of Queens)
Smuggler1991 collected $9.62 from main pot
*** SUMMARY ***
Total pot $11.58 Main pot $9.62. Side pot-1 $0.72. Side pot-2 $0.66. | Rake $0.58
Board [2h 7c Qs 4h Th]
Seat 1: skillzplumber (button) showed [Ad Kd] and lost with high card Ace
Seat 2: pie3210 (small blind) showed [As Qh] and lost with a pair of Queens
Seat 3: Smuggler1991 (big blind) showed [Ah Kh] and won ($10.34) with a flush, Ace high
Seat 4: Cake_Horn_14 folded before Flop (didn't bet)
Seat 5: DemolishIT showed [6d 7d] and won ($0.66) with a pair of Sevens
Seat 6: PlayTheBlues4U folded before Flop


PokerStars Hand #204207708147:  Hold'em No Limit ($0.02/$0.05 USD) - 2019/10/03 22:54:32 ET
Table 'Phoenix' 6-max Seat #6 is the button
Seat 1: skillzplumber ($9.37 in chips)
Seat 2: pie3210 ($2.52 in chips)
Seat 3: Smuggler1991 ($2.72 in chips)
Seat 4: Cake_Horn_14 ($5.26 in chips)
Seat 5: DemolishIT ($4.67 in chips)
Seat 6: PlayTheBlues4U ($6.50 in chips)
skillzplumber: posts small blind $0.02
pie3210: posts big blind $0.05
*** HOLE CARDS ***
Dealt to PlayTheBlues4U [6d Ad]
Smuggler1991: folds
Cake_Horn_14: folds
DemolishIT: raises $0.25 to $0.30
PlayTheBlues4U: raises $0.45 to $0.75
skillzplumber: folds
pie3210: folds
DemolishIT: calls $0.45
*** FLOP *** [Td Kc 2c]
DemolishIT: checks
PlayTheBlues4U: bets $0.85
DemolishIT: calls $0.85
*** TURN *** [Td Kc 2c] [4s]
DemolishIT: checks
PlayTheBlues4U: checks
*** RIVER *** [Td Kc 2c 4s] [4h]
DemolishIT: checks
PlayTheBlues4U: bets $1.70
DemolishIT: folds
Uncalled bet ($1.70) returned to PlayTheBlues4U
PlayTheBlues4U collected $3.11 from pot
PlayTheBlues4U: doesn't show hand
*** SUMMARY ***
Total pot $3.27 | Rake $0.16
Board [Td Kc 2c 4s 4h]
Seat 1: skillzplumber (small blind) folded before Flop
Seat 2: pie3210 (big blind) folded before Flop
Seat 3: Smuggler1991 folded before Flop (didn't bet)
Seat 4: Cake_Horn_14 folded before Flop (didn't bet)
Seat 5: DemolishIT folded on the River
Seat 6: PlayTheBlues4U (button) collected ($3.11)


PokerStars Hand #204207708064:  Hold'em No Limit ($0.02/$0.05 USD) - 2019/10/03 22:54:04 ET
Table 'Phoenix' 6-max Seat #5 is the button
Seat 1: skillzplumber ($9.42 in chips)
Seat 2: pie3210 ($2.57 in chips)
Seat 3: Smuggler1991 ($2.60 in chips)
Seat 4: Cake_Horn_14 ($5.26 in chips)
Seat 5: DemolishIT ($4.67 in chips)
Seat 6: PlayTheBlues4U ($6.52 in chips)
PlayTheBlues4U: posts small blind $0.02
skillzplumber: posts big blind $0.05
*** HOLE CARDS ***
Dealt to PlayTheBlues4U [3c Tc]
pie3210: calls $0.05
Smuggler1991: raises $0.17 to $0.22
Cake_Horn_14: folds
DemolishIT: folds
PlayTheBlues4U: folds
skillzplumber: folds
pie3210: folds
Uncalled bet ($0.17) returned to Smuggler1991
Smuggler1991 collected $0.17 from pot
Smuggler1991: doesn't show hand
*** SUMMARY ***
Total pot $0.17 | Rake $0
Seat 1: skillzplumber (big blind) folded before Flop
Seat 2: pie3210 folded before Flop
Seat 3: Smuggler1991 collected ($0.17)
Seat 4: Cake_Horn_14 folded before Flop (didn't bet)
Seat 5: DemolishIT (button) folded before Flop (didn't bet)
Seat 6: PlayTheBlues4U (small blind) folded before Flop


PokerStars Hand #204207707980:  Hold'em No Limit ($0.02/$0.05 USD) - 2019/10/03 22:53:36 ET
Table 'Phoenix' 6-max Seat #4 is the button
Seat 1: skillzplumber ($9.42 in chips)
Seat 2: pie3210 ($2.57 in chips)
Seat 3: Smuggler1991 ($2.77 in chips)
Seat 4: Cake_Horn_14 ($5.26 in chips)
Seat 5: DemolishIT ($4.45 in chips)
Seat 6: PlayTheBlues4U ($6.57 in chips)
DemolishIT: posts small blind $0.02
PlayTheBlues4U: posts big blind $0.05
*** HOLE CARDS ***
Dealt to PlayTheBlues4U [Kh 9c]
skillzplumber: folds
pie3210: folds
Smuggler1991: raises $0.12 to $0.17
Cake_Horn_14: folds
DemolishIT: raises $0.58 to $0.75
PlayTheBlues4U: folds
Smuggler1991: folds
Uncalled bet ($0.58) returned to DemolishIT
DemolishIT collected $0.39 from pot
DemolishIT: doesn't show hand
*** SUMMARY ***
Total pot $0.39 | Rake $0
Seat 1: skillzplumber folded before Flop (didn't bet)
Seat 2: pie3210 folded before Flop (didn't bet)
Seat 3: Smuggler1991 folded before Flop
Seat 4: Cake_Horn_14 (button) folded before Flop (didn't bet)
Seat 5: DemolishIT (small blind) collected ($0.39)
Seat 6: PlayTheBlues4U (big blind) folded before Flop


PokerStars Hand #204206679926:  Hold'em No Limit ($0.02/$0.05 USD) - 2019/10/03 22:52:38 ET
Table 'Phoenix' 6-max Seat #3 is the button
Seat 1: skillzplumber ($9.22 in chips)
Seat 2: pie3210 ($2.62 in chips)
Seat 3: Smuggler1991 ($2.77 in chips)
Seat 4: Cake_Horn_14 ($5.28 in chips)
Seat 5: DemolishIT ($4.60 in chips)
Seat 6: PlayTheBlues4U ($6.57 in chips)
Cake_Horn_14: posts small blind $0.02
DemolishIT: posts big blind $0.05
pie3210: posts big blind $0.05
*** HOLE CARDS ***
Dealt to PlayTheBlues4U [7h Kc]
PlayTheBlues4U: folds
skillzplumber: raises $0.10 to $0.15
pie3210: folds
Smuggler1991: folds
Cake_Horn_14: folds
DemolishIT: calls $0.10
*** FLOP *** [8c Qc 2d]
DemolishIT: checks
skillzplumber: checks
*** TURN *** [8c Qc 2d] [Ts]
DemolishIT: checks
skillzplumber: checks
*** RIVER *** [8c Qc 2d Ts] [Ad]
DemolishIT: checks
skillzplumber: bets $0.30
DemolishIT: folds
Uncalled bet ($0.30) returned to skillzplumber
skillzplumber collected $0.35 from pot
skillzplumber: doesn't show hand
*** SUMMARY ***
Total pot $0.37 | Rake $0.02
Board [8c Qc 2d Ts Ad]
Seat 1: skillzplumber collected ($0.35)
Seat 2: pie3210 folded before Flop (didn't bet)
Seat 3: Smuggler1991 (button) folded before Flop (didn't bet)
Seat 4: Cake_Horn_14 (small blind) folded before Flop
Seat 5: DemolishIT (big blind) folded on the River
Seat 6: PlayTheBlues4U folded before Flop (didn't bet)


PokerStars Hand #204206679819:  Hold'em No Limit ($0.02/$0.05 USD) - 2019/10/03 22:51:59 ET
Table 'Phoenix' 6-max Seat #1 is the button
Seat 1: skillzplumber ($9.22 in chips)
Seat 3: Smuggler1991 ($2.79 in chips)
Seat 4: Cake_Horn_14 ($5.22 in chips)
Seat 5: DemolishIT ($4.65 in chips)
Seat 6: PlayTheBlues4U ($6.57 in chips)
pie3210 will be allowed to play after the button
Smuggler1991: posts small blind $0.02
Cake_Horn_14: posts big blind $0.05
*** HOLE CARDS ***
Dealt to PlayTheBlues4U [7h 3s]
DemolishIT: calls $0.05
PlayTheBlues4U: folds
skillzplumber: folds
Smuggler1991: folds
Cake_Horn_14: checks
*** FLOP *** [As Kh 6s]
Cake_Horn_14: checks
DemolishIT: checks
*** TURN *** [As Kh 6s] [4c]
Cake_Horn_14: bets $0.08
DemolishIT: folds
Uncalled bet ($0.08) returned to Cake_Horn_14
Cake_Horn_14 collected $0.11 from pot
Cake_Horn_14: doesn't show hand
*** SUMMARY ***
Total pot $0.12 | Rake $0.01
Board [As Kh 6s 4c]
Seat 1: skillzplumber (button) folded before Flop (didn't bet)
Seat 3: Smuggler1991 (small blind) folded before Flop
Seat 4: Cake_Horn_14 (big blind) collected ($0.11)
Seat 5: DemolishIT folded on the Turn
Seat 6: PlayTheBlues4U folded before Flop (didn't bet)


PokerStars Hand #204206679775:  Hold'em No Limit ($0.02/$0.05 USD) - 2019/10/03 22:51:42 ET
Table 'Phoenix' 6-max Seat #6 is the button
Seat 1: skillzplumber ($9.24 in chips)
Seat 3: Smuggler1991 ($2.77 in chips)
Seat 4: Cake_Horn_14 ($5.22 in chips)
Seat 5: DemolishIT ($4.65 in chips)
Seat 6: PlayTheBlues4U ($6.57 in chips)
skillzplumber: posts small blind $0.02
Gould Rush: is sitting out
Smuggler1991: posts big blind $0.05
*** HOLE CARDS ***
Dealt to PlayTheBlues4U [6d Kc]
Gould Rush leaves the table
Cake_Horn_14: folds
DemolishIT: folds
PlayTheBlues4U: folds
pie3210 joins the table at seat #2
skillzplumber: folds
Uncalled bet ($0.03) returned to Smuggler1991
Smuggler1991 collected $0.04 from pot
Smuggler1991: doesn't show hand
*** SUMMARY ***
Total pot $0.04 | Rake $0
Seat 1: skillzplumber (small blind) folded before Flop
Seat 3: Smuggler1991 (big blind) collected ($0.04)
Seat 4: Cake_Horn_14 folded before Flop (didn't bet)
Seat 5: DemolishIT folded before Flop (didn't bet)
Seat 6: PlayTheBlues4U (button) folded before Flop (didn't bet)


PokerStars Hand #204206679661:  Hold'em No Limit ($0.02/$0.05 USD) - 2019/10/03 22:51:03 ET
Table 'Phoenix' 6-max Seat #5 is the button
Seat 1: skillzplumber ($9.29 in chips)
Seat 2: Gould Rush ($5.52 in chips)
Seat 3: Smuggler1991 ($2.77 in chips)
Seat 4: Cake_Horn_14 ($5.22 in chips)
Seat 5: DemolishIT ($4.65 in chips)
Seat 6: PlayTheBlues4U ($6.52 in chips)
PlayTheBlues4U: posts small blind $0.02
skillzplumber: posts big blind $0.05
*** HOLE CARDS ***
Dealt to PlayTheBlues4U [Kc 7c]
Gould Rush: folds
Smuggler1991: folds
Cake_Horn_14: folds
DemolishIT: folds
PlayTheBlues4U: raises $0.05 to $0.10
skillzplumber: folds
Uncalled bet ($0.05) returned to PlayTheBlues4U
PlayTheBlues4U collected $0.10 from pot
PlayTheBlues4U: doesn't show hand
*** SUMMARY ***
Total pot $0.10 | Rake $0
Seat 1: skillzplumber (big blind) folded before Flop
Seat 2: Gould Rush folded before Flop (didn't bet)
Seat 3: Smuggler1991 folded before Flop (didn't bet)
Seat 4: Cake_Horn_14 folded before Flop (didn't bet)
Seat 5: DemolishIT (button) folded before Flop (didn't bet)
Seat 6: PlayTheBlues4U (small blind) collected ($0.10)


PokerStars Hand #204206679599:  Hold'em No Limit ($0.05/$0.10 USD) - 2019/10/03 22:50:41 ET
Table 'Sculptor' 6-max Seat #4 is the button
Seat 2: Mo8791 ($10.65 in chips)
Seat 3: PlayTheBlues4U ($6.70 in chips)
Seat 4: Gould Rush ($21.97 in chips)
Seat 6: Smuggler1991 ($9.67 in chips)
Smuggler1991: posts small blind $0.05
Mo8791: posts big blind $0.10
*** HOLE CARDS ***
Dealt to PlayTheBlues4U [Ac 6s]
PlayTheBlues4U: raises $0.20 to $0.30
Gould Rush: folds
Smuggler1991: raises $0.70 to $1
Mo8791: folds
PlayTheBlues4U: folds
Uncalled bet ($0.70) returned to Smuggler1991
Smuggler1991 collected $0.70 from pot
Smuggler1991: doesn't show hand
*** SUMMARY ***
Total pot $0.70 | Rake $0
Seat 2: Mo8791 (big blind) folded before Flop
Seat 3: PlayTheBlues4U folded before Flop
Seat 4: Gould Rush (button) folded before Flop (didn't bet)
Seat 6: Smuggler1991 (small blind) collected ($0.70)


PokerStars Hand #204206679518:  Hold'em No Limit ($0.02/$0.05 USD) - 2019/10/03 22:50:14 ET
Table 'Phoenix' 6-max Seat #4 is the button
Seat 1: skillzplumber ($9.29 in chips)
Seat 2: Gould Rush ($5 in chips)
Seat 3: Smuggler1991 ($3.27 in chips)
Seat 4: Cake_Horn_14 ($5.22 in chips)
Seat 5: DemolishIT ($4.67 in chips)
Seat 6: PlayTheBlues4U ($6.57 in chips)
DemolishIT: posts small blind $0.02
PlayTheBlues4U: posts big blind $0.05
*** HOLE CARDS ***
Dealt to PlayTheBlues4U [6c 2c]
skillzplumber: folds
Gould Rush: raises $0.10 to $0.15
Smuggler1991: raises $0.10 to $0.25
Cake_Horn_14: folds
DemolishIT: folds
PlayTheBlues4U: folds
Gould Rush: calls $0.10
*** FLOP *** [2s Tc Td]
Gould Rush: checks
Smuggler1991: bets $0.25
Gould Rush: calls $0.25
*** TURN *** [2s Tc Td] [8s]
Gould Rush: checks
Smuggler1991: checks
*** RIVER *** [2s Tc Td 8s] [7c]
Gould Rush: bets $1.05
Smuggler1991: folds
Uncalled bet ($1.05) returned to Gould Rush
Gould Rush collected $1.02 from pot
Gould Rush: doesn't show hand
*** SUMMARY ***
Total pot $1.07 | Rake $0.05
Board [2s Tc Td 8s 7c]
Seat 1: skillzplumber folded before Flop (didn't bet)
Seat 2: Gould Rush collected ($1.02)
Seat 3: Smuggler1991 folded on the River
Seat 4: Cake_Horn_14 (button) folded before Flop (didn't bet)
Seat 5: DemolishIT (small blind) folded before Flop
Seat 6: PlayTheBlues4U (big blind) folded before Flop


PokerStars Hand #204206679464:  Hold'em No Limit ($0.05/$0.10 USD) - 2019/10/03 22:49:54 ET
Table 'Sculptor' 6-max Seat #3 is the button
Seat 2: Mo8791 ($10.47 in chips)
Seat 3: PlayTheBlues4U ($6.70 in chips)
Seat 4: Gould Rush ($22.07 in chips)
Seat 6: Smuggler1991 ($9.77 in chips)
Gould Rush: posts small blind $0.05
Smuggler1991: posts big blind $0.10
*** HOLE CARDS ***
Dealt to PlayTheBlues4U [5d 2h]
Mo8791: calls $0.10
PlayTheBlues4U: folds
Gould Rush: calls $0.05
Smuggler1991: checks
*** FLOP *** [Jh 9d Qs]
Gould Rush: checks
Smuggler1991: checks
Mo8791: checks
*** TURN *** [Jh 9d Qs] [Tc]
Gould Rush: checks
Smuggler1991: checks
Mo8791: bets $0.30
Gould Rush: folds
Smuggler1991: folds
Uncalled bet ($0.30) returned to Mo8791
Mo8791 collected $0.28 from pot
Mo8791: doesn't show hand
*** SUMMARY ***
Total pot $0.30 | Rake $0.02
Board [Jh 9d Qs Tc]
Seat 2: Mo8791 collected ($0.28)
Seat 3: PlayTheBlues4U (button) folded before Flop (didn't bet)
Seat 4: Gould Rush (small blind) folded on the Turn
Seat 6: Smuggler1991 (big blind) folded on the Turn


PokerStars Hand #204206679438:  Hold'em No Limit ($0.02/$0.05 USD) - 2019/10/03 22:49:45 ET
Table 'Phoenix' 6-max Seat #3 is the button
Seat 1: skillzplumber ($9.29 in chips)
Seat 2: Gould Rush ($3.20 in chips)
Seat 3: Smuggler1991 ($3.10 in chips)
Seat 4: Cake_Horn_14 ($5.24 in chips)
Seat 5: DemolishIT ($4.84 in chips)
Seat 6: PlayTheBlues4U ($6.57 in chips)
Cake_Horn_14: posts small blind $0.02
DemolishIT: posts big blind $0.05
*** HOLE CARDS ***
Dealt to PlayTheBlues4U [3h Js]
PlayTheBlues4U: folds
skillzplumber: folds
Gould Rush: folds
Smuggler1991: raises $0.12 to $0.17
Cake_Horn_14: folds
DemolishIT: calls $0.12
*** FLOP *** [8d 6c 6s]
DemolishIT: checks
Smuggler1991: bets $0.20
DemolishIT: folds
Uncalled bet ($0.20) returned to Smuggler1991
Smuggler1991 collected $0.34 from pot
Smuggler1991: doesn't show hand
*** SUMMARY ***
Total pot $0.36 | Rake $0.02
Board [8d 6c 6s]
Seat 1: skillzplumber folded before Flop (didn't bet)
Seat 2: Gould Rush folded before Flop (didn't bet)
Seat 3: Smuggler1991 (button) collected ($0.34)
Seat 4: Cake_Horn_14 (small blind) folded before Flop
Seat 5: DemolishIT (big blind) folded on the Flop
Seat 6: PlayTheBlues4U folded before Flop (didn't bet)


PokerStars Hand #204206679324:  Hold'em No Limit ($0.05/$0.10 USD) - 2019/10/03 22:49:02 ET
Table 'Sculptor' 6-max Seat #2 is the button
Seat 2: Mo8791 ($10.11 in chips)
Seat 3: PlayTheBlues4U ($7 in chips)
Seat 4: Gould Rush ($22.17 in chips)
Seat 6: Smuggler1991 ($9.77 in chips)
PlayTheBlues4U: posts small blind $0.05
Gould Rush: posts big blind $0.10
*** HOLE CARDS ***
Dealt to PlayTheBlues4U [Ac 2c]
Smuggler1991: folds
Mo8791: raises $0.20 to $0.30
PlayTheBlues4U: calls $0.25
Gould Rush: folds
*** FLOP *** [5d Js Tc]
PlayTheBlues4U: checks
Mo8791: bets $0.30
PlayTheBlues4U: folds
Uncalled bet ($0.30) returned to Mo8791
Mo8791 collected $0.66 from pot
Mo8791: doesn't show hand
*** SUMMARY ***
Total pot $0.70 | Rake $0.04
Board [5d Js Tc]
Seat 2: Mo8791 (button) collected ($0.66)
Seat 3: PlayTheBlues4U (small blind) folded on the Flop
Seat 4: Gould Rush (big blind) folded before Flop
Seat 6: Smuggler1991 folded before Flop (didn't bet)


PokerStars Hand #204206679241:  Hold'em No Limit ($0.02/$0.05 USD) - 2019/10/03 22:48:38 ET
Table 'Phoenix' 6-max Seat #2 is the button
Seat 1: skillzplumber ($9.29 in chips)
Seat 2: Gould Rush ($5 in chips)
Seat 3: Smuggler1991 ($3.12 in chips)
Seat 4: Cake_Horn_14 ($5.29 in chips)
Seat 5: DemolishIT ($5.54 in chips)
Seat 6: PlayTheBlues4U ($4.22 in chips)
Smuggler1991: posts small blind $0.02
Cake_Horn_14: posts big blind $0.05
*** HOLE CARDS ***
Dealt to PlayTheBlues4U [Ac Tc]
DemolishIT: raises $0.20 to $0.25
PlayTheBlues4U: calls $0.25
skillzplumber: folds
Gould Rush: raises $0.45 to $0.70
Smuggler1991: folds
Cake_Horn_14: folds
DemolishIT: calls $0.45
PlayTheBlues4U: calls $0.45
*** FLOP *** [Td Ah 8h]
DemolishIT: checks
PlayTheBlues4U: bets $1.10
Gould Rush: calls $1.10
DemolishIT: folds
*** TURN *** [Td Ah 8h] [Jd]
PlayTheBlues4U: bets $2.42 and is all-in
Gould Rush: folds
Uncalled bet ($2.42) returned to PlayTheBlues4U
PlayTheBlues4U collected $4.15 from pot
PlayTheBlues4U: doesn't show hand
*** SUMMARY ***
Total pot $4.37 | Rake $0.22
Board [Td Ah 8h Jd]
Seat 1: skillzplumber folded before Flop (didn't bet)
Seat 2: Gould Rush (button) folded on the Turn
Seat 3: Smuggler1991 (small blind) folded before Flop
Seat 4: Cake_Horn_14 (big blind) folded before Flop
Seat 5: DemolishIT folded on the Flop
Seat 6: PlayTheBlues4U collected ($4.15)


PokerStars Hand #204206679142:  Hold'em No Limit ($0.05/$0.10 USD) - 2019/10/03 22:47:58 ET
Table 'Sculptor' 6-max Seat #6 is the button
Seat 2: Mo8791 ($10.16 in chips)
Seat 3: PlayTheBlues4U ($10 in chips)
Seat 4: Gould Rush ($19.42 in chips)
Seat 6: Smuggler1991 ($9.77 in chips)
Mo8791: posts small blind $0.05
PlayTheBlues4U: posts big blind $0.10
*** HOLE CARDS ***
Dealt to PlayTheBlues4U [8c Td]
Gould Rush: raises $0.20 to $0.30
Smuggler1991: folds
Mo8791: folds
PlayTheBlues4U: calls $0.20
*** FLOP *** [Qh Tc Jd]
PlayTheBlues4U: checks
Gould Rush: bets $0.30
PlayTheBlues4U: calls $0.30
*** TURN *** [Qh Tc Jd] [7c]
PlayTheBlues4U: bets $0.70
Gould Rush: calls $0.70
*** RIVER *** [Qh Tc Jd 7c] [Js]
PlayTheBlues4U: bets $1.70
Gould Rush: calls $1.70
*** SHOW DOWN ***
PlayTheBlues4U: shows [8c Td] (two pair, Jacks and Tens)
Gould Rush: shows [As Qs] (two pair, Queens and Jacks)
Gould Rush collected $5.75 from pot
*** SUMMARY ***
Total pot $6.05 | Rake $0.30
Board [Qh Tc Jd 7c Js]
Seat 2: Mo8791 (small blind) folded before Flop
Seat 3: PlayTheBlues4U (big blind) showed [8c Td] and lost with two pair, Jacks and Tens
Seat 4: Gould Rush showed [As Qs] and won ($5.75) with two pair, Queens and Jacks
Seat 6: Smuggler1991 (button) folded before Flop (didn't bet)


PokerStars Hand #204206679124:  Hold'em No Limit ($0.02/$0.05 USD) - 2019/10/03 22:47:53 ET
Table 'Phoenix' 6-max Seat #1 is the button
Seat 1: skillzplumber ($9.29 in chips)
Seat 2: Gould Rush ($4.40 in chips)
Seat 3: Smuggler1991 ($3.22 in chips)
Seat 4: Cake_Horn_14 ($5.29 in chips)
Seat 5: DemolishIT ($5.54 in chips)
Seat 6: PlayTheBlues4U ($4.22 in chips)
Gould Rush: posts small blind $0.02
Smuggler1991: posts big blind $0.05
*** HOLE CARDS ***
Dealt to PlayTheBlues4U [Th 5s]
Cake_Horn_14: folds
DemolishIT: folds
PlayTheBlues4U: folds
skillzplumber: folds
Gould Rush: calls $0.03
Smuggler1991: checks
*** FLOP *** [2s 8s As]
Gould Rush: checks
Smuggler1991: bets $0.05
Gould Rush: calls $0.05
*** TURN *** [2s 8s As] [7d]
Gould Rush: checks
Smuggler1991: checks
*** RIVER *** [2s 8s As 7d] [2h]
Gould Rush: bets $0.20
Smuggler1991: folds
Uncalled bet ($0.20) returned to Gould Rush
Gould Rush collected $0.19 from pot
Gould Rush: doesn't show hand
*** SUMMARY ***
Total pot $0.20 | Rake $0.01
Board [2s 8s As 7d 2h]
Seat 1: skillzplumber (button) folded before Flop (didn't bet)
Seat 2: Gould Rush (small blind) collected ($0.19)
Seat 3: Smuggler1991 (big blind) folded on the River
Seat 4: Cake_Horn_14 folded before Flop (didn't bet)
Seat 5: DemolishIT folded before Flop (didn't bet)
Seat 6: PlayTheBlues4U folded before Flop (didn't bet)


PokerStars Hand #204206679112:  Hold'em No Limit ($0.05/$0.10 USD) - 2019/10/03 22:47:48 ET
Table 'Sculptor' 6-max Seat #4 is the button
Seat 2: Mo8791 ($10.11 in chips)
Seat 3: PlayTheBlues4U ($10 in chips)
Seat 4: Gould Rush ($19.42 in chips)
Seat 6: Smuggler1991 ($9.82 in chips)
Smuggler1991: posts small blind $0.05
Mo8791: posts big blind $0.10
*** HOLE CARDS ***
Dealt to PlayTheBlues4U [Th Qs]
PlayTheBlues4U: folds
Gould Rush: folds
Smuggler1991: folds
Uncalled bet ($0.05) returned to Mo8791
Mo8791 collected $0.10 from pot
Mo8791: doesn't show hand
*** SUMMARY ***
Total pot $0.10 | Rake $0
Seat 2: Mo8791 (big blind) collected ($0.10)
Seat 3: PlayTheBlues4U folded before Flop (didn't bet)
Seat 4: Gould Rush (button) folded before Flop (didn't bet)
Seat 6: Smuggler1991 (small blind) folded before Flop


PokerStars Hand #204206679020:  Hold'em No Limit ($0.02/$0.05 USD) - 2019/10/03 22:47:12 ET
Table 'Phoenix' 6-max Seat #6 is the button
Seat 1: skillzplumber ($8.27 in chips)
Seat 2: Gould Rush ($5 in chips)
Seat 3: Smuggler1991 ($3.22 in chips)
Seat 4: Cake_Horn_14 ($5.29 in chips)
Seat 5: DemolishIT ($6.04 in chips)
Seat 6: PlayTheBlues4U ($4.22 in chips)
skillzplumber: posts small blind $0.02
Gould Rush: posts big blind $0.05
*** HOLE CARDS ***
Dealt to PlayTheBlues4U [3d 2h]
Smuggler1991: folds
Cake_Horn_14: folds
DemolishIT: raises $0.15 to $0.20
PlayTheBlues4U: folds
skillzplumber: calls $0.18
Gould Rush: calls $0.15
*** FLOP *** [7c Td Ks]
skillzplumber: checks
Gould Rush: bets $0.30
DemolishIT: calls $0.30
skillzplumber: calls $0.30
*** TURN *** [7c Td Ks] [Tc]
skillzplumber: checks
Gould Rush: checks
DemolishIT: checks
*** RIVER *** [7c Td Ks Tc] [6c]
skillzplumber: bets $0.10
Gould Rush: calls $0.10
DemolishIT: folds
*** SHOW DOWN ***
skillzplumber: shows [Ah Th] (three of a kind, Tens)
Gould Rush: mucks hand
skillzplumber collected $1.62 from pot
*** SUMMARY ***
Total pot $1.70 | Rake $0.08
Board [7c Td Ks Tc 6c]
Seat 1: skillzplumber (small blind) showed [Ah Th] and won ($1.62) with three of a kind, Tens
Seat 2: Gould Rush (big blind) mucked [7d 8d]
Seat 3: Smuggler1991 folded before Flop (didn't bet)
Seat 4: Cake_Horn_14 folded before Flop (didn't bet)
Seat 5: DemolishIT folded on the River
Seat 6: PlayTheBlues4U (button) folded before Flop (didn't bet)


PokerStars Hand #204206678966:  Hold'em No Limit ($0.05/$0.10 USD) - 2019/10/03 22:46:51 ET
Table 'Sculptor' 6-max Seat #3 is the button
Seat 2: Mo8791 ($6.59 in chips)
Seat 3: PlayTheBlues4U ($6.65 in chips)
Seat 4: Gould Rush ($23.22 in chips)
Seat 6: Smuggler1991 ($9.92 in chips)
Gould Rush: posts small blind $0.05
Smuggler1991: posts big blind $0.10
*** HOLE CARDS ***
Dealt to PlayTheBlues4U [3h Ac]
Mo8791: raises $0.20 to $0.30
PlayTheBlues4U: folds
Gould Rush: calls $0.25
Smuggler1991: folds
*** FLOP *** [6s 5s 6c]
Gould Rush: bets $0.30
Mo8791: raises $1.20 to $1.50
Gould Rush: calls $1.20
*** TURN *** [6s 5s 6c] [Js]
Gould Rush: checks
Mo8791: bets $2
Gould Rush: calls $2
*** RIVER *** [6s 5s 6c Js] [3d]
Gould Rush: checks
Mo8791: checks
*** SHOW DOWN ***
Gould Rush: shows [4d As] (a pair of Sixes)
Mo8791: shows [2c 5c] (two pair, Sixes and Fives)
Mo8791 collected $7.32 from pot
*** SUMMARY ***
Total pot $7.70 | Rake $0.38
Board [6s 5s 6c Js 3d]
Seat 2: Mo8791 showed [2c 5c] and won ($7.32) with two pair, Sixes and Fives
Seat 3: PlayTheBlues4U (button) folded before Flop (didn't bet)
Seat 4: Gould Rush (small blind) showed [4d As] and lost with a pair of Sixes
Seat 6: Smuggler1991 (big blind) folded before Flop


PokerStars Hand #204206678909:  Hold'em No Limit ($0.02/$0.05 USD) - 2019/10/03 22:46:32 ET
Table 'Phoenix' 6-max Seat #5 is the button
Seat 1: skillzplumber ($8.93 in chips)
Seat 2: Gould Rush ($0.66 in chips)
Seat 3: Smuggler1991 ($3.22 in chips)
Seat 4: Cake_Horn_14 ($5.29 in chips)
Seat 5: DemolishIT ($6.04 in chips)
Seat 6: PlayTheBlues4U ($4.24 in chips)
PlayTheBlues4U: posts small blind $0.02
skillzplumber: posts big blind $0.05
*** HOLE CARDS ***
Dealt to PlayTheBlues4U [2c 7c]
Gould Rush: raises $0.61 to $0.66 and is all-in
Smuggler1991: folds
Cake_Horn_14: folds
DemolishIT: folds
PlayTheBlues4U: folds
skillzplumber: calls $0.61
*** FLOP *** [Ks 7s 4c]
*** TURN *** [Ks 7s 4c] [7h]
*** RIVER *** [Ks 7s 4c 7h] [Jc]
*** SHOW DOWN ***
skillzplumber: shows [Th Kh] (two pair, Kings and Sevens)
Gould Rush: shows [Kc Qd] (two pair, Kings and Sevens - Queen kicker)
Gould Rush collected $1.27 from pot
*** SUMMARY ***
Total pot $1.34 | Rake $0.07
Board [Ks 7s 4c 7h Jc]
Seat 1: skillzplumber (big blind) showed [Th Kh] and lost with two pair, Kings and Sevens
Seat 2: Gould Rush showed [Kc Qd] and won ($1.27) with two pair, Kings and Sevens
Seat 3: Smuggler1991 folded before Flop (didn't bet)
Seat 4: Cake_Horn_14 folded before Flop (didn't bet)
Seat 5: DemolishIT (button) folded before Flop (didn't bet)
Seat 6: PlayTheBlues4U (small blind) folded before Flop


PokerStars Hand #204206678775:  Hold'em No Limit ($0.05/$0.10 USD) - 2019/10/03 22:45:35 ET
Table 'Sculptor' 6-max Seat #2 is the button
Seat 2: Mo8791 ($6.59 in chips)
Seat 3: PlayTheBlues4U ($8.95 in chips)
Seat 4: Gould Rush ($21.15 in chips)
Seat 6: Smuggler1991 ($9.92 in chips)
PlayTheBlues4U: posts small blind $0.05
Gould Rush: posts big blind $0.10
*** HOLE CARDS ***
Dealt to PlayTheBlues4U [As Jc]
Smuggler1991: folds
Mo8791: folds
PlayTheBlues4U: raises $0.20 to $0.30
Gould Rush: calls $0.20
*** FLOP *** [5h 9d 2c]
PlayTheBlues4U: checks
Gould Rush: bets $0.50
PlayTheBlues4U: calls $0.50
*** TURN *** [5h 9d 2c] [5d]
PlayTheBlues4U: checks
Gould Rush: bets $1.50
PlayTheBlues4U: calls $1.50
*** RIVER *** [5h 9d 2c 5d] [Td]
PlayTheBlues4U: checks
Gould Rush: checks
*** SHOW DOWN ***
PlayTheBlues4U: shows [As Jc] (a pair of Fives)
Gould Rush: shows [Kh 9h] (two pair, Nines and Fives)
Gould Rush collected $4.37 from pot
*** SUMMARY ***
Total pot $4.60 | Rake $0.23
Board [5h 9d 2c 5d Td]
Seat 2: Mo8791 (button) folded before Flop (didn't bet)
Seat 3: PlayTheBlues4U (small blind) showed [As Jc] and lost with a pair of Fives
Seat 4: Gould Rush (big blind) showed [Kh 9h] and won ($4.37) with two pair, Nines and Fives
Seat 6: Smuggler1991 folded before Flop (didn't bet)


PokerStars Hand #204206678683:  Hold'em No Limit ($0.02/$0.05 USD) - 2019/10/03 22:45:03 ET
Table 'Phoenix' 6-max Seat #4 is the button
Seat 1: skillzplumber ($4.34 in chips)
Seat 2: Gould Rush ($5 in chips)
Seat 3: Smuggler1991 ($3.22 in chips)
Seat 4: Cake_Horn_14 ($5.29 in chips)
Seat 5: DemolishIT ($6.06 in chips)
Seat 6: PlayTheBlues4U ($4.94 in chips)
DemolishIT: posts small blind $0.02
PlayTheBlues4U: posts big blind $0.05
*** HOLE CARDS ***
Dealt to PlayTheBlues4U [Qd Kh]
skillzplumber: calls $0.05
Gould Rush: raises $0.10 to $0.15
Smuggler1991: folds
Cake_Horn_14: folds
DemolishIT: folds
PlayTheBlues4U: raises $0.10 to $0.25
skillzplumber: calls $0.20
Gould Rush: raises $0.45 to $0.70
PlayTheBlues4U: calls $0.45
skillzplumber: calls $0.45
*** FLOP *** [As Td Qs]
PlayTheBlues4U: checks
skillzplumber: checks
Gould Rush: bets $1
PlayTheBlues4U: folds
skillzplumber: raises $1.05 to $2.05
Gould Rush: raises $2.25 to $4.30 and is all-in
skillzplumber: calls $1.59 and is all-in
Uncalled bet ($0.66) returned to Gould Rush
*** TURN *** [As Td Qs] [5c]
*** RIVER *** [As Td Qs 5c] [2h]
*** SHOW DOWN ***
skillzplumber: shows [Ks Jd] (a straight, Ten to Ace)
Gould Rush: shows [Ad Ac] (three of a kind, Aces)
skillzplumber collected $8.93 from pot
*** SUMMARY ***
Total pot $9.40 | Rake $0.47
Board [As Td Qs 5c 2h]
Seat 1: skillzplumber showed [Ks Jd] and won ($8.93) with a straight, Ten to Ace
Seat 2: Gould Rush showed [Ad Ac] and lost with three of a kind, Aces
Seat 3: Smuggler1991 folded before Flop (didn't bet)
Seat 4: Cake_Horn_14 (button) folded before Flop (didn't bet)
Seat 5: DemolishIT (small blind) folded before Flop
Seat 6: PlayTheBlues4U (big blind) folded on the Flop


PokerStars Hand #204206678634:  Hold'em No Limit ($0.05/$0.10 USD) - 2019/10/03 22:44:42 ET
Table 'Sculptor' 6-max Seat #6 is the button
Seat 2: Mo8791 ($6.64 in chips)
Seat 3: PlayTheBlues4U ($9.70 in chips)
Seat 4: Gould Rush ($21.15 in chips)
Seat 6: Smuggler1991 ($9.20 in chips)
Mo8791: posts small blind $0.05
PlayTheBlues4U: posts big blind $0.10
*** HOLE CARDS ***
Dealt to PlayTheBlues4U [7c Ac]
Gould Rush: folds
Smuggler1991: raises $0.25 to $0.35
Mo8791: folds
PlayTheBlues4U: calls $0.25
*** FLOP *** [6d 2s Qd]
PlayTheBlues4U: checks
Smuggler1991: bets $0.40
PlayTheBlues4U: calls $0.40
*** TURN *** [6d 2s Qd] [Jc]
PlayTheBlues4U: checks
Smuggler1991: bets $1.50
PlayTheBlues4U: folds
Uncalled bet ($1.50) returned to Smuggler1991
Smuggler1991 collected $1.47 from pot
Smuggler1991: doesn't show hand
*** SUMMARY ***
Total pot $1.55 | Rake $0.08
Board [6d 2s Qd Jc]
Seat 2: Mo8791 (small blind) folded before Flop
Seat 3: PlayTheBlues4U (big blind) folded on the Turn
Seat 4: Gould Rush folded before Flop (didn't bet)
Seat 6: Smuggler1991 (button) collected ($1.47)


PokerStars Hand #204206678557:  Hold'em No Limit ($0.05/$0.10 USD) - 2019/10/03 22:44:17 ET
Table 'Sculptor' 6-max Seat #4 is the button
Seat 2: Mo8791 ($6.54 in chips)
Seat 3: PlayTheBlues4U ($9.70 in chips)
Seat 4: Gould Rush ($21.15 in chips)
Seat 6: Smuggler1991 ($9.30 in chips)
Smuggler1991: posts small blind $0.05
Mo8791: posts big blind $0.10
*** HOLE CARDS ***
Dealt to PlayTheBlues4U [5c Jc]
PlayTheBlues4U: folds
Gould Rush: folds
Smuggler1991: calls $0.05
Mo8791: raises $0.20 to $0.30
Smuggler1991: folds
Uncalled bet ($0.20) returned to Mo8791
Mo8791 collected $0.20 from pot
Mo8791: doesn't show hand
*** SUMMARY ***
Total pot $0.20 | Rake $0
Seat 2: Mo8791 (big blind) collected ($0.20)
Seat 3: PlayTheBlues4U folded before Flop (didn't bet)
Seat 4: Gould Rush (button) folded before Flop (didn't bet)
Seat 6: Smuggler1991 (small blind) folded before Flop


PokerStars Hand #204206678524:  Hold'em No Limit ($0.02/$0.05 USD) - 2019/10/03 22:44:05 ET
Table 'Phoenix' 6-max Seat #3 is the button
Seat 1: skillzplumber ($3.91 in chips)
Seat 2: Gould Rush ($5 in chips)
Seat 3: Smuggler1991 ($3.32 in chips)
Seat 4: Cake_Horn_14 ($5.31 in chips)
Seat 5: DemolishIT ($6.11 in chips)
Seat 6: PlayTheBlues4U ($5.24 in chips)
Cake_Horn_14: posts small blind $0.02
DemolishIT: posts big blind $0.05
*** HOLE CARDS ***
Dealt to PlayTheBlues4U [Ad Js]
PlayTheBlues4U: raises $0.05 to $0.10
skillzplumber: calls $0.10
Gould Rush: folds
Smuggler1991: calls $0.10
Cake_Horn_14: folds
DemolishIT: folds
*** FLOP *** [9d Kc Jh]
PlayTheBlues4U: bets $0.20
skillzplumber: calls $0.20
Smuggler1991: folds
*** TURN *** [9d Kc Jh] [2d]
PlayTheBlues4U: checks
skillzplumber: bets $0.55
PlayTheBlues4U: folds
Uncalled bet ($0.55) returned to skillzplumber
skillzplumber collected $0.73 from pot
skillzplumber: doesn't show hand
*** SUMMARY ***
Total pot $0.77 | Rake $0.04
Board [9d Kc Jh 2d]
Seat 1: skillzplumber collected ($0.73)
Seat 2: Gould Rush folded before Flop (didn't bet)
Seat 3: Smuggler1991 (button) folded on the Flop
Seat 4: Cake_Horn_14 (small blind) folded before Flop
Seat 5: DemolishIT (big blind) folded before Flop
Seat 6: PlayTheBlues4U folded on the Turn


PokerStars Hand #204206678400:  Hold'em No Limit ($0.05/$0.10 USD) - 2019/10/03 22:43:20 ET
Table 'Sculptor' 6-max Seat #3 is the button
Seat 2: Mo8791 ($6.54 in chips)
Seat 3: PlayTheBlues4U ($9.40 in chips)
Seat 4: Gould Rush ($20.85 in chips)
Seat 6: Smuggler1991 ($10 in chips)
Gould Rush: posts small blind $0.05
Smuggler1991: posts big blind $0.10
*** HOLE CARDS ***
Dealt to PlayTheBlues4U [Qc 9c]
Mo8791: folds
PlayTheBlues4U: raises $0.20 to $0.30
Gould Rush: calls $0.25
Smuggler1991: calls $0.20
*** FLOP *** [3s Js Jd]
Gould Rush: checks
Smuggler1991: checks
PlayTheBlues4U: checks
*** TURN *** [3s Js Jd] [3h]
Gould Rush: checks
Smuggler1991: checks
PlayTheBlues4U: checks
*** RIVER *** [3s Js Jd 3h] [9d]
Gould Rush: bets $0.40
Smuggler1991: calls $0.40
PlayTheBlues4U: calls $0.40
*** SHOW DOWN ***
Gould Rush: shows [Qd 9h] (two pair, Jacks and Nines)
Smuggler1991: mucks hand
PlayTheBlues4U: shows [Qc 9c] (two pair, Jacks and Nines)
Gould Rush collected $1 from pot
PlayTheBlues4U collected $1 from pot
*** SUMMARY ***
Total pot $2.10 | Rake $0.10
Board [3s Js Jd 3h 9d]
Seat 2: Mo8791 folded before Flop (didn't bet)
Seat 3: PlayTheBlues4U (button) showed [Qc 9c] and won ($1) with two pair, Jacks and Nines
Seat 4: Gould Rush (small blind) showed [Qd 9h] and won ($1) with two pair, Jacks and Nines
Seat 6: Smuggler1991 (big blind) mucked [9s Th]


PokerStars Hand #204206678386:  Hold'em No Limit ($0.02/$0.05 USD) - 2019/10/03 22:43:15 ET
Table 'Phoenix' 6-max Seat #2 is the button
Seat 1: skillzplumber ($3.91 in chips)
Seat 2: Gould Rush ($3.56 in chips)
Seat 3: Smuggler1991 ($3.82 in chips)
Seat 4: Cake_Horn_14 ($5.36 in chips)
Seat 5: DemolishIT ($6.11 in chips)
Seat 6: PlayTheBlues4U ($4.74 in chips)
Smuggler1991: posts small blind $0.02
Cake_Horn_14: posts big blind $0.05
*** HOLE CARDS ***
Dealt to PlayTheBlues4U [3h 3d]
DemolishIT: folds
PlayTheBlues4U: raises $0.10 to $0.15
skillzplumber: folds
Gould Rush: folds
Smuggler1991: raises $0.35 to $0.50
Cake_Horn_14: folds
PlayTheBlues4U: calls $0.35
*** FLOP *** [4s 9h Qh]
Smuggler1991: checks
PlayTheBlues4U: checks
*** TURN *** [4s 9h Qh] [Jh]
Smuggler1991: checks
PlayTheBlues4U: bets $0.50
Smuggler1991: folds
Uncalled bet ($0.50) returned to PlayTheBlues4U
PlayTheBlues4U collected $1 from pot
PlayTheBlues4U: doesn't show hand
*** SUMMARY ***
Total pot $1.05 | Rake $0.05
Board [4s 9h Qh Jh]
Seat 1: skillzplumber folded before Flop (didn't bet)
Seat 2: Gould Rush (button) folded before Flop (didn't bet)
Seat 3: Smuggler1991 (small blind) folded on the Turn
Seat 4: Cake_Horn_14 (big blind) folded before Flop
Seat 5: DemolishIT folded before Flop (didn't bet)
Seat 6: PlayTheBlues4U collected ($1)


PokerStars Hand #204206678359:  Hold'em No Limit ($0.05/$0.10 USD) - 2019/10/03 22:43:06 ET
Table 'Sculptor' 6-max Seat #2 is the button
Seat 2: Mo8791 ($6.54 in chips)
Seat 3: PlayTheBlues4U ($9.30 in chips)
Seat 4: Gould Rush ($20.95 in chips)
PlayTheBlues4U: posts small blind $0.05
Gould Rush: posts big blind $0.10
*** HOLE CARDS ***
Dealt to PlayTheBlues4U [Js Td]
Mo8791: folds
PlayTheBlues4U: raises $0.20 to $0.30
Gould Rush: folds
Uncalled bet ($0.20) returned to PlayTheBlues4U
PlayTheBlues4U collected $0.20 from pot
PlayTheBlues4U: doesn't show hand
*** SUMMARY ***
Total pot $0.20 | Rake $0
Seat 2: Mo8791 (button) folded before Flop (didn't bet)
Seat 3: PlayTheBlues4U (small blind) collected ($0.20)
Seat 4: Gould Rush (big blind) folded before Flop


PokerStars Hand #204206678334:  Hold'em No Limit ($0.05/$0.10 USD) - 2019/10/03 22:43:00 ET
Table 'Sculptor' 6-max Seat #4 is the button
Seat 2: Mo8791 ($6.59 in chips)
Seat 3: PlayTheBlues4U ($9.25 in chips)
Seat 4: Gould Rush ($20.95 in chips)
Mo8791: posts small blind $0.05
PlayTheBlues4U: posts big blind $0.10
*** HOLE CARDS ***
Dealt to PlayTheBlues4U [Td Qd]
Gould Rush: folds
Mo8791: folds
Uncalled bet ($0.05) returned to PlayTheBlues4U
PlayTheBlues4U collected $0.10 from pot
PlayTheBlues4U: doesn't show hand
*** SUMMARY ***
Total pot $0.10 | Rake $0
Seat 2: Mo8791 (small blind) folded before Flop
Seat 3: PlayTheBlues4U (big blind) collected ($0.10)
Seat 4: Gould Rush (button) folded before Flop (didn't bet)


PokerStars Hand #204206678217:  Hold'em No Limit ($0.02/$0.05 USD) - 2019/10/03 22:42:17 ET
Table 'Phoenix' 6-max Seat #1 is the button
Seat 1: skillzplumber ($3.91 in chips)
Seat 2: Gould Rush ($5.46 in chips)
Seat 3: Smuggler1991 ($3.87 in chips)
Seat 4: Cake_Horn_14 ($5.48 in chips)
Seat 5: DemolishIT ($4.12 in chips)
Seat 6: PlayTheBlues4U ($4.86 in chips)
Gould Rush: posts small blind $0.02
Smuggler1991: posts big blind $0.05
*** HOLE CARDS ***
Dealt to PlayTheBlues4U [5h 5d]
Cake_Horn_14: raises $0.07 to $0.12
DemolishIT: calls $0.12
PlayTheBlues4U: calls $0.12
skillzplumber: folds
Gould Rush: raises $0.78 to $0.90
Smuggler1991: folds
Cake_Horn_14: folds
DemolishIT: calls $0.78
PlayTheBlues4U: folds
*** FLOP *** [Qh 8d Jd]
Gould Rush: bets $1
DemolishIT: calls $1
*** TURN *** [Qh 8d Jd] [5s]
Gould Rush: checks
DemolishIT: bets $1.90
Gould Rush: folds
Uncalled bet ($1.90) returned to DemolishIT
DemolishIT collected $3.89 from pot
DemolishIT: doesn't show hand
*** SUMMARY ***
Total pot $4.09 | Rake $0.20
Board [Qh 8d Jd 5s]
Seat 1: skillzplumber (button) folded before Flop (didn't bet)
Seat 2: Gould Rush (small blind) folded on the Turn
Seat 3: Smuggler1991 (big blind) folded before Flop
Seat 4: Cake_Horn_14 folded before Flop
Seat 5: DemolishIT collected ($3.89)
Seat 6: PlayTheBlues4U folded before Flop


PokerStars Hand #204206678203:  Hold'em No Limit ($0.05/$0.10 USD) - 2019/10/03 22:42:12 ET
Table 'Sculptor' 6-max Seat #3 is the button
Seat 2: Mo8791 ($6.59 in chips)
Seat 3: PlayTheBlues4U ($9.25 in chips)
Seat 4: Gould Rush ($13.98 in chips)
Seat 6: Smuggler1991 ($7.75 in chips)
Gould Rush: posts small blind $0.05
Smuggler1991: posts big blind $0.10
*** HOLE CARDS ***
Dealt to PlayTheBlues4U [8c 2s]
Mo8791: folds
PlayTheBlues4U: folds
Gould Rush: raises $0.20 to $0.30
Smuggler1991: raises $0.60 to $0.90
Gould Rush: calls $0.60
*** FLOP *** [Qs 5s 6d]
Gould Rush: checks
Smuggler1991: bets $0.90
Gould Rush: calls $0.90
*** TURN *** [Qs 5s 6d] [4d]
Gould Rush: checks
Smuggler1991: bets $1.70
Gould Rush: calls $1.70
*** RIVER *** [Qs 5s 6d 4d] [8s]
Gould Rush: bets $10.48 and is all-in
Smuggler1991: calls $4.25 and is all-in
Uncalled bet ($6.23) returned to Gould Rush
*** SHOW DOWN ***
Gould Rush: shows [Ks 4s] (a flush, King high)
Smuggler1991: shows [9h 9d] (a pair of Nines)
Gould Rush collected $14.72 from pot
*** SUMMARY ***
Total pot $15.50 | Rake $0.78
Board [Qs 5s 6d 4d 8s]
Seat 2: Mo8791 folded before Flop (didn't bet)
Seat 3: PlayTheBlues4U (button) folded before Flop (didn't bet)
Seat 4: Gould Rush (small blind) showed [Ks 4s] and won ($14.72) with a flush, King high
Seat 6: Smuggler1991 (big blind) showed [9h 9d] and lost with a pair of Nines


PokerStars Hand #204206678088:  Hold'em No Limit ($0.05/$0.10 USD) - 2019/10/03 22:41:35 ET
Table 'Sculptor' 6-max Seat #2 is the button
Seat 2: Mo8791 ($6.59 in chips)
Seat 3: PlayTheBlues4U ($9.30 in chips)
Seat 4: Gould Rush ($13.62 in chips)
Seat 6: Smuggler1991 ($8.10 in chips)
PlayTheBlues4U: posts small blind $0.05
Gould Rush: posts big blind $0.10
*** HOLE CARDS ***
Dealt to PlayTheBlues4U [5h 7s]
Smuggler1991: raises $0.25 to $0.35
Mo8791: folds
PlayTheBlues4U: folds
Gould Rush: calls $0.25
*** FLOP *** [2c 7h Kh]
Gould Rush: checks
Smuggler1991: checks
*** TURN *** [2c 7h Kh] [8c]
Gould Rush: checks
Smuggler1991: checks
*** RIVER *** [2c 7h Kh 8c] [Th]
Gould Rush: checks
Smuggler1991: checks
*** SHOW DOWN ***
Gould Rush: shows [Tc 9s] (a pair of Tens)
Smuggler1991: mucks hand
Gould Rush collected $0.71 from pot
*** SUMMARY ***
Total pot $0.75 | Rake $0.04
Board [2c 7h Kh 8c Th]
Seat 2: Mo8791 (button) folded before Flop (didn't bet)
Seat 3: PlayTheBlues4U (small blind) folded before Flop
Seat 4: Gould Rush (big blind) showed [Tc 9s] and won ($0.71) with a pair of Tens
Seat 6: Smuggler1991 mucked [6c Ah]


PokerStars Hand #204206678055:  Hold'em No Limit ($0.02/$0.05 USD) - 2019/10/03 22:41:23 ET
Table 'Phoenix' 6-max Seat #6 is the button
Seat 1: skillzplumber ($4.06 in chips)
Seat 2: Gould Rush ($5 in chips)
Seat 3: Smuggler1991 ($3.87 in chips)
Seat 4: Cake_Horn_14 ($5.48 in chips)
Seat 5: DemolishIT ($4.12 in chips)
Seat 6: PlayTheBlues4U ($5.21 in chips)
skillzplumber: posts small blind $0.02
Gould Rush: posts big blind $0.05
*** HOLE CARDS ***
Dealt to PlayTheBlues4U [Kd 2d]
Gould Rush said, "lol"
Smuggler1991: folds
Cake_Horn_14: folds
DemolishIT: folds
PlayTheBlues4U: raises $0.10 to $0.15
skillzplumber: calls $0.13
Gould Rush: calls $0.10
*** FLOP *** [Kh As Qc]
skillzplumber: checks
Gould Rush: checks
PlayTheBlues4U: bets $0.20
skillzplumber: folds
Gould Rush: calls $0.20
*** TURN *** [Kh As Qc] [Qs]
Gould Rush: checks
PlayTheBlues4U: checks
*** RIVER *** [Kh As Qc Qs] [4h]
Gould Rush: bets $0.80
PlayTheBlues4U: folds
Uncalled bet ($0.80) returned to Gould Rush
Gould Rush collected $0.81 from pot
Gould Rush: doesn't show hand
*** SUMMARY ***
Total pot $0.85 | Rake $0.04
Board [Kh As Qc Qs 4h]
Seat 1: skillzplumber (small blind) folded on the Flop
Seat 2: Gould Rush (big blind) collected ($0.81)
Seat 3: Smuggler1991 folded before Flop (didn't bet)
Seat 4: Cake_Horn_14 folded before Flop (didn't bet)
Seat 5: DemolishIT folded before Flop (didn't bet)
Seat 6: PlayTheBlues4U (button) folded on the River


PokerStars Hand #204206678049:  Hold'em No Limit ($0.05/$0.10 USD) - 2019/10/03 22:41:19 ET
Table 'Sculptor' 6-max Seat #6 is the button
Seat 2: Mo8791 ($6.64 in chips)
Seat 3: PlayTheBlues4U ($9.40 in chips)
Seat 4: Gould Rush ($13.47 in chips)
Seat 6: Smuggler1991 ($8.10 in chips)
Mo8791: posts small blind $0.05
PlayTheBlues4U: posts big blind $0.10
*** HOLE CARDS ***
Dealt to PlayTheBlues4U [2d Qc]
Gould Rush: raises $0.20 to $0.30
Smuggler1991: folds
Mo8791: folds
PlayTheBlues4U: folds
Uncalled bet ($0.20) returned to Gould Rush
Gould Rush collected $0.25 from pot
Gould Rush: doesn't show hand
*** SUMMARY ***
Total pot $0.25 | Rake $0
Seat 2: Mo8791 (small blind) folded before Flop
Seat 3: PlayTheBlues4U (big blind) folded before Flop
Seat 4: Gould Rush collected ($0.25)
Seat 6: Smuggler1991 (button) folded before Flop (didn't bet)


PokerStars Hand #204206677930:  Hold'em No Limit ($0.02/$0.05 USD) - 2019/10/03 22:40:38 ET
Table 'Phoenix' 6-max Seat #5 is the button
Seat 1: skillzplumber ($4.11 in chips)
Seat 2: Gould Rush ($5.35 in chips)
Seat 3: Smuggler1991 ($3.49 in chips)
Seat 4: Cake_Horn_14 ($5.48 in chips)
Seat 5: DemolishIT ($4.12 in chips)
Seat 6: PlayTheBlues4U ($5.23 in chips)
PlayTheBlues4U: posts small blind $0.02
skillzplumber: posts big blind $0.05
*** HOLE CARDS ***
Dealt to PlayTheBlues4U [9s Ad]
Gould Rush: raises $0.10 to $0.15
Smuggler1991: calls $0.15
Cake_Horn_14: folds
DemolishIT: folds
PlayTheBlues4U: folds
skillzplumber: folds
*** FLOP *** [Qd 6s 6d]
Gould Rush: checks
Smuggler1991: checks
*** TURN *** [Qd 6s 6d] [8s]
Gould Rush: checks
Smuggler1991: bets $0.20
Gould Rush: calls $0.20
*** RIVER *** [Qd 6s 6d 8s] [8c]
Gould Rush: checks
Smuggler1991: checks
*** SHOW DOWN ***
Gould Rush: shows [4h 4s] (two pair, Eights and Sixes)
Smuggler1991: shows [As 4d] (two pair, Eights and Sixes - Ace kicker)
Smuggler1991 collected $0.73 from pot
*** SUMMARY ***
Total pot $0.77 | Rake $0.04
Board [Qd 6s 6d 8s 8c]
Seat 1: skillzplumber (big blind) folded before Flop
Seat 2: Gould Rush showed [4h 4s] and lost with two pair, Eights and Sixes
Seat 3: Smuggler1991 showed [As 4d] and won ($0.73) with two pair, Eights and Sixes
Seat 4: Cake_Horn_14 folded before Flop (didn't bet)
Seat 5: DemolishIT (button) folded before Flop (didn't bet)
Seat 6: PlayTheBlues4U (small blind) folded before Flop


PokerStars Hand #204206677902:  Hold'em No Limit ($0.05/$0.10 USD) - 2019/10/03 22:40:25 ET
Table 'Sculptor' 6-max Seat #4 is the button
Seat 2: Mo8791 ($6.05 in chips)
Seat 3: PlayTheBlues4U ($10 in chips)
Seat 4: Gould Rush ($13.47 in chips)
Seat 6: Smuggler1991 ($8.15 in chips)
Smuggler1991: posts small blind $0.05
Mo8791: posts big blind $0.10
*** HOLE CARDS ***
Dealt to PlayTheBlues4U [Js Qc]
PlayTheBlues4U: raises $0.20 to $0.30
Gould Rush: folds
Smuggler1991: folds
Mo8791: calls $0.20
*** FLOP *** [6c 6d 4h]
Mo8791: checks
PlayTheBlues4U: checks
*** TURN *** [6c 6d 4h] [Ad]
Mo8791: checks
PlayTheBlues4U: bets $0.30
Mo8791: calls $0.30
*** RIVER *** [6c 6d 4h Ad] [4s]
Mo8791: checks
PlayTheBlues4U: checks
*** SHOW DOWN ***
Mo8791: shows [8s Ac] (two pair, Aces and Sixes)
PlayTheBlues4U: mucks hand
Mo8791 collected $1.19 from pot
*** SUMMARY ***
Total pot $1.25 | Rake $0.06
Board [6c 6d 4h Ad 4s]
Seat 2: Mo8791 (big blind) showed [8s Ac] and won ($1.19) with two pair, Aces and Sixes
Seat 3: PlayTheBlues4U mucked [Js Qc]
Seat 4: Gould Rush (button) folded before Flop (didn't bet)
Seat 6: Smuggler1991 (small blind) folded before Flop


PokerStars Hand #204206677842:  Hold'em No Limit ($0.02/$0.05 USD) - 2019/10/03 22:40:05 ET
Table 'Phoenix' 6-max Seat #4 is the button
Seat 1: skillzplumber ($4.04 in chips)
Seat 2: Gould Rush ($5.35 in chips)
Seat 3: Smuggler1991 ($3.49 in chips)
Seat 4: Cake_Horn_14 ($5.48 in chips)
Seat 5: DemolishIT ($4.14 in chips)
Seat 6: PlayTheBlues4U ($5.28 in chips)
DemolishIT: posts small blind $0.02
PlayTheBlues4U: posts big blind $0.05
*** HOLE CARDS ***
Dealt to PlayTheBlues4U [Kh 9c]
skillzplumber: raises $0.15 to $0.20
Gould Rush: folds
Smuggler1991: folds
Cake_Horn_14: folds
DemolishIT: folds
PlayTheBlues4U: folds
Uncalled bet ($0.15) returned to skillzplumber
skillzplumber collected $0.12 from pot
skillzplumber: doesn't show hand
*** SUMMARY ***
Total pot $0.12 | Rake $0
Seat 1: skillzplumber collected ($0.12)
Seat 2: Gould Rush folded before Flop (didn't bet)
Seat 3: Smuggler1991 folded before Flop (didn't bet)
Seat 4: Cake_Horn_14 (button) folded before Flop (didn't bet)
Seat 5: DemolishIT (small blind) folded before Flop
Seat 6: PlayTheBlues4U (big blind) folded before Flop


PokerStars Hand #204206677796:  Hold'em No Limit ($0.02/$0.05 USD) - 2019/10/03 22:39:50 ET
Table 'Phoenix' 6-max Seat #3 is the button
Seat 1: skillzplumber ($4.04 in chips)
Seat 2: Gould Rush ($5.28 in chips)
Seat 3: Smuggler1991 ($3.49 in chips)
Seat 4: Cake_Horn_14 ($5.50 in chips)
Seat 5: DemolishIT ($4.19 in chips)
Seat 6: PlayTheBlues4U ($5.28 in chips)
Cake_Horn_14: posts small blind $0.02
DemolishIT: posts big blind $0.05
*** HOLE CARDS ***
Dealt to PlayTheBlues4U [Js 5h]
PlayTheBlues4U: folds
skillzplumber: folds
Gould Rush: raises $0.10 to $0.15
Smuggler1991: folds
Cake_Horn_14: folds
DemolishIT: folds
Uncalled bet ($0.10) returned to Gould Rush
Gould Rush collected $0.12 from pot
Gould Rush: doesn't show hand
*** SUMMARY ***
Total pot $0.12 | Rake $0
Seat 1: skillzplumber folded before Flop (didn't bet)
Seat 2: Gould Rush collected ($0.12)
Seat 3: Smuggler1991 (button) folded before Flop (didn't bet)
Seat 4: Cake_Horn_14 (small blind) folded before Flop
Seat 5: DemolishIT (big blind) folded before Flop
Seat 6: PlayTheBlues4U folded before Flop (didn't bet)


PokerStars Hand #204206677732:  Hold'em No Limit ($0.05/$0.10 USD) - 2019/10/03 22:39:27 ET
Table 'Sculptor' 6-max Seat #3 is the button
Seat 2: Mo8791 ($6.05 in chips)
Seat 3: PlayTheBlues4U ($7.46 in chips)
Seat 4: Gould Rush ($15.07 in chips)
Seat 6: Smuggler1991 ($8.25 in chips)
Gould Rush: posts small blind $0.05
Smuggler1991: posts big blind $0.10
*** HOLE CARDS ***
Dealt to PlayTheBlues4U [Ad Jc]
Mo8791: folds
PlayTheBlues4U: raises $0.20 to $0.30
Gould Rush: calls $0.25
Smuggler1991: folds
*** FLOP *** [4h Js 9c]
Gould Rush: checks
PlayTheBlues4U: bets $0.40
Gould Rush: calls $0.40
*** TURN *** [4h Js 9c] [3d]
Gould Rush: checks
PlayTheBlues4U: checks
*** RIVER *** [4h Js 9c 3d] [Ts]
Gould Rush: checks
PlayTheBlues4U: bets $0.90
Gould Rush: calls $0.90
*** SHOW DOWN ***
PlayTheBlues4U: shows [Ad Jc] (a pair of Jacks)
Gould Rush: mucks hand
PlayTheBlues4U collected $3.14 from pot
*** SUMMARY ***
Total pot $3.30 | Rake $0.16
Board [4h Js 9c 3d Ts]
Seat 2: Mo8791 folded before Flop (didn't bet)
Seat 3: PlayTheBlues4U (button) showed [Ad Jc] and won ($3.14) with a pair of Jacks
Seat 4: Gould Rush (small blind) mucked [7s 7c]
Seat 6: Smuggler1991 (big blind) folded before Flop


PokerStars Hand #204206677677:  Hold'em No Limit ($0.02/$0.05 USD) - 2019/10/03 22:39:08 ET
Table 'Phoenix' 6-max Seat #2 is the button
Seat 1: skillzplumber ($4.04 in chips)
Seat 2: Gould Rush ($5.13 in chips)
Seat 3: Smuggler1991 ($3.51 in chips)
Seat 4: Cake_Horn_14 ($5.65 in chips)
Seat 5: DemolishIT ($4.19 in chips)
Seat 6: PlayTheBlues4U ($5.28 in chips)
Smuggler1991: posts small blind $0.02
Cake_Horn_14: posts big blind $0.05
*** HOLE CARDS ***
Dealt to PlayTheBlues4U [Jh 9s]
DemolishIT: folds
PlayTheBlues4U: folds
skillzplumber: folds
Gould Rush: raises $0.10 to $0.15
Smuggler1991: folds
Cake_Horn_14: calls $0.10
*** FLOP *** [7s 6s 2d]
Cake_Horn_14: checks
Gould Rush: bets $0.30
Cake_Horn_14: folds
Uncalled bet ($0.30) returned to Gould Rush
Gould Rush collected $0.30 from pot
Gould Rush: doesn't show hand
*** SUMMARY ***
Total pot $0.32 | Rake $0.02
Board [7s 6s 2d]
Seat 1: skillzplumber folded before Flop (didn't bet)
Seat 2: Gould Rush (button) collected ($0.30)
Seat 3: Smuggler1991 (small blind) folded before Flop
Seat 4: Cake_Horn_14 (big blind) folded on the Flop
Seat 5: DemolishIT folded before Flop (didn't bet)
Seat 6: PlayTheBlues4U folded before Flop (didn't bet)


PokerStars Hand #204206677582:  Hold'em No Limit ($0.05/$0.10 USD) - 2019/10/03 22:38:35 ET
Table 'Sculptor' 6-max Seat #2 is the button
Seat 2: Mo8791 ($7.90 in chips)
Seat 3: PlayTheBlues4U ($7.81 in chips)
Seat 4: Gould Rush ($15.17 in chips)
Seat 6: Smuggler1991 ($6.16 in chips)
PlayTheBlues4U: posts small blind $0.05
Gould Rush: posts big blind $0.10
*** HOLE CARDS ***
Dealt to PlayTheBlues4U [Ad 7h]
Smuggler1991: raises $0.25 to $0.35
Mo8791: calls $0.35
PlayTheBlues4U: calls $0.30
Gould Rush: folds
*** FLOP *** [3h 6c Ks]
PlayTheBlues4U: checks
Smuggler1991: bets $0.50
Mo8791: calls $0.50
PlayTheBlues4U: folds
*** TURN *** [3h 6c Ks] [8h]
Smuggler1991: checks
Mo8791: checks
*** RIVER *** [3h 6c Ks 8h] [3d]
Smuggler1991: bets $1
Mo8791: calls $1
*** SHOW DOWN ***
Smuggler1991: shows [3c As] (three of a kind, Threes)
Mo8791: mucks hand
Smuggler1991 collected $3.94 from pot
*** SUMMARY ***
Total pot $4.15 | Rake $0.21
Board [3h 6c Ks 8h 3d]
Seat 2: Mo8791 (button) mucked [Js Kd]
Seat 3: PlayTheBlues4U (small blind) folded on the Flop
Seat 4: Gould Rush (big blind) folded before Flop
Seat 6: Smuggler1991 showed [3c As] and won ($3.94) with three of a kind, Threes


PokerStars Hand #204206677560:  Hold'em No Limit ($0.02/$0.05 USD) - 2019/10/03 22:38:29 ET
Table 'Phoenix' 6-max Seat #1 is the button
Seat 1: skillzplumber ($4.04 in chips)
Seat 2: Gould Rush ($5.40 in chips)
Seat 3: Smuggler1991 ($3.15 in chips)
Seat 4: Cake_Horn_14 ($5.77 in chips)
Seat 5: DemolishIT ($4.19 in chips)
Seat 6: PlayTheBlues4U ($5.28 in chips)
Gould Rush: posts small blind $0.02
Smuggler1991: posts big blind $0.05
*** HOLE CARDS ***
Dealt to PlayTheBlues4U [Tc 6c]
Cake_Horn_14: raises $0.07 to $0.12
DemolishIT: folds
PlayTheBlues4U: folds
skillzplumber: folds
Gould Rush: calls $0.10
Smuggler1991: calls $0.07
*** FLOP *** [2s Jd Ac]
Gould Rush: checks
Smuggler1991: bets $0.15
Cake_Horn_14: folds
Gould Rush: calls $0.15
*** TURN *** [2s Jd Ac] [4c]
Gould Rush: checks
Smuggler1991: bets $0.30
Gould Rush: folds
Uncalled bet ($0.30) returned to Smuggler1991
Smuggler1991 collected $0.63 from pot
Smuggler1991: doesn't show hand
*** SUMMARY ***
Total pot $0.66 | Rake $0.03
Board [2s Jd Ac 4c]
Seat 1: skillzplumber (button) folded before Flop (didn't bet)
Seat 2: Gould Rush (small blind) folded on the Turn
Seat 3: Smuggler1991 (big blind) collected ($0.63)
Seat 4: Cake_Horn_14 folded on the Flop
Seat 5: DemolishIT folded before Flop (didn't bet)
Seat 6: PlayTheBlues4U folded before Flop (didn't bet)


PokerStars Hand #204206677548:  Hold'em No Limit ($0.05/$0.10 USD) - 2019/10/03 22:38:26 ET
Table 'Sculptor' 6-max Seat #6 is the button
Seat 2: Mo8791 ($7.95 in chips)
Seat 3: PlayTheBlues4U ($7.76 in chips)
Seat 4: Gould Rush ($15.17 in chips)
Seat 6: Smuggler1991 ($6.16 in chips)
Mo8791: posts small blind $0.05
PlayTheBlues4U: posts big blind $0.10
*** HOLE CARDS ***
Dealt to PlayTheBlues4U [4d 4s]
Gould Rush: folds
Smuggler1991: folds
Mo8791: folds
Uncalled bet ($0.05) returned to PlayTheBlues4U
PlayTheBlues4U collected $0.10 from pot
PlayTheBlues4U: doesn't show hand
*** SUMMARY ***
Total pot $0.10 | Rake $0
Seat 2: Mo8791 (small blind) folded before Flop
Seat 3: PlayTheBlues4U (big blind) collected ($0.10)
Seat 4: Gould Rush folded before Flop (didn't bet)
Seat 6: Smuggler1991 (button) folded before Flop (didn't bet)


PokerStars Hand #204206677524:  Hold'em No Limit ($0.05/$0.10 USD) - 2019/10/03 22:38:17 ET
Table 'Sculptor' 6-max Seat #4 is the button
Seat 2: Mo8791 ($7.90 in chips)
Seat 3: PlayTheBlues4U ($7.76 in chips)
Seat 4: Gould Rush ($15.17 in chips)
Seat 6: Smuggler1991 ($6.21 in chips)
Smuggler1991: posts small blind $0.05
Mo8791: posts big blind $0.10
*** HOLE CARDS ***
Dealt to PlayTheBlues4U [Kd 7c]
PlayTheBlues4U: folds
Gould Rush: folds
Smuggler1991: folds
Uncalled bet ($0.05) returned to Mo8791
Mo8791 collected $0.10 from pot
Mo8791: doesn't show hand
*** SUMMARY ***
Total pot $0.10 | Rake $0
Seat 2: Mo8791 (big blind) collected ($0.10)
Seat 3: PlayTheBlues4U folded before Flop (didn't bet)
Seat 4: Gould Rush (button) folded before Flop (didn't bet)
Seat 6: Smuggler1991 (small blind) folded before Flop


PokerStars Hand #204206677481:  Hold'em No Limit ($0.02/$0.05 USD) - 2019/10/03 22:38:00 ET
Table 'Phoenix' 6-max Seat #6 is the button
Seat 1: skillzplumber ($4.06 in chips)
Seat 2: Gould Rush ($5.55 in chips)
Seat 3: Smuggler1991 ($3.15 in chips)
Seat 4: Cake_Horn_14 ($5.77 in chips)
Seat 5: DemolishIT ($4.19 in chips)
Seat 6: PlayTheBlues4U ($5.13 in chips)
skillzplumber: posts small blind $0.02
Gould Rush: posts big blind $0.05
*** HOLE CARDS ***
Dealt to PlayTheBlues4U [4d 8c]
Smuggler1991: folds
Cake_Horn_14: folds
DemolishIT: folds
PlayTheBlues4U: raises $0.10 to $0.15
skillzplumber: folds
Gould Rush: calls $0.10
*** FLOP *** [6s Ks Td]
Gould Rush: checks
PlayTheBlues4U: bets $0.15
Gould Rush: folds
Uncalled bet ($0.15) returned to PlayTheBlues4U
PlayTheBlues4U collected $0.30 from pot
PlayTheBlues4U: doesn't show hand
*** SUMMARY ***
Total pot $0.32 | Rake $0.02
Board [6s Ks Td]
Seat 1: skillzplumber (small blind) folded before Flop
Seat 2: Gould Rush (big blind) folded on the Flop
Seat 3: Smuggler1991 folded before Flop (didn't bet)
Seat 4: Cake_Horn_14 folded before Flop (didn't bet)
Seat 5: DemolishIT folded before Flop (didn't bet)
Seat 6: PlayTheBlues4U (button) collected ($0.30)


PokerStars Hand #204206677479:  Hold'em No Limit ($0.05/$0.10 USD) - 2019/10/03 22:38:00 ET
Table 'Sculptor' 6-max Seat #3 is the button
Seat 2: Mo8791 ($8 in chips)
Seat 3: PlayTheBlues4U ($7.76 in chips)
Seat 4: Gould Rush ($14.97 in chips)
Seat 6: Smuggler1991 ($6.31 in chips)
Gould Rush: posts small blind $0.05
Smuggler1991: posts big blind $0.10
Mo8791: posts big blind $0.10
*** HOLE CARDS ***
Dealt to PlayTheBlues4U [9h 4h]
Mo8791: checks
PlayTheBlues4U: folds
Gould Rush: raises $0.40 to $0.50
Smuggler1991: folds
Mo8791: folds
Uncalled bet ($0.40) returned to Gould Rush
Gould Rush collected $0.30 from pot
Gould Rush: doesn't show hand
*** SUMMARY ***
Total pot $0.30 | Rake $0
Seat 2: Mo8791 folded before Flop (didn't bet)
Seat 3: PlayTheBlues4U (button) folded before Flop (didn't bet)
Seat 4: Gould Rush (small blind) collected ($0.30)
Seat 6: Smuggler1991 (big blind) folded before Flop


PokerStars Hand #204206677437:  Hold'em No Limit ($0.02/$0.05 USD) - 2019/10/03 22:37:46 ET
Table 'Phoenix' 6-max Seat #5 is the button
Seat 1: skillzplumber ($4.11 in chips)
Seat 2: Gould Rush ($5.55 in chips)
Seat 3: Smuggler1991 ($3.08 in chips)
Seat 4: Cake_Horn_14 ($5.77 in chips)
Seat 5: DemolishIT ($4.19 in chips)
Seat 6: PlayTheBlues4U ($5.15 in chips)
PlayTheBlues4U: posts small blind $0.02
skillzplumber: posts big blind $0.05
*** HOLE CARDS ***
Dealt to PlayTheBlues4U [4c Th]
Gould Rush: folds
Smuggler1991: raises $0.12 to $0.17
Cake_Horn_14: folds
DemolishIT: folds
PlayTheBlues4U: folds
skillzplumber: folds
Uncalled bet ($0.12) returned to Smuggler1991
Smuggler1991 collected $0.12 from pot
Smuggler1991: doesn't show hand
*** SUMMARY ***
Total pot $0.12 | Rake $0
Seat 1: skillzplumber (big blind) folded before Flop
Seat 2: Gould Rush folded before Flop (didn't bet)
Seat 3: Smuggler1991 collected ($0.12)
Seat 4: Cake_Horn_14 folded before Flop (didn't bet)
Seat 5: DemolishIT (button) folded before Flop (didn't bet)
Seat 6: PlayTheBlues4U (small blind) folded before Flop


PokerStars Hand #204206677304:  Hold'em No Limit ($0.05/$0.10 USD) - 2019/10/03 22:37:00 ET
Table 'Sculptor' 6-max Seat #6 is the button
Seat 3: PlayTheBlues4U ($7.22 in chips)
Seat 4: Gould Rush ($15.57 in chips)
Seat 6: Smuggler1991 ($6.31 in chips)
PlayTheBlues4U: posts small blind $0.05
Gould Rush: posts big blind $0.10
*** HOLE CARDS ***
Dealt to PlayTheBlues4U [8c Th]
Smuggler1991: folds
PlayTheBlues4U: calls $0.05
Gould Rush: raises $0.20 to $0.30
Mo8791 joins the table at seat #2
PlayTheBlues4U: calls $0.20
*** FLOP *** [Qc 9h Kd]
PlayTheBlues4U: checks
Gould Rush: bets $0.30
PlayTheBlues4U: calls $0.30
*** TURN *** [Qc 9h Kd] [2s]
PlayTheBlues4U: checks
Gould Rush: checks
*** RIVER *** [Qc 9h Kd 2s] [Jh]
PlayTheBlues4U: bets $1.10
Gould Rush: folds
Uncalled bet ($1.10) returned to PlayTheBlues4U
PlayTheBlues4U collected $1.14 from pot
PlayTheBlues4U: doesn't show hand
*** SUMMARY ***
Total pot $1.20 | Rake $0.06
Board [Qc 9h Kd 2s Jh]
Seat 3: PlayTheBlues4U (small blind) collected ($1.14)
Seat 4: Gould Rush (big blind) folded on the River
Seat 6: Smuggler1991 (button) folded before Flop (didn't bet)


PokerStars Hand #204206677303:  Hold'em No Limit ($0.02/$0.05 USD) - 2019/10/03 22:37:00 ET
Table 'Phoenix' 6-max Seat #4 is the button
Seat 1: skillzplumber ($4.11 in chips)
Seat 2: Gould Rush ($5.55 in chips)
Seat 3: Smuggler1991 ($3.08 in chips)
Seat 4: Cake_Horn_14 ($5.61 in chips)
Seat 5: DemolishIT ($4.31 in chips)
Seat 6: PlayTheBlues4U ($5.20 in chips)
DemolishIT: posts small blind $0.02
PlayTheBlues4U: posts big blind $0.05
*** HOLE CARDS ***
Dealt to PlayTheBlues4U [4d 8c]
skillzplumber: folds
Gould Rush: folds
Smuggler1991: folds
Cake_Horn_14: raises $0.07 to $0.12
DemolishIT: calls $0.10
PlayTheBlues4U: folds
*** FLOP *** [3s 7d Js]
DemolishIT: checks
Cake_Horn_14: checks
*** TURN *** [3s 7d Js] [Kd]
DemolishIT: checks
Cake_Horn_14: bets $0.19
DemolishIT: folds
Uncalled bet ($0.19) returned to Cake_Horn_14
Cake_Horn_14 collected $0.28 from pot
Cake_Horn_14: doesn't show hand
*** SUMMARY ***
Total pot $0.29 | Rake $0.01
Board [3s 7d Js Kd]
Seat 1: skillzplumber folded before Flop (didn't bet)
Seat 2: Gould Rush folded before Flop (didn't bet)
Seat 3: Smuggler1991 folded before Flop (didn't bet)
Seat 4: Cake_Horn_14 (button) collected ($0.28)
Seat 5: DemolishIT (small blind) folded on the Turn
Seat 6: PlayTheBlues4U (big blind) folded before Flop


PokerStars Hand #204206677277:  Hold'em No Limit ($0.05/$0.10 USD) - 2019/10/03 22:36:50 ET
Table 'Sculptor' 6-max Seat #4 is the button
Seat 3: PlayTheBlues4U ($7.17 in chips)
Seat 4: Gould Rush ($15.57 in chips)
Seat 6: Smuggler1991 ($6.36 in chips)
Smuggler1991: posts small blind $0.05
PlayTheBlues4U: posts big blind $0.10
*** HOLE CARDS ***
Dealt to PlayTheBlues4U [2s 4d]
Gould Rush: folds
Smuggler1991: folds
Uncalled bet ($0.05) returned to PlayTheBlues4U
PlayTheBlues4U collected $0.10 from pot
PlayTheBlues4U: doesn't show hand
*** SUMMARY ***
Total pot $0.10 | Rake $0
Seat 3: PlayTheBlues4U (big blind) collected ($0.10)
Seat 4: Gould Rush (button) folded before Flop (didn't bet)
Seat 6: Smuggler1991 (small blind) folded before Flop


PokerStars Hand #204206677115:  Hold'em No Limit ($0.02/$0.05 USD) - 2019/10/03 22:35:54 ET
Table 'Phoenix' 6-max Seat #3 is the button
Seat 1: skillzplumber ($4.71 in chips)
Seat 2: Gould Rush ($4.94 in chips)
Seat 3: Smuggler1991 ($3.08 in chips)
Seat 4: Cake_Horn_14 ($5.63 in chips)
Seat 5: DemolishIT ($4.36 in chips)
Seat 6: PlayTheBlues4U ($5.20 in chips)
Cake_Horn_14: posts small blind $0.02
DemolishIT: posts big blind $0.05
*** HOLE CARDS ***
Dealt to PlayTheBlues4U [4h Jc]
PlayTheBlues4U: folds
skillzplumber: raises $0.15 to $0.20
Gould Rush: raises $0.40 to $0.60
Smuggler1991: folds
Cake_Horn_14: folds
DemolishIT: folds
skillzplumber: calls $0.40
*** FLOP *** [2c 9s 6c]
skillzplumber: checks
Gould Rush: bets $0.75
skillzplumber: folds
Uncalled bet ($0.75) returned to Gould Rush
Gould Rush collected $1.21 from pot
Gould Rush: doesn't show hand
*** SUMMARY ***
Total pot $1.27 | Rake $0.06
Board [2c 9s 6c]
Seat 1: skillzplumber folded on the Flop
Seat 2: Gould Rush collected ($1.21)
Seat 3: Smuggler1991 (button) folded before Flop (didn't bet)
Seat 4: Cake_Horn_14 (small blind) folded before Flop
Seat 5: DemolishIT (big blind) folded before Flop
Seat 6: PlayTheBlues4U folded before Flop (didn't bet)


PokerStars Hand #204206677071:  Hold'em No Limit ($0.05/$0.10 USD) - 2019/10/03 22:35:40 ET
Table 'Sculptor' 6-max Seat #3 is the button
Seat 3: PlayTheBlues4U ($10.22 in chips)
Seat 4: Gould Rush ($12.73 in chips)
Seat 6: Smuggler1991 ($6.46 in chips)
Gould Rush: posts small blind $0.05
Smuggler1991: posts big blind $0.10
*** HOLE CARDS ***
Dealt to PlayTheBlues4U [9s 6d]
PlayTheBlues4U: raises $0.15 to $0.25
Gould Rush: calls $0.20
Smuggler1991: folds
*** FLOP *** [4c Qs Qh]
Gould Rush: checks
PlayTheBlues4U: checks
*** TURN *** [4c Qs Qh] [7s]
Gould Rush: bets $0.30
PlayTheBlues4U: calls $0.30
*** RIVER *** [4c Qs Qh 7s] [3s]
Gould Rush: bets $1.10
PlayTheBlues4U: raises $1.40 to $2.50
Gould Rush: raises $9.68 to $12.18 and is all-in
PlayTheBlues4U: folds
Uncalled bet ($9.68) returned to Gould Rush
Gould Rush collected $5.89 from pot
Gould Rush: doesn't show hand
*** SUMMARY ***
Total pot $6.20 | Rake $0.31
Board [4c Qs Qh 7s 3s]
Seat 3: PlayTheBlues4U (button) folded on the River
Seat 4: Gould Rush (small blind) collected ($5.89)
Seat 6: Smuggler1991 (big blind) folded before Flop


PokerStars Hand #204206677012:  Hold'em No Limit ($0.02/$0.05 USD) - 2019/10/03 22:35:25 ET
Table 'Phoenix' 6-max Seat #2 is the button
Seat 1: skillzplumber ($4.71 in chips)
Seat 2: Gould Rush ($4.76 in chips)
Seat 3: Smuggler1991 ($3.23 in chips)
Seat 4: Cake_Horn_14 ($5.68 in chips)
Seat 5: DemolishIT ($4.36 in chips)
Seat 6: PlayTheBlues4U ($5.20 in chips)
Smuggler1991: posts small blind $0.02
Cake_Horn_14: posts big blind $0.05
*** HOLE CARDS ***
Dealt to PlayTheBlues4U [5h 8d]
DemolishIT: folds
PlayTheBlues4U: folds
skillzplumber: folds
Gould Rush: raises $0.10 to $0.15
Smuggler1991: calls $0.13
Cake_Horn_14: folds
*** FLOP *** [6h Qh 4s]
Smuggler1991: checks
Gould Rush: bets $0.20
Smuggler1991: folds
Uncalled bet ($0.20) returned to Gould Rush
Gould Rush collected $0.33 from pot
Gould Rush: doesn't show hand
*** SUMMARY ***
Total pot $0.35 | Rake $0.02
Board [6h Qh 4s]
Seat 1: skillzplumber folded before Flop (didn't bet)
Seat 2: Gould Rush (button) collected ($0.33)
Seat 3: Smuggler1991 (small blind) folded on the Flop
Seat 4: Cake_Horn_14 (big blind) folded before Flop
Seat 5: DemolishIT folded before Flop (didn't bet)
Seat 6: PlayTheBlues4U folded before Flop (didn't bet)


PokerStars Hand #204206677000:  Hold'em No Limit ($0.05/$0.10 USD) - 2019/10/03 22:35:20 ET
Table 'Sculptor' 6-max Seat #6 is the button
Seat 3: PlayTheBlues4U ($10.27 in chips)
Seat 4: Gould Rush ($13.08 in chips)
Seat 6: Smuggler1991 ($6.10 in chips)
PlayTheBlues4U: posts small blind $0.05
Gould Rush: posts big blind $0.10
*** HOLE CARDS ***
Dealt to PlayTheBlues4U [5d Tc]
Smuggler1991: raises $0.25 to $0.35
PlayTheBlues4U: folds
Gould Rush: calls $0.25
*** FLOP *** [Qs Js 8h]
Gould Rush: checks
Smuggler1991: bets $0.40
Gould Rush: folds
Uncalled bet ($0.40) returned to Smuggler1991
Smuggler1991 collected $0.71 from pot
Smuggler1991: doesn't show hand
*** SUMMARY ***
Total pot $0.75 | Rake $0.04
Board [Qs Js 8h]
Seat 3: PlayTheBlues4U (small blind) folded before Flop
Seat 4: Gould Rush (big blind) folded on the Flop
Seat 6: Smuggler1991 (button) collected ($0.71)


PokerStars Hand #204206676929:  Hold'em No Limit ($0.05/$0.10 USD) - 2019/10/03 22:34:59 ET
Table 'Sculptor' 6-max Seat #4 is the button
Seat 3: PlayTheBlues4U ($10 in chips)
Seat 4: Gould Rush ($13.08 in chips)
Seat 6: Smuggler1991 ($6.40 in chips)
Smuggler1991: posts small blind $0.05
PlayTheBlues4U: posts big blind $0.10
*** HOLE CARDS ***
Dealt to PlayTheBlues4U [7c Td]
Gould Rush: folds
Smuggler1991: raises $0.20 to $0.30
PlayTheBlues4U: calls $0.20
*** FLOP *** [Ts Ah 3h]
Smuggler1991: checks
PlayTheBlues4U: bets $0.30
Smuggler1991: folds
Uncalled bet ($0.30) returned to PlayTheBlues4U
PlayTheBlues4U collected $0.57 from pot
PlayTheBlues4U: doesn't show hand
*** SUMMARY ***
Total pot $0.60 | Rake $0.03
Board [Ts Ah 3h]
Seat 3: PlayTheBlues4U (big blind) collected ($0.57)
Seat 4: Gould Rush (button) folded before Flop (didn't bet)
Seat 6: Smuggler1991 (small blind) folded on the Flop


PokerStars Hand #204206676865:  Hold'em No Limit ($0.05/$0.10 USD) - 2019/10/03 22:34:41 ET
Table 'Sculptor' 6-max Seat #3 is the button
Seat 3: PlayTheBlues4U ($8.15 in chips)
Seat 4: Gould Rush ($12.81 in chips)
Seat 6: Smuggler1991 ($6.70 in chips)
Gould Rush: posts small blind $0.05
Smuggler1991: posts big blind $0.10
*** HOLE CARDS ***
Dealt to PlayTheBlues4U [3h Qd]
PlayTheBlues4U: folds
Gould Rush: raises $0.20 to $0.30
Smuggler1991: calls $0.20
*** FLOP *** [Kd 7s 3d]
Gould Rush: bets $0.30
Smuggler1991: folds
Uncalled bet ($0.30) returned to Gould Rush
Gould Rush collected $0.57 from pot
Gould Rush: doesn't show hand
*** SUMMARY ***
Total pot $0.60 | Rake $0.03
Board [Kd 7s 3d]
Seat 3: PlayTheBlues4U (button) folded before Flop (didn't bet)
Seat 4: Gould Rush (small blind) collected ($0.57)
Seat 6: Smuggler1991 (big blind) folded on the Flop


PokerStars Hand #204206676812:  Hold'em No Limit ($0.02/$0.05 USD) - 2019/10/03 22:34:27 ET
Table 'Phoenix' 6-max Seat #1 is the button
Seat 1: skillzplumber ($4.71 in chips)
Seat 2: Gould Rush ($4.78 in chips)
Seat 3: Smuggler1991 ($3.96 in chips)
Seat 4: Cake_Horn_14 ($5 in chips)
Seat 5: DemolishIT ($4.36 in chips)
Seat 6: PlayTheBlues4U ($5.20 in chips)
Gould Rush: posts small blind $0.02
Smuggler1991: posts big blind $0.05
*** HOLE CARDS ***
Dealt to PlayTheBlues4U [4h 3s]
Cake_Horn_14: raises $0.07 to $0.12
DemolishIT: folds
PlayTheBlues4U: folds
skillzplumber: folds
Gould Rush: folds
Smuggler1991: raises $0.26 to $0.38
Cake_Horn_14: calls $0.26
*** FLOP *** [5c 8c Ts]
Smuggler1991: bets $0.35
Cake_Horn_14: raises $0.95 to $1.30
Smuggler1991: folds
Uncalled bet ($0.95) returned to Cake_Horn_14
Cake_Horn_14 collected $1.41 from pot
Cake_Horn_14: doesn't show hand
*** SUMMARY ***
Total pot $1.48 | Rake $0.07
Board [5c 8c Ts]
Seat 1: skillzplumber (button) folded before Flop (didn't bet)
Seat 2: Gould Rush (small blind) folded before Flop
Seat 3: Smuggler1991 (big blind) folded on the Flop
Seat 4: Cake_Horn_14 collected ($1.41)
Seat 5: DemolishIT folded before Flop (didn't bet)
Seat 6: PlayTheBlues4U folded before Flop (didn't bet)


PokerStars Hand #204206676769:  Hold'em No Limit ($0.05/$0.10 USD) - 2019/10/03 22:34:11 ET
Table 'Sculptor' 6-max Seat #6 is the button
Seat 3: PlayTheBlues4U ($8.95 in chips)
Seat 4: Gould Rush ($12.09 in chips)
Seat 6: Smuggler1991 ($6.70 in chips)
PlayTheBlues4U: posts small blind $0.05
Gould Rush: posts big blind $0.10
*** HOLE CARDS ***
Dealt to PlayTheBlues4U [4d 4s]
Smuggler1991: folds
PlayTheBlues4U: raises $0.10 to $0.20
Gould Rush: calls $0.10
*** FLOP *** [Jh 8c 7s]
PlayTheBlues4U: bets $0.20
Gould Rush: raises $0.40 to $0.60
PlayTheBlues4U: calls $0.40
*** TURN *** [Jh 8c 7s] [Kc]
PlayTheBlues4U: checks
Gould Rush: bets $1
PlayTheBlues4U: folds
Uncalled bet ($1) returned to Gould Rush
Gould Rush collected $1.52 from pot
Gould Rush: doesn't show hand
*** SUMMARY ***
Total pot $1.60 | Rake $0.08
Board [Jh 8c 7s Kc]
Seat 3: PlayTheBlues4U (small blind) folded on the Turn
Seat 4: Gould Rush (big blind) collected ($1.52)
Seat 6: Smuggler1991 (button) folded before Flop (didn't bet)


PokerStars Hand #204909678926: Hold'em No Limit ($0.05/$0.10 USD) - 2019/10/22 22:46:55 ET
Table 'Celuta' 6-max Seat #3 is the button
Seat 2: SeaofLove ($19.88 in chips) 
Seat 3: ng2414 ($13.67 in chips) 
Seat 4: Jahlah1 ($11.34 in chips) 
Seat 5: KeithTurbo48 ($15.66 in chips) 
Seat 6: PlayTheBlues4U ($8.62 in chips) 
Jahlah1: posts small blind $0.05
KeithTurbo48: posts big blind $0.10
*** HOLE CARDS ***
Dealt to PlayTheBlues4U [Th 6h]
PlayTheBlues4U: folds 
SeaofLove: folds 
ng2414: raises $0.20 to $0.30
Jahlah1: calls $0.25
KeithTurbo48: folds 
*** FLOP *** [9c Ac 6c]
Jahlah1: checks 
ng2414: checks 
*** TURN *** [9c Ac 6c] [Tc]
Jahlah1: checks 
ng2414: checks 
*** RIVER *** [9c Ac 6c Tc] [7d]
Jahlah1: checks 
ng2414: checks 
*** SHOW DOWN ***
Jahlah1: shows [4h 4c] (a flush, Ace high)
ng2414: mucks hand 
Jahlah1 collected $0.66 from pot
*** SUMMARY ***
Total pot $0.70 | Rake $0.04 
Board [9c Ac 6c Tc 7d]
Seat 2: SeaofLove folded before Flop (didn't bet)
Seat 3: ng2414 (button) mucked [Ah 8d]
Seat 4: Jahlah1 (small blind) showed [4h 4c] and won ($0.66) with a flush, Ace high
Seat 5: KeithTurbo48 (big blind) folded before Flop
Seat 6: PlayTheBlues4U folded before Flop (didn't bet)


PokerStars Hand #204909678803: Hold'em No Limit ($0.05/$0.10 USD) - 2019/10/22 22:46:27 ET
Table 'Celuta' 6-max Seat #2 is the button
Seat 2: SeaofLove ($19.88 in chips) 
Seat 3: ng2414 ($13.57 in chips) 
Seat 4: Jahlah1 ($11.44 in chips) 
Seat 5: KeithTurbo48 ($15.66 in chips) 
Seat 6: PlayTheBlues4U ($8.62 in chips) 
ng2414: posts small blind $0.05
Jahlah1: posts big blind $0.10
*** HOLE CARDS ***
Dealt to PlayTheBlues4U [Jd 2c]
KeithTurbo48: folds 
PlayTheBlues4U: folds 
SeaofLove: folds 
ng2414: raises $0.20 to $0.30
Jahlah1: folds 
Uncalled bet ($0.20) returned to ng2414
ng2414 collected $0.20 from pot
*** SUMMARY ***
Total pot $0.20 | Rake $0 
Seat 2: SeaofLove (button) folded before Flop (didn't bet)
Seat 3: ng2414 (small blind) collected ($0.20)
Seat 4: Jahlah1 (big blind) folded before Flop
Seat 5: KeithTurbo48 folded before Flop (didn't bet)
Seat 6: PlayTheBlues4U folded before Flop (didn't bet)


PokerStars Hand #204909678728: Hold'em No Limit ($0.05/$0.10 USD) - 2019/10/22 22:46:06 ET
Table 'Danae' 6-max Seat #2 is the button
Seat 1: zombiehedgehog ($15.53 in chips) 
Seat 2: SeaofLove ($12.97 in chips) 
Seat 3: KeithTurbo48 ($14.35 in chips) 
Seat 4: ng2414 ($24.28 in chips) 
Seat 5: PlayTheBlues4U ($9.70 in chips) 
Seat 6: Donkey1206 ($6.55 in chips) 
KeithTurbo48: posts small blind $0.05
ng2414: posts big blind $0.10
*** HOLE CARDS ***
Dealt to PlayTheBlues4U [6d 7c]
PlayTheBlues4U: folds 
Donkey1206: calls $0.10
zombiehedgehog: calls $0.10
SeaofLove: folds 
KeithTurbo48: calls $0.05
ng2414: checks 
*** FLOP *** [Ac Kh 3c]
KeithTurbo48: checks 
ng2414: checks 
Donkey1206: bets $0.40
zombiehedgehog: calls $0.40
KeithTurbo48: folds 
ng2414: folds 
*** TURN *** [Ac Kh 3c] [9d]
Donkey1206: bets $1.10
zombiehedgehog: calls $1.10
*** RIVER *** [Ac Kh 3c 9d] [5d]
Donkey1206: bets $1.10
zombiehedgehog: raises $5.43 to $6.53
Donkey1206: calls $3.85 and is all-in
Uncalled bet ($1.58) returned to zombiehedgehog
*** SHOW DOWN ***
zombiehedgehog: shows [9c 5c] (two pair, Nines and Fives)
Donkey1206: shows [Kc Tc] (a pair of Kings)
zombiehedgehog collected $12.64 from pot
*** SUMMARY ***
Total pot $13.30 | Rake $0.66 
Board [Ac Kh 3c 9d 5d]
Seat 1: zombiehedgehog showed [9c 5c] and won ($12.64) with two pair, Nines and Fives
Seat 2: SeaofLove (button) folded before Flop (didn't bet)
Seat 3: KeithTurbo48 (small blind) folded on the Flop
Seat 4: ng2414 (big blind) folded on the Flop
Seat 5: PlayTheBlues4U folded before Flop (didn't bet)
Seat 6: Donkey1206 showed [Kc Tc] and lost with a pair of Kings


PokerStars Hand #204909678705: Hold'em No Limit ($0.05/$0.10 USD) - 2019/10/22 22:46:01 ET
Table 'Celuta' 6-max Seat #6 is the button
Seat 2: SeaofLove ($19.56 in chips) 
Seat 3: ng2414 ($13.67 in chips) 
Seat 4: Jahlah1 ($11.44 in chips) 
Seat 5: KeithTurbo48 ($15.66 in chips) 
Seat 6: PlayTheBlues4U ($8.87 in chips) 
SeaofLove: posts small blind $0.05
ng2414: posts big blind $0.10
*** HOLE CARDS ***
Dealt to PlayTheBlues4U [9d Ks]
Jahlah1: folds 
KeithTurbo48: folds 
PlayTheBlues4U: raises $0.15 to $0.25
SeaofLove: calls $0.20
ng2414: folds 
*** FLOP *** [Th 6h Jh]
SeaofLove: bets $0.38
PlayTheBlues4U: folds 
Uncalled bet ($0.38) returned to SeaofLove
SeaofLove collected $0.57 from pot
SeaofLove: doesn't show hand 
*** SUMMARY ***
Total pot $0.60 | Rake $0.03 
Board [Th 6h Jh]
Seat 2: SeaofLove (small blind) collected ($0.57)
Seat 3: ng2414 (big blind) folded before Flop
Seat 4: Jahlah1 folded before Flop (didn't bet)
Seat 5: KeithTurbo48 folded before Flop (didn't bet)
Seat 6: PlayTheBlues4U (button) folded on the Flop


PokerStars Hand #204909678607: Hold'em No Limit ($0.05/$0.10 USD) - 2019/10/22 22:45:39 ET
Table 'Celuta' 6-max Seat #5 is the button
Seat 2: SeaofLove ($19.51 in chips) 
Seat 3: ng2414 ($13.67 in chips) 
Seat 4: Jahlah1 ($11.44 in chips) 
Seat 5: KeithTurbo48 ($15.66 in chips) 
Seat 6: PlayTheBlues4U ($8.92 in chips) 
PlayTheBlues4U: posts small blind $0.05
SeaofLove: posts big blind $0.10
*** HOLE CARDS ***
Dealt to PlayTheBlues4U [Kh 2s]
ng2414: folds 
Jahlah1: folds 
KeithTurbo48: folds 
PlayTheBlues4U: folds 
Uncalled bet ($0.05) returned to SeaofLove
SeaofLove collected $0.10 from pot
SeaofLove: doesn't show hand 
*** SUMMARY ***
Total pot $0.10 | Rake $0 
Seat 2: SeaofLove (big blind) collected ($0.10)
Seat 3: ng2414 folded before Flop (didn't bet)
Seat 4: Jahlah1 folded before Flop (didn't bet)
Seat 5: KeithTurbo48 (button) folded before Flop (didn't bet)
Seat 6: PlayTheBlues4U (small blind) folded before Flop


PokerStars Hand #204909678538: Hold'em No Limit ($0.05/$0.10 USD) - 2019/10/22 22:45:23 ET
Table 'Danae' 6-max Seat #1 is the button
Seat 1: zombiehedgehog ($15.35 in chips) 
Seat 2: SeaofLove ($13.07 in chips) 
Seat 3: KeithTurbo48 ($14.45 in chips) 
Seat 4: ng2414 ($24.28 in chips) 
Seat 5: PlayTheBlues4U ($9.70 in chips) 
Seat 6: Donkey1206 ($6.55 in chips) 
SeaofLove: posts small blind $0.05
KeithTurbo48: posts big blind $0.10
*** HOLE CARDS ***
Dealt to PlayTheBlues4U [Qd 4d]
ng2414: folds 
PlayTheBlues4U: folds 
Donkey1206: folds 
zombiehedgehog: calls $0.10
SeaofLove: calls $0.05
KeithTurbo48: checks 
*** FLOP *** [2d 9s 2s]
SeaofLove: checks 
KeithTurbo48: checks 
zombiehedgehog: bets $0.10
SeaofLove: folds 
KeithTurbo48: folds 
Uncalled bet ($0.10) returned to zombiehedgehog
zombiehedgehog collected $0.28 from pot
zombiehedgehog: doesn't show hand 
*** SUMMARY ***
Total pot $0.30 | Rake $0.02 
Board [2d 9s 2s]
Seat 1: zombiehedgehog (button) collected ($0.28)
Seat 2: SeaofLove (small blind) folded on the Flop
Seat 3: KeithTurbo48 (big blind) folded on the Flop
Seat 4: ng2414 folded before Flop (didn't bet)
Seat 5: PlayTheBlues4U folded before Flop (didn't bet)
Seat 6: Donkey1206 folded before Flop (didn't bet)


PokerStars Hand #204909678464: Hold'em No Limit ($0.05/$0.10 USD) - 2019/10/22 22:45:06 ET
Table 'Danae' 6-max Seat #6 is the button
Seat 1: zombiehedgehog ($15.25 in chips) 
Seat 2: SeaofLove ($13.17 in chips) 
Seat 3: KeithTurbo48 ($14.45 in chips) 
Seat 4: ng2414 ($24.28 in chips) 
Seat 5: PlayTheBlues4U ($9.70 in chips) 
Seat 6: Donkey1206 ($6.55 in chips) 
zombiehedgehog: posts small blind $0.05
SeaofLove: posts big blind $0.10
*** HOLE CARDS ***
Dealt to PlayTheBlues4U [3d Kd]
KeithTurbo48: folds 
ng2414: folds 
PlayTheBlues4U: folds 
Donkey1206: folds 
zombiehedgehog: raises $0.20 to $0.30
SeaofLove: folds 
Uncalled bet ($0.20) returned to zombiehedgehog
zombiehedgehog collected $0.20 from pot
zombiehedgehog: doesn't show hand 
*** SUMMARY ***
Total pot $0.20 | Rake $0 
Seat 1: zombiehedgehog (small blind) collected ($0.20)
Seat 2: SeaofLove (big blind) folded before Flop
Seat 3: KeithTurbo48 folded before Flop (didn't bet)
Seat 4: ng2414 folded before Flop (didn't bet)
Seat 5: PlayTheBlues4U folded before Flop (didn't bet)
Seat 6: Donkey1206 (button) folded before Flop (didn't bet)


PokerStars Hand #204909678456: Hold'em No Limit ($0.05/$0.10 USD) - 2019/10/22 22:45:05 ET
Table 'Celuta' 6-max Seat #4 is the button
Seat 2: SeaofLove ($19.51 in chips) 
Seat 3: ng2414 ($13.67 in chips) 
Seat 4: Jahlah1 ($11.44 in chips) 
Seat 5: KeithTurbo48 ($15.56 in chips) 
Seat 6: PlayTheBlues4U ($9.02 in chips) 
KeithTurbo48: posts small blind $0.05
PlayTheBlues4U: posts big blind $0.10
*** HOLE CARDS ***
Dealt to PlayTheBlues4U [Qs 8c]
SeaofLove: folds 
ng2414: folds 
Jahlah1: folds 
KeithTurbo48: raises $0.20 to $0.30
PlayTheBlues4U: folds 
Uncalled bet ($0.20) returned to KeithTurbo48
KeithTurbo48 collected $0.20 from pot
KeithTurbo48: doesn't show hand 
*** SUMMARY ***
Total pot $0.20 | Rake $0 
Seat 2: SeaofLove folded before Flop (didn't bet)
Seat 3: ng2414 folded before Flop (didn't bet)
Seat 4: Jahlah1 (button) folded before Flop (didn't bet)
Seat 5: KeithTurbo48 (small blind) collected ($0.20)
Seat 6: PlayTheBlues4U (big blind) folded before Flop


PokerStars Hand #204909678331: Hold'em No Limit ($0.05/$0.10 USD) - 2019/10/22 22:44:29 ET
Table 'Danae' 6-max Seat #5 is the button
Seat 1: zombiehedgehog ($14.98 in chips) 
Seat 2: SeaofLove ($13.17 in chips) 
Seat 3: KeithTurbo48 ($14.45 in chips) 
Seat 4: ng2414 ($24.28 in chips) 
Seat 5: PlayTheBlues4U ($9.95 in chips) 
Seat 6: Donkey1206 ($6.60 in chips) 
Donkey1206: posts small blind $0.05
zombiehedgehog: posts big blind $0.10
*** HOLE CARDS ***
Dealt to PlayTheBlues4U [3s Ad]
SeaofLove: folds 
KeithTurbo48: folds 
ng2414: folds 
PlayTheBlues4U: raises $0.15 to $0.25
Donkey1206: folds 
zombiehedgehog: calls $0.15
*** FLOP *** [Qs Tc Qh]
zombiehedgehog: bets $0.26
PlayTheBlues4U: folds 
Uncalled bet ($0.26) returned to zombiehedgehog
zombiehedgehog collected $0.52 from pot
zombiehedgehog: doesn't show hand 
*** SUMMARY ***
Total pot $0.55 | Rake $0.03 
Board [Qs Tc Qh]
Seat 1: zombiehedgehog (big blind) collected ($0.52)
Seat 2: SeaofLove folded before Flop (didn't bet)
Seat 3: KeithTurbo48 folded before Flop (didn't bet)
Seat 4: ng2414 folded before Flop (didn't bet)
Seat 5: PlayTheBlues4U (button) folded on the Flop
Seat 6: Donkey1206 (small blind) folded before Flop


PokerStars Hand #204909678230: Hold'em No Limit ($0.05/$0.10 USD) - 2019/10/22 22:44:06 ET
Table 'Celuta' 6-max Seat #3 is the button
Seat 2: SeaofLove ($19.51 in chips) 
Seat 3: ng2414 ($13.97 in chips) 
Seat 4: Jahlah1 ($11.49 in chips) 
Seat 5: KeithTurbo48 ($15.24 in chips) 
Seat 6: PlayTheBlues4U ($9.02 in chips) 
Jahlah1: posts small blind $0.05
KeithTurbo48: posts big blind $0.10
*** HOLE CARDS ***
Dealt to PlayTheBlues4U [7h 2s]
PlayTheBlues4U: folds 
SeaofLove: folds 
ng2414: raises $0.20 to $0.30
Jahlah1: folds 
KeithTurbo48: calls $0.20
*** FLOP *** [6c Qc Kh]
KeithTurbo48: checks 
ng2414: checks 
*** TURN *** [6c Qc Kh] [Qh]
KeithTurbo48: bets $0.30
ng2414: folds 
Uncalled bet ($0.30) returned to KeithTurbo48
KeithTurbo48 collected $0.62 from pot
KeithTurbo48: doesn't show hand 
*** SUMMARY ***
Total pot $0.65 | Rake $0.03 
Board [6c Qc Kh Qh]
Seat 2: SeaofLove folded before Flop (didn't bet)
Seat 3: ng2414 (button) folded on the Turn
Seat 4: Jahlah1 (small blind) folded before Flop
Seat 5: KeithTurbo48 (big blind) collected ($0.62)
Seat 6: PlayTheBlues4U folded before Flop (didn't bet)


PokerStars Hand #204909678155: Hold'em No Limit ($0.05/$0.10 USD) - 2019/10/22 22:43:49 ET
Table 'Danae' 6-max Seat #4 is the button
Seat 1: zombiehedgehog ($14.98 in chips) 
Seat 2: SeaofLove ($12.80 in chips) 
Seat 3: KeithTurbo48 ($14.45 in chips) 
Seat 4: ng2414 ($24.53 in chips) 
Seat 5: PlayTheBlues4U ($10 in chips) 
Seat 6: Donkey1206 ($6.70 in chips) 
PlayTheBlues4U: posts small blind $0.05
Donkey1206: posts big blind $0.10
*** HOLE CARDS ***
Dealt to PlayTheBlues4U [7s 4d]
zombiehedgehog: folds 
SeaofLove: raises $0.15 to $0.25
KeithTurbo48: folds 
ng2414: calls $0.25
PlayTheBlues4U: folds 
Donkey1206: folds 
*** FLOP *** [2d Qc Jd]
SeaofLove: checks 
ng2414: checks 
*** TURN *** [2d Qc Jd] [9d]
SeaofLove: bets $0.41
ng2414: folds 
Uncalled bet ($0.41) returned to SeaofLove
SeaofLove collected $0.62 from pot
SeaofLove: doesn't show hand 
*** SUMMARY ***
Total pot $0.65 | Rake $0.03 
Board [2d Qc Jd 9d]
Seat 1: zombiehedgehog folded before Flop (didn't bet)
Seat 2: SeaofLove collected ($0.62)
Seat 3: KeithTurbo48 folded before Flop (didn't bet)
Seat 4: ng2414 (button) folded on the Turn
Seat 5: PlayTheBlues4U (small blind) folded before Flop
Seat 6: Donkey1206 (big blind) folded before Flop


PokerStars Hand #204909677959: Hold'em No Limit ($0.05/$0.10 USD) - 2019/10/22 22:43:01 ET
Table 'Danae' 6-max Seat #3 is the button
Seat 1: zombiehedgehog ($15.08 in chips) 
Seat 2: SeaofLove ($12.80 in chips) 
Seat 3: KeithTurbo48 ($14.22 in chips) 
Seat 4: ng2414 ($24.58 in chips) 
Seat 5: PlayTheBlues4U ($8.01 in chips) 
Seat 6: Donkey1206 ($6.70 in chips) 
ng2414: posts small blind $0.05
PlayTheBlues4U: posts big blind $0.10
*** HOLE CARDS ***
Dealt to PlayTheBlues4U [Qd 4c]
Donkey1206 has timed out
Donkey1206: folds 
zombiehedgehog: calls $0.10
SeaofLove: folds 
KeithTurbo48: calls $0.10
ng2414: folds 
PlayTheBlues4U: checks 
*** FLOP *** [Ks 5c Kc]
PlayTheBlues4U: checks 
zombiehedgehog: checks 
KeithTurbo48: bets $0.15
PlayTheBlues4U: folds 
zombiehedgehog: folds 
Uncalled bet ($0.15) returned to KeithTurbo48
KeithTurbo48 collected $0.33 from pot
KeithTurbo48: doesn't show hand 
*** SUMMARY ***
Total pot $0.35 | Rake $0.02 
Board [Ks 5c Kc]
Seat 1: zombiehedgehog folded on the Flop
Seat 2: SeaofLove folded before Flop (didn't bet)
Seat 3: KeithTurbo48 (button) collected ($0.33)
Seat 4: ng2414 (small blind) folded before Flop
Seat 5: PlayTheBlues4U (big blind) folded on the Flop
Seat 6: Donkey1206 folded before Flop (didn't bet)


PokerStars Hand #204909677905: Hold'em No Limit ($0.05/$0.10 USD) - 2019/10/22 22:42:46 ET
Table 'Celuta' 6-max Seat #2 is the button
Seat 2: SeaofLove ($15.25 in chips) 
Seat 3: ng2414 ($14.02 in chips) 
Seat 4: Jahlah1 ($11.59 in chips) 
Seat 5: KeithTurbo48 ($19.55 in chips) 
Seat 6: PlayTheBlues4U ($9.27 in chips) 
ng2414: posts small blind $0.05
Jahlah1: posts big blind $0.10
*** HOLE CARDS ***
Dealt to PlayTheBlues4U [Js Ks]
KeithTurbo48: raises $0.15 to $0.25
PlayTheBlues4U: calls $0.25
SeaofLove: calls $0.25
ng2414: folds 
Jahlah1: folds 
*** FLOP *** [4s 9c Tc]
KeithTurbo48: checks 
PlayTheBlues4U: checks 
SeaofLove: bets $0.57
KeithTurbo48: calls $0.57
PlayTheBlues4U: folds 
*** TURN *** [4s 9c Tc] [Qc]
KeithTurbo48: checks 
SeaofLove: bets $1.29
KeithTurbo48: calls $1.29
*** RIVER *** [4s 9c Tc Qc] [Ts]
KeithTurbo48: checks 
SeaofLove: bets $2.20
KeithTurbo48: calls $2.20
*** SHOW DOWN ***
SeaofLove: shows [3c 5c] (a flush, Queen high)
KeithTurbo48: mucks hand 
SeaofLove collected $8.57 from pot
*** SUMMARY ***
Total pot $9.02 | Rake $0.45 
Board [4s 9c Tc Qc Ts]
Seat 2: SeaofLove (button) showed [3c 5c] and won ($8.57) with a flush, Queen high
Seat 3: ng2414 (small blind) folded before Flop
Seat 4: Jahlah1 (big blind) folded before Flop
Seat 5: KeithTurbo48 mucked [Ac Qs]
Seat 6: PlayTheBlues4U folded on the Flop


PokerStars Hand #204909677808: Hold'em No Limit ($0.05/$0.10 USD) - 2019/10/22 22:42:25 ET
Table 'Danae' 6-max Seat #2 is the button
Seat 1: zombiehedgehog ($14.93 in chips) 
Seat 2: SeaofLove ($12.80 in chips) 
Seat 3: KeithTurbo48 ($14.27 in chips) 
Seat 4: ng2414 ($24.68 in chips) 
Seat 5: PlayTheBlues4U ($8.01 in chips) 
Seat 6: Donkey1206 ($6.70 in chips) 
KeithTurbo48: posts small blind $0.05
ng2414: posts big blind $0.10
*** HOLE CARDS ***
Dealt to PlayTheBlues4U [9s 5s]
PlayTheBlues4U: folds 
Donkey1206: folds 
zombiehedgehog: raises $0.10 to $0.20
SeaofLove: folds 
KeithTurbo48: folds 
ng2414: folds 
Uncalled bet ($0.10) returned to zombiehedgehog
zombiehedgehog collected $0.25 from pot
zombiehedgehog: doesn't show hand 
*** SUMMARY ***
Total pot $0.25 | Rake $0 
Seat 1: zombiehedgehog collected ($0.25)
Seat 2: SeaofLove (button) folded before Flop (didn't bet)
Seat 3: KeithTurbo48 (small blind) folded before Flop
Seat 4: ng2414 (big blind) folded before Flop
Seat 5: PlayTheBlues4U folded before Flop (didn't bet)
Seat 6: Donkey1206 folded before Flop (didn't bet)


PokerStars Hand #204909677790: Hold'em No Limit ($0.05/$0.10 USD) - 2019/10/22 22:42:20 ET
Table 'Celuta' 6-max Seat #6 is the button
Seat 2: SeaofLove ($15.30 in chips) 
Seat 3: ng2414 ($14.12 in chips) 
Seat 4: Jahlah1 ($11.59 in chips) 
Seat 5: KeithTurbo48 ($19.55 in chips) 
Seat 6: PlayTheBlues4U ($9.12 in chips) 
SeaofLove: posts small blind $0.05
ng2414: posts big blind $0.10
*** HOLE CARDS ***
Dealt to PlayTheBlues4U [8h Qh]
Jahlah1: folds 
KeithTurbo48: folds 
PlayTheBlues4U: raises $0.10 to $0.20
SeaofLove: folds 
ng2414: folds 
Uncalled bet ($0.10) returned to PlayTheBlues4U
PlayTheBlues4U collected $0.25 from pot
PlayTheBlues4U: doesn't show hand 
*** SUMMARY ***
Total pot $0.25 | Rake $0 
Seat 2: SeaofLove (small blind) folded before Flop
Seat 3: ng2414 (big blind) folded before Flop
Seat 4: Jahlah1 folded before Flop (didn't bet)
Seat 5: KeithTurbo48 folded before Flop (didn't bet)
Seat 6: PlayTheBlues4U (button) collected ($0.25)


PokerStars Hand #204909677724: Hold'em No Limit ($0.05/$0.10 USD) - 2019/10/22 22:42:01 ET
Table 'Celuta' 6-max Seat #5 is the button
Seat 2: SeaofLove ($15.25 in chips) 
Seat 3: ng2414 ($14.12 in chips) 
Seat 4: Jahlah1 ($11.59 in chips) 
Seat 5: KeithTurbo48 ($19.55 in chips) 
Seat 6: PlayTheBlues4U ($9.17 in chips) 
PlayTheBlues4U: posts small blind $0.05
SeaofLove: posts big blind $0.10
*** HOLE CARDS ***
Dealt to PlayTheBlues4U [3c 9d]
ng2414: folds 
Jahlah1: folds 
KeithTurbo48: folds 
PlayTheBlues4U: folds 
Uncalled bet ($0.05) returned to SeaofLove
SeaofLove collected $0.10 from pot
SeaofLove: doesn't show hand 
*** SUMMARY ***
Total pot $0.10 | Rake $0 
Seat 2: SeaofLove (big blind) collected ($0.10)
Seat 3: ng2414 folded before Flop (didn't bet)
Seat 4: Jahlah1 folded before Flop (didn't bet)
Seat 5: KeithTurbo48 (button) folded before Flop (didn't bet)
Seat 6: PlayTheBlues4U (small blind) folded before Flop


PokerStars Hand #204909677713: Hold'em No Limit ($0.05/$0.10 USD) - 2019/10/22 22:41:58 ET
Table 'Danae' 6-max Seat #1 is the button
Seat 1: zombiehedgehog ($14.70 in chips) 
Seat 2: SeaofLove ($12.85 in chips) 
Seat 3: KeithTurbo48 ($14.47 in chips) 
Seat 4: ng2414 ($24.68 in chips) 
Seat 5: PlayTheBlues4U ($8.01 in chips) 
Seat 6: Donkey1206 ($6.70 in chips) 
SeaofLove: posts small blind $0.05
KeithTurbo48: posts big blind $0.10
*** HOLE CARDS ***
Dealt to PlayTheBlues4U [5c 2d]
ng2414: folds 
PlayTheBlues4U: folds 
Donkey1206: folds 
zombiehedgehog: raises $0.10 to $0.20
SeaofLove: folds 
KeithTurbo48: calls $0.10
*** FLOP *** [6s 7h Td]
KeithTurbo48: checks 
zombiehedgehog: bets $0.22
KeithTurbo48: folds 
Uncalled bet ($0.22) returned to zombiehedgehog
zombiehedgehog collected $0.43 from pot
zombiehedgehog: doesn't show hand 
*** SUMMARY ***
Total pot $0.45 | Rake $0.02 
Board [6s 7h Td]
Seat 1: zombiehedgehog (button) collected ($0.43)
Seat 2: SeaofLove (small blind) folded before Flop
Seat 3: KeithTurbo48 (big blind) folded on the Flop
Seat 4: ng2414 folded before Flop (didn't bet)
Seat 5: PlayTheBlues4U folded before Flop (didn't bet)
Seat 6: Donkey1206 folded before Flop (didn't bet)


PokerStars Hand #204909677663: Hold'em No Limit ($0.05/$0.10 USD) - 2019/10/22 22:41:47 ET
Table 'Danae' 6-max Seat #6 is the button
Seat 1: zombiehedgehog ($14.60 in chips) 
Seat 2: SeaofLove ($12.95 in chips) 
Seat 3: KeithTurbo48 ($14.47 in chips) 
Seat 4: ng2414 ($24.68 in chips) 
Seat 5: PlayTheBlues4U ($8.01 in chips) 
Seat 6: Donkey1206 ($6.70 in chips) 
zombiehedgehog: posts small blind $0.05
SeaofLove: posts big blind $0.10
*** HOLE CARDS ***
Dealt to PlayTheBlues4U [Qc 2d]
KeithTurbo48: folds 
ng2414: folds 
PlayTheBlues4U: folds 
Donkey1206: folds 
zombiehedgehog: raises $0.10 to $0.20
SeaofLove: folds 
Uncalled bet ($0.10) returned to zombiehedgehog
zombiehedgehog collected $0.20 from pot
zombiehedgehog: doesn't show hand 
*** SUMMARY ***
Total pot $0.20 | Rake $0 
Seat 1: zombiehedgehog (small blind) collected ($0.20)
Seat 2: SeaofLove (big blind) folded before Flop
Seat 3: KeithTurbo48 folded before Flop (didn't bet)
Seat 4: ng2414 folded before Flop (didn't bet)
Seat 5: PlayTheBlues4U folded before Flop (didn't bet)
Seat 6: Donkey1206 (button) folded before Flop (didn't bet)


PokerStars Hand #204909677533: Hold'em No Limit ($0.05/$0.10 USD) - 2019/10/22 22:41:16 ET
Table 'Celuta' 6-max Seat #4 is the button
Seat 1: trumpcaddy ($9.43 in chips) 
Seat 2: SeaofLove ($15.25 in chips) 
Seat 3: ng2414 ($12.72 in chips) 
Seat 4: Jahlah1 ($11.59 in chips) 
Seat 5: KeithTurbo48 ($19.60 in chips) 
Seat 6: PlayTheBlues4U ($10.67 in chips) 
KeithTurbo48: posts small blind $0.05
PlayTheBlues4U: posts big blind $0.10
*** HOLE CARDS ***
Dealt to PlayTheBlues4U [Ah 9h]
trumpcaddy: folds 
SeaofLove: folds 
ng2414: raises $0.20 to $0.30
Jahlah1: folds 
KeithTurbo48: folds 
PlayTheBlues4U: calls $0.20
*** FLOP *** [2d 6c Ks]
PlayTheBlues4U: checks 
ng2414: checks 
*** TURN *** [2d 6c Ks] [9c]
PlayTheBlues4U: checks 
ng2414: bets $0.40
PlayTheBlues4U: calls $0.40
*** RIVER *** [2d 6c Ks 9c] [Td]
PlayTheBlues4U: checks 
ng2414: bets $0.80
PlayTheBlues4U: calls $0.80
*** SHOW DOWN ***
ng2414: shows [Tc Kh] (two pair, Kings and Tens)
PlayTheBlues4U: mucks hand 
ng2414 collected $2.90 from pot
*** SUMMARY ***
Total pot $3.05 | Rake $0.15 
Board [2d 6c Ks 9c Td]
Seat 1: trumpcaddy folded before Flop (didn't bet)
Seat 2: SeaofLove folded before Flop (didn't bet)
Seat 3: ng2414 showed [Tc Kh] and won ($2.90) with two pair, Kings and Tens
Seat 4: Jahlah1 (button) folded before Flop (didn't bet)
Seat 5: KeithTurbo48 (small blind) folded before Flop
Seat 6: PlayTheBlues4U (big blind) mucked [Ah 9h]


PokerStars Hand #204909677451: Hold'em No Limit ($0.05/$0.10 USD) - 2019/10/22 22:40:57 ET
Table 'Danae' 6-max Seat #5 is the button
Seat 1: zombiehedgehog ($14.85 in chips) 
Seat 2: SeaofLove ($13.20 in chips) 
Seat 3: KeithTurbo48 ($13.96 in chips) 
Seat 4: ng2414 ($24.68 in chips) 
Seat 5: PlayTheBlues4U ($8.01 in chips) 
Seat 6: Donkey1206 ($6.75 in chips) 
Donkey1206: posts small blind $0.05
zombiehedgehog: posts big blind $0.10
*** HOLE CARDS ***
Dealt to PlayTheBlues4U [4h Qs]
SeaofLove: raises $0.15 to $0.25
KeithTurbo48: calls $0.25
ng2414: folds 
PlayTheBlues4U: folds 
Donkey1206: folds 
zombiehedgehog: calls $0.15
*** FLOP *** [5c 2s Th]
zombiehedgehog: checks 
SeaofLove: checks 
KeithTurbo48: bets $0.50
zombiehedgehog: folds 
SeaofLove: folds 
Uncalled bet ($0.50) returned to KeithTurbo48
KeithTurbo48 collected $0.76 from pot
KeithTurbo48: doesn't show hand 
*** SUMMARY ***
Total pot $0.80 | Rake $0.04 
Board [5c 2s Th]
Seat 1: zombiehedgehog (big blind) folded on the Flop
Seat 2: SeaofLove folded on the Flop
Seat 3: KeithTurbo48 collected ($0.76)
Seat 4: ng2414 folded before Flop (didn't bet)
Seat 5: PlayTheBlues4U (button) folded before Flop (didn't bet)
Seat 6: Donkey1206 (small blind) folded before Flop


PokerStars Hand #204909677328: Hold'em No Limit ($0.05/$0.10 USD) - 2019/10/22 22:40:29 ET
Table 'Danae' 6-max Seat #4 is the button
Seat 1: zombiehedgehog ($14.67 in chips) 
Seat 2: SeaofLove ($13.20 in chips) 
Seat 3: KeithTurbo48 ($13.96 in chips) 
Seat 4: ng2414 ($24.68 in chips) 
Seat 5: PlayTheBlues4U ($8.11 in chips) 
Seat 6: Donkey1206 ($6.85 in chips) 
PlayTheBlues4U: posts small blind $0.05
Donkey1206: posts big blind $0.10
*** HOLE CARDS ***
Dealt to PlayTheBlues4U [2h Kh]
zombiehedgehog: calls $0.10
SeaofLove: folds 
KeithTurbo48: folds 
ng2414: folds 
PlayTheBlues4U: calls $0.05
Donkey1206: checks 
*** FLOP *** [9d Qs Js]
PlayTheBlues4U: checks 
Donkey1206: checks 
zombiehedgehog: bets $0.10
PlayTheBlues4U: folds 
Donkey1206: folds 
Uncalled bet ($0.10) returned to zombiehedgehog
zombiehedgehog collected $0.28 from pot
zombiehedgehog: doesn't show hand 
*** SUMMARY ***
Total pot $0.30 | Rake $0.02 
Board [9d Qs Js]
Seat 1: zombiehedgehog collected ($0.28)
Seat 2: SeaofLove folded before Flop (didn't bet)
Seat 3: KeithTurbo48 folded before Flop (didn't bet)
Seat 4: ng2414 (button) folded before Flop (didn't bet)
Seat 5: PlayTheBlues4U (small blind) folded on the Flop
Seat 6: Donkey1206 (big blind) folded on the Flop


PokerStars Hand #204909677220: Hold'em No Limit ($0.05/$0.10 USD) - 2019/10/22 22:40:02 ET
Table 'Celuta' 6-max Seat #3 is the button
Seat 1: trumpcaddy ($10.63 in chips) 
Seat 2: SeaofLove ($17.65 in chips) 
Seat 3: ng2414 ($12.72 in chips) 
Seat 4: Jahlah1 ($8.19 in chips) 
Seat 5: KeithTurbo48 ($19.70 in chips) 
Seat 6: PlayTheBlues4U ($10.67 in chips) 
Jahlah1: posts small blind $0.05
KeithTurbo48: posts big blind $0.10
*** HOLE CARDS ***
Dealt to PlayTheBlues4U [Ah 5c]
PlayTheBlues4U: folds 
trumpcaddy: raises $0.20 to $0.30
SeaofLove: calls $0.30
ng2414: folds 
Jahlah1: raises $0.90 to $1.20
KeithTurbo48: folds 
trumpcaddy: calls $0.90
SeaofLove: calls $0.90
*** FLOP *** [5s 8d As]
Jahlah1: bets $1.20
trumpcaddy: folds 
SeaofLove: calls $1.20
*** TURN *** [5s 8d As] [6h]
Jahlah1: checks 
SeaofLove: checks 
*** RIVER *** [5s 8d As 6h] [Jc]
Jahlah1: checks 
SeaofLove: checks 
*** SHOW DOWN ***
Jahlah1: shows [Ks Kd] (a pair of Kings)
SeaofLove: mucks hand 
Jahlah1 collected $5.80 from pot
*** SUMMARY ***
Total pot $6.10 | Rake $0.30 
Board [5s 8d As 6h Jc]
Seat 1: trumpcaddy folded on the Flop
Seat 2: SeaofLove mucked [5d 4d]
Seat 3: ng2414 (button) folded before Flop (didn't bet)
Seat 4: Jahlah1 (small blind) showed [Ks Kd] and won ($5.80) with a pair of Kings
Seat 5: KeithTurbo48 (big blind) folded before Flop
Seat 6: PlayTheBlues4U folded before Flop (didn't bet)


PokerStars Hand #204909677125: Hold'em No Limit ($0.05/$0.10 USD) - 2019/10/22 22:39:38 ET
Table 'Celuta' 6-max Seat #2 is the button
Seat 1: trumpcaddy ($10.63 in chips) 
Seat 2: SeaofLove ($17.50 in chips) 
Seat 3: ng2414 ($12.77 in chips) 
Seat 4: Jahlah1 ($8.29 in chips) 
Seat 5: KeithTurbo48 ($19.70 in chips) 
Seat 6: PlayTheBlues4U ($10.67 in chips) 
ng2414: posts small blind $0.05
Jahlah1: posts big blind $0.10
*** HOLE CARDS ***
Dealt to PlayTheBlues4U [6s 5h]
KeithTurbo48: folds 
PlayTheBlues4U: folds 
trumpcaddy: folds 
SeaofLove: raises $0.15 to $0.25
ng2414: folds 
Jahlah1: folds 
Uncalled bet ($0.15) returned to SeaofLove
SeaofLove collected $0.25 from pot
SeaofLove: doesn't show hand 
*** SUMMARY ***
Total pot $0.25 | Rake $0 
Seat 1: trumpcaddy folded before Flop (didn't bet)
Seat 2: SeaofLove (button) collected ($0.25)
Seat 3: ng2414 (small blind) folded before Flop
Seat 4: Jahlah1 (big blind) folded before Flop
Seat 5: KeithTurbo48 folded before Flop (didn't bet)
Seat 6: PlayTheBlues4U folded before Flop (didn't bet)


PokerStars Hand #204909677092: Hold'em No Limit ($0.05/$0.10 USD) - 2019/10/22 22:39:29 ET
Table 'Celuta' 6-max Seat #1 is the button
Seat 1: trumpcaddy ($10.63 in chips) 
Seat 2: SeaofLove ($17.55 in chips) 
Seat 3: ng2414 ($12.72 in chips) 
Seat 4: Jahlah1 ($8.29 in chips) 
Seat 5: KeithTurbo48 ($19.70 in chips) 
Seat 6: PlayTheBlues4U ($10.67 in chips) 
SeaofLove: posts small blind $0.05
ng2414: posts big blind $0.10
*** HOLE CARDS ***
Dealt to PlayTheBlues4U [9d Qs]
Jahlah1: folds 
KeithTurbo48: folds 
PlayTheBlues4U: folds 
trumpcaddy: folds 
SeaofLove: folds 
Uncalled bet ($0.05) returned to ng2414
ng2414 collected $0.10 from pot
*** SUMMARY ***
Total pot $0.10 | Rake $0 
Seat 1: trumpcaddy (button) folded before Flop (didn't bet)
Seat 2: SeaofLove (small blind) folded before Flop
Seat 3: ng2414 (big blind) collected ($0.10)
Seat 4: Jahlah1 folded before Flop (didn't bet)
Seat 5: KeithTurbo48 folded before Flop (didn't bet)
Seat 6: PlayTheBlues4U folded before Flop (didn't bet)


PokerStars Hand #204909677074: Hold'em No Limit ($0.05/$0.10 USD) - 2019/10/22 22:39:25 ET
Table 'Danae' 6-max Seat #3 is the button
Seat 1: zombiehedgehog ($14.67 in chips) 
Seat 2: SeaofLove ($13.20 in chips) 
Seat 3: KeithTurbo48 ($11.30 in chips) 
Seat 4: ng2414 ($24.73 in chips) 
Seat 5: PlayTheBlues4U ($8.21 in chips) 
Seat 6: Donkey1206 ($9.65 in chips) 
ng2414: posts small blind $0.05
PlayTheBlues4U: posts big blind $0.10
*** HOLE CARDS ***
Dealt to PlayTheBlues4U [9s 2h]
Donkey1206: raises $0.30 to $0.40
zombiehedgehog: folds 
SeaofLove: folds 
KeithTurbo48: calls $0.40
ng2414: folds 
PlayTheBlues4U: folds 
*** FLOP *** [7s 8s 3c]
Donkey1206: checks 
KeithTurbo48: checks 
*** TURN *** [7s 8s 3c] [9d]
Donkey1206: checks 
KeithTurbo48: bets $0.70
Donkey1206: calls $0.70
*** RIVER *** [7s 8s 3c 9d] [5d]
Donkey1206: checks 
KeithTurbo48: bets $1.70
Donkey1206: calls $1.70
*** SHOW DOWN ***
KeithTurbo48: shows [Ah 6h] (a straight, Five to Nine)
Donkey1206: mucks hand 
KeithTurbo48 collected $5.46 from pot
*** SUMMARY ***
Total pot $5.75 | Rake $0.29 
Board [7s 8s 3c 9d 5d]
Seat 1: zombiehedgehog folded before Flop (didn't bet)
Seat 2: SeaofLove folded before Flop (didn't bet)
Seat 3: KeithTurbo48 (button) showed [Ah 6h] and won ($5.46) with a straight, Five to Nine
Seat 4: ng2414 (small blind) folded before Flop
Seat 5: PlayTheBlues4U (big blind) folded before Flop
Seat 6: Donkey1206 mucked [Ad Kc]


PokerStars Hand #204909677000: Hold'em No Limit ($0.05/$0.10 USD) - 2019/10/22 22:39:06 ET
Table 'Celuta' 6-max Seat #6 is the button
Seat 1: trumpcaddy ($10.68 in chips) 
Seat 2: SeaofLove ($17.50 in chips) 
Seat 3: ng2414 ($12.72 in chips) 
Seat 4: Jahlah1 ($8.29 in chips) 
Seat 5: KeithTurbo48 ($19.70 in chips) 
Seat 6: PlayTheBlues4U ($10.67 in chips) 
trumpcaddy: posts small blind $0.05
SeaofLove: posts big blind $0.10
*** HOLE CARDS ***
Dealt to PlayTheBlues4U [Jc 6c]
ng2414: folds 
Jahlah1: folds 
KeithTurbo48: folds 
PlayTheBlues4U: folds 
trumpcaddy: folds 
Uncalled bet ($0.05) returned to SeaofLove
SeaofLove collected $0.10 from pot
SeaofLove: doesn't show hand 
*** SUMMARY ***
Total pot $0.10 | Rake $0 
Seat 1: trumpcaddy (small blind) folded before Flop
Seat 2: SeaofLove (big blind) collected ($0.10)
Seat 3: ng2414 folded before Flop (didn't bet)
Seat 4: Jahlah1 folded before Flop (didn't bet)
Seat 5: KeithTurbo48 folded before Flop (didn't bet)
Seat 6: PlayTheBlues4U (button) folded before Flop (didn't bet)


PokerStars Hand #204909676922: Hold'em No Limit ($0.05/$0.10 USD) - 2019/10/22 22:38:47 ET
Table 'Celuta' 6-max Seat #5 is the button
Seat 1: trumpcaddy ($10.78 in chips) 
Seat 2: SeaofLove ($17.50 in chips) 
Seat 3: ng2414 ($12.72 in chips) 
Seat 4: Jahlah1 ($8.29 in chips) 
Seat 5: KeithTurbo48 ($19.55 in chips) 
Seat 6: PlayTheBlues4U ($10.72 in chips) 
PlayTheBlues4U: posts small blind $0.05
trumpcaddy: posts big blind $0.10
*** HOLE CARDS ***
Dealt to PlayTheBlues4U [9c 6h]
SeaofLove: folds 
ng2414: folds 
Jahlah1: folds 
KeithTurbo48: raises $0.15 to $0.25
PlayTheBlues4U: folds 
trumpcaddy: folds 
Uncalled bet ($0.15) returned to KeithTurbo48
KeithTurbo48 collected $0.25 from pot
KeithTurbo48: doesn't show hand 
*** SUMMARY ***
Total pot $0.25 | Rake $0 
Seat 1: trumpcaddy (big blind) folded before Flop
Seat 2: SeaofLove folded before Flop (didn't bet)
Seat 3: ng2414 folded before Flop (didn't bet)
Seat 4: Jahlah1 folded before Flop (didn't bet)
Seat 5: KeithTurbo48 (button) collected ($0.25)
Seat 6: PlayTheBlues4U (small blind) folded before Flop


PokerStars Hand #204909676907: Hold'em No Limit ($0.05/$0.10 USD) - 2019/10/22 22:38:43 ET
Table 'Danae' 6-max Seat #2 is the button
Seat 1: zombiehedgehog ($14.67 in chips) 
Seat 2: SeaofLove ($13.20 in chips) 
Seat 3: KeithTurbo48 ($11.35 in chips) 
Seat 4: ng2414 ($24.59 in chips) 
Seat 5: PlayTheBlues4U ($8.21 in chips) 
Seat 6: Donkey1206 ($9.75 in chips) 
KeithTurbo48: posts small blind $0.05
ng2414: posts big blind $0.10
*** HOLE CARDS ***
Dealt to PlayTheBlues4U [Ah 4c]
PlayTheBlues4U: folds 
Donkey1206: calls $0.10
zombiehedgehog: folds 
SeaofLove: folds 
KeithTurbo48: folds 
ng2414: checks 
*** FLOP *** [8s 3h 5s]
ng2414: checks 
Donkey1206: checks 
*** TURN *** [8s 3h 5s] [7d]
ng2414: checks 
Donkey1206: checks 
*** RIVER *** [8s 3h 5s 7d] [Qs]
ng2414: bets $0.10
Donkey1206: folds 
Uncalled bet ($0.10) returned to ng2414
ng2414 collected $0.24 from pot
*** SUMMARY ***
Total pot $0.25 | Rake $0.01 
Board [8s 3h 5s 7d Qs]
Seat 1: zombiehedgehog folded before Flop (didn't bet)
Seat 2: SeaofLove (button) folded before Flop (didn't bet)
Seat 3: KeithTurbo48 (small blind) folded before Flop
Seat 4: ng2414 (big blind) collected ($0.24)
Seat 5: PlayTheBlues4U folded before Flop (didn't bet)
Seat 6: Donkey1206 folded on the River


PokerStars Hand #204909676859: Hold'em No Limit ($0.05/$0.10 USD) - 2019/10/22 22:38:32 ET
Table 'Celuta' 6-max Seat #4 is the button
Seat 1: trumpcaddy ($10.78 in chips) 
Seat 2: SeaofLove ($17.50 in chips) 
Seat 3: ng2414 ($12.72 in chips) 
Seat 4: Jahlah1 ($8.29 in chips) 
Seat 5: KeithTurbo48 ($19.60 in chips) 
Seat 6: PlayTheBlues4U ($10.67 in chips) 
KeithTurbo48: posts small blind $0.05
PlayTheBlues4U: posts big blind $0.10
*** HOLE CARDS ***
Dealt to PlayTheBlues4U [5h 6c]
trumpcaddy: folds 
SeaofLove: folds 
ng2414: folds 
Jahlah1: folds 
KeithTurbo48: folds 
Uncalled bet ($0.05) returned to PlayTheBlues4U
PlayTheBlues4U collected $0.10 from pot
PlayTheBlues4U: doesn't show hand 
*** SUMMARY ***
Total pot $0.10 | Rake $0 
Seat 1: trumpcaddy folded before Flop (didn't bet)
Seat 2: SeaofLove folded before Flop (didn't bet)
Seat 3: ng2414 folded before Flop (didn't bet)
Seat 4: Jahlah1 (button) folded before Flop (didn't bet)
Seat 5: KeithTurbo48 (small blind) folded before Flop
Seat 6: PlayTheBlues4U (big blind) collected ($0.10)


PokerStars Hand #204909676805: Hold'em No Limit ($0.05/$0.10 USD) - 2019/10/22 22:38:17 ET
Table 'Celuta' 6-max Seat #3 is the button
Seat 1: trumpcaddy ($10.78 in chips) 
Seat 2: SeaofLove ($17.50 in chips) 
Seat 3: ng2414 ($12.72 in chips) 
Seat 4: Jahlah1 ($8.34 in chips) 
Seat 5: KeithTurbo48 ($19.55 in chips) 
Seat 6: PlayTheBlues4U ($10.67 in chips) 
Jahlah1: posts small blind $0.05
KeithTurbo48: posts big blind $0.10
*** HOLE CARDS ***
Dealt to PlayTheBlues4U [Ks 2d]
PlayTheBlues4U: folds 
trumpcaddy: folds 
SeaofLove: folds 
ng2414: folds 
Jahlah1: folds 
Uncalled bet ($0.05) returned to KeithTurbo48
KeithTurbo48 collected $0.10 from pot
*** SUMMARY ***
Total pot $0.10 | Rake $0 
Seat 1: trumpcaddy folded before Flop (didn't bet)
Seat 2: SeaofLove folded before Flop (didn't bet)
Seat 3: ng2414 (button) folded before Flop (didn't bet)
Seat 4: Jahlah1 (small blind) folded before Flop
Seat 5: KeithTurbo48 (big blind) collected ($0.10)
Seat 6: PlayTheBlues4U folded before Flop (didn't bet)


PokerStars Hand #204909676734: Hold'em No Limit ($0.05/$0.10 USD) - 2019/10/22 22:38:00 ET
Table 'Danae' 6-max Seat #1 is the button
Seat 1: zombiehedgehog ($14.77 in chips) 
Seat 2: SeaofLove ($12.90 in chips) 
Seat 3: KeithTurbo48 ($11.45 in chips) 
Seat 4: ng2414 ($24.59 in chips) 
Seat 5: PlayTheBlues4U ($8.21 in chips) 
Seat 6: Donkey1206 ($9.85 in chips) 
SeaofLove: posts small blind $0.05
KeithTurbo48: posts big blind $0.10
*** HOLE CARDS ***
Dealt to PlayTheBlues4U [Kd 5c]
ng2414: folds 
PlayTheBlues4U: folds 
Donkey1206: calls $0.10
zombiehedgehog: calls $0.10
SeaofLove: raises $0.50 to $0.60
KeithTurbo48: folds 
Donkey1206: folds 
zombiehedgehog: folds 
Uncalled bet ($0.50) returned to SeaofLove
SeaofLove collected $0.40 from pot
SeaofLove: doesn't show hand 
*** SUMMARY ***
Total pot $0.40 | Rake $0 
Seat 1: zombiehedgehog (button) folded before Flop
Seat 2: SeaofLove (small blind) collected ($0.40)
Seat 3: KeithTurbo48 (big blind) folded before Flop
Seat 4: ng2414 folded before Flop (didn't bet)
Seat 5: PlayTheBlues4U folded before Flop (didn't bet)
Seat 6: Donkey1206 folded before Flop


PokerStars Hand #204909676725: Hold'em No Limit ($0.05/$0.10 USD) - 2019/10/22 22:37:57 ET
Table 'Celuta' 6-max Seat #2 is the button
Seat 1: trumpcaddy ($10.78 in chips) 
Seat 2: SeaofLove ($17.50 in chips) 
Seat 3: ng2414 ($12.77 in chips) 
Seat 4: Jahlah1 ($8.44 in chips) 
Seat 5: KeithTurbo48 ($19.40 in chips) 
Seat 6: PlayTheBlues4U ($10.67 in chips) 
ng2414: posts small blind $0.05
Jahlah1: posts big blind $0.10
*** HOLE CARDS ***
Dealt to PlayTheBlues4U [7d Ac]
KeithTurbo48: raises $0.15 to $0.25
PlayTheBlues4U: folds 
trumpcaddy: folds 
SeaofLove: folds 
ng2414: folds 
Jahlah1: folds 
Uncalled bet ($0.15) returned to KeithTurbo48
KeithTurbo48 collected $0.25 from pot
KeithTurbo48: doesn't show hand 
*** SUMMARY ***
Total pot $0.25 | Rake $0 
Seat 1: trumpcaddy folded before Flop (didn't bet)
Seat 2: SeaofLove (button) folded before Flop (didn't bet)
Seat 3: ng2414 (small blind) folded before Flop
Seat 4: Jahlah1 (big blind) folded before Flop
Seat 5: KeithTurbo48 collected ($0.25)
Seat 6: PlayTheBlues4U folded before Flop (didn't bet)


PokerStars Hand #204909676524: Hold'em No Limit ($0.05/$0.10 USD) - 2019/10/22 22:37:07 ET
Table 'Danae' 6-max Seat #6 is the button
Seat 1: zombiehedgehog ($14.68 in chips) 
Seat 2: SeaofLove ($13 in chips) 
Seat 3: KeithTurbo48 ($11.45 in chips) 
Seat 4: ng2414 ($24.59 in chips) 
Seat 5: PlayTheBlues4U ($8.21 in chips) 
Seat 6: Donkey1206 ($9.85 in chips) 
zombiehedgehog: posts small blind $0.05
SeaofLove: posts big blind $0.10
*** HOLE CARDS ***
Dealt to PlayTheBlues4U [5d Ac]
KeithTurbo48: folds 
ng2414: folds 
PlayTheBlues4U: folds 
Donkey1206: folds 
zombiehedgehog: calls $0.05
SeaofLove: checks 
*** FLOP *** [8c 9h 2c]
zombiehedgehog: bets $0.10
SeaofLove: folds 
Uncalled bet ($0.10) returned to zombiehedgehog
zombiehedgehog collected $0.19 from pot
zombiehedgehog: doesn't show hand 
*** SUMMARY ***
Total pot $0.20 | Rake $0.01 
Board [8c 9h 2c]
Seat 1: zombiehedgehog (small blind) collected ($0.19)
Seat 2: SeaofLove (big blind) folded on the Flop
Seat 3: KeithTurbo48 folded before Flop (didn't bet)
Seat 4: ng2414 folded before Flop (didn't bet)
Seat 5: PlayTheBlues4U folded before Flop (didn't bet)
Seat 6: Donkey1206 (button) folded before Flop (didn't bet)


PokerStars Hand #204909676512: Hold'em No Limit ($0.05/$0.10 USD) - 2019/10/22 22:37:04 ET
Table 'Celuta' 6-max Seat #1 is the button
Seat 1: trumpcaddy ($11.28 in chips) 
Seat 2: SeaofLove ($17.55 in chips) 
Seat 3: ng2414 ($12.87 in chips) 
Seat 4: Jahlah1 ($7.85 in chips) 
Seat 5: KeithTurbo48 ($19.40 in chips) 
Seat 6: PlayTheBlues4U ($10.67 in chips) 
SeaofLove: posts small blind $0.05
ng2414: posts big blind $0.10
*** HOLE CARDS ***
Dealt to PlayTheBlues4U [7h Qd]
Jahlah1: calls $0.10
KeithTurbo48: folds 
PlayTheBlues4U: folds 
trumpcaddy: raises $0.40 to $0.50
SeaofLove: folds 
ng2414: folds 
Jahlah1: calls $0.40
*** FLOP *** [8c Jc Js]
Jahlah1: checks 
trumpcaddy: checks 
*** TURN *** [8c Jc Js] [9s]
Jahlah1: bets $0.40
trumpcaddy: folds 
Uncalled bet ($0.40) returned to Jahlah1
Jahlah1 collected $1.09 from pot
Jahlah1: doesn't show hand 
*** SUMMARY ***
Total pot $1.15 | Rake $0.06 
Board [8c Jc Js 9s]
Seat 1: trumpcaddy (button) folded on the Turn
Seat 2: SeaofLove (small blind) folded before Flop
Seat 3: ng2414 (big blind) folded before Flop
Seat 4: Jahlah1 collected ($1.09)
Seat 5: KeithTurbo48 folded before Flop (didn't bet)
Seat 6: PlayTheBlues4U folded before Flop (didn't bet)


PokerStars Hand #204909676456: Hold'em No Limit ($0.05/$0.10 USD) - 2019/10/22 22:36:50 ET
Table 'Celuta' 6-max Seat #6 is the button
Seat 1: trumpcaddy ($11.33 in chips) 
Seat 2: SeaofLove ($17.50 in chips) 
Seat 3: ng2414 ($12.87 in chips) 
Seat 4: Jahlah1 ($7.85 in chips) 
Seat 5: KeithTurbo48 ($19.40 in chips) 
Seat 6: PlayTheBlues4U ($10.67 in chips) 
trumpcaddy: posts small blind $0.05
SeaofLove: posts big blind $0.10
*** HOLE CARDS ***
Dealt to PlayTheBlues4U [2d 9h]
ng2414: folds 
Jahlah1: folds 
KeithTurbo48: folds 
PlayTheBlues4U: folds 
trumpcaddy: folds 
Uncalled bet ($0.05) returned to SeaofLove
SeaofLove collected $0.10 from pot
SeaofLove: doesn't show hand 
*** SUMMARY ***
Total pot $0.10 | Rake $0 
Seat 1: trumpcaddy (small blind) folded before Flop
Seat 2: SeaofLove (big blind) collected ($0.10)
Seat 3: ng2414 folded before Flop (didn't bet)
Seat 4: Jahlah1 folded before Flop (didn't bet)
Seat 5: KeithTurbo48 folded before Flop (didn't bet)
Seat 6: PlayTheBlues4U (button) folded before Flop (didn't bet)


PokerStars Hand #204909676332: Hold'em No Limit ($0.05/$0.10 USD) - 2019/10/22 22:36:19 ET
Table 'Danae' 6-max Seat #5 is the button
Seat 1: zombiehedgehog ($14.78 in chips) 
Seat 2: SeaofLove ($13 in chips) 
Seat 3: KeithTurbo48 ($9.82 in chips) 
Seat 4: ng2414 ($24.59 in chips) 
Seat 5: PlayTheBlues4U ($9.86 in chips) 
Seat 6: Donkey1206 ($9.90 in chips) 
Donkey1206: posts small blind $0.05
zombiehedgehog: posts big blind $0.10
*** HOLE CARDS ***
Dealt to PlayTheBlues4U [Kc Ah]
SeaofLove: folds 
KeithTurbo48: raises $0.15 to $0.25
ng2414: folds 
PlayTheBlues4U: raises $0.50 to $0.75
Donkey1206: folds 
zombiehedgehog: folds 
KeithTurbo48: calls $0.50
*** FLOP *** [Ts 3d 6h]
KeithTurbo48: checks 
PlayTheBlues4U: bets $0.90
KeithTurbo48: calls $0.90
*** TURN *** [Ts 3d 6h] [Qh]
KeithTurbo48: checks 
PlayTheBlues4U: checks 
*** RIVER *** [Ts 3d 6h Qh] [2d]
KeithTurbo48: checks 
PlayTheBlues4U: checks 
*** SHOW DOWN ***
KeithTurbo48: shows [As 6s] (a pair of Sixes)
PlayTheBlues4U: mucks hand 
KeithTurbo48 collected $3.28 from pot
*** SUMMARY ***
Total pot $3.45 | Rake $0.17 
Board [Ts 3d 6h Qh 2d]
Seat 1: zombiehedgehog (big blind) folded before Flop
Seat 2: SeaofLove folded before Flop (didn't bet)
Seat 3: KeithTurbo48 showed [As 6s] and won ($3.28) with a pair of Sixes
Seat 4: ng2414 folded before Flop (didn't bet)
Seat 5: PlayTheBlues4U (button) mucked [Kc Ah]
Seat 6: Donkey1206 (small blind) folded before Flop


PokerStars Hand #204909676205: Hold'em No Limit ($0.05/$0.10 USD) - 2019/10/22 22:35:48 ET
Table 'Celuta' 6-max Seat #5 is the button
Seat 1: trumpcaddy ($11.43 in chips) 
Seat 2: SeaofLove ($17.50 in chips) 
Seat 3: ng2414 ($12.87 in chips) 
Seat 4: Jahlah1 ($7.85 in chips) 
Seat 5: KeithTurbo48 ($20.15 in chips) 
Seat 6: PlayTheBlues4U ($9.90 in chips) 
PlayTheBlues4U: posts small blind $0.05
trumpcaddy: posts big blind $0.10
*** HOLE CARDS ***
Dealt to PlayTheBlues4U [Ah 5h]
SeaofLove: folds 
ng2414: folds 
Jahlah1: folds 
KeithTurbo48: raises $0.15 to $0.25
PlayTheBlues4U: raises $0.50 to $0.75
trumpcaddy: folds 
KeithTurbo48: calls $0.50
*** FLOP *** [7h Kd Ac]
PlayTheBlues4U: bets $0.90
KeithTurbo48: folds 
Uncalled bet ($0.90) returned to PlayTheBlues4U
PlayTheBlues4U collected $1.52 from pot
PlayTheBlues4U: doesn't show hand 
*** SUMMARY ***
Total pot $1.60 | Rake $0.08 
Board [7h Kd Ac]
Seat 1: trumpcaddy (big blind) folded before Flop
Seat 2: SeaofLove folded before Flop (didn't bet)
Seat 3: ng2414 folded before Flop (didn't bet)
Seat 4: Jahlah1 folded before Flop (didn't bet)
Seat 5: KeithTurbo48 (button) folded on the Flop
Seat 6: PlayTheBlues4U (small blind) collected ($1.52)


PokerStars Hand #204909676174: Hold'em No Limit ($0.05/$0.10 USD) - 2019/10/22 22:35:41 ET
Table 'Danae' 6-max Seat #4 is the button
Seat 1: zombiehedgehog ($14.88 in chips) 
Seat 2: SeaofLove ($12.36 in chips) 
Seat 3: KeithTurbo48 ($10.27 in chips) 
Seat 4: ng2414 ($24.59 in chips) 
Seat 5: PlayTheBlues4U ($9.91 in chips) 
Seat 6: Donkey1206 ($10 in chips) 
PlayTheBlues4U: posts small blind $0.05
Donkey1206: posts big blind $0.10
*** HOLE CARDS ***
Dealt to PlayTheBlues4U [7s Qd]
zombiehedgehog: calls $0.10
SeaofLove: raises $0.35 to $0.45
KeithTurbo48: calls $0.45
ng2414: folds 
PlayTheBlues4U: folds 
Donkey1206: folds 
zombiehedgehog: folds 
*** FLOP *** [8d Ks 2c]
SeaofLove: checks 
KeithTurbo48: checks 
*** TURN *** [8d Ks 2c] [Qs]
SeaofLove: bets $0.50
KeithTurbo48: folds 
Uncalled bet ($0.50) returned to SeaofLove
SeaofLove collected $1.09 from pot
SeaofLove: doesn't show hand 
*** SUMMARY ***
Total pot $1.15 | Rake $0.06 
Board [8d Ks 2c Qs]
Seat 1: zombiehedgehog folded before Flop
Seat 2: SeaofLove collected ($1.09)
Seat 3: KeithTurbo48 folded on the Turn
Seat 4: ng2414 (button) folded before Flop (didn't bet)
Seat 5: PlayTheBlues4U (small blind) folded before Flop
Seat 6: Donkey1206 (big blind) folded before Flop


PokerStars Hand #204909676086: Hold'em No Limit ($0.05/$0.10 USD) - 2019/10/22 22:35:22 ET
Table 'Celuta' 6-max Seat #4 is the button
Seat 1: trumpcaddy ($11.53 in chips) 
Seat 2: SeaofLove ($17.50 in chips) 
Seat 3: ng2414 ($12.87 in chips) 
Seat 4: Jahlah1 ($7.85 in chips) 
Seat 5: KeithTurbo48 ($19.97 in chips) 
Seat 6: PlayTheBlues4U ($10 in chips) 
KeithTurbo48: posts small blind $0.05
PlayTheBlues4U: posts big blind $0.10
*** HOLE CARDS ***
Dealt to PlayTheBlues4U [2h Jc]
trumpcaddy: calls $0.10
SeaofLove: folds 
ng2414: folds 
Jahlah1: folds 
KeithTurbo48: calls $0.05
PlayTheBlues4U: checks 
*** FLOP *** [4h As 7h]
KeithTurbo48: bets $0.20
PlayTheBlues4U: folds 
trumpcaddy: folds 
Uncalled bet ($0.20) returned to KeithTurbo48
KeithTurbo48 collected $0.28 from pot
KeithTurbo48: doesn't show hand 
*** SUMMARY ***
Total pot $0.30 | Rake $0.02 
Board [4h As 7h]
Seat 1: trumpcaddy folded on the Flop
Seat 2: SeaofLove folded before Flop (didn't bet)
Seat 3: ng2414 folded before Flop (didn't bet)
Seat 4: Jahlah1 (button) folded before Flop (didn't bet)
Seat 5: KeithTurbo48 (small blind) collected ($0.28)
Seat 6: PlayTheBlues4U (big blind) folded on the Flop


PokerStars Hand #204909676010: Hold'em No Limit ($0.05/$0.10 USD) - 2019/10/22 22:35:03 ET
Table 'Celuta' 6-max Seat #3 is the button
Seat 1: trumpcaddy ($11.53 in chips) 
Seat 2: SeaofLove ($17.50 in chips) 
Seat 3: ng2414 ($12.87 in chips) 
Seat 4: Jahlah1 ($7.90 in chips) 
Seat 5: KeithTurbo48 ($19.92 in chips) 
Seat 6: PlayTheBlues4U ($10 in chips) 
Jahlah1: posts small blind $0.05
KeithTurbo48: posts big blind $0.10
*** HOLE CARDS ***
Dealt to PlayTheBlues4U [8s 3s]
PlayTheBlues4U: folds 
trumpcaddy: folds 
SeaofLove: folds 
ng2414: folds 
Jahlah1: folds 
Uncalled bet ($0.05) returned to KeithTurbo48
KeithTurbo48 collected $0.10 from pot
KeithTurbo48: doesn't show hand 
*** SUMMARY ***
Total pot $0.10 | Rake $0 
Seat 1: trumpcaddy folded before Flop (didn't bet)
Seat 2: SeaofLove folded before Flop (didn't bet)
Seat 3: ng2414 (button) folded before Flop (didn't bet)
Seat 4: Jahlah1 (small blind) folded before Flop
Seat 5: KeithTurbo48 (big blind) collected ($0.10)
Seat 6: PlayTheBlues4U folded before Flop (didn't bet)


PokerStars Hand #204909675903: Hold'em No Limit ($0.05/$0.10 USD) - 2019/10/22 22:34:39 ET
Table 'Danae' 6-max Seat #3 is the button
Seat 1: zombiehedgehog ($15.18 in chips) 
Seat 2: SeaofLove ($12.36 in chips) 
Seat 3: KeithTurbo48 ($10.27 in chips) 
Seat 4: ng2414 ($24.69 in chips) 
Seat 5: PlayTheBlues4U ($9.55 in chips) 
Seat 6: Donkey1206 ($6.09 in chips) 
ng2414: posts small blind $0.05
PlayTheBlues4U: posts big blind $0.10
*** HOLE CARDS ***
Dealt to PlayTheBlues4U [Kh Qs]
Donkey1206: folds 
zombiehedgehog: calls $0.10
SeaofLove: folds 
KeithTurbo48: folds 
ng2414: calls $0.05
PlayTheBlues4U: raises $0.20 to $0.30
zombiehedgehog: calls $0.20
ng2414: folds 
*** FLOP *** [3c Js 9c]
PlayTheBlues4U: checks 
zombiehedgehog: checks 
*** TURN *** [3c Js 9c] [Ts]
PlayTheBlues4U: bets $0.50
zombiehedgehog: folds 
Uncalled bet ($0.50) returned to PlayTheBlues4U
PlayTheBlues4U collected $0.66 from pot
PlayTheBlues4U: doesn't show hand 
*** SUMMARY ***
Total pot $0.70 | Rake $0.04 
Board [3c Js 9c Ts]
Seat 1: zombiehedgehog folded on the Turn
Seat 2: SeaofLove folded before Flop (didn't bet)
Seat 3: KeithTurbo48 (button) folded before Flop (didn't bet)
Seat 4: ng2414 (small blind) folded before Flop
Seat 5: PlayTheBlues4U (big blind) collected ($0.66)
Seat 6: Donkey1206 folded before Flop (didn't bet)


PokerStars Hand #204909675662: Hold'em No Limit ($0.05/$0.10 USD) - 2019/10/22 22:33:43 ET
Table 'Danae' 6-max Seat #2 is the button
Seat 1: zombiehedgehog ($11.52 in chips) 
Seat 2: SeaofLove ($12.36 in chips) 
Seat 3: KeithTurbo48 ($10.32 in chips) 
Seat 4: ng2414 ($24.79 in chips) 
Seat 5: PlayTheBlues4U ($9.55 in chips) 
Seat 6: Donkey1206 ($10 in chips) 
KeithTurbo48: posts small blind $0.05
ng2414: posts big blind $0.10
*** HOLE CARDS ***
Dealt to PlayTheBlues4U [6h 7h]
PlayTheBlues4U: folds 
Donkey1206: raises $0.30 to $0.40
zombiehedgehog: calls $0.40
SeaofLove: folds 
KeithTurbo48: folds 
ng2414: folds 
*** FLOP *** [8h Ad 3s]
Donkey1206: checks 
zombiehedgehog: bets $0.90
Donkey1206: calls $0.90
*** TURN *** [8h Ad 3s] [Td]
Donkey1206: checks 
zombiehedgehog: bets $2.61
Donkey1206: calls $2.61
*** RIVER *** [8h Ad 3s Td] [Js]
Donkey1206: checks 
zombiehedgehog: checks 
*** SHOW DOWN ***
Donkey1206: shows [Qd As] (a pair of Aces)
zombiehedgehog: shows [Kh Ah] (a pair of Aces - King kicker)
zombiehedgehog collected $7.57 from pot
*** SUMMARY ***
Total pot $7.97 | Rake $0.40 
Board [8h Ad 3s Td Js]
Seat 1: zombiehedgehog showed [Kh Ah] and won ($7.57) with a pair of Aces
Seat 2: SeaofLove (button) folded before Flop (didn't bet)
Seat 3: KeithTurbo48 (small blind) folded before Flop
Seat 4: ng2414 (big blind) folded before Flop
Seat 5: PlayTheBlues4U folded before Flop (didn't bet)
Seat 6: Donkey1206 showed [Qd As] and lost with a pair of Aces


PokerStars Hand #204909675400: Hold'em No Limit ($0.05/$0.10 USD) - 2019/10/22 22:32:40 ET
Table 'Celuta' 6-max Seat #2 is the button
Seat 1: trumpcaddy ($11.53 in chips) 
Seat 2: SeaofLove ($17.50 in chips) 
Seat 3: ng2414 ($9.63 in chips) 
Seat 4: Jahlah1 ($8 in chips) 
Seat 5: KeithTurbo48 ($19.92 in chips) 
Seat 6: PlayTheBlues4U ($9.59 in chips) 
ng2414: posts small blind $0.05
Jahlah1: posts big blind $0.10
*** HOLE CARDS ***
Dealt to PlayTheBlues4U [Js Jc]
KeithTurbo48: folds 
PlayTheBlues4U: raises $0.20 to $0.30
trumpcaddy: folds 
SeaofLove: folds 
ng2414: raises $0.70 to $1
Jahlah1: folds 
PlayTheBlues4U: calls $0.70
*** FLOP *** [4h Th 2s]
ng2414: bets $0.80
PlayTheBlues4U: calls $0.80
*** TURN *** [4h Th 2s] [6d]
ng2414: bets $1.70
PlayTheBlues4U: calls $1.70
*** RIVER *** [4h Th 2s 6d] [9h]
ng2414: bets $3.50
PlayTheBlues4U: folds 
Uncalled bet ($3.50) returned to ng2414
ng2414 collected $6.74 from pot
*** SUMMARY ***
Total pot $7.10 | Rake $0.36 
Board [4h Th 2s 6d 9h]
Seat 1: trumpcaddy folded before Flop (didn't bet)
Seat 2: SeaofLove (button) folded before Flop (didn't bet)
Seat 3: ng2414 (small blind) collected ($6.74)
Seat 4: Jahlah1 (big blind) folded before Flop
Seat 5: KeithTurbo48 folded before Flop (didn't bet)
Seat 6: PlayTheBlues4U folded on the River


PokerStars Hand #204909675355: Hold'em No Limit ($0.05/$0.10 USD) - 2019/10/22 22:32:29 ET
Table 'Danae' 6-max Seat #1 is the button
Seat 1: zombiehedgehog ($10.12 in chips) 
Seat 2: SeaofLove ($12.41 in chips) 
Seat 3: KeithTurbo48 ($10.42 in chips) 
Seat 4: ng2414 ($24.79 in chips) 
Seat 5: PlayTheBlues4U ($9.55 in chips) 
Seat 6: Donkey1206 ($9.85 in chips) 
SeaofLove: posts small blind $0.05
KeithTurbo48: posts big blind $0.10
*** HOLE CARDS ***
Dealt to PlayTheBlues4U [9c Ad]
ng2414: folds 
PlayTheBlues4U: folds 
Donkey1206: calls $0.10
zombiehedgehog: raises $0.35 to $0.45
SeaofLove: folds 
KeithTurbo48: folds 
Donkey1206: calls $0.35
*** FLOP *** [8d Ks 5h]
Donkey1206: checks 
zombiehedgehog: bets $0.25
Donkey1206: calls $0.25
*** TURN *** [8d Ks 5h] [8c]
Donkey1206: checks 
zombiehedgehog: checks 
*** RIVER *** [8d Ks 5h 8c] [2d]
Donkey1206: bets $0.70
zombiehedgehog: raises $2.87 to $3.57
Donkey1206: folds 
Uncalled bet ($2.87) returned to zombiehedgehog
zombiehedgehog collected $2.80 from pot
zombiehedgehog: doesn't show hand 
*** SUMMARY ***
Total pot $2.95 | Rake $0.15 
Board [8d Ks 5h 8c 2d]
Seat 1: zombiehedgehog (button) collected ($2.80)
Seat 2: SeaofLove (small blind) folded before Flop
Seat 3: KeithTurbo48 (big blind) folded before Flop
Seat 4: ng2414 folded before Flop (didn't bet)
Seat 5: PlayTheBlues4U folded before Flop (didn't bet)
Seat 6: Donkey1206 folded on the River


PokerStars Hand #204909675281: Hold'em No Limit ($0.05/$0.10 USD) - 2019/10/22 22:32:11 ET
Table 'Danae' 6-max Seat #6 is the button
Seat 1: zombiehedgehog ($10.17 in chips) 
Seat 2: SeaofLove ($12.51 in chips) 
Seat 3: KeithTurbo48 ($10.42 in chips) 
Seat 4: ng2414 ($24.64 in chips) 
Seat 5: PlayTheBlues4U ($9.55 in chips) 
Seat 6: Donkey1206 ($9.85 in chips) 
zombiehedgehog: posts small blind $0.05
SeaofLove: posts big blind $0.10
*** HOLE CARDS ***
Dealt to PlayTheBlues4U [6c 2c]
KeithTurbo48: folds 
ng2414: raises $0.20 to $0.30
PlayTheBlues4U: folds 
Donkey1206: folds 
zombiehedgehog: folds 
SeaofLove: folds 
Uncalled bet ($0.20) returned to ng2414
ng2414 collected $0.25 from pot
*** SUMMARY ***
Total pot $0.25 | Rake $0 
Seat 1: zombiehedgehog (small blind) folded before Flop
Seat 2: SeaofLove (big blind) folded before Flop
Seat 3: KeithTurbo48 folded before Flop (didn't bet)
Seat 4: ng2414 collected ($0.25)
Seat 5: PlayTheBlues4U folded before Flop (didn't bet)
Seat 6: Donkey1206 (button) folded before Flop (didn't bet)


PokerStars Hand #204909675242: Hold'em No Limit ($0.05/$0.10 USD) - 2019/10/22 22:32:03 ET
Table 'Celuta' 6-max Seat #1 is the button
Seat 1: trumpcaddy ($11.53 in chips) 
Seat 2: SeaofLove ($17.55 in chips) 
Seat 3: ng2414 ($8.53 in chips) 
Seat 5: KeithTurbo48 ($20.17 in chips) 
Seat 6: PlayTheBlues4U ($10.49 in chips) 
SeaofLove: posts small blind $0.05
ng2414: posts big blind $0.10
*** HOLE CARDS ***
Dealt to PlayTheBlues4U [2s 2c]
KeithTurbo48: raises $0.15 to $0.25
PlayTheBlues4U: calls $0.25
trumpcaddy: folds 
SeaofLove: folds 
ng2414: raises $0.65 to $0.90
Jahlah1 joins the table at seat #4 
KeithTurbo48: folds 
PlayTheBlues4U: calls $0.65
*** FLOP *** [Js Qs 4d]
ng2414: bets $0.80
PlayTheBlues4U: folds 
Uncalled bet ($0.80) returned to ng2414
ng2414 collected $2 from pot
*** SUMMARY ***
Total pot $2.10 | Rake $0.10 
Board [Js Qs 4d]
Seat 1: trumpcaddy (button) folded before Flop (didn't bet)
Seat 2: SeaofLove (small blind) folded before Flop
Seat 3: ng2414 (big blind) collected ($2)
Seat 5: KeithTurbo48 folded before Flop
Seat 6: PlayTheBlues4U folded on the Flop


PokerStars Hand #204909675140: Hold'em No Limit ($0.05/$0.10 USD) - 2019/10/22 22:31:38 ET
Table 'Celuta' 6-max Seat #6 is the button
Seat 1: trumpcaddy ($11.58 in chips) 
Seat 2: SeaofLove ($17.80 in chips) 
Seat 3: ng2414 ($8.53 in chips) 
Seat 4: pancakes1912 ($11.28 in chips) 
Seat 5: KeithTurbo48 ($19.90 in chips) 
Seat 6: PlayTheBlues4U ($10.49 in chips) 
trumpcaddy: posts small blind $0.05
SeaofLove: posts big blind $0.10
*** HOLE CARDS ***
Dealt to PlayTheBlues4U [6s 8d]
ng2414: folds 
pancakes1912: folds 
pancakes1912 leaves the table
KeithTurbo48: raises $0.15 to $0.25
PlayTheBlues4U: folds 
trumpcaddy: folds 
SeaofLove: calls $0.15
*** FLOP *** [2c 8h Ac]
SeaofLove: checks 
KeithTurbo48: bets $0.17
SeaofLove: folds 
Uncalled bet ($0.17) returned to KeithTurbo48
KeithTurbo48 collected $0.52 from pot
KeithTurbo48: doesn't show hand 
*** SUMMARY ***
Total pot $0.55 | Rake $0.03 
Board [2c 8h Ac]
Seat 1: trumpcaddy (small blind) folded before Flop
Seat 2: SeaofLove (big blind) folded on the Flop
Seat 3: ng2414 folded before Flop (didn't bet)
Seat 4: pancakes1912 folded before Flop (didn't bet)
Seat 5: KeithTurbo48 collected ($0.52)
Seat 6: PlayTheBlues4U (button) folded before Flop (didn't bet)


PokerStars Hand #204909675101: Hold'em No Limit ($0.05/$0.10 USD) - 2019/10/22 22:31:29 ET
Table 'Danae' 6-max Seat #5 is the button
Seat 1: zombiehedgehog ($11.57 in chips) 
Seat 2: SeaofLove ($12.51 in chips) 
Seat 3: KeithTurbo48 ($10.42 in chips) 
Seat 4: ng2414 ($23.33 in chips) 
Seat 5: PlayTheBlues4U ($9.55 in chips) 
Seat 6: Donkey1206 ($9.90 in chips) 
Donkey1206: posts small blind $0.05
zombiehedgehog: posts big blind $0.10
*** HOLE CARDS ***
Dealt to PlayTheBlues4U [Qd 3d]
SeaofLove: folds 
KeithTurbo48: folds 
ng2414: raises $0.20 to $0.30
PlayTheBlues4U: folds 
Donkey1206: folds 
zombiehedgehog: calls $0.20
*** FLOP *** [Js As Jc]
zombiehedgehog: checks 
ng2414: bets $0.40
zombiehedgehog: calls $0.40
*** TURN *** [Js As Jc] [Kd]
zombiehedgehog: checks 
ng2414: bets $0.70
zombiehedgehog: calls $0.70
*** RIVER *** [Js As Jc Kd] [8d]
zombiehedgehog: checks 
ng2414: checks 
*** SHOW DOWN ***
zombiehedgehog: shows [8s Ts] (two pair, Jacks and Eights)
ng2414: shows [Ks 5s] (two pair, Kings and Jacks)
ng2414 collected $2.71 from pot
*** SUMMARY ***
Total pot $2.85 | Rake $0.14 
Board [Js As Jc Kd 8d]
Seat 1: zombiehedgehog (big blind) showed [8s Ts] and lost with two pair, Jacks and Eights
Seat 2: SeaofLove folded before Flop (didn't bet)
Seat 3: KeithTurbo48 folded before Flop (didn't bet)
Seat 4: ng2414 showed [Ks 5s] and won ($2.71) with two pair, Kings and Jacks
Seat 5: PlayTheBlues4U (button) folded before Flop (didn't bet)
Seat 6: Donkey1206 (small blind) folded before Flop


PokerStars Hand #204909675013: Hold'em No Limit ($0.05/$0.10 USD) - 2019/10/22 22:31:09 ET
Table 'Danae' 6-max Seat #4 is the button
Seat 1: zombiehedgehog ($11.57 in chips) 
Seat 2: SeaofLove ($12.36 in chips) 
Seat 3: KeithTurbo48 ($10.42 in chips) 
Seat 4: ng2414 ($23.33 in chips) 
Seat 5: PlayTheBlues4U ($9.60 in chips) 
Seat 6: Donkey1206 ($10 in chips) 
PlayTheBlues4U: posts small blind $0.05
Donkey1206: posts big blind $0.10
*** HOLE CARDS ***
Dealt to PlayTheBlues4U [5d 8d]
zombiehedgehog: folds 
SeaofLove: raises $0.15 to $0.25
KeithTurbo48: folds 
ng2414: folds 
PlayTheBlues4U: folds 
Donkey1206: folds 
Uncalled bet ($0.15) returned to SeaofLove
SeaofLove collected $0.25 from pot
SeaofLove: doesn't show hand 
*** SUMMARY ***
Total pot $0.25 | Rake $0 
Seat 1: zombiehedgehog folded before Flop (didn't bet)
Seat 2: SeaofLove collected ($0.25)
Seat 3: KeithTurbo48 folded before Flop (didn't bet)
Seat 4: ng2414 (button) folded before Flop (didn't bet)
Seat 5: PlayTheBlues4U (small blind) folded before Flop
Seat 6: Donkey1206 (big blind) folded before Flop


PokerStars Hand #204909674838: Hold'em No Limit ($0.05/$0.10 USD) - 2019/10/22 22:30:29 ET
Table 'Celuta' 6-max Seat #5 is the button
Seat 1: trumpcaddy ($10.15 in chips) 
Seat 2: SeaofLove ($17.80 in chips) 
Seat 3: ng2414 ($8.53 in chips) 
Seat 4: pancakes1912 ($12.82 in chips) 
Seat 5: KeithTurbo48 ($19.90 in chips) 
Seat 6: PlayTheBlues4U ($10.54 in chips) 
PlayTheBlues4U: posts small blind $0.05
trumpcaddy: posts big blind $0.10
*** HOLE CARDS ***
Dealt to PlayTheBlues4U [7d Jh]
SeaofLove: folds 
ng2414: folds 
pancakes1912: calls $0.10
KeithTurbo48: folds 
PlayTheBlues4U: folds 
trumpcaddy: checks 
*** FLOP *** [Td 9c 3h]
trumpcaddy: checks 
pancakes1912: checks 
*** TURN *** [Td 9c 3h] [Kc]
trumpcaddy: checks 
pancakes1912: bets $0.20
trumpcaddy: calls $0.20
*** RIVER *** [Td 9c 3h Kc] [Jc]
trumpcaddy: bets $0.62
pancakes1912: raises $0.62 to $1.24
trumpcaddy: calls $0.62
*** SHOW DOWN ***
pancakes1912: shows [6c 4c] (a flush, King high)
trumpcaddy: shows [3c Qc] (a flush, King high - Queen higher)
trumpcaddy collected $2.97 from pot
*** SUMMARY ***
Total pot $3.13 | Rake $0.16 
Board [Td 9c 3h Kc Jc]
Seat 1: trumpcaddy (big blind) showed [3c Qc] and won ($2.97) with a flush, King high
Seat 2: SeaofLove folded before Flop (didn't bet)
Seat 3: ng2414 folded before Flop (didn't bet)
Seat 4: pancakes1912 showed [6c 4c] and lost with a flush, King high
Seat 5: KeithTurbo48 (button) folded before Flop (didn't bet)
Seat 6: PlayTheBlues4U (small blind) folded before Flop


PokerStars Hand #204909674806: Hold'em No Limit ($0.05/$0.10 USD) - 2019/10/22 22:30:19 ET
Table 'Danae' 6-max Seat #3 is the button
Seat 1: zombiehedgehog ($11.57 in chips) 
Seat 2: SeaofLove ($12.36 in chips) 
Seat 3: KeithTurbo48 ($10.84 in chips) 
Seat 4: ng2414 ($23.38 in chips) 
Seat 5: PlayTheBlues4U ($9.17 in chips) 
ng2414: posts small blind $0.05
PlayTheBlues4U: posts big blind $0.10
*** HOLE CARDS ***
Dealt to PlayTheBlues4U [Qd Ts]
zombiehedgehog: folds 
SeaofLove: folds 
KeithTurbo48: raises $0.15 to $0.25
ng2414: folds 
Donkey1206 joins the table at seat #6 
PlayTheBlues4U: calls $0.15
*** FLOP *** [6s Ac 3d]
PlayTheBlues4U: checks 
KeithTurbo48: bets $0.17
PlayTheBlues4U: calls $0.17
*** TURN *** [6s Ac 3d] [4c]
PlayTheBlues4U: checks 
KeithTurbo48: checks 
*** RIVER *** [6s Ac 3d 4c] [2s]
PlayTheBlues4U: bets $0.60
KeithTurbo48: folds 
Uncalled bet ($0.60) returned to PlayTheBlues4U
PlayTheBlues4U collected $0.85 from pot
PlayTheBlues4U: doesn't show hand 
*** SUMMARY ***
Total pot $0.89 | Rake $0.04 
Board [6s Ac 3d 4c 2s]
Seat 1: zombiehedgehog folded before Flop (didn't bet)
Seat 2: SeaofLove folded before Flop (didn't bet)
Seat 3: KeithTurbo48 (button) folded on the River
Seat 4: ng2414 (small blind) folded before Flop
Seat 5: PlayTheBlues4U (big blind) collected ($0.85)


PokerStars Hand #204909674774: Hold'em No Limit ($0.05/$0.10 USD) - 2019/10/22 22:30:13 ET
Table 'Celuta' 6-max Seat #4 is the button
Seat 1: trumpcaddy ($10 in chips) 
Seat 2: SeaofLove ($17.80 in chips) 
Seat 3: ng2414 ($8.53 in chips) 
Seat 4: pancakes1912 ($12.82 in chips) 
Seat 5: KeithTurbo48 ($19.95 in chips) 
Seat 6: PlayTheBlues4U ($10.64 in chips) 
KeithTurbo48: posts small blind $0.05
PlayTheBlues4U: posts big blind $0.10
*** HOLE CARDS ***
Dealt to PlayTheBlues4U [Qh 5h]
trumpcaddy: raises $0.20 to $0.30
SeaofLove: folds 
ng2414: folds 
pancakes1912: folds 
KeithTurbo48: folds 
PlayTheBlues4U: folds 
Uncalled bet ($0.20) returned to trumpcaddy
trumpcaddy collected $0.25 from pot
trumpcaddy: doesn't show hand 
*** SUMMARY ***
Total pot $0.25 | Rake $0 
Seat 1: trumpcaddy collected ($0.25)
Seat 2: SeaofLove folded before Flop (didn't bet)
Seat 3: ng2414 folded before Flop (didn't bet)
Seat 4: pancakes1912 (button) folded before Flop (didn't bet)
Seat 5: KeithTurbo48 (small blind) folded before Flop
Seat 6: PlayTheBlues4U (big blind) folded before Flop


PokerStars Hand #204909674732: Hold'em No Limit ($0.05/$0.10 USD) - 2019/10/22 22:30:02 ET
Table 'Danae' 6-max Seat #2 is the button
Seat 1: zombiehedgehog ($11.57 in chips) 
Seat 2: SeaofLove ($12.21 in chips) 
Seat 3: KeithTurbo48 ($10.89 in chips) 
Seat 4: ng2414 ($23.48 in chips) 
Seat 5: PlayTheBlues4U ($9.17 in chips) 
KeithTurbo48: posts small blind $0.05
ng2414: posts big blind $0.10
*** HOLE CARDS ***
Dealt to PlayTheBlues4U [8s Jh]
PlayTheBlues4U: folds 
zombiehedgehog: folds 
SeaofLove: raises $0.15 to $0.25
KeithTurbo48: folds 
ng2414: folds 
Uncalled bet ($0.15) returned to SeaofLove
SeaofLove collected $0.25 from pot
SeaofLove: doesn't show hand 
*** SUMMARY ***
Total pot $0.25 | Rake $0 
Seat 1: zombiehedgehog folded before Flop (didn't bet)
Seat 2: SeaofLove (button) collected ($0.25)
Seat 3: KeithTurbo48 (small blind) folded before Flop
Seat 4: ng2414 (big blind) folded before Flop
Seat 5: PlayTheBlues4U folded before Flop (didn't bet)


PokerStars Hand #204909674592: Hold'em No Limit ($0.05/$0.10 USD) - 2019/10/22 22:29:25 ET
Table 'Danae' 6-max Seat #1 is the button
Seat 1: zombiehedgehog ($11.57 in chips) 
Seat 2: SeaofLove ($12.26 in chips) 
Seat 3: KeithTurbo48 ($10.84 in chips) 
Seat 4: ng2414 ($23.48 in chips) 
Seat 5: PlayTheBlues4U ($9.17 in chips) 
Seat 6: x Aristokat x ($9.53 in chips) 
SeaofLove: posts small blind $0.05
KeithTurbo48: posts big blind $0.10
*** HOLE CARDS ***
Dealt to PlayTheBlues4U [4s Kh]
ng2414: folds 
PlayTheBlues4U: folds 
x Aristokat x has timed out while disconnected
x Aristokat x: folds 
zombiehedgehog: folds 
x Aristokat x leaves the table
SeaofLove: folds 
Uncalled bet ($0.05) returned to KeithTurbo48
KeithTurbo48 collected $0.10 from pot
KeithTurbo48: doesn't show hand 
*** SUMMARY ***
Total pot $0.10 | Rake $0 
Seat 1: zombiehedgehog (button) folded before Flop (didn't bet)
Seat 2: SeaofLove (small blind) folded before Flop
Seat 3: KeithTurbo48 (big blind) collected ($0.10)
Seat 4: ng2414 folded before Flop (didn't bet)
Seat 5: PlayTheBlues4U folded before Flop (didn't bet)
Seat 6: x Aristokat x folded before Flop (didn't bet)


PokerStars Hand #204909674535: Hold'em No Limit ($0.05/$0.10 USD) - 2019/10/22 22:29:11 ET
Table 'Celuta' 6-max Seat #3 is the button
Seat 1: trumpcaddy ($10 in chips) 
Seat 2: SeaofLove ($17.80 in chips) 
Seat 3: ng2414 ($8.53 in chips) 
Seat 4: pancakes1912 ($13.12 in chips) 
Seat 5: KeithTurbo48 ($19.68 in chips) 
Seat 6: PlayTheBlues4U ($10.64 in chips) 
pancakes1912: posts small blind $0.05
KeithTurbo48: posts big blind $0.10
*** HOLE CARDS ***
Dealt to PlayTheBlues4U [Tc 6c]
PlayTheBlues4U: folds 
trumpcaddy: folds 
SeaofLove: folds 
ng2414: folds 
pancakes1912: calls $0.05
KeithTurbo48: checks 
*** FLOP *** [6d Ks Qc]
pancakes1912: checks 
KeithTurbo48: checks 
*** TURN *** [6d Ks Qc] [Jc]
pancakes1912: checks 
KeithTurbo48: checks 
*** RIVER *** [6d Ks Qc Jc] [5d]
pancakes1912: bets $0.20
KeithTurbo48: calls $0.20
*** SHOW DOWN ***
pancakes1912: shows [2c 3c] (high card King)
KeithTurbo48: shows [Jd 7c] (a pair of Jacks)
KeithTurbo48 collected $0.57 from pot
*** SUMMARY ***
Total pot $0.60 | Rake $0.03 
Board [6d Ks Qc Jc 5d]
Seat 1: trumpcaddy folded before Flop (didn't bet)
Seat 2: SeaofLove folded before Flop (didn't bet)
Seat 3: ng2414 (button) folded before Flop (didn't bet)
Seat 4: pancakes1912 (small blind) showed [2c 3c] and lost with high card King
Seat 5: KeithTurbo48 (big blind) showed [Jd 7c] and won ($0.57) with a pair of Jacks
Seat 6: PlayTheBlues4U folded before Flop (didn't bet)


PokerStars Hand #204909674392: Hold'em No Limit ($0.05/$0.10 USD) - 2019/10/22 22:28:40 ET
Table 'Danae' 6-max Seat #6 is the button
Seat 1: zombiehedgehog ($11.62 in chips) 
Seat 2: SeaofLove ($12.36 in chips) 
Seat 3: KeithTurbo48 ($9.10 in chips) 
Seat 4: ng2414 ($23.48 in chips) 
Seat 5: PlayTheBlues4U ($9.17 in chips) 
Seat 6: x Aristokat x ($11.30 in chips) 
zombiehedgehog: posts small blind $0.05
SeaofLove: posts big blind $0.10
*** HOLE CARDS ***
Dealt to PlayTheBlues4U [6c Kd]
KeithTurbo48: raises $0.15 to $0.25
ng2414: folds 
PlayTheBlues4U: folds 
x Aristokat x: calls $0.25
zombiehedgehog: folds 
SeaofLove: folds 
*** FLOP *** [3h 9c 8d]
KeithTurbo48: checks 
x Aristokat x: bets $0.31
KeithTurbo48: calls $0.31
*** TURN *** [3h 9c 8d] [2s]
KeithTurbo48: checks 
x Aristokat x: bets $1.21
KeithTurbo48: raises $2.69 to $3.90
x Aristokat x: folds 
Uncalled bet ($2.69) returned to KeithTurbo48
KeithTurbo48 collected $3.51 from pot
KeithTurbo48: doesn't show hand 
*** SUMMARY ***
Total pot $3.69 | Rake $0.18 
Board [3h 9c 8d 2s]
Seat 1: zombiehedgehog (small blind) folded before Flop
Seat 2: SeaofLove (big blind) folded before Flop
Seat 3: KeithTurbo48 collected ($3.51)
Seat 4: ng2414 folded before Flop (didn't bet)
Seat 5: PlayTheBlues4U folded before Flop (didn't bet)
Seat 6: x Aristokat x (button) folded on the Turn


PokerStars Hand #204909674302: Hold'em No Limit ($0.05/$0.10 USD) - 2019/10/22 22:28:17 ET
Table 'Celuta' 6-max Seat #2 is the button
Seat 1: trumpcaddy ($10 in chips) 
Seat 2: SeaofLove ($17.80 in chips) 
Seat 3: ng2414 ($8.58 in chips) 
Seat 4: pancakes1912 ($12.80 in chips) 
Seat 5: KeithTurbo48 ($19.68 in chips) 
Seat 6: PlayTheBlues4U ($10.94 in chips) 
ng2414: posts small blind $0.05
pancakes1912: posts big blind $0.10
*** HOLE CARDS ***
Dealt to PlayTheBlues4U [8d 9d]
KeithTurbo48: folds 
PlayTheBlues4U: raises $0.20 to $0.30
trumpcaddy has timed out
trumpcaddy: folds 
SeaofLove: folds 
ng2414: folds 
pancakes1912: calls $0.20
*** FLOP *** [Tc 3h Ac]
pancakes1912: bets $0.50
PlayTheBlues4U: folds 
Uncalled bet ($0.50) returned to pancakes1912
pancakes1912 collected $0.62 from pot
*** SUMMARY ***
Total pot $0.65 | Rake $0.03 
Board [Tc 3h Ac]
Seat 1: trumpcaddy folded before Flop (didn't bet)
Seat 2: SeaofLove (button) folded before Flop (didn't bet)
Seat 3: ng2414 (small blind) folded before Flop
Seat 4: pancakes1912 (big blind) collected ($0.62)
Seat 5: KeithTurbo48 folded before Flop (didn't bet)
Seat 6: PlayTheBlues4U folded on the Flop


PokerStars Hand #204909674255: Hold'em No Limit ($0.05/$0.10 USD) - 2019/10/22 22:28:03 ET
Table 'Danae' 6-max Seat #5 is the button
Seat 1: zombiehedgehog ($11.72 in chips) 
Seat 2: SeaofLove ($11.16 in chips) 
Seat 3: KeithTurbo48 ($10.27 in chips) 
Seat 4: ng2414 ($23.48 in chips) 
Seat 5: PlayTheBlues4U ($9.17 in chips) 
Seat 6: x Aristokat x ($11.35 in chips) 
x Aristokat x: posts small blind $0.05
zombiehedgehog: posts big blind $0.10
*** HOLE CARDS ***
Dealt to PlayTheBlues4U [3c 9h]
SeaofLove: raises $0.15 to $0.25
KeithTurbo48: calls $0.25
ng2414: folds 
PlayTheBlues4U: folds 
x Aristokat x: folds 
zombiehedgehog: folds 
*** FLOP *** [Ac 3d Js]
SeaofLove: bets $0.31
KeithTurbo48: calls $0.31
*** TURN *** [Ac 3d Js] [9d]
SeaofLove: bets $0.61
KeithTurbo48: calls $0.61
*** RIVER *** [Ac 3d Js 9d] [2d]
SeaofLove: bets $0.80
KeithTurbo48: folds 
Uncalled bet ($0.80) returned to SeaofLove
SeaofLove collected $2.37 from pot
SeaofLove: doesn't show hand 
*** SUMMARY ***
Total pot $2.49 | Rake $0.12 
Board [Ac 3d Js 9d 2d]
Seat 1: zombiehedgehog (big blind) folded before Flop
Seat 2: SeaofLove collected ($2.37)
Seat 3: KeithTurbo48 folded on the River
Seat 4: ng2414 folded before Flop (didn't bet)
Seat 5: PlayTheBlues4U (button) folded before Flop (didn't bet)
Seat 6: x Aristokat x (small blind) folded before Flop


PokerStars Hand #204909674119: Hold'em No Limit ($0.05/$0.10 USD) - 2019/10/22 22:27:32 ET
Table 'Celuta' 6-max Seat #1 is the button
Seat 1: trumpcaddy ($4.95 in chips) 
Seat 2: SeaofLove ($17.85 in chips) 
Seat 3: ng2414 ($8.68 in chips) 
Seat 4: pancakes1912 ($14.17 in chips) 
Seat 5: KeithTurbo48 ($18.30 in chips) 
Seat 6: PlayTheBlues4U ($10.94 in chips) 
SeaofLove: posts small blind $0.05
ng2414: posts big blind $0.10
*** HOLE CARDS ***
Dealt to PlayTheBlues4U [Tc 2c]
pancakes1912: calls $0.10
KeithTurbo48: raises $0.30 to $0.40
PlayTheBlues4U: folds 
trumpcaddy: folds 
SeaofLove: folds 
ng2414: folds 
pancakes1912: calls $0.30
*** FLOP *** [4h 9d 8s]
pancakes1912: checks 
KeithTurbo48: bets $0.67
pancakes1912: calls $0.67
*** TURN *** [4h 9d 8s] [2s]
pancakes1912: bets $0.30
KeithTurbo48: raises $1.90 to $2.20
pancakes1912: folds 
Uncalled bet ($1.90) returned to KeithTurbo48
KeithTurbo48 collected $2.75 from pot
KeithTurbo48: doesn't show hand 
*** SUMMARY ***
Total pot $2.89 | Rake $0.14 
Board [4h 9d 8s 2s]
Seat 1: trumpcaddy (button) folded before Flop (didn't bet)
Seat 2: SeaofLove (small blind) folded before Flop
Seat 3: ng2414 (big blind) folded before Flop
Seat 4: pancakes1912 folded on the Turn
Seat 5: KeithTurbo48 collected ($2.75)
Seat 6: PlayTheBlues4U folded before Flop (didn't bet)


PokerStars Hand #204909673993: Hold'em No Limit ($0.05/$0.10 USD) - 2019/10/22 22:27:02 ET
Table 'Danae' 6-max Seat #4 is the button
Seat 1: zombiehedgehog ($12.45 in chips) 
Seat 2: SeaofLove ($11.16 in chips) 
Seat 3: KeithTurbo48 ($10.27 in chips) 
Seat 4: ng2414 ($23.48 in chips) 
Seat 5: PlayTheBlues4U ($9.90 in chips) 
Seat 6: x Aristokat x ($10 in chips) 
PlayTheBlues4U: posts small blind $0.05
x Aristokat x: posts big blind $0.10
*** HOLE CARDS ***
Dealt to PlayTheBlues4U [Ah 5c]
zombiehedgehog: calls $0.10
SeaofLove: folds 
KeithTurbo48: folds 
ng2414: folds 
PlayTheBlues4U: calls $0.05
x Aristokat x: raises $0.20 to $0.30
zombiehedgehog: calls $0.20
PlayTheBlues4U: calls $0.20
*** FLOP *** [Td 7h As]
PlayTheBlues4U: checks 
x Aristokat x: bets $0.43
zombiehedgehog: calls $0.43
PlayTheBlues4U: calls $0.43
*** TURN *** [Td 7h As] [2s]
PlayTheBlues4U: checks 
x Aristokat x: checks 
zombiehedgehog: checks 
*** RIVER *** [Td 7h As 2s] [Js]
PlayTheBlues4U: checks 
x Aristokat x: bets $2.08
zombiehedgehog: folds 
PlayTheBlues4U: folds 
Uncalled bet ($2.08) returned to x Aristokat x
x Aristokat x collected $2.08 from pot
x Aristokat x: doesn't show hand 
*** SUMMARY ***
Total pot $2.19 | Rake $0.11 
Board [Td 7h As 2s Js]
Seat 1: zombiehedgehog folded on the River
Seat 2: SeaofLove folded before Flop (didn't bet)
Seat 3: KeithTurbo48 folded before Flop (didn't bet)
Seat 4: ng2414 (button) folded before Flop (didn't bet)
Seat 5: PlayTheBlues4U (small blind) folded on the River
Seat 6: x Aristokat x (big blind) collected ($2.08)


PokerStars Hand #204909673944: Hold'em No Limit ($0.05/$0.10 USD) - 2019/10/22 22:26:47 ET
Table 'Celuta' 6-max Seat #6 is the button
Seat 1: trumpcaddy ($11.91 in chips) 
Seat 2: SeaofLove ($18.85 in chips) 
Seat 3: ng2414 ($8.68 in chips) 
Seat 4: pancakes1912 ($6.96 in chips) 
Seat 5: KeithTurbo48 ($18.30 in chips) 
Seat 6: PlayTheBlues4U ($10.94 in chips) 
trumpcaddy: posts small blind $0.05
SeaofLove: posts big blind $0.10
*** HOLE CARDS ***
Dealt to PlayTheBlues4U [4s Ac]
ng2414: folds 
pancakes1912: raises $0.10 to $0.20
KeithTurbo48: folds 
PlayTheBlues4U: folds 
trumpcaddy: raises $0.80 to $1
SeaofLove: calls $0.90
pancakes1912: calls $0.80
*** FLOP *** [Td Qh 5d]
trumpcaddy: bets $2.85
SeaofLove: folds 
pancakes1912: raises $3.11 to $5.96 and is all-in
trumpcaddy: calls $3.11
*** TURN *** [Td Qh 5d] [6h]
*** RIVER *** [Td Qh 5d 6h] [6d]
*** SHOW DOWN ***
trumpcaddy: shows [Ad As] (two pair, Aces and Sixes)
pancakes1912: shows [4d 9d] (a flush, Ten high)
pancakes1912 collected $14.17 from pot
*** SUMMARY ***
Total pot $14.92 | Rake $0.75 
Board [Td Qh 5d 6h 6d]
Seat 1: trumpcaddy (small blind) showed [Ad As] and lost with two pair, Aces and Sixes
Seat 2: SeaofLove (big blind) folded on the Flop
Seat 3: ng2414 folded before Flop (didn't bet)
Seat 4: pancakes1912 showed [4d 9d] and won ($14.17) with a flush, Ten high
Seat 5: KeithTurbo48 folded before Flop (didn't bet)
Seat 6: PlayTheBlues4U (button) folded before Flop (didn't bet)


PokerStars Hand #204909673876: Hold'em No Limit ($0.05/$0.10 USD) - 2019/10/22 22:26:32 ET
Table 'Danae' 6-max Seat #3 is the button
Seat 1: zombiehedgehog ($13.15 in chips) 
Seat 2: SeaofLove ($11.16 in chips) 
Seat 3: KeithTurbo48 ($9.50 in chips) 
Seat 4: ng2414 ($23.53 in chips) 
Seat 5: PlayTheBlues4U ($10 in chips) 
ng2414: posts small blind $0.05
PlayTheBlues4U: posts big blind $0.10
*** HOLE CARDS ***
Dealt to PlayTheBlues4U [Jc 9d]
zombiehedgehog: raises $0.20 to $0.30
SeaofLove: folds 
KeithTurbo48: raises $0.40 to $0.70
ng2414: folds 
PlayTheBlues4U: folds 
zombiehedgehog: calls $0.40
*** FLOP *** [9h Ad 2h]
x Aristokat x joins the table at seat #6 
zombiehedgehog: checks 
KeithTurbo48: bets $0.50
zombiehedgehog: folds 
Uncalled bet ($0.50) returned to KeithTurbo48
KeithTurbo48 collected $1.47 from pot
KeithTurbo48: doesn't show hand 
*** SUMMARY ***
Total pot $1.55 | Rake $0.08 
Board [9h Ad 2h]
Seat 1: zombiehedgehog folded on the Flop
Seat 2: SeaofLove folded before Flop (didn't bet)
Seat 3: KeithTurbo48 (button) collected ($1.47)
Seat 4: ng2414 (small blind) folded before Flop
Seat 5: PlayTheBlues4U (big blind) folded before Flop


PokerStars Hand #204909673863: Hold'em No Limit ($0.05/$0.10 USD) - 2019/10/22 22:26:28 ET
Table 'Celuta' 6-max Seat #5 is the button
Seat 1: trumpcaddy ($12.01 in chips) 
Seat 2: SeaofLove ($18.85 in chips) 
Seat 3: ng2414 ($8.53 in chips) 
Seat 4: pancakes1912 ($6.96 in chips) 
Seat 5: KeithTurbo48 ($18.30 in chips) 
Seat 6: PlayTheBlues4U ($10.99 in chips) 
PlayTheBlues4U: posts small blind $0.05
trumpcaddy: posts big blind $0.10
*** HOLE CARDS ***
Dealt to PlayTheBlues4U [Jd 5s]
SeaofLove: folds 
ng2414: raises $0.20 to $0.30
pancakes1912: folds 
KeithTurbo48: folds 
PlayTheBlues4U: folds 
trumpcaddy: folds 
Uncalled bet ($0.20) returned to ng2414
ng2414 collected $0.25 from pot
*** SUMMARY ***
Total pot $0.25 | Rake $0 
Seat 1: trumpcaddy (big blind) folded before Flop
Seat 2: SeaofLove folded before Flop (didn't bet)
Seat 3: ng2414 collected ($0.25)
Seat 4: pancakes1912 folded before Flop (didn't bet)
Seat 5: KeithTurbo48 (button) folded before Flop (didn't bet)
Seat 6: PlayTheBlues4U (small blind) folded before Flop


PokerStars Hand #204909673705: Hold'em No Limit ($0.05/$0.10 USD) - 2019/10/22 22:25:48 ET
Table 'Danae' 6-max Seat #2 is the button
Seat 1: zombiehedgehog ($13.15 in chips) 
Seat 2: SeaofLove ($11.16 in chips) 
Seat 3: KeithTurbo48 ($9.14 in chips) 
Seat 4: ng2414 ($23.63 in chips) 
Seat 5: PlayTheBlues4U ($8.02 in chips) 
KeithTurbo48: posts small blind $0.05
ng2414: posts big blind $0.10
*** HOLE CARDS ***
Dealt to PlayTheBlues4U [8d Ad]
PlayTheBlues4U: raises $0.20 to $0.30
zombiehedgehog: folds 
SeaofLove: folds 
KeithTurbo48: calls $0.25
ng2414: folds 
*** FLOP *** [Qh 8h Ks]
KeithTurbo48: checks 
PlayTheBlues4U: checks 
*** TURN *** [Qh 8h Ks] [3h]
KeithTurbo48: bets $0.49
PlayTheBlues4U: folds 
Uncalled bet ($0.49) returned to KeithTurbo48
KeithTurbo48 collected $0.66 from pot
KeithTurbo48: doesn't show hand 
*** SUMMARY ***
Total pot $0.70 | Rake $0.04 
Board [Qh 8h Ks 3h]
Seat 1: zombiehedgehog folded before Flop (didn't bet)
Seat 2: SeaofLove (button) folded before Flop (didn't bet)
Seat 3: KeithTurbo48 (small blind) collected ($0.66)
Seat 4: ng2414 (big blind) folded before Flop
Seat 5: PlayTheBlues4U folded on the Turn


PokerStars Hand #204909673664: Hold'em No Limit ($0.05/$0.10 USD) - 2019/10/22 22:25:36 ET
Table 'Celuta' 6-max Seat #4 is the button
Seat 1: trumpcaddy ($12.01 in chips) 
Seat 2: SeaofLove ($15.85 in chips) 
Seat 3: ng2414 ($8.53 in chips) 
Seat 4: pancakes1912 ($10.13 in chips) 
Seat 5: KeithTurbo48 ($18.35 in chips) 
Seat 6: PlayTheBlues4U ($11.09 in chips) 
KeithTurbo48: posts small blind $0.05
PlayTheBlues4U: posts big blind $0.10
*** HOLE CARDS ***
Dealt to PlayTheBlues4U [3h 6d]
trumpcaddy: folds 
SeaofLove: raises $0.15 to $0.25
ng2414: folds 
pancakes1912: calls $0.25
KeithTurbo48: folds 
PlayTheBlues4U: folds 
*** FLOP *** [2s 7s Kh]
SeaofLove: bets $0.40
pancakes1912: calls $0.40
*** TURN *** [2s 7s Kh] [8c]
SeaofLove: bets $0.92
pancakes1912: calls $0.92
*** RIVER *** [2s 7s Kh 8c] [7h]
SeaofLove: bets $1.60
pancakes1912: calls $1.60
*** SHOW DOWN ***
SeaofLove: shows [Tc Kc] (two pair, Kings and Sevens)
pancakes1912: mucks hand 
SeaofLove collected $6.17 from pot
*** SUMMARY ***
Total pot $6.49 | Rake $0.32 
Board [2s 7s Kh 8c 7h]
Seat 1: trumpcaddy folded before Flop (didn't bet)
Seat 2: SeaofLove showed [Tc Kc] and won ($6.17) with two pair, Kings and Sevens
Seat 3: ng2414 folded before Flop (didn't bet)
Seat 4: pancakes1912 (button) mucked [Jc Ah]
Seat 5: KeithTurbo48 (small blind) folded before Flop
Seat 6: PlayTheBlues4U (big blind) folded before Flop


PokerStars Hand #204909673487: Hold'em No Limit ($0.05/$0.10 USD) - 2019/10/22 22:24:53 ET
Table 'Danae' 6-max Seat #1 is the button
Seat 1: zombiehedgehog ($13.15 in chips) 
Seat 2: SeaofLove ($11.21 in chips) 
Seat 3: KeithTurbo48 ($8.60 in chips) 
Seat 4: ng2414 ($24.18 in chips) 
Seat 5: PlayTheBlues4U ($8.02 in chips) 
Seat 6: w111r@n ($7.58 in chips) 
SeaofLove: posts small blind $0.05
KeithTurbo48: posts big blind $0.10
*** HOLE CARDS ***
Dealt to PlayTheBlues4U [2h 7c]
ng2414: raises $0.20 to $0.30
PlayTheBlues4U: folds 
w111r@n: folds 
zombiehedgehog: folds 
w111r@n leaves the table
SeaofLove: folds 
KeithTurbo48: calls $0.20
*** FLOP *** [Js Ah 5s]
KeithTurbo48: checks 
ng2414: bets $0.25
KeithTurbo48: calls $0.25
*** TURN *** [Js Ah 5s] [Ts]
KeithTurbo48: checks 
ng2414: checks 
*** RIVER *** [Js Ah 5s Ts] [9h]
KeithTurbo48: checks 
ng2414: checks 
*** SHOW DOWN ***
KeithTurbo48: shows [3d 5d] (a pair of Fives)
ng2414: mucks hand 
KeithTurbo48 collected $1.09 from pot
*** SUMMARY ***
Total pot $1.15 | Rake $0.06 
Board [Js Ah 5s Ts 9h]
Seat 1: zombiehedgehog (button) folded before Flop (didn't bet)
Seat 2: SeaofLove (small blind) folded before Flop
Seat 3: KeithTurbo48 (big blind) showed [3d 5d] and won ($1.09) with a pair of Fives
Seat 4: ng2414 mucked [4c 4d]
Seat 5: PlayTheBlues4U folded before Flop (didn't bet)
Seat 6: w111r@n folded before Flop (didn't bet)


PokerStars Hand #204909673484: Hold'em No Limit ($0.05/$0.10 USD) - 2019/10/22 22:24:53 ET
Table 'Celuta' 6-max Seat #3 is the button
Seat 1: trumpcaddy ($12.01 in chips) 
Seat 2: SeaofLove ($15.85 in chips) 
Seat 3: ng2414 ($8.53 in chips) 
Seat 4: pancakes1912 ($10.04 in chips) 
Seat 5: KeithTurbo48 ($18.45 in chips) 
Seat 6: PlayTheBlues4U ($11.09 in chips) 
pancakes1912: posts small blind $0.05
KeithTurbo48: posts big blind $0.10
*** HOLE CARDS ***
Dealt to PlayTheBlues4U [4c Kc]
PlayTheBlues4U: folds 
trumpcaddy: folds 
SeaofLove: folds 
ng2414: folds 
pancakes1912: calls $0.05
KeithTurbo48: checks 
*** FLOP *** [9s 8d Jh]
pancakes1912: checks 
KeithTurbo48: checks 
*** TURN *** [9s 8d Jh] [Tc]
pancakes1912: bets $0.40
KeithTurbo48: folds 
Uncalled bet ($0.40) returned to pancakes1912
pancakes1912 collected $0.19 from pot
*** SUMMARY ***
Total pot $0.20 | Rake $0.01 
Board [9s 8d Jh Tc]
Seat 1: trumpcaddy folded before Flop (didn't bet)
Seat 2: SeaofLove folded before Flop (didn't bet)
Seat 3: ng2414 (button) folded before Flop (didn't bet)
Seat 4: pancakes1912 (small blind) collected ($0.19)
Seat 5: KeithTurbo48 (big blind) folded on the Turn
Seat 6: PlayTheBlues4U folded before Flop (didn't bet)


PokerStars Hand #204909673418: Hold'em No Limit ($0.05/$0.10 USD) - 2019/10/22 22:24:37 ET
Table 'Celuta' 6-max Seat #2 is the button
Seat 1: trumpcaddy ($12.01 in chips) 
Seat 2: SeaofLove ($15.85 in chips) 
Seat 3: ng2414 ($8.58 in chips) 
Seat 4: pancakes1912 ($9.99 in chips) 
Seat 5: KeithTurbo48 ($18.45 in chips) 
Seat 6: PlayTheBlues4U ($11.09 in chips) 
ng2414: posts small blind $0.05
pancakes1912: posts big blind $0.10
*** HOLE CARDS ***
Dealt to PlayTheBlues4U [Qd 8c]
KeithTurbo48: folds 
PlayTheBlues4U: folds 
trumpcaddy: folds 
SeaofLove: folds 
ng2414: folds 
Uncalled bet ($0.05) returned to pancakes1912
pancakes1912 collected $0.10 from pot
*** SUMMARY ***
Total pot $0.10 | Rake $0 
Seat 1: trumpcaddy folded before Flop (didn't bet)
Seat 2: SeaofLove (button) folded before Flop (didn't bet)
Seat 3: ng2414 (small blind) folded before Flop
Seat 4: pancakes1912 (big blind) collected ($0.10)
Seat 5: KeithTurbo48 folded before Flop (didn't bet)
Seat 6: PlayTheBlues4U folded before Flop (didn't bet)


PokerStars Hand #204909673247: Hold'em No Limit ($0.05/$0.10 USD) - 2019/10/22 22:23:53 ET
Table 'Danae' 6-max Seat #6 is the button
Seat 1: zombiehedgehog ($12.05 in chips) 
Seat 2: SeaofLove ($12.11 in chips) 
Seat 3: KeithTurbo48 ($8.60 in chips) 
Seat 4: ng2414 ($24.18 in chips) 
Seat 5: PlayTheBlues4U ($8.32 in chips) 
Seat 6: w111r@n ($7.58 in chips) 
zombiehedgehog: posts small blind $0.05
SeaofLove: posts big blind $0.10
*** HOLE CARDS ***
Dealt to PlayTheBlues4U [9d Td]
KeithTurbo48: folds 
ng2414: folds 
PlayTheBlues4U: raises $0.20 to $0.30
w111r@n: folds 
zombiehedgehog: calls $0.25
SeaofLove: calls $0.20
*** FLOP *** [3s Qh As]
zombiehedgehog: bets $0.60
SeaofLove: calls $0.60
PlayTheBlues4U: folds 
*** TURN *** [3s Qh As] [Ah]
zombiehedgehog: bets $2
SeaofLove: folds 
Uncalled bet ($2) returned to zombiehedgehog
zombiehedgehog collected $2 from pot
zombiehedgehog: doesn't show hand 
*** SUMMARY ***
Total pot $2.10 | Rake $0.10 
Board [3s Qh As Ah]
Seat 1: zombiehedgehog (small blind) collected ($2)
Seat 2: SeaofLove (big blind) folded on the Turn
Seat 3: KeithTurbo48 folded before Flop (didn't bet)
Seat 4: ng2414 folded before Flop (didn't bet)
Seat 5: PlayTheBlues4U folded on the Flop
Seat 6: w111r@n (button) folded before Flop (didn't bet)


PokerStars Hand #204909673123: Hold'em No Limit ($0.05/$0.10 USD) - 2019/10/22 22:23:24 ET
Table 'Celuta' 6-max Seat #1 is the button
Seat 1: trumpcaddy ($12.01 in chips) 
Seat 2: SeaofLove ($15.90 in chips) 
Seat 3: ng2414 ($8.68 in chips) 
Seat 4: pancakes1912 ($11.99 in chips) 
Seat 5: KeithTurbo48 ($16.51 in chips) 
Seat 6: PlayTheBlues4U ($11.09 in chips) 
SeaofLove: posts small blind $0.05
ng2414: posts big blind $0.10
*** HOLE CARDS ***
Dealt to PlayTheBlues4U [Jh Ad]
pancakes1912: raises $0.10 to $0.20
KeithTurbo48: raises $0.60 to $0.80
PlayTheBlues4U: folds 
trumpcaddy: folds 
SeaofLove: folds 
ng2414: folds 
pancakes1912: calls $0.60
*** FLOP *** [Th 4s Qd]
pancakes1912: bets $0.40
KeithTurbo48: calls $0.40
*** TURN *** [Th 4s Qd] [5c]
pancakes1912: bets $0.40
KeithTurbo48: calls $0.40
*** RIVER *** [Th 4s Qd 5c] [3h]
pancakes1912: bets $0.40
KeithTurbo48: calls $0.40
*** SHOW DOWN ***
pancakes1912: shows [Kc Jd] (high card King)
KeithTurbo48: shows [Kh As] (high card Ace)
KeithTurbo48 collected $3.94 from pot
*** SUMMARY ***
Total pot $4.15 | Rake $0.21 
Board [Th 4s Qd 5c 3h]
Seat 1: trumpcaddy (button) folded before Flop (didn't bet)
Seat 2: SeaofLove (small blind) folded before Flop
Seat 3: ng2414 (big blind) folded before Flop
Seat 4: pancakes1912 showed [Kc Jd] and lost with high card King
Seat 5: KeithTurbo48 showed [Kh As] and won ($3.94) with high card Ace
Seat 6: PlayTheBlues4U folded before Flop (didn't bet)


PokerStars Hand #204909672986: Hold'em No Limit ($0.05/$0.10 USD) - 2019/10/22 22:22:55 ET
Table 'Danae' 6-max Seat #5 is the button
Seat 1: zombiehedgehog ($12.30 in chips) 
Seat 2: SeaofLove ($10.84 in chips) 
Seat 3: KeithTurbo48 ($9.48 in chips) 
Seat 4: ng2414 ($24.18 in chips) 
Seat 5: PlayTheBlues4U ($8.32 in chips) 
Seat 6: w111r@n ($7.83 in chips) 
w111r@n: posts small blind $0.05
zombiehedgehog: posts big blind $0.10
*** HOLE CARDS ***
Dealt to PlayTheBlues4U [4d Jh]
SeaofLove: raises $0.15 to $0.25
KeithTurbo48: calls $0.25
ng2414: folds 
PlayTheBlues4U: folds 
w111r@n: calls $0.20
zombiehedgehog: calls $0.15
*** FLOP *** [5h 7c 4h]
w111r@n: checks 
zombiehedgehog: checks 
SeaofLove: bets $0.63
KeithTurbo48: calls $0.63
w111r@n: folds 
zombiehedgehog: folds 
*** TURN *** [5h 7c 4h] [6h]
SeaofLove: bets $1.43
KeithTurbo48: folds 
Uncalled bet ($1.43) returned to SeaofLove
SeaofLove collected $2.15 from pot
SeaofLove: doesn't show hand 
*** SUMMARY ***
Total pot $2.26 | Rake $0.11 
Board [5h 7c 4h 6h]
Seat 1: zombiehedgehog (big blind) folded on the Flop
Seat 2: SeaofLove collected ($2.15)
Seat 3: KeithTurbo48 folded on the Turn
Seat 4: ng2414 folded before Flop (didn't bet)
Seat 5: PlayTheBlues4U (button) folded before Flop (didn't bet)
Seat 6: w111r@n (small blind) folded on the Flop


PokerStars Hand #204909672882: Hold'em No Limit ($0.05/$0.10 USD) - 2019/10/22 22:22:31 ET
Table 'Danae' 6-max Seat #4 is the button
Seat 1: zombiehedgehog ($12.30 in chips) 
Seat 2: SeaofLove ($10.84 in chips) 
Seat 3: KeithTurbo48 ($9.48 in chips) 
Seat 4: ng2414 ($24.18 in chips) 
Seat 5: PlayTheBlues4U ($8.22 in chips) 
Seat 6: w111r@n ($7.93 in chips) 
PlayTheBlues4U: posts small blind $0.05
w111r@n: posts big blind $0.10
*** HOLE CARDS ***
Dealt to PlayTheBlues4U [Jc Ad]
zombiehedgehog: folds 
SeaofLove: folds 
KeithTurbo48: folds 
ng2414: folds 
PlayTheBlues4U: raises $0.20 to $0.30
w111r@n: folds 
Uncalled bet ($0.20) returned to PlayTheBlues4U
PlayTheBlues4U collected $0.20 from pot
PlayTheBlues4U: doesn't show hand 
*** SUMMARY ***
Total pot $0.20 | Rake $0 
Seat 1: zombiehedgehog folded before Flop (didn't bet)
Seat 2: SeaofLove folded before Flop (didn't bet)
Seat 3: KeithTurbo48 folded before Flop (didn't bet)
Seat 4: ng2414 (button) folded before Flop (didn't bet)
Seat 5: PlayTheBlues4U (small blind) collected ($0.20)
Seat 6: w111r@n (big blind) folded before Flop


PokerStars Hand #204909672815: Hold'em No Limit ($0.05/$0.10 USD) - 2019/10/22 22:22:15 ET
Table 'Celuta' 6-max Seat #6 is the button
Seat 1: trumpcaddy ($12.06 in chips) 
Seat 2: SeaofLove ($18.06 in chips) 
Seat 3: ng2414 ($8.68 in chips) 
Seat 4: pancakes1912 ($10 in chips) 
Seat 5: KeithTurbo48 ($16.51 in chips) 
Seat 6: PlayTheBlues4U ($11.09 in chips) 
trumpcaddy: posts small blind $0.05
SeaofLove: posts big blind $0.10
*** HOLE CARDS ***
Dealt to PlayTheBlues4U [6d Qs]
ng2414 has timed out
ng2414: folds 
pancakes1912: calls $0.10
KeithTurbo48: folds 
PlayTheBlues4U: folds 
trumpcaddy: folds 
SeaofLove: raises $0.30 to $0.40
pancakes1912: calls $0.30
*** FLOP *** [2h 7h Jd]
SeaofLove: bets $0.54
pancakes1912: calls $0.54
*** TURN *** [2h 7h Jd] [9h]
SeaofLove: bets $1.22
pancakes1912: calls $1.22
*** RIVER *** [2h 7h Jd 9h] [Jh]
SeaofLove: checks 
pancakes1912: bets $2
SeaofLove: folds 
Uncalled bet ($2) returned to pancakes1912
pancakes1912 collected $4.15 from pot
*** SUMMARY ***
Total pot $4.37 | Rake $0.22 
Board [2h 7h Jd 9h Jh]
Seat 1: trumpcaddy (small blind) folded before Flop
Seat 2: SeaofLove (big blind) folded on the River
Seat 3: ng2414 folded before Flop (didn't bet)
Seat 4: pancakes1912 collected ($4.15)
Seat 5: KeithTurbo48 folded before Flop (didn't bet)
Seat 6: PlayTheBlues4U (button) folded before Flop (didn't bet)


PokerStars Hand #204909672581: Hold'em No Limit ($0.05/$0.10 USD) - 2019/10/22 22:21:17 ET
Table 'Danae' 6-max Seat #3 is the button
Seat 1: zombiehedgehog ($12.02 in chips) 
Seat 2: SeaofLove ($10.84 in chips) 
Seat 3: KeithTurbo48 ($9.58 in chips) 
Seat 4: ng2414 ($24.28 in chips) 
Seat 5: PlayTheBlues4U ($8.32 in chips) 
Seat 6: w111r@n ($7.93 in chips) 
ng2414: posts small blind $0.05
PlayTheBlues4U: posts big blind $0.10
*** HOLE CARDS ***
Dealt to PlayTheBlues4U [4s 6h]
w111r@n: folds 
zombiehedgehog said, "wow what are the odds"
zombiehedgehog: calls $0.10
SeaofLove: folds 
KeithTurbo48: calls $0.10
ng2414 said, "What lol"
zombiehedgehog said, "AJ"
ng2414 said, "me?"
ng2414: calls $0.05
PlayTheBlues4U: checks 
*** FLOP *** [3c 2d Kh]
ng2414: checks 
PlayTheBlues4U: checks 
zombiehedgehog said, "we both had trips. nice little kicker you had"
zombiehedgehog: bets $0.10
KeithTurbo48: folds 
ng2414 said, "Yes"
ng2414: folds 
PlayTheBlues4U: folds 
Uncalled bet ($0.10) returned to zombiehedgehog
zombiehedgehog collected $0.38 from pot
zombiehedgehog: doesn't show hand 
*** SUMMARY ***
Total pot $0.40 | Rake $0.02 
Board [3c 2d Kh]
Seat 1: zombiehedgehog collected ($0.38)
Seat 2: SeaofLove folded before Flop (didn't bet)
Seat 3: KeithTurbo48 (button) folded on the Flop
Seat 4: ng2414 (small blind) folded on the Flop
Seat 5: PlayTheBlues4U (big blind) folded on the Flop
Seat 6: w111r@n folded before Flop (didn't bet)


PokerStars Hand #204909672449: Hold'em No Limit ($0.05/$0.10 USD) - 2019/10/22 22:20:47 ET
Table 'Celuta' 6-max Seat #5 is the button
Seat 1: trumpcaddy ($12.16 in chips) 
Seat 2: SeaofLove ($18.06 in chips) 
Seat 3: ng2414 ($8.98 in chips) 
Seat 5: KeithTurbo48 ($16.10 in chips) 
Seat 6: PlayTheBlues4U ($11.14 in chips) 
PlayTheBlues4U: posts small blind $0.05
trumpcaddy: posts big blind $0.10
*** HOLE CARDS ***
Dealt to PlayTheBlues4U [6s Tc]
SeaofLove: folds 
ng2414: raises $0.20 to $0.30
KeithTurbo48: calls $0.30
PlayTheBlues4U: folds 
trumpcaddy: folds 
*** FLOP *** [2c Kc Th]
ng2414: checks 
KeithTurbo48: checks 
*** TURN *** [2c Kc Th] [9d]
ng2414: checks 
KeithTurbo48: bets $0.50
ng2414: folds 
Uncalled bet ($0.50) returned to KeithTurbo48
KeithTurbo48 collected $0.71 from pot
KeithTurbo48: doesn't show hand 
*** SUMMARY ***
Total pot $0.75 | Rake $0.04 
Board [2c Kc Th 9d]
Seat 1: trumpcaddy (big blind) folded before Flop
Seat 2: SeaofLove folded before Flop (didn't bet)
Seat 3: ng2414 folded on the Turn
Seat 5: KeithTurbo48 (button) collected ($0.71)
Seat 6: PlayTheBlues4U (small blind) folded before Flop


PokerStars Hand #204909672241: Hold'em No Limit ($0.05/$0.10 USD) - 2019/10/22 22:20:00 ET
Table 'Celuta' 6-max Seat #3 is the button
Seat 1: trumpcaddy ($12.16 in chips) 
Seat 2: SeaofLove ($14.01 in chips) 
Seat 3: ng2414 ($8.98 in chips) 
Seat 4: pancakes1912 ($4.39 in chips) 
Seat 5: KeithTurbo48 ($16.20 in chips) 
Seat 6: PlayTheBlues4U ($11.14 in chips) 
pancakes1912: posts small blind $0.05
KeithTurbo48: posts big blind $0.10
*** HOLE CARDS ***
Dealt to PlayTheBlues4U [7c 2c]
PlayTheBlues4U: folds 
trumpcaddy: folds 
SeaofLove: raises $0.15 to $0.25
ng2414: folds 
pancakes1912: raises $0.15 to $0.40
KeithTurbo48: folds 
SeaofLove: calls $0.15
*** FLOP *** [9h Ts 6d]
pancakes1912: bets $0.40
SeaofLove: calls $0.40
*** TURN *** [9h Ts 6d] [5s]
pancakes1912: bets $0.40
SeaofLove: raises $4.20 to $4.60
pancakes1912: calls $3.19 and is all-in
Uncalled bet ($1.01) returned to SeaofLove
*** RIVER *** [9h Ts 6d 5s] [Qs]
*** SHOW DOWN ***
pancakes1912: shows [Ac Ks] (high card Ace)
SeaofLove: shows [Jc Tc] (a pair of Tens)
SeaofLove collected $8.44 from pot
*** SUMMARY ***
Total pot $8.88 | Rake $0.44 
Board [9h Ts 6d 5s Qs]
Seat 1: trumpcaddy folded before Flop (didn't bet)
Seat 2: SeaofLove showed [Jc Tc] and won ($8.44) with a pair of Tens
Seat 3: ng2414 (button) folded before Flop (didn't bet)
Seat 4: pancakes1912 (small blind) showed [Ac Ks] and lost with high card Ace
Seat 5: KeithTurbo48 (big blind) folded before Flop
Seat 6: PlayTheBlues4U folded before Flop (didn't bet)


PokerStars Hand #204909672034: Hold'em No Limit ($0.05/$0.10 USD) - 2019/10/22 22:19:10 ET
Table 'Celuta' 6-max Seat #2 is the button
Seat 1: trumpcaddy ($12.16 in chips) 
Seat 2: SeaofLove ($10.71 in chips) 
Seat 3: ng2414 ($9.03 in chips) 
Seat 4: pancakes1912 ($8 in chips) 
Seat 5: KeithTurbo48 ($16.20 in chips) 
Seat 6: PlayTheBlues4U ($11.14 in chips) 
ng2414: posts small blind $0.05
pancakes1912: posts big blind $0.10
*** HOLE CARDS ***
Dealt to PlayTheBlues4U [4s 7d]
KeithTurbo48: folds 
PlayTheBlues4U: folds 
trumpcaddy: folds 
SeaofLove: raises $0.15 to $0.25
ng2414: folds 
pancakes1912: calls $0.15
*** FLOP *** [Kc Td 8d]
pancakes1912: bets $0.30
SeaofLove: calls $0.30
*** TURN *** [Kc Td 8d] [Qs]
pancakes1912: bets $0.40
SeaofLove: raises $1.26 to $1.66
pancakes1912: calls $1.26
*** RIVER *** [Kc Td 8d Qs] [Ad]
pancakes1912: bets $1.40
SeaofLove: calls $1.40
*** SHOW DOWN ***
pancakes1912: shows [Tc 9c] (a pair of Tens)
SeaofLove: shows [Qh Ks] (two pair, Kings and Queens)
SeaofLove collected $6.91 from pot
*** SUMMARY ***
Total pot $7.27 | Rake $0.36 
Board [Kc Td 8d Qs Ad]
Seat 1: trumpcaddy folded before Flop (didn't bet)
Seat 2: SeaofLove (button) showed [Qh Ks] and won ($6.91) with two pair, Kings and Queens
Seat 3: ng2414 (small blind) folded before Flop
Seat 4: pancakes1912 (big blind) showed [Tc 9c] and lost with a pair of Tens
Seat 5: KeithTurbo48 folded before Flop (didn't bet)
Seat 6: PlayTheBlues4U folded before Flop (didn't bet)


PokerStars Hand #204909672030: Hold'em No Limit ($0.05/$0.10 USD) - 2019/10/22 22:19:09 ET
Table 'Danae' 6-max Seat #2 is the button
Seat 1: zombiehedgehog ($21.78 in chips) 
Seat 2: SeaofLove ($10.84 in chips) 
Seat 3: KeithTurbo48 ($9.68 in chips) 
Seat 4: ng2414 ($15.40 in chips) 
Seat 5: PlayTheBlues4U ($8.32 in chips) 
Seat 6: w111r@n ($7.93 in chips) 
KeithTurbo48: posts small blind $0.05
ng2414: posts big blind $0.10
*** HOLE CARDS ***
Dealt to PlayTheBlues4U [Kd 9c]
PlayTheBlues4U: folds 
w111r@n: folds 
zombiehedgehog: calls $0.10
SeaofLove: folds 
KeithTurbo48: calls $0.05
ng2414: raises $0.20 to $0.30
zombiehedgehog: calls $0.20
KeithTurbo48: folds 
*** FLOP *** [7h Ts Ac]
ng2414: checks 
zombiehedgehog: bets $0.66
ng2414: calls $0.66
*** TURN *** [7h Ts Ac] [2c]
ng2414: checks 
zombiehedgehog: bets $1.92
ng2414: raises $2.88 to $4.80
zombiehedgehog: calls $2.88
*** RIVER *** [7h Ts Ac 2c] [Ah]
ng2414: bets $4
zombiehedgehog: calls $4
*** SHOW DOWN ***
ng2414: shows [As Kc] (three of a kind, Aces)
zombiehedgehog: mucks hand 
ng2414 collected $18.64 from pot
*** SUMMARY ***
Total pot $19.62 | Rake $0.98 
Board [7h Ts Ac 2c Ah]
Seat 1: zombiehedgehog mucked [Ad 8c]
Seat 2: SeaofLove (button) folded before Flop (didn't bet)
Seat 3: KeithTurbo48 (small blind) folded before Flop
Seat 4: ng2414 (big blind) showed [As Kc] and won ($18.64) with three of a kind, Aces
Seat 5: PlayTheBlues4U folded before Flop (didn't bet)
Seat 6: w111r@n folded before Flop (didn't bet)


PokerStars Hand #204909671932: Hold'em No Limit ($0.05/$0.10 USD) - 2019/10/22 22:18:48 ET
Table 'Celuta' 6-max Seat #1 is the button
Seat 1: trumpcaddy ($12.16 in chips) 
Seat 2: SeaofLove ($10.76 in chips) 
Seat 3: ng2414 ($9.13 in chips) 
Seat 5: KeithTurbo48 ($16.05 in chips) 
Seat 6: PlayTheBlues4U ($11.14 in chips) 
SeaofLove: posts small blind $0.05
ng2414: posts big blind $0.10
*** HOLE CARDS ***
Dealt to PlayTheBlues4U [9s 7s]
KeithTurbo48: raises $0.15 to $0.25
pancakes1912 joins the table at seat #4 
PlayTheBlues4U: folds 
trumpcaddy: folds 
SeaofLove: folds 
ng2414: folds 
Uncalled bet ($0.15) returned to KeithTurbo48
KeithTurbo48 collected $0.25 from pot
KeithTurbo48: doesn't show hand 
*** SUMMARY ***
Total pot $0.25 | Rake $0 
Seat 1: trumpcaddy (button) folded before Flop (didn't bet)
Seat 2: SeaofLove (small blind) folded before Flop
Seat 3: ng2414 (big blind) folded before Flop
Seat 5: KeithTurbo48 collected ($0.25)
Seat 6: PlayTheBlues4U folded before Flop (didn't bet)


PokerStars Hand #204909671839: Hold'em No Limit ($0.05/$0.10 USD) - 2019/10/22 22:18:24 ET
Table 'Danae' 6-max Seat #1 is the button
Seat 1: zombiehedgehog ($22.08 in chips) 
Seat 2: SeaofLove ($10 in chips) 
Seat 3: KeithTurbo48 ($9.98 in chips) 
Seat 4: ng2414 ($15.40 in chips) 
Seat 5: PlayTheBlues4U ($8.62 in chips) 
Seat 6: w111r@n ($7.93 in chips) 
SeaofLove: posts small blind $0.05
KeithTurbo48: posts big blind $0.10
*** HOLE CARDS ***
Dealt to PlayTheBlues4U [Kh Ac]
ng2414: folds 
PlayTheBlues4U: raises $0.20 to $0.30
w111r@n: folds 
zombiehedgehog: calls $0.30
SeaofLove: calls $0.25
KeithTurbo48: calls $0.20
*** FLOP *** [4d Th Qh]
SeaofLove: bets $0.76
KeithTurbo48: folds 
PlayTheBlues4U: folds 
zombiehedgehog: folds 
Uncalled bet ($0.76) returned to SeaofLove
SeaofLove collected $1.14 from pot
SeaofLove: doesn't show hand 
*** SUMMARY ***
Total pot $1.20 | Rake $0.06 
Board [4d Th Qh]
Seat 1: zombiehedgehog (button) folded on the Flop
Seat 2: SeaofLove (small blind) collected ($1.14)
Seat 3: KeithTurbo48 (big blind) folded on the Flop
Seat 4: ng2414 folded before Flop (didn't bet)
Seat 5: PlayTheBlues4U folded on the Flop
Seat 6: w111r@n folded before Flop (didn't bet)


PokerStars Hand #204909671812: Hold'em No Limit ($0.05/$0.10 USD) - 2019/10/22 22:18:18 ET
Table 'Celuta' 6-max Seat #6 is the button
Seat 1: trumpcaddy ($12.21 in chips) 
Seat 2: SeaofLove ($10.22 in chips) 
Seat 3: ng2414 ($9.13 in chips) 
Seat 5: KeithTurbo48 ($16.05 in chips) 
Seat 6: PlayTheBlues4U ($11.69 in chips) 
trumpcaddy: posts small blind $0.05
SeaofLove: posts big blind $0.10
*** HOLE CARDS ***
Dealt to PlayTheBlues4U [Ts Js]
ng2414: folds 
KeithTurbo48: folds 
PlayTheBlues4U: raises $0.15 to $0.25
trumpcaddy: folds 
SeaofLove: calls $0.15
*** FLOP *** [Qd 5c 6c]
SeaofLove: checks 
PlayTheBlues4U: bets $0.30
SeaofLove: raises $0.80 to $1.10
PlayTheBlues4U: folds 
Uncalled bet ($0.80) returned to SeaofLove
SeaofLove collected $1.09 from pot
SeaofLove: doesn't show hand 
*** SUMMARY ***
Total pot $1.15 | Rake $0.06 
Board [Qd 5c 6c]
Seat 1: trumpcaddy (small blind) folded before Flop
Seat 2: SeaofLove (big blind) collected ($1.09)
Seat 3: ng2414 folded before Flop (didn't bet)
Seat 5: KeithTurbo48 folded before Flop (didn't bet)
Seat 6: PlayTheBlues4U (button) folded on the Flop


PokerStars Hand #204909671612: Hold'em No Limit ($0.05/$0.10 USD) - 2019/10/22 22:17:29 ET
Table 'Celuta' 6-max Seat #5 is the button
Seat 1: trumpcaddy ($12.31 in chips) 
Seat 2: SeaofLove ($10.22 in chips) 
Seat 3: ng2414 ($9.13 in chips) 
Seat 5: KeithTurbo48 ($16.30 in chips) 
Seat 6: PlayTheBlues4U ($11.34 in chips) 
PlayTheBlues4U: posts small blind $0.05
trumpcaddy: posts big blind $0.10
*** HOLE CARDS ***
Dealt to PlayTheBlues4U [Ad Ah]
SeaofLove: folds 
ng2414: folds 
KeithTurbo48: raises $0.15 to $0.25
PlayTheBlues4U: raises $0.45 to $0.70
trumpcaddy: folds 
KeithTurbo48: folds 
Uncalled bet ($0.45) returned to PlayTheBlues4U
PlayTheBlues4U collected $0.60 from pot
PlayTheBlues4U: doesn't show hand 
*** SUMMARY ***
Total pot $0.60 | Rake $0 
Seat 1: trumpcaddy (big blind) folded before Flop
Seat 2: SeaofLove folded before Flop (didn't bet)
Seat 3: ng2414 folded before Flop (didn't bet)
Seat 5: KeithTurbo48 (button) folded before Flop
Seat 6: PlayTheBlues4U (small blind) collected ($0.60)


PokerStars Hand #204909671547: Hold'em No Limit ($0.05/$0.10 USD) - 2019/10/22 22:17:16 ET
Table 'Danae' 6-max Seat #6 is the button
Seat 1: zombiehedgehog ($18.58 in chips) 
Seat 2: SeaofLove ($10 in chips) 
Seat 3: KeithTurbo48 ($13.50 in chips) 
Seat 4: ng2414 ($15.40 in chips) 
Seat 5: PlayTheBlues4U ($8.87 in chips) 
Seat 6: w111r@n ($7.93 in chips) 
zombiehedgehog: posts small blind $0.05
SeaofLove: posts big blind $0.10
*** HOLE CARDS ***
Dealt to PlayTheBlues4U [6s 7s]
KeithTurbo48: raises $0.15 to $0.25
ng2414: folds 
PlayTheBlues4U: calls $0.25
w111r@n: folds 
zombiehedgehog: raises $0.85 to $1.10
SeaofLove: folds 
KeithTurbo48: calls $0.85
PlayTheBlues4U: folds 
*** FLOP *** [8d 3h 4h]
zombiehedgehog: bets $2.42
KeithTurbo48: calls $2.42
*** TURN *** [8d 3h 4h] [Kd]
zombiehedgehog: checks 
KeithTurbo48: checks 
*** RIVER *** [8d 3h 4h Kd] [Ad]
zombiehedgehog: bets $3.51
KeithTurbo48: folds 
Uncalled bet ($3.51) returned to zombiehedgehog
zombiehedgehog collected $7.02 from pot
zombiehedgehog: doesn't show hand 
*** SUMMARY ***
Total pot $7.39 | Rake $0.37 
Board [8d 3h 4h Kd Ad]
Seat 1: zombiehedgehog (small blind) collected ($7.02)
Seat 2: SeaofLove (big blind) folded before Flop
Seat 3: KeithTurbo48 folded on the River
Seat 4: ng2414 folded before Flop (didn't bet)
Seat 5: PlayTheBlues4U folded before Flop
Seat 6: w111r@n (button) folded before Flop (didn't bet)


PokerStars Hand #204907679852: Hold'em No Limit ($0.05/$0.10 USD) - 2019/10/22 22:16:27 ET
Table 'Danae' 6-max Seat #5 is the button
Seat 1: zombiehedgehog ($19.28 in chips) 
Seat 2: SeaofLove ($10 in chips) 
Seat 3: KeithTurbo48 ($13.50 in chips) 
Seat 4: ng2414 ($14.72 in chips) 
Seat 5: PlayTheBlues4U ($8.87 in chips) 
Seat 6: w111r@n ($7.98 in chips) 
w111r@n: posts small blind $0.05
zombiehedgehog: posts big blind $0.10
*** HOLE CARDS ***
Dealt to PlayTheBlues4U [4d 6s]
SeaofLove: folds 
KeithTurbo48: folds 
ng2414: raises $0.20 to $0.30
PlayTheBlues4U: folds 
w111r@n: folds 
zombiehedgehog: calls $0.20
*** FLOP *** [2h Kh Qc]
zombiehedgehog: checks 
ng2414: checks 
*** TURN *** [2h Kh Qc] [4s]
zombiehedgehog: checks 
ng2414: bets $0.40
zombiehedgehog: calls $0.40
*** RIVER *** [2h Kh Qc 4s] [Qs]
zombiehedgehog: checks 
ng2414: checks 
*** SHOW DOWN ***
zombiehedgehog: shows [Ah 5s] (a pair of Queens)
ng2414: shows [Ad Th] (a pair of Queens - Ace+King+Ten kicker)
ng2414 collected $1.38 from pot
*** SUMMARY ***
Total pot $1.45 | Rake $0.07 
Board [2h Kh Qc 4s Qs]
Seat 1: zombiehedgehog (big blind) showed [Ah 5s] and lost with a pair of Queens
Seat 2: SeaofLove folded before Flop (didn't bet)
Seat 3: KeithTurbo48 folded before Flop (didn't bet)
Seat 4: ng2414 showed [Ad Th] and won ($1.38) with a pair of Queens
Seat 5: PlayTheBlues4U (button) folded before Flop (didn't bet)
Seat 6: w111r@n (small blind) folded before Flop


PokerStars Hand #204907679849: Hold'em No Limit ($0.05/$0.10 USD) - 2019/10/22 22:16:26 ET
Table 'Celuta' 6-max Seat #3 is the button
Seat 1: trumpcaddy ($12.31 in chips) 
Seat 2: SeaofLove ($10.22 in chips) 
Seat 3: ng2414 ($9.13 in chips) 
Seat 5: KeithTurbo48 ($8.58 in chips) 
Seat 6: PlayTheBlues4U ($19.92 in chips) 
KeithTurbo48: posts small blind $0.05
PlayTheBlues4U: posts big blind $0.10
*** HOLE CARDS ***
Dealt to PlayTheBlues4U [As Qc]
trumpcaddy: folds 
SeaofLove: folds 
ng2414: folds 
KeithTurbo48: raises $0.20 to $0.30
PlayTheBlues4U: raises $0.50 to $0.80
KeithTurbo48: raises $7.78 to $8.58 and is all-in
PlayTheBlues4U: calls $7.78
*** FLOP *** [6h Kd Kh]
*** TURN *** [6h Kd Kh] [4h]
*** RIVER *** [6h Kd Kh 4h] [2c]
*** SHOW DOWN ***
KeithTurbo48: shows [9c 9s] (two pair, Kings and Nines)
PlayTheBlues4U: shows [As Qc] (a pair of Kings)
KeithTurbo48 collected $16.30 from pot
*** SUMMARY ***
Total pot $17.16 | Rake $0.86 
Board [6h Kd Kh 4h 2c]
Seat 1: trumpcaddy folded before Flop (didn't bet)
Seat 2: SeaofLove folded before Flop (didn't bet)
Seat 3: ng2414 (button) folded before Flop (didn't bet)
Seat 5: KeithTurbo48 (small blind) showed [9c 9s] and won ($16.30) with two pair, Kings and Nines
Seat 6: PlayTheBlues4U (big blind) showed [As Qc] and lost with a pair of Kings


PokerStars Hand #204907679580: Hold'em No Limit ($0.05/$0.10 USD) - 2019/10/22 22:15:22 ET
Table 'Danae' 6-max Seat #4 is the button
Seat 1: zombiehedgehog ($20.73 in chips) 
Seat 2: SeaofLove ($10 in chips) 
Seat 3: KeithTurbo48 ($12.05 in chips) 
Seat 4: ng2414 ($14.72 in chips) 
Seat 5: PlayTheBlues4U ($8.92 in chips) 
Seat 6: w111r@n ($8.08 in chips) 
PlayTheBlues4U: posts small blind $0.05
w111r@n: posts big blind $0.10
*** HOLE CARDS ***
Dealt to PlayTheBlues4U [8h 2s]
zombiehedgehog: raises $0.10 to $0.20
SeaofLove: folds 
KeithTurbo48: calls $0.20
ng2414: folds 
PlayTheBlues4U: folds 
w111r@n: folds 
*** FLOP *** [Jd 2d 8c]
zombiehedgehog: bets $0.25
KeithTurbo48: calls $0.25
*** TURN *** [Jd 2d 8c] [Th]
zombiehedgehog: bets $0.33
KeithTurbo48: raises $0.67 to $1
zombiehedgehog: calls $0.67
*** RIVER *** [Jd 2d 8c Th] [8s]
zombiehedgehog: checks 
KeithTurbo48: checks 
*** SHOW DOWN ***
zombiehedgehog: shows [5d 3d] (a pair of Eights)
KeithTurbo48: shows [Td Qc] (two pair, Tens and Eights)
KeithTurbo48 collected $2.90 from pot
*** SUMMARY ***
Total pot $3.05 | Rake $0.15 
Board [Jd 2d 8c Th 8s]
Seat 1: zombiehedgehog showed [5d 3d] and lost with a pair of Eights
Seat 2: SeaofLove folded before Flop (didn't bet)
Seat 3: KeithTurbo48 showed [Td Qc] and won ($2.90) with two pair, Tens and Eights
Seat 4: ng2414 (button) folded before Flop (didn't bet)
Seat 5: PlayTheBlues4U (small blind) folded before Flop
Seat 6: w111r@n (big blind) folded before Flop


PokerStars Hand #204907679543: Hold'em No Limit ($0.05/$0.10 USD) - 2019/10/22 22:15:12 ET
Table 'Celuta' 6-max Seat #2 is the button
Seat 1: trumpcaddy ($12.31 in chips) 
Seat 2: SeaofLove ($10.22 in chips) 
Seat 3: ng2414 ($9.25 in chips) 
Seat 5: KeithTurbo48 ($8.71 in chips) 
Seat 6: PlayTheBlues4U ($19.92 in chips) 
ng2414: posts small blind $0.05
KeithTurbo48: posts big blind $0.10
*** HOLE CARDS ***
Dealt to PlayTheBlues4U [2d 8s]
PlayTheBlues4U: folds 
trumpcaddy: folds 
SeaofLove: folds 
ng2414: raises $0.20 to $0.30
KeithTurbo48: calls $0.20
*** FLOP *** [As 7c 7d]
ng2414: checks 
KeithTurbo48: checks 
*** TURN *** [As 7c 7d] [3s]
ng2414: bets $0.29
KeithTurbo48: calls $0.29
*** RIVER *** [As 7c 7d 3s] [7s]
ng2414: bets $0.56
KeithTurbo48: raises $1.34 to $1.90
ng2414: calls $1.34
*** SHOW DOWN ***
KeithTurbo48: shows [Th Ad] (a full house, Sevens full of Aces)
ng2414: shows [Qs Ac] (a full house, Sevens full of Aces)
ng2414 collected $2.37 from pot
KeithTurbo48 collected $2.36 from pot
*** SUMMARY ***
Total pot $4.98 | Rake $0.25 
Board [As 7c 7d 3s 7s]
Seat 1: trumpcaddy folded before Flop (didn't bet)
Seat 2: SeaofLove (button) folded before Flop (didn't bet)
Seat 3: ng2414 (small blind) showed [Qs Ac] and won ($2.37) with a full house, Sevens full of Aces
Seat 5: KeithTurbo48 (big blind) showed [Th Ad] and won ($2.36) with a full house, Sevens full of Aces
Seat 6: PlayTheBlues4U folded before Flop (didn't bet)


PokerStars Hand #204907679531: Hold'em No Limit ($0.05/$0.10 USD) - 2019/10/22 22:15:09 ET
Table 'Danae' 6-max Seat #3 is the button
Seat 1: zombiehedgehog ($20.58 in chips) 
Seat 2: SeaofLove ($10 in chips) 
Seat 3: KeithTurbo48 ($12.05 in chips) 
Seat 4: ng2414 ($14.77 in chips) 
Seat 5: PlayTheBlues4U ($9.02 in chips) 
Seat 6: w111r@n ($8.08 in chips) 
ng2414: posts small blind $0.05
PlayTheBlues4U: posts big blind $0.10
*** HOLE CARDS ***
Dealt to PlayTheBlues4U [4h 6s]
w111r@n: folds 
zombiehedgehog: raises $0.10 to $0.20
SeaofLove: folds 
KeithTurbo48: folds 
ng2414: folds 
PlayTheBlues4U: folds 
Uncalled bet ($0.10) returned to zombiehedgehog
zombiehedgehog collected $0.25 from pot
zombiehedgehog: doesn't show hand 
*** SUMMARY ***
Total pot $0.25 | Rake $0 
Seat 1: zombiehedgehog collected ($0.25)
Seat 2: SeaofLove folded before Flop (didn't bet)
Seat 3: KeithTurbo48 (button) folded before Flop (didn't bet)
Seat 4: ng2414 (small blind) folded before Flop
Seat 5: PlayTheBlues4U (big blind) folded before Flop
Seat 6: w111r@n folded before Flop (didn't bet)


PokerStars Hand #204907679476: Hold'em No Limit ($0.05/$0.10 USD) - 2019/10/22 22:14:53 ET
Table 'Celuta' 6-max Seat #1 is the button
Seat 1: trumpcaddy ($12.31 in chips) 
Seat 2: SeaofLove ($10.27 in chips) 
Seat 3: ng2414 ($9.35 in chips) 
Seat 4: ney1202 ($10.78 in chips) 
Seat 5: KeithTurbo48 ($8.56 in chips) 
Seat 6: PlayTheBlues4U ($19.92 in chips) 
SeaofLove: posts small blind $0.05
ng2414: posts big blind $0.10
*** HOLE CARDS ***
Dealt to PlayTheBlues4U [Kd 7d]
ney1202: folds 
KeithTurbo48: raises $0.15 to $0.25
ney1202 leaves the table
PlayTheBlues4U: folds 
trumpcaddy: folds 
SeaofLove: folds 
ng2414: folds 
Uncalled bet ($0.15) returned to KeithTurbo48
KeithTurbo48 collected $0.25 from pot
KeithTurbo48: doesn't show hand 
*** SUMMARY ***
Total pot $0.25 | Rake $0 
Seat 1: trumpcaddy (button) folded before Flop (didn't bet)
Seat 2: SeaofLove (small blind) folded before Flop
Seat 3: ng2414 (big blind) folded before Flop
Seat 4: ney1202 folded before Flop (didn't bet)
Seat 5: KeithTurbo48 collected ($0.25)
Seat 6: PlayTheBlues4U folded before Flop (didn't bet)


PokerStars Hand #204907679373: Hold'em No Limit ($0.05/$0.10 USD) - 2019/10/22 22:14:26 ET
Table 'Celuta' 6-max Seat #6 is the button
Seat 1: trumpcaddy ($12.36 in chips) 
Seat 2: SeaofLove ($10 in chips) 
Seat 3: ng2414 ($9.35 in chips) 
Seat 4: ney1202 ($10.78 in chips) 
Seat 5: KeithTurbo48 ($8.56 in chips) 
Seat 6: PlayTheBlues4U ($20.17 in chips) 
trumpcaddy: posts small blind $0.05
SeaofLove: posts big blind $0.10
*** HOLE CARDS ***
Dealt to PlayTheBlues4U [Qd 7d]
ng2414: folds 
ney1202: folds 
KeithTurbo48: folds 
PlayTheBlues4U: raises $0.15 to $0.25
trumpcaddy: folds 
SeaofLove: calls $0.15
*** FLOP *** [Js 6c 3h]
SeaofLove: checks 
PlayTheBlues4U: checks 
*** TURN *** [Js 6c 3h] [2d]
SeaofLove: bets $0.17
PlayTheBlues4U: folds 
Uncalled bet ($0.17) returned to SeaofLove
SeaofLove collected $0.52 from pot
SeaofLove: doesn't show hand 
*** SUMMARY ***
Total pot $0.55 | Rake $0.03 
Board [Js 6c 3h 2d]
Seat 1: trumpcaddy (small blind) folded before Flop
Seat 2: SeaofLove (big blind) collected ($0.52)
Seat 3: ng2414 folded before Flop (didn't bet)
Seat 4: ney1202 folded before Flop (didn't bet)
Seat 5: KeithTurbo48 folded before Flop (didn't bet)
Seat 6: PlayTheBlues4U (button) folded on the Turn


PokerStars Hand #204907679327: Hold'em No Limit ($0.05/$0.10 USD) - 2019/10/22 22:14:15 ET
Table 'Danae' 6-max Seat #2 is the button
Seat 1: zombiehedgehog ($20.58 in chips) 
Seat 2: SeaofLove ($10 in chips) 
Seat 3: KeithTurbo48 ($12.15 in chips) 
Seat 4: ng2414 ($14.68 in chips) 
Seat 5: PlayTheBlues4U ($9.02 in chips) 
Seat 6: w111r@n ($8.08 in chips) 
KeithTurbo48: posts small blind $0.05
ng2414: posts big blind $0.10
*** HOLE CARDS ***
Dealt to PlayTheBlues4U [7h Th]
PlayTheBlues4U: folds 
w111r@n: folds 
zombiehedgehog: folds 
SeaofLove: folds 
KeithTurbo48: calls $0.05
ng2414: checks 
*** FLOP *** [Qc 8s 8c]
KeithTurbo48: checks 
ng2414: checks 
*** TURN *** [Qc 8s 8c] [Ad]
KeithTurbo48: checks 
ng2414: checks 
*** RIVER *** [Qc 8s 8c Ad] [Kh]
KeithTurbo48: checks 
ng2414: checks 
*** SHOW DOWN ***
KeithTurbo48: shows [4c 5h] (a pair of Eights)
ng2414: shows [Kc 7s] (two pair, Kings and Eights)
ng2414 collected $0.19 from pot
*** SUMMARY ***
Total pot $0.20 | Rake $0.01 
Board [Qc 8s 8c Ad Kh]
Seat 1: zombiehedgehog folded before Flop (didn't bet)
Seat 2: SeaofLove (button) folded before Flop (didn't bet)
Seat 3: KeithTurbo48 (small blind) showed [4c 5h] and lost with a pair of Eights
Seat 4: ng2414 (big blind) showed [Kc 7s] and won ($0.19) with two pair, Kings and Eights
Seat 5: PlayTheBlues4U folded before Flop (didn't bet)
Seat 6: w111r@n folded before Flop (didn't bet)


PokerStars Hand #204907679232: Hold'em No Limit ($0.05/$0.10 USD) - 2019/10/22 22:13:52 ET
Table 'Danae' 6-max Seat #1 is the button
Seat 1: zombiehedgehog ($20.58 in chips) 
Seat 2: SeaofLove ($10 in chips) 
Seat 3: KeithTurbo48 ($12.35 in chips) 
Seat 4: ng2414 ($14.68 in chips) 
Seat 5: PlayTheBlues4U ($9.02 in chips) 
Seat 6: w111r@n ($7.85 in chips) 
SeaofLove: posts small blind $0.05
KeithTurbo48: posts big blind $0.10
*** HOLE CARDS ***
Dealt to PlayTheBlues4U [Ts Qh]
ng2414: folds 
PlayTheBlues4U: folds 
w111r@n: raises $0.10 to $0.20
zombiehedgehog: folds 
SeaofLove: folds 
KeithTurbo48: calls $0.10
*** FLOP *** [Ac Kh 5s]
KeithTurbo48: checks 
w111r@n: bets $0.20
KeithTurbo48: folds 
Uncalled bet ($0.20) returned to w111r@n
w111r@n collected $0.43 from pot
w111r@n: doesn't show hand 
*** SUMMARY ***
Total pot $0.45 | Rake $0.02 
Board [Ac Kh 5s]
Seat 1: zombiehedgehog (button) folded before Flop (didn't bet)
Seat 2: SeaofLove (small blind) folded before Flop
Seat 3: KeithTurbo48 (big blind) folded on the Flop
Seat 4: ng2414 folded before Flop (didn't bet)
Seat 5: PlayTheBlues4U folded before Flop (didn't bet)
Seat 6: w111r@n collected ($0.43)


PokerStars Hand #204907679151: Hold'em No Limit ($0.05/$0.10 USD) - 2019/10/22 22:13:32 ET
Table 'Danae' 6-max Seat #6 is the button
Seat 1: zombiehedgehog ($20.63 in chips) 
Seat 2: SeaofLove ($10 in chips) 
Seat 3: KeithTurbo48 ($12.35 in chips) 
Seat 4: ng2414 ($14.53 in chips) 
Seat 5: PlayTheBlues4U ($9.02 in chips) 
Seat 6: w111r@n ($7.85 in chips) 
zombiehedgehog: posts small blind $0.05
SeaofLove: posts big blind $0.10
*** HOLE CARDS ***
Dealt to PlayTheBlues4U [Th 8s]
KeithTurbo48: folds 
ng2414: raises $0.20 to $0.30
PlayTheBlues4U: folds 
w111r@n: folds 
zombiehedgehog: folds 
SeaofLove: folds 
Uncalled bet ($0.20) returned to ng2414
ng2414 collected $0.25 from pot
*** SUMMARY ***
Total pot $0.25 | Rake $0 
Seat 1: zombiehedgehog (small blind) folded before Flop
Seat 2: SeaofLove (big blind) folded before Flop
Seat 3: KeithTurbo48 folded before Flop (didn't bet)
Seat 4: ng2414 collected ($0.25)
Seat 5: PlayTheBlues4U folded before Flop (didn't bet)
Seat 6: w111r@n (button) folded before Flop (didn't bet)


PokerStars Hand #204907679102: Hold'em No Limit ($0.05/$0.10 USD) - 2019/10/22 22:13:22 ET
Table 'Danae' 6-max Seat #5 is the button
Seat 1: zombiehedgehog ($20.58 in chips) 
Seat 3: KeithTurbo48 ($12.35 in chips) 
Seat 4: ng2414 ($14.53 in chips) 
Seat 5: PlayTheBlues4U ($9.02 in chips) 
Seat 6: w111r@n ($7.90 in chips) 
w111r@n: posts small blind $0.05
zombiehedgehog: posts big blind $0.10
SeaofLove: sits out 
*** HOLE CARDS ***
Dealt to PlayTheBlues4U [6s 4d]
KeithTurbo48: folds 
ng2414: folds 
PlayTheBlues4U: folds 
w111r@n: folds 
Uncalled bet ($0.05) returned to zombiehedgehog
zombiehedgehog collected $0.10 from pot
zombiehedgehog: doesn't show hand 
*** SUMMARY ***
Total pot $0.10 | Rake $0 
Seat 1: zombiehedgehog (big blind) collected ($0.10)
Seat 3: KeithTurbo48 folded before Flop (didn't bet)
Seat 4: ng2414 folded before Flop (didn't bet)
Seat 5: PlayTheBlues4U (button) folded before Flop (didn't bet)
Seat 6: w111r@n (small blind) folded before Flop


PokerStars Hand #204907679064: Hold'em No Limit ($0.05/$0.10 USD) - 2019/10/22 22:13:14 ET
Table 'Celuta' 6-max Seat #5 is the button
Seat 1: trumpcaddy ($12.46 in chips) 
Seat 3: ng2414 ($9.35 in chips) 
Seat 4: ney1202 ($10.78 in chips) 
Seat 5: KeithTurbo48 ($12.06 in chips) 
Seat 6: PlayTheBlues4U ($16.93 in chips) 
PlayTheBlues4U: posts small blind $0.05
trumpcaddy: posts big blind $0.10
SeaofLove: sits out 
*** HOLE CARDS ***
Dealt to PlayTheBlues4U [Ac Ks]
ng2414: folds 
ney1202: folds 
KeithTurbo48: raises $0.15 to $0.25
PlayTheBlues4U: raises $0.45 to $0.70
trumpcaddy: folds 
KeithTurbo48: calls $0.45
*** FLOP *** [5s 4s Jd]
PlayTheBlues4U: bets $0.90
KeithTurbo48: calls $0.90
*** TURN *** [5s 4s Jd] [3d]
PlayTheBlues4U: checks 
KeithTurbo48: bets $1.90
PlayTheBlues4U: calls $1.90
*** RIVER *** [5s 4s Jd 3d] [Kd]
PlayTheBlues4U: checks 
KeithTurbo48: checks 
*** SHOW DOWN ***
PlayTheBlues4U: shows [Ac Ks] (a pair of Kings)
KeithTurbo48: mucks hand 
PlayTheBlues4U collected $6.74 from pot
*** SUMMARY ***
Total pot $7.10 | Rake $0.36 
Board [5s 4s Jd 3d Kd]
Seat 1: trumpcaddy (big blind) folded before Flop
Seat 3: ng2414 folded before Flop (didn't bet)
Seat 4: ney1202 folded before Flop (didn't bet)
Seat 5: KeithTurbo48 (button) mucked [Jc 9d]
Seat 6: PlayTheBlues4U (small blind) showed [Ac Ks] and won ($6.74) with a pair of Kings


PokerStars Hand #204907678988: Hold'em No Limit ($0.05/$0.10 USD) - 2019/10/22 22:12:55 ET
Table 'Celuta' 6-max Seat #4 is the button
Seat 1: trumpcaddy ($12.46 in chips) 
Seat 3: ng2414 ($9.20 in chips) 
Seat 4: ney1202 ($10.78 in chips) 
Seat 5: KeithTurbo48 ($12.11 in chips) 
Seat 6: PlayTheBlues4U ($17.03 in chips) 
KeithTurbo48: posts small blind $0.05
PlayTheBlues4U: posts big blind $0.10
SeaofLove: sits out 
*** HOLE CARDS ***
Dealt to PlayTheBlues4U [Th 3d]
trumpcaddy: folds 
ng2414: raises $0.20 to $0.30
ney1202: folds 
KeithTurbo48: folds 
PlayTheBlues4U: folds 
Uncalled bet ($0.20) returned to ng2414
ng2414 collected $0.25 from pot
*** SUMMARY ***
Total pot $0.25 | Rake $0 
Seat 1: trumpcaddy folded before Flop (didn't bet)
Seat 3: ng2414 collected ($0.25)
Seat 4: ney1202 (button) folded before Flop (didn't bet)
Seat 5: KeithTurbo48 (small blind) folded before Flop
Seat 6: PlayTheBlues4U (big blind) folded before Flop


PokerStars Hand #204907678935: Hold'em No Limit ($0.05/$0.10 USD) - 2019/10/22 22:12:43 ET
Table 'Celuta' 6-max Seat #3 is the button
Seat 1: trumpcaddy ($12.46 in chips) 
Seat 3: ng2414 ($9.20 in chips) 
Seat 4: ney1202 ($10.83 in chips) 
Seat 5: KeithTurbo48 ($12.06 in chips) 
Seat 6: PlayTheBlues4U ($17.03 in chips) 
ney1202: posts small blind $0.05
KeithTurbo48: posts big blind $0.10
SeaofLove: sits out 
*** HOLE CARDS ***
Dealt to PlayTheBlues4U [9d 5h]
PlayTheBlues4U: folds 
trumpcaddy: folds 
ng2414: folds 
ney1202: folds 
Uncalled bet ($0.05) returned to KeithTurbo48
KeithTurbo48 collected $0.10 from pot
KeithTurbo48: doesn't show hand 
*** SUMMARY ***
Total pot $0.10 | Rake $0 
Seat 1: trumpcaddy folded before Flop (didn't bet)
Seat 3: ng2414 (button) folded before Flop (didn't bet)
Seat 4: ney1202 (small blind) folded before Flop
Seat 5: KeithTurbo48 (big blind) collected ($0.10)
Seat 6: PlayTheBlues4U folded before Flop (didn't bet)


PokerStars Hand #204907678836: Hold'em No Limit ($0.05/$0.10 USD) - 2019/10/22 22:12:20 ET
Table 'Celuta' 6-max Seat #2 is the button
Seat 1: trumpcaddy ($12.31 in chips) 
Seat 2: dcami_nj ($10 in chips) 
Seat 3: ng2414 ($9.25 in chips) 
Seat 4: ney1202 ($10.93 in chips) 
Seat 5: KeithTurbo48 ($12.06 in chips) 
Seat 6: PlayTheBlues4U ($17.03 in chips) 
ng2414: posts small blind $0.05
ney1202: posts big blind $0.10
*** HOLE CARDS ***
Dealt to PlayTheBlues4U [Kd 9s]
KeithTurbo48: folds 
PlayTheBlues4U: folds 
trumpcaddy: raises $0.25 to $0.35
dcami_nj: folds 
dcami_nj leaves the table
SeaofLove joins the table at seat #2 
ng2414: folds 
ney1202: folds 
Uncalled bet ($0.25) returned to trumpcaddy
trumpcaddy collected $0.25 from pot
trumpcaddy: doesn't show hand 
*** SUMMARY ***
Total pot $0.25 | Rake $0 
Seat 1: trumpcaddy collected ($0.25)
Seat 2: dcami_nj (button) folded before Flop (didn't bet)
Seat 3: ng2414 (small blind) folded before Flop
Seat 4: ney1202 (big blind) folded before Flop
Seat 5: KeithTurbo48 folded before Flop (didn't bet)
Seat 6: PlayTheBlues4U folded before Flop (didn't bet)


PokerStars Hand #204907678819: Hold'em No Limit ($0.05/$0.10 USD) - 2019/10/22 22:12:16 ET
Table 'Danae' 6-max Seat #4 is the button
Seat 1: zombiehedgehog ($20.03 in chips) 
Seat 2: dcami_nj ($7.80 in chips) 
Seat 3: KeithTurbo48 ($12.35 in chips) 
Seat 4: ng2414 ($14.98 in chips) 
Seat 5: PlayTheBlues4U ($9.07 in chips) 
Seat 6: w111r@n ($8 in chips) 
PlayTheBlues4U: posts small blind $0.05
w111r@n: posts big blind $0.10
*** HOLE CARDS ***
Dealt to PlayTheBlues4U [Jd 7d]
zombiehedgehog: calls $0.10
dcami_nj: folds 
KeithTurbo48: folds 
dcami_nj leaves the table
SeaofLove joins the table at seat #2 
ng2414: raises $0.35 to $0.45
PlayTheBlues4U: folds 
w111r@n: folds 
zombiehedgehog: calls $0.35
*** FLOP *** [9c 9s Ts]
zombiehedgehog: checks 
ng2414: checks 
*** TURN *** [9c 9s Ts] [8c]
zombiehedgehog: bets $1
ng2414: folds 
Uncalled bet ($1) returned to zombiehedgehog
zombiehedgehog collected $1 from pot
zombiehedgehog: doesn't show hand 
*** SUMMARY ***
Total pot $1.05 | Rake $0.05 
Board [9c 9s Ts 8c]
Seat 1: zombiehedgehog collected ($1)
Seat 2: dcami_nj folded before Flop (didn't bet)
Seat 3: KeithTurbo48 folded before Flop (didn't bet)
Seat 4: ng2414 (button) folded on the Turn
Seat 5: PlayTheBlues4U (small blind) folded before Flop
Seat 6: w111r@n (big blind) folded before Flop


PokerStars Hand #204907678749: Hold'em No Limit ($0.05/$0.10 USD) - 2019/10/22 22:12:00 ET
Table 'Celuta' 6-max Seat #1 is the button
Seat 1: trumpcaddy ($12.31 in chips) 
Seat 2: dcami_nj ($7.74 in chips) 
Seat 3: ng2414 ($9.20 in chips) 
Seat 4: ney1202 ($10.93 in chips) 
Seat 5: KeithTurbo48 ($12.06 in chips) 
Seat 6: PlayTheBlues4U ($17.03 in chips) 
dcami_nj: posts small blind $0.05
ng2414: posts big blind $0.10
*** HOLE CARDS ***
Dealt to PlayTheBlues4U [6c Td]
ney1202: folds 
KeithTurbo48: folds 
PlayTheBlues4U: folds 
trumpcaddy: folds 
dcami_nj: folds 
Uncalled bet ($0.05) returned to ng2414
ng2414 collected $0.10 from pot
*** SUMMARY ***
Total pot $0.10 | Rake $0 
Seat 1: trumpcaddy (button) folded before Flop (didn't bet)
Seat 2: dcami_nj (small blind) folded before Flop
Seat 3: ng2414 (big blind) collected ($0.10)
Seat 4: ney1202 folded before Flop (didn't bet)
Seat 5: KeithTurbo48 folded before Flop (didn't bet)
Seat 6: PlayTheBlues4U folded before Flop (didn't bet)


PokerStars Hand #204907678495: Hold'em No Limit ($0.05/$0.10 USD) - 2019/10/22 22:10:56 ET
Table 'Danae' 6-max Seat #3 is the button
Seat 1: zombiehedgehog ($20.03 in chips) 
Seat 2: dcami_nj ($5.60 in chips) 
Seat 3: KeithTurbo48 ($10.59 in chips) 
Seat 4: ng2414 ($15.03 in chips) 
Seat 5: PlayTheBlues4U ($9.17 in chips) 
ng2414: posts small blind $0.05
PlayTheBlues4U: posts big blind $0.10
w111r@n: sits out 
*** HOLE CARDS ***
Dealt to PlayTheBlues4U [6c Kd]
zombiehedgehog: folds 
dcami_nj: raises $0.30 to $0.40
KeithTurbo48: calls $0.40
ng2414: folds 
PlayTheBlues4U: folds 
*** FLOP *** [8c Js Jc]
dcami_nj: bets $0.50
KeithTurbo48: calls $0.50
*** TURN *** [8c Js Jc] [4d]
dcami_nj: bets $0.90
KeithTurbo48: raises $2.50 to $3.40
dcami_nj: folds 
Uncalled bet ($2.50) returned to KeithTurbo48
KeithTurbo48 collected $3.56 from pot
KeithTurbo48: doesn't show hand 
*** SUMMARY ***
Total pot $3.75 | Rake $0.19 
Board [8c Js Jc 4d]
Seat 1: zombiehedgehog folded before Flop (didn't bet)
Seat 2: dcami_nj folded on the Turn
Seat 3: KeithTurbo48 (button) collected ($3.56)
Seat 4: ng2414 (small blind) folded before Flop
Seat 5: PlayTheBlues4U (big blind) folded before Flop


PokerStars Hand #204907678335: Hold'em No Limit ($0.05/$0.10 USD) - 2019/10/22 22:10:17 ET
Table 'Celuta' 6-max Seat #6 is the button
Seat 1: trumpcaddy ($12.36 in chips) 
Seat 2: dcami_nj ($16.68 in chips) 
Seat 3: ng2414 ($9.20 in chips) 
Seat 4: ney1202 ($10.93 in chips) 
Seat 5: KeithTurbo48 ($12.06 in chips) 
Seat 6: PlayTheBlues4U ($8.94 in chips) 
trumpcaddy: posts small blind $0.05
dcami_nj: posts big blind $0.10
*** HOLE CARDS ***
Dealt to PlayTheBlues4U [6s 6c]
ng2414 has timed out
ng2414: folds 
ney1202: folds 
KeithTurbo48: folds 
PlayTheBlues4U: raises $0.15 to $0.25
trumpcaddy: folds 
dcami_nj: raises $0.65 to $0.90
PlayTheBlues4U: calls $0.65
*** FLOP *** [6h 6d 8h]
dcami_nj: bets $1
PlayTheBlues4U: calls $1
*** TURN *** [6h 6d 8h] [8c]
dcami_nj: bets $2
PlayTheBlues4U: calls $2
*** RIVER *** [6h 6d 8h 8c] [Tc]
dcami_nj: bets $3.70
PlayTheBlues4U: raises $1.34 to $5.04 and is all-in
dcami_nj: calls $1.34
*** SHOW DOWN ***
PlayTheBlues4U: shows [6s 6c] (four of a kind, Sixes)
dcami_nj: shows [Jd Jh] (two pair, Jacks and Eights)
PlayTheBlues4U collected $17.03 from pot
*** SUMMARY ***
Total pot $17.93 | Rake $0.90 
Board [6h 6d 8h 8c Tc]
Seat 1: trumpcaddy (small blind) folded before Flop
Seat 2: dcami_nj (big blind) showed [Jd Jh] and lost with two pair, Jacks and Eights
Seat 3: ng2414 folded before Flop (didn't bet)
Seat 4: ney1202 folded before Flop (didn't bet)
Seat 5: KeithTurbo48 folded before Flop (didn't bet)
Seat 6: PlayTheBlues4U (button) showed [6s 6c] and won ($17.03) with four of a kind, Sixes


PokerStars Hand #204907678126: Hold'em No Limit ($0.05/$0.10 USD) - 2019/10/22 22:09:27 ET
Table 'Celuta' 6-max Seat #5 is the button
Seat 1: trumpcaddy ($13.16 in chips) 
Seat 2: dcami_nj ($15.15 in chips) 
Seat 3: ng2414 ($9.20 in chips) 
Seat 4: ney1202 ($10.93 in chips) 
Seat 5: KeithTurbo48 ($12.86 in chips) 
Seat 6: PlayTheBlues4U ($8.99 in chips) 
PlayTheBlues4U: posts small blind $0.05
trumpcaddy: posts big blind $0.10
*** HOLE CARDS ***
Dealt to PlayTheBlues4U [Td 2c]
dcami_nj: raises $0.20 to $0.30
ng2414: folds 
ney1202: folds 
KeithTurbo48: calls $0.30
PlayTheBlues4U: folds 
trumpcaddy: calls $0.20
*** FLOP *** [Tc 3h 5s]
trumpcaddy: checks 
dcami_nj: bets $0.50
KeithTurbo48: calls $0.50
trumpcaddy: calls $0.50
*** TURN *** [Tc 3h 5s] [Jc]
trumpcaddy: checks 
dcami_nj: bets $1.50
KeithTurbo48: folds 
trumpcaddy: folds 
Uncalled bet ($1.50) returned to dcami_nj
dcami_nj collected $2.33 from pot
dcami_nj: doesn't show hand 
*** SUMMARY ***
Total pot $2.45 | Rake $0.12 
Board [Tc 3h 5s Jc]
Seat 1: trumpcaddy (big blind) folded on the Turn
Seat 2: dcami_nj collected ($2.33)
Seat 3: ng2414 folded before Flop (didn't bet)
Seat 4: ney1202 folded before Flop (didn't bet)
Seat 5: KeithTurbo48 (button) folded on the Turn
Seat 6: PlayTheBlues4U (small blind) folded before Flop


PokerStars Hand #204907678020: Hold'em No Limit ($0.05/$0.10 USD) - 2019/10/22 22:09:03 ET
Table 'Celuta' 6-max Seat #4 is the button
Seat 1: trumpcaddy ($13.16 in chips) 
Seat 2: dcami_nj ($15.15 in chips) 
Seat 4: ney1202 ($10.93 in chips) 
Seat 5: KeithTurbo48 ($12.76 in chips) 
Seat 6: PlayTheBlues4U ($9.09 in chips) 
KeithTurbo48: posts small blind $0.05
PlayTheBlues4U: posts big blind $0.10
*** HOLE CARDS ***
Dealt to PlayTheBlues4U [9h 8s]
trumpcaddy: folds 
dcami_nj: folds 
ney1202: folds 
KeithTurbo48: raises $0.20 to $0.30
PlayTheBlues4U: folds 
Uncalled bet ($0.20) returned to KeithTurbo48
KeithTurbo48 collected $0.20 from pot
KeithTurbo48: doesn't show hand 
*** SUMMARY ***
Total pot $0.20 | Rake $0 
Seat 1: trumpcaddy folded before Flop (didn't bet)
Seat 2: dcami_nj folded before Flop (didn't bet)
Seat 4: ney1202 (button) folded before Flop (didn't bet)
Seat 5: KeithTurbo48 (small blind) collected ($0.20)
Seat 6: PlayTheBlues4U (big blind) folded before Flop


PokerStars Hand #204907677994: Hold'em No Limit ($0.05/$0.10 USD) - 2019/10/22 22:08:56 ET
Table 'Danae' 6-max Seat #2 is the button
Seat 1: zombiehedgehog ($20.03 in chips) 
Seat 2: dcami_nj ($11.25 in chips) 
Seat 3: KeithTurbo48 ($10.64 in chips) 
Seat 4: ng2414 ($9.90 in chips) 
Seat 5: PlayTheBlues4U ($9.17 in chips) 
KeithTurbo48: posts small blind $0.05
ng2414: posts big blind $0.10
w111r@n: sits out 
*** HOLE CARDS ***
Dealt to PlayTheBlues4U [9d Jd]
PlayTheBlues4U: folds 
zombiehedgehog: folds 
dcami_nj: raises $0.20 to $0.30
KeithTurbo48: folds 
ng2414: raises $0.65 to $0.95
dcami_nj: calls $0.65
*** FLOP *** [5s Ah Jc]
ng2414: checks 
dcami_nj: bets $1
ng2414: calls $1
*** TURN *** [5s Ah Jc] [5d]
ng2414: checks 
dcami_nj: bets $3.70
ng2414: calls $3.70
*** RIVER *** [5s Ah Jc 5d] [Ad]
ng2414: bets $3.10
dcami_nj: folds 
Uncalled bet ($3.10) returned to ng2414
ng2414 collected $10.78 from pot
*** SUMMARY ***
Total pot $11.35 | Rake $0.57 
Board [5s Ah Jc 5d Ad]
Seat 1: zombiehedgehog folded before Flop (didn't bet)
Seat 2: dcami_nj (button) folded on the River
Seat 3: KeithTurbo48 (small blind) folded before Flop
Seat 4: ng2414 (big blind) collected ($10.78)
Seat 5: PlayTheBlues4U folded before Flop (didn't bet)


PokerStars Hand #204907677890: Hold'em No Limit ($0.05/$0.10 USD) - 2019/10/22 22:08:33 ET
Table 'Celuta' 6-max Seat #3 is the button
Seat 1: trumpcaddy ($13.16 in chips) 
Seat 2: dcami_nj ($15.15 in chips) 
Seat 3: ng2414 ($9.20 in chips) 
Seat 4: ney1202 ($10.98 in chips) 
Seat 5: KeithTurbo48 ($12.71 in chips) 
Seat 6: PlayTheBlues4U ($9.09 in chips) 
ney1202: posts small blind $0.05
KeithTurbo48: posts big blind $0.10
*** HOLE CARDS ***
Dealt to PlayTheBlues4U [Td Js]
PlayTheBlues4U: folds 
trumpcaddy: folds 
dcami_nj: folds 
ng2414 has timed out
ng2414: folds 
ney1202: folds 
Uncalled bet ($0.05) returned to KeithTurbo48
KeithTurbo48 collected $0.10 from pot
KeithTurbo48: doesn't show hand 
*** SUMMARY ***
Total pot $0.10 | Rake $0 
Seat 1: trumpcaddy folded before Flop (didn't bet)
Seat 2: dcami_nj folded before Flop (didn't bet)
Seat 3: ng2414 (button) folded before Flop (didn't bet)
Seat 4: ney1202 (small blind) folded before Flop
Seat 5: KeithTurbo48 (big blind) collected ($0.10)
Seat 6: PlayTheBlues4U folded before Flop (didn't bet)


PokerStars Hand #204907677767: Hold'em No Limit ($0.05/$0.10 USD) - 2019/10/22 22:08:06 ET
Table 'Danae' 6-max Seat #1 is the button
Seat 1: zombiehedgehog ($20.38 in chips) 
Seat 2: dcami_nj ($12.10 in chips) 
Seat 3: KeithTurbo48 ($9.54 in chips) 
Seat 4: ng2414 ($9.90 in chips) 
Seat 5: PlayTheBlues4U ($9.17 in chips) 
dcami_nj: posts small blind $0.05
KeithTurbo48: posts big blind $0.10
w111r@n: sits out 
*** HOLE CARDS ***
Dealt to PlayTheBlues4U [2s 4s]
ng2414: folds 
PlayTheBlues4U: folds 
zombiehedgehog: raises $0.25 to $0.35
dcami_nj: calls $0.30
KeithTurbo48: calls $0.25
*** FLOP *** [Th Js Qh]
dcami_nj: bets $0.50
KeithTurbo48: calls $0.50
zombiehedgehog: folds 
*** TURN *** [Th Js Qh] [2c]
dcami_nj: checks 
KeithTurbo48: bets $1.90
dcami_nj: folds 
Uncalled bet ($1.90) returned to KeithTurbo48
KeithTurbo48 collected $1.95 from pot
KeithTurbo48: doesn't show hand 
*** SUMMARY ***
Total pot $2.05 | Rake $0.10 
Board [Th Js Qh 2c]
Seat 1: zombiehedgehog (button) folded on the Flop
Seat 2: dcami_nj (small blind) folded on the Turn
Seat 3: KeithTurbo48 (big blind) collected ($1.95)
Seat 4: ng2414 folded before Flop (didn't bet)
Seat 5: PlayTheBlues4U folded before Flop (didn't bet)


PokerStars Hand #204907677740: Hold'em No Limit ($0.05/$0.10 USD) - 2019/10/22 22:07:59 ET
Table 'Celuta' 6-max Seat #2 is the button
Seat 1: trumpcaddy ($13.16 in chips) 
Seat 2: dcami_nj ($15.15 in chips) 
Seat 3: ng2414 ($9.25 in chips) 
Seat 4: ney1202 ($11.08 in chips) 
Seat 5: KeithTurbo48 ($12.71 in chips) 
Seat 6: PlayTheBlues4U ($8.94 in chips) 
ng2414: posts small blind $0.05
ney1202: posts big blind $0.10
*** HOLE CARDS ***
Dealt to PlayTheBlues4U [Qd Qh]
KeithTurbo48: folds 
PlayTheBlues4U: raises $0.20 to $0.30
trumpcaddy: folds 
dcami_nj: folds 
ng2414: folds 
ney1202: folds 
Uncalled bet ($0.20) returned to PlayTheBlues4U
PlayTheBlues4U collected $0.25 from pot
PlayTheBlues4U: doesn't show hand 
*** SUMMARY ***
Total pot $0.25 | Rake $0 
Seat 1: trumpcaddy folded before Flop (didn't bet)
Seat 2: dcami_nj (button) folded before Flop (didn't bet)
Seat 3: ng2414 (small blind) folded before Flop
Seat 4: ney1202 (big blind) folded before Flop
Seat 5: KeithTurbo48 folded before Flop (didn't bet)
Seat 6: PlayTheBlues4U collected ($0.25)


PokerStars Hand #204907677646: Hold'em No Limit ($0.05/$0.10 USD) - 2019/10/22 22:07:41 ET
Table 'Danae' 6-max Seat #5 is the button
Seat 1: zombiehedgehog ($20.29 in chips) 
Seat 2: dcami_nj ($12.20 in chips) 
Seat 3: KeithTurbo48 ($9.54 in chips) 
Seat 4: ng2414 ($9.90 in chips) 
Seat 5: PlayTheBlues4U ($9.17 in chips) 
w111r@n will be allowed to play after the button
zombiehedgehog: posts small blind $0.05
dcami_nj: posts big blind $0.10
*** HOLE CARDS ***
Dealt to PlayTheBlues4U [8c 4h]
KeithTurbo48: folds 
ng2414: folds 
PlayTheBlues4U: folds 
zombiehedgehog: calls $0.05
dcami_nj: checks 
*** FLOP *** [3s 8s Qh]
zombiehedgehog: checks 
dcami_nj: checks 
*** TURN *** [3s 8s Qh] [Th]
zombiehedgehog: bets $0.10
dcami_nj: folds 
Uncalled bet ($0.10) returned to zombiehedgehog
zombiehedgehog collected $0.19 from pot
zombiehedgehog: doesn't show hand 
*** SUMMARY ***
Total pot $0.20 | Rake $0.01 
Board [3s 8s Qh Th]
Seat 1: zombiehedgehog (small blind) collected ($0.19)
Seat 2: dcami_nj (big blind) folded on the Turn
Seat 3: KeithTurbo48 folded before Flop (didn't bet)
Seat 4: ng2414 folded before Flop (didn't bet)
Seat 5: PlayTheBlues4U (button) folded before Flop (didn't bet)


PokerStars Hand #204907677543: Hold'em No Limit ($0.05/$0.10 USD) - 2019/10/22 22:07:16 ET
Table 'Danae' 6-max Seat #4 is the button
Seat 1: zombiehedgehog ($20.39 in chips) 
Seat 2: dcami_nj ($12.20 in chips) 
Seat 3: KeithTurbo48 ($9.39 in chips) 
Seat 4: ng2414 ($9.90 in chips) 
Seat 5: PlayTheBlues4U ($9.22 in chips) 
PlayTheBlues4U: posts small blind $0.05
zombiehedgehog: posts big blind $0.10
*** HOLE CARDS ***
Dealt to PlayTheBlues4U [5s 6c]
dcami_nj: folds 
KeithTurbo48: raises $0.15 to $0.25
ng2414: folds 
w111r@n joins the table at seat #6 
PlayTheBlues4U: folds 
zombiehedgehog: folds 
Uncalled bet ($0.15) returned to KeithTurbo48
KeithTurbo48 collected $0.25 from pot
KeithTurbo48: doesn't show hand 
*** SUMMARY ***
Total pot $0.25 | Rake $0 
Seat 1: zombiehedgehog (big blind) folded before Flop
Seat 2: dcami_nj folded before Flop (didn't bet)
Seat 3: KeithTurbo48 collected ($0.25)
Seat 4: ng2414 (button) folded before Flop (didn't bet)
Seat 5: PlayTheBlues4U (small blind) folded before Flop


PokerStars Hand #204907677518: Hold'em No Limit ($0.05/$0.10 USD) - 2019/10/22 22:07:11 ET
Table 'Celuta' 6-max Seat #1 is the button
Seat 1: trumpcaddy ($13.16 in chips) 
Seat 2: dcami_nj ($15.20 in chips) 
Seat 3: ng2414 ($9.50 in chips) 
Seat 4: ney1202 ($11.08 in chips) 
Seat 5: KeithTurbo48 ($12.44 in chips) 
Seat 6: PlayTheBlues4U ($8.94 in chips) 
dcami_nj: posts small blind $0.05
ng2414: posts big blind $0.10
*** HOLE CARDS ***
Dealt to PlayTheBlues4U [Jc 4h]
ney1202: folds 
KeithTurbo48: raises $0.15 to $0.25
PlayTheBlues4U: folds 
trumpcaddy: folds 
dcami_nj: folds 
ng2414: calls $0.15
*** FLOP *** [6s Js Td]
ng2414: checks 
KeithTurbo48: checks 
*** TURN *** [6s Js Td] [7d]
ng2414: checks 
KeithTurbo48: bets $0.38
ng2414: folds 
Uncalled bet ($0.38) returned to KeithTurbo48
KeithTurbo48 collected $0.52 from pot
KeithTurbo48: doesn't show hand 
*** SUMMARY ***
Total pot $0.55 | Rake $0.03 
Board [6s Js Td 7d]
Seat 1: trumpcaddy (button) folded before Flop (didn't bet)
Seat 2: dcami_nj (small blind) folded before Flop
Seat 3: ng2414 (big blind) folded on the Turn
Seat 4: ney1202 folded before Flop (didn't bet)
Seat 5: KeithTurbo48 collected ($0.52)
Seat 6: PlayTheBlues4U folded before Flop (didn't bet)


PokerStars Hand #204907677435: Hold'em No Limit ($0.05/$0.10 USD) - 2019/10/22 22:06:53 ET
Table 'Danae' 6-max Seat #3 is the button
Seat 1: zombiehedgehog ($20.39 in chips) 
Seat 2: dcami_nj ($12.05 in chips) 
Seat 3: KeithTurbo48 ($9.39 in chips) 
Seat 4: ng2414 ($9.95 in chips) 
Seat 5: PlayTheBlues4U ($9.32 in chips) 
ng2414: posts small blind $0.05
PlayTheBlues4U: posts big blind $0.10
*** HOLE CARDS ***
Dealt to PlayTheBlues4U [3d Qs]
zombiehedgehog: folds 
dcami_nj: raises $0.20 to $0.30
KeithTurbo48: folds 
ng2414: folds 
PlayTheBlues4U: folds 
Uncalled bet ($0.20) returned to dcami_nj
dcami_nj collected $0.25 from pot
dcami_nj: doesn't show hand 
*** SUMMARY ***
Total pot $0.25 | Rake $0 
Seat 1: zombiehedgehog folded before Flop (didn't bet)
Seat 2: dcami_nj collected ($0.25)
Seat 3: KeithTurbo48 (button) folded before Flop (didn't bet)
Seat 4: ng2414 (small blind) folded before Flop
Seat 5: PlayTheBlues4U (big blind) folded before Flop


PokerStars Hand #204907677308: Hold'em No Limit ($0.05/$0.10 USD) - 2019/10/22 22:06:24 ET
Table 'Celuta' 6-max Seat #6 is the button
Seat 1: trumpcaddy ($13.21 in chips) 
Seat 2: dcami_nj ($15.45 in chips) 
Seat 3: ng2414 ($9.50 in chips) 
Seat 4: ney1202 ($11.08 in chips) 
Seat 5: KeithTurbo48 ($11.93 in chips) 
Seat 6: PlayTheBlues4U ($9.19 in chips) 
trumpcaddy: posts small blind $0.05
dcami_nj: posts big blind $0.10
*** HOLE CARDS ***
Dealt to PlayTheBlues4U [Td Jc]
ng2414: folds 
ney1202: folds 
KeithTurbo48: raises $0.15 to $0.25
PlayTheBlues4U: calls $0.25
trumpcaddy: folds 
dcami_nj: calls $0.15
*** FLOP *** [5c 5s 2d]
dcami_nj: checks 
KeithTurbo48: bets $0.25
PlayTheBlues4U: folds 
dcami_nj: folds 
Uncalled bet ($0.25) returned to KeithTurbo48
KeithTurbo48 collected $0.76 from pot
KeithTurbo48: doesn't show hand 
*** SUMMARY ***
Total pot $0.80 | Rake $0.04 
Board [5c 5s 2d]
Seat 1: trumpcaddy (small blind) folded before Flop
Seat 2: dcami_nj (big blind) folded on the Flop
Seat 3: ng2414 folded before Flop (didn't bet)
Seat 4: ney1202 folded before Flop (didn't bet)
Seat 5: KeithTurbo48 collected ($0.76)
Seat 6: PlayTheBlues4U (button) folded on the Flop


PokerStars Hand #204907677179: Hold'em No Limit ($0.05/$0.10 USD) - 2019/10/22 22:05:52 ET
Table 'Celuta' 6-max Seat #5 is the button
Seat 1: trumpcaddy ($13.51 in chips) 
Seat 2: dcami_nj ($15.45 in chips) 
Seat 3: ng2414 ($9.50 in chips) 
Seat 4: ney1202 ($11.08 in chips) 
Seat 5: KeithTurbo48 ($11.93 in chips) 
Seat 6: PlayTheBlues4U ($8.92 in chips) 
PlayTheBlues4U: posts small blind $0.05
trumpcaddy: posts big blind $0.10
*** HOLE CARDS ***
Dealt to PlayTheBlues4U [Jd Ac]
dcami_nj: folds 
ng2414: folds 
ney1202: folds 
KeithTurbo48: folds 
PlayTheBlues4U: raises $0.20 to $0.30
trumpcaddy: calls $0.20
*** FLOP *** [Ah 5d Qs]
PlayTheBlues4U: checks 
trumpcaddy: checks 
*** TURN *** [Ah 5d Qs] [Kd]
PlayTheBlues4U: bets $0.40
trumpcaddy: folds 
Uncalled bet ($0.40) returned to PlayTheBlues4U
PlayTheBlues4U collected $0.57 from pot
PlayTheBlues4U: doesn't show hand 
*** SUMMARY ***
Total pot $0.60 | Rake $0.03 
Board [Ah 5d Qs Kd]
Seat 1: trumpcaddy (big blind) folded on the Turn
Seat 2: dcami_nj folded before Flop (didn't bet)
Seat 3: ng2414 folded before Flop (didn't bet)
Seat 4: ney1202 folded before Flop (didn't bet)
Seat 5: KeithTurbo48 (button) folded before Flop (didn't bet)
Seat 6: PlayTheBlues4U (small blind) collected ($0.57)


PokerStars Hand #204907676944: Hold'em No Limit ($0.05/$0.10 USD) - 2019/10/22 22:04:59 ET
Table 'Danae' 6-max Seat #2 is the button
Seat 1: zombiehedgehog ($20.61 in chips) 
Seat 2: dcami_nj ($12.05 in chips) 
Seat 3: KeithTurbo48 ($9.44 in chips) 
Seat 4: ng2414 ($9.70 in chips) 
Seat 5: PlayTheBlues4U ($9.32 in chips) 
KeithTurbo48: posts small blind $0.05
ng2414: posts big blind $0.10
*** HOLE CARDS ***
Dealt to PlayTheBlues4U [7s Js]
PlayTheBlues4U: folds 
zombiehedgehog: calls $0.10
dcami_nj: folds 
KeithTurbo48: folds 
ng2414: checks 
*** FLOP *** [Kd 7d Jh]
ng2414: checks 
zombiehedgehog: checks 
*** TURN *** [Kd 7d Jh] [5d]
ng2414: checks 
zombiehedgehog: checks 
*** RIVER *** [Kd 7d Jh 5d] [Qs]
ng2414: checks 
zombiehedgehog: bets $0.12
ng2414: calls $0.12
*** SHOW DOWN ***
zombiehedgehog: shows [4s 8s] (high card King)
ng2414: shows [7h Th] (a pair of Sevens)
ng2414 collected $0.47 from pot
*** SUMMARY ***
Total pot $0.49 | Rake $0.02 
Board [Kd 7d Jh 5d Qs]
Seat 1: zombiehedgehog showed [4s 8s] and lost with high card King
Seat 2: dcami_nj (button) folded before Flop (didn't bet)
Seat 3: KeithTurbo48 (small blind) folded before Flop
Seat 4: ng2414 (big blind) showed [7h Th] and won ($0.47) with a pair of Sevens
Seat 5: PlayTheBlues4U folded before Flop (didn't bet)


PokerStars Hand #204907676892: Hold'em No Limit ($0.05/$0.10 USD) - 2019/10/22 22:04:47 ET
Table 'Celuta' 6-max Seat #4 is the button
Seat 1: trumpcaddy ($13.51 in chips) 
Seat 2: dcami_nj ($15.45 in chips) 
Seat 3: ng2414 ($9.50 in chips) 
Seat 4: ney1202 ($10.06 in chips) 
Seat 5: KeithTurbo48 ($11.98 in chips) 
Seat 6: PlayTheBlues4U ($10 in chips) 
KeithTurbo48: posts small blind $0.05
PlayTheBlues4U: posts big blind $0.10
*** HOLE CARDS ***
Dealt to PlayTheBlues4U [Js 7s]
trumpcaddy: folds 
dcami_nj: folds 
PlayTheBlues4U said, "wow"
ng2414: folds 
ney1202: raises $0.13 to $0.23
KeithTurbo48: folds 
PlayTheBlues4U: calls $0.13
*** FLOP *** [8s Kc Ad]
PlayTheBlues4U: checks 
ney1202: checks 
*** TURN *** [8s Kc Ad] [2d]
PlayTheBlues4U: bets $0.25
ney1202: calls $0.25
*** RIVER *** [8s Kc Ad 2d] [4c]
PlayTheBlues4U: bets $0.60
ney1202: calls $0.60
*** SHOW DOWN ***
PlayTheBlues4U: shows [Js 7s] (high card Ace)
ney1202: shows [6d Ah] (a pair of Aces)
ney1202 collected $2.10 from pot
*** SUMMARY ***
Total pot $2.21 | Rake $0.11 
Board [8s Kc Ad 2d 4c]
Seat 1: trumpcaddy folded before Flop (didn't bet)
Seat 2: dcami_nj folded before Flop (didn't bet)
Seat 3: ng2414 folded before Flop (didn't bet)
Seat 4: ney1202 (button) showed [6d Ah] and won ($2.10) with a pair of Aces
Seat 5: KeithTurbo48 (small blind) folded before Flop
Seat 6: PlayTheBlues4U (big blind) showed [Js 7s] and lost with high card Ace


PokerStars Hand #204907676631: Hold'em No Limit ($0.05/$0.10 USD) - 2019/10/22 22:03:47 ET
Table 'Danae' 6-max Seat #1 is the button
Seat 1: zombiehedgehog ($20.61 in chips) 
Seat 2: dcami_nj ($12.85 in chips) 
Seat 3: KeithTurbo48 ($8.44 in chips) 
Seat 4: ng2414 ($10 in chips) 
Seat 5: PlayTheBlues4U ($9.32 in chips) 
dcami_nj: posts small blind $0.05
KeithTurbo48: posts big blind $0.10
*** HOLE CARDS ***
Dealt to PlayTheBlues4U [4s Ah]
ng2414: raises $0.20 to $0.30
PlayTheBlues4U: folds 
zombiehedgehog: folds 
dcami_nj: calls $0.25
KeithTurbo48: calls $0.20
*** FLOP *** [Js Td 3c]
dcami_nj: checks 
KeithTurbo48: checks 
ng2414: checks 
*** TURN *** [Js Td 3c] [5s]
dcami_nj: bets $0.50
KeithTurbo48: calls $0.50
ng2414: folds 
*** RIVER *** [Js Td 3c 5s] [2s]
dcami_nj: checks 
KeithTurbo48: checks 
*** SHOW DOWN ***
dcami_nj: shows [6c 6d] (a pair of Sixes)
KeithTurbo48: shows [Ts Qd] (a pair of Tens)
KeithTurbo48 collected $1.80 from pot
*** SUMMARY ***
Total pot $1.90 | Rake $0.10 
Board [Js Td 3c 5s 2s]
Seat 1: zombiehedgehog (button) folded before Flop (didn't bet)
Seat 2: dcami_nj (small blind) showed [6c 6d] and lost with a pair of Sixes
Seat 3: KeithTurbo48 (big blind) showed [Ts Qd] and won ($1.80) with a pair of Tens
Seat 4: ng2414 folded on the Turn
Seat 5: PlayTheBlues4U folded before Flop (didn't bet)


PokerStars Hand #204907676579: Hold'em No Limit ($0.05/$0.10 USD) - 2019/10/22 22:03:38 ET
Table 'Celuta' 6-max Seat #3 is the button
Seat 1: trumpcaddy ($13.51 in chips) 
Seat 2: dcami_nj ($15.45 in chips) 
Seat 3: ng2414 ($9.50 in chips) 
Seat 4: ney1202 ($10.11 in chips) 
Seat 5: KeithTurbo48 ($6.28 in chips) 
Seat 6: PlayTheBlues4U ($10.17 in chips) 
ney1202: posts small blind $0.05
KeithTurbo48: posts big blind $0.10
*** HOLE CARDS ***
Dealt to PlayTheBlues4U [Tc Th]
PlayTheBlues4U: raises $0.20 to $0.30
trumpcaddy: folds 
dcami_nj: folds 
ng2414: folds 
ney1202: folds 
KeithTurbo48: calls $0.20
*** FLOP *** [6s 4c 4s]
KeithTurbo48: checks 
PlayTheBlues4U: bets $0.40
KeithTurbo48: raises $0.90 to $1.30
PlayTheBlues4U: calls $0.90
*** TURN *** [6s 4c 4s] [9c]
KeithTurbo48: bets $1.20
PlayTheBlues4U: raises $2.30 to $3.50
KeithTurbo48: raises $1.18 to $4.68 and is all-in
PlayTheBlues4U: calls $1.18
*** RIVER *** [6s 4c 4s 9c] [3h]
*** SHOW DOWN ***
KeithTurbo48: shows [4h 9h] (a full house, Fours full of Nines)
PlayTheBlues4U: shows [Tc Th] (two pair, Tens and Fours)
KeithTurbo48 collected $11.98 from pot
*** SUMMARY ***
Total pot $12.61 | Rake $0.63 
Board [6s 4c 4s 9c 3h]
Seat 1: trumpcaddy folded before Flop (didn't bet)
Seat 2: dcami_nj folded before Flop (didn't bet)
Seat 3: ng2414 (button) folded before Flop (didn't bet)
Seat 4: ney1202 (small blind) folded before Flop
Seat 5: KeithTurbo48 (big blind) showed [4h 9h] and won ($11.98) with a full house, Fours full of Nines
Seat 6: PlayTheBlues4U showed [Tc Th] and lost with two pair, Tens and Fours


PokerStars Hand #204907676434: Hold'em No Limit ($0.05/$0.10 USD) - 2019/10/22 22:03:05 ET
Table 'Celuta' 6-max Seat #2 is the button
Seat 1: trumpcaddy ($12.47 in chips) 
Seat 2: dcami_nj ($15.45 in chips) 
Seat 3: ng2414 ($9.55 in chips) 
Seat 4: ney1202 ($10.21 in chips) 
Seat 5: KeithTurbo48 ($7.28 in chips) 
Seat 6: PlayTheBlues4U ($10.17 in chips) 
ng2414: posts small blind $0.05
ney1202: posts big blind $0.10
*** HOLE CARDS ***
Dealt to PlayTheBlues4U [Td 9c]
KeithTurbo48: raises $0.15 to $0.25
PlayTheBlues4U: folds 
trumpcaddy: raises $0.75 to $1
dcami_nj: folds 
ng2414: folds 
ney1202: folds 
KeithTurbo48: calls $0.75
*** FLOP *** [Jd 7h Ts]
KeithTurbo48: checks 
trumpcaddy: bets $2
KeithTurbo48: folds 
Uncalled bet ($2) returned to trumpcaddy
trumpcaddy collected $2.04 from pot
trumpcaddy: doesn't show hand 
*** SUMMARY ***
Total pot $2.15 | Rake $0.11 
Board [Jd 7h Ts]
Seat 1: trumpcaddy collected ($2.04)
Seat 2: dcami_nj (button) folded before Flop (didn't bet)
Seat 3: ng2414 (small blind) folded before Flop
Seat 4: ney1202 (big blind) folded before Flop
Seat 5: KeithTurbo48 folded on the Flop
Seat 6: PlayTheBlues4U folded before Flop (didn't bet)


PokerStars Hand #204907676363: Hold'em No Limit ($0.05/$0.10 USD) - 2019/10/22 22:02:46 ET
Table 'Danae' 6-max Seat #6 is the button
Seat 1: zombiehedgehog ($22.16 in chips) 
Seat 2: dcami_nj ($10.84 in chips) 
Seat 3: KeithTurbo48 ($8.44 in chips) 
Seat 4: ng2414 ($10 in chips) 
Seat 5: PlayTheBlues4U ($9.32 in chips) 
Seat 6: kptrpt ($12.85 in chips) 
zombiehedgehog: posts small blind $0.05
dcami_nj: posts big blind $0.10
*** HOLE CARDS ***
Dealt to PlayTheBlues4U [Ad 6c]
KeithTurbo48: folds 
ng2414: folds 
PlayTheBlues4U: folds 
kptrpt: raises $0.15 to $0.25
zombiehedgehog: calls $0.20
dcami_nj: calls $0.15
*** FLOP *** [8c 7d Js]
zombiehedgehog: checks 
dcami_nj: bets $0.40
kptrpt: calls $0.40
zombiehedgehog: calls $0.40
*** TURN *** [8c 7d Js] [2s]
zombiehedgehog: checks 
dcami_nj: bets $0.90
kptrpt: folds 
kptrpt leaves the table
zombiehedgehog: calls $0.90
*** RIVER *** [8c 7d Js 2s] [4d]
zombiehedgehog: checks 
dcami_nj: checks 
*** SHOW DOWN ***
zombiehedgehog: shows [Td Kd] (high card King)
dcami_nj: shows [9s 8h] (a pair of Eights)
dcami_nj collected $3.56 from pot
*** SUMMARY ***
Total pot $3.75 | Rake $0.19 
Board [8c 7d Js 2s 4d]
Seat 1: zombiehedgehog (small blind) showed [Td Kd] and lost with high card King
Seat 2: dcami_nj (big blind) showed [9s 8h] and won ($3.56) with a pair of Eights
Seat 3: KeithTurbo48 folded before Flop (didn't bet)
Seat 4: ng2414 folded before Flop (didn't bet)
Seat 5: PlayTheBlues4U folded before Flop (didn't bet)
Seat 6: kptrpt (button) folded on the Turn


PokerStars Hand #204907676286: Hold'em No Limit ($0.05/$0.10 USD) - 2019/10/22 22:02:29 ET
Table 'Celuta' 6-max Seat #1 is the button
Seat 1: trumpcaddy ($12.47 in chips) 
Seat 2: dcami_nj ($15.18 in chips) 
Seat 3: ng2414 ($9.85 in chips) 
Seat 4: ney1202 ($10.21 in chips) 
Seat 5: KeithTurbo48 ($7.28 in chips) 
Seat 6: PlayTheBlues4U ($10.17 in chips) 
dcami_nj: posts small blind $0.05
ng2414: posts big blind $0.10
*** HOLE CARDS ***
Dealt to PlayTheBlues4U [3s 8d]
ney1202: folds 
KeithTurbo48: folds 
PlayTheBlues4U: folds 
trumpcaddy: folds 
dcami_nj: raises $0.20 to $0.30
ng2414: calls $0.20
*** FLOP *** [Qd Kd Ac]
dcami_nj: bets $0.30
ng2414: folds 
Uncalled bet ($0.30) returned to dcami_nj
dcami_nj collected $0.57 from pot
dcami_nj: doesn't show hand 
*** SUMMARY ***
Total pot $0.60 | Rake $0.03 
Board [Qd Kd Ac]
Seat 1: trumpcaddy (button) folded before Flop (didn't bet)
Seat 2: dcami_nj (small blind) collected ($0.57)
Seat 3: ng2414 (big blind) folded on the Flop
Seat 4: ney1202 folded before Flop (didn't bet)
Seat 5: KeithTurbo48 folded before Flop (didn't bet)
Seat 6: PlayTheBlues4U folded before Flop (didn't bet)


PokerStars Hand #204907676127: Hold'em No Limit ($0.05/$0.10 USD) - 2019/10/22 22:01:53 ET
Table 'Danae' 6-max Seat #5 is the button
Seat 1: zombiehedgehog ($22.26 in chips) 
Seat 2: dcami_nj ($10.84 in chips) 
Seat 3: KeithTurbo48 ($8.44 in chips) 
Seat 4: ng2414 ($8.55 in chips) 
Seat 5: PlayTheBlues4U ($10.06 in chips) 
Seat 6: kptrpt ($12.09 in chips) 
kptrpt: posts small blind $0.05
zombiehedgehog: posts big blind $0.10
*** HOLE CARDS ***
Dealt to PlayTheBlues4U [Js Jh]
dcami_nj: folds 
KeithTurbo48: folds 
ng2414: folds 
PlayTheBlues4U: raises $0.20 to $0.30
kptrpt: calls $0.25
zombiehedgehog: folds 
*** FLOP *** [9h 5c Kh]
kptrpt: bets $0.44
PlayTheBlues4U: calls $0.44
*** TURN *** [9h 5c Kh] [As]
kptrpt: checks 
PlayTheBlues4U: checks 
*** RIVER *** [9h 5c Kh As] [Th]
kptrpt: bets $1
PlayTheBlues4U: folds 
Uncalled bet ($1) returned to kptrpt
kptrpt collected $1.50 from pot
kptrpt: doesn't show hand 
*** SUMMARY ***
Total pot $1.58 | Rake $0.08 
Board [9h 5c Kh As Th]
Seat 1: zombiehedgehog (big blind) folded before Flop
Seat 2: dcami_nj folded before Flop (didn't bet)
Seat 3: KeithTurbo48 folded before Flop (didn't bet)
Seat 4: ng2414 folded before Flop (didn't bet)
Seat 5: PlayTheBlues4U (button) folded on the River
Seat 6: kptrpt (small blind) collected ($1.50)


PokerStars Hand #204907676123: Hold'em No Limit ($0.05/$0.10 USD) - 2019/10/22 22:01:53 ET
Table 'Celuta' 6-max Seat #6 is the button
Seat 1: trumpcaddy ($12.57 in chips) 
Seat 2: dcami_nj ($15.09 in chips) 
Seat 3: ng2414 ($9.85 in chips) 
Seat 4: ney1202 ($10.21 in chips) 
Seat 5: KeithTurbo48 ($7.28 in chips) 
Seat 6: PlayTheBlues4U ($10.17 in chips) 
trumpcaddy: posts small blind $0.05
dcami_nj: posts big blind $0.10
*** HOLE CARDS ***
Dealt to PlayTheBlues4U [3d 7d]
ng2414: folds 
ney1202: folds 
KeithTurbo48: folds 
PlayTheBlues4U: folds 
trumpcaddy: calls $0.05
dcami_nj: checks 
*** FLOP *** [3s Qh Ad]
trumpcaddy: checks 
dcami_nj: bets $0.20
trumpcaddy: folds 
Uncalled bet ($0.20) returned to dcami_nj
dcami_nj collected $0.19 from pot
dcami_nj: doesn't show hand 
*** SUMMARY ***
Total pot $0.20 | Rake $0.01 
Board [3s Qh Ad]
Seat 1: trumpcaddy (small blind) folded on the Flop
Seat 2: dcami_nj (big blind) collected ($0.19)
Seat 3: ng2414 folded before Flop (didn't bet)
Seat 4: ney1202 folded before Flop (didn't bet)
Seat 5: KeithTurbo48 folded before Flop (didn't bet)
Seat 6: PlayTheBlues4U (button) folded before Flop (didn't bet)


PokerStars Hand #204907675960: Hold'em No Limit ($0.05/$0.10 USD) - 2019/10/22 22:01:16 ET
Table 'Celuta' 6-max Seat #5 is the button
Seat 1: trumpcaddy ($12.52 in chips) 
Seat 2: dcami_nj ($15.09 in chips) 
Seat 3: ng2414 ($9.85 in chips) 
Seat 4: ney1202 ($10.21 in chips) 
Seat 5: KeithTurbo48 ($7.28 in chips) 
Seat 6: PlayTheBlues4U ($10.22 in chips) 
PlayTheBlues4U: posts small blind $0.05
trumpcaddy: posts big blind $0.10
*** HOLE CARDS ***
Dealt to PlayTheBlues4U [Ts 3c]
dcami_nj: folds 
ng2414: folds 
ney1202: folds 
KeithTurbo48: folds 
PlayTheBlues4U: folds 
Uncalled bet ($0.05) returned to trumpcaddy
trumpcaddy collected $0.10 from pot
trumpcaddy: doesn't show hand 
*** SUMMARY ***
Total pot $0.10 | Rake $0 
Seat 1: trumpcaddy (big blind) collected ($0.10)
Seat 2: dcami_nj folded before Flop (didn't bet)
Seat 3: ng2414 folded before Flop (didn't bet)
Seat 4: ney1202 folded before Flop (didn't bet)
Seat 5: KeithTurbo48 (button) folded before Flop (didn't bet)
Seat 6: PlayTheBlues4U (small blind) folded before Flop


PokerStars Hand #204907675793: Hold'em No Limit ($0.05/$0.10 USD) - 2019/10/22 22:00:37 ET
Table 'Danae' 6-max Seat #4 is the button
Seat 1: zombiehedgehog ($22.36 in chips) 
Seat 2: dcami_nj ($10.84 in chips) 
Seat 3: KeithTurbo48 ($8.44 in chips) 
Seat 4: ng2414 ($9.85 in chips) 
Seat 5: PlayTheBlues4U ($8.70 in chips) 
Seat 6: kptrpt ($12.19 in chips) 
PlayTheBlues4U: posts small blind $0.05
kptrpt: posts big blind $0.10
*** HOLE CARDS ***
Dealt to PlayTheBlues4U [Tc Th]
zombiehedgehog: calls $0.10
dcami_nj: folds 
KeithTurbo48: folds 
ng2414: raises $0.35 to $0.45
PlayTheBlues4U: raises $0.85 to $1.30
kptrpt: folds 
zombiehedgehog: folds 
ng2414: calls $0.85
*** FLOP *** [6h Ts Jh]
PlayTheBlues4U: bets $1.40
ng2414: folds 
Uncalled bet ($1.40) returned to PlayTheBlues4U
PlayTheBlues4U collected $2.66 from pot
PlayTheBlues4U: doesn't show hand 
*** SUMMARY ***
Total pot $2.80 | Rake $0.14 
Board [6h Ts Jh]
Seat 1: zombiehedgehog folded before Flop
Seat 2: dcami_nj folded before Flop (didn't bet)
Seat 3: KeithTurbo48 folded before Flop (didn't bet)
Seat 4: ng2414 (button) folded on the Flop
Seat 5: PlayTheBlues4U (small blind) collected ($2.66)
Seat 6: kptrpt (big blind) folded before Flop


PokerStars Hand #204907675773: Hold'em No Limit ($0.05/$0.10 USD) - 2019/10/22 22:00:33 ET
Table 'Celuta' 6-max Seat #4 is the button
Seat 1: trumpcaddy ($12.52 in chips) 
Seat 2: dcami_nj ($15.09 in chips) 
Seat 3: ng2414 ($9.85 in chips) 
Seat 4: ney1202 ($10.21 in chips) 
Seat 5: KeithTurbo48 ($7.31 in chips) 
Seat 6: PlayTheBlues4U ($10.25 in chips) 
KeithTurbo48: posts small blind $0.05
PlayTheBlues4U: posts big blind $0.10
*** HOLE CARDS ***
Dealt to PlayTheBlues4U [5h 2h]
trumpcaddy: folds 
dcami_nj: folds 
ng2414: folds 
ney1202: folds 
KeithTurbo48: calls $0.05
PlayTheBlues4U: checks 
*** FLOP *** [6d 2c 5c]
KeithTurbo48: bets $0.14
PlayTheBlues4U: calls $0.14
*** TURN *** [6d 2c 5c] [4s]
KeithTurbo48: bets $0.40
PlayTheBlues4U: calls $0.40
*** RIVER *** [6d 2c 5c 4s] [3c]
KeithTurbo48: checks 
PlayTheBlues4U: checks 
*** SHOW DOWN ***
KeithTurbo48: shows [2d 4d] (a straight, Deuce to Six)
PlayTheBlues4U: shows [5h 2h] (a straight, Deuce to Six)
KeithTurbo48 collected $0.61 from pot
PlayTheBlues4U collected $0.61 from pot
*** SUMMARY ***
Total pot $1.28 | Rake $0.06 
Board [6d 2c 5c 4s 3c]
Seat 1: trumpcaddy folded before Flop (didn't bet)
Seat 2: dcami_nj folded before Flop (didn't bet)
Seat 3: ng2414 folded before Flop (didn't bet)
Seat 4: ney1202 (button) folded before Flop (didn't bet)
Seat 5: KeithTurbo48 (small blind) showed [2d 4d] and won ($0.61) with a straight, Deuce to Six
Seat 6: PlayTheBlues4U (big blind) showed [5h 2h] and won ($0.61) with a straight, Deuce to Six


PokerStars Hand #204907675653: Hold'em No Limit ($0.05/$0.10 USD) - 2019/10/22 21:59:55 ET
Table 'Celuta' 6-max Seat #3 is the button
Seat 1: trumpcaddy ($12.52 in chips) 
Seat 2: dcami_nj ($15.09 in chips) 
Seat 3: ng2414 ($9.85 in chips) 
Seat 4: ney1202 ($9.90 in chips) 
Seat 5: KeithTurbo48 ($7.66 in chips) 
Seat 6: PlayTheBlues4U ($10.25 in chips) 
ney1202: posts small blind $0.05
KeithTurbo48: posts big blind $0.10
*** HOLE CARDS ***
Dealt to PlayTheBlues4U [Qd 4h]
PlayTheBlues4U: folds 
trumpcaddy: folds 
dcami_nj: folds 
ng2414: folds 
ney1202: raises $0.25 to $0.35
KeithTurbo48: calls $0.25
*** FLOP *** [Ac 6d 6s]
ney1202: bets $0.30
KeithTurbo48: folds 
Uncalled bet ($0.30) returned to ney1202
ney1202 collected $0.66 from pot
*** SUMMARY ***
Total pot $0.70 | Rake $0.04 
Board [Ac 6d 6s]
Seat 1: trumpcaddy folded before Flop (didn't bet)
Seat 2: dcami_nj folded before Flop (didn't bet)
Seat 3: ng2414 (button) folded before Flop (didn't bet)
Seat 4: ney1202 (small blind) collected ($0.66)
Seat 5: KeithTurbo48 (big blind) folded on the Flop
Seat 6: PlayTheBlues4U folded before Flop (didn't bet)


PokerStars Hand #204907675641: Hold'em No Limit ($0.05/$0.10 USD) - 2019/10/22 21:59:52 ET
Table 'Danae' 6-max Seat #3 is the button
Seat 1: zombiehedgehog ($21.95 in chips) 
Seat 2: dcami_nj ($10.84 in chips) 
Seat 3: KeithTurbo48 ($8.54 in chips) 
Seat 4: ng2414 ($9.90 in chips) 
Seat 5: PlayTheBlues4U ($9 in chips) 
Seat 6: kptrpt ($12.19 in chips) 
ng2414: posts small blind $0.05
PlayTheBlues4U: posts big blind $0.10
*** HOLE CARDS ***
Dealt to PlayTheBlues4U [3h 9h]
kptrpt: folds 
zombiehedgehog: calls $0.10
dcami_nj: folds 
KeithTurbo48: calls $0.10
ng2414: folds 
PlayTheBlues4U: checks 
*** FLOP *** [Qd Kc 5h]
PlayTheBlues4U: checks 
zombiehedgehog: checks 
KeithTurbo48: checks 
*** TURN *** [Qd Kc 5h] [6h]
PlayTheBlues4U: bets $0.20
zombiehedgehog: calls $0.20
KeithTurbo48: folds 
*** RIVER *** [Qd Kc 5h 6h] [Kd]
PlayTheBlues4U: checks 
zombiehedgehog: bets $0.71
PlayTheBlues4U: folds 
Uncalled bet ($0.71) returned to zombiehedgehog
zombiehedgehog collected $0.71 from pot
zombiehedgehog: doesn't show hand 
*** SUMMARY ***
Total pot $0.75 | Rake $0.04 
Board [Qd Kc 5h 6h Kd]
Seat 1: zombiehedgehog collected ($0.71)
Seat 2: dcami_nj folded before Flop (didn't bet)
Seat 3: KeithTurbo48 (button) folded on the Turn
Seat 4: ng2414 (small blind) folded before Flop
Seat 5: PlayTheBlues4U (big blind) folded on the River
Seat 6: kptrpt folded before Flop (didn't bet)


PokerStars Hand #204907675529: Hold'em No Limit ($0.05/$0.10 USD) - 2019/10/22 21:59:18 ET
Table 'Celuta' 6-max Seat #2 is the button
Seat 1: trumpcaddy ($12.52 in chips) 
Seat 2: dcami_nj ($14.54 in chips) 
Seat 3: ng2414 ($9.90 in chips) 
Seat 4: ney1202 ($10 in chips) 
Seat 5: KeithTurbo48 ($8.11 in chips) 
Seat 6: PlayTheBlues4U ($10.25 in chips) 
ng2414: posts small blind $0.05
ney1202: posts big blind $0.10
*** HOLE CARDS ***
Dealt to PlayTheBlues4U [3s Kc]
KeithTurbo48: raises $0.15 to $0.25
PlayTheBlues4U: folds 
trumpcaddy: folds 
dcami_nj: calls $0.25
ng2414: folds 
ney1202: folds 
*** FLOP *** [3d Ks 6s]
KeithTurbo48: bets $0.20
dcami_nj: calls $0.20
*** TURN *** [3d Ks 6s] [4c]
KeithTurbo48: checks 
dcami_nj: bets $1
KeithTurbo48: folds 
Uncalled bet ($1) returned to dcami_nj
dcami_nj collected $1 from pot
dcami_nj: doesn't show hand 
*** SUMMARY ***
Total pot $1.05 | Rake $0.05 
Board [3d Ks 6s 4c]
Seat 1: trumpcaddy folded before Flop (didn't bet)
Seat 2: dcami_nj (button) collected ($1)
Seat 3: ng2414 (small blind) folded before Flop
Seat 4: ney1202 (big blind) folded before Flop
Seat 5: KeithTurbo48 folded on the Turn
Seat 6: PlayTheBlues4U folded before Flop (didn't bet)


PokerStars Hand #204907675462: Hold'em No Limit ($0.05/$0.10 USD) - 2019/10/22 21:58:57 ET
Table 'Danae' 6-max Seat #2 is the button
Seat 1: zombiehedgehog ($21.22 in chips) 
Seat 2: dcami_nj ($10.84 in chips) 
Seat 3: KeithTurbo48 ($9.25 in chips) 
Seat 4: ng2414 ($10 in chips) 
Seat 5: PlayTheBlues4U ($9 in chips) 
Seat 6: kptrpt ($12.19 in chips) 
KeithTurbo48: posts small blind $0.05
ng2414: posts big blind $0.10
*** HOLE CARDS ***
Dealt to PlayTheBlues4U [6s Th]
PlayTheBlues4U: folds 
kptrpt: folds 
zombiehedgehog: calls $0.10
dcami_nj: folds 
KeithTurbo48: calls $0.05
ng2414: checks 
*** FLOP *** [5c 6c 8h]
KeithTurbo48: checks 
ng2414: checks 
zombiehedgehog: checks 
*** TURN *** [5c 6c 8h] [2h]
KeithTurbo48: bets $0.21
ng2414: folds 
zombiehedgehog: calls $0.21
*** RIVER *** [5c 6c 8h 2h] [6d]
KeithTurbo48: bets $0.40
zombiehedgehog: raises $0.84 to $1.24
KeithTurbo48: folds 
Uncalled bet ($0.84) returned to zombiehedgehog
zombiehedgehog collected $1.44 from pot
zombiehedgehog: doesn't show hand 
*** SUMMARY ***
Total pot $1.52 | Rake $0.08 
Board [5c 6c 8h 2h 6d]
Seat 1: zombiehedgehog collected ($1.44)
Seat 2: dcami_nj (button) folded before Flop (didn't bet)
Seat 3: KeithTurbo48 (small blind) folded on the River
Seat 4: ng2414 (big blind) folded on the Turn
Seat 5: PlayTheBlues4U folded before Flop (didn't bet)
Seat 6: kptrpt folded before Flop (didn't bet)


PokerStars Hand #204907675325: Hold'em No Limit ($0.05/$0.10 USD) - 2019/10/22 21:58:18 ET
Table 'Celuta' 6-max Seat #1 is the button
Seat 1: trumpcaddy ($9.96 in chips) 
Seat 2: dcami_nj ($14.59 in chips) 
Seat 3: ng2414 ($10 in chips) 
Seat 4: Varginho13 ($19.18 in chips) 
Seat 5: KeithTurbo48 ($10 in chips) 
Seat 6: PlayTheBlues4U ($11 in chips) 
dcami_nj: posts small blind $0.05
ng2414: posts big blind $0.10
*** HOLE CARDS ***
Dealt to PlayTheBlues4U [Jd Jc]
Varginho13: folds 
Varginho13 leaves the table
KeithTurbo48: raises $0.15 to $0.25
PlayTheBlues4U: raises $0.50 to $0.75
trumpcaddy: calls $0.75
dcami_nj: folds 
ng2414: folds 
ney1202 joins the table at seat #4 
KeithTurbo48: calls $0.50
*** FLOP *** [6c 6s Kc]
KeithTurbo48: checks 
PlayTheBlues4U: checks 
trumpcaddy: bets $1.14
KeithTurbo48: calls $1.14
PlayTheBlues4U: folds 
*** TURN *** [6c 6s Kc] [4d]
KeithTurbo48: checks 
trumpcaddy: bets $2.70
KeithTurbo48: folds 
Uncalled bet ($2.70) returned to trumpcaddy
trumpcaddy collected $4.45 from pot
trumpcaddy: doesn't show hand 
*** SUMMARY ***
Total pot $4.68 | Rake $0.23 
Board [6c 6s Kc 4d]
Seat 1: trumpcaddy (button) collected ($4.45)
Seat 2: dcami_nj (small blind) folded before Flop
Seat 3: ng2414 (big blind) folded before Flop
Seat 4: Varginho13 folded before Flop (didn't bet)
Seat 5: KeithTurbo48 folded on the Turn
Seat 6: PlayTheBlues4U folded on the Flop


PokerStars Hand #204907675309: Hold'em No Limit ($0.05/$0.10 USD) - 2019/10/22 21:58:13 ET
Table 'Danae' 6-max Seat #1 is the button
Seat 1: zombiehedgehog ($21.97 in chips) 
Seat 2: dcami_nj ($10.89 in chips) 
Seat 3: KeithTurbo48 ($10 in chips) 
Seat 5: PlayTheBlues4U ($9 in chips) 
Seat 6: kptrpt ($10.76 in chips) 
dcami_nj: posts small blind $0.05
KeithTurbo48: posts big blind $0.10
ng2414: sits out 
*** HOLE CARDS ***
Dealt to PlayTheBlues4U [Kd 7d]
PlayTheBlues4U: folds 
kptrpt: raises $0.20 to $0.30
zombiehedgehog: calls $0.30
dcami_nj: folds 
KeithTurbo48: calls $0.20
*** FLOP *** [3c 4d Ac]
KeithTurbo48: checks 
kptrpt: checks 
zombiehedgehog: bets $0.45
KeithTurbo48: calls $0.45
kptrpt: raises $0.95 to $1.40
zombiehedgehog: folds 
KeithTurbo48: folds 
Uncalled bet ($0.95) returned to kptrpt
kptrpt collected $2.18 from pot
kptrpt: doesn't show hand 
*** SUMMARY ***
Total pot $2.30 | Rake $0.12 
Board [3c 4d Ac]
Seat 1: zombiehedgehog (button) folded on the Flop
Seat 2: dcami_nj (small blind) folded before Flop
Seat 3: KeithTurbo48 (big blind) folded on the Flop
Seat 5: PlayTheBlues4U folded before Flop (didn't bet)
Seat 6: kptrpt collected ($2.18)


PokerStars Hand #204907675151: Hold'em No Limit ($0.05/$0.10 USD) - 2019/10/22 21:57:29 ET
Table 'Danae' 6-max Seat #6 is the button
Seat 1: zombiehedgehog ($21.33 in chips) 
Seat 2: dcami_nj ($11.39 in chips) 
Seat 3: KeithTurbo48 ($5.48 in chips) 
Seat 4: jvilla119 ($11.26 in chips) 
Seat 5: PlayTheBlues4U ($9 in chips) 
Seat 6: kptrpt ($10.96 in chips) 
zombiehedgehog: posts small blind $0.05
dcami_nj: posts big blind $0.10
*** HOLE CARDS ***
Dealt to PlayTheBlues4U [9d 4c]
KeithTurbo48: folds 
jvilla119: folds 
PlayTheBlues4U: folds 
kptrpt: raises $0.10 to $0.20
zombiehedgehog: calls $0.15
dcami_nj: calls $0.10
*** FLOP *** [3d Jc Qc]
zombiehedgehog: checks 
jvilla119 leaves the table
dcami_nj: bets $0.30
ng2414 joins the table at seat #4 
kptrpt: folds 
zombiehedgehog: raises $1.17 to $1.47
dcami_nj: folds 
Uncalled bet ($1.17) returned to zombiehedgehog
zombiehedgehog collected $1.14 from pot
zombiehedgehog: doesn't show hand 
*** SUMMARY ***
Total pot $1.20 | Rake $0.06 
Board [3d Jc Qc]
Seat 1: zombiehedgehog (small blind) collected ($1.14)
Seat 2: dcami_nj (big blind) folded on the Flop
Seat 3: KeithTurbo48 folded before Flop (didn't bet)
Seat 4: jvilla119 folded before Flop (didn't bet)
Seat 5: PlayTheBlues4U folded before Flop (didn't bet)
Seat 6: kptrpt (button) folded on the Flop


PokerStars Hand #204907675134: Hold'em No Limit ($0.05/$0.10 USD) - 2019/10/22 21:57:25 ET
Table 'Celuta' 6-max Seat #6 is the button
Seat 1: trumpcaddy ($9.60 in chips) 
Seat 2: dcami_nj ($14.69 in chips) 
Seat 4: Varginho13 ($19.48 in chips) 
Seat 5: KeithTurbo48 ($8.57 in chips) 
Seat 6: PlayTheBlues4U ($11 in chips) 
trumpcaddy: posts small blind $0.05
dcami_nj: posts big blind $0.10
ng2414: sits out 
*** HOLE CARDS ***
Dealt to PlayTheBlues4U [2d 7c]
Varginho13: raises $0.20 to $0.30
KeithTurbo48: folds 
PlayTheBlues4U: folds 
trumpcaddy: calls $0.25
dcami_nj: folds 
*** FLOP *** [9s Ts Qs]
trumpcaddy: bets $0.66
Varginho13: folds 
Uncalled bet ($0.66) returned to trumpcaddy
trumpcaddy collected $0.66 from pot
trumpcaddy: doesn't show hand 
*** SUMMARY ***
Total pot $0.70 | Rake $0.04 
Board [9s Ts Qs]
Seat 1: trumpcaddy (small blind) collected ($0.66)
Seat 2: dcami_nj (big blind) folded before Flop
Seat 4: Varginho13 folded on the Flop
Seat 5: KeithTurbo48 folded before Flop (didn't bet)
Seat 6: PlayTheBlues4U (button) folded before Flop (didn't bet)


PokerStars Hand #204907674988: Hold'em No Limit ($0.05/$0.10 USD) - 2019/10/22 21:56:41 ET
Table 'Danae' 6-max Seat #5 is the button
Seat 1: zombiehedgehog ($21.43 in chips) 
Seat 2: dcami_nj ($11.39 in chips) 
Seat 3: KeithTurbo48 ($6.15 in chips) 
Seat 4: jvilla119 ($11.26 in chips) 
Seat 5: PlayTheBlues4U ($9 in chips) 
Seat 6: kptrpt ($10.26 in chips) 
kptrpt: posts small blind $0.05
zombiehedgehog: posts big blind $0.10
*** HOLE CARDS ***
Dealt to PlayTheBlues4U [3d 9d]
dcami_nj: folds 
KeithTurbo48: raises $0.15 to $0.25
jvilla119: folds 
PlayTheBlues4U: folds 
kptrpt: calls $0.20
zombiehedgehog: folds 
*** FLOP *** [9s Th Jd]
kptrpt: checks 
KeithTurbo48: checks 
*** TURN *** [9s Th Jd] [4h]
kptrpt: checks 
KeithTurbo48: bets $0.42
kptrpt: calls $0.42
*** RIVER *** [9s Th Jd 4h] [4d]
kptrpt: checks 
KeithTurbo48: checks 
*** SHOW DOWN ***
kptrpt: shows [Ac 8h] (a pair of Fours)
KeithTurbo48: mucks hand 
kptrpt collected $1.37 from pot
*** SUMMARY ***
Total pot $1.44 | Rake $0.07 
Board [9s Th Jd 4h 4d]
Seat 1: zombiehedgehog (big blind) folded before Flop
Seat 2: dcami_nj folded before Flop (didn't bet)
Seat 3: KeithTurbo48 mucked [5s 7s]
Seat 4: jvilla119 folded before Flop (didn't bet)
Seat 5: PlayTheBlues4U (button) folded before Flop (didn't bet)
Seat 6: kptrpt (small blind) showed [Ac 8h] and won ($1.37) with a pair of Fours


PokerStars Hand #204907674986: Hold'em No Limit ($0.05/$0.10 USD) - 2019/10/22 21:56:40 ET
Table 'Celuta' 6-max Seat #5 is the button
Seat 1: trumpcaddy ($9.85 in chips) 
Seat 2: dcami_nj ($14.69 in chips) 
Seat 4: Varginho13 ($19.48 in chips) 
Seat 5: KeithTurbo48 ($9.32 in chips) 
Seat 6: PlayTheBlues4U ($10.09 in chips) 
PlayTheBlues4U: posts small blind $0.05
trumpcaddy: posts big blind $0.10
ng2414: sits out 
*** HOLE CARDS ***
Dealt to PlayTheBlues4U [2s 2c]
dcami_nj: folds 
Varginho13: folds 
KeithTurbo48: raises $0.15 to $0.25
PlayTheBlues4U: calls $0.20
trumpcaddy: calls $0.15
*** FLOP *** [3d 8h 6s]
PlayTheBlues4U: checks 
trumpcaddy: checks 
KeithTurbo48: checks 
*** TURN *** [3d 8h 6s] [2d]
PlayTheBlues4U: bets $0.50
trumpcaddy: folds 
KeithTurbo48: calls $0.50
*** RIVER *** [3d 8h 6s 2d] [Qh]
PlayTheBlues4U: bets $1.20
KeithTurbo48: folds 
Uncalled bet ($1.20) returned to PlayTheBlues4U
PlayTheBlues4U collected $1.66 from pot
PlayTheBlues4U: doesn't show hand 
*** SUMMARY ***
Total pot $1.75 | Rake $0.09 
Board [3d 8h 6s 2d Qh]
Seat 1: trumpcaddy (big blind) folded on the Turn
Seat 2: dcami_nj folded before Flop (didn't bet)
Seat 4: Varginho13 folded before Flop (didn't bet)
Seat 5: KeithTurbo48 (button) folded on the River
Seat 6: PlayTheBlues4U (small blind) collected ($1.66)


PokerStars Hand #204905819998: Hold'em No Limit ($0.05/$0.10 USD) - 2019/10/22 21:56:12 ET
Table 'Celuta' 6-max Seat #4 is the button
Seat 1: trumpcaddy ($9.85 in chips) 
Seat 2: dcami_nj ($14.69 in chips) 
Seat 4: Varginho13 ($19.48 in chips) 
Seat 5: KeithTurbo48 ($9.42 in chips) 
Seat 6: PlayTheBlues4U ($10 in chips) 
KeithTurbo48: posts small blind $0.05
PlayTheBlues4U: posts big blind $0.10
ng2414: sits out 
*** HOLE CARDS ***
Dealt to PlayTheBlues4U [8d 2h]
trumpcaddy: folds 
dcami_nj: folds 
Varginho13: folds 
KeithTurbo48: calls $0.05
PlayTheBlues4U: checks 
*** FLOP *** [Ah 3s Kh]
KeithTurbo48: checks 
PlayTheBlues4U: checks 
*** TURN *** [Ah 3s Kh] [8h]
KeithTurbo48: checks 
PlayTheBlues4U: checks 
*** RIVER *** [Ah 3s Kh 8h] [6d]
KeithTurbo48: checks 
PlayTheBlues4U: checks 
*** SHOW DOWN ***
KeithTurbo48: shows [2s 9s] (high card Ace)
PlayTheBlues4U: shows [8d 2h] (a pair of Eights)
PlayTheBlues4U collected $0.19 from pot
*** SUMMARY ***
Total pot $0.20 | Rake $0.01 
Board [Ah 3s Kh 8h 6d]
Seat 1: trumpcaddy folded before Flop (didn't bet)
Seat 2: dcami_nj folded before Flop (didn't bet)
Seat 4: Varginho13 (button) folded before Flop (didn't bet)
Seat 5: KeithTurbo48 (small blind) showed [2s 9s] and lost with high card Ace
Seat 6: PlayTheBlues4U (big blind) showed [8d 2h] and won ($0.19) with a pair of Eights


PokerStars Hand #204905819911: Hold'em No Limit ($0.05/$0.10 USD) - 2019/10/22 21:55:48 ET
Table 'Danae' 6-max Seat #4 is the button
Seat 1: zombiehedgehog ($21.43 in chips) 
Seat 2: dcami_nj ($11.39 in chips) 
Seat 3: KeithTurbo48 ($7.65 in chips) 
Seat 4: jvilla119 ($11.26 in chips) 
Seat 5: PlayTheBlues4U ($9.25 in chips) 
Seat 6: kptrpt ($8.67 in chips) 
PlayTheBlues4U: posts small blind $0.05
kptrpt: posts big blind $0.10
*** HOLE CARDS ***
Dealt to PlayTheBlues4U [4d Ah]
zombiehedgehog: folds 
dcami_nj: folds 
KeithTurbo48: raises $0.15 to $0.25
jvilla119: folds 
PlayTheBlues4U: calls $0.20
kptrpt: calls $0.15
*** FLOP *** [8s 2c Ks]
PlayTheBlues4U: checks 
kptrpt: checks 
KeithTurbo48: bets $0.30
PlayTheBlues4U: folds 
kptrpt: calls $0.30
*** TURN *** [8s 2c Ks] [3h]
kptrpt: checks 
KeithTurbo48: bets $0.95
kptrpt: calls $0.95
*** RIVER *** [8s 2c Ks 3h] [Qh]
kptrpt: checks 
KeithTurbo48: checks 
*** SHOW DOWN ***
kptrpt: shows [4s Kh] (a pair of Kings)
KeithTurbo48: mucks hand 
kptrpt collected $3.09 from pot
*** SUMMARY ***
Total pot $3.25 | Rake $0.16 
Board [8s 2c Ks 3h Qh]
Seat 1: zombiehedgehog folded before Flop (didn't bet)
Seat 2: dcami_nj folded before Flop (didn't bet)
Seat 3: KeithTurbo48 mucked [Js Jd]
Seat 4: jvilla119 (button) folded before Flop (didn't bet)
Seat 5: PlayTheBlues4U (small blind) folded on the Flop
Seat 6: kptrpt (big blind) showed [4s Kh] and won ($3.09) with a pair of Kings


PokerStars Hand #204905819624: Hold'em No Limit ($0.05/$0.10 USD) - 2019/10/22 21:54:38 ET
Table 'Danae' 6-max Seat #3 is the button
Seat 1: zombiehedgehog ($21.43 in chips) 
Seat 2: dcami_nj ($11.39 in chips) 
Seat 3: KeithTurbo48 ($6.65 in chips) 
Seat 4: jvilla119 ($11.51 in chips) 
Seat 5: PlayTheBlues4U ($10 in chips) 
jvilla119: posts small blind $0.05
PlayTheBlues4U: posts big blind $0.10
*** HOLE CARDS ***
Dealt to PlayTheBlues4U [As Jh]
zombiehedgehog: folds 
dcami_nj: folds 
KeithTurbo48: raises $0.15 to $0.25
jvilla119: calls $0.20
PlayTheBlues4U: raises $0.50 to $0.75
KeithTurbo48: raises $2.25 to $3
jvilla119: folds 
PlayTheBlues4U: folds 
Uncalled bet ($2.25) returned to KeithTurbo48
KeithTurbo48 collected $1.75 from pot
KeithTurbo48: doesn't show hand 
*** SUMMARY ***
Total pot $1.75 | Rake $0 
Seat 1: zombiehedgehog folded before Flop (didn't bet)
Seat 2: dcami_nj folded before Flop (didn't bet)
Seat 3: KeithTurbo48 (button) collected ($1.75)
Seat 4: jvilla119 (small blind) folded before Flop
Seat 5: PlayTheBlues4U (big blind) folded before Flop


PokerStars Hand #204851189215: Hold'em No Limit ($0.05/$0.10 USD) - 2019/10/21 22:03:27 ET
Table 'Draco' 6-max Seat #6 is the button
Seat 1: BigBlue ($7.45 in chips) 
Seat 2: LanskyBanksy ($15.66 in chips) 
Seat 3: PlayTheBlues4U ($18.51 in chips) 
Seat 5: Klytu ($10 in chips) 
Seat 6: EddieMoney9 ($16.34 in chips) 
BigBlue: posts small blind $0.05
LanskyBanksy: posts big blind $0.10
*** HOLE CARDS ***
Dealt to PlayTheBlues4U [Qc Qs]
PlayTheBlues4U: raises $0.20 to $0.30
Klytu: folds 
EddieMoney9: calls $0.30
BigBlue: calls $0.25
LanskyBanksy: calls $0.20
*** FLOP *** [4c 5c 7d]
BigBlue: checks 
LanskyBanksy: checks 
PlayTheBlues4U: bets $0.80
EddieMoney9: folds 
BigBlue: raises $1.40 to $2.20
LanskyBanksy: folds 
x Aristokat x joins the table at seat #4 
PlayTheBlues4U: calls $1.40
*** TURN *** [4c 5c 7d] [7h]
BigBlue: bets $2.70
PlayTheBlues4U: calls $2.70
*** RIVER *** [4c 5c 7d 7h] [5s]
BigBlue: bets $2.25 and is all-in
PlayTheBlues4U: calls $2.25
*** SHOW DOWN ***
BigBlue: shows [4h 5h] (a full house, Fives full of Sevens)
PlayTheBlues4U: shows [Qc Qs] (two pair, Queens and Sevens)
BigBlue collected $14.72 from pot
*** SUMMARY ***
Total pot $15.50 | Rake $0.78 
Board [4c 5c 7d 7h 5s]
Seat 1: BigBlue (small blind) showed [4h 5h] and won ($14.72) with a full house, Fives full of Sevens
Seat 2: LanskyBanksy (big blind) folded on the Flop
Seat 3: PlayTheBlues4U showed [Qc Qs] and lost with two pair, Queens and Sevens
Seat 5: Klytu folded before Flop (didn't bet)
Seat 6: EddieMoney9 (button) folded on the Flop


PokerStars Hand #204851189105: Hold'em No Limit ($0.05/$0.10 USD) - 2019/10/21 22:03:00 ET
Table 'Draco' 6-max Seat #5 is the button
Seat 1: BigBlue ($7.55 in chips) 
Seat 2: LanskyBanksy ($15.66 in chips) 
Seat 3: PlayTheBlues4U ($18.36 in chips) 
Seat 5: Klytu ($10 in chips) 
Seat 6: EddieMoney9 ($16.39 in chips) 
EddieMoney9: posts small blind $0.05
BigBlue: posts big blind $0.10
*** HOLE CARDS ***
Dealt to PlayTheBlues4U [Kh Tc]
LanskyBanksy: folds 
PlayTheBlues4U: raises $0.20 to $0.30
Klytu: folds 
EddieMoney9: folds 
BigBlue: folds 
Uncalled bet ($0.20) returned to PlayTheBlues4U
PlayTheBlues4U collected $0.25 from pot
PlayTheBlues4U: doesn't show hand 
*** SUMMARY ***
Total pot $0.25 | Rake $0 
Seat 1: BigBlue (big blind) folded before Flop
Seat 2: LanskyBanksy folded before Flop (didn't bet)
Seat 3: PlayTheBlues4U collected ($0.25)
Seat 5: Klytu (button) folded before Flop (didn't bet)
Seat 6: EddieMoney9 (small blind) folded before Flop


PokerStars Hand #204851188897: Hold'em No Limit ($0.05/$0.10 USD) - 2019/10/21 22:02:10 ET
Table 'Draco' 6-max Seat #3 is the button
Seat 1: BigBlue ($7.85 in chips) 
Seat 2: LanskyBanksy ($15.66 in chips) 
Seat 3: PlayTheBlues4U ($17.76 in chips) 
Seat 5: Klytu ($10.05 in chips) 
Seat 6: EddieMoney9 ($16.69 in chips) 
Klytu: posts small blind $0.05
EddieMoney9: posts big blind $0.10
*** HOLE CARDS ***
Dealt to PlayTheBlues4U [Ah 8s]
BigBlue: calls $0.10
LanskyBanksy: folds 
PlayTheBlues4U: raises $0.20 to $0.30
Klytu: folds 
EddieMoney9: calls $0.20
BigBlue: calls $0.20
*** FLOP *** [As Ts 8d]
EddieMoney9: checks 
BigBlue: checks 
PlayTheBlues4U: bets $0.70
EddieMoney9: folds 
BigBlue: folds 
Uncalled bet ($0.70) returned to PlayTheBlues4U
PlayTheBlues4U collected $0.90 from pot
PlayTheBlues4U: doesn't show hand 
*** SUMMARY ***
Total pot $0.95 | Rake $0.05 
Board [As Ts 8d]
Seat 1: BigBlue folded on the Flop
Seat 2: LanskyBanksy folded before Flop (didn't bet)
Seat 3: PlayTheBlues4U (button) collected ($0.90)
Seat 5: Klytu (small blind) folded before Flop
Seat 6: EddieMoney9 (big blind) folded on the Flop


PokerStars Hand #204851188699: Hold'em No Limit ($0.05/$0.10 USD) - 2019/10/21 22:01:24 ET
Table 'Draco' 6-max Seat #2 is the button
Seat 1: BigBlue ($7.85 in chips) 
Seat 2: LanskyBanksy ($15.52 in chips) 
Seat 3: PlayTheBlues4U ($17.81 in chips) 
Seat 5: Klytu ($10.15 in chips) 
Seat 6: EddieMoney9 ($16.69 in chips) 
PlayTheBlues4U: posts small blind $0.05
Klytu: posts big blind $0.10
*** HOLE CARDS ***
Dealt to PlayTheBlues4U [5d 7c]
EddieMoney9: folds 
BigBlue: folds 
LanskyBanksy: calls $0.10
PlayTheBlues4U: folds 
Klytu: checks 
*** FLOP *** [Qc 8h Ac]
Klytu: checks 
LanskyBanksy: checks 
*** TURN *** [Qc 8h Ac] [3c]
Klytu: checks 
LanskyBanksy: checks 
*** RIVER *** [Qc 8h Ac 3c] [5h]
Klytu: checks 
LanskyBanksy: bets $0.50
Klytu: folds 
Uncalled bet ($0.50) returned to LanskyBanksy
LanskyBanksy collected $0.24 from pot
LanskyBanksy: doesn't show hand 
*** SUMMARY ***
Total pot $0.25 | Rake $0.01 
Board [Qc 8h Ac 3c 5h]
Seat 1: BigBlue folded before Flop (didn't bet)
Seat 2: LanskyBanksy (button) collected ($0.24)
Seat 3: PlayTheBlues4U (small blind) folded before Flop
Seat 5: Klytu (big blind) folded on the River
Seat 6: EddieMoney9 folded before Flop (didn't bet)


PokerStars Hand #204851188654: Hold'em No Limit ($0.05/$0.10 USD) - 2019/10/21 22:01:14 ET
Table 'Hesperia' 6-max Seat #5 is the button
Seat 1: BigBlue ($9.79 in chips) 
Seat 2: LanskyBanksy ($16.16 in chips) 
Seat 4: PlayTheBlues4U ($9.05 in chips) 
Seat 5: Klytu ($10 in chips) 
BigBlue: posts small blind $0.05
LanskyBanksy: posts big blind $0.10
*** HOLE CARDS ***
Dealt to PlayTheBlues4U [6d Td]
PlayTheBlues4U: folds 
Klytu: raises $0.15 to $0.25
BigBlue: folds 
LanskyBanksy: calls $0.15
*** FLOP *** [6s Qs 3c]
LanskyBanksy: checks 
Klytu: bets $0.30
LanskyBanksy: calls $0.30
*** TURN *** [6s Qs 3c] [5h]
LanskyBanksy: checks 
Klytu: bets $0.45
LanskyBanksy: raises $0.55 to $1
Klytu: calls $0.55
*** RIVER *** [6s Qs 3c 5h] [Ks]
LanskyBanksy: bets $2.40
Klytu: folds 
Uncalled bet ($2.40) returned to LanskyBanksy
LanskyBanksy collected $2.99 from pot
LanskyBanksy: doesn't show hand 
*** SUMMARY ***
Total pot $3.15 | Rake $0.16 
Board [6s Qs 3c 5h Ks]
Seat 1: BigBlue (small blind) folded before Flop
Seat 2: LanskyBanksy (big blind) collected ($2.99)
Seat 4: PlayTheBlues4U folded before Flop (didn't bet)
Seat 5: Klytu (button) folded on the River


PokerStars Hand #204851188595: Hold'em No Limit ($0.05/$0.10 USD) - 2019/10/21 22:01:00 ET
Table 'Hesperia' 6-max Seat #4 is the button
Seat 1: BigBlue ($9.89 in chips) 
Seat 2: LanskyBanksy ($16.16 in chips) 
Seat 4: PlayTheBlues4U ($8.90 in chips) 
Seat 5: Klytu ($9.95 in chips) 
Klytu: posts small blind $0.05
BigBlue: posts big blind $0.10
*** HOLE CARDS ***
Dealt to PlayTheBlues4U [2d Ac]
LanskyBanksy: folds 
PlayTheBlues4U: raises $0.20 to $0.30
Klytu: folds 
BigBlue: folds 
Uncalled bet ($0.20) returned to PlayTheBlues4U
PlayTheBlues4U collected $0.25 from pot
PlayTheBlues4U: doesn't show hand 
*** SUMMARY ***
Total pot $0.25 | Rake $0 
Seat 1: BigBlue (big blind) folded before Flop
Seat 2: LanskyBanksy folded before Flop (didn't bet)
Seat 4: PlayTheBlues4U (button) collected ($0.25)
Seat 5: Klytu (small blind) folded before Flop


PokerStars Hand #204851188549: Hold'em No Limit ($0.05/$0.10 USD) - 2019/10/21 22:00:50 ET
Table 'Draco' 6-max Seat #1 is the button
Seat 1: BigBlue ($7.85 in chips) 
Seat 2: LanskyBanksy ($15.72 in chips) 
Seat 3: PlayTheBlues4U ($17.63 in chips) 
Seat 5: Klytu ($10.15 in chips) 
Seat 6: EddieMoney9 ($16.69 in chips) 
LanskyBanksy: posts small blind $0.05
PlayTheBlues4U: posts big blind $0.10
*** HOLE CARDS ***
Dealt to PlayTheBlues4U [7s Ad]
Klytu: folds 
EddieMoney9: folds 
BigBlue: folds 
LanskyBanksy: calls $0.05
PlayTheBlues4U: raises $0.10 to $0.20
LanskyBanksy: calls $0.10
*** FLOP *** [Ts 9h Js]
LanskyBanksy: checks 
PlayTheBlues4U: checks 
*** TURN *** [Ts 9h Js] [7d]
LanskyBanksy: checks 
PlayTheBlues4U: checks 
*** RIVER *** [Ts 9h Js 7d] [Kh]
LanskyBanksy: checks 
PlayTheBlues4U: checks 
*** SHOW DOWN ***
LanskyBanksy: shows [4h 6d] (high card King)
PlayTheBlues4U: shows [7s Ad] (a pair of Sevens)
PlayTheBlues4U collected $0.38 from pot
*** SUMMARY ***
Total pot $0.40 | Rake $0.02 
Board [Ts 9h Js 7d Kh]
Seat 1: BigBlue (button) folded before Flop (didn't bet)
Seat 2: LanskyBanksy (small blind) showed [4h 6d] and lost with high card King
Seat 3: PlayTheBlues4U (big blind) showed [7s Ad] and won ($0.38) with a pair of Sevens
Seat 5: Klytu folded before Flop (didn't bet)
Seat 6: EddieMoney9 folded before Flop (didn't bet)


PokerStars Hand #204851188507: Hold'em No Limit ($0.05/$0.10 USD) - 2019/10/21 22:00:41 ET
Table 'Hesperia' 6-max Seat #2 is the button
Seat 1: BigBlue ($9.89 in chips) 
Seat 2: LanskyBanksy ($16.16 in chips) 
Seat 4: PlayTheBlues4U ($8.72 in chips) 
Seat 5: Klytu ($10.15 in chips) 
PlayTheBlues4U: posts small blind $0.05
Klytu: posts big blind $0.10
*** HOLE CARDS ***
Dealt to PlayTheBlues4U [5s 7d]
BigBlue: folds 
LanskyBanksy: folds 
PlayTheBlues4U: raises $0.10 to $0.20
Klytu: calls $0.10
*** FLOP *** [4h Jd 3h]
PlayTheBlues4U: bets $0.20
Klytu: folds 
Uncalled bet ($0.20) returned to PlayTheBlues4U
PlayTheBlues4U collected $0.38 from pot
PlayTheBlues4U: doesn't show hand 
*** SUMMARY ***
Total pot $0.40 | Rake $0.02 
Board [4h Jd 3h]
Seat 1: BigBlue folded before Flop (didn't bet)
Seat 2: LanskyBanksy (button) folded before Flop (didn't bet)
Seat 4: PlayTheBlues4U (small blind) collected ($0.38)
Seat 5: Klytu (big blind) folded on the Flop


PokerStars Hand #204851188466: Hold'em No Limit ($0.05/$0.10 USD) - 2019/10/21 22:00:30 ET
Table 'Hesperia' 6-max Seat #1 is the button
Seat 1: BigBlue ($9.74 in chips) 
Seat 2: LanskyBanksy ($16.21 in chips) 
Seat 4: PlayTheBlues4U ($8.82 in chips) 
Seat 5: Klytu ($10.15 in chips) 
LanskyBanksy: posts small blind $0.05
PlayTheBlues4U: posts big blind $0.10
*** HOLE CARDS ***
Dealt to PlayTheBlues4U [Qh 3c]
Klytu: folds 
BigBlue: raises $0.15 to $0.25
LanskyBanksy: folds 
PlayTheBlues4U: folds 
Uncalled bet ($0.15) returned to BigBlue
BigBlue collected $0.25 from pot
BigBlue: doesn't show hand 
*** SUMMARY ***
Total pot $0.25 | Rake $0 
Seat 1: BigBlue (button) collected ($0.25)
Seat 2: LanskyBanksy (small blind) folded before Flop
Seat 4: PlayTheBlues4U (big blind) folded before Flop
Seat 5: Klytu folded before Flop (didn't bet)


PokerStars Hand #204851188389: Hold'em No Limit ($0.05/$0.10 USD) - 2019/10/21 22:00:11 ET
Table 'Hesperia' 6-max Seat #5 is the button
Seat 1: BigBlue ($9.79 in chips) 
Seat 2: LanskyBanksy ($16.16 in chips) 
Seat 4: PlayTheBlues4U ($8.82 in chips) 
Seat 5: Klytu ($10.15 in chips) 
BigBlue: posts small blind $0.05
LanskyBanksy: posts big blind $0.10
*** HOLE CARDS ***
Dealt to PlayTheBlues4U [2c Qd]
PlayTheBlues4U: folds 
Klytu: folds 
BigBlue: folds 
Uncalled bet ($0.05) returned to LanskyBanksy
LanskyBanksy collected $0.10 from pot
LanskyBanksy: doesn't show hand 
*** SUMMARY ***
Total pot $0.10 | Rake $0 
Seat 1: BigBlue (small blind) folded before Flop
Seat 2: LanskyBanksy (big blind) collected ($0.10)
Seat 4: PlayTheBlues4U folded before Flop (didn't bet)
Seat 5: Klytu (button) folded before Flop (didn't bet)


PokerStars Hand #204851188344: Hold'em No Limit ($0.05/$0.10 USD) - 2019/10/21 21:59:56 ET
Table 'Hesperia' 6-max Seat #4 is the button
Seat 1: BigBlue ($9.89 in chips) 
Seat 2: LanskyBanksy ($16.16 in chips) 
Seat 4: PlayTheBlues4U ($8.82 in chips) 
Seat 5: Klytu ($10.05 in chips) 
Klytu: posts small blind $0.05
BigBlue: posts big blind $0.10
*** HOLE CARDS ***
Dealt to PlayTheBlues4U [8d 3c]
LanskyBanksy: folds 
PlayTheBlues4U: folds 
Klytu: raises $0.20 to $0.30
BigBlue: folds 
Uncalled bet ($0.20) returned to Klytu
Klytu collected $0.20 from pot
Klytu: doesn't show hand 
*** SUMMARY ***
Total pot $0.20 | Rake $0 
Seat 1: BigBlue (big blind) folded before Flop
Seat 2: LanskyBanksy folded before Flop (didn't bet)
Seat 4: PlayTheBlues4U (button) folded before Flop (didn't bet)
Seat 5: Klytu (small blind) collected ($0.20)


PokerStars Hand #204851188290: Hold'em No Limit ($0.05/$0.10 USD) - 2019/10/21 21:59:43 ET
Table 'Draco' 6-max Seat #6 is the button
Seat 1: BigBlue ($7.90 in chips) 
Seat 2: LanskyBanksy ($15.82 in chips) 
Seat 3: PlayTheBlues4U ($17.93 in chips) 
Seat 5: Klytu ($10.90 in chips) 
Seat 6: EddieMoney9 ($15.59 in chips) 
BigBlue: posts small blind $0.05
LanskyBanksy: posts big blind $0.10
*** HOLE CARDS ***
Dealt to PlayTheBlues4U [Tc 7c]
PlayTheBlues4U: raises $0.20 to $0.30
Klytu: calls $0.30
EddieMoney9: calls $0.30
BigBlue: folds 
LanskyBanksy: folds 
*** FLOP *** [Kc Qh 3h]
PlayTheBlues4U: checks 
Klytu: checks 
EddieMoney9: checks 
*** TURN *** [Kc Qh 3h] [4d]
PlayTheBlues4U: checks 
Klytu: bets $0.45
EddieMoney9: calls $0.45
PlayTheBlues4U: folds 
*** RIVER *** [Kc Qh 3h 4d] [Qc]
Klytu: checks 
EddieMoney9: bets $0.60
Klytu: folds 
Uncalled bet ($0.60) returned to EddieMoney9
EddieMoney9 collected $1.85 from pot
EddieMoney9: doesn't show hand 
*** SUMMARY ***
Total pot $1.95 | Rake $0.10 
Board [Kc Qh 3h 4d Qc]
Seat 1: BigBlue (small blind) folded before Flop
Seat 2: LanskyBanksy (big blind) folded before Flop
Seat 3: PlayTheBlues4U folded on the Turn
Seat 5: Klytu folded on the River
Seat 6: EddieMoney9 (button) collected ($1.85)


PokerStars Hand #204851188230: Hold'em No Limit ($0.05/$0.10 USD) - 2019/10/21 21:59:27 ET
Table 'Draco' 6-max Seat #5 is the button
Seat 1: BigBlue ($8 in chips) 
Seat 2: LanskyBanksy ($15.82 in chips) 
Seat 3: PlayTheBlues4U ($17.93 in chips) 
Seat 5: Klytu ($10.75 in chips) 
Seat 6: EddieMoney9 ($15.64 in chips) 
EddieMoney9: posts small blind $0.05
BigBlue: posts big blind $0.10
*** HOLE CARDS ***
Dealt to PlayTheBlues4U [2s Jc]
LanskyBanksy: folds 
PlayTheBlues4U: folds 
Klytu: raises $0.15 to $0.25
EddieMoney9: folds 
BigBlue: folds 
Uncalled bet ($0.15) returned to Klytu
Klytu collected $0.25 from pot
Klytu: doesn't show hand 
*** SUMMARY ***
Total pot $0.25 | Rake $0 
Seat 1: BigBlue (big blind) folded before Flop
Seat 2: LanskyBanksy folded before Flop (didn't bet)
Seat 3: PlayTheBlues4U folded before Flop (didn't bet)
Seat 5: Klytu (button) collected ($0.25)
Seat 6: EddieMoney9 (small blind) folded before Flop


PokerStars Hand #204851188200: Hold'em No Limit ($0.05/$0.10 USD) - 2019/10/21 21:59:18 ET
Table 'Hesperia' 6-max Seat #2 is the button
Seat 1: BigBlue ($9.12 in chips) 
Seat 2: LanskyBanksy ($16.16 in chips) 
Seat 4: PlayTheBlues4U ($9.57 in chips) 
Seat 5: Klytu ($10.15 in chips) 
PlayTheBlues4U: posts small blind $0.05
Klytu: posts big blind $0.10
*** HOLE CARDS ***
Dealt to PlayTheBlues4U [Jd As]
BigBlue: raises $0.25 to $0.35
LanskyBanksy: folds 
PlayTheBlues4U: calls $0.30
Klytu: folds 
*** FLOP *** [8d Ac 6s]
PlayTheBlues4U: checks 
BigBlue: bets $0.40
PlayTheBlues4U: calls $0.40
*** TURN *** [8d Ac 6s] [7c]
PlayTheBlues4U: checks 
BigBlue: checks 
*** RIVER *** [8d Ac 6s 7c] [5d]
PlayTheBlues4U: checks 
BigBlue: bets $2
PlayTheBlues4U: folds 
Uncalled bet ($2) returned to BigBlue
BigBlue collected $1.52 from pot
BigBlue: doesn't show hand 
*** SUMMARY ***
Total pot $1.60 | Rake $0.08 
Board [8d Ac 6s 7c 5d]
Seat 1: BigBlue collected ($1.52)
Seat 2: LanskyBanksy (button) folded before Flop (didn't bet)
Seat 4: PlayTheBlues4U (small blind) folded on the River
Seat 5: Klytu (big blind) folded before Flop


PokerStars Hand #204851188165: Hold'em No Limit ($0.05/$0.10 USD) - 2019/10/21 21:59:11 ET
Table 'Draco' 6-max Seat #3 is the button
Seat 2: LanskyBanksy ($15.82 in chips) 
Seat 3: PlayTheBlues4U ($17.93 in chips) 
Seat 5: Klytu ($11.05 in chips) 
Seat 6: EddieMoney9 ($15.37 in chips) 
Klytu: posts small blind $0.05
EddieMoney9: posts big blind $0.10
BigBlue: sits out 
*** HOLE CARDS ***
Dealt to PlayTheBlues4U [2s 9d]
LanskyBanksy: folds 
PlayTheBlues4U: folds 
Klytu: raises $0.20 to $0.30
EddieMoney9: calls $0.20
*** FLOP *** [Jh 7d 6h]
Klytu: checks 
EddieMoney9: bets $0.40
Klytu: folds 
Uncalled bet ($0.40) returned to EddieMoney9
EddieMoney9 collected $0.57 from pot
EddieMoney9: doesn't show hand 
*** SUMMARY ***
Total pot $0.60 | Rake $0.03 
Board [Jh 7d 6h]
Seat 2: LanskyBanksy folded before Flop (didn't bet)
Seat 3: PlayTheBlues4U (button) folded before Flop (didn't bet)
Seat 5: Klytu (small blind) folded on the Flop
Seat 6: EddieMoney9 (big blind) collected ($0.57)


PokerStars Hand #204851188106: Hold'em No Limit ($0.05/$0.10 USD) - 2019/10/21 21:58:55 ET
Table 'Draco' 6-max Seat #2 is the button
Seat 2: LanskyBanksy ($15.82 in chips) 
Seat 3: PlayTheBlues4U ($17.98 in chips) 
Seat 5: Klytu ($11 in chips) 
Seat 6: EddieMoney9 ($15.37 in chips) 
PlayTheBlues4U: posts small blind $0.05
Klytu: posts big blind $0.10
BigBlue: sits out 
*** HOLE CARDS ***
Dealt to PlayTheBlues4U [6d 4s]
EddieMoney9: folds 
LanskyBanksy: folds 
PlayTheBlues4U: folds 
Uncalled bet ($0.05) returned to Klytu
Klytu collected $0.10 from pot
Klytu: doesn't show hand 
*** SUMMARY ***
Total pot $0.10 | Rake $0 
Seat 2: LanskyBanksy (button) folded before Flop (didn't bet)
Seat 3: PlayTheBlues4U (small blind) folded before Flop
Seat 5: Klytu (big blind) collected ($0.10)
Seat 6: EddieMoney9 folded before Flop (didn't bet)


PokerStars Hand #204851188077: Hold'em No Limit ($0.05/$0.10 USD) - 2019/10/21 21:58:46 ET
Table 'Hesperia' 6-max Seat #1 is the button
Seat 1: BigBlue ($9.12 in chips) 
Seat 2: LanskyBanksy ($16.07 in chips) 
Seat 4: PlayTheBlues4U ($9.67 in chips) 
Seat 5: Klytu ($10.15 in chips) 
LanskyBanksy: posts small blind $0.05
PlayTheBlues4U: posts big blind $0.10
*** HOLE CARDS ***
Dealt to PlayTheBlues4U [2d 6h]
Klytu: folds 
BigBlue: folds 
LanskyBanksy: calls $0.05
PlayTheBlues4U: checks 
*** FLOP *** [3c Ks Kc]
LanskyBanksy: checks 
PlayTheBlues4U: checks 
*** TURN *** [3c Ks Kc] [9s]
LanskyBanksy: checks 
PlayTheBlues4U: checks 
*** RIVER *** [3c Ks Kc 9s] [5c]
LanskyBanksy: bets $0.20
PlayTheBlues4U: folds 
Uncalled bet ($0.20) returned to LanskyBanksy
LanskyBanksy collected $0.19 from pot
LanskyBanksy: doesn't show hand 
*** SUMMARY ***
Total pot $0.20 | Rake $0.01 
Board [3c Ks Kc 9s 5c]
Seat 1: BigBlue (button) folded before Flop (didn't bet)
Seat 2: LanskyBanksy (small blind) collected ($0.19)
Seat 4: PlayTheBlues4U (big blind) folded on the River
Seat 5: Klytu folded before Flop (didn't bet)


PokerStars Hand #204851188049: Hold'em No Limit ($0.05/$0.10 USD) - 2019/10/21 21:58:39 ET
Table 'Draco' 6-max Seat #6 is the button
Seat 2: LanskyBanksy ($15.87 in chips) 
Seat 3: PlayTheBlues4U ($18.08 in chips) 
Seat 5: Klytu ($10.85 in chips) 
Seat 6: EddieMoney9 ($15.37 in chips) 
LanskyBanksy: posts small blind $0.05
PlayTheBlues4U: posts big blind $0.10
*** HOLE CARDS ***
Dealt to PlayTheBlues4U [3c Qc]
BigBlue joins the table at seat #1 
Klytu: raises $0.20 to $0.30
EddieMoney9: folds 
LanskyBanksy: folds 
PlayTheBlues4U: folds 
Uncalled bet ($0.20) returned to Klytu
Klytu collected $0.25 from pot
Klytu: doesn't show hand 
*** SUMMARY ***
Total pot $0.25 | Rake $0 
Seat 2: LanskyBanksy (small blind) folded before Flop
Seat 3: PlayTheBlues4U (big blind) folded before Flop
Seat 5: Klytu collected ($0.25)
Seat 6: EddieMoney9 (button) folded before Flop (didn't bet)


PokerStars Hand #204851188039: Hold'em No Limit ($0.05/$0.10 USD) - 2019/10/21 21:58:37 ET
Table 'Hesperia' 6-max Seat #5 is the button
Seat 1: BigBlue ($9.17 in chips) 
Seat 2: LanskyBanksy ($16.17 in chips) 
Seat 4: PlayTheBlues4U ($9.67 in chips) 
Seat 5: Klytu ($10 in chips) 
BigBlue: posts small blind $0.05
LanskyBanksy: posts big blind $0.10
*** HOLE CARDS ***
Dealt to PlayTheBlues4U [6d Qh]
PlayTheBlues4U: folds 
Klytu: raises $0.15 to $0.25
BigBlue: folds 
LanskyBanksy: folds 
Uncalled bet ($0.15) returned to Klytu
Klytu collected $0.25 from pot
Klytu: doesn't show hand 
*** SUMMARY ***
Total pot $0.25 | Rake $0 
Seat 1: BigBlue (small blind) folded before Flop
Seat 2: LanskyBanksy (big blind) folded before Flop
Seat 4: PlayTheBlues4U folded before Flop (didn't bet)
Seat 5: Klytu (button) collected ($0.25)


PokerStars Hand #204851188008: Hold'em No Limit ($0.05/$0.10 USD) - 2019/10/21 21:58:28 ET
Table 'Draco' 6-max Seat #5 is the button
Seat 2: LanskyBanksy ($15.97 in chips) 
Seat 3: PlayTheBlues4U ($18.08 in chips) 
Seat 5: Klytu ($10.70 in chips) 
Seat 6: EddieMoney9 ($15.42 in chips) 
EddieMoney9: posts small blind $0.05
LanskyBanksy: posts big blind $0.10
*** HOLE CARDS ***
Dealt to PlayTheBlues4U [5s Jd]
PlayTheBlues4U: folds 
bsdnj leaves the table
Klytu: raises $0.15 to $0.25
EddieMoney9: folds 
LanskyBanksy: folds 
Uncalled bet ($0.15) returned to Klytu
Klytu collected $0.25 from pot
Klytu: doesn't show hand 
*** SUMMARY ***
Total pot $0.25 | Rake $0 
Seat 2: LanskyBanksy (big blind) folded before Flop
Seat 3: PlayTheBlues4U folded before Flop (didn't bet)
Seat 5: Klytu (button) collected ($0.25)
Seat 6: EddieMoney9 (small blind) folded before Flop


PokerStars Hand #204851187977: Hold'em No Limit ($0.05/$0.10 USD) - 2019/10/21 21:58:18 ET
Table 'Hesperia' 6-max Seat #4 is the button
Seat 1: BigBlue ($9.12 in chips) 
Seat 2: LanskyBanksy ($16.17 in chips) 
Seat 4: PlayTheBlues4U ($9.67 in chips) 
Seat 5: Klytu ($10.05 in chips) 
Klytu: posts small blind $0.05
BigBlue: posts big blind $0.10
*** HOLE CARDS ***
Dealt to PlayTheBlues4U [3d 9s]
LanskyBanksy: folds 
PlayTheBlues4U: folds 
Klytu: folds 
Uncalled bet ($0.05) returned to BigBlue
BigBlue collected $0.10 from pot
BigBlue: doesn't show hand 
*** SUMMARY ***
Total pot $0.10 | Rake $0 
Seat 1: BigBlue (big blind) collected ($0.10)
Seat 2: LanskyBanksy folded before Flop (didn't bet)
Seat 4: PlayTheBlues4U (button) folded before Flop (didn't bet)
Seat 5: Klytu (small blind) folded before Flop


PokerStars Hand #204851187929: Hold'em No Limit ($0.05/$0.10 USD) - 2019/10/21 21:58:04 ET
Table 'Hesperia' 6-max Seat #2 is the button
Seat 1: BigBlue ($9.12 in chips) 
Seat 2: LanskyBanksy ($16.02 in chips) 
Seat 4: PlayTheBlues4U ($9.72 in chips) 
Seat 5: Klytu ($10.15 in chips) 
PlayTheBlues4U: posts small blind $0.05
Klytu: posts big blind $0.10
*** HOLE CARDS ***
Dealt to PlayTheBlues4U [3s Kc]
BigBlue: folds 
LanskyBanksy: raises $0.20 to $0.30
PlayTheBlues4U: folds 
Klytu: folds 
Uncalled bet ($0.20) returned to LanskyBanksy
LanskyBanksy collected $0.25 from pot
LanskyBanksy: doesn't show hand 
*** SUMMARY ***
Total pot $0.25 | Rake $0 
Seat 1: BigBlue folded before Flop (didn't bet)
Seat 2: LanskyBanksy (button) collected ($0.25)
Seat 4: PlayTheBlues4U (small blind) folded before Flop
Seat 5: Klytu (big blind) folded before Flop


PokerStars Hand #204851187892: Hold'em No Limit ($0.05/$0.10 USD) - 2019/10/21 21:57:54 ET
Table 'Draco' 6-max Seat #4 is the button
Seat 1: 123tiger711a ($10.14 in chips) 
Seat 2: LanskyBanksy ($15.97 in chips) 
Seat 3: PlayTheBlues4U ($16.04 in chips) 
Seat 4: bsdnj ($2.11 in chips) 
Seat 5: Klytu ($10.75 in chips) 
Seat 6: EddieMoney9 ($15.52 in chips) 
Klytu: posts small blind $0.05
EddieMoney9: posts big blind $0.10
*** HOLE CARDS ***
Dealt to PlayTheBlues4U [Td Kd]
123tiger711a: folds 
LanskyBanksy: folds 
PlayTheBlues4U: raises $0.20 to $0.30
123tiger711a leaves the table
bsdnj: calls $0.30
Klytu: folds 
EddieMoney9: folds 
*** FLOP *** [5s Jd Ad]
PlayTheBlues4U: bets $0.40
bsdnj: raises $1.41 to $1.81 and is all-in
PlayTheBlues4U: calls $1.41
*** TURN *** [5s Jd Ad] [3h]
*** RIVER *** [5s Jd Ad 3h] [Qh]
*** SHOW DOWN ***
PlayTheBlues4U: shows [Td Kd] (a straight, Ten to Ace)
bsdnj: shows [Ah Qc] (two pair, Aces and Queens)
PlayTheBlues4U collected $4.15 from pot
*** SUMMARY ***
Total pot $4.37 | Rake $0.22 
Board [5s Jd Ad 3h Qh]
Seat 1: 123tiger711a folded before Flop (didn't bet)
Seat 2: LanskyBanksy folded before Flop (didn't bet)
Seat 3: PlayTheBlues4U showed [Td Kd] and won ($4.15) with a straight, Ten to Ace
Seat 4: bsdnj (button) showed [Ah Qc] and lost with two pair, Aces and Queens
Seat 5: Klytu (small blind) folded before Flop
Seat 6: EddieMoney9 (big blind) folded before Flop


PokerStars Hand #204851187889: Hold'em No Limit ($0.05/$0.10 USD) - 2019/10/21 21:57:53 ET
Table 'Hesperia' 6-max Seat #1 is the button
Seat 1: BigBlue ($9.12 in chips) 
Seat 2: LanskyBanksy ($16.07 in chips) 
Seat 4: PlayTheBlues4U ($9.82 in chips) 
Seat 5: Klytu ($10 in chips) 
LanskyBanksy: posts small blind $0.05
PlayTheBlues4U: posts big blind $0.10
*** HOLE CARDS ***
Dealt to PlayTheBlues4U [Tc 2c]
Klytu: raises $0.20 to $0.30
BigBlue: folds 
LanskyBanksy: folds 
PlayTheBlues4U: folds 
Uncalled bet ($0.20) returned to Klytu
Klytu collected $0.25 from pot
Klytu: doesn't show hand 
*** SUMMARY ***
Total pot $0.25 | Rake $0 
Seat 1: BigBlue (button) folded before Flop (didn't bet)
Seat 2: LanskyBanksy (small blind) folded before Flop
Seat 4: PlayTheBlues4U (big blind) folded before Flop
Seat 5: Klytu collected ($0.25)


PokerStars Hand #204851187853: Hold'em No Limit ($0.05/$0.10 USD) - 2019/10/21 21:57:44 ET
Table 'Hesperia' 6-max Seat #5 is the button
Seat 1: BigBlue ($9.17 in chips) 
Seat 2: LanskyBanksy ($16.02 in chips) 
Seat 4: PlayTheBlues4U ($9.82 in chips) 
Seat 5: Klytu ($10 in chips) 
BigBlue: posts small blind $0.05
LanskyBanksy: posts big blind $0.10
*** HOLE CARDS ***
Dealt to PlayTheBlues4U [4h Ac]
PlayTheBlues4U: folds 
Klytu: folds 
BigBlue: folds 
Uncalled bet ($0.05) returned to LanskyBanksy
LanskyBanksy collected $0.10 from pot
LanskyBanksy: doesn't show hand 
*** SUMMARY ***
Total pot $0.10 | Rake $0 
Seat 1: BigBlue (small blind) folded before Flop
Seat 2: LanskyBanksy (big blind) collected ($0.10)
Seat 4: PlayTheBlues4U folded before Flop (didn't bet)
Seat 5: Klytu (button) folded before Flop (didn't bet)


PokerStars Hand #204851187825: Hold'em No Limit ($0.05/$0.10 USD) - 2019/10/21 21:57:37 ET
Table 'Hesperia' 6-max Seat #4 is the button
Seat 1: BigBlue ($9.12 in chips) 
Seat 2: LanskyBanksy ($16.02 in chips) 
Seat 4: PlayTheBlues4U ($9.82 in chips) 
Seat 5: Klytu ($6.75 in chips) 
Klytu: posts small blind $0.05
BigBlue: posts big blind $0.10
*** HOLE CARDS ***
Dealt to PlayTheBlues4U [5s 2h]
LanskyBanksy: folds 
PlayTheBlues4U: folds 
Klytu: folds 
Uncalled bet ($0.05) returned to BigBlue
BigBlue collected $0.10 from pot
BigBlue: doesn't show hand 
*** SUMMARY ***
Total pot $0.10 | Rake $0 
Seat 1: BigBlue (big blind) collected ($0.10)
Seat 2: LanskyBanksy folded before Flop (didn't bet)
Seat 4: PlayTheBlues4U (button) folded before Flop (didn't bet)
Seat 5: Klytu (small blind) folded before Flop


PokerStars Hand #204851187786: Hold'em No Limit ($0.05/$0.10 USD) - 2019/10/21 21:57:24 ET
Table 'Draco' 6-max Seat #3 is the button
Seat 1: 123tiger711a ($10.14 in chips) 
Seat 2: LanskyBanksy ($15.97 in chips) 
Seat 3: PlayTheBlues4U ($16.34 in chips) 
Seat 4: bsdnj ($2.16 in chips) 
Seat 5: Klytu ($10.43 in chips) 
Seat 6: EddieMoney9 ($15.52 in chips) 
bsdnj: posts small blind $0.05
Klytu: posts big blind $0.10
*** HOLE CARDS ***
Dealt to PlayTheBlues4U [Qh Kc]
EddieMoney9: folds 
123tiger711a: folds 
LanskyBanksy: folds 
PlayTheBlues4U: raises $0.20 to $0.30
bsdnj: folds 
Klytu: calls $0.20
*** FLOP *** [Th 3c 8d]
Klytu: checks 
PlayTheBlues4U: checks 
*** TURN *** [Th 3c 8d] [5d]
Klytu: checks 
PlayTheBlues4U: checks 
*** RIVER *** [Th 3c 8d 5d] [8h]
Klytu: checks 
PlayTheBlues4U: checks 
*** SHOW DOWN ***
Klytu: shows [Ac 4s] (a pair of Eights)
PlayTheBlues4U: mucks hand 
Klytu collected $0.62 from pot
*** SUMMARY ***
Total pot $0.65 | Rake $0.03 
Board [Th 3c 8d 5d 8h]
Seat 1: 123tiger711a folded before Flop (didn't bet)
Seat 2: LanskyBanksy folded before Flop (didn't bet)
Seat 3: PlayTheBlues4U (button) mucked [Qh Kc]
Seat 4: bsdnj (small blind) folded before Flop
Seat 5: Klytu (big blind) showed [Ac 4s] and won ($0.62) with a pair of Eights
Seat 6: EddieMoney9 folded before Flop (didn't bet)


PokerStars Hand #204851187676: Hold'em No Limit ($0.05/$0.10 USD) - 2019/10/21 21:56:51 ET
Table 'Draco' 6-max Seat #2 is the button
Seat 1: 123tiger711a ($10.14 in chips) 
Seat 2: LanskyBanksy ($15.65 in chips) 
Seat 3: PlayTheBlues4U ($16.39 in chips) 
Seat 4: bsdnj ($2.46 in chips) 
Seat 5: Klytu ($10.43 in chips) 
Seat 6: EddieMoney9 ($15.52 in chips) 
PlayTheBlues4U: posts small blind $0.05
bsdnj: posts big blind $0.10
*** HOLE CARDS ***
Dealt to PlayTheBlues4U [7s 6d]
Klytu: folds 
EddieMoney9: folds 
123tiger711a: folds 
LanskyBanksy: calls $0.10
PlayTheBlues4U: folds 
bsdnj: checks 
*** FLOP *** [Ah Ks Ad]
bsdnj: checks 
LanskyBanksy: bets $0.20
bsdnj: calls $0.20
*** TURN *** [Ah Ks Ad] [8h]
bsdnj: checks 
LanskyBanksy: bets $0.40
bsdnj: folds 
Uncalled bet ($0.40) returned to LanskyBanksy
LanskyBanksy collected $0.62 from pot
LanskyBanksy: doesn't show hand 
*** SUMMARY ***
Total pot $0.65 | Rake $0.03 
Board [Ah Ks Ad 8h]
Seat 1: 123tiger711a folded before Flop (didn't bet)
Seat 2: LanskyBanksy (button) collected ($0.62)
Seat 3: PlayTheBlues4U (small blind) folded before Flop
Seat 4: bsdnj (big blind) folded on the Turn
Seat 5: Klytu folded before Flop (didn't bet)
Seat 6: EddieMoney9 folded before Flop (didn't bet)


PokerStars Hand #204851187640: Hold'em No Limit ($0.05/$0.10 USD) - 2019/10/21 21:56:41 ET
Table 'Hesperia' 6-max Seat #2 is the button
Seat 1: BigBlue ($6.15 in chips) 
Seat 2: LanskyBanksy ($16.02 in chips) 
Seat 4: PlayTheBlues4U ($9.87 in chips) 
Seat 5: Klytu ($10 in chips) 
Seat 6: 123tiger711a ($22.64 in chips) 
PlayTheBlues4U: posts small blind $0.05
Klytu: posts big blind $0.10
*** HOLE CARDS ***
Dealt to PlayTheBlues4U [Jh 5c]
123tiger711a: folds 
BigBlue: calls $0.10
LanskyBanksy: folds 
123tiger711a leaves the table
PlayTheBlues4U: folds 
Klytu: raises $0.30 to $0.40
BigBlue: calls $0.30
*** FLOP *** [Kh 3s As]
Klytu: bets $0.45
BigBlue: calls $0.45
*** TURN *** [Kh 3s As] [Kc]
Klytu: checks 
Varginho13 leaves the table
BigBlue: bets $0.80
Klytu: calls $0.80
*** RIVER *** [Kh 3s As Kc] [4h]
Klytu: checks 
BigBlue: bets $1.60
Klytu: calls $1.60
*** SHOW DOWN ***
BigBlue: shows [5s Ks] (three of a kind, Kings)
Klytu: mucks hand 
BigBlue collected $6.22 from pot
*** SUMMARY ***
Total pot $6.55 | Rake $0.33 
Board [Kh 3s As Kc 4h]
Seat 1: BigBlue showed [5s Ks] and won ($6.22) with three of a kind, Kings
Seat 2: LanskyBanksy (button) folded before Flop (didn't bet)
Seat 4: PlayTheBlues4U (small blind) folded before Flop
Seat 5: Klytu (big blind) mucked [Jc Js]
Seat 6: 123tiger711a folded before Flop (didn't bet)


PokerStars Hand #204851187620: Hold'em No Limit ($0.05/$0.10 USD) - 2019/10/21 21:56:35 ET
Table 'Draco' 6-max Seat #1 is the button
Seat 1: 123tiger711a ($10.14 in chips) 
Seat 2: LanskyBanksy ($15.75 in chips) 
Seat 3: PlayTheBlues4U ($16.29 in chips) 
Seat 4: bsdnj ($2.46 in chips) 
Seat 5: Klytu ($10.43 in chips) 
Seat 6: EddieMoney9 ($15.52 in chips) 
LanskyBanksy: posts small blind $0.05
PlayTheBlues4U: posts big blind $0.10
*** HOLE CARDS ***
Dealt to PlayTheBlues4U [Th As]
bsdnj: folds 
Klytu: folds 
EddieMoney9: folds 
123tiger711a: folds 
LanskyBanksy: calls $0.05
PlayTheBlues4U: raises $0.20 to $0.30
LanskyBanksy: folds 
Uncalled bet ($0.20) returned to PlayTheBlues4U
PlayTheBlues4U collected $0.20 from pot
PlayTheBlues4U: doesn't show hand 
*** SUMMARY ***
Total pot $0.20 | Rake $0 
Seat 1: 123tiger711a (button) folded before Flop (didn't bet)
Seat 2: LanskyBanksy (small blind) folded before Flop
Seat 3: PlayTheBlues4U (big blind) collected ($0.20)
Seat 4: bsdnj folded before Flop (didn't bet)
Seat 5: Klytu folded before Flop (didn't bet)
Seat 6: EddieMoney9 folded before Flop (didn't bet)


PokerStars Hand #204851187550: Hold'em No Limit ($0.05/$0.10 USD) - 2019/10/21 21:56:13 ET
Table 'Draco' 6-max Seat #6 is the button
Seat 1: 123tiger711a ($10.44 in chips) 
Seat 2: LanskyBanksy ($15.85 in chips) 
Seat 3: PlayTheBlues4U ($15.93 in chips) 
Seat 4: bsdnj ($2.46 in chips) 
Seat 5: Klytu ($10.43 in chips) 
Seat 6: EddieMoney9 ($15.52 in chips) 
123tiger711a: posts small blind $0.05
LanskyBanksy: posts big blind $0.10
*** HOLE CARDS ***
Dealt to PlayTheBlues4U [Qc Kd]
PlayTheBlues4U: raises $0.20 to $0.30
bsdnj: folds 
Klytu: folds 
EddieMoney9: folds 
123tiger711a: calls $0.25
LanskyBanksy: folds 
*** FLOP *** [2h 4s 2d]
123tiger711a: checks 
PlayTheBlues4U: checks 
*** TURN *** [2h 4s 2d] [As]
123tiger711a: checks 
PlayTheBlues4U: bets $0.40
123tiger711a: folds 
Uncalled bet ($0.40) returned to PlayTheBlues4U
PlayTheBlues4U collected $0.66 from pot
PlayTheBlues4U: doesn't show hand 
*** SUMMARY ***
Total pot $0.70 | Rake $0.04 
Board [2h 4s 2d As]
Seat 1: 123tiger711a (small blind) folded on the Turn
Seat 2: LanskyBanksy (big blind) folded before Flop
Seat 3: PlayTheBlues4U collected ($0.66)
Seat 4: bsdnj folded before Flop (didn't bet)
Seat 5: Klytu folded before Flop (didn't bet)
Seat 6: EddieMoney9 (button) folded before Flop (didn't bet)


PokerStars Hand #204851187529: Hold'em No Limit ($0.05/$0.10 USD) - 2019/10/21 21:56:06 ET
Table 'Hesperia' 6-max Seat #1 is the button
Seat 1: BigBlue ($6.15 in chips) 
Seat 2: LanskyBanksy ($16.12 in chips) 
Seat 4: PlayTheBlues4U ($9.78 in chips) 
Seat 5: Klytu ($10 in chips) 
Seat 6: 123tiger711a ($22.64 in chips) 
LanskyBanksy: posts small blind $0.05
PlayTheBlues4U: posts big blind $0.10
*** HOLE CARDS ***
Dealt to PlayTheBlues4U [8s 9c]
Klytu: folds 
123tiger711a: folds 
BigBlue: folds 
LanskyBanksy: calls $0.05
PlayTheBlues4U: checks 
*** FLOP *** [Ks Kc Ac]
LanskyBanksy: checks 
PlayTheBlues4U: checks 
*** TURN *** [Ks Kc Ac] [Kd]
LanskyBanksy: checks 
PlayTheBlues4U: checks 
*** RIVER *** [Ks Kc Ac Kd] [4d]
LanskyBanksy: checks 
PlayTheBlues4U: checks 
*** SHOW DOWN ***
LanskyBanksy: shows [5d 3c] (three of a kind, Kings)
PlayTheBlues4U: shows [8s 9c] (three of a kind, Kings - Ace+Nine kicker)
PlayTheBlues4U collected $0.19 from pot
*** SUMMARY ***
Total pot $0.20 | Rake $0.01 
Board [Ks Kc Ac Kd 4d]
Seat 1: BigBlue (button) folded before Flop (didn't bet)
Seat 2: LanskyBanksy (small blind) showed [5d 3c] and lost with three of a kind, Kings
Seat 4: PlayTheBlues4U (big blind) showed [8s 9c] and won ($0.19) with three of a kind, Kings
Seat 5: Klytu folded before Flop (didn't bet)
Seat 6: 123tiger711a folded before Flop (didn't bet)


PokerStars Hand #204851187486: Hold'em No Limit ($0.05/$0.10 USD) - 2019/10/21 21:55:55 ET
Table 'Hesperia' 6-max Seat #6 is the button
Seat 1: BigBlue ($6.05 in chips) 
Seat 2: LanskyBanksy ($16.22 in chips) 
Seat 4: PlayTheBlues4U ($9.78 in chips) 
Seat 5: Klytu ($10 in chips) 
Seat 6: 123tiger711a ($22.64 in chips) 
BigBlue: posts small blind $0.05
LanskyBanksy: posts big blind $0.10
*** HOLE CARDS ***
Dealt to PlayTheBlues4U [Ad 6d]
PlayTheBlues4U: folds 
Klytu: folds 
123tiger711a: folds 
BigBlue: raises $0.10 to $0.20
LanskyBanksy: folds 
Uncalled bet ($0.10) returned to BigBlue
BigBlue collected $0.20 from pot
BigBlue: doesn't show hand 
*** SUMMARY ***
Total pot $0.20 | Rake $0 
Seat 1: BigBlue (small blind) collected ($0.20)
Seat 2: LanskyBanksy (big blind) folded before Flop
Seat 4: PlayTheBlues4U folded before Flop (didn't bet)
Seat 5: Klytu folded before Flop (didn't bet)
Seat 6: 123tiger711a (button) folded before Flop (didn't bet)


PokerStars Hand #204851187453: Hold'em No Limit ($0.05/$0.10 USD) - 2019/10/21 21:55:47 ET
Table 'Draco' 6-max Seat #5 is the button
Seat 1: 123tiger711a ($10.54 in chips) 
Seat 2: LanskyBanksy ($15.85 in chips) 
Seat 3: PlayTheBlues4U ($15.93 in chips) 
Seat 4: bsdnj ($2.46 in chips) 
Seat 5: Klytu ($10.28 in chips) 
Seat 6: EddieMoney9 ($15.57 in chips) 
EddieMoney9: posts small blind $0.05
123tiger711a: posts big blind $0.10
*** HOLE CARDS ***
Dealt to PlayTheBlues4U [8d As]
LanskyBanksy: folds 
PlayTheBlues4U: folds 
bsdnj: folds 
Klytu: raises $0.15 to $0.25
EddieMoney9: folds 
123tiger711a: folds 
Uncalled bet ($0.15) returned to Klytu
Klytu collected $0.25 from pot
Klytu: doesn't show hand 
*** SUMMARY ***
Total pot $0.25 | Rake $0 
Seat 1: 123tiger711a (big blind) folded before Flop
Seat 2: LanskyBanksy folded before Flop (didn't bet)
Seat 3: PlayTheBlues4U folded before Flop (didn't bet)
Seat 4: bsdnj folded before Flop (didn't bet)
Seat 5: Klytu (button) collected ($0.25)
Seat 6: EddieMoney9 (small blind) folded before Flop


PokerStars Hand #204851187151: Hold'em No Limit ($0.05/$0.10 USD) - 2019/10/21 21:54:35 ET
Table 'Hesperia' 6-max Seat #5 is the button
Seat 1: BigBlue ($6.85 in chips) 
Seat 2: LanskyBanksy ($15.22 in chips) 
Seat 4: PlayTheBlues4U ($9.78 in chips) 
Seat 5: Klytu ($10 in chips) 
Seat 6: 123tiger711a ($22.94 in chips) 
123tiger711a: posts small blind $0.05
BigBlue: posts big blind $0.10
*** HOLE CARDS ***
Dealt to PlayTheBlues4U [4c Qc]
LanskyBanksy: raises $0.20 to $0.30
PlayTheBlues4U: folds 
Klytu: folds 
123tiger711a: calls $0.25
BigBlue: calls $0.20
*** FLOP *** [6c 5c 9d]
123tiger711a: checks 
BigBlue: checks 
LanskyBanksy: checks 
*** TURN *** [6c 5c 9d] [Kd]
123tiger711a: checks 
BigBlue: checks 
LanskyBanksy: bets $0.50
123tiger711a: folds 
BigBlue: calls $0.50
*** RIVER *** [6c 5c 9d Kd] [2s]
BigBlue: checks 
LanskyBanksy: bets $0.90
BigBlue: folds 
Uncalled bet ($0.90) returned to LanskyBanksy
LanskyBanksy collected $1.80 from pot
LanskyBanksy: doesn't show hand 
*** SUMMARY ***
Total pot $1.90 | Rake $0.10 
Board [6c 5c 9d Kd 2s]
Seat 1: BigBlue (big blind) folded on the River
Seat 2: LanskyBanksy collected ($1.80)
Seat 4: PlayTheBlues4U folded before Flop (didn't bet)
Seat 5: Klytu (button) folded before Flop (didn't bet)
Seat 6: 123tiger711a (small blind) folded on the Turn


PokerStars Hand #204851187133: Hold'em No Limit ($0.05/$0.10 USD) - 2019/10/21 21:54:31 ET
Table 'Draco' 6-max Seat #4 is the button
Seat 1: 123tiger711a ($10.54 in chips) 
Seat 2: LanskyBanksy ($15.85 in chips) 
Seat 3: PlayTheBlues4U ($12.28 in chips) 
Seat 4: bsdnj ($6.36 in chips) 
Seat 5: Klytu ($10.33 in chips) 
Seat 6: EddieMoney9 ($15.67 in chips) 
Klytu: posts small blind $0.05
EddieMoney9: posts big blind $0.10
*** HOLE CARDS ***
Dealt to PlayTheBlues4U [6h 7s]
123tiger711a: folds 
LanskyBanksy: folds 
PlayTheBlues4U: raises $0.20 to $0.30
bsdnj: calls $0.30
Klytu: folds 
EddieMoney9: folds 
*** FLOP *** [5c 4c 3s]
PlayTheBlues4U: bets $0.50
bsdnj: calls $0.50
*** TURN *** [5c 4c 3s] [Qs]
PlayTheBlues4U: bets $1.20
bsdnj: calls $1.20
*** RIVER *** [5c 4c 3s Qs] [Td]
PlayTheBlues4U: bets $1.90
bsdnj: calls $1.90
*** SHOW DOWN ***
PlayTheBlues4U: shows [6h 7s] (a straight, Three to Seven)
bsdnj: mucks hand 
PlayTheBlues4U collected $7.55 from pot
*** SUMMARY ***
Total pot $7.95 | Rake $0.40 
Board [5c 4c 3s Qs Td]
Seat 1: 123tiger711a folded before Flop (didn't bet)
Seat 2: LanskyBanksy folded before Flop (didn't bet)
Seat 3: PlayTheBlues4U showed [6h 7s] and won ($7.55) with a straight, Three to Seven
Seat 4: bsdnj (button) mucked [Qc Ac]
Seat 5: Klytu (small blind) folded before Flop
Seat 6: EddieMoney9 (big blind) folded before Flop


PokerStars Hand #204851187077: Hold'em No Limit ($0.05/$0.10 USD) - 2019/10/21 21:54:18 ET
Table 'Hesperia' 6-max Seat #4 is the button
Seat 1: BigBlue ($6.85 in chips) 
Seat 2: LanskyBanksy ($15.22 in chips) 
Seat 4: PlayTheBlues4U ($9.78 in chips) 
Seat 5: Klytu ($8.98 in chips) 
Seat 6: 123tiger711a ($22.89 in chips) 
Klytu: posts small blind $0.05
123tiger711a: posts big blind $0.10
*** HOLE CARDS ***
Dealt to PlayTheBlues4U [Js 2s]
BigBlue: folds 
LanskyBanksy: folds 
PlayTheBlues4U: folds 
Klytu: folds 
Uncalled bet ($0.05) returned to 123tiger711a
123tiger711a collected $0.10 from pot
*** SUMMARY ***
Total pot $0.10 | Rake $0 
Seat 1: BigBlue folded before Flop (didn't bet)
Seat 2: LanskyBanksy folded before Flop (didn't bet)
Seat 4: PlayTheBlues4U (button) folded before Flop (didn't bet)
Seat 5: Klytu (small blind) folded before Flop
Seat 6: 123tiger711a (big blind) collected ($0.10)


PokerStars Hand #204851187044: Hold'em No Limit ($0.05/$0.10 USD) - 2019/10/21 21:54:10 ET
Table 'Draco' 6-max Seat #3 is the button
Seat 1: 123tiger711a ($10.54 in chips) 
Seat 2: LanskyBanksy ($15.85 in chips) 
Seat 3: PlayTheBlues4U ($12.28 in chips) 
Seat 4: bsdnj ($6.41 in chips) 
Seat 5: Klytu ($10.28 in chips) 
Seat 6: EddieMoney9 ($15.67 in chips) 
bsdnj: posts small blind $0.05
Klytu: posts big blind $0.10
*** HOLE CARDS ***
Dealt to PlayTheBlues4U [7s 2h]
EddieMoney9: folds 
123tiger711a: folds 
LanskyBanksy: folds 
PlayTheBlues4U: folds 
bsdnj: folds 
Uncalled bet ($0.05) returned to Klytu
Klytu collected $0.10 from pot
Klytu: doesn't show hand 
*** SUMMARY ***
Total pot $0.10 | Rake $0 
Seat 1: 123tiger711a folded before Flop (didn't bet)
Seat 2: LanskyBanksy folded before Flop (didn't bet)
Seat 3: PlayTheBlues4U (button) folded before Flop (didn't bet)
Seat 4: bsdnj (small blind) folded before Flop
Seat 5: Klytu (big blind) collected ($0.10)
Seat 6: EddieMoney9 folded before Flop (didn't bet)


PokerStars Hand #204851187007: Hold'em No Limit ($0.05/$0.10 USD) - 2019/10/21 21:54:01 ET
Table 'Draco' 6-max Seat #2 is the button
Seat 1: 123tiger711a ($10.54 in chips) 
Seat 2: LanskyBanksy ($15.85 in chips) 
Seat 3: PlayTheBlues4U ($12.33 in chips) 
Seat 4: bsdnj ($6.36 in chips) 
Seat 5: Klytu ($10.28 in chips) 
Seat 6: EddieMoney9 ($15.67 in chips) 
PlayTheBlues4U: posts small blind $0.05
bsdnj: posts big blind $0.10
*** HOLE CARDS ***
Dealt to PlayTheBlues4U [7c Kd]
Klytu: folds 
EddieMoney9: folds 
123tiger711a: folds 
LanskyBanksy: folds 
PlayTheBlues4U: folds 
Uncalled bet ($0.05) returned to bsdnj
bsdnj collected $0.10 from pot
bsdnj: doesn't show hand 
*** SUMMARY ***
Total pot $0.10 | Rake $0 
Seat 1: 123tiger711a folded before Flop (didn't bet)
Seat 2: LanskyBanksy (button) folded before Flop (didn't bet)
Seat 3: PlayTheBlues4U (small blind) folded before Flop
Seat 4: bsdnj (big blind) collected ($0.10)
Seat 5: Klytu folded before Flop (didn't bet)
Seat 6: EddieMoney9 folded before Flop (didn't bet)


PokerStars Hand #204851186891: Hold'em No Limit ($0.05/$0.10 USD) - 2019/10/21 21:53:35 ET
Table 'Draco' 6-max Seat #1 is the button
Seat 1: 123tiger711a ($10.54 in chips) 
Seat 2: LanskyBanksy ($15.95 in chips) 
Seat 3: PlayTheBlues4U ($12.43 in chips) 
Seat 4: bsdnj ($6.18 in chips) 
Seat 5: Klytu ($10.28 in chips) 
Seat 6: EddieMoney9 ($15.67 in chips) 
LanskyBanksy: posts small blind $0.05
PlayTheBlues4U: posts big blind $0.10
*** HOLE CARDS ***
Dealt to PlayTheBlues4U [2c 8d]
bsdnj: calls $0.10
Klytu: folds 
EddieMoney9: folds 
123tiger711a: folds 
LanskyBanksy: calls $0.05
PlayTheBlues4U: checks 
*** FLOP *** [7d 5s Jd]
LanskyBanksy: checks 
PlayTheBlues4U: checks 
bsdnj: bets $0.30
LanskyBanksy: folds 
PlayTheBlues4U: folds 
Uncalled bet ($0.30) returned to bsdnj
bsdnj collected $0.28 from pot
bsdnj: doesn't show hand 
*** SUMMARY ***
Total pot $0.30 | Rake $0.02 
Board [7d 5s Jd]
Seat 1: 123tiger711a (button) folded before Flop (didn't bet)
Seat 2: LanskyBanksy (small blind) folded on the Flop
Seat 3: PlayTheBlues4U (big blind) folded on the Flop
Seat 4: bsdnj collected ($0.28)
Seat 5: Klytu folded before Flop (didn't bet)
Seat 6: EddieMoney9 folded before Flop (didn't bet)


PokerStars Hand #204851186880: Hold'em No Limit ($0.05/$0.10 USD) - 2019/10/21 21:53:34 ET
Table 'Hesperia' 6-max Seat #2 is the button
Seat 1: BigBlue ($6.85 in chips) 
Seat 2: LanskyBanksy ($14.12 in chips) 
Seat 4: PlayTheBlues4U ($9.88 in chips) 
Seat 5: Klytu ($8.61 in chips) 
Seat 6: 123tiger711a ($22.89 in chips) 
PlayTheBlues4U: posts small blind $0.05
Klytu: posts big blind $0.10
*** HOLE CARDS ***
Dealt to PlayTheBlues4U [Kd 2d]
123tiger711a: folds 
BigBlue: folds 
LanskyBanksy: calls $0.10
PlayTheBlues4U: calls $0.05
Klytu: checks 
*** FLOP *** [4s Jc 9h]
PlayTheBlues4U: checks 
Klytu: bets $0.15
LanskyBanksy: calls $0.15
PlayTheBlues4U: folds 
*** TURN *** [4s Jc 9h] [6s]
Klytu: bets $0.30
LanskyBanksy: calls $0.30
*** RIVER *** [4s Jc 9h 6s] [9c]
Klytu: checks 
LanskyBanksy: bets $0.57
Klytu: calls $0.57
*** SHOW DOWN ***
LanskyBanksy: shows [Qh Jd] (two pair, Jacks and Nines)
Klytu: mucks hand 
LanskyBanksy collected $2.22 from pot
*** SUMMARY ***
Total pot $2.34 | Rake $0.12 
Board [4s Jc 9h 6s 9c]
Seat 1: BigBlue folded before Flop (didn't bet)
Seat 2: LanskyBanksy (button) showed [Qh Jd] and won ($2.22) with two pair, Jacks and Nines
Seat 4: PlayTheBlues4U (small blind) folded on the Flop
Seat 5: Klytu (big blind) mucked [5c Js]
Seat 6: 123tiger711a folded before Flop (didn't bet)


PokerStars Hand #204851186699: Hold'em No Limit ($0.05/$0.10 USD) - 2019/10/21 21:52:53 ET
Table 'Draco' 6-max Seat #6 is the button
Seat 1: 123tiger711a ($10.18 in chips) 
Seat 2: LanskyBanksy ($16.05 in chips) 
Seat 3: PlayTheBlues4U ($12.43 in chips) 
Seat 4: bsdnj ($6.18 in chips) 
Seat 5: Klytu ($10.28 in chips) 
Seat 6: EddieMoney9 ($15.97 in chips) 
123tiger711a: posts small blind $0.05
LanskyBanksy: posts big blind $0.10
*** HOLE CARDS ***
Dealt to PlayTheBlues4U [3d 9d]
PlayTheBlues4U: folds 
bsdnj: folds 
Klytu: folds 
EddieMoney9: raises $0.20 to $0.30
123tiger711a: calls $0.25
LanskyBanksy: folds 
*** FLOP *** [6c 5c 8h]
123tiger711a: checks 
EddieMoney9: checks 
*** TURN *** [6c 5c 8h] [2d]
123tiger711a: checks 
EddieMoney9: checks 
*** RIVER *** [6c 5c 8h 2d] [5h]
123tiger711a: checks 
EddieMoney9: checks 
*** SHOW DOWN ***
123tiger711a: shows [Jh As] (a pair of Fives)
EddieMoney9: mucks hand 
123tiger711a collected $0.66 from pot
*** SUMMARY ***
Total pot $0.70 | Rake $0.04 
Board [6c 5c 8h 2d 5h]
Seat 1: 123tiger711a (small blind) showed [Jh As] and won ($0.66) with a pair of Fives
Seat 2: LanskyBanksy (big blind) folded before Flop
Seat 3: PlayTheBlues4U folded before Flop (didn't bet)
Seat 4: bsdnj folded before Flop (didn't bet)
Seat 5: Klytu folded before Flop (didn't bet)
Seat 6: EddieMoney9 (button) mucked [Kh Qh]


PokerStars Hand #204851186671: Hold'em No Limit ($0.05/$0.10 USD) - 2019/10/21 21:52:46 ET
Table 'Hesperia' 6-max Seat #1 is the button
Seat 1: BigBlue ($6.85 in chips) 
Seat 2: LanskyBanksy ($12.64 in chips) 
Seat 4: PlayTheBlues4U ($9.98 in chips) 
Seat 5: Klytu ($10.15 in chips) 
Seat 6: 123tiger711a ($22.89 in chips) 
LanskyBanksy: posts small blind $0.05
PlayTheBlues4U: posts big blind $0.10
*** HOLE CARDS ***
Dealt to PlayTheBlues4U [6s Ks]
Klytu: raises $0.20 to $0.30
123tiger711a: folds 
BigBlue: folds 
LanskyBanksy: calls $0.25
PlayTheBlues4U: folds 
*** FLOP *** [4s Kh 7d]
LanskyBanksy: bets $0.20
Klytu: calls $0.20
*** TURN *** [4s Kh 7d] [6c]
LanskyBanksy: checks 
Klytu: checks 
*** RIVER *** [4s Kh 7d 6c] [5s]
LanskyBanksy: bets $1.04
Klytu: calls $1.04
*** SHOW DOWN ***
LanskyBanksy: shows [Ah Ad] (a pair of Aces)
Klytu: mucks hand 
LanskyBanksy collected $3.02 from pot
*** SUMMARY ***
Total pot $3.18 | Rake $0.16 
Board [4s Kh 7d 6c 5s]
Seat 1: BigBlue (button) folded before Flop (didn't bet)
Seat 2: LanskyBanksy (small blind) showed [Ah Ad] and won ($3.02) with a pair of Aces
Seat 4: PlayTheBlues4U (big blind) folded before Flop
Seat 5: Klytu mucked [Jc Kd]
Seat 6: 123tiger711a folded before Flop (didn't bet)


PokerStars Hand #204851186615: Hold'em No Limit ($0.05/$0.10 USD) - 2019/10/21 21:52:31 ET
Table 'Hesperia' 6-max Seat #6 is the button
Seat 1: BigBlue ($6.90 in chips) 
Seat 2: LanskyBanksy ($12.74 in chips) 
Seat 4: PlayTheBlues4U ($9.98 in chips) 
Seat 5: Klytu ($10 in chips) 
Seat 6: 123tiger711a ($22.89 in chips) 
BigBlue: posts small blind $0.05
LanskyBanksy: posts big blind $0.10
*** HOLE CARDS ***
Dealt to PlayTheBlues4U [5c 4c]
PlayTheBlues4U: folds 
Klytu: raises $0.15 to $0.25
123tiger711a: folds 
BigBlue: folds 
LanskyBanksy: folds 
Uncalled bet ($0.15) returned to Klytu
Klytu collected $0.25 from pot
Klytu: doesn't show hand 
*** SUMMARY ***
Total pot $0.25 | Rake $0 
Seat 1: BigBlue (small blind) folded before Flop
Seat 2: LanskyBanksy (big blind) folded before Flop
Seat 4: PlayTheBlues4U folded before Flop (didn't bet)
Seat 5: Klytu collected ($0.25)
Seat 6: 123tiger711a (button) folded before Flop (didn't bet)


PokerStars Hand #204851186534: Hold'em No Limit ($0.05/$0.10 USD) - 2019/10/21 21:52:14 ET
Table 'Draco' 6-max Seat #5 is the button
Seat 1: 123tiger711a ($10 in chips) 
Seat 2: LanskyBanksy ($16.05 in chips) 
Seat 3: PlayTheBlues4U ($12.43 in chips) 
Seat 4: bsdnj ($6.28 in chips) 
Seat 5: Klytu ($10.28 in chips) 
Seat 6: EddieMoney9 ($16.07 in chips) 
EddieMoney9: posts small blind $0.05
123tiger711a: posts big blind $0.10
*** HOLE CARDS ***
Dealt to PlayTheBlues4U [Tc Qh]
LanskyBanksy: folds 
PlayTheBlues4U said, "pure skill"
PlayTheBlues4U: folds 
bsdnj: calls $0.10
Klytu: folds 
EddieMoney9: calls $0.05
123tiger711a: checks 
*** FLOP *** [Ad 4c As]
EddieMoney9: checks 
123tiger711a: checks 
bsdnj: checks 
*** TURN *** [Ad 4c As] [4h]
EddieMoney9: checks 
123tiger711a: checks 
bsdnj: checks 
*** RIVER *** [Ad 4c As 4h] [7s]
EddieMoney9: checks 
123tiger711a: checks 
bsdnj: checks 
*** SHOW DOWN ***
EddieMoney9: shows [3d Qs] (two pair, Aces and Fours)
123tiger711a: shows [8d Kc] (two pair, Aces and Fours - King kicker)
bsdnj: mucks hand 
123tiger711a collected $0.28 from pot
*** SUMMARY ***
Total pot $0.30 | Rake $0.02 
Board [Ad 4c As 4h 7s]
Seat 1: 123tiger711a (big blind) showed [8d Kc] and won ($0.28) with two pair, Aces and Fours
Seat 2: LanskyBanksy folded before Flop (didn't bet)
Seat 3: PlayTheBlues4U folded before Flop (didn't bet)
Seat 4: bsdnj mucked [Td 9h]
Seat 5: Klytu (button) folded before Flop (didn't bet)
Seat 6: EddieMoney9 (small blind) showed [3d Qs] and lost with two pair, Aces and Fours


PokerStars Hand #204851186358: Hold'em No Limit ($0.05/$0.10 USD) - 2019/10/21 21:51:37 ET
Table 'Hesperia' 6-max Seat #5 is the button
Seat 1: BigBlue ($7.20 in chips) 
Seat 2: LanskyBanksy ($12.18 in chips) 
Seat 4: PlayTheBlues4U ($9.98 in chips) 
Seat 5: Klytu ($6.54 in chips) 
Seat 6: 123tiger711a ($23.19 in chips) 
123tiger711a: posts small blind $0.05
BigBlue: posts big blind $0.10
*** HOLE CARDS ***
Dealt to PlayTheBlues4U [7c 8h]
LanskyBanksy: raises $0.20 to $0.30
PlayTheBlues4U: folds 
Klytu: folds 
123tiger711a: calls $0.25
BigBlue: calls $0.20
*** FLOP *** [Qc Qd 2h]
123tiger711a: checks 
BigBlue: checks 
LanskyBanksy: checks 
*** TURN *** [Qc Qd 2h] [7d]
123tiger711a: checks 
BigBlue: checks 
LanskyBanksy: bets $0.50
123tiger711a: folds 
BigBlue: folds 
Uncalled bet ($0.50) returned to LanskyBanksy
LanskyBanksy collected $0.86 from pot
LanskyBanksy: doesn't show hand 
*** SUMMARY ***
Total pot $0.90 | Rake $0.04 
Board [Qc Qd 2h 7d]
Seat 1: BigBlue (big blind) folded on the Turn
Seat 2: LanskyBanksy collected ($0.86)
Seat 4: PlayTheBlues4U folded before Flop (didn't bet)
Seat 5: Klytu (button) folded before Flop (didn't bet)
Seat 6: 123tiger711a (small blind) folded on the Turn


PokerStars Hand #204851186222: Hold'em No Limit ($0.05/$0.10 USD) - 2019/10/21 21:51:04 ET
Table 'Draco' 6-max Seat #4 is the button
Seat 1: 123tiger711a ($10.06 in chips) 
Seat 2: LanskyBanksy ($16.05 in chips) 
Seat 3: PlayTheBlues4U ($11.59 in chips) 
Seat 4: bsdnj ($6.28 in chips) 
Seat 5: Klytu ($10.58 in chips) 
Seat 6: EddieMoney9 ($16.37 in chips) 
Klytu: posts small blind $0.05
EddieMoney9: posts big blind $0.10
*** HOLE CARDS ***
Dealt to PlayTheBlues4U [2h 2d]
123tiger711a: calls $0.10
LanskyBanksy: folds 
PlayTheBlues4U: raises $0.20 to $0.30
bsdnj: folds 
Klytu: calls $0.25
EddieMoney9: calls $0.20
123tiger711a: calls $0.20
*** FLOP *** [Th 6h 5h]
Klytu: checks 
EddieMoney9: checks 
123tiger711a: checks 
PlayTheBlues4U: checks 
*** TURN *** [Th 6h 5h] [6s]
Klytu: checks 
EddieMoney9: checks 
123tiger711a: checks 
PlayTheBlues4U: checks 
*** RIVER *** [Th 6h 5h 6s] [9h]
Klytu: checks 
EddieMoney9: checks 
123tiger711a: checks 
PlayTheBlues4U: checks 
*** SHOW DOWN ***
Klytu: shows [Kd Qs] (a pair of Sixes)
EddieMoney9: shows [Ac 4s] (a pair of Sixes - Ace kicker)
123tiger711a: mucks hand 
PlayTheBlues4U: shows [2h 2d] (a flush, Ten high)
PlayTheBlues4U collected $1.14 from pot
*** SUMMARY ***
Total pot $1.20 | Rake $0.06 
Board [Th 6h 5h 6s 9h]
Seat 1: 123tiger711a mucked [Js 8s]
Seat 2: LanskyBanksy folded before Flop (didn't bet)
Seat 3: PlayTheBlues4U showed [2h 2d] and won ($1.14) with a flush, Ten high
Seat 4: bsdnj (button) folded before Flop (didn't bet)
Seat 5: Klytu (small blind) showed [Kd Qs] and lost with a pair of Sixes
Seat 6: EddieMoney9 (big blind) showed [Ac 4s] and lost with a pair of Sixes


PokerStars Hand #204851186201: Hold'em No Limit ($0.05/$0.10 USD) - 2019/10/21 21:51:01 ET
Table 'Hesperia' 6-max Seat #4 is the button
Seat 1: BigBlue ($7.20 in chips) 
Seat 2: LanskyBanksy ($12.18 in chips) 
Seat 4: PlayTheBlues4U ($9.98 in chips) 
Seat 5: Klytu ($16.77 in chips) 
Seat 6: 123tiger711a ($13.98 in chips) 
Klytu: posts small blind $0.05
123tiger711a: posts big blind $0.10
*** HOLE CARDS ***
Dealt to PlayTheBlues4U [6d Tc]
BigBlue: folds 
LanskyBanksy: folds 
PlayTheBlues4U: folds 
Klytu: raises $0.20 to $0.30
123tiger711a: calls $0.20
*** FLOP *** [Qc 2h Qh]
Klytu: checks 
123tiger711a: checks 
*** TURN *** [Qc 2h Qh] [9c]
Klytu: bets $0.30
123tiger711a: raises $1.17 to $1.47
Klytu: calls $1.17
*** RIVER *** [Qc 2h Qh 9c] [3d]
Klytu: bets $1.70
123tiger711a: raises $6.76 to $8.46
Klytu: calls $6.76
*** SHOW DOWN ***
123tiger711a: shows [Qs Ks] (three of a kind, Queens)
Klytu: mucks hand 
123tiger711a collected $19.44 from pot
*** SUMMARY ***
Total pot $20.46 | Rake $1.02 
Board [Qc 2h Qh 9c 3d]
Seat 1: BigBlue folded before Flop (didn't bet)
Seat 2: LanskyBanksy folded before Flop (didn't bet)
Seat 4: PlayTheBlues4U (button) folded before Flop (didn't bet)
Seat 5: Klytu (small blind) mucked [Ah 7s]
Seat 6: 123tiger711a (big blind) showed [Qs Ks] and won ($19.44) with three of a kind, Queens


PokerStars Hand #204851186145: Hold'em No Limit ($0.05/$0.10 USD) - 2019/10/21 21:50:48 ET
Table 'Hesperia' 6-max Seat #2 is the button
Seat 1: BigBlue ($7.05 in chips) 
Seat 2: LanskyBanksy ($12.18 in chips) 
Seat 4: PlayTheBlues4U ($10.03 in chips) 
Seat 5: Klytu ($16.87 in chips) 
Seat 6: 123tiger711a ($13.98 in chips) 
PlayTheBlues4U: posts small blind $0.05
Klytu: posts big blind $0.10
*** HOLE CARDS ***
Dealt to PlayTheBlues4U [Ks 7c]
123tiger711a: folds 
BigBlue: raises $0.15 to $0.25
LanskyBanksy: folds 
PlayTheBlues4U: folds 
Klytu: folds 
Uncalled bet ($0.15) returned to BigBlue
BigBlue collected $0.25 from pot
BigBlue: doesn't show hand 
*** SUMMARY ***
Total pot $0.25 | Rake $0 
Seat 1: BigBlue collected ($0.25)
Seat 2: LanskyBanksy (button) folded before Flop (didn't bet)
Seat 4: PlayTheBlues4U (small blind) folded before Flop
Seat 5: Klytu (big blind) folded before Flop
Seat 6: 123tiger711a folded before Flop (didn't bet)


PokerStars Hand #204851186110: Hold'em No Limit ($0.05/$0.10 USD) - 2019/10/21 21:50:40 ET
Table 'Draco' 6-max Seat #3 is the button
Seat 1: 123tiger711a ($10.46 in chips) 
Seat 2: LanskyBanksy ($16.05 in chips) 
Seat 3: PlayTheBlues4U ($11.09 in chips) 
Seat 4: bsdnj ($6.33 in chips) 
Seat 5: Klytu ($10.68 in chips) 
Seat 6: EddieMoney9 ($16.37 in chips) 
bsdnj: posts small blind $0.05
Klytu: posts big blind $0.10
*** HOLE CARDS ***
Dealt to PlayTheBlues4U [Ks 9s]
EddieMoney9: folds 
123tiger711a: calls $0.10
LanskyBanksy: folds 
PlayTheBlues4U: raises $0.30 to $0.40
bsdnj: folds 
Klytu: folds 
123tiger711a: calls $0.30
*** FLOP *** [Tc Ah 9d]
123tiger711a: checks 
PlayTheBlues4U: bets $0.60
123tiger711a: folds 
Uncalled bet ($0.60) returned to PlayTheBlues4U
PlayTheBlues4U collected $0.90 from pot
PlayTheBlues4U: doesn't show hand 
*** SUMMARY ***
Total pot $0.95 | Rake $0.05 
Board [Tc Ah 9d]
Seat 1: 123tiger711a folded on the Flop
Seat 2: LanskyBanksy folded before Flop (didn't bet)
Seat 3: PlayTheBlues4U (button) collected ($0.90)
Seat 4: bsdnj (small blind) folded before Flop
Seat 5: Klytu (big blind) folded before Flop
Seat 6: EddieMoney9 folded before Flop (didn't bet)


PokerStars Hand #204851186067: Hold'em No Limit ($0.05/$0.10 USD) - 2019/10/21 21:50:32 ET
Table 'Hesperia' 6-max Seat #1 is the button
Seat 1: BigBlue ($6.80 in chips) 
Seat 2: LanskyBanksy ($12.23 in chips) 
Seat 4: PlayTheBlues4U ($10.13 in chips) 
Seat 5: Klytu ($16.87 in chips) 
Seat 6: 123tiger711a ($14.08 in chips) 
LanskyBanksy: posts small blind $0.05
PlayTheBlues4U: posts big blind $0.10
*** HOLE CARDS ***
Dealt to PlayTheBlues4U [Td 6s]
Klytu: folds 
123tiger711a: calls $0.10
BigBlue: raises $0.35 to $0.45
LanskyBanksy: folds 
PlayTheBlues4U: folds 
123tiger711a: folds 
Uncalled bet ($0.35) returned to BigBlue
BigBlue collected $0.35 from pot
BigBlue: doesn't show hand 
*** SUMMARY ***
Total pot $0.35 | Rake $0 
Seat 1: BigBlue (button) collected ($0.35)
Seat 2: LanskyBanksy (small blind) folded before Flop
Seat 4: PlayTheBlues4U (big blind) folded before Flop
Seat 5: Klytu folded before Flop (didn't bet)
Seat 6: 123tiger711a folded before Flop


PokerStars Hand #204851185990: Hold'em No Limit ($0.05/$0.10 USD) - 2019/10/21 21:50:15 ET
Table 'Hesperia' 6-max Seat #6 is the button
Seat 1: BigBlue ($6.85 in chips) 
Seat 2: LanskyBanksy ($12.18 in chips) 
Seat 4: PlayTheBlues4U ($10.13 in chips) 
Seat 5: Klytu ($16.87 in chips) 
Seat 6: 123tiger711a ($14.08 in chips) 
BigBlue: posts small blind $0.05
LanskyBanksy: posts big blind $0.10
*** HOLE CARDS ***
Dealt to PlayTheBlues4U [4d Kc]
PlayTheBlues4U: folds 
Klytu: folds 
123tiger711a: folds 
BigBlue: folds 
Uncalled bet ($0.05) returned to LanskyBanksy
LanskyBanksy collected $0.10 from pot
LanskyBanksy: doesn't show hand 
*** SUMMARY ***
Total pot $0.10 | Rake $0 
Seat 1: BigBlue (small blind) folded before Flop
Seat 2: LanskyBanksy (big blind) collected ($0.10)
Seat 4: PlayTheBlues4U folded before Flop (didn't bet)
Seat 5: Klytu folded before Flop (didn't bet)
Seat 6: 123tiger711a (button) folded before Flop (didn't bet)


PokerStars Hand #204850619977: Hold'em No Limit ($0.05/$0.10 USD) - 2019/10/21 21:49:49 ET
Table 'Draco' 6-max Seat #2 is the button
Seat 1: 123tiger711a ($10.46 in chips) 
Seat 2: LanskyBanksy ($15.68 in chips) 
Seat 3: PlayTheBlues4U ($11.29 in chips) 
Seat 4: bsdnj ($6.53 in chips) 
Seat 5: Klytu ($10.68 in chips) 
Seat 6: EddieMoney9 ($16.37 in chips) 
PlayTheBlues4U: posts small blind $0.05
bsdnj: posts big blind $0.10
*** HOLE CARDS ***
Dealt to PlayTheBlues4U [9s 5s]
Klytu: folds 
EddieMoney9: folds 
123tiger711a: folds 
LanskyBanksy: raises $0.10 to $0.20
PlayTheBlues4U: calls $0.15
bsdnj: calls $0.10
*** FLOP *** [Td Kd Jc]
PlayTheBlues4U: checks 
bsdnj: checks 
LanskyBanksy: bets $0.29
PlayTheBlues4U: folds 
bsdnj: folds 
Uncalled bet ($0.29) returned to LanskyBanksy
LanskyBanksy collected $0.57 from pot
LanskyBanksy: doesn't show hand 
*** SUMMARY ***
Total pot $0.60 | Rake $0.03 
Board [Td Kd Jc]
Seat 1: 123tiger711a folded before Flop (didn't bet)
Seat 2: LanskyBanksy (button) collected ($0.57)
Seat 3: PlayTheBlues4U (small blind) folded on the Flop
Seat 4: bsdnj (big blind) folded on the Flop
Seat 5: Klytu folded before Flop (didn't bet)
Seat 6: EddieMoney9 folded before Flop (didn't bet)


PokerStars Hand #204850619827: Hold'em No Limit ($0.05/$0.10 USD) - 2019/10/21 21:49:12 ET
Table 'Hesperia' 6-max Seat #5 is the button
Seat 1: BigBlue ($6.95 in chips) 
Seat 2: LanskyBanksy ($12.18 in chips) 
Seat 4: PlayTheBlues4U ($10.43 in chips) 
Seat 5: Klytu ($19.12 in chips) 
Seat 6: 123tiger711a ($11.67 in chips) 
123tiger711a: posts small blind $0.05
BigBlue: posts big blind $0.10
*** HOLE CARDS ***
Dealt to PlayTheBlues4U [Ac 8d]
LanskyBanksy: folds 
PlayTheBlues4U: raises $0.20 to $0.30
Klytu: raises $0.75 to $1.05
123tiger711a: calls $1
BigBlue: folds 
PlayTheBlues4U: folds 
*** FLOP *** [6d Th 5d]
123tiger711a: checks 
Klytu: bets $1.20
123tiger711a: raises $4.78 to $5.98
Klytu: folds 
Uncalled bet ($4.78) returned to 123tiger711a
123tiger711a collected $4.66 from pot
*** SUMMARY ***
Total pot $4.90 | Rake $0.24 
Board [6d Th 5d]
Seat 1: BigBlue (big blind) folded before Flop
Seat 2: LanskyBanksy folded before Flop (didn't bet)
Seat 4: PlayTheBlues4U folded before Flop
Seat 5: Klytu (button) folded on the Flop
Seat 6: 123tiger711a (small blind) collected ($4.66)


PokerStars Hand #204850619711: Hold'em No Limit ($0.05/$0.10 USD) - 2019/10/21 21:48:42 ET
Table 'Draco' 6-max Seat #1 is the button
Seat 1: 123tiger711a ($10.70 in chips) 
Seat 2: LanskyBanksy ($15.78 in chips) 
Seat 3: PlayTheBlues4U ($10.98 in chips) 
Seat 4: bsdnj ($6.53 in chips) 
Seat 5: Klytu ($10.68 in chips) 
Seat 6: EddieMoney9 ($16.37 in chips) 
LanskyBanksy: posts small blind $0.05
PlayTheBlues4U: posts big blind $0.10
*** HOLE CARDS ***
Dealt to PlayTheBlues4U [Tc 8c]
bsdnj: folds 
Klytu: folds 
EddieMoney9: folds 
123tiger711a: calls $0.10
LanskyBanksy: calls $0.05
PlayTheBlues4U: checks 
*** FLOP *** [7c 8d Jh]
LanskyBanksy: checks 
PlayTheBlues4U: checks 
123tiger711a: bets $0.14
LanskyBanksy: folds 
PlayTheBlues4U: calls $0.14
*** TURN *** [7c 8d Jh] [9s]
PlayTheBlues4U: checks 
123tiger711a: checks 
*** RIVER *** [7c 8d Jh 9s] [6s]
PlayTheBlues4U: bets $0.90
123tiger711a: folds 
Uncalled bet ($0.90) returned to PlayTheBlues4U
PlayTheBlues4U collected $0.55 from pot
PlayTheBlues4U: doesn't show hand 
*** SUMMARY ***
Total pot $0.58 | Rake $0.03 
Board [7c 8d Jh 9s 6s]
Seat 1: 123tiger711a (button) folded on the River
Seat 2: LanskyBanksy (small blind) folded on the Flop
Seat 3: PlayTheBlues4U (big blind) collected ($0.55)
Seat 4: bsdnj folded before Flop (didn't bet)
Seat 5: Klytu folded before Flop (didn't bet)
Seat 6: EddieMoney9 folded before Flop (didn't bet)


PokerStars Hand #204850619694: Hold'em No Limit ($0.05/$0.10 USD) - 2019/10/21 21:48:39 ET
Table 'Hesperia' 6-max Seat #4 is the button
Seat 1: BigBlue ($6.95 in chips) 
Seat 2: LanskyBanksy ($12.18 in chips) 
Seat 4: PlayTheBlues4U ($11.08 in chips) 
Seat 5: Klytu ($19.17 in chips) 
Seat 6: 123tiger711a ($11.04 in chips) 
Klytu: posts small blind $0.05
123tiger711a: posts big blind $0.10
*** HOLE CARDS ***
Dealt to PlayTheBlues4U [9d 6d]
BigBlue: folds 
LanskyBanksy: folds 
PlayTheBlues4U: raises $0.20 to $0.30
Klytu: folds 
123tiger711a: calls $0.20
*** FLOP *** [5h 6c Jd]
123tiger711a: checks 
PlayTheBlues4U: bets $0.35
123tiger711a: raises $1.32 to $1.67
PlayTheBlues4U: folds 
Uncalled bet ($1.32) returned to 123tiger711a
123tiger711a collected $1.28 from pot
*** SUMMARY ***
Total pot $1.35 | Rake $0.07 
Board [5h 6c Jd]
Seat 1: BigBlue folded before Flop (didn't bet)
Seat 2: LanskyBanksy folded before Flop (didn't bet)
Seat 4: PlayTheBlues4U (button) folded on the Flop
Seat 5: Klytu (small blind) folded before Flop
Seat 6: 123tiger711a (big blind) collected ($1.28)


PokerStars Hand #204850619612: Hold'em No Limit ($0.05/$0.10 USD) - 2019/10/21 21:48:21 ET
Table 'Hesperia' 6-max Seat #2 is the button
Seat 1: BigBlue ($6.80 in chips) 
Seat 2: LanskyBanksy ($12.18 in chips) 
Seat 4: PlayTheBlues4U ($11.13 in chips) 
Seat 5: Klytu ($19.27 in chips) 
Seat 6: 123tiger711a ($11.04 in chips) 
PlayTheBlues4U: posts small blind $0.05
Klytu: posts big blind $0.10
*** HOLE CARDS ***
Dealt to PlayTheBlues4U [Qs 5h]
123tiger711a: folds 
BigBlue: raises $0.25 to $0.35
LanskyBanksy: folds 
PlayTheBlues4U: folds 
Klytu: folds 
Uncalled bet ($0.25) returned to BigBlue
BigBlue collected $0.25 from pot
BigBlue: doesn't show hand 
*** SUMMARY ***
Total pot $0.25 | Rake $0 
Seat 1: BigBlue collected ($0.25)
Seat 2: LanskyBanksy (button) folded before Flop (didn't bet)
Seat 4: PlayTheBlues4U (small blind) folded before Flop
Seat 5: Klytu (big blind) folded before Flop
Seat 6: 123tiger711a folded before Flop (didn't bet)


PokerStars Hand #204850619580: Hold'em No Limit ($0.05/$0.10 USD) - 2019/10/21 21:48:12 ET
Table 'Draco' 6-max Seat #6 is the button
Seat 1: 123tiger711a ($10.80 in chips) 
Seat 2: LanskyBanksy ($15.69 in chips) 
Seat 3: PlayTheBlues4U ($10.98 in chips) 
Seat 4: bsdnj ($6.53 in chips) 
Seat 5: Klytu ($10.68 in chips) 
Seat 6: EddieMoney9 ($16.37 in chips) 
123tiger711a: posts small blind $0.05
LanskyBanksy: posts big blind $0.10
*** HOLE CARDS ***
Dealt to PlayTheBlues4U [Js 8s]
PlayTheBlues4U: folds 
bsdnj: folds 
Klytu: folds 
EddieMoney9: folds 
123tiger711a: calls $0.05
LanskyBanksy: checks 
*** FLOP *** [3c 9s 4c]
123tiger711a: checks 
LanskyBanksy: checks 
*** TURN *** [3c 9s 4c] [Qs]
123tiger711a: checks 
LanskyBanksy: checks 
*** RIVER *** [3c 9s 4c Qs] [5d]
123tiger711a: checks 
LanskyBanksy: bets $0.50
123tiger711a: folds 
Uncalled bet ($0.50) returned to LanskyBanksy
LanskyBanksy collected $0.19 from pot
LanskyBanksy: doesn't show hand 
*** SUMMARY ***
Total pot $0.20 | Rake $0.01 
Board [3c 9s 4c Qs 5d]
Seat 1: 123tiger711a (small blind) folded on the River
Seat 2: LanskyBanksy (big blind) collected ($0.19)
Seat 3: PlayTheBlues4U folded before Flop (didn't bet)
Seat 4: bsdnj folded before Flop (didn't bet)
Seat 5: Klytu folded before Flop (didn't bet)
Seat 6: EddieMoney9 (button) folded before Flop (didn't bet)


PokerStars Hand #204850619520: Hold'em No Limit ($0.05/$0.10 USD) - 2019/10/21 21:47:56 ET
Table 'Draco' 6-max Seat #5 is the button
Seat 1: 123tiger711a ($10.90 in chips) 
Seat 2: LanskyBanksy ($15.54 in chips) 
Seat 3: PlayTheBlues4U ($10.98 in chips) 
Seat 4: bsdnj ($6.53 in chips) 
Seat 5: Klytu ($10.68 in chips) 
Seat 6: EddieMoney9 ($16.42 in chips) 
EddieMoney9: posts small blind $0.05
123tiger711a: posts big blind $0.10
*** HOLE CARDS ***
Dealt to PlayTheBlues4U [6h 8d]
LanskyBanksy: raises $0.30 to $0.40
PlayTheBlues4U: folds 
bsdnj: folds 
Klytu: folds 
EddieMoney9: folds 
123tiger711a: folds 
Uncalled bet ($0.30) returned to LanskyBanksy
LanskyBanksy collected $0.25 from pot
LanskyBanksy: doesn't show hand 
*** SUMMARY ***
Total pot $0.25 | Rake $0 
Seat 1: 123tiger711a (big blind) folded before Flop
Seat 2: LanskyBanksy collected ($0.25)
Seat 3: PlayTheBlues4U folded before Flop (didn't bet)
Seat 4: bsdnj folded before Flop (didn't bet)
Seat 5: Klytu (button) folded before Flop (didn't bet)
Seat 6: EddieMoney9 (small blind) folded before Flop


PokerStars Hand #204850619465: Hold'em No Limit ($0.05/$0.10 USD) - 2019/10/21 21:47:42 ET
Table 'Hesperia' 6-max Seat #1 is the button
Seat 1: BigBlue ($6.80 in chips) 
Seat 2: LanskyBanksy ($12.28 in chips) 
Seat 4: PlayTheBlues4U ($11.04 in chips) 
Seat 5: Klytu ($19.27 in chips) 
Seat 6: 123tiger711a ($11.04 in chips) 
LanskyBanksy: posts small blind $0.05
PlayTheBlues4U: posts big blind $0.10
*** HOLE CARDS ***
Dealt to PlayTheBlues4U [7h 4c]
Klytu: folds 
123tiger711a: folds 
BigBlue: folds 
LanskyBanksy: calls $0.05
PlayTheBlues4U: checks 
*** FLOP *** [2c 5d Js]
LanskyBanksy: checks 
PlayTheBlues4U: checks 
*** TURN *** [2c 5d Js] [Kh]
LanskyBanksy: checks 
PlayTheBlues4U: bets $0.10
LanskyBanksy: folds 
Uncalled bet ($0.10) returned to PlayTheBlues4U
PlayTheBlues4U collected $0.19 from pot
PlayTheBlues4U: doesn't show hand 
*** SUMMARY ***
Total pot $0.20 | Rake $0.01 
Board [2c 5d Js Kh]
Seat 1: BigBlue (button) folded before Flop (didn't bet)
Seat 2: LanskyBanksy (small blind) folded on the Turn
Seat 4: PlayTheBlues4U (big blind) collected ($0.19)
Seat 5: Klytu folded before Flop (didn't bet)
Seat 6: 123tiger711a folded before Flop (didn't bet)


PokerStars Hand #204445467342:  Hold'em No Limit ($0.05/$0.10 USD) - 2019/10/11 19:05:19 ET
Table 'Beatrix' 6-max Seat #4 is the button
Seat 1: wcb607a ($10.46 in chips) 
Seat 2: griffinxblack ($6.35 in chips) 
Seat 3: SuWasup ($6.97 in chips) 
Seat 4: clovvnfiesta ($4.96 in chips) 
Seat 5: RiverbendAA ($10 in chips) 
Seat 6: PlayTheBlues4U ($10 in chips) 
RiverbendAA: posts small blind $0.05
PlayTheBlues4U: posts big blind $0.10
*** HOLE CARDS ***
Dealt to PlayTheBlues4U [Ts 4c]
wcb607a: folds 
griffinxblack: folds 
SuWasup: raises $0.20 to $0.30
clovvnfiesta: folds 
RiverbendAA: calls $0.25
PlayTheBlues4U: folds 
*** FLOP *** [Kd 5s Js]
RiverbendAA: checks 
SuWasup: bets $0.30
RiverbendAA: folds 
Uncalled bet ($0.30) returned to SuWasup
SuWasup collected $0.66 from pot
SuWasup: doesn't show hand 
*** SUMMARY ***
Total pot $0.70 | Rake $0.04 
Board [Kd 5s Js]
Seat 1: wcb607a folded before Flop (didn't bet)
Seat 2: griffinxblack folded before Flop (didn't bet)
Seat 3: SuWasup collected ($0.66)
Seat 4: clovvnfiesta (button) folded before Flop (didn't bet)
Seat 5: RiverbendAA (small blind) folded on the Flop
Seat 6: PlayTheBlues4U (big blind) folded before Flop



PokerStars Hand #204445467397:  Hold'em No Limit ($0.05/$0.10 USD) - 2019/10/11 19:05:50 ET
Table 'Beatrix' 6-max Seat #5 is the button
Seat 1: wcb607a ($10.46 in chips) 
Seat 2: griffinxblack ($6.35 in chips) 
Seat 3: SuWasup ($7.33 in chips) 
Seat 4: clovvnfiesta ($4.96 in chips) 
Seat 5: RiverbendAA ($10 in chips) 
Seat 6: PlayTheBlues4U ($9.90 in chips) 
PlayTheBlues4U: posts small blind $0.05
wcb607a: posts big blind $0.10
*** HOLE CARDS ***
Dealt to PlayTheBlues4U [Qc Ad]
griffinxblack: folds 
SuWasup: folds 
clovvnfiesta: raises $0.10 to $0.20
RiverbendAA: folds 
PlayTheBlues4U: calls $0.15
wcb607a: folds 
*** FLOP *** [8c 7h 7s]
PlayTheBlues4U: checks 
clovvnfiesta: bets $0.10
PlayTheBlues4U: calls $0.10
*** TURN *** [8c 7h 7s] [Jd]
PlayTheBlues4U: checks 
clovvnfiesta: bets $0.33
PlayTheBlues4U: calls $0.33
*** RIVER *** [8c 7h 7s Jd] [9h]
PlayTheBlues4U: checks 
clovvnfiesta: bets $0.75
PlayTheBlues4U: folds 
Uncalled bet ($0.75) returned to clovvnfiesta
clovvnfiesta collected $1.29 from pot
clovvnfiesta: doesn't show hand 
*** SUMMARY ***
Total pot $1.36 | Rake $0.07 
Board [8c 7h 7s Jd 9h]
Seat 1: wcb607a (big blind) folded before Flop
Seat 2: griffinxblack folded before Flop (didn't bet)
Seat 3: SuWasup folded before Flop (didn't bet)
Seat 4: clovvnfiesta collected ($1.29)
Seat 5: RiverbendAA (button) folded before Flop (didn't bet)
Seat 6: PlayTheBlues4U (small blind) folded on the River



PokerStars Hand #204445467486:  Hold'em No Limit ($0.05/$0.10 USD) - 2019/10/11 19:06:40 ET
Table 'Beatrix' 6-max Seat #6 is the button
Seat 1: wcb607a ($10.36 in chips) 
Seat 2: griffinxblack ($6.35 in chips) 
Seat 3: SuWasup ($7.33 in chips) 
Seat 4: clovvnfiesta ($5.62 in chips) 
Seat 5: RiverbendAA ($10 in chips) 
Seat 6: PlayTheBlues4U ($9.27 in chips) 
wcb607a: posts small blind $0.05
griffinxblack: posts big blind $0.10
*** HOLE CARDS ***
Dealt to PlayTheBlues4U [7d Qs]
SuWasup: raises $0.20 to $0.30
clovvnfiesta: folds 
RiverbendAA: folds 
PlayTheBlues4U: folds 
wcb607a: folds 
griffinxblack: calls $0.20
*** FLOP *** [7h 4c 2h]
griffinxblack: checks 
SuWasup: bets $0.40
griffinxblack: calls $0.40
*** TURN *** [7h 4c 2h] [Jh]
griffinxblack: checks 
SuWasup: bets $0.90
griffinxblack: folds 
Uncalled bet ($0.90) returned to SuWasup
SuWasup collected $1.38 from pot
SuWasup: doesn't show hand 
*** SUMMARY ***
Total pot $1.45 | Rake $0.07 
Board [7h 4c 2h Jh]
Seat 1: wcb607a (small blind) folded before Flop
Seat 2: griffinxblack (big blind) folded on the Turn
Seat 3: SuWasup collected ($1.38)
Seat 4: clovvnfiesta folded before Flop (didn't bet)
Seat 5: RiverbendAA folded before Flop (didn't bet)
Seat 6: PlayTheBlues4U (button) folded before Flop (didn't bet)



PokerStars Hand #204445467553:  Hold'em No Limit ($0.05/$0.10 USD) - 2019/10/11 19:07:17 ET
Table 'Beatrix' 6-max Seat #1 is the button
Seat 1: wcb607a ($10.31 in chips) 
Seat 2: griffinxblack ($5.65 in chips) 
Seat 3: SuWasup ($8.01 in chips) 
Seat 4: clovvnfiesta ($5.62 in chips) 
Seat 5: RiverbendAA ($10 in chips) 
Seat 6: PlayTheBlues4U ($9.27 in chips) 
griffinxblack: posts small blind $0.05
SuWasup: posts big blind $0.10
*** HOLE CARDS ***
Dealt to PlayTheBlues4U [Jd 4c]
clovvnfiesta: raises $0.10 to $0.20
RiverbendAA: folds 
PlayTheBlues4U: folds 
wcb607a: folds 
griffinxblack: raises $0.60 to $0.80
SuWasup: folds 
clovvnfiesta: calls $0.60
*** FLOP *** [7h 3c Qd]
griffinxblack: bets $1.20
clovvnfiesta: raises $1.20 to $2.40
griffinxblack: raises $2.45 to $4.85 and is all-in
clovvnfiesta: calls $2.42 and is all-in
Uncalled bet ($0.03) returned to griffinxblack
*** TURN *** [7h 3c Qd] [7c]
*** RIVER *** [7h 3c Qd 7c] [5d]
*** SHOW DOWN ***
griffinxblack: shows [Ah As] (two pair, Aces and Sevens)
clovvnfiesta: shows [Qc Ac] (two pair, Queens and Sevens)
griffinxblack collected $10.77 from pot
*** SUMMARY ***
Total pot $11.34 | Rake $0.57 
Board [7h 3c Qd 7c 5d]
Seat 1: wcb607a (button) folded before Flop (didn't bet)
Seat 2: griffinxblack (small blind) showed [Ah As] and won ($10.77) with two pair, Aces and Sevens
Seat 3: SuWasup (big blind) folded before Flop
Seat 4: clovvnfiesta showed [Qc Ac] and lost with two pair, Queens and Sevens
Seat 5: RiverbendAA folded before Flop (didn't bet)
Seat 6: PlayTheBlues4U folded before Flop (didn't bet)



PokerStars Hand #204445467664:  Hold'em No Limit ($0.05/$0.10 USD) - 2019/10/11 19:08:18 ET
Table 'Beatrix' 6-max Seat #2 is the button
Seat 1: wcb607a ($10.31 in chips) 
Seat 2: griffinxblack ($10.80 in chips) 
Seat 3: SuWasup ($7.91 in chips) 
Seat 5: RiverbendAA ($10 in chips) 
Seat 6: PlayTheBlues4U ($9.27 in chips) 
SuWasup: posts small blind $0.05
RiverbendAA: posts big blind $0.10
*** HOLE CARDS ***
Dealt to PlayTheBlues4U [8s Jh]
PlayTheBlues4U: folds 
clovvnfiesta leaves the table
wcb607a: folds 
griffinxblack: raises $0.20 to $0.30
SuWasup: folds 
RiverbendAA: folds 
Uncalled bet ($0.20) returned to griffinxblack
griffinxblack collected $0.25 from pot
griffinxblack: doesn't show hand 
*** SUMMARY ***
Total pot $0.25 | Rake $0 
Seat 1: wcb607a folded before Flop (didn't bet)
Seat 2: griffinxblack (button) collected ($0.25)
Seat 3: SuWasup (small blind) folded before Flop
Seat 5: RiverbendAA (big blind) folded before Flop
Seat 6: PlayTheBlues4U folded before Flop (didn't bet)



PokerStars Hand #204445467722:  Hold'em No Limit ($0.05/$0.10 USD) - 2019/10/11 19:08:45 ET
Table 'Beatrix' 6-max Seat #3 is the button
Seat 1: wcb607a ($10.31 in chips) 
Seat 2: griffinxblack ($10.95 in chips) 
Seat 3: SuWasup ($7.86 in chips) 
Seat 5: RiverbendAA ($10 in chips) 
Seat 6: PlayTheBlues4U ($9.27 in chips) 
RiverbendAA: posts small blind $0.05
PlayTheBlues4U: posts big blind $0.10
*** HOLE CARDS ***
Dealt to PlayTheBlues4U [Kc 5d]
wcb607a: folds 
griffinxblack: raises $0.20 to $0.30
SuWasup: folds 
RiverbendAA: folds 
PlayTheBlues4U: folds 
Uncalled bet ($0.20) returned to griffinxblack
griffinxblack collected $0.25 from pot
griffinxblack: doesn't show hand 
*** SUMMARY ***
Total pot $0.25 | Rake $0 
Seat 1: wcb607a folded before Flop (didn't bet)
Seat 2: griffinxblack collected ($0.25)
Seat 3: SuWasup (button) folded before Flop (didn't bet)
Seat 5: RiverbendAA (small blind) folded before Flop
Seat 6: PlayTheBlues4U (big blind) folded before Flop



PokerStars Hand #204445467755:  Hold'em No Limit ($0.05/$0.10 USD) - 2019/10/11 19:09:02 ET
Table 'Beatrix' 6-max Seat #5 is the button
Seat 1: wcb607a ($10.31 in chips) 
Seat 2: griffinxblack ($11.10 in chips) 
Seat 3: SuWasup ($7.86 in chips) 
Seat 5: RiverbendAA ($10 in chips) 
Seat 6: PlayTheBlues4U ($9.17 in chips) 
PlayTheBlues4U: posts small blind $0.05
wcb607a: posts big blind $0.10
*** HOLE CARDS ***
Dealt to PlayTheBlues4U [Ts Ad]
griffinxblack: folds 
SuWasup: folds 
RiverbendAA: raises $0.25 to $0.35
PlayTheBlues4U: calls $0.30
wcb607a: folds 
*** FLOP *** [4d Tc 6h]
PlayTheBlues4U: bets $0.60
RiverbendAA: calls $0.60
*** TURN *** [4d Tc 6h] [Qc]
PlayTheBlues4U: checks 
RiverbendAA: bets $1.27
PlayTheBlues4U: calls $1.27
*** RIVER *** [4d Tc 6h Qc] [2h]
PlayTheBlues4U: checks 
RiverbendAA: bets $2.20
PlayTheBlues4U: calls $2.20
*** SHOW DOWN ***
RiverbendAA: shows [Td Qs] (two pair, Queens and Tens)
PlayTheBlues4U: mucks hand 
RiverbendAA collected $8.49 from pot
*** SUMMARY ***
Total pot $8.94 | Rake $0.45 
Board [4d Tc 6h Qc 2h]
Seat 1: wcb607a (big blind) folded before Flop
Seat 2: griffinxblack folded before Flop (didn't bet)
Seat 3: SuWasup folded before Flop (didn't bet)
Seat 5: RiverbendAA (button) showed [Td Qs] and won ($8.49) with two pair, Queens and Tens
Seat 6: PlayTheBlues4U (small blind) mucked [Ts Ad]



PokerStars Hand #204445467894:  Hold'em No Limit ($0.05/$0.10 USD) - 2019/10/11 19:10:22 ET
Table 'Beatrix' 6-max Seat #6 is the button
Seat 1: wcb607a ($10.21 in chips) 
Seat 2: griffinxblack ($11.10 in chips) 
Seat 3: SuWasup ($7.86 in chips) 
Seat 5: RiverbendAA ($14.07 in chips) 
Seat 6: PlayTheBlues4U ($4.75 in chips) 
wcb607a: posts small blind $0.05
griffinxblack: posts big blind $0.10
*** HOLE CARDS ***
Dealt to PlayTheBlues4U [5h 9d]
SuWasup: raises $0.20 to $0.30
RiverbendAA: folds 
PlayTheBlues4U: folds 
wcb607a: folds 
griffinxblack: folds 
Uncalled bet ($0.20) returned to SuWasup
SuWasup collected $0.25 from pot
SuWasup: doesn't show hand 
*** SUMMARY ***
Total pot $0.25 | Rake $0 
Seat 1: wcb607a (small blind) folded before Flop
Seat 2: griffinxblack (big blind) folded before Flop
Seat 3: SuWasup collected ($0.25)
Seat 5: RiverbendAA folded before Flop (didn't bet)
Seat 6: PlayTheBlues4U (button) folded before Flop (didn't bet)



PokerStars Hand #204445467932:  Hold'em No Limit ($0.05/$0.10 USD) - 2019/10/11 19:10:41 ET
Table 'Beatrix' 6-max Seat #1 is the button
Seat 1: wcb607a ($10.16 in chips) 
Seat 2: griffinxblack ($11 in chips) 
Seat 3: SuWasup ($8.01 in chips) 
Seat 5: RiverbendAA ($14.07 in chips) 
Seat 6: PlayTheBlues4U ($10 in chips) 
griffinxblack: posts small blind $0.05
SuWasup: posts big blind $0.10
*** HOLE CARDS ***
Dealt to PlayTheBlues4U [Qh 6h]
RiverbendAA: folds 
PlayTheBlues4U: folds 
wcb607a: folds 
griffinxblack: raises $0.20 to $0.30
SuWasup: raises $0.60 to $0.90
griffinxblack: calls $0.60
*** FLOP *** [7s 6s Td]
griffinxblack: checks 
SuWasup: checks 
*** TURN *** [7s 6s Td] [7c]
griffinxblack: checks 
SuWasup: bets $0.90
griffinxblack: calls $0.90
*** RIVER *** [7s 6s Td 7c] [3d]
griffinxblack: checks 
SuWasup: checks 
*** SHOW DOWN ***
griffinxblack: shows [8h 8c] (two pair, Eights and Sevens)
SuWasup: mucks hand 
griffinxblack collected $3.42 from pot
*** SUMMARY ***
Total pot $3.60 | Rake $0.18 
Board [7s 6s Td 7c 3d]
Seat 1: wcb607a (button) folded before Flop (didn't bet)
Seat 2: griffinxblack (small blind) showed [8h 8c] and won ($3.42) with two pair, Eights and Sevens
Seat 3: SuWasup (big blind) mucked [Ac 4s]
Seat 5: RiverbendAA folded before Flop (didn't bet)
Seat 6: PlayTheBlues4U folded before Flop (didn't bet)



PokerStars Hand #204445468050:  Hold'em No Limit ($0.05/$0.10 USD) - 2019/10/11 19:11:39 ET
Table 'Beatrix' 6-max Seat #2 is the button
Seat 1: wcb607a ($10.16 in chips) 
Seat 2: griffinxblack ($12.62 in chips) 
Seat 3: SuWasup ($6.21 in chips) 
Seat 5: RiverbendAA ($14.07 in chips) 
Seat 6: PlayTheBlues4U ($10 in chips) 
SuWasup: posts small blind $0.05
RiverbendAA: posts big blind $0.10
*** HOLE CARDS ***
Dealt to PlayTheBlues4U [Kc 7h]
PlayTheBlues4U: folds 
wcb607a: folds 
griffinxblack: raises $0.10 to $0.20
SuWasup: folds 
RiverbendAA: folds 
Uncalled bet ($0.10) returned to griffinxblack
griffinxblack collected $0.25 from pot
griffinxblack: doesn't show hand 
*** SUMMARY ***
Total pot $0.25 | Rake $0 
Seat 1: wcb607a folded before Flop (didn't bet)
Seat 2: griffinxblack (button) collected ($0.25)
Seat 3: SuWasup (small blind) folded before Flop
Seat 5: RiverbendAA (big blind) folded before Flop
Seat 6: PlayTheBlues4U folded before Flop (didn't bet)



PokerStars Hand #204445468083:  Hold'em No Limit ($0.05/$0.10 USD) - 2019/10/11 19:11:55 ET
Table 'Beatrix' 6-max Seat #3 is the button
Seat 1: wcb607a ($10.16 in chips) 
Seat 2: griffinxblack ($12.77 in chips) 
Seat 3: SuWasup ($6.16 in chips) 
Seat 5: RiverbendAA ($13.97 in chips) 
Seat 6: PlayTheBlues4U ($10 in chips) 
RiverbendAA: posts small blind $0.05
PlayTheBlues4U: posts big blind $0.10
*** HOLE CARDS ***
Dealt to PlayTheBlues4U [Js 4d]
wcb607a: folds 
griffinxblack: raises $0.20 to $0.30
SuWasup: folds 
RiverbendAA: folds 
PlayTheBlues4U: folds 
Uncalled bet ($0.20) returned to griffinxblack
griffinxblack collected $0.25 from pot
griffinxblack: doesn't show hand 
*** SUMMARY ***
Total pot $0.25 | Rake $0 
Seat 1: wcb607a folded before Flop (didn't bet)
Seat 2: griffinxblack collected ($0.25)
Seat 3: SuWasup (button) folded before Flop (didn't bet)
Seat 5: RiverbendAA (small blind) folded before Flop
Seat 6: PlayTheBlues4U (big blind) folded before Flop



PokerStars Hand #204445468108:  Hold'em No Limit ($0.05/$0.10 USD) - 2019/10/11 19:12:05 ET
Table 'Beatrix' 6-max Seat #5 is the button
Seat 1: wcb607a ($10.16 in chips) 
Seat 2: griffinxblack ($12.92 in chips) 
Seat 3: SuWasup ($6.16 in chips) 
Seat 5: RiverbendAA ($13.92 in chips) 
Seat 6: PlayTheBlues4U ($9.90 in chips) 
PlayTheBlues4U: posts small blind $0.05
wcb607a: posts big blind $0.10
*** HOLE CARDS ***
Dealt to PlayTheBlues4U [As 7s]
griffinxblack: raises $0.20 to $0.30
SuWasup: raises $0.60 to $0.90
RiverbendAA: folds 
PlayTheBlues4U: folds 
wcb607a: folds 
griffinxblack: calls $0.60
*** FLOP *** [4c 4h 3c]
griffinxblack: checks 
SuWasup: bets $0.90
griffinxblack: folds 
Uncalled bet ($0.90) returned to SuWasup
SuWasup collected $1.85 from pot
SuWasup: doesn't show hand 
*** SUMMARY ***
Total pot $1.95 | Rake $0.10 
Board [4c 4h 3c]
Seat 1: wcb607a (big blind) folded before Flop
Seat 2: griffinxblack folded on the Flop
Seat 3: SuWasup collected ($1.85)
Seat 5: RiverbendAA (button) folded before Flop (didn't bet)
Seat 6: PlayTheBlues4U (small blind) folded before Flop



PokerStars Hand #204445468163:  Hold'em No Limit ($0.05/$0.10 USD) - 2019/10/11 19:12:34 ET
Table 'Beatrix' 6-max Seat #6 is the button
Seat 1: wcb607a ($10.06 in chips) 
Seat 2: griffinxblack ($12.02 in chips) 
Seat 3: SuWasup ($7.11 in chips) 
Seat 5: RiverbendAA ($13.92 in chips) 
Seat 6: PlayTheBlues4U ($9.85 in chips) 
wcb607a: posts small blind $0.05
griffinxblack: posts big blind $0.10
*** HOLE CARDS ***
Dealt to PlayTheBlues4U [Th 4d]
SuWasup: folds 
RiverbendAA: folds 
PlayTheBlues4U: folds 
wcb607a: folds 
Uncalled bet ($0.05) returned to griffinxblack
griffinxblack collected $0.10 from pot
griffinxblack: doesn't show hand 
*** SUMMARY ***
Total pot $0.10 | Rake $0 
Seat 1: wcb607a (small blind) folded before Flop
Seat 2: griffinxblack (big blind) collected ($0.10)
Seat 3: SuWasup folded before Flop (didn't bet)
Seat 5: RiverbendAA folded before Flop (didn't bet)
Seat 6: PlayTheBlues4U (button) folded before Flop (didn't bet)



PokerStars Hand #204445468195:  Hold'em No Limit ($0.05/$0.10 USD) - 2019/10/11 19:12:47 ET
Table 'Beatrix' 6-max Seat #1 is the button
Seat 1: wcb607a ($10.01 in chips) 
Seat 2: griffinxblack ($12.07 in chips) 
Seat 3: SuWasup ($7.11 in chips) 
Seat 5: RiverbendAA ($13.92 in chips) 
Seat 6: PlayTheBlues4U ($9.85 in chips) 
griffinxblack: posts small blind $0.05
SuWasup: posts big blind $0.10
*** HOLE CARDS ***
Dealt to PlayTheBlues4U [Ah Kd]
RiverbendAA: raises $0.25 to $0.35
PlayTheBlues4U: raises $0.55 to $0.90
wcb607a: folds 
griffinxblack: folds 
SuWasup: folds 
RiverbendAA: folds 
Uncalled bet ($0.55) returned to PlayTheBlues4U
PlayTheBlues4U collected $0.85 from pot
PlayTheBlues4U: doesn't show hand 
*** SUMMARY ***
Total pot $0.85 | Rake $0 
Seat 1: wcb607a (button) folded before Flop (didn't bet)
Seat 2: griffinxblack (small blind) folded before Flop
Seat 3: SuWasup (big blind) folded before Flop
Seat 5: RiverbendAA folded before Flop
Seat 6: PlayTheBlues4U collected ($0.85)



PokerStars Hand #204445468240:  Hold'em No Limit ($0.05/$0.10 USD) - 2019/10/11 19:13:16 ET
Table 'Beatrix' 6-max Seat #2 is the button
Seat 1: wcb607a ($10.01 in chips) 
Seat 2: griffinxblack ($12.02 in chips) 
Seat 3: SuWasup ($7.01 in chips) 
Seat 5: RiverbendAA ($13.57 in chips) 
Seat 6: PlayTheBlues4U ($10.35 in chips) 
SuWasup: posts small blind $0.05
RiverbendAA: posts big blind $0.10
*** HOLE CARDS ***
Dealt to PlayTheBlues4U [6h 4h]
PlayTheBlues4U: folds 
wcb607a: folds 
griffinxblack: folds 
SuWasup: raises $0.20 to $0.30
RiverbendAA: calls $0.20
*** FLOP *** [Ah 7c 9h]
SuWasup: bets $0.35
RiverbendAA: folds 
Uncalled bet ($0.35) returned to SuWasup
SuWasup collected $0.57 from pot
SuWasup: doesn't show hand 
*** SUMMARY ***
Total pot $0.60 | Rake $0.03 
Board [Ah 7c 9h]
Seat 1: wcb607a folded before Flop (didn't bet)
Seat 2: griffinxblack (button) folded before Flop (didn't bet)
Seat 3: SuWasup (small blind) collected ($0.57)
Seat 5: RiverbendAA (big blind) folded on the Flop
Seat 6: PlayTheBlues4U folded before Flop (didn't bet)



PokerStars Hand #204445468324:  Hold'em No Limit ($0.05/$0.10 USD) - 2019/10/11 19:13:57 ET
Table 'Beatrix' 6-max Seat #3 is the button
Seat 1: wcb607a ($10.01 in chips) 
Seat 2: griffinxblack ($12.02 in chips) 
Seat 3: SuWasup ($7.28 in chips) 
Seat 5: RiverbendAA ($13.27 in chips) 
Seat 6: PlayTheBlues4U ($10.35 in chips) 
RiverbendAA: posts small blind $0.05
PlayTheBlues4U: posts big blind $0.10
*** HOLE CARDS ***
Dealt to PlayTheBlues4U [4s 7c]
wcb607a: folds 
griffinxblack: raises $0.20 to $0.30
SuWasup: raises $0.60 to $0.90
RiverbendAA: folds 
PlayTheBlues4U: folds 
griffinxblack: folds 
Uncalled bet ($0.60) returned to SuWasup
SuWasup collected $0.75 from pot
SuWasup: doesn't show hand 
*** SUMMARY ***
Total pot $0.75 | Rake $0 
Seat 1: wcb607a folded before Flop (didn't bet)
Seat 2: griffinxblack folded before Flop
Seat 3: SuWasup (button) collected ($0.75)
Seat 5: RiverbendAA (small blind) folded before Flop
Seat 6: PlayTheBlues4U (big blind) folded before Flop



PokerStars Hand #204445468371:  Hold'em No Limit ($0.05/$0.10 USD) - 2019/10/11 19:14:22 ET
Table 'Beatrix' 6-max Seat #5 is the button
Seat 1: wcb607a ($10.01 in chips) 
Seat 2: griffinxblack ($11.72 in chips) 
Seat 3: SuWasup ($7.73 in chips) 
Seat 5: RiverbendAA ($13.22 in chips) 
Seat 6: PlayTheBlues4U ($10.25 in chips) 
PlayTheBlues4U: posts small blind $0.05
wcb607a: posts big blind $0.10
*** HOLE CARDS ***
Dealt to PlayTheBlues4U [2c Kd]
griffinxblack: raises $0.20 to $0.30
SuWasup: calls $0.30
RiverbendAA: calls $0.30
PlayTheBlues4U: folds 
wcb607a: calls $0.20
*** FLOP *** [6h Jd 5h]
wcb607a: checks 
griffinxblack: checks 
SuWasup: bets $0.60
RiverbendAA: folds 
wcb607a: folds 
griffinxblack: folds 
Uncalled bet ($0.60) returned to SuWasup
SuWasup collected $1.19 from pot
SuWasup: doesn't show hand 
*** SUMMARY ***
Total pot $1.25 | Rake $0.06 
Board [6h Jd 5h]
Seat 1: wcb607a (big blind) folded on the Flop
Seat 2: griffinxblack folded on the Flop
Seat 3: SuWasup collected ($1.19)
Seat 5: RiverbendAA (button) folded on the Flop
Seat 6: PlayTheBlues4U (small blind) folded before Flop



PokerStars Hand #204445468446:  Hold'em No Limit ($0.05/$0.10 USD) - 2019/10/11 19:15:00 ET
Table 'Beatrix' 6-max Seat #6 is the button
Seat 1: wcb607a ($9.71 in chips) 
Seat 2: griffinxblack ($11.42 in chips) 
Seat 3: SuWasup ($8.62 in chips) 
Seat 5: RiverbendAA ($12.92 in chips) 
Seat 6: PlayTheBlues4U ($10.20 in chips) 
wcb607a: posts small blind $0.05
griffinxblack: posts big blind $0.10
*** HOLE CARDS ***
Dealt to PlayTheBlues4U [8d 7d]
SuWasup: folds 
RiverbendAA: folds 
PlayTheBlues4U: raises $0.20 to $0.30
wcb607a: folds 
griffinxblack: folds 
Uncalled bet ($0.20) returned to PlayTheBlues4U
PlayTheBlues4U collected $0.25 from pot
PlayTheBlues4U: doesn't show hand 
*** SUMMARY ***
Total pot $0.25 | Rake $0 
Seat 1: wcb607a (small blind) folded before Flop
Seat 2: griffinxblack (big blind) folded before Flop
Seat 3: SuWasup folded before Flop (didn't bet)
Seat 5: RiverbendAA folded before Flop (didn't bet)
Seat 6: PlayTheBlues4U (button) collected ($0.25)



PokerStars Hand #204445468495:  Hold'em No Limit ($0.05/$0.10 USD) - 2019/10/11 19:15:23 ET
Table 'Beatrix' 6-max Seat #1 is the button
Seat 1: wcb607a ($9.66 in chips) 
Seat 2: griffinxblack ($11.32 in chips) 
Seat 3: SuWasup ($8.62 in chips) 
Seat 5: RiverbendAA ($12.92 in chips) 
Seat 6: PlayTheBlues4U ($10.35 in chips) 
griffinxblack: posts small blind $0.05
SuWasup: posts big blind $0.10
*** HOLE CARDS ***
Dealt to PlayTheBlues4U [5h 5c]
RiverbendAA: folds 
PlayTheBlues4U: folds 
wcb607a: raises $0.20 to $0.30
griffinxblack: folds 
SuWasup: calls $0.20
*** FLOP *** [Tc 3s 8c]
SuWasup: checks 
wcb607a: checks 
*** TURN *** [Tc 3s 8c] [3d]
SuWasup: bets $0.35
wcb607a: folds 
Uncalled bet ($0.35) returned to SuWasup
SuWasup collected $0.62 from pot
SuWasup: doesn't show hand 
*** SUMMARY ***
Total pot $0.65 | Rake $0.03 
Board [Tc 3s 8c 3d]
Seat 1: wcb607a (button) folded on the Turn
Seat 2: griffinxblack (small blind) folded before Flop
Seat 3: SuWasup (big blind) collected ($0.62)
Seat 5: RiverbendAA folded before Flop (didn't bet)
Seat 6: PlayTheBlues4U folded before Flop (didn't bet)



PokerStars Hand #204445468575:  Hold'em No Limit ($0.05/$0.10 USD) - 2019/10/11 19:16:03 ET
Table 'Beatrix' 6-max Seat #2 is the button
Seat 1: wcb607a ($9.36 in chips) 
Seat 2: griffinxblack ($11.27 in chips) 
Seat 3: SuWasup ($8.94 in chips) 
Seat 5: RiverbendAA ($12.92 in chips) 
Seat 6: PlayTheBlues4U ($10.35 in chips) 
SuWasup: posts small blind $0.05
RiverbendAA: posts big blind $0.10
*** HOLE CARDS ***
Dealt to PlayTheBlues4U [Kc 2d]
PlayTheBlues4U: folds 
wcb607a: folds 
griffinxblack: raises $0.25 to $0.35
SuWasup: folds 
RiverbendAA: calls $0.25
*** FLOP *** [4c As 8s]
RiverbendAA: checks 
griffinxblack: bets $0.36
RiverbendAA: folds 
Uncalled bet ($0.36) returned to griffinxblack
griffinxblack collected $0.71 from pot
griffinxblack: doesn't show hand 
*** SUMMARY ***
Total pot $0.75 | Rake $0.04 
Board [4c As 8s]
Seat 1: wcb607a folded before Flop (didn't bet)
Seat 2: griffinxblack (button) collected ($0.71)
Seat 3: SuWasup (small blind) folded before Flop
Seat 5: RiverbendAA (big blind) folded on the Flop
Seat 6: PlayTheBlues4U folded before Flop (didn't bet)



PokerStars Hand #204445468671:  Hold'em No Limit ($0.05/$0.10 USD) - 2019/10/11 19:16:57 ET
Table 'Beatrix' 6-max Seat #3 is the button
Seat 1: wcb607a ($9.36 in chips) 
Seat 2: griffinxblack ($11.63 in chips) 
Seat 3: SuWasup ($8.89 in chips) 
Seat 5: RiverbendAA ($12.57 in chips) 
Seat 6: PlayTheBlues4U ($10.35 in chips) 
RiverbendAA: posts small blind $0.05
PlayTheBlues4U: posts big blind $0.10
*** HOLE CARDS ***
Dealt to PlayTheBlues4U [Ah Jh]
wcb607a: folds 
griffinxblack: folds 
SuWasup: raises $0.20 to $0.30
RiverbendAA: folds 
PlayTheBlues4U: raises $0.50 to $0.80
SuWasup: calls $0.50
*** FLOP *** [8c Ac Qd]
PlayTheBlues4U: bets $0.90
SuWasup: folds 
Uncalled bet ($0.90) returned to PlayTheBlues4U
PlayTheBlues4U collected $1.57 from pot
PlayTheBlues4U: doesn't show hand 
*** SUMMARY ***
Total pot $1.65 | Rake $0.08 
Board [8c Ac Qd]
Seat 1: wcb607a folded before Flop (didn't bet)
Seat 2: griffinxblack folded before Flop (didn't bet)
Seat 3: SuWasup (button) folded on the Flop
Seat 5: RiverbendAA (small blind) folded before Flop
Seat 6: PlayTheBlues4U (big blind) collected ($1.57)



PokerStars Hand #204445468785:  Hold'em No Limit ($0.05/$0.10 USD) - 2019/10/11 19:17:58 ET
Table 'Beatrix' 6-max Seat #5 is the button
Seat 1: wcb607a ($9.36 in chips) 
Seat 2: griffinxblack ($11.63 in chips) 
Seat 3: SuWasup ($8.09 in chips) 
Seat 5: RiverbendAA ($12.52 in chips) 
Seat 6: PlayTheBlues4U ($11.12 in chips) 
PlayTheBlues4U: posts small blind $0.05
wcb607a: posts big blind $0.10
*** HOLE CARDS ***
Dealt to PlayTheBlues4U [Ts 7s]
griffinxblack: folds 
SuWasup: folds 
RiverbendAA: folds 
PlayTheBlues4U: raises $0.20 to $0.30
wcb607a: folds 
Uncalled bet ($0.20) returned to PlayTheBlues4U
PlayTheBlues4U collected $0.20 from pot
PlayTheBlues4U: doesn't show hand 
*** SUMMARY ***
Total pot $0.20 | Rake $0 
Seat 1: wcb607a (big blind) folded before Flop
Seat 2: griffinxblack folded before Flop (didn't bet)
Seat 3: SuWasup folded before Flop (didn't bet)
Seat 5: RiverbendAA (button) folded before Flop (didn't bet)
Seat 6: PlayTheBlues4U (small blind) collected ($0.20)



PokerStars Hand #204445468832:  Hold'em No Limit ($0.05/$0.10 USD) - 2019/10/11 19:18:20 ET
Table 'Beatrix' 6-max Seat #6 is the button
Seat 1: wcb607a ($9.26 in chips) 
Seat 3: SuWasup ($8.09 in chips) 
Seat 5: RiverbendAA ($12.52 in chips) 
Seat 6: PlayTheBlues4U ($11.22 in chips) 
wcb607a: posts small blind $0.05
griffinxblack: is sitting out 
SuWasup: posts big blind $0.10
*** HOLE CARDS ***
Dealt to PlayTheBlues4U [7d 8d]
RiverbendAA: raises $0.25 to $0.35
PlayTheBlues4U: calls $0.35
wcb607a: folds 
SuWasup: folds 
*** FLOP *** [3h Td 6s]
RiverbendAA: bets $0.41
PlayTheBlues4U: calls $0.41
*** TURN *** [3h Td 6s] [4c]
RiverbendAA: checks 
PlayTheBlues4U: bets $1.10
RiverbendAA: folds 
Uncalled bet ($1.10) returned to PlayTheBlues4U
PlayTheBlues4U collected $1.59 from pot
PlayTheBlues4U: doesn't show hand 
*** SUMMARY ***
Total pot $1.67 | Rake $0.08 
Board [3h Td 6s 4c]
Seat 1: wcb607a (small blind) folded before Flop
Seat 3: SuWasup (big blind) folded before Flop
Seat 5: RiverbendAA folded on the Turn
Seat 6: PlayTheBlues4U (button) collected ($1.59)



PokerStars Hand #204445468940:  Hold'em No Limit ($0.05/$0.10 USD) - 2019/10/11 19:19:08 ET
Table 'Beatrix' 6-max Seat #1 is the button
Seat 1: wcb607a ($9.21 in chips) 
Seat 3: SuWasup ($7.99 in chips) 
Seat 5: RiverbendAA ($11.76 in chips) 
Seat 6: PlayTheBlues4U ($12.05 in chips) 
SuWasup: posts small blind $0.05
RiverbendAA: posts big blind $0.10
*** HOLE CARDS ***
Dealt to PlayTheBlues4U [9h 5d]
PlayTheBlues4U: folds 
wcb607a: raises $0.20 to $0.30
SuWasup: folds 
RiverbendAA: folds 
Uncalled bet ($0.20) returned to wcb607a
wcb607a collected $0.25 from pot
wcb607a: doesn't show hand 
*** SUMMARY ***
Total pot $0.25 | Rake $0 
Seat 1: wcb607a (button) collected ($0.25)
Seat 3: SuWasup (small blind) folded before Flop
Seat 5: RiverbendAA (big blind) folded before Flop
Seat 6: PlayTheBlues4U folded before Flop (didn't bet)



PokerStars Hand #204445468968:  Hold'em No Limit ($0.05/$0.10 USD) - 2019/10/11 19:19:23 ET
Table 'Beatrix' 6-max Seat #3 is the button
Seat 1: wcb607a ($9.36 in chips) 
Seat 3: SuWasup ($7.94 in chips) 
Seat 5: RiverbendAA ($11.66 in chips) 
Seat 6: PlayTheBlues4U ($12.05 in chips) 
RiverbendAA: posts small blind $0.05
PlayTheBlues4U: posts big blind $0.10
*** HOLE CARDS ***
Dealt to PlayTheBlues4U [5h 3h]
wcb607a: raises $0.20 to $0.30
SuWasup: folds 
RiverbendAA: folds 
PlayTheBlues4U: folds 
Uncalled bet ($0.20) returned to wcb607a
wcb607a collected $0.25 from pot
wcb607a: doesn't show hand 
*** SUMMARY ***
Total pot $0.25 | Rake $0 
Seat 1: wcb607a collected ($0.25)
Seat 3: SuWasup (button) folded before Flop (didn't bet)
Seat 5: RiverbendAA (small blind) folded before Flop
Seat 6: PlayTheBlues4U (big blind) folded before Flop



PokerStars Hand #204445469013:  Hold'em No Limit ($0.05/$0.10 USD) - 2019/10/11 19:19:44 ET
Table 'Beatrix' 6-max Seat #5 is the button
Seat 1: wcb607a ($9.51 in chips) 
Seat 3: SuWasup ($7.94 in chips) 
Seat 5: RiverbendAA ($11.61 in chips) 
Seat 6: PlayTheBlues4U ($11.95 in chips) 
PlayTheBlues4U: posts small blind $0.05
wcb607a: posts big blind $0.10
*** HOLE CARDS ***
Dealt to PlayTheBlues4U [8s 7d]
SuWasup: raises $0.20 to $0.30
RiverbendAA: raises $0.60 to $0.90
PlayTheBlues4U: folds 
wcb607a: folds 
SuWasup: folds 
Uncalled bet ($0.60) returned to RiverbendAA
RiverbendAA collected $0.75 from pot
RiverbendAA: doesn't show hand 
*** SUMMARY ***
Total pot $0.75 | Rake $0 
Seat 1: wcb607a (big blind) folded before Flop
Seat 3: SuWasup folded before Flop
Seat 5: RiverbendAA (button) collected ($0.75)
Seat 6: PlayTheBlues4U (small blind) folded before Flop



PokerStars Hand #204445469039:  Hold'em No Limit ($0.05/$0.10 USD) - 2019/10/11 19:19:59 ET
Table 'Beatrix' 6-max Seat #6 is the button
Seat 1: wcb607a ($9.41 in chips) 
Seat 3: SuWasup ($7.64 in chips) 
Seat 5: RiverbendAA ($12.06 in chips) 
Seat 6: PlayTheBlues4U ($11.90 in chips) 
wcb607a: posts small blind $0.05
SuWasup: posts big blind $0.10
*** HOLE CARDS ***
Dealt to PlayTheBlues4U [8c Qs]
RiverbendAA: folds 
PlayTheBlues4U: folds 
wcb607a: folds 
Uncalled bet ($0.05) returned to SuWasup
SuWasup collected $0.10 from pot
SuWasup: doesn't show hand 
*** SUMMARY ***
Total pot $0.10 | Rake $0 
Seat 1: wcb607a (small blind) folded before Flop
Seat 3: SuWasup (big blind) collected ($0.10)
Seat 5: RiverbendAA folded before Flop (didn't bet)
Seat 6: PlayTheBlues4U (button) folded before Flop (didn't bet)



PokerStars Hand #204445469105:  Hold'em No Limit ($0.05/$0.10 USD) - 2019/10/11 19:20:27 ET
Table 'Beatrix' 6-max Seat #1 is the button
Seat 1: wcb607a ($9.36 in chips) 
Seat 3: SuWasup ($7.69 in chips) 
Seat 5: RiverbendAA ($12.06 in chips) 
Seat 6: PlayTheBlues4U ($11.90 in chips) 
SuWasup: posts small blind $0.05
RiverbendAA: posts big blind $0.10
*** HOLE CARDS ***
Dealt to PlayTheBlues4U [6s Ad]
PlayTheBlues4U: raises $0.15 to $0.25
wcb607a: folds 
SuWasup: folds 
RiverbendAA: folds 
Uncalled bet ($0.15) returned to PlayTheBlues4U
PlayTheBlues4U collected $0.25 from pot
PlayTheBlues4U: doesn't show hand 
*** SUMMARY ***
Total pot $0.25 | Rake $0 
Seat 1: wcb607a (button) folded before Flop (didn't bet)
Seat 3: SuWasup (small blind) folded before Flop
Seat 5: RiverbendAA (big blind) folded before Flop
Seat 6: PlayTheBlues4U collected ($0.25)



PokerStars Hand #204445469143:  Hold'em No Limit ($0.05/$0.10 USD) - 2019/10/11 19:20:46 ET
Table 'Beatrix' 6-max Seat #3 is the button
Seat 1: wcb607a ($9.36 in chips) 
Seat 3: SuWasup ($7.64 in chips) 
Seat 5: RiverbendAA ($11.96 in chips) 
Seat 6: PlayTheBlues4U ($12.05 in chips) 
RiverbendAA: posts small blind $0.05
PlayTheBlues4U: posts big blind $0.10
griffinxblack: sits out 
*** HOLE CARDS ***
Dealt to PlayTheBlues4U [4h 8h]
wcb607a: folds 
SuWasup: raises $0.20 to $0.30
RiverbendAA: raises $0.60 to $0.90
PlayTheBlues4U: folds 
SuWasup: calls $0.60
*** FLOP *** [2c 8c Kc]
boxerpupp727 joins the table at seat #4 
RiverbendAA: bets $0.90
SuWasup: raises $3.60 to $4.50
RiverbendAA: folds 
Uncalled bet ($3.60) returned to SuWasup
SuWasup collected $3.52 from pot
SuWasup: doesn't show hand 
*** SUMMARY ***
Total pot $3.70 | Rake $0.18 
Board [2c 8c Kc]
Seat 1: wcb607a folded before Flop (didn't bet)
Seat 3: SuWasup (button) collected ($3.52)
Seat 5: RiverbendAA (small blind) folded on the Flop
Seat 6: PlayTheBlues4U (big blind) folded before Flop



PokerStars Hand #204445469224:  Hold'em No Limit ($0.05/$0.10 USD) - 2019/10/11 19:21:31 ET
Table 'Beatrix' 6-max Seat #5 is the button
Seat 1: wcb607a ($9.36 in chips) 
Seat 3: SuWasup ($9.36 in chips) 
Seat 5: RiverbendAA ($10.16 in chips) 
Seat 6: PlayTheBlues4U ($11.95 in chips) 
PlayTheBlues4U: posts small blind $0.05
wcb607a: posts big blind $0.10
griffinxblack: sits out 
boxerpupp727: sits out 
*** HOLE CARDS ***
Dealt to PlayTheBlues4U [2c 3c]
SuWasup: raises $0.20 to $0.30
RiverbendAA: folds 
PlayTheBlues4U: folds 
wcb607a: folds 
Uncalled bet ($0.20) returned to SuWasup
SuWasup collected $0.25 from pot
SuWasup: doesn't show hand 
*** SUMMARY ***
Total pot $0.25 | Rake $0 
Seat 1: wcb607a (big blind) folded before Flop
Seat 3: SuWasup collected ($0.25)
Seat 5: RiverbendAA (button) folded before Flop (didn't bet)
Seat 6: PlayTheBlues4U (small blind) folded before Flop



PokerStars Hand #204445469249:  Hold'em No Limit ($0.05/$0.10 USD) - 2019/10/11 19:21:42 ET
Table 'Beatrix' 6-max Seat #6 is the button
Seat 1: wcb607a ($9.26 in chips) 
Seat 2: griffinxblack ($11.63 in chips) 
Seat 3: SuWasup ($9.51 in chips) 
Seat 4: boxerpupp727 ($10 in chips) 
Seat 5: RiverbendAA ($10.16 in chips) 
Seat 6: PlayTheBlues4U ($11.90 in chips) 
wcb607a: posts small blind $0.05
griffinxblack: posts big blind $0.10
boxerpupp727: posts big blind $0.10
*** HOLE CARDS ***
Dealt to PlayTheBlues4U [5h 9s]
SuWasup: raises $0.20 to $0.30
boxerpupp727: calls $0.20
RiverbendAA: folds 
PlayTheBlues4U: folds 
wcb607a: folds 
griffinxblack: calls $0.20
*** FLOP *** [Kd Jd Ac]
griffinxblack: checks 
SuWasup: bets $0.55
boxerpupp727: folds 
griffinxblack: folds 
Uncalled bet ($0.55) returned to SuWasup
SuWasup collected $0.90 from pot
SuWasup: doesn't show hand 
*** SUMMARY ***
Total pot $0.95 | Rake $0.05 
Board [Kd Jd Ac]
Seat 1: wcb607a (small blind) folded before Flop
Seat 2: griffinxblack (big blind) folded on the Flop
Seat 3: SuWasup collected ($0.90)
Seat 4: boxerpupp727 folded on the Flop
Seat 5: RiverbendAA folded before Flop (didn't bet)
Seat 6: PlayTheBlues4U (button) folded before Flop (didn't bet)



PokerStars Hand #204445469375:  Hold'em No Limit ($0.05/$0.10 USD) - 2019/10/11 19:22:46 ET
Table 'Beatrix' 6-max Seat #1 is the button
Seat 1: wcb607a ($9.21 in chips) 
Seat 2: griffinxblack ($11.33 in chips) 
Seat 3: SuWasup ($10.11 in chips) 
Seat 4: boxerpupp727 ($9.70 in chips) 
Seat 5: RiverbendAA ($10.16 in chips) 
Seat 6: PlayTheBlues4U ($11.90 in chips) 
griffinxblack: posts small blind $0.05
SuWasup: posts big blind $0.10
*** HOLE CARDS ***
Dealt to PlayTheBlues4U [6h Kc]
boxerpupp727: calls $0.10
RiverbendAA: folds 
PlayTheBlues4U: folds 
wcb607a: calls $0.10
griffinxblack: calls $0.05
SuWasup: raises $0.30 to $0.40
boxerpupp727: calls $0.30
wcb607a: calls $0.30
griffinxblack: calls $0.30
*** FLOP *** [4s 3d Jd]
griffinxblack: checks 
SuWasup: checks 
boxerpupp727: checks 
wcb607a: bets $1
griffinxblack: folds 
SuWasup: folds 
boxerpupp727: calls $1
*** TURN *** [4s 3d Jd] [Qs]
boxerpupp727: checks 
wcb607a: bets $2
boxerpupp727: calls $2
*** RIVER *** [4s 3d Jd Qs] [8s]
boxerpupp727: checks 
wcb607a: bets $3.60
boxerpupp727: folds 
Uncalled bet ($3.60) returned to wcb607a
wcb607a collected $7.22 from pot
wcb607a: doesn't show hand 
*** SUMMARY ***
Total pot $7.60 | Rake $0.38 
Board [4s 3d Jd Qs 8s]
Seat 1: wcb607a (button) collected ($7.22)
Seat 2: griffinxblack (small blind) folded on the Flop
Seat 3: SuWasup (big blind) folded on the Flop
Seat 4: boxerpupp727 folded on the River
Seat 5: RiverbendAA folded before Flop (didn't bet)
Seat 6: PlayTheBlues4U folded before Flop (didn't bet)



PokerStars Hand #204445469637:  Hold'em No Limit ($0.05/$0.10 USD) - 2019/10/11 19:24:46 ET
Table 'Beatrix' 6-max Seat #2 is the button
Seat 1: wcb607a ($13.03 in chips) 
Seat 2: griffinxblack ($10.93 in chips) 
Seat 3: SuWasup ($9.71 in chips) 
Seat 4: boxerpupp727 ($10 in chips) 
Seat 5: RiverbendAA ($10.16 in chips) 
Seat 6: PlayTheBlues4U ($11.90 in chips) 
SuWasup: posts small blind $0.05
boxerpupp727: posts big blind $0.10
*** HOLE CARDS ***
Dealt to PlayTheBlues4U [8c 5d]
RiverbendAA: raises $0.25 to $0.35
PlayTheBlues4U: folds 
wcb607a: folds 
griffinxblack has timed out
griffinxblack: folds 
SuWasup: folds 
boxerpupp727: calls $0.25
*** FLOP *** [4c 5h Tc]
boxerpupp727: checks 
RiverbendAA: bets $0.50
boxerpupp727: raises $0.50 to $1
RiverbendAA: calls $0.50
*** TURN *** [4c 5h Tc] [2d]
boxerpupp727: checks 
RiverbendAA: checks 
*** RIVER *** [4c 5h Tc 2d] [4s]
boxerpupp727: checks 
RiverbendAA: checks 
*** SHOW DOWN ***
boxerpupp727: shows [9h 9d] (two pair, Nines and Fours)
RiverbendAA: mucks hand 
boxerpupp727 collected $2.61 from pot
*** SUMMARY ***
Total pot $2.75 | Rake $0.14 
Board [4c 5h Tc 2d 4s]
Seat 1: wcb607a folded before Flop (didn't bet)
Seat 2: griffinxblack (button) folded before Flop (didn't bet)
Seat 3: SuWasup (small blind) folded before Flop
Seat 4: boxerpupp727 (big blind) showed [9h 9d] and won ($2.61) with two pair, Nines and Fours
Seat 5: RiverbendAA mucked [Kd Qs]
Seat 6: PlayTheBlues4U folded before Flop (didn't bet)



PokerStars Hand #204445469826:  Hold'em No Limit ($0.05/$0.10 USD) - 2019/10/11 19:26:02 ET
Table 'Beatrix' 6-max Seat #3 is the button
Seat 1: wcb607a ($13.03 in chips) 
Seat 3: SuWasup ($9.66 in chips) 
Seat 4: boxerpupp727 ($11.26 in chips) 
Seat 5: RiverbendAA ($10 in chips) 
Seat 6: PlayTheBlues4U ($11.90 in chips) 
boxerpupp727: posts small blind $0.05
RiverbendAA: posts big blind $0.10
*** HOLE CARDS ***
Dealt to PlayTheBlues4U [Kc 2h]
PlayTheBlues4U: folds 
wcb607a: folds 
SuWasup: raises $0.20 to $0.30
boxerpupp727: calls $0.25
RiverbendAA: folds 
*** FLOP *** [4d 3h 2s]
boxerpupp727: checks 
SuWasup: checks 
*** TURN *** [4d 3h 2s] [8c]
boxerpupp727: checks 
SuWasup: bets $0.40
boxerpupp727: calls $0.40
*** RIVER *** [4d 3h 2s 8c] [Ac]
boxerpupp727: checks 
SuWasup: checks 
*** SHOW DOWN ***
boxerpupp727: shows [8h Kh] (a pair of Eights)
SuWasup: mucks hand 
boxerpupp727 collected $1.42 from pot
*** SUMMARY ***
Total pot $1.50 | Rake $0.08 
Board [4d 3h 2s 8c Ac]
Seat 1: wcb607a folded before Flop (didn't bet)
Seat 3: SuWasup (button) mucked [8d 7s]
Seat 4: boxerpupp727 (small blind) showed [8h Kh] and won ($1.42) with a pair of Eights
Seat 5: RiverbendAA (big blind) folded before Flop
Seat 6: PlayTheBlues4U folded before Flop (didn't bet)



PokerStars Hand #204445469912:  Hold'em No Limit ($0.05/$0.10 USD) - 2019/10/11 19:26:42 ET
Table 'Beatrix' 6-max Seat #4 is the button
Seat 1: wcb607a ($13.03 in chips) 
Seat 3: SuWasup ($8.96 in chips) 
Seat 4: boxerpupp727 ($11.98 in chips) 
Seat 5: RiverbendAA ($10 in chips) 
Seat 6: PlayTheBlues4U ($11.90 in chips) 
RiverbendAA: posts small blind $0.05
PlayTheBlues4U: posts big blind $0.10
*** HOLE CARDS ***
Dealt to PlayTheBlues4U [7h Ts]
wcb607a: folds 
SuWasup: raises $0.20 to $0.30
boxerpupp727: folds 
RiverbendAA: folds 
PlayTheBlues4U: folds 
Uncalled bet ($0.20) returned to SuWasup
SuWasup collected $0.25 from pot
SuWasup: doesn't show hand 
*** SUMMARY ***
Total pot $0.25 | Rake $0 
Seat 1: wcb607a folded before Flop (didn't bet)
Seat 3: SuWasup collected ($0.25)
Seat 4: boxerpupp727 (button) folded before Flop (didn't bet)
Seat 5: RiverbendAA (small blind) folded before Flop
Seat 6: PlayTheBlues4U (big blind) folded before Flop



PokerStars Hand #204445469933:  Hold'em No Limit ($0.05/$0.10 USD) - 2019/10/11 19:26:53 ET
Table 'Beatrix' 6-max Seat #5 is the button
Seat 1: wcb607a ($13.03 in chips) 
Seat 3: SuWasup ($9.11 in chips) 
Seat 5: RiverbendAA ($10 in chips) 
Seat 6: PlayTheBlues4U ($11.80 in chips) 
PlayTheBlues4U: posts small blind $0.05
wcb607a: posts big blind $0.10
*** HOLE CARDS ***
Dealt to PlayTheBlues4U [8d 9h]
boxerpupp727 is disconnected 
SuWasup: folds 
RiverbendAA: folds 
PlayTheBlues4U: calls $0.05
wcb607a: checks 
*** FLOP *** [2s As 9s]
PlayTheBlues4U: checks 
wcb607a: checks 
*** TURN *** [2s As 9s] [3d]
PlayTheBlues4U: bets $0.10
boxerpupp727 leaves the table
wcb607a: folds 
Uncalled bet ($0.10) returned to PlayTheBlues4U
PlayTheBlues4U collected $0.19 from pot
PlayTheBlues4U: doesn't show hand 
*** SUMMARY ***
Total pot $0.20 | Rake $0.01 
Board [2s As 9s 3d]
Seat 1: wcb607a (big blind) folded on the Turn
Seat 3: SuWasup folded before Flop (didn't bet)
Seat 5: RiverbendAA (button) folded before Flop (didn't bet)
Seat 6: PlayTheBlues4U (small blind) collected ($0.19)



PokerStars Hand #204447288111:  Hold'em No Limit ($0.05/$0.10 USD) - 2019/10/11 19:27:29 ET
Table 'Beatrix' 6-max Seat #6 is the button
Seat 1: wcb607a ($12.93 in chips) 
Seat 2: griffinxblack ($10.93 in chips) 
Seat 3: SuWasup ($9.11 in chips) 
Seat 5: RiverbendAA ($10 in chips) 
Seat 6: PlayTheBlues4U ($11.89 in chips) 
wcb607a: posts small blind $0.05
griffinxblack: posts big blind $0.10
*** HOLE CARDS ***
Dealt to PlayTheBlues4U [9d 9h]
SuWasup: raises $0.20 to $0.30
RiverbendAA: folds 
PlayTheBlues4U: calls $0.30
wcb607a: raises $1.10 to $1.40
griffinxblack: folds 
SuWasup: folds 
PlayTheBlues4U: calls $1.10
*** FLOP *** [Kh Js 5s]
wcb607a: bets $1.40
PlayTheBlues4U: folds 
Uncalled bet ($1.40) returned to wcb607a
wcb607a collected $3.04 from pot
wcb607a: doesn't show hand 
*** SUMMARY ***
Total pot $3.20 | Rake $0.16 
Board [Kh Js 5s]
Seat 1: wcb607a (small blind) collected ($3.04)
Seat 2: griffinxblack (big blind) folded before Flop
Seat 3: SuWasup folded before Flop
Seat 5: RiverbendAA folded before Flop (didn't bet)
Seat 6: PlayTheBlues4U (button) folded on the Flop



PokerStars Hand #204447288239:  Hold'em No Limit ($0.05/$0.10 USD) - 2019/10/11 19:28:32 ET
Table 'Beatrix' 6-max Seat #1 is the button
Seat 1: wcb607a ($14.57 in chips) 
Seat 2: griffinxblack ($10.83 in chips) 
Seat 3: SuWasup ($8.81 in chips) 
Seat 5: RiverbendAA ($10 in chips) 
Seat 6: PlayTheBlues4U ($10.49 in chips) 
griffinxblack: posts small blind $0.05
SuWasup: posts big blind $0.10
*** HOLE CARDS ***
Dealt to PlayTheBlues4U [3d 7c]
RiverbendAA: raises $0.15 to $0.25
PlayTheBlues4U: folds 
wcb607a: raises $0.75 to $1
griffinxblack: raises $2.35 to $3.35
SuWasup: raises $5.46 to $8.81 and is all-in
RiverbendAA: folds 
wcb607a: raises $5.76 to $14.57 and is all-in
griffinxblack: calls $7.48 and is all-in
Uncalled bet ($3.74) returned to wcb607a
*** FLOP *** [7s Jc 4d]
*** TURN *** [7s Jc 4d] [Td]
*** RIVER *** [7s Jc 4d Td] [8h]
*** SHOW DOWN ***
griffinxblack: shows [Jh Jd] (three of a kind, Jacks)
wcb607a: shows [Ad Ac] (a pair of Aces)
SuWasup said, "lol"
griffinxblack collected $3.87 from side pot
SuWasup: shows [Ah As] (a pair of Aces)
griffinxblack collected $25.35 from main pot
*** SUMMARY ***
Total pot $30.72 Main pot $25.35. Side pot $3.87. | Rake $1.50 
Board [7s Jc 4d Td 8h]
Seat 1: wcb607a (button) showed [Ad Ac] and lost with a pair of Aces
Seat 2: griffinxblack (small blind) showed [Jh Jd] and won ($29.22) with three of a kind, Jacks
Seat 3: SuWasup (big blind) showed [Ah As] and lost with a pair of Aces
Seat 5: RiverbendAA folded before Flop
Seat 6: PlayTheBlues4U folded before Flop (didn't bet)



PokerStars Hand #204447288333:  Hold'em No Limit ($0.05/$0.10 USD) - 2019/10/11 19:29:22 ET
Table 'Beatrix' 6-max Seat #2 is the button
Seat 1: wcb607a ($3.74 in chips) 
Seat 2: griffinxblack ($29.22 in chips) 
Seat 5: RiverbendAA ($10 in chips) 
Seat 6: PlayTheBlues4U ($10.49 in chips) 
RiverbendAA: posts small blind $0.05
PlayTheBlues4U: posts big blind $0.10
*** HOLE CARDS ***
Dealt to PlayTheBlues4U [5h Kh]
PlayTheBlues4U said, "wow"
wcb607a: raises $0.20 to $0.30
SuWasup leaves the table
griffinxblack: calls $0.30
RiverbendAA: calls $0.25
PlayTheBlues4U: folds 
*** FLOP *** [3h Jd 7d]
RiverbendAA: checks 
wcb607a: checks 
griffinxblack: checks 
*** TURN *** [3h Jd 7d] [Td]
RiverbendAA: checks 
wcb607a: checks 
griffinxblack: checks 
*** RIVER *** [3h Jd 7d Td] [4c]
RiverbendAA: checks 
wcb607a: checks 
griffinxblack: checks 
*** SHOW DOWN ***
RiverbendAA: shows [As 5s] (high card Ace)
wcb607a: shows [Ac 8c] (high card Ace - Jack+Ten+Eight kicker)
griffinxblack: shows [Kc Th] (a pair of Tens)
griffinxblack collected $0.95 from pot
*** SUMMARY ***
Total pot $1 | Rake $0.05 
Board [3h Jd 7d Td 4c]
Seat 1: wcb607a showed [Ac 8c] and lost with high card Ace
Seat 2: griffinxblack (button) showed [Kc Th] and won ($0.95) with a pair of Tens
Seat 5: RiverbendAA (small blind) showed [As 5s] and lost with high card Ace
Seat 6: PlayTheBlues4U (big blind) folded before Flop



PokerStars Hand #204447288395:  Hold'em No Limit ($0.05/$0.10 USD) - 2019/10/11 19:29:56 ET
Table 'Beatrix' 6-max Seat #5 is the button
Seat 1: wcb607a ($3.44 in chips) 
Seat 2: griffinxblack ($29.87 in chips) 
Seat 5: RiverbendAA ($10 in chips) 
Seat 6: PlayTheBlues4U ($10.39 in chips) 
PlayTheBlues4U: posts small blind $0.05
wcb607a: posts big blind $0.10
*** HOLE CARDS ***
Dealt to PlayTheBlues4U [Ts 3d]
griffinxblack: folds 
RiverbendAA: raises $0.25 to $0.35
PlayTheBlues4U: folds 
wcb607a: folds 
Uncalled bet ($0.25) returned to RiverbendAA
RiverbendAA collected $0.25 from pot
RiverbendAA: doesn't show hand 
*** SUMMARY ***
Total pot $0.25 | Rake $0 
Seat 1: wcb607a (big blind) folded before Flop
Seat 2: griffinxblack folded before Flop (didn't bet)
Seat 5: RiverbendAA (button) collected ($0.25)
Seat 6: PlayTheBlues4U (small blind) folded before Flop



PokerStars Hand #204447288449:  Hold'em No Limit ($0.05/$0.10 USD) - 2019/10/11 19:30:19 ET
Table 'Beatrix' 6-max Seat #6 is the button
Seat 1: wcb607a ($3.34 in chips) 
Seat 2: griffinxblack ($29.87 in chips) 
Seat 5: RiverbendAA ($10.15 in chips) 
Seat 6: PlayTheBlues4U ($10.34 in chips) 
wcb607a: posts small blind $0.05
griffinxblack: posts big blind $0.10
*** HOLE CARDS ***
Dealt to PlayTheBlues4U [3h 3d]
RiverbendAA: raises $0.25 to $0.35
PlayTheBlues4U: calls $0.35
wcb607a: folds 
griffinxblack: calls $0.25
*** FLOP *** [Ac Qc 7c]
griffinxblack: checks 
RiverbendAA: bets $0.69
PlayTheBlues4U: folds 
griffinxblack: folds 
Uncalled bet ($0.69) returned to RiverbendAA
RiverbendAA collected $1.04 from pot
RiverbendAA: doesn't show hand 
*** SUMMARY ***
Total pot $1.10 | Rake $0.06 
Board [Ac Qc 7c]
Seat 1: wcb607a (small blind) folded before Flop
Seat 2: griffinxblack (big blind) folded on the Flop
Seat 5: RiverbendAA collected ($1.04)
Seat 6: PlayTheBlues4U (button) folded on the Flop



PokerStars Hand #204447288521:  Hold'em No Limit ($0.05/$0.10 USD) - 2019/10/11 19:30:54 ET
Table 'Beatrix' 6-max Seat #1 is the button
Seat 1: wcb607a ($3.29 in chips) 
Seat 2: griffinxblack ($29.52 in chips) 
Seat 5: RiverbendAA ($10.84 in chips) 
Seat 6: PlayTheBlues4U ($9.99 in chips) 
griffinxblack: posts small blind $0.05
RiverbendAA: posts big blind $0.10
*** HOLE CARDS ***
Dealt to PlayTheBlues4U [5h 3d]
PlayTheBlues4U: folds 
wcb607a: raises $0.20 to $0.30
griffinxblack: folds 
RiverbendAA: calls $0.20
*** FLOP *** [Qs As 9s]
RiverbendAA: bets $0.31
wcb607a: calls $0.31
*** TURN *** [Qs As 9s] [2h]
RiverbendAA: bets $0.81
wcb607a: calls $0.81
*** RIVER *** [Qs As 9s 2h] [Ks]
RiverbendAA: checks 
wcb607a: checks 
*** SHOW DOWN ***
RiverbendAA: shows [9d Ad] (two pair, Aces and Nines)
wcb607a: shows [Ac 5s] (a flush, Ace high)
wcb607a collected $2.75 from pot
*** SUMMARY ***
Total pot $2.89 | Rake $0.14 
Board [Qs As 9s 2h Ks]
Seat 1: wcb607a (button) showed [Ac 5s] and won ($2.75) with a flush, Ace high
Seat 2: griffinxblack (small blind) folded before Flop
Seat 5: RiverbendAA (big blind) showed [9d Ad] and lost with two pair, Aces and Nines
Seat 6: PlayTheBlues4U folded before Flop (didn't bet)



PokerStars Hand #204447288657:  Hold'em No Limit ($0.05/$0.10 USD) - 2019/10/11 19:32:02 ET
Table 'Beatrix' 6-max Seat #2 is the button
Seat 1: wcb607a ($4.62 in chips) 
Seat 2: griffinxblack ($29.47 in chips) 
Seat 5: RiverbendAA ($10 in chips) 
Seat 6: PlayTheBlues4U ($9.99 in chips) 
RiverbendAA: posts small blind $0.05
PlayTheBlues4U: posts big blind $0.10
*** HOLE CARDS ***
Dealt to PlayTheBlues4U [3c 5h]
wcb607a: raises $0.20 to $0.30
griffinxblack: folds 
RiverbendAA: folds 
1212wjf joins the table at seat #4 
PlayTheBlues4U: folds 
Uncalled bet ($0.20) returned to wcb607a
wcb607a collected $0.25 from pot
wcb607a: doesn't show hand 
*** SUMMARY ***
Total pot $0.25 | Rake $0 
Seat 1: wcb607a collected ($0.25)
Seat 2: griffinxblack (button) folded before Flop (didn't bet)
Seat 5: RiverbendAA (small blind) folded before Flop
Seat 6: PlayTheBlues4U (big blind) folded before Flop



PokerStars Hand #204447288716:  Hold'em No Limit ($0.05/$0.10 USD) - 2019/10/11 19:32:30 ET
Table 'Beatrix' 6-max Seat #5 is the button
Seat 1: wcb607a ($4.77 in chips) 
Seat 2: griffinxblack ($29.47 in chips) 
Seat 5: RiverbendAA ($10 in chips) 
Seat 6: PlayTheBlues4U ($9.89 in chips) 
PlayTheBlues4U: posts small blind $0.05
wcb607a: posts big blind $0.10
1212wjf: sits out 
*** HOLE CARDS ***
Dealt to PlayTheBlues4U [5s 3h]
griffinxblack: raises $0.20 to $0.30
RiverbendAA: calls $0.30
PlayTheBlues4U: folds 
wcb607a: folds 
*** FLOP *** [9d Jd 9s]
griffinxblack: checks 
RiverbendAA: bets $0.53
griffinxblack: folds 
Uncalled bet ($0.53) returned to RiverbendAA
RiverbendAA collected $0.71 from pot
RiverbendAA: doesn't show hand 
*** SUMMARY ***
Total pot $0.75 | Rake $0.04 
Board [9d Jd 9s]
Seat 1: wcb607a (big blind) folded before Flop
Seat 2: griffinxblack folded on the Flop
Seat 5: RiverbendAA (button) collected ($0.71)
Seat 6: PlayTheBlues4U (small blind) folded before Flop



PokerStars Hand #204447288788:  Hold'em No Limit ($0.05/$0.10 USD) - 2019/10/11 19:33:08 ET
Table 'Beatrix' 6-max Seat #6 is the button
Seat 1: wcb607a ($4.67 in chips) 
Seat 2: griffinxblack ($29.17 in chips) 
Seat 5: RiverbendAA ($10.41 in chips) 
Seat 6: PlayTheBlues4U ($9.84 in chips) 
wcb607a: posts small blind $0.05
griffinxblack: posts big blind $0.10
1212wjf: sits out 
*** HOLE CARDS ***
Dealt to PlayTheBlues4U [6d 8c]
RiverbendAA: folds 
PlayTheBlues4U: folds 
wcb607a: calls $0.05
griffinxblack: checks 
*** FLOP *** [4d 8d 8s]
wcb607a: checks 
griffinxblack: checks 
*** TURN *** [4d 8d 8s] [3h]
wcb607a: checks 
griffinxblack: checks 
*** RIVER *** [4d 8d 8s 3h] [As]
wcb607a: checks 
griffinxblack: checks 
*** SHOW DOWN ***
wcb607a: shows [Ts 4s] (two pair, Eights and Fours)
griffinxblack: mucks hand 
wcb607a collected $0.19 from pot
*** SUMMARY ***
Total pot $0.20 | Rake $0.01 
Board [4d 8d 8s 3h As]
Seat 1: wcb607a (small blind) showed [Ts 4s] and won ($0.19) with two pair, Eights and Fours
Seat 2: griffinxblack (big blind) mucked [7c Js]
Seat 5: RiverbendAA folded before Flop (didn't bet)
Seat 6: PlayTheBlues4U (button) folded before Flop (didn't bet)



PokerStars Hand #204447288855:  Hold'em No Limit ($0.05/$0.10 USD) - 2019/10/11 19:33:44 ET
Table 'Beatrix' 6-max Seat #1 is the button
Seat 1: wcb607a ($4.76 in chips) 
Seat 2: griffinxblack ($29.07 in chips) 
Seat 4: 1212wjf ($10 in chips) 
Seat 5: RiverbendAA ($10.41 in chips) 
Seat 6: PlayTheBlues4U ($9.84 in chips) 
griffinxblack: posts small blind $0.05
1212wjf: posts big blind $0.10
*** HOLE CARDS ***
Dealt to PlayTheBlues4U [3s Ad]
RiverbendAA: folds 
PlayTheBlues4U: folds 
wcb607a: raises $0.20 to $0.30
griffinxblack: folds 
1212wjf: calls $0.20
*** FLOP *** [Qh 4s 2c]
1212wjf: checks 
wcb607a: bets $0.30
1212wjf: calls $0.30
*** TURN *** [Qh 4s 2c] [Qd]
1212wjf: checks 
wcb607a: bets $0.50
1212wjf: calls $0.50
*** RIVER *** [Qh 4s 2c Qd] [As]
1212wjf: checks 
wcb607a: checks 
*** SHOW DOWN ***
1212wjf: shows [9h 9d] (two pair, Queens and Nines)
wcb607a: mucks hand 
1212wjf collected $2.14 from pot
*** SUMMARY ***
Total pot $2.25 | Rake $0.11 
Board [Qh 4s 2c Qd As]
Seat 1: wcb607a (button) mucked [3d 3c]
Seat 2: griffinxblack (small blind) folded before Flop
Seat 4: 1212wjf (big blind) showed [9h 9d] and won ($2.14) with two pair, Queens and Nines
Seat 5: RiverbendAA folded before Flop (didn't bet)
Seat 6: PlayTheBlues4U folded before Flop (didn't bet)



PokerStars Hand #204447288978:  Hold'em No Limit ($0.05/$0.10 USD) - 2019/10/11 19:34:52 ET
Table 'Beatrix' 6-max Seat #2 is the button
Seat 1: wcb607a ($3.66 in chips) 
Seat 2: griffinxblack ($29.02 in chips) 
Seat 4: 1212wjf ($11.04 in chips) 
Seat 5: RiverbendAA ($10.41 in chips) 
Seat 6: PlayTheBlues4U ($9.84 in chips) 
1212wjf: posts small blind $0.05
RiverbendAA: posts big blind $0.10
*** HOLE CARDS ***
Dealt to PlayTheBlues4U [7d Ac]
PlayTheBlues4U: folds 
wcb607a: folds 
smoothdram18 joins the table at seat #3 
griffinxblack: raises $0.20 to $0.30
1212wjf: folds 
RiverbendAA: calls $0.20
*** FLOP *** [Jd 8c Td]
RiverbendAA: checks 
griffinxblack: checks 
*** TURN *** [Jd 8c Td] [Qd]
RiverbendAA: bets $0.41
griffinxblack: folds 
Uncalled bet ($0.41) returned to RiverbendAA
RiverbendAA collected $0.62 from pot
RiverbendAA: doesn't show hand 
*** SUMMARY ***
Total pot $0.65 | Rake $0.03 
Board [Jd 8c Td Qd]
Seat 1: wcb607a folded before Flop (didn't bet)
Seat 2: griffinxblack (button) folded on the Turn
Seat 4: 1212wjf (small blind) folded before Flop
Seat 5: RiverbendAA (big blind) collected ($0.62)
Seat 6: PlayTheBlues4U folded before Flop (didn't bet)



PokerStars Hand #204447289093:  Hold'em No Limit ($0.05/$0.10 USD) - 2019/10/11 19:35:51 ET
Table 'Beatrix' 6-max Seat #4 is the button
Seat 1: wcb607a ($3.66 in chips) 
Seat 2: griffinxblack ($28.72 in chips) 
Seat 4: 1212wjf ($10.99 in chips) 
Seat 5: RiverbendAA ($10.73 in chips) 
Seat 6: PlayTheBlues4U ($9.84 in chips) 
RiverbendAA: posts small blind $0.05
PlayTheBlues4U: posts big blind $0.10
smoothdram18: sits out 
*** HOLE CARDS ***
Dealt to PlayTheBlues4U [Td Ac]
wcb607a: raises $0.20 to $0.30
griffinxblack: folds 
1212wjf: folds 
RiverbendAA: folds 
PlayTheBlues4U: calls $0.20
*** FLOP *** [8h Ks 9d]
PlayTheBlues4U: checks 
wcb607a: bets $0.30
PlayTheBlues4U: calls $0.30
*** TURN *** [8h Ks 9d] [5d]
PlayTheBlues4U: checks 
wcb607a: checks 
*** RIVER *** [8h Ks 9d 5d] [8c]
PlayTheBlues4U: bets $0.80
wcb607a: calls $0.80
*** SHOW DOWN ***
PlayTheBlues4U: shows [Td Ac] (a pair of Eights)
wcb607a: shows [5h Ah] (two pair, Eights and Fives)
wcb607a collected $2.71 from pot
*** SUMMARY ***
Total pot $2.85 | Rake $0.14 
Board [8h Ks 9d 5d 8c]
Seat 1: wcb607a showed [5h Ah] and won ($2.71) with two pair, Eights and Fives
Seat 2: griffinxblack folded before Flop (didn't bet)
Seat 4: 1212wjf (button) folded before Flop (didn't bet)
Seat 5: RiverbendAA (small blind) folded before Flop
Seat 6: PlayTheBlues4U (big blind) showed [Td Ac] and lost with a pair of Eights



PokerStars Hand #204447289205:  Hold'em No Limit ($0.05/$0.10 USD) - 2019/10/11 19:36:53 ET
Table 'Beatrix' 6-max Seat #5 is the button
Seat 1: wcb607a ($4.97 in chips) 
Seat 2: griffinxblack ($28.72 in chips) 
Seat 4: 1212wjf ($10.99 in chips) 
Seat 5: RiverbendAA ($10.68 in chips) 
Seat 6: PlayTheBlues4U ($8.44 in chips) 
PlayTheBlues4U: posts small blind $0.05
wcb607a: posts big blind $0.10
smoothdram18: sits out 
*** HOLE CARDS ***
Dealt to PlayTheBlues4U [8d 8s]
griffinxblack: raises $0.20 to $0.30
1212wjf: folds 
RiverbendAA: raises $0.60 to $0.90
PlayTheBlues4U: calls $0.85
wcb607a: folds 
griffinxblack: calls $0.60
*** FLOP *** [Js 9h Qs]
PlayTheBlues4U: checks 
griffinxblack: checks 
RiverbendAA: bets $1.40
PlayTheBlues4U: folds 
griffinxblack: calls $1.40
*** TURN *** [Js 9h Qs] [9c]
griffinxblack: checks 
RiverbendAA: bets $1.80
griffinxblack: folds 
Uncalled bet ($1.80) returned to RiverbendAA
RiverbendAA collected $5.32 from pot
RiverbendAA: doesn't show hand 
*** SUMMARY ***
Total pot $5.60 | Rake $0.28 
Board [Js 9h Qs 9c]
Seat 1: wcb607a (big blind) folded before Flop
Seat 2: griffinxblack folded on the Turn
Seat 4: 1212wjf folded before Flop (didn't bet)
Seat 5: RiverbendAA (button) collected ($5.32)
Seat 6: PlayTheBlues4U (small blind) folded on the Flop



PokerStars Hand #204447289348:  Hold'em No Limit ($0.05/$0.10 USD) - 2019/10/11 19:38:07 ET
Table 'Beatrix' 6-max Seat #6 is the button
Seat 1: wcb607a ($4.87 in chips) 
Seat 2: griffinxblack ($26.42 in chips) 
Seat 4: 1212wjf ($10.99 in chips) 
Seat 5: RiverbendAA ($13.70 in chips) 
Seat 6: PlayTheBlues4U ($7.54 in chips) 
wcb607a: posts small blind $0.05
griffinxblack: posts big blind $0.10
smoothdram18: sits out 
*** HOLE CARDS ***
Dealt to PlayTheBlues4U [2c 2d]
1212wjf: folds 
RiverbendAA: raises $0.25 to $0.35
PlayTheBlues4U: calls $0.35
wcb607a: calls $0.30
griffinxblack: folds 
*** FLOP *** [5c 4c Jd]
wcb607a: bets $0.60
RiverbendAA: folds 
PlayTheBlues4U: folds 
Uncalled bet ($0.60) returned to wcb607a
wcb607a collected $1.09 from pot
wcb607a: doesn't show hand 
*** SUMMARY ***
Total pot $1.15 | Rake $0.06 
Board [5c 4c Jd]
Seat 1: wcb607a (small blind) collected ($1.09)
Seat 2: griffinxblack (big blind) folded before Flop
Seat 4: 1212wjf folded before Flop (didn't bet)
Seat 5: RiverbendAA folded on the Flop
Seat 6: PlayTheBlues4U (button) folded on the Flop



PokerStars Hand #204447289417:  Hold'em No Limit ($0.05/$0.10 USD) - 2019/10/11 19:38:41 ET
Table 'Beatrix' 6-max Seat #1 is the button
Seat 1: wcb607a ($5.61 in chips) 
Seat 2: griffinxblack ($26.32 in chips) 
Seat 3: smoothdram18 ($10 in chips) 
Seat 4: 1212wjf ($10.99 in chips) 
Seat 5: RiverbendAA ($13.35 in chips) 
Seat 6: PlayTheBlues4U ($7.19 in chips) 
griffinxblack: posts small blind $0.05
smoothdram18: posts big blind $0.10
*** HOLE CARDS ***
Dealt to PlayTheBlues4U [2d Qd]
1212wjf: folds 
RiverbendAA: folds 
PlayTheBlues4U: folds 
wcb607a: raises $0.20 to $0.30
griffinxblack: folds 
smoothdram18: folds 
Uncalled bet ($0.20) returned to wcb607a
wcb607a collected $0.25 from pot
wcb607a: doesn't show hand 
*** SUMMARY ***
Total pot $0.25 | Rake $0 
Seat 1: wcb607a (button) collected ($0.25)
Seat 2: griffinxblack (small blind) folded before Flop
Seat 3: smoothdram18 (big blind) folded before Flop
Seat 4: 1212wjf folded before Flop (didn't bet)
Seat 5: RiverbendAA folded before Flop (didn't bet)
Seat 6: PlayTheBlues4U folded before Flop (didn't bet)



PokerStars Hand #204445467396:  Hold'em No Limit ($0.05/$0.10 USD) - 2019/10/11 19:05:49 ET
Table 'Elektra' 6-max Seat #1 is the button
Seat 1: RiverbendAA ($10.31 in chips) 
Seat 2: clovvnfiesta ($3.75 in chips) 
Seat 3: PlayTheBlues4U ($10 in chips) 
Seat 5: Antonmirk ($10.09 in chips) 
Seat 6: Jfinx ($11.68 in chips) 
clovvnfiesta: posts small blind $0.05
PlayTheBlues4U: posts big blind $0.10
wcb607a: sits out 
*** HOLE CARDS ***
Dealt to PlayTheBlues4U [8d 4h]
Antonmirk: folds 
Jfinx: folds 
RiverbendAA: folds 
clovvnfiesta: folds 
Uncalled bet ($0.05) returned to PlayTheBlues4U
PlayTheBlues4U collected $0.10 from pot
PlayTheBlues4U: doesn't show hand 
*** SUMMARY ***
Total pot $0.10 | Rake $0 
Seat 1: RiverbendAA (button) folded before Flop (didn't bet)
Seat 2: clovvnfiesta (small blind) folded before Flop
Seat 3: PlayTheBlues4U (big blind) collected ($0.10)
Seat 5: Antonmirk folded before Flop (didn't bet)
Seat 6: Jfinx folded before Flop (didn't bet)



PokerStars Hand #204445467432:  Hold'em No Limit ($0.05/$0.10 USD) - 2019/10/11 19:06:11 ET
Table 'Elektra' 6-max Seat #2 is the button
Seat 1: RiverbendAA ($10.31 in chips) 
Seat 2: clovvnfiesta ($3.70 in chips) 
Seat 3: PlayTheBlues4U ($10.05 in chips) 
Seat 4: wcb607a ($10 in chips) 
Seat 5: Antonmirk ($10.09 in chips) 
Seat 6: Jfinx ($11.68 in chips) 
PlayTheBlues4U: posts small blind $0.05
wcb607a: posts big blind $0.10
*** HOLE CARDS ***
Dealt to PlayTheBlues4U [Jd 5c]
Antonmirk: calls $0.10
Jfinx: folds 
RiverbendAA: calls $0.10
clovvnfiesta: folds 
PlayTheBlues4U: folds 
wcb607a: checks 
*** FLOP *** [4s 5d As]
wcb607a: bets $0.20
Antonmirk: folds 
RiverbendAA: calls $0.20
*** TURN *** [4s 5d As] [4c]
wcb607a: bets $0.40
RiverbendAA: calls $0.40
*** RIVER *** [4s 5d As 4c] [6d]
wcb607a: bets $1.10
RiverbendAA: folds 
Uncalled bet ($1.10) returned to wcb607a
wcb607a collected $1.47 from pot
wcb607a: doesn't show hand 
*** SUMMARY ***
Total pot $1.55 | Rake $0.08 
Board [4s 5d As 4c 6d]
Seat 1: RiverbendAA folded on the River
Seat 2: clovvnfiesta (button) folded before Flop (didn't bet)
Seat 3: PlayTheBlues4U (small blind) folded before Flop
Seat 4: wcb607a (big blind) collected ($1.47)
Seat 5: Antonmirk folded on the Flop
Seat 6: Jfinx folded before Flop (didn't bet)



PokerStars Hand #204445467531:  Hold'em No Limit ($0.05/$0.10 USD) - 2019/10/11 19:07:04 ET
Table 'Elektra' 6-max Seat #3 is the button
Seat 1: RiverbendAA ($10 in chips) 
Seat 2: clovvnfiesta ($3.70 in chips) 
Seat 3: PlayTheBlues4U ($10 in chips) 
Seat 4: wcb607a ($10.77 in chips) 
Seat 5: Antonmirk ($9.99 in chips) 
Seat 6: Jfinx ($11.68 in chips) 
wcb607a: posts small blind $0.05
Antonmirk: posts big blind $0.10
*** HOLE CARDS ***
Dealt to PlayTheBlues4U [Kh Ts]
Jfinx: folds 
RiverbendAA: folds 
clovvnfiesta: folds 
PlayTheBlues4U: raises $0.20 to $0.30
wcb607a: folds 
Antonmirk: folds 
Uncalled bet ($0.20) returned to PlayTheBlues4U
PlayTheBlues4U collected $0.25 from pot
PlayTheBlues4U: doesn't show hand 
*** SUMMARY ***
Total pot $0.25 | Rake $0 
Seat 1: RiverbendAA folded before Flop (didn't bet)
Seat 2: clovvnfiesta folded before Flop (didn't bet)
Seat 3: PlayTheBlues4U (button) collected ($0.25)
Seat 4: wcb607a (small blind) folded before Flop
Seat 5: Antonmirk (big blind) folded before Flop
Seat 6: Jfinx folded before Flop (didn't bet)



PokerStars Hand #204445467554:  Hold'em No Limit ($0.05/$0.10 USD) - 2019/10/11 19:07:18 ET
Table 'Elektra' 6-max Seat #4 is the button
Seat 1: RiverbendAA ($10 in chips) 
Seat 2: clovvnfiesta ($3.70 in chips) 
Seat 3: PlayTheBlues4U ($10.15 in chips) 
Seat 4: wcb607a ($10.72 in chips) 
Seat 5: Antonmirk ($9.89 in chips) 
Seat 6: Jfinx ($11.68 in chips) 
Antonmirk: posts small blind $0.05
Jfinx: posts big blind $0.10
*** HOLE CARDS ***
Dealt to PlayTheBlues4U [3s Jh]
RiverbendAA: folds 
clovvnfiesta: folds 
PlayTheBlues4U: folds 
wcb607a: raises $0.20 to $0.30
Antonmirk: folds 
Jfinx: folds 
Uncalled bet ($0.20) returned to wcb607a
wcb607a collected $0.25 from pot
wcb607a: doesn't show hand 
*** SUMMARY ***
Total pot $0.25 | Rake $0 
Seat 1: RiverbendAA folded before Flop (didn't bet)
Seat 2: clovvnfiesta folded before Flop (didn't bet)
Seat 3: PlayTheBlues4U folded before Flop (didn't bet)
Seat 4: wcb607a (button) collected ($0.25)
Seat 5: Antonmirk (small blind) folded before Flop
Seat 6: Jfinx (big blind) folded before Flop



PokerStars Hand #204445467596:  Hold'em No Limit ($0.05/$0.10 USD) - 2019/10/11 19:07:42 ET
Table 'Elektra' 6-max Seat #5 is the button
Seat 1: RiverbendAA ($10 in chips) 
Seat 2: clovvnfiesta ($3.70 in chips) 
Seat 3: PlayTheBlues4U ($10.15 in chips) 
Seat 4: wcb607a ($10.87 in chips) 
Seat 5: Antonmirk ($9.84 in chips) 
Seat 6: Jfinx ($11.58 in chips) 
Jfinx: posts small blind $0.05
RiverbendAA: posts big blind $0.10
*** HOLE CARDS ***
Dealt to PlayTheBlues4U [Ah 8s]
clovvnfiesta: folds 
PlayTheBlues4U: folds 
wcb607a: folds 
Antonmirk: raises $0.25 to $0.35
Jfinx: folds 
RiverbendAA: raises $0.75 to $1.10
Antonmirk: folds 
Uncalled bet ($0.75) returned to RiverbendAA
RiverbendAA collected $0.75 from pot
RiverbendAA: doesn't show hand 
*** SUMMARY ***
Total pot $0.75 | Rake $0 
Seat 1: RiverbendAA (big blind) collected ($0.75)
Seat 2: clovvnfiesta folded before Flop (didn't bet)
Seat 3: PlayTheBlues4U folded before Flop (didn't bet)
Seat 4: wcb607a folded before Flop (didn't bet)
Seat 5: Antonmirk (button) folded before Flop
Seat 6: Jfinx (small blind) folded before Flop



PokerStars Hand #204445467655:  Hold'em No Limit ($0.05/$0.10 USD) - 2019/10/11 19:08:13 ET
Table 'Elektra' 6-max Seat #6 is the button
Seat 1: RiverbendAA ($10.40 in chips) 
Seat 2: clovvnfiesta ($3.70 in chips) 
Seat 3: PlayTheBlues4U ($10.15 in chips) 
Seat 4: wcb607a ($10.87 in chips) 
Seat 5: Antonmirk ($9.49 in chips) 
Seat 6: Jfinx ($11.53 in chips) 
RiverbendAA: posts small blind $0.05
clovvnfiesta: posts big blind $0.10
*** HOLE CARDS ***
Dealt to PlayTheBlues4U [Kd 4c]
PlayTheBlues4U: folds 
wcb607a: raises $0.20 to $0.30
Antonmirk: folds 
Jfinx: folds 
RiverbendAA: folds 
clovvnfiesta: folds 
Uncalled bet ($0.20) returned to wcb607a
clovvnfiesta leaves the table
wcb607a collected $0.25 from pot
wcb607a: doesn't show hand 
*** SUMMARY ***
Total pot $0.25 | Rake $0 
Seat 1: RiverbendAA (small blind) folded before Flop
Seat 2: clovvnfiesta (big blind) folded before Flop
Seat 3: PlayTheBlues4U folded before Flop (didn't bet)
Seat 4: wcb607a collected ($0.25)
Seat 5: Antonmirk folded before Flop (didn't bet)
Seat 6: Jfinx (button) folded before Flop (didn't bet)



PokerStars Hand #204445467708:  Hold'em No Limit ($0.05/$0.10 USD) - 2019/10/11 19:08:39 ET
Table 'Elektra' 6-max Seat #1 is the button
Seat 1: RiverbendAA ($10.35 in chips) 
Seat 3: PlayTheBlues4U ($10.15 in chips) 
Seat 4: wcb607a ($11.02 in chips) 
Seat 5: Antonmirk ($9.49 in chips) 
Seat 6: Jfinx ($11.53 in chips) 
PlayTheBlues4U: posts small blind $0.05
wcb607a: posts big blind $0.10
*** HOLE CARDS ***
Dealt to PlayTheBlues4U [Ad As]
Antonmirk: calls $0.10
Jfinx: folds 
RiverbendAA: folds 
PlayTheBlues4U: raises $0.20 to $0.30
wcb607a: folds 
Antonmirk: calls $0.20
*** FLOP *** [Qs Td Jd]
PlayTheBlues4U: bets $0.66
Antonmirk: calls $0.66
*** TURN *** [Qs Td Jd] [8c]
PlayTheBlues4U: checks 
Antonmirk: bets $0.50
PlayTheBlues4U: calls $0.50
*** RIVER *** [Qs Td Jd 8c] [Ks]
PlayTheBlues4U: bets $1.70
Antonmirk: calls $1.70
*** SHOW DOWN ***
PlayTheBlues4U: shows [Ad As] (a straight, Ten to Ace)
Antonmirk: mucks hand 
PlayTheBlues4U collected $6.10 from pot
*** SUMMARY ***
Total pot $6.42 | Rake $0.32 
Board [Qs Td Jd 8c Ks]
Seat 1: RiverbendAA (button) folded before Flop (didn't bet)
Seat 3: PlayTheBlues4U (small blind) showed [Ad As] and won ($6.10) with a straight, Ten to Ace
Seat 4: wcb607a (big blind) folded before Flop
Seat 5: Antonmirk mucked [Kd Js]
Seat 6: Jfinx folded before Flop (didn't bet)



PokerStars Hand #204445467885:  Hold'em No Limit ($0.05/$0.10 USD) - 2019/10/11 19:10:18 ET
Table 'Elektra' 6-max Seat #3 is the button
Seat 1: RiverbendAA ($10.35 in chips) 
Seat 3: PlayTheBlues4U ($13.09 in chips) 
Seat 4: wcb607a ($10.92 in chips) 
Seat 5: Antonmirk ($6.33 in chips) 
Seat 6: Jfinx ($11.53 in chips) 
wcb607a: posts small blind $0.05
Antonmirk: posts big blind $0.10
*** HOLE CARDS ***
Dealt to PlayTheBlues4U [Td 8d]
Jfinx: folds 
RiverbendAA: folds 
PlayTheBlues4U: raises $0.15 to $0.25
Jfinx leaves the table
wcb607a: raises $0.70 to $0.95
Antonmirk: folds 
PlayTheBlues4U: folds 
Uncalled bet ($0.70) returned to wcb607a
wcb607a collected $0.60 from pot
wcb607a: doesn't show hand 
*** SUMMARY ***
Total pot $0.60 | Rake $0 
Seat 1: RiverbendAA folded before Flop (didn't bet)
Seat 3: PlayTheBlues4U (button) folded before Flop
Seat 4: wcb607a (small blind) collected ($0.60)
Seat 5: Antonmirk (big blind) folded before Flop
Seat 6: Jfinx folded before Flop (didn't bet)



PokerStars Hand #204445467942:  Hold'em No Limit ($0.05/$0.10 USD) - 2019/10/11 19:10:44 ET
Table 'Elektra' 6-max Seat #4 is the button
Seat 1: RiverbendAA ($10.35 in chips) 
Seat 3: PlayTheBlues4U ($12.84 in chips) 
Seat 4: wcb607a ($11.27 in chips) 
Seat 5: Antonmirk ($6.23 in chips) 
Antonmirk: posts small blind $0.05
RiverbendAA: posts big blind $0.10
*** HOLE CARDS ***
Dealt to PlayTheBlues4U [6h 9c]
PlayTheBlues4U: folds 
wcb607a: folds 
Antonmirk: raises $0.20 to $0.30
RiverbendAA: folds 
Uncalled bet ($0.20) returned to Antonmirk
Antonmirk collected $0.20 from pot
Antonmirk: doesn't show hand 
*** SUMMARY ***
Total pot $0.20 | Rake $0 
Seat 1: RiverbendAA (big blind) folded before Flop
Seat 3: PlayTheBlues4U folded before Flop (didn't bet)
Seat 4: wcb607a (button) folded before Flop (didn't bet)
Seat 5: Antonmirk (small blind) collected ($0.20)



PokerStars Hand #204445467960:  Hold'em No Limit ($0.05/$0.10 USD) - 2019/10/11 19:10:56 ET
Table 'Elektra' 6-max Seat #5 is the button
Seat 1: RiverbendAA ($10.25 in chips) 
Seat 3: PlayTheBlues4U ($12.84 in chips) 
Seat 4: wcb607a ($11.27 in chips) 
Seat 5: Antonmirk ($6.33 in chips) 
RiverbendAA: posts small blind $0.05
PlayTheBlues4U: posts big blind $0.10
*** HOLE CARDS ***
Dealt to PlayTheBlues4U [2d 8d]
wcb607a: folds 
Antonmirk: calls $0.10
RiverbendAA: calls $0.05
PlayTheBlues4U: checks 
*** FLOP *** [9c 4d 5c]
RiverbendAA: checks 
PlayTheBlues4U: checks 
Antonmirk: bets $0.28
RiverbendAA: raises $0.42 to $0.70
PlayTheBlues4U: folds 
Antonmirk: folds 
Uncalled bet ($0.42) returned to RiverbendAA
RiverbendAA collected $0.82 from pot
RiverbendAA: doesn't show hand 
*** SUMMARY ***
Total pot $0.86 | Rake $0.04 
Board [9c 4d 5c]
Seat 1: RiverbendAA (small blind) collected ($0.82)
Seat 3: PlayTheBlues4U (big blind) folded on the Flop
Seat 4: wcb607a folded before Flop (didn't bet)
Seat 5: Antonmirk (button) folded on the Flop



PokerStars Hand #204445468051:  Hold'em No Limit ($0.05/$0.10 USD) - 2019/10/11 19:11:40 ET
Table 'Elektra' 6-max Seat #1 is the button
Seat 1: RiverbendAA ($10.69 in chips) 
Seat 3: PlayTheBlues4U ($12.74 in chips) 
Seat 4: wcb607a ($11.27 in chips) 
Seat 5: Antonmirk ($5.95 in chips) 
PlayTheBlues4U: posts small blind $0.05
wcb607a: posts big blind $0.10
*** HOLE CARDS ***
Dealt to PlayTheBlues4U [Js Ah]
Antonmirk: folds 
RiverbendAA: folds 
PlayTheBlues4U: raises $0.20 to $0.30
wcb607a: calls $0.20
*** FLOP *** [3s 4h As]
PlayTheBlues4U: bets $0.40
wcb607a: folds 
Uncalled bet ($0.40) returned to PlayTheBlues4U
PlayTheBlues4U collected $0.57 from pot
PlayTheBlues4U: doesn't show hand 
*** SUMMARY ***
Total pot $0.60 | Rake $0.03 
Board [3s 4h As]
Seat 1: RiverbendAA (button) folded before Flop (didn't bet)
Seat 3: PlayTheBlues4U (small blind) collected ($0.57)
Seat 4: wcb607a (big blind) folded on the Flop
Seat 5: Antonmirk folded before Flop (didn't bet)



PokerStars Hand #204445468112:  Hold'em No Limit ($0.05/$0.10 USD) - 2019/10/11 19:12:06 ET
Table 'Elektra' 6-max Seat #3 is the button
Seat 1: RiverbendAA ($10.69 in chips) 
Seat 3: PlayTheBlues4U ($13.01 in chips) 
Seat 4: wcb607a ($10.97 in chips) 
Seat 5: Antonmirk ($5.95 in chips) 
wcb607a: posts small blind $0.05
Antonmirk: posts big blind $0.10
*** HOLE CARDS ***
Dealt to PlayTheBlues4U [6s 6h]
RiverbendAA: folds 
PlayTheBlues4U: raises $0.15 to $0.25
wcb607a: folds 
Antonmirk: calls $0.15
*** FLOP *** [5s 2s 3d]
Antonmirk: checks 
PlayTheBlues4U: bets $0.40
Antonmirk: calls $0.40
*** TURN *** [5s 2s 3d] [Js]
Antonmirk: checks 
PlayTheBlues4U: checks 
*** RIVER *** [5s 2s 3d Js] [Tc]
Antonmirk: bets $0.50
PlayTheBlues4U: calls $0.50
*** SHOW DOWN ***
Antonmirk: shows [7c Ad] (high card Ace)
PlayTheBlues4U: shows [6s 6h] (a pair of Sixes)
PlayTheBlues4U collected $2.23 from pot
*** SUMMARY ***
Total pot $2.35 | Rake $0.12 
Board [5s 2s 3d Js Tc]
Seat 1: RiverbendAA folded before Flop (didn't bet)
Seat 3: PlayTheBlues4U (button) showed [6s 6h] and won ($2.23) with a pair of Sixes
Seat 4: wcb607a (small blind) folded before Flop
Seat 5: Antonmirk (big blind) showed [7c Ad] and lost with high card Ace



PokerStars Hand #204445468255:  Hold'em No Limit ($0.05/$0.10 USD) - 2019/10/11 19:13:22 ET
Table 'Elektra' 6-max Seat #4 is the button
Seat 1: RiverbendAA ($10.69 in chips) 
Seat 3: PlayTheBlues4U ($14.09 in chips) 
Seat 4: wcb607a ($10.92 in chips) 
Seat 5: Antonmirk ($4.80 in chips) 
Antonmirk: posts small blind $0.05
RiverbendAA: posts big blind $0.10
*** HOLE CARDS ***
Dealt to PlayTheBlues4U [2d Kh]
PlayTheBlues4U: folds 
wcb607a: folds 
Antonmirk: calls $0.05
RiverbendAA: checks 
*** FLOP *** [9d 6s Ks]
Antonmirk: bets $0.19
RiverbendAA: folds 
Uncalled bet ($0.19) returned to Antonmirk
Antonmirk collected $0.19 from pot
Antonmirk: doesn't show hand 
*** SUMMARY ***
Total pot $0.20 | Rake $0.01 
Board [9d 6s Ks]
Seat 1: RiverbendAA (big blind) folded on the Flop
Seat 3: PlayTheBlues4U folded before Flop (didn't bet)
Seat 4: wcb607a (button) folded before Flop (didn't bet)
Seat 5: Antonmirk (small blind) collected ($0.19)



PokerStars Hand #204445468302:  Hold'em No Limit ($0.05/$0.10 USD) - 2019/10/11 19:13:48 ET
Table 'Elektra' 6-max Seat #5 is the button
Seat 1: RiverbendAA ($10.59 in chips) 
Seat 3: PlayTheBlues4U ($14.09 in chips) 
Seat 4: wcb607a ($10.92 in chips) 
Seat 5: Antonmirk ($4.89 in chips) 
RiverbendAA: posts small blind $0.05
PlayTheBlues4U: posts big blind $0.10
*** HOLE CARDS ***
Dealt to PlayTheBlues4U [Jh Kc]
wcb607a: folds 
Antonmirk: calls $0.10
RiverbendAA: folds 
PlayTheBlues4U: checks 
*** FLOP *** [Jc 2c 9d]
PlayTheBlues4U: checks 
Antonmirk: bets $0.10
PlayTheBlues4U: calls $0.10
*** TURN *** [Jc 2c 9d] [Ts]
PlayTheBlues4U: bets $0.30
Antonmirk: calls $0.30
*** RIVER *** [Jc 2c 9d Ts] [Th]
PlayTheBlues4U: bets $0.60
Antonmirk: folds 
Uncalled bet ($0.60) returned to PlayTheBlues4U
PlayTheBlues4U collected $1 from pot
PlayTheBlues4U: doesn't show hand 
*** SUMMARY ***
Total pot $1.05 | Rake $0.05 
Board [Jc 2c 9d Ts Th]
Seat 1: RiverbendAA (small blind) folded before Flop
Seat 3: PlayTheBlues4U (big blind) collected ($1)
Seat 4: wcb607a folded before Flop (didn't bet)
Seat 5: Antonmirk (button) folded on the River



PokerStars Hand #204445468392:  Hold'em No Limit ($0.05/$0.10 USD) - 2019/10/11 19:14:33 ET
Table 'Elektra' 6-max Seat #1 is the button
Seat 1: RiverbendAA ($10.54 in chips) 
Seat 3: PlayTheBlues4U ($14.59 in chips) 
Seat 4: wcb607a ($10.92 in chips) 
Seat 5: Antonmirk ($4.39 in chips) 
PlayTheBlues4U: posts small blind $0.05
wcb607a: posts big blind $0.10
*** HOLE CARDS ***
Dealt to PlayTheBlues4U [Qd As]
Antonmirk: folds 
RiverbendAA: folds 
PlayTheBlues4U: raises $0.20 to $0.30
wcb607a: folds 
Uncalled bet ($0.20) returned to PlayTheBlues4U
PlayTheBlues4U collected $0.20 from pot
PlayTheBlues4U: doesn't show hand 
*** SUMMARY ***
Total pot $0.20 | Rake $0 
Seat 1: RiverbendAA (button) folded before Flop (didn't bet)
Seat 3: PlayTheBlues4U (small blind) collected ($0.20)
Seat 4: wcb607a (big blind) folded before Flop
Seat 5: Antonmirk folded before Flop (didn't bet)



PokerStars Hand #204445468413:  Hold'em No Limit ($0.05/$0.10 USD) - 2019/10/11 19:14:43 ET
Table 'Elektra' 6-max Seat #3 is the button
Seat 1: RiverbendAA ($10.54 in chips) 
Seat 3: PlayTheBlues4U ($14.69 in chips) 
Seat 4: wcb607a ($10.82 in chips) 
Seat 5: Antonmirk ($4.39 in chips) 
wcb607a: posts small blind $0.05
Antonmirk: posts big blind $0.10
*** HOLE CARDS ***
Dealt to PlayTheBlues4U [Qd Qh]
RiverbendAA: folds 
PlayTheBlues4U: raises $0.20 to $0.30
wcb607a: raises $0.70 to $1
Antonmirk: folds 
PlayTheBlues4U: raises $1.30 to $2.30
wcb607a: calls $1.30
*** FLOP *** [5d Qc 4d]
wcb607a: checks 
PlayTheBlues4U: bets $2.60
wcb607a: calls $2.60
*** TURN *** [5d Qc 4d] [Td]
wcb607a: bets $5
PlayTheBlues4U: raises $4.79 to $9.79 and is all-in
wcb607a: calls $0.92 and is all-in
Uncalled bet ($3.87) returned to PlayTheBlues4U
*** RIVER *** [5d Qc 4d Td] [6h]
*** SHOW DOWN ***
wcb607a: shows [6s Ah] (a pair of Sixes)
PlayTheBlues4U: shows [Qd Qh] (three of a kind, Queens)
PlayTheBlues4U collected $20.74 from pot
*** SUMMARY ***
Total pot $21.74 | Rake $1 
Board [5d Qc 4d Td 6h]
Seat 1: RiverbendAA folded before Flop (didn't bet)
Seat 3: PlayTheBlues4U (button) showed [Qd Qh] and won ($20.74) with three of a kind, Queens
Seat 4: wcb607a (small blind) showed [6s Ah] and lost with a pair of Sixes
Seat 5: Antonmirk (big blind) folded before Flop



PokerStars Hand #204445468592:  Hold'em No Limit ($0.05/$0.10 USD) - 2019/10/11 19:16:14 ET
Table 'Elektra' 6-max Seat #5 is the button
Seat 1: RiverbendAA ($10.54 in chips) 
Seat 3: PlayTheBlues4U ($24.61 in chips) 
Seat 5: Antonmirk ($4.29 in chips) 
RiverbendAA: posts small blind $0.05
PlayTheBlues4U: posts big blind $0.10
*** HOLE CARDS ***
Dealt to PlayTheBlues4U [Kc 3d]
Antonmirk: calls $0.10
RiverbendAA: calls $0.05
PlayTheBlues4U: checks 
*** FLOP *** [Ah 5h 6s]
RiverbendAA: checks 
PlayTheBlues4U: checks 
Antonmirk: bets $0.10
RiverbendAA: folds 
PlayTheBlues4U: folds 
Uncalled bet ($0.10) returned to Antonmirk
Antonmirk collected $0.28 from pot
Antonmirk: doesn't show hand 
*** SUMMARY ***
Total pot $0.30 | Rake $0.02 
Board [Ah 5h 6s]
Seat 1: RiverbendAA (small blind) folded on the Flop
Seat 3: PlayTheBlues4U (big blind) folded on the Flop
Seat 5: Antonmirk (button) collected ($0.28)



PokerStars Hand #204445468637:  Hold'em No Limit ($0.05/$0.10 USD) - 2019/10/11 19:16:39 ET
Table 'Elektra' 6-max Seat #1 is the button
Seat 1: RiverbendAA ($10.44 in chips) 
Seat 3: PlayTheBlues4U ($24.51 in chips) 
Seat 4: wcb607a ($10 in chips) 
Seat 5: Antonmirk ($4.47 in chips) 
PlayTheBlues4U: posts small blind $0.05
wcb607a: posts big blind $0.10
*** HOLE CARDS ***
Dealt to PlayTheBlues4U [Td Ts]
Antonmirk: calls $0.10
RiverbendAA: calls $0.10
PlayTheBlues4U: raises $0.30 to $0.40
wcb607a: folds 
Antonmirk: calls $0.30
RiverbendAA: calls $0.30
*** FLOP *** [5c 3d Kc]
PlayTheBlues4U: checks 
Antonmirk: checks 
RiverbendAA: bets $0.83
PlayTheBlues4U: folds 
Antonmirk: folds 
Uncalled bet ($0.83) returned to RiverbendAA
RiverbendAA collected $1.24 from pot
RiverbendAA: doesn't show hand 
*** SUMMARY ***
Total pot $1.30 | Rake $0.06 
Board [5c 3d Kc]
Seat 1: RiverbendAA (button) collected ($1.24)
Seat 3: PlayTheBlues4U (small blind) folded on the Flop
Seat 4: wcb607a (big blind) folded before Flop
Seat 5: Antonmirk folded on the Flop



PokerStars Hand #204445468755:  Hold'em No Limit ($0.05/$0.10 USD) - 2019/10/11 19:17:40 ET
Table 'Elektra' 6-max Seat #3 is the button
Seat 1: RiverbendAA ($11.28 in chips) 
Seat 3: PlayTheBlues4U ($24.11 in chips) 
Seat 4: wcb607a ($9.90 in chips) 
Seat 5: Antonmirk ($4.07 in chips) 
wcb607a: posts small blind $0.05
Antonmirk: posts big blind $0.10
*** HOLE CARDS ***
Dealt to PlayTheBlues4U [Th Ks]
RiverbendAA: raises $0.25 to $0.35
PlayTheBlues4U: folds 
wcb607a: folds 
Antonmirk: folds 
Uncalled bet ($0.25) returned to RiverbendAA
RiverbendAA collected $0.25 from pot
RiverbendAA: doesn't show hand 
*** SUMMARY ***
Total pot $0.25 | Rake $0 
Seat 1: RiverbendAA collected ($0.25)
Seat 3: PlayTheBlues4U (button) folded before Flop (didn't bet)
Seat 4: wcb607a (small blind) folded before Flop
Seat 5: Antonmirk (big blind) folded before Flop



PokerStars Hand #204445468772:  Hold'em No Limit ($0.05/$0.10 USD) - 2019/10/11 19:17:52 ET
Table 'Elektra' 6-max Seat #4 is the button
Seat 1: RiverbendAA ($11.43 in chips) 
Seat 3: PlayTheBlues4U ($24.11 in chips) 
Seat 4: wcb607a ($9.85 in chips) 
Seat 5: Antonmirk ($3.97 in chips) 
Antonmirk: posts small blind $0.05
RiverbendAA: posts big blind $0.10
*** HOLE CARDS ***
Dealt to PlayTheBlues4U [2d 5d]
PlayTheBlues4U: folds 
wcb607a: raises $0.20 to $0.30
Antonmirk: calls $0.25
RiverbendAA: folds 
*** FLOP *** [8s As Ad]
Antonmirk: checks 
wcb607a: bets $0.20
Antonmirk: folds 
Uncalled bet ($0.20) returned to wcb607a
wcb607a collected $0.66 from pot
wcb607a: doesn't show hand 
*** SUMMARY ***
Total pot $0.70 | Rake $0.04 
Board [8s As Ad]
Seat 1: RiverbendAA (big blind) folded before Flop
Seat 3: PlayTheBlues4U folded before Flop (didn't bet)
Seat 4: wcb607a (button) collected ($0.66)
Seat 5: Antonmirk (small blind) folded on the Flop



PokerStars Hand #204445468818:  Hold'em No Limit ($0.05/$0.10 USD) - 2019/10/11 19:18:13 ET
Table 'Elektra' 6-max Seat #5 is the button
Seat 1: RiverbendAA ($11.33 in chips) 
Seat 3: PlayTheBlues4U ($24.11 in chips) 
Seat 4: wcb607a ($10.21 in chips) 
Seat 5: Antonmirk ($3.67 in chips) 
RiverbendAA: posts small blind $0.05
PlayTheBlues4U: posts big blind $0.10
*** HOLE CARDS ***
Dealt to PlayTheBlues4U [Jd 4h]
wcb607a: folds 
Antonmirk: folds 
RiverbendAA: raises $0.15 to $0.25
PlayTheBlues4U: folds 
Uncalled bet ($0.15) returned to RiverbendAA
RiverbendAA collected $0.20 from pot
RiverbendAA: doesn't show hand 
*** SUMMARY ***
Total pot $0.20 | Rake $0 
Seat 1: RiverbendAA (small blind) collected ($0.20)
Seat 3: PlayTheBlues4U (big blind) folded before Flop
Seat 4: wcb607a folded before Flop (didn't bet)
Seat 5: Antonmirk (button) folded before Flop (didn't bet)



PokerStars Hand #204445468845:  Hold'em No Limit ($0.05/$0.10 USD) - 2019/10/11 19:18:26 ET
Table 'Elektra' 6-max Seat #1 is the button
Seat 1: RiverbendAA ($11.43 in chips) 
Seat 3: PlayTheBlues4U ($24.01 in chips) 
Seat 4: wcb607a ($10.21 in chips) 
Seat 5: Antonmirk ($3.67 in chips) 
PlayTheBlues4U: posts small blind $0.05
wcb607a: posts big blind $0.10
*** HOLE CARDS ***
Dealt to PlayTheBlues4U [6h 2c]
Antonmirk: folds 
RiverbendAA: raises $0.25 to $0.35
PlayTheBlues4U: folds 
wcb607a: raises $0.85 to $1.20
RiverbendAA: folds 
Uncalled bet ($0.85) returned to wcb607a
wcb607a collected $0.75 from pot
wcb607a: doesn't show hand 
*** SUMMARY ***
Total pot $0.75 | Rake $0 
Seat 1: RiverbendAA (button) folded before Flop
Seat 3: PlayTheBlues4U (small blind) folded before Flop
Seat 4: wcb607a (big blind) collected ($0.75)
Seat 5: Antonmirk folded before Flop (didn't bet)



PokerStars Hand #204445468914:  Hold'em No Limit ($0.05/$0.10 USD) - 2019/10/11 19:18:56 ET
Table 'Elektra' 6-max Seat #3 is the button
Seat 1: RiverbendAA ($11.08 in chips) 
Seat 3: PlayTheBlues4U ($23.96 in chips) 
Seat 4: wcb607a ($10.61 in chips) 
Seat 5: Antonmirk ($3.67 in chips) 
wcb607a: posts small blind $0.05
Antonmirk: posts big blind $0.10
*** HOLE CARDS ***
Dealt to PlayTheBlues4U [3d 3c]
RiverbendAA: folds 
PlayTheBlues4U: raises $0.20 to $0.30
wcb607a: folds 
KillerKlownShoe joins the table at seat #6 
Antonmirk: calls $0.20
*** FLOP *** [4s 6d Qc]
Antonmirk: bets $0.31
PlayTheBlues4U: folds 
Uncalled bet ($0.31) returned to Antonmirk
Antonmirk collected $0.62 from pot
Antonmirk: doesn't show hand 
*** SUMMARY ***
Total pot $0.65 | Rake $0.03 
Board [4s 6d Qc]
Seat 1: RiverbendAA folded before Flop (didn't bet)
Seat 3: PlayTheBlues4U (button) folded on the Flop
Seat 4: wcb607a (small blind) folded before Flop
Seat 5: Antonmirk (big blind) collected ($0.62)



PokerStars Hand #204445468988:  Hold'em No Limit ($0.05/$0.10 USD) - 2019/10/11 19:19:33 ET
Table 'Elektra' 6-max Seat #4 is the button
Seat 1: RiverbendAA ($11.08 in chips) 
Seat 3: PlayTheBlues4U ($23.66 in chips) 
Seat 4: wcb607a ($10.56 in chips) 
Seat 5: Antonmirk ($3.99 in chips) 
Seat 6: KillerKlownShoe ($8 in chips) 
Antonmirk: posts small blind $0.05
KillerKlownShoe: posts big blind $0.10
*** HOLE CARDS ***
Dealt to PlayTheBlues4U [5h 7d]
RiverbendAA: folds 
PlayTheBlues4U: folds 
wcb607a: raises $0.20 to $0.30
Antonmirk: calls $0.25
KillerKlownShoe: folds 
*** FLOP *** [Js As 9d]
Antonmirk: checks 
wcb607a: checks 
*** TURN *** [Js As 9d] [7c]
Antonmirk: bets $0.66
wcb607a: folds 
Uncalled bet ($0.66) returned to Antonmirk
Antonmirk collected $0.66 from pot
Antonmirk: doesn't show hand 
*** SUMMARY ***
Total pot $0.70 | Rake $0.04 
Board [Js As 9d 7c]
Seat 1: RiverbendAA folded before Flop (didn't bet)
Seat 3: PlayTheBlues4U folded before Flop (didn't bet)
Seat 4: wcb607a (button) folded on the Turn
Seat 5: Antonmirk (small blind) collected ($0.66)
Seat 6: KillerKlownShoe (big blind) folded before Flop



PokerStars Hand #204445469102:  Hold'em No Limit ($0.05/$0.10 USD) - 2019/10/11 19:20:24 ET
Table 'Elektra' 6-max Seat #5 is the button
Seat 1: RiverbendAA ($11.08 in chips) 
Seat 3: PlayTheBlues4U ($23.66 in chips) 
Seat 4: wcb607a ($10.26 in chips) 
Seat 5: Antonmirk ($4.35 in chips) 
Seat 6: KillerKlownShoe ($7.90 in chips) 
KillerKlownShoe: posts small blind $0.05
RiverbendAA: posts big blind $0.10
*** HOLE CARDS ***
Dealt to PlayTheBlues4U [7s 2h]
PlayTheBlues4U: folds 
wcb607a: folds 
Antonmirk: calls $0.10
KillerKlownShoe: calls $0.05
RiverbendAA: checks 
*** FLOP *** [3h Jd 4d]
KillerKlownShoe: checks 
RiverbendAA: checks 
Antonmirk: bets $0.28
KillerKlownShoe: calls $0.28
TheFreeWilly joins the table at seat #2 
RiverbendAA: folds 
*** TURN *** [3h Jd 4d] [8h]
KillerKlownShoe: checks 
Antonmirk: bets $0.41
KillerKlownShoe: calls $0.41
*** RIVER *** [3h Jd 4d 8h] [8s]
KillerKlownShoe: checks 
Antonmirk: checks 
*** SHOW DOWN ***
KillerKlownShoe: shows [9s 9h] (two pair, Nines and Eights)
Antonmirk: mucks hand 
KillerKlownShoe collected $1.60 from pot
*** SUMMARY ***
Total pot $1.68 | Rake $0.08 
Board [3h Jd 4d 8h 8s]
Seat 1: RiverbendAA (big blind) folded on the Flop
Seat 3: PlayTheBlues4U folded before Flop (didn't bet)
Seat 4: wcb607a folded before Flop (didn't bet)
Seat 5: Antonmirk (button) mucked [Td 4s]
Seat 6: KillerKlownShoe (small blind) showed [9s 9h] and won ($1.60) with two pair, Nines and Eights



PokerStars Hand #204445469213:  Hold'em No Limit ($0.05/$0.10 USD) - 2019/10/11 19:21:27 ET
Table 'Elektra' 6-max Seat #6 is the button
Seat 1: RiverbendAA ($10.98 in chips) 
Seat 2: TheFreeWilly ($8 in chips) 
Seat 3: PlayTheBlues4U ($23.66 in chips) 
Seat 4: wcb607a ($10.26 in chips) 
Seat 5: Antonmirk ($3.56 in chips) 
Seat 6: KillerKlownShoe ($8.71 in chips) 
RiverbendAA: posts small blind $0.05
TheFreeWilly: posts big blind $0.10
*** HOLE CARDS ***
Dealt to PlayTheBlues4U [2d 5h]
PlayTheBlues4U: folds 
wcb607a: folds 
Antonmirk: calls $0.10
KillerKlownShoe: calls $0.10
RiverbendAA: folds 
TheFreeWilly: raises $0.30 to $0.40
Antonmirk: calls $0.30
KillerKlownShoe: calls $0.30
*** FLOP *** [Qd 5s Js]
TheFreeWilly: bets $0.81
Antonmirk: folds 
KillerKlownShoe: folds 
Uncalled bet ($0.81) returned to TheFreeWilly
TheFreeWilly collected $1.19 from pot
TheFreeWilly: doesn't show hand 
*** SUMMARY ***
Total pot $1.25 | Rake $0.06 
Board [Qd 5s Js]
Seat 1: RiverbendAA (small blind) folded before Flop
Seat 2: TheFreeWilly (big blind) collected ($1.19)
Seat 3: PlayTheBlues4U folded before Flop (didn't bet)
Seat 4: wcb607a folded before Flop (didn't bet)
Seat 5: Antonmirk folded on the Flop
Seat 6: KillerKlownShoe (button) folded on the Flop



PokerStars Hand #204445469268:  Hold'em No Limit ($0.05/$0.10 USD) - 2019/10/11 19:21:51 ET
Table 'Elektra' 6-max Seat #1 is the button
Seat 1: RiverbendAA ($10.93 in chips) 
Seat 2: TheFreeWilly ($8.79 in chips) 
Seat 3: PlayTheBlues4U ($23.66 in chips) 
Seat 4: wcb607a ($10.26 in chips) 
Seat 5: Antonmirk ($3.16 in chips) 
Seat 6: KillerKlownShoe ($8.31 in chips) 
TheFreeWilly: posts small blind $0.05
PlayTheBlues4U: posts big blind $0.10
*** HOLE CARDS ***
Dealt to PlayTheBlues4U [2s 9d]
wcb607a: folds 
Antonmirk: folds 
KillerKlownShoe: folds 
RiverbendAA: folds 
TheFreeWilly: raises $0.30 to $0.40
PlayTheBlues4U: folds 
Uncalled bet ($0.30) returned to TheFreeWilly
TheFreeWilly collected $0.20 from pot
TheFreeWilly: doesn't show hand 
*** SUMMARY ***
Total pot $0.20 | Rake $0 
Seat 1: RiverbendAA (button) folded before Flop (didn't bet)
Seat 2: TheFreeWilly (small blind) collected ($0.20)
Seat 3: PlayTheBlues4U (big blind) folded before Flop
Seat 4: wcb607a folded before Flop (didn't bet)
Seat 5: Antonmirk folded before Flop (didn't bet)
Seat 6: KillerKlownShoe folded before Flop (didn't bet)



PokerStars Hand #204445469280:  Hold'em No Limit ($0.05/$0.10 USD) - 2019/10/11 19:22:00 ET
Table 'Elektra' 6-max Seat #2 is the button
Seat 1: RiverbendAA ($10.93 in chips) 
Seat 2: TheFreeWilly ($8.89 in chips) 
Seat 3: PlayTheBlues4U ($23.56 in chips) 
Seat 4: wcb607a ($10.26 in chips) 
Seat 6: KillerKlownShoe ($8.31 in chips) 
PlayTheBlues4U: posts small blind $0.05
wcb607a: posts big blind $0.10
*** HOLE CARDS ***
Dealt to PlayTheBlues4U [As Ah]
KillerKlownShoe: folds 
RiverbendAA: folds 
TheFreeWilly: raises $0.20 to $0.30
Antonmirk leaves the table
PlayTheBlues4U: raises $0.60 to $0.90
KillerKlownShoe leaves the table
wcb607a: folds 
TheFreeWilly: calls $0.60
*** FLOP *** [7c 8d 3c]
PlayTheBlues4U: bets $1.10
TheFreeWilly: folds 
Uncalled bet ($1.10) returned to PlayTheBlues4U
PlayTheBlues4U collected $1.80 from pot
PlayTheBlues4U: doesn't show hand 
*** SUMMARY ***
Total pot $1.90 | Rake $0.10 
Board [7c 8d 3c]
Seat 1: RiverbendAA folded before Flop (didn't bet)
Seat 2: TheFreeWilly (button) folded on the Flop
Seat 3: PlayTheBlues4U (small blind) collected ($1.80)
Seat 4: wcb607a (big blind) folded before Flop
Seat 6: KillerKlownShoe folded before Flop (didn't bet)



PokerStars Hand #204445469377:  Hold'em No Limit ($0.05/$0.10 USD) - 2019/10/11 19:22:47 ET
Table 'Elektra' 6-max Seat #3 is the button
Seat 1: RiverbendAA ($10.93 in chips) 
Seat 2: TheFreeWilly ($7.99 in chips) 
Seat 3: PlayTheBlues4U ($24.46 in chips) 
Seat 4: wcb607a ($10.16 in chips) 
wcb607a: posts small blind $0.05
RiverbendAA: posts big blind $0.10
*** HOLE CARDS ***
Dealt to PlayTheBlues4U [Jc Ah]
TheFreeWilly: raises $0.20 to $0.30
PlayTheBlues4U: raises $0.30 to $0.60
wcb607a: folds 
RiverbendAA: folds 
TheFreeWilly: calls $0.30
*** FLOP *** [6s 3h 6c]
TheFreeWilly: checks 
PlayTheBlues4U: checks 
*** TURN *** [6s 3h 6c] [9c]
TheFreeWilly: bets $0.72
PlayTheBlues4U: calls $0.72
*** RIVER *** [6s 3h 6c 9c] [3c]
TheFreeWilly: checks 
PlayTheBlues4U: checks 
*** SHOW DOWN ***
TheFreeWilly: shows [Ks 7h] (two pair, Sixes and Threes)
PlayTheBlues4U: shows [Jc Ah] (two pair, Sixes and Threes - Ace kicker)
PlayTheBlues4U collected $2.65 from pot
*** SUMMARY ***
Total pot $2.79 | Rake $0.14 
Board [6s 3h 6c 9c 3c]
Seat 1: RiverbendAA (big blind) folded before Flop
Seat 2: TheFreeWilly showed [Ks 7h] and lost with two pair, Sixes and Threes
Seat 3: PlayTheBlues4U (button) showed [Jc Ah] and won ($2.65) with two pair, Sixes and Threes
Seat 4: wcb607a (small blind) folded before Flop



PokerStars Hand #204445469474:  Hold'em No Limit ($0.05/$0.10 USD) - 2019/10/11 19:23:36 ET
Table 'Elektra' 6-max Seat #4 is the button
Seat 1: RiverbendAA ($10.83 in chips) 
Seat 2: TheFreeWilly ($6.67 in chips) 
Seat 3: PlayTheBlues4U ($25.79 in chips) 
Seat 4: wcb607a ($10.11 in chips) 
RiverbendAA: posts small blind $0.05
TheFreeWilly: posts big blind $0.10
*** HOLE CARDS ***
Dealt to PlayTheBlues4U [Ad Qc]
Ryaniam1981 joins the table at seat #5 
PlayTheBlues4U: raises $0.20 to $0.30
wcb607a: folds 
RiverbendAA: folds 
TheFreeWilly: folds 
Uncalled bet ($0.20) returned to PlayTheBlues4U
PlayTheBlues4U collected $0.25 from pot
PlayTheBlues4U: doesn't show hand 
*** SUMMARY ***
Total pot $0.25 | Rake $0 
Seat 1: RiverbendAA (small blind) folded before Flop
Seat 2: TheFreeWilly (big blind) folded before Flop
Seat 3: PlayTheBlues4U collected ($0.25)
Seat 4: wcb607a (button) folded before Flop (didn't bet)



PokerStars Hand #204445469502:  Hold'em No Limit ($0.05/$0.10 USD) - 2019/10/11 19:23:46 ET
Table 'Elektra' 6-max Seat #1 is the button
Seat 1: RiverbendAA ($10.78 in chips) 
Seat 2: TheFreeWilly ($6.57 in chips) 
Seat 3: PlayTheBlues4U ($25.94 in chips) 
Seat 4: wcb607a ($10.11 in chips) 
Seat 5: Ryaniam1981 ($10 in chips) 
TheFreeWilly: posts small blind $0.05
PlayTheBlues4U: posts big blind $0.10
Ryaniam1981: posts big blind $0.10
*** HOLE CARDS ***
Dealt to PlayTheBlues4U [2h 6h]
wcb607a: folds 
Ryaniam1981: checks 
RiverbendAA: raises $0.50 to $0.60
TheFreeWilly: calls $0.55
PlayTheBlues4U: folds 
Ryaniam1981: folds 
*** FLOP *** [Qc 4s 3h]
TheFreeWilly: checks 
Rannbankura joins the table at seat #6 
RiverbendAA: bets $0.70
TheFreeWilly: folds 
Uncalled bet ($0.70) returned to RiverbendAA
RiverbendAA collected $1.33 from pot
RiverbendAA: doesn't show hand 
*** SUMMARY ***
Total pot $1.40 | Rake $0.07 
Board [Qc 4s 3h]
Seat 1: RiverbendAA (button) collected ($1.33)
Seat 2: TheFreeWilly (small blind) folded on the Flop
Seat 3: PlayTheBlues4U (big blind) folded before Flop
Seat 4: wcb607a folded before Flop (didn't bet)
Seat 5: Ryaniam1981 folded before Flop (didn't bet)



PokerStars Hand #204445469608:  Hold'em No Limit ($0.05/$0.10 USD) - 2019/10/11 19:24:37 ET
Table 'Elektra' 6-max Seat #2 is the button
Seat 1: RiverbendAA ($11.51 in chips) 
Seat 2: TheFreeWilly ($5.97 in chips) 
Seat 3: PlayTheBlues4U ($25.84 in chips) 
Seat 4: wcb607a ($10.11 in chips) 
Seat 5: Ryaniam1981 ($9.90 in chips) 
PlayTheBlues4U: posts small blind $0.05
wcb607a: posts big blind $0.10
Rannbankura: sits out 
*** HOLE CARDS ***
Dealt to PlayTheBlues4U [6s 9d]
Ryaniam1981: calls $0.10
RiverbendAA: folds 
TheFreeWilly: folds 
PlayTheBlues4U: folds 
wcb607a: checks 
*** FLOP *** [Th 6h 7s]
wcb607a: checks 
Ryaniam1981: bets $0.20
wcb607a: folds 
Uncalled bet ($0.20) returned to Ryaniam1981
Ryaniam1981 collected $0.24 from pot
Ryaniam1981: doesn't show hand 
*** SUMMARY ***
Total pot $0.25 | Rake $0.01 
Board [Th 6h 7s]
Seat 1: RiverbendAA folded before Flop (didn't bet)
Seat 2: TheFreeWilly (button) folded before Flop (didn't bet)
Seat 3: PlayTheBlues4U (small blind) folded before Flop
Seat 4: wcb607a (big blind) folded on the Flop
Seat 5: Ryaniam1981 collected ($0.24)



PokerStars Hand #204445469705:  Hold'em No Limit ($0.05/$0.10 USD) - 2019/10/11 19:25:15 ET
Table 'Elektra' 6-max Seat #3 is the button
Seat 1: RiverbendAA ($11.51 in chips) 
Seat 2: TheFreeWilly ($5.97 in chips) 
Seat 3: PlayTheBlues4U ($25.79 in chips) 
Seat 4: wcb607a ($10.01 in chips) 
Seat 5: Ryaniam1981 ($10.04 in chips) 
wcb607a: posts small blind $0.05
Ryaniam1981: posts big blind $0.10
Rannbankura: sits out 
*** HOLE CARDS ***
Dealt to PlayTheBlues4U [7s 2s]
RiverbendAA: folds 
TheFreeWilly: raises $0.15 to $0.25
PlayTheBlues4U: folds 
wcb607a: raises $0.80 to $1.05
Ryaniam1981: folds 
TheFreeWilly: folds 
Uncalled bet ($0.80) returned to wcb607a
wcb607a collected $0.60 from pot
wcb607a: doesn't show hand 
*** SUMMARY ***
Total pot $0.60 | Rake $0 
Seat 1: RiverbendAA folded before Flop (didn't bet)
Seat 2: TheFreeWilly folded before Flop
Seat 3: PlayTheBlues4U (button) folded before Flop (didn't bet)
Seat 4: wcb607a (small blind) collected ($0.60)
Seat 5: Ryaniam1981 (big blind) folded before Flop



PokerStars Hand #204445469782:  Hold'em No Limit ($0.05/$0.10 USD) - 2019/10/11 19:25:45 ET
Table 'Elektra' 6-max Seat #4 is the button
Seat 1: RiverbendAA ($11.51 in chips) 
Seat 2: TheFreeWilly ($5.72 in chips) 
Seat 3: PlayTheBlues4U ($25.79 in chips) 
Seat 4: wcb607a ($10.36 in chips) 
Seat 5: Ryaniam1981 ($9.94 in chips) 
Seat 6: Rannbankura ($8.92 in chips) 
Ryaniam1981: posts small blind $0.05
Rannbankura: posts big blind $0.10
*** HOLE CARDS ***
Dealt to PlayTheBlues4U [3h 6h]
RiverbendAA: folds 
TheFreeWilly: folds 
PlayTheBlues4U: folds 
wcb607a: folds 
Ryaniam1981: calls $0.05
Rannbankura: raises $0.20 to $0.30
Ryaniam1981: folds 
Uncalled bet ($0.20) returned to Rannbankura
Rannbankura collected $0.20 from pot
Rannbankura: doesn't show hand 
*** SUMMARY ***
Total pot $0.20 | Rake $0 
Seat 1: RiverbendAA folded before Flop (didn't bet)
Seat 2: TheFreeWilly folded before Flop (didn't bet)
Seat 3: PlayTheBlues4U folded before Flop (didn't bet)
Seat 4: wcb607a (button) folded before Flop (didn't bet)
Seat 5: Ryaniam1981 (small blind) folded before Flop
Seat 6: Rannbankura (big blind) collected ($0.20)



PokerStars Hand #204445469907:  Hold'em No Limit ($0.05/$0.10 USD) - 2019/10/11 19:26:37 ET
Table 'Elektra' 6-max Seat #6 is the button
Seat 1: RiverbendAA ($11.51 in chips) 
Seat 2: TheFreeWilly ($5.72 in chips) 
Seat 3: PlayTheBlues4U ($25.79 in chips) 
Seat 4: wcb607a ($10.36 in chips) 
Seat 6: Rannbankura ($9.02 in chips) 
RiverbendAA: posts small blind $0.05
TheFreeWilly: posts big blind $0.10
*** HOLE CARDS ***
Dealt to PlayTheBlues4U [Ah 6h]
Ryaniam1981 leaves the table
PlayTheBlues4U: raises $0.20 to $0.30
wcb607a: folds 
Rannbankura: raises $0.75 to $1.05
RiverbendAA: folds 
TheFreeWilly: folds 
PlayTheBlues4U: folds 
Uncalled bet ($0.75) returned to Rannbankura
Rannbankura collected $0.75 from pot
Rannbankura: doesn't show hand 
*** SUMMARY ***
Total pot $0.75 | Rake $0 
Seat 1: RiverbendAA (small blind) folded before Flop
Seat 2: TheFreeWilly (big blind) folded before Flop
Seat 3: PlayTheBlues4U folded before Flop
Seat 4: wcb607a folded before Flop (didn't bet)
Seat 6: Rannbankura (button) collected ($0.75)



PokerStars Hand #204445469941:  Hold'em No Limit ($0.05/$0.10 USD) - 2019/10/11 19:26:55 ET
Table 'Elektra' 6-max Seat #1 is the button
Seat 1: RiverbendAA ($11.46 in chips) 
Seat 2: TheFreeWilly ($5.62 in chips) 
Seat 3: PlayTheBlues4U ($25.49 in chips) 
Seat 4: wcb607a ($10.36 in chips) 
Seat 6: Rannbankura ($9.47 in chips) 
xxzuluzuluxx joins the table at seat #5 
TheFreeWilly: posts small blind $0.05
PlayTheBlues4U: posts big blind $0.10
*** HOLE CARDS ***
Dealt to PlayTheBlues4U [Qd 6h]
wcb607a: raises $0.20 to $0.30
Rannbankura: raises $0.75 to $1.05
RiverbendAA: folds 
TheFreeWilly: folds 
PlayTheBlues4U: folds 
wcb607a: calls $0.75
*** FLOP *** [3h Jc 2s]
wcb607a: checks 
Rannbankura: bets $1.20
wcb607a: calls $1.20
*** TURN *** [3h Jc 2s] [5s]
wcb607a: checks 
Rannbankura: bets $4.40
wcb607a: folds 
Uncalled bet ($4.40) returned to Rannbankura
Rannbankura collected $4.42 from pot
Rannbankura: doesn't show hand 
*** SUMMARY ***
Total pot $4.65 | Rake $0.23 
Board [3h Jc 2s 5s]
Seat 1: RiverbendAA (button) folded before Flop (didn't bet)
Seat 2: TheFreeWilly (small blind) folded before Flop
Seat 3: PlayTheBlues4U (big blind) folded before Flop
Seat 4: wcb607a folded on the Turn
Seat 6: Rannbankura collected ($4.42)



PokerStars Hand #204447288137:  Hold'em No Limit ($0.05/$0.10 USD) - 2019/10/11 19:27:42 ET
Table 'Elektra' 6-max Seat #2 is the button
Seat 1: RiverbendAA ($11.46 in chips) 
Seat 2: TheFreeWilly ($5.57 in chips) 
Seat 3: PlayTheBlues4U ($25.39 in chips) 
Seat 4: wcb607a ($8.11 in chips) 
Seat 6: Rannbankura ($11.64 in chips) 
PlayTheBlues4U: posts small blind $0.05
wcb607a: posts big blind $0.10
xxzuluzuluxx: sits out 
*** HOLE CARDS ***
Dealt to PlayTheBlues4U [Kd 2c]
Rannbankura: calls $0.10
RiverbendAA: folds 
TheFreeWilly: folds 
PlayTheBlues4U: folds 
wcb607a: checks 
*** FLOP *** [Ac Th Kh]
wcb607a: checks 
Rannbankura: checks 
*** TURN *** [Ac Th Kh] [As]
wcb607a: checks 
Rannbankura: checks 
*** RIVER *** [Ac Th Kh As] [7d]
wcb607a: bets $0.10
Rannbankura: folds 
Uncalled bet ($0.10) returned to wcb607a
wcb607a collected $0.24 from pot
wcb607a: doesn't show hand 
*** SUMMARY ***
Total pot $0.25 | Rake $0.01 
Board [Ac Th Kh As 7d]
Seat 1: RiverbendAA folded before Flop (didn't bet)
Seat 2: TheFreeWilly (button) folded before Flop (didn't bet)
Seat 3: PlayTheBlues4U (small blind) folded before Flop
Seat 4: wcb607a (big blind) collected ($0.24)
Seat 6: Rannbankura folded on the River



PokerStars Hand #204447288188:  Hold'em No Limit ($0.05/$0.10 USD) - 2019/10/11 19:28:06 ET
Table 'Elektra' 6-max Seat #3 is the button
Seat 1: RiverbendAA ($11.46 in chips) 
Seat 2: TheFreeWilly ($5.57 in chips) 
Seat 3: PlayTheBlues4U ($25.34 in chips) 
Seat 4: wcb607a ($8.25 in chips) 
Seat 5: xxzuluzuluxx ($4 in chips) 
Seat 6: Rannbankura ($11.54 in chips) 
wcb607a: posts small blind $0.05
xxzuluzuluxx: posts big blind $0.10
*** HOLE CARDS ***
Dealt to PlayTheBlues4U [Jc Ks]
Rannbankura: folds 
RiverbendAA: folds 
TheFreeWilly: folds 
PlayTheBlues4U: raises $0.20 to $0.30
wcb607a: calls $0.25
xxzuluzuluxx: calls $0.20
*** FLOP *** [As 3d 4h]
wcb607a: checks 
xxzuluzuluxx: checks 
PlayTheBlues4U: bets $0.50
wcb607a: calls $0.50
xxzuluzuluxx: folds 
*** TURN *** [As 3d 4h] [3s]
wcb607a: checks 
PlayTheBlues4U: checks 
*** RIVER *** [As 3d 4h 3s] [4d]
wcb607a: checks 
PlayTheBlues4U: checks 
*** SHOW DOWN ***
wcb607a: shows [6s 7s] (two pair, Fours and Threes)
PlayTheBlues4U: shows [Jc Ks] (two pair, Fours and Threes)
wcb607a collected $0.90 from pot
PlayTheBlues4U collected $0.90 from pot
*** SUMMARY ***
Total pot $1.90 | Rake $0.10 
Board [As 3d 4h 3s 4d]
Seat 1: RiverbendAA folded before Flop (didn't bet)
Seat 2: TheFreeWilly folded before Flop (didn't bet)
Seat 3: PlayTheBlues4U (button) showed [Jc Ks] and won ($0.90) with two pair, Fours and Threes
Seat 4: wcb607a (small blind) showed [6s 7s] and won ($0.90) with two pair, Fours and Threes
Seat 5: xxzuluzuluxx (big blind) folded on the Flop
Seat 6: Rannbankura folded before Flop (didn't bet)



PokerStars Hand #204447288328:  Hold'em No Limit ($0.05/$0.10 USD) - 2019/10/11 19:29:20 ET
Table 'Elektra' 6-max Seat #4 is the button
Seat 1: RiverbendAA ($11.46 in chips) 
Seat 2: TheFreeWilly ($5.57 in chips) 
Seat 3: PlayTheBlues4U ($25.44 in chips) 
Seat 4: wcb607a ($8.35 in chips) 
Seat 5: xxzuluzuluxx ($3.70 in chips) 
Seat 6: Rannbankura ($11.54 in chips) 
xxzuluzuluxx: posts small blind $0.05
Rannbankura: posts big blind $0.10
*** HOLE CARDS ***
Dealt to PlayTheBlues4U [6d As]
RiverbendAA: folds 
TheFreeWilly: folds 
PlayTheBlues4U: raises $0.15 to $0.25
wcb607a: raises $0.65 to $0.90
xxzuluzuluxx: calls $0.85
Rannbankura is disconnected 
Rannbankura has timed out while disconnected
Rannbankura: folds 
PlayTheBlues4U: folds 
*** FLOP *** [3c Kh 9h]
xxzuluzuluxx: checks 
wcb607a: bets $1.10
xxzuluzuluxx: folds [5h]
Uncalled bet ($1.10) returned to wcb607a
wcb607a collected $2.04 from pot
wcb607a: doesn't show hand 
*** SUMMARY ***
Total pot $2.15 | Rake $0.11 
Board [3c Kh 9h]
Seat 1: RiverbendAA folded before Flop (didn't bet)
Seat 2: TheFreeWilly folded before Flop (didn't bet)
Seat 3: PlayTheBlues4U folded before Flop
Seat 4: wcb607a (button) collected ($2.04)
Seat 5: xxzuluzuluxx (small blind) folded on the Flop
Seat 6: Rannbankura (big blind) folded before Flop



PokerStars Hand #204447288624:  Hold'em No Limit ($0.05/$0.10 USD) - 2019/10/11 19:31:48 ET
Table 'Elektra' 6-max Seat #5 is the button
Seat 1: RiverbendAA ($11.46 in chips) 
Seat 2: TheFreeWilly ($9.57 in chips) 
Seat 3: PlayTheBlues4U ($25.19 in chips) 
Seat 4: wcb607a ($9.49 in chips) 
Seat 5: xxzuluzuluxx ($2.80 in chips) 
RiverbendAA: posts small blind $0.05
TheFreeWilly: posts big blind $0.10
*** HOLE CARDS ***
Dealt to PlayTheBlues4U [Jc Th]
PlayTheBlues4U: folds 
wcb607a: folds 
xxzuluzuluxx: calls $0.10
RiverbendAA: folds 
TheFreeWilly: checks 
*** FLOP *** [Kc 3d 9c]
TheFreeWilly: checks 
xxzuluzuluxx: bets $0.10
TheFreeWilly: calls $0.10
*** TURN *** [Kc 3d 9c] [5h]
TheFreeWilly: checks 
xxzuluzuluxx: bets $0.10
TheFreeWilly: calls $0.10
*** RIVER *** [Kc 3d 9c 5h] [2s]
TheFreeWilly: bets $0.40
xxzuluzuluxx: raises $0.40 to $0.80
TheFreeWilly: folds 
Uncalled bet ($0.40) returned to xxzuluzuluxx
xxzuluzuluxx collected $1.38 from pot
xxzuluzuluxx: doesn't show hand 
*** SUMMARY ***
Total pot $1.45 | Rake $0.07 
Board [Kc 3d 9c 5h 2s]
Seat 1: RiverbendAA (small blind) folded before Flop
Seat 2: TheFreeWilly (big blind) folded on the River
Seat 3: PlayTheBlues4U folded before Flop (didn't bet)
Seat 4: wcb607a folded before Flop (didn't bet)
Seat 5: xxzuluzuluxx (button) collected ($1.38)



PokerStars Hand #204447288717:  Hold'em No Limit ($0.05/$0.10 USD) - 2019/10/11 19:32:30 ET
Table 'Elektra' 6-max Seat #1 is the button
Seat 1: RiverbendAA ($11.41 in chips) 
Seat 2: TheFreeWilly ($8.87 in chips) 
Seat 3: PlayTheBlues4U ($25.19 in chips) 
Seat 4: wcb607a ($9.49 in chips) 
Seat 5: xxzuluzuluxx ($3.48 in chips) 
TheFreeWilly: posts small blind $0.05
PlayTheBlues4U: posts big blind $0.10
*** HOLE CARDS ***
Dealt to PlayTheBlues4U [9h 6d]
wcb607a: folds 
xxzuluzuluxx: raises $0.10 to $0.20
RiverbendAA: folds 
TheFreeWilly: folds 
PlayTheBlues4U: calls $0.10
*** FLOP *** [9c 3d Ac]
PlayTheBlues4U: checks 
xxzuluzuluxx: bets $0.10
PlayTheBlues4U: calls $0.10
*** TURN *** [9c 3d Ac] [As]
PlayTheBlues4U: checks 
xxzuluzuluxx: bets $0.10
PlayTheBlues4U: calls $0.10
*** RIVER *** [9c 3d Ac As] [4d]
PlayTheBlues4U: checks 
xxzuluzuluxx: checks 
*** SHOW DOWN ***
PlayTheBlues4U: shows [9h 6d] (two pair, Aces and Nines)
xxzuluzuluxx: mucks hand 
PlayTheBlues4U collected $0.81 from pot
*** SUMMARY ***
Total pot $0.85 | Rake $0.04 
Board [9c 3d Ac As 4d]
Seat 1: RiverbendAA (button) folded before Flop (didn't bet)
Seat 2: TheFreeWilly (small blind) folded before Flop
Seat 3: PlayTheBlues4U (big blind) showed [9h 6d] and won ($0.81) with two pair, Aces and Nines
Seat 4: wcb607a folded before Flop (didn't bet)
Seat 5: xxzuluzuluxx mucked [Kd Th]



PokerStars Hand #204447288764:  Hold'em No Limit ($0.05/$0.10 USD) - 2019/10/11 19:32:53 ET
Table 'Elektra' 6-max Seat #2 is the button
Seat 1: RiverbendAA ($11.41 in chips) 
Seat 2: TheFreeWilly ($8.82 in chips) 
Seat 3: PlayTheBlues4U ($25.60 in chips) 
Seat 4: wcb607a ($9.49 in chips) 
Seat 5: xxzuluzuluxx ($3.08 in chips) 
PlayTheBlues4U: posts small blind $0.05
wcb607a: posts big blind $0.10
*** HOLE CARDS ***
Dealt to PlayTheBlues4U [4c 5h]
xxzuluzuluxx: calls $0.10
RiverbendAA: folds 
TheFreeWilly: folds 
PlayTheBlues4U: folds 
wcb607a: checks 
*** FLOP *** [Kc 7c 6h]
wcb607a: checks 
xxzuluzuluxx: checks 
*** TURN *** [Kc 7c 6h] [9s]
wcb607a: checks 
xxzuluzuluxx: checks 
*** RIVER *** [Kc 7c 6h 9s] [Js]
wcb607a: checks 
xxzuluzuluxx: bets $0.10
wcb607a: folds 
Uncalled bet ($0.10) returned to xxzuluzuluxx
xxzuluzuluxx collected $0.24 from pot
xxzuluzuluxx: doesn't show hand 
*** SUMMARY ***
Total pot $0.25 | Rake $0.01 
Board [Kc 7c 6h 9s Js]
Seat 1: RiverbendAA folded before Flop (didn't bet)
Seat 2: TheFreeWilly (button) folded before Flop (didn't bet)
Seat 3: PlayTheBlues4U (small blind) folded before Flop
Seat 4: wcb607a (big blind) folded on the River
Seat 5: xxzuluzuluxx collected ($0.24)



PokerStars Hand #204447288829:  Hold'em No Limit ($0.05/$0.10 USD) - 2019/10/11 19:33:33 ET
Table 'Elektra' 6-max Seat #3 is the button
Seat 1: RiverbendAA ($11.41 in chips) 
Seat 2: TheFreeWilly ($8.82 in chips) 
Seat 3: PlayTheBlues4U ($25.55 in chips) 
Seat 4: wcb607a ($9.39 in chips) 
Seat 5: xxzuluzuluxx ($3.22 in chips) 
wcb607a: posts small blind $0.05
xxzuluzuluxx: posts big blind $0.10
Rannbankura: sits out 
*** HOLE CARDS ***
Dealt to PlayTheBlues4U [Ad 5s]
RiverbendAA: folds 
TheFreeWilly: folds 
PlayTheBlues4U: raises $0.20 to $0.30
wcb607a: folds 
xxzuluzuluxx: calls $0.20
*** FLOP *** [6c Td Jh]
xxzuluzuluxx: checks 
PlayTheBlues4U: checks 
*** TURN *** [6c Td Jh] [Qs]
xxzuluzuluxx: bets $0.31
PlayTheBlues4U: folds 
Uncalled bet ($0.31) returned to xxzuluzuluxx
xxzuluzuluxx collected $0.62 from pot
xxzuluzuluxx: doesn't show hand 
*** SUMMARY ***
Total pot $0.65 | Rake $0.03 
Board [6c Td Jh Qs]
Seat 1: RiverbendAA folded before Flop (didn't bet)
Seat 2: TheFreeWilly folded before Flop (didn't bet)
Seat 3: PlayTheBlues4U (button) folded on the Turn
Seat 4: wcb607a (small blind) folded before Flop
Seat 5: xxzuluzuluxx (big blind) collected ($0.62)



PokerStars Hand #204447288884:  Hold'em No Limit ($0.05/$0.10 USD) - 2019/10/11 19:34:03 ET
Table 'Elektra' 6-max Seat #4 is the button
Seat 1: RiverbendAA ($11.41 in chips) 
Seat 2: TheFreeWilly ($8.82 in chips) 
Seat 3: PlayTheBlues4U ($25.25 in chips) 
Seat 4: wcb607a ($9.34 in chips) 
Seat 5: xxzuluzuluxx ($3.54 in chips) 
Seat 6: Rannbankura ($11.44 in chips) 
xxzuluzuluxx: posts small blind $0.05
Rannbankura: posts big blind $0.10
*** HOLE CARDS ***
Dealt to PlayTheBlues4U [3h 8s]
RiverbendAA: folds 
TheFreeWilly: raises $0.20 to $0.30
PlayTheBlues4U: folds 
wcb607a: raises $0.85 to $1.15
xxzuluzuluxx: folds 
Rannbankura: folds 
TheFreeWilly: folds 
Uncalled bet ($0.85) returned to wcb607a
wcb607a collected $0.75 from pot
wcb607a: doesn't show hand 
*** SUMMARY ***
Total pot $0.75 | Rake $0 
Seat 1: RiverbendAA folded before Flop (didn't bet)
Seat 2: TheFreeWilly folded before Flop
Seat 3: PlayTheBlues4U folded before Flop (didn't bet)
Seat 4: wcb607a (button) collected ($0.75)
Seat 5: xxzuluzuluxx (small blind) folded before Flop
Seat 6: Rannbankura (big blind) folded before Flop



PokerStars Hand #204447288960:  Hold'em No Limit ($0.05/$0.10 USD) - 2019/10/11 19:34:42 ET
Table 'Elektra' 6-max Seat #5 is the button
Seat 1: RiverbendAA ($11.41 in chips) 
Seat 2: TheFreeWilly ($8.52 in chips) 
Seat 3: PlayTheBlues4U ($25.25 in chips) 
Seat 4: wcb607a ($9.79 in chips) 
Seat 5: xxzuluzuluxx ($3.49 in chips) 
Seat 6: Rannbankura ($11.34 in chips) 
Rannbankura: posts small blind $0.05
RiverbendAA: posts big blind $0.10
*** HOLE CARDS ***
Dealt to PlayTheBlues4U [5h 6h]
TheFreeWilly: folds 
PlayTheBlues4U: folds 
wcb607a: folds 
xxzuluzuluxx: calls $0.10
Rannbankura: calls $0.05
RiverbendAA: checks 
*** FLOP *** [5d Th 6s]
Rannbankura: checks 
RiverbendAA: bets $0.20
xxzuluzuluxx: calls $0.20
Rannbankura: folds 
*** TURN *** [5d Th 6s] [3s]
RiverbendAA: bets $0.30
xxzuluzuluxx: folds [8h]
Uncalled bet ($0.30) returned to RiverbendAA
RiverbendAA collected $0.66 from pot
RiverbendAA: doesn't show hand 
*** SUMMARY ***
Total pot $0.70 | Rake $0.04 
Board [5d Th 6s 3s]
Seat 1: RiverbendAA (big blind) collected ($0.66)
Seat 2: TheFreeWilly folded before Flop (didn't bet)
Seat 3: PlayTheBlues4U folded before Flop (didn't bet)
Seat 4: wcb607a folded before Flop (didn't bet)
Seat 5: xxzuluzuluxx (button) folded on the Turn
Seat 6: Rannbankura (small blind) folded on the Flop



PokerStars Hand #204447289079:  Hold'em No Limit ($0.05/$0.10 USD) - 2019/10/11 19:35:43 ET
Table 'Elektra' 6-max Seat #6 is the button
Seat 1: RiverbendAA ($11.77 in chips) 
Seat 2: TheFreeWilly ($8.52 in chips) 
Seat 3: PlayTheBlues4U ($25.25 in chips) 
Seat 4: wcb607a ($9.79 in chips) 
Seat 5: xxzuluzuluxx ($3.19 in chips) 
Seat 6: Rannbankura ($11.24 in chips) 
RiverbendAA: posts small blind $0.05
TheFreeWilly: posts big blind $0.10
*** HOLE CARDS ***
Dealt to PlayTheBlues4U [9h Tc]
PlayTheBlues4U: folds 
wcb607a: folds 
xxzuluzuluxx: folds 
Rannbankura: folds 
RiverbendAA: raises $0.15 to $0.25
TheFreeWilly: calls $0.15
*** FLOP *** [Kd Kc 7s]
RiverbendAA: bets $0.24
TheFreeWilly: calls $0.24
*** TURN *** [Kd Kc 7s] [As]
RiverbendAA: checks 
TheFreeWilly: checks 
*** RIVER *** [Kd Kc 7s As] [Kh]
RiverbendAA: checks 
TheFreeWilly: bets $0.35
RiverbendAA: folds 
Uncalled bet ($0.35) returned to TheFreeWilly
TheFreeWilly collected $0.93 from pot
TheFreeWilly: doesn't show hand 
*** SUMMARY ***
Total pot $0.98 | Rake $0.05 
Board [Kd Kc 7s As Kh]
Seat 1: RiverbendAA (small blind) folded on the River
Seat 2: TheFreeWilly (big blind) collected ($0.93)
Seat 3: PlayTheBlues4U folded before Flop (didn't bet)
Seat 4: wcb607a folded before Flop (didn't bet)
Seat 5: xxzuluzuluxx folded before Flop (didn't bet)
Seat 6: Rannbankura (button) folded before Flop (didn't bet)



PokerStars Hand #204447289195:  Hold'em No Limit ($0.05/$0.10 USD) - 2019/10/11 19:36:47 ET
Table 'Elektra' 6-max Seat #1 is the button
Seat 1: RiverbendAA ($11.28 in chips) 
Seat 2: TheFreeWilly ($8.96 in chips) 
Seat 3: PlayTheBlues4U ($25.25 in chips) 
Seat 4: wcb607a ($9.79 in chips) 
Seat 5: xxzuluzuluxx ($3.19 in chips) 
Seat 6: Rannbankura ($11.24 in chips) 
TheFreeWilly: posts small blind $0.05
PlayTheBlues4U: posts big blind $0.10
*** HOLE CARDS ***
Dealt to PlayTheBlues4U [Qh Jd]
wcb607a: folds 
xxzuluzuluxx: calls $0.10
Rannbankura: raises $0.35 to $0.45
RiverbendAA: folds 
TheFreeWilly: folds 
PlayTheBlues4U: folds 
xxzuluzuluxx: calls $0.35
*** FLOP *** [6h 9c Jc]
xxzuluzuluxx: checks 
Rannbankura: bets $0.60
xxzuluzuluxx: raises $0.60 to $1.20
Rannbankura: calls $0.60
*** TURN *** [6h 9c Jc] [7h]
xxzuluzuluxx: bets $1.54 and is all-in
Rannbankura: calls $1.54
*** RIVER *** [6h 9c Jc 7h] [6s]
*** SHOW DOWN ***
xxzuluzuluxx: shows [Ks Js] (two pair, Jacks and Sixes)
Rannbankura: shows [4d 6d] (three of a kind, Sixes)
Rannbankura collected $6.20 from pot
*** SUMMARY ***
Total pot $6.53 | Rake $0.33 
Board [6h 9c Jc 7h 6s]
Seat 1: RiverbendAA (button) folded before Flop (didn't bet)
Seat 2: TheFreeWilly (small blind) folded before Flop
Seat 3: PlayTheBlues4U (big blind) folded before Flop
Seat 4: wcb607a folded before Flop (didn't bet)
Seat 5: xxzuluzuluxx showed [Ks Js] and lost with two pair, Jacks and Sixes
Seat 6: Rannbankura showed [4d 6d] and won ($6.20) with three of a kind, Sixes



PokerStars Hand #204447289273:  Hold'em No Limit ($0.05/$0.10 USD) - 2019/10/11 19:37:27 ET
Table 'Elektra' 6-max Seat #2 is the button
Seat 1: RiverbendAA ($11.28 in chips) 
Seat 2: TheFreeWilly ($8.91 in chips) 
Seat 3: PlayTheBlues4U ($25.15 in chips) 
Seat 4: wcb607a ($9.79 in chips) 
Seat 6: Rannbankura ($14.25 in chips) 
PlayTheBlues4U: posts small blind $0.05
wcb607a: posts big blind $0.10
*** HOLE CARDS ***
Dealt to PlayTheBlues4U [5c 4h]
Rannbankura: folds 
RiverbendAA: folds 
TheFreeWilly: folds 
PlayTheBlues4U: calls $0.05
wcb607a: checks 
*** FLOP *** [8d 4c Kd]
PlayTheBlues4U: checks 
wcb607a: bets $0.10
PlayTheBlues4U: calls $0.10
*** TURN *** [8d 4c Kd] [As]
PlayTheBlues4U: checks 
wcb607a: checks 
*** RIVER *** [8d 4c Kd As] [Jc]
PlayTheBlues4U: checks 
wcb607a: checks 
*** SHOW DOWN ***
PlayTheBlues4U: shows [5c 4h] (a pair of Fours)
wcb607a: mucks hand 
PlayTheBlues4U collected $0.38 from pot
*** SUMMARY ***
Total pot $0.40 | Rake $0.02 
Board [8d 4c Kd As Jc]
Seat 1: RiverbendAA folded before Flop (didn't bet)
Seat 2: TheFreeWilly (button) folded before Flop (didn't bet)
Seat 3: PlayTheBlues4U (small blind) showed [5c 4h] and won ($0.38) with a pair of Fours
Seat 4: wcb607a (big blind) mucked [9c Qs]
Seat 6: Rannbankura folded before Flop (didn't bet)



PokerStars Hand #204447289377:  Hold'em No Limit ($0.05/$0.10 USD) - 2019/10/11 19:38:20 ET
Table 'Elektra' 6-max Seat #3 is the button
Seat 1: RiverbendAA ($11.28 in chips) 
Seat 2: TheFreeWilly ($8.91 in chips) 
Seat 3: PlayTheBlues4U ($25.33 in chips) 
Seat 4: wcb607a ($9.59 in chips) 
Seat 6: Rannbankura ($14.25 in chips) 
wcb607a: posts small blind $0.05
Rannbankura: posts big blind $0.10
*** HOLE CARDS ***
Dealt to PlayTheBlues4U [Tc 9s]
RiverbendAA: folds 
TheFreeWilly: raises $0.20 to $0.30
PlayTheBlues4U: folds 
wcb607a: folds 
Rannbankura: calls $0.20
*** FLOP *** [3d 4s 4d]
Rannbankura: checks 
TheFreeWilly: bets $0.35
Rannbankura: calls $0.35
*** TURN *** [3d 4s 4d] [Js]
Rannbankura: checks 
TheFreeWilly: bets $0.87
Rannbankura: folds 
Uncalled bet ($0.87) returned to TheFreeWilly
TheFreeWilly collected $1.28 from pot
TheFreeWilly: doesn't show hand 
*** SUMMARY ***
Total pot $1.35 | Rake $0.07 
Board [3d 4s 4d Js]
Seat 1: RiverbendAA folded before Flop (didn't bet)
Seat 2: TheFreeWilly collected ($1.28)
Seat 3: PlayTheBlues4U (button) folded before Flop (didn't bet)
Seat 4: wcb607a (small blind) folded before Flop
Seat 6: Rannbankura (big blind) folded on the Turn



PokerStars Hand #204644608641:  Hold'em No Limit ($0.05/$0.10 USD) - 2019/10/17 18:20:05 ET
Table 'Crater' 6-max Seat #2 is the button
Seat 1: Ionix1 ($5.10 in chips) 
Seat 2: okletsflip ($5.25 in chips) 
Seat 3: yoli0820 ($10.08 in chips) 
Seat 4: PlayTheBlues4U ($10 in chips) 
Seat 5: JoeDude60 ($9.97 in chips) 
Seat 6: maccount ($10.58 in chips) 
yoli0820: posts small blind $0.05
PlayTheBlues4U: posts big blind $0.10
*** HOLE CARDS ***
Dealt to PlayTheBlues4U [Kh 5s]
yoli0820 said, "lol"
JoeDude60: folds 
maccount: folds 
Ionix1: calls $0.10
okletsflip: calls $0.10
yoli0820: calls $0.05
Ionix1 said, "Full table gl all!"
okletsflip said, ":)"
PlayTheBlues4U: checks 
*** FLOP *** [6s Ts 4s]
yoli0820: bets $0.20
PlayTheBlues4U: folds 
Ionix1: calls $0.20
yoli0820 said, "site.is a joke"
okletsflip: raises $0.30 to $0.50
yoli0820: calls $0.30
Ionix1: calls $0.30
*** TURN *** [6s Ts 4s] [Qh]
yoli0820: checks 
Ionix1: checks 
okletsflip: checks 
*** RIVER *** [6s Ts 4s Qh] [Qs]
yoli0820: bets $0.80
Ionix1: raises $0.80 to $1.60
okletsflip: raises $3.05 to $4.65 and is all-in
yoli0820: folds 
Ionix1: calls $2.90 and is all-in
Uncalled bet ($0.15) returned to okletsflip
*** SHOW DOWN ***
okletsflip: shows [As 4d] (a flush, Ace high)
Ionix1: shows [8d Ks] (a flush, King high)
okletsflip collected $11.12 from pot
*** SUMMARY ***
Total pot $11.70 | Rake $0.58 
Board [6s Ts 4s Qh Qs]
Seat 1: Ionix1 showed [8d Ks] and lost with a flush, King high
Seat 2: okletsflip (button) showed [As 4d] and won ($11.12) with a flush, Ace high
Seat 3: yoli0820 (small blind) folded on the River
Seat 4: PlayTheBlues4U (big blind) folded on the Flop
Seat 5: JoeDude60 folded before Flop (didn't bet)
Seat 6: maccount folded before Flop (didn't bet)



PokerStars Hand #204644608748:  Hold'em No Limit ($0.05/$0.10 USD) - 2019/10/17 18:20:51 ET
Table 'Crater' 6-max Seat #3 is the button
Seat 2: okletsflip ($11.27 in chips) 
Seat 3: yoli0820 ($8.68 in chips) 
Seat 4: PlayTheBlues4U ($9.90 in chips) 
Seat 5: JoeDude60 ($9.97 in chips) 
Seat 6: maccount ($10.58 in chips) 
PlayTheBlues4U: posts small blind $0.05
JoeDude60: posts big blind $0.10
*** HOLE CARDS ***
Dealt to PlayTheBlues4U [Js Td]
maccount: folds 
okletsflip: calls $0.10
yoli0820: calls $0.10
yoli0820 said, "full table duh duh duh"
Ionix1 said, "Oof"
PlayTheBlues4U: calls $0.05
JoeDude60: checks 
*** FLOP *** [4c 6h 5d]
PlayTheBlues4U: checks 
JoeDude60: bets $0.10
okletsflip: calls $0.10
yoli0820: calls $0.10
PlayTheBlues4U: folds 
*** TURN *** [4c 6h 5d] [7h]
JoeDude60: checks 
okletsflip: checks 
yoli0820: checks 
*** RIVER *** [4c 6h 5d 7h] [Tc]
JoeDude60: checks 
okletsflip: bets $0.20
yoli0820: raises $0.50 to $0.70
JoeDude60: folds 
okletsflip: folds 
Uncalled bet ($0.50) returned to yoli0820
yoli0820 collected $1.04 from pot
yoli0820: doesn't show hand 
*** SUMMARY ***
Total pot $1.10 | Rake $0.06 
Board [4c 6h 5d 7h Tc]
Seat 2: okletsflip folded on the River
Seat 3: yoli0820 (button) collected ($1.04)
Seat 4: PlayTheBlues4U (small blind) folded on the Flop
Seat 5: JoeDude60 (big blind) folded on the River
Seat 6: maccount folded before Flop (didn't bet)



PokerStars Hand #204644608915:  Hold'em No Limit ($0.05/$0.10 USD) - 2019/10/17 18:22:03 ET
Table 'Crater' 6-max Seat #4 is the button
Seat 1: Ionix1 ($5 in chips) 
Seat 2: okletsflip ($10.87 in chips) 
Seat 3: yoli0820 ($9.32 in chips) 
Seat 4: PlayTheBlues4U ($9.80 in chips) 
Seat 5: JoeDude60 ($9.77 in chips) 
Seat 6: maccount ($10.58 in chips) 
JoeDude60: posts small blind $0.05
maccount: posts big blind $0.10
*** HOLE CARDS ***
Dealt to PlayTheBlues4U [3h 8h]
Ionix1: calls $0.10
okletsflip: calls $0.10
yoli0820: calls $0.10
yoli0820 said, "lol"
PlayTheBlues4U: folds 
JoeDude60: raises $0.50 to $0.60
maccount: folds 
Ionix1: folds 
okletsflip: folds 
yoli0820: folds 
Uncalled bet ($0.50) returned to JoeDude60
JoeDude60 collected $0.50 from pot
JoeDude60: doesn't show hand 
*** SUMMARY ***
Total pot $0.50 | Rake $0 
Seat 1: Ionix1 folded before Flop
Seat 2: okletsflip folded before Flop
Seat 3: yoli0820 folded before Flop
Seat 4: PlayTheBlues4U (button) folded before Flop (didn't bet)
Seat 5: JoeDude60 (small blind) collected ($0.50)
Seat 6: maccount (big blind) folded before Flop



PokerStars Hand #204644608976:  Hold'em No Limit ($0.05/$0.10 USD) - 2019/10/17 18:22:28 ET
Table 'Crater' 6-max Seat #5 is the button
Seat 1: Ionix1 ($4.90 in chips) 
Seat 2: okletsflip ($10.77 in chips) 
Seat 3: yoli0820 ($9.22 in chips) 
Seat 4: PlayTheBlues4U ($9.80 in chips) 
Seat 5: JoeDude60 ($10.17 in chips) 
Seat 6: maccount ($10.48 in chips) 
maccount: posts small blind $0.05
Ionix1: posts big blind $0.10
*** HOLE CARDS ***
Dealt to PlayTheBlues4U [8d Jd]
okletsflip: calls $0.10
yoli0820: folds 
PlayTheBlues4U: folds 
JoeDude60: calls $0.10
maccount: calls $0.05
Ionix1: checks 
*** FLOP *** [6c Ks Jc]
maccount: checks 
Ionix1: checks 
okletsflip: checks 
JoeDude60: bets $0.10
maccount: folds 
Ionix1: calls $0.10
okletsflip: folds 
*** TURN *** [6c Ks Jc] [2d]
Ionix1: checks 
JoeDude60: bets $0.10
Ionix1: calls $0.10
*** RIVER *** [6c Ks Jc 2d] [Tc]
Ionix1: checks 
JoeDude60: checks 
*** SHOW DOWN ***
Ionix1: shows [5d Jh] (a pair of Jacks)
JoeDude60: mucks hand 
Ionix1 collected $0.76 from pot
*** SUMMARY ***
Total pot $0.80 | Rake $0.04 
Board [6c Ks Jc 2d Tc]
Seat 1: Ionix1 (big blind) showed [5d Jh] and won ($0.76) with a pair of Jacks
Seat 2: okletsflip folded on the Flop
Seat 3: yoli0820 folded before Flop (didn't bet)
Seat 4: PlayTheBlues4U folded before Flop (didn't bet)
Seat 5: JoeDude60 (button) mucked [Td Qd]
Seat 6: maccount (small blind) folded on the Flop



PokerStars Hand #204644609066:  Hold'em No Limit ($0.05/$0.10 USD) - 2019/10/17 18:23:03 ET
Table 'Crater' 6-max Seat #6 is the button
Seat 1: Ionix1 ($5.36 in chips) 
Seat 2: okletsflip ($10.67 in chips) 
Seat 3: yoli0820 ($9.22 in chips) 
Seat 4: PlayTheBlues4U ($9.80 in chips) 
Seat 5: JoeDude60 ($9.87 in chips) 
Seat 6: maccount ($10.38 in chips) 
Ionix1: posts small blind $0.05
okletsflip: posts big blind $0.10
*** HOLE CARDS ***
Dealt to PlayTheBlues4U [7h 9s]
yoli0820: raises $0.10 to $0.20
PlayTheBlues4U: folds 
JoeDude60: folds 
maccount: folds 
Ionix1: calls $0.15
okletsflip: calls $0.10
*** FLOP *** [4d 7c Kh]
Ionix1: checks 
okletsflip: checks 
yoli0820: bets $0.30
Ionix1: folds 
okletsflip: folds 
Uncalled bet ($0.30) returned to yoli0820
yoli0820 collected $0.57 from pot
yoli0820: doesn't show hand 
*** SUMMARY ***
Total pot $0.60 | Rake $0.03 
Board [4d 7c Kh]
Seat 1: Ionix1 (small blind) folded on the Flop
Seat 2: okletsflip (big blind) folded on the Flop
Seat 3: yoli0820 collected ($0.57)
Seat 4: PlayTheBlues4U folded before Flop (didn't bet)
Seat 5: JoeDude60 folded before Flop (didn't bet)
Seat 6: maccount (button) folded before Flop (didn't bet)



PokerStars Hand #204644609122:  Hold'em No Limit ($0.05/$0.10 USD) - 2019/10/17 18:23:27 ET
Table 'Crater' 6-max Seat #1 is the button
Seat 1: Ionix1 ($5.16 in chips) 
Seat 2: okletsflip ($10.47 in chips) 
Seat 4: PlayTheBlues4U ($9.80 in chips) 
Seat 5: JoeDude60 ($9.87 in chips) 
Seat 6: maccount ($10.38 in chips) 
okletsflip: posts small blind $0.05
yoli0820: is sitting out 
PlayTheBlues4U: posts big blind $0.10
*** HOLE CARDS ***
Dealt to PlayTheBlues4U [8h As]
JoeDude60: calls $0.10
maccount: folds 
Ionix1: folds 
okletsflip: folds 
PlayTheBlues4U: raises $0.20 to $0.30
JoeDude60: calls $0.20
*** FLOP *** [5c Kh 7s]
PlayTheBlues4U: bets $0.40
JoeDude60: folds 
Uncalled bet ($0.40) returned to PlayTheBlues4U
PlayTheBlues4U collected $0.62 from pot
PlayTheBlues4U: doesn't show hand 
*** SUMMARY ***
Total pot $0.65 | Rake $0.03 
Board [5c Kh 7s]
Seat 1: Ionix1 (button) folded before Flop (didn't bet)
Seat 2: okletsflip (small blind) folded before Flop
Seat 4: PlayTheBlues4U (big blind) collected ($0.62)
Seat 5: JoeDude60 folded on the Flop
Seat 6: maccount folded before Flop (didn't bet)



PokerStars Hand #204644609216:  Hold'em No Limit ($0.05/$0.10 USD) - 2019/10/17 18:24:04 ET
Table 'Crater' 6-max Seat #2 is the button
Seat 1: Ionix1 ($5.16 in chips) 
Seat 2: okletsflip ($10.42 in chips) 
Seat 4: PlayTheBlues4U ($10.12 in chips) 
Seat 5: JoeDude60 ($9.57 in chips) 
Seat 6: maccount ($10.38 in chips) 
PlayTheBlues4U: posts small blind $0.05
JoeDude60: posts big blind $0.10
*** HOLE CARDS ***
Dealt to PlayTheBlues4U [2h 9s]
maccount: folds 
Ionix1: calls $0.10
okletsflip: raises $0.10 to $0.20
PlayTheBlues4U: folds 
JoeDude60: calls $0.10
Ionix1: calls $0.10
*** FLOP *** [Qh 3h Kh]
JoeDude60: checks 
Ionix1: checks 
okletsflip: bets $0.20
JoeDude60: folds 
Ionix1: folds 
Uncalled bet ($0.20) returned to okletsflip
okletsflip collected $0.62 from pot
okletsflip: doesn't show hand 
*** SUMMARY ***
Total pot $0.65 | Rake $0.03 
Board [Qh 3h Kh]
Seat 1: Ionix1 folded on the Flop
Seat 2: okletsflip (button) collected ($0.62)
Seat 4: PlayTheBlues4U (small blind) folded before Flop
Seat 5: JoeDude60 (big blind) folded on the Flop
Seat 6: maccount folded before Flop (didn't bet)



PokerStars Hand #204644609276:  Hold'em No Limit ($0.05/$0.10 USD) - 2019/10/17 18:24:30 ET
Table 'Crater' 6-max Seat #4 is the button
Seat 1: Ionix1 ($4.96 in chips) 
Seat 2: okletsflip ($10.84 in chips) 
Seat 3: yoli0820 ($9.59 in chips) 
Seat 4: PlayTheBlues4U ($10.07 in chips) 
Seat 5: JoeDude60 ($9.37 in chips) 
Seat 6: maccount ($10.38 in chips) 
JoeDude60: posts small blind $0.05
maccount: posts big blind $0.10
yoli0820: posts small & big blinds $0.15
*** HOLE CARDS ***
Dealt to PlayTheBlues4U [Qh 8c]
Ionix1: calls $0.10
okletsflip: folds 
yoli0820: checks 
PlayTheBlues4U: folds 
JoeDude60: folds 
maccount: checks 
*** FLOP *** [Js 5c 3h]
maccount: checks 
Ionix1: bets $0.10
yoli0820: calls $0.10
maccount: calls $0.10
*** TURN *** [Js 5c 3h] [5h]
maccount: checks 
Ionix1: bets $0.30
yoli0820: calls $0.30
maccount: folds 
*** RIVER *** [Js 5c 3h 5h] [Ah]
Ionix1: bets $1
yoli0820: raises $8.04 to $9.04 and is all-in
Ionix1: calls $3.46 and is all-in
Uncalled bet ($4.58) returned to yoli0820
*** SHOW DOWN ***
yoli0820: shows [9h Jh] (a flush, Ace high)
Ionix1: shows [3s 3d] (a full house, Threes full of Fives)
Ionix1 collected $9.71 from pot
*** SUMMARY ***
Total pot $10.22 | Rake $0.51 
Board [Js 5c 3h 5h Ah]
Seat 1: Ionix1 showed [3s 3d] and won ($9.71) with a full house, Threes full of Fives
Seat 2: okletsflip folded before Flop (didn't bet)
Seat 3: yoli0820 showed [9h Jh] and lost with a flush, Ace high
Seat 4: PlayTheBlues4U (button) folded before Flop (didn't bet)
Seat 5: JoeDude60 (small blind) folded before Flop
Seat 6: maccount (big blind) folded on the Turn



PokerStars Hand #204644609381:  Hold'em No Limit ($0.05/$0.10 USD) - 2019/10/17 18:25:20 ET
Table 'Crater' 6-max Seat #5 is the button
Seat 1: Ionix1 ($9.71 in chips) 
Seat 3: yoli0820 ($4.58 in chips) 
Seat 4: PlayTheBlues4U ($10.07 in chips) 
Seat 5: JoeDude60 ($9.32 in chips) 
Seat 6: maccount ($10.18 in chips) 
maccount: posts small blind $0.05
Ionix1: posts big blind $0.10
*** HOLE CARDS ***
Dealt to PlayTheBlues4U [2s 8h]
yoli0820: raises $0.25 to $0.35
PlayTheBlues4U: folds 
JoeDude60: folds 
maccount: folds 
Ionix1: folds 
Uncalled bet ($0.25) returned to yoli0820
yoli0820 collected $0.25 from pot
yoli0820: doesn't show hand 
*** SUMMARY ***
Total pot $0.25 | Rake $0 
Seat 1: Ionix1 (big blind) folded before Flop
Seat 3: yoli0820 collected ($0.25)
Seat 4: PlayTheBlues4U folded before Flop (didn't bet)
Seat 5: JoeDude60 (button) folded before Flop (didn't bet)
Seat 6: maccount (small blind) folded before Flop



PokerStars Hand #204644609414:  Hold'em No Limit ($0.05/$0.10 USD) - 2019/10/17 18:25:33 ET
Table 'Crater' 6-max Seat #6 is the button
Seat 1: Ionix1 ($9.61 in chips) 
Seat 3: yoli0820 ($4.73 in chips) 
Seat 4: PlayTheBlues4U ($10.07 in chips) 
Seat 5: JoeDude60 ($9.32 in chips) 
Seat 6: maccount ($10.13 in chips) 
Ionix1: posts small blind $0.05
yoli0820: posts big blind $0.10
*** HOLE CARDS ***
Dealt to PlayTheBlues4U [5d 5c]
PlayTheBlues4U: raises $0.20 to $0.30
JoeDude60: calls $0.30
maccount: folds 
Ionix1: folds 
yoli0820: calls $0.20
*** FLOP *** [3c 4c 5s]
yoli0820: checks 
PlayTheBlues4U: bets $0.80
JoeDude60: folds 
yoli0820: calls $0.80
*** TURN *** [3c 4c 5s] [7s]
yoli0820: checks 
PlayTheBlues4U: checks 
*** RIVER *** [3c 4c 5s 7s] [9h]
yoli0820: bets $3.63 and is all-in
yoli0820 said, "a5"
PlayTheBlues4U: folds [5c]
Uncalled bet ($3.63) returned to yoli0820
yoli0820 collected $2.42 from pot
yoli0820: doesn't show hand 
*** SUMMARY ***
Total pot $2.55 | Rake $0.13 
Board [3c 4c 5s 7s 9h]
Seat 1: Ionix1 (small blind) folded before Flop
Seat 3: yoli0820 (big blind) collected ($2.42)
Seat 4: PlayTheBlues4U folded on the River
Seat 5: JoeDude60 folded on the Flop
Seat 6: maccount (button) folded before Flop (didn't bet)



PokerStars Hand #204644609555:  Hold'em No Limit ($0.05/$0.10 USD) - 2019/10/17 18:26:25 ET
Table 'Crater' 6-max Seat #1 is the button
Seat 1: Ionix1 ($9.56 in chips) 
Seat 3: yoli0820 ($6.05 in chips) 
Seat 4: PlayTheBlues4U ($8.97 in chips) 
Seat 5: JoeDude60 ($9.02 in chips) 
Seat 6: maccount ($10.13 in chips) 
yoli0820: posts small blind $0.05
PlayTheBlues4U: posts big blind $0.10
*** HOLE CARDS ***
Dealt to PlayTheBlues4U [Kc 4s]
JoeDude60: folds 
maccount: folds 
Ionix1: calls $0.10
yoli0820: calls $0.05
PlayTheBlues4U: checks 
*** FLOP *** [9c Qh Tc]
yoli0820: checks 
PlayTheBlues4U: checks 
Ionix1: checks 
*** TURN *** [9c Qh Tc] [8c]
yoli0820: bets $0.10
PlayTheBlues4U: calls $0.10
Ionix1: calls $0.10
*** RIVER *** [9c Qh Tc 8c] [Kd]
yoli0820: bets $0.30
PlayTheBlues4U: calls $0.30
Ionix1: raises $2.20 to $2.50
yoli0820: folds 
PlayTheBlues4U: folds 
Uncalled bet ($2.20) returned to Ionix1
Ionix1 collected $1.42 from pot
Ionix1: doesn't show hand 
*** SUMMARY ***
Total pot $1.50 | Rake $0.08 
Board [9c Qh Tc 8c Kd]
Seat 1: Ionix1 (button) collected ($1.42)
Seat 3: yoli0820 (small blind) folded on the River
Seat 4: PlayTheBlues4U (big blind) folded on the River
Seat 5: JoeDude60 folded before Flop (didn't bet)
Seat 6: maccount folded before Flop (didn't bet)



PokerStars Hand #204644609690:  Hold'em No Limit ($0.05/$0.10 USD) - 2019/10/17 18:27:13 ET
Table 'Crater' 6-max Seat #3 is the button
Seat 1: Ionix1 ($10.48 in chips) 
Seat 2: okletsflip ($10.84 in chips) 
Seat 3: yoli0820 ($5.55 in chips) 
Seat 4: PlayTheBlues4U ($8.47 in chips) 
Seat 5: JoeDude60 ($9.02 in chips) 
Seat 6: maccount ($10.13 in chips) 
PlayTheBlues4U: posts small blind $0.05
JoeDude60: posts big blind $0.10
okletsflip: posts small & big blinds $0.15
*** HOLE CARDS ***
Dealt to PlayTheBlues4U [7c 9d]
Ionix1 said, "aj"
maccount: folds 
Ionix1: calls $0.10
okletsflip: raises $0.10 to $0.20
yoli0820: calls $0.20
PlayTheBlues4U said, "Qx"
yoli0820 said, "of course nit"
PlayTheBlues4U: folds 
JoeDude60: calls $0.10
Ionix1: calls $0.10
*** FLOP *** [4h Jd 7s]
JoeDude60: checks 
Ionix1: checks 
PlayTheBlues4U said, "it was my bb lol"
okletsflip: checks 
Ionix1 said, "-_-"
yoli0820: bets $0.90
JoeDude60: calls $0.90
Ionix1: folds 
Ionix1 said, "Yoli with pocket jacks lol"
okletsflip: calls $0.90
*** TURN *** [4h Jd 7s] [Ts]
JoeDude60: checks 
okletsflip: bets $0.50
yoli0820: raises $3.95 to $4.45 and is all-in
JoeDude60: folds 
okletsflip: calls $3.95
*** RIVER *** [4h Jd 7s Ts] [5c]
*** SHOW DOWN ***
okletsflip: shows [8s 9s] (a straight, Seven to Jack)
yoli0820: shows [Jh 8h] (a pair of Jacks)
okletsflip collected $11.88 from pot
okletsflip said, "hahahaha"
*** SUMMARY ***
Total pot $12.50 | Rake $0.62 
Board [4h Jd 7s Ts 5c]
Seat 1: Ionix1 folded on the Flop
Seat 2: okletsflip showed [8s 9s] and won ($11.88) with a straight, Seven to Jack
Seat 3: yoli0820 (button) showed [Jh 8h] and lost with a pair of Jacks
Seat 4: PlayTheBlues4U (small blind) folded before Flop
Seat 5: JoeDude60 (big blind) folded on the Turn
Seat 6: maccount folded before Flop (didn't bet)



PokerStars Hand #204644609862:  Hold'em No Limit ($0.05/$0.10 USD) - 2019/10/17 18:28:14 ET
Table 'Crater' 6-max Seat #4 is the button
Seat 1: Ionix1 ($10.28 in chips) 
Seat 2: okletsflip ($17.12 in chips) 
Seat 4: PlayTheBlues4U ($8.42 in chips) 
Seat 5: JoeDude60 ($7.92 in chips) 
Seat 6: maccount ($10.13 in chips) 
JoeDude60: posts small blind $0.05
maccount: posts big blind $0.10
*** HOLE CARDS ***
Dealt to PlayTheBlues4U [5h Tc]
Ionix1 said, "OOF"
Ionix1: folds 
Ionix1 said, "big oof"
yoli0820 leaves the table
okletsflip: calls $0.10
PlayTheBlues4U: folds 
JoeDude60: calls $0.05
maccount: checks 
*** FLOP *** [3h Th Kd]
JoeDude60: checks 
maccount: checks 
hammerking19 joins the table at seat #3 
okletsflip: bets $0.20
Ionix1 said, "Howdy Hammerking"
JoeDude60: folds 
maccount: folds 
Uncalled bet ($0.20) returned to okletsflip
okletsflip collected $0.28 from pot
okletsflip: doesn't show hand 
*** SUMMARY ***
Total pot $0.30 | Rake $0.02 
Board [3h Th Kd]
Seat 1: Ionix1 folded before Flop (didn't bet)
Seat 2: okletsflip collected ($0.28)
Seat 4: PlayTheBlues4U (button) folded before Flop (didn't bet)
Seat 5: JoeDude60 (small blind) folded on the Flop
Seat 6: maccount (big blind) folded on the Flop



PokerStars Hand #204644609939:  Hold'em No Limit ($0.05/$0.10 USD) - 2019/10/17 18:28:43 ET
Table 'Crater' 6-max Seat #5 is the button
Seat 1: Ionix1 ($10.28 in chips) 
Seat 2: okletsflip ($17.30 in chips) 
Seat 3: hammerking19 ($10 in chips) 
Seat 4: PlayTheBlues4U ($8.42 in chips) 
Seat 5: JoeDude60 ($7.82 in chips) 
Seat 6: maccount ($10.03 in chips) 
maccount: posts small blind $0.05
Ionix1: posts big blind $0.10
hammerking19: posts big blind $0.10
*** HOLE CARDS ***
Dealt to PlayTheBlues4U [6s 3d]
okletsflip: calls $0.10
hammerking19: checks 
PlayTheBlues4U: folds 
JoeDude60: folds 
maccount: calls $0.05
Ionix1: checks 
*** FLOP *** [2d Tc 9s]
maccount: checks 
Ionix1: checks 
okletsflip: bets $0.20
hammerking19: folds 
maccount: folds 
Ionix1: folds 
Uncalled bet ($0.20) returned to okletsflip
okletsflip collected $0.38 from pot
okletsflip: doesn't show hand 
*** SUMMARY ***
Total pot $0.40 | Rake $0.02 
Board [2d Tc 9s]
Seat 1: Ionix1 (big blind) folded on the Flop
Seat 2: okletsflip collected ($0.38)
Seat 3: hammerking19 folded on the Flop (didn't bet)
Seat 4: PlayTheBlues4U folded before Flop (didn't bet)
Seat 5: JoeDude60 (button) folded before Flop (didn't bet)
Seat 6: maccount (small blind) folded on the Flop



PokerStars Hand #204645133309:  Hold'em No Limit ($0.05/$0.10 USD) - 2019/10/17 18:29:07 ET
Table 'Crater' 6-max Seat #6 is the button
Seat 1: Ionix1 ($10.18 in chips) 
Seat 2: okletsflip ($17.58 in chips) 
Seat 3: hammerking19 ($9.90 in chips) 
Seat 4: PlayTheBlues4U ($8.42 in chips) 
Seat 5: JoeDude60 ($7.82 in chips) 
Seat 6: maccount ($10 in chips) 
Ionix1: posts small blind $0.05
okletsflip: posts big blind $0.10
*** HOLE CARDS ***
Dealt to PlayTheBlues4U [3s 5c]
hammerking19: calls $0.10
PlayTheBlues4U: folds 
JoeDude60: folds 
maccount: folds 
Ionix1: calls $0.05
okletsflip: raises $1 to $1.10
hammerking19: folds 
Ionix1: folds 
Uncalled bet ($1) returned to okletsflip
okletsflip collected $0.30 from pot
okletsflip: doesn't show hand 
*** SUMMARY ***
Total pot $0.30 | Rake $0 
Seat 1: Ionix1 (small blind) folded before Flop
Seat 2: okletsflip (big blind) collected ($0.30)
Seat 3: hammerking19 folded before Flop
Seat 4: PlayTheBlues4U folded before Flop (didn't bet)
Seat 5: JoeDude60 folded before Flop (didn't bet)
Seat 6: maccount (button) folded before Flop (didn't bet)



PokerStars Hand #204645133385:  Hold'em No Limit ($0.05/$0.10 USD) - 2019/10/17 18:29:39 ET
Table 'Crater' 6-max Seat #1 is the button
Seat 1: Ionix1 ($10.08 in chips) 
Seat 2: okletsflip ($17.78 in chips) 
Seat 3: hammerking19 ($9.80 in chips) 
Seat 4: PlayTheBlues4U ($8.42 in chips) 
Seat 5: JoeDude60 ($7.82 in chips) 
Seat 6: maccount ($10 in chips) 
okletsflip: posts small blind $0.05
hammerking19: posts big blind $0.10
*** HOLE CARDS ***
Dealt to PlayTheBlues4U [6h 4c]
PlayTheBlues4U: folds 
JoeDude60: calls $0.10
maccount: folds 
Ionix1: calls $0.10
okletsflip: calls $0.05
hammerking19: checks 
*** FLOP *** [Th 9h 8h]
okletsflip: checks 
hammerking19: checks 
JoeDude60: checks 
Ionix1: checks 
*** TURN *** [Th 9h 8h] [9s]
okletsflip: bets $0.10
hammerking19: calls $0.10
JoeDude60: folds 
Ionix1: calls $0.10
*** RIVER *** [Th 9h 8h 9s] [5h]
okletsflip: checks 
hammerking19: checks 
Ionix1: checks 
*** SHOW DOWN ***
okletsflip: shows [7c Qd] (a pair of Nines)
hammerking19: shows [As Js] (a pair of Nines - Ace kicker)
Ionix1: shows [Ks 8c] (two pair, Nines and Eights)
Ionix1 collected $0.66 from pot
*** SUMMARY ***
Total pot $0.70 | Rake $0.04 
Board [Th 9h 8h 9s 5h]
Seat 1: Ionix1 (button) showed [Ks 8c] and won ($0.66) with two pair, Nines and Eights
Seat 2: okletsflip (small blind) showed [7c Qd] and lost with a pair of Nines
Seat 3: hammerking19 (big blind) showed [As Js] and lost with a pair of Nines
Seat 4: PlayTheBlues4U folded before Flop (didn't bet)
Seat 5: JoeDude60 folded on the Turn
Seat 6: maccount folded before Flop (didn't bet)



PokerStars Hand #204645133458:  Hold'em No Limit ($0.05/$0.10 USD) - 2019/10/17 18:30:13 ET
Table 'Crater' 6-max Seat #2 is the button
Seat 1: Ionix1 ($10.54 in chips) 
Seat 2: okletsflip ($17.58 in chips) 
Seat 3: hammerking19 ($9.60 in chips) 
Seat 4: PlayTheBlues4U ($8.42 in chips) 
Seat 5: JoeDude60 ($7.72 in chips) 
Seat 6: maccount ($10 in chips) 
hammerking19: posts small blind $0.05
PlayTheBlues4U: posts big blind $0.10
*** HOLE CARDS ***
Dealt to PlayTheBlues4U [8c 3h]
okletsflip said, "hahaha"
JoeDude60: calls $0.10
maccount: folds 
Ionix1: calls $0.10
Ionix1 said, "Couldn't risk the flush"
okletsflip: calls $0.10
hammerking19: calls $0.05
PlayTheBlues4U: checks 
*** FLOP *** [2s 6c 2c]
hammerking19: checks 
PlayTheBlues4U: checks 
JoeDude60: checks 
Ionix1: checks 
okletsflip: bets $0.20
hammerking19: folds 
PlayTheBlues4U: folds 
JoeDude60: folds 
Ionix1: folds 
Uncalled bet ($0.20) returned to okletsflip
okletsflip collected $0.48 from pot
okletsflip: doesn't show hand 
*** SUMMARY ***
Total pot $0.50 | Rake $0.02 
Board [2s 6c 2c]
Seat 1: Ionix1 folded on the Flop
Seat 2: okletsflip (button) collected ($0.48)
Seat 3: hammerking19 (small blind) folded on the Flop
Seat 4: PlayTheBlues4U (big blind) folded on the Flop
Seat 5: JoeDude60 folded on the Flop
Seat 6: maccount folded before Flop (didn't bet)



PokerStars Hand #204645133515:  Hold'em No Limit ($0.05/$0.10 USD) - 2019/10/17 18:30:39 ET
Table 'Crater' 6-max Seat #3 is the button
Seat 1: Ionix1 ($10.44 in chips) 
Seat 2: okletsflip ($17.96 in chips) 
Seat 3: hammerking19 ($9.50 in chips) 
Seat 4: PlayTheBlues4U ($8.32 in chips) 
Seat 5: JoeDude60 ($7.62 in chips) 
Seat 6: maccount ($10 in chips) 
PlayTheBlues4U: posts small blind $0.05
JoeDude60: posts big blind $0.10
*** HOLE CARDS ***
Dealt to PlayTheBlues4U [9h Th]
maccount: calls $0.10
Ionix1: folds 
okletsflip: folds 
hammerking19: folds 
hammerking19 leaves the table
PlayTheBlues4U: raises $0.20 to $0.30
JoeDude60: calls $0.20
maccount: calls $0.20
*** FLOP *** [3c Qh 7c]
LanskyBanksy joins the table at seat #3 
PlayTheBlues4U: bets $0.50
JoeDude60: folds 
maccount: raises $0.50 to $1
PlayTheBlues4U: folds 
Uncalled bet ($0.50) returned to maccount
maccount collected $1.80 from pot
maccount: doesn't show hand 
*** SUMMARY ***
Total pot $1.90 | Rake $0.10 
Board [3c Qh 7c]
Seat 1: Ionix1 folded before Flop (didn't bet)
Seat 2: okletsflip folded before Flop (didn't bet)
Seat 3: hammerking19 (button) folded before Flop (didn't bet)
Seat 4: PlayTheBlues4U (small blind) folded on the Flop
Seat 5: JoeDude60 (big blind) folded on the Flop
Seat 6: maccount collected ($1.80)



PokerStars Hand #204645133618:  Hold'em No Limit ($0.05/$0.10 USD) - 2019/10/17 18:31:29 ET
Table 'Crater' 6-max Seat #4 is the button
Seat 1: Ionix1 ($10.44 in chips) 
Seat 2: okletsflip ($17.96 in chips) 
Seat 4: PlayTheBlues4U ($7.52 in chips) 
Seat 5: JoeDude60 ($7.32 in chips) 
Seat 6: maccount ($11 in chips) 
JoeDude60: posts small blind $0.05
maccount: posts big blind $0.10
LanskyBanksy: sits out 
*** HOLE CARDS ***
Dealt to PlayTheBlues4U [2d 6c]
PlayTheBlues4U said, "A7 good?"
Ionix1: folds 
okletsflip: calls $0.10
PlayTheBlues4U: folds 
JoeDude60: calls $0.05
maccount: checks 
*** FLOP *** [Kh 8c Js]
JoeDude60: checks 
maccount: checks 
okletsflip: bets $0.20
JoeDude60: folds 
maccount: folds 
Uncalled bet ($0.20) returned to okletsflip
okletsflip collected $0.28 from pot
okletsflip: doesn't show hand 
*** SUMMARY ***
Total pot $0.30 | Rake $0.02 
Board [Kh 8c Js]
Seat 1: Ionix1 folded before Flop (didn't bet)
Seat 2: okletsflip collected ($0.28)
Seat 4: PlayTheBlues4U (button) folded before Flop (didn't bet)
Seat 5: JoeDude60 (small blind) folded on the Flop
Seat 6: maccount (big blind) folded on the Flop



PokerStars Hand #204645133674:  Hold'em No Limit ($0.05/$0.10 USD) - 2019/10/17 18:31:48 ET
Table 'Crater' 6-max Seat #5 is the button
Seat 1: Ionix1 ($10.44 in chips) 
Seat 2: okletsflip ($18.14 in chips) 
Seat 4: PlayTheBlues4U ($7.52 in chips) 
Seat 5: JoeDude60 ($7.22 in chips) 
Seat 6: maccount ($10.90 in chips) 
maccount: posts small blind $0.05
Ionix1: posts big blind $0.10
LanskyBanksy: sits out 
*** HOLE CARDS ***
Dealt to PlayTheBlues4U [Tc 6d]
okletsflip: calls $0.10
PlayTheBlues4U: folds 
JoeDude60: raises $0.20 to $0.30
maccount: calls $0.25
Ionix1: calls $0.20
okletsflip: calls $0.20
*** FLOP *** [As 4h 5h]
maccount: checks 
Ionix1: bets $0.40
okletsflip: folds 
JoeDude60: calls $0.40
maccount: folds 
*** TURN *** [As 4h 5h] [Qd]
Ionix1: bets $0.40
JoeDude60: calls $0.40
*** RIVER *** [As 4h 5h Qd] [Ah]
Ionix1: bets $9.34 and is all-in
JoeDude60: folds 
Uncalled bet ($9.34) returned to Ionix1
Ionix1 collected $2.66 from pot
Ionix1: doesn't show hand 
*** SUMMARY ***
Total pot $2.80 | Rake $0.14 
Board [As 4h 5h Qd Ah]
Seat 1: Ionix1 (big blind) collected ($2.66)
Seat 2: okletsflip folded on the Flop
Seat 4: PlayTheBlues4U folded before Flop (didn't bet)
Seat 5: JoeDude60 (button) folded on the River
Seat 6: maccount (small blind) folded on the Flop



PokerStars Hand #204645133774:  Hold'em No Limit ($0.05/$0.10 USD) - 2019/10/17 18:32:33 ET
Table 'Crater' 6-max Seat #6 is the button
Seat 1: Ionix1 ($12 in chips) 
Seat 2: okletsflip ($17.84 in chips) 
Seat 4: PlayTheBlues4U ($10 in chips) 
Seat 5: JoeDude60 ($6.12 in chips) 
Seat 6: maccount ($10.60 in chips) 
Ionix1: posts small blind $0.05
okletsflip: posts big blind $0.10
LanskyBanksy: sits out 
*** HOLE CARDS ***
Dealt to PlayTheBlues4U [3d Jc]
PlayTheBlues4U: folds 
JoeDude60: folds 
maccount: folds 
Ionix1: folds 
Uncalled bet ($0.05) returned to okletsflip
okletsflip collected $0.10 from pot
okletsflip: doesn't show hand 
*** SUMMARY ***
Total pot $0.10 | Rake $0 
Seat 1: Ionix1 (small blind) folded before Flop
Seat 2: okletsflip (big blind) collected ($0.10)
Seat 4: PlayTheBlues4U folded before Flop (didn't bet)
Seat 5: JoeDude60 folded before Flop (didn't bet)
Seat 6: maccount (button) folded before Flop (didn't bet)



PokerStars Hand #204645133791:  Hold'em No Limit ($0.05/$0.10 USD) - 2019/10/17 18:32:40 ET
Table 'Crater' 6-max Seat #1 is the button
Seat 1: Ionix1 ($11.95 in chips) 
Seat 2: okletsflip ($17.89 in chips) 
Seat 3: LanskyBanksy ($10 in chips) 
Seat 4: PlayTheBlues4U ($10 in chips) 
Seat 5: JoeDude60 ($6.12 in chips) 
Seat 6: maccount ($10.60 in chips) 
okletsflip: posts small blind $0.05
LanskyBanksy: posts big blind $0.10
*** HOLE CARDS ***
Dealt to PlayTheBlues4U [7d 6d]
PlayTheBlues4U: folds 
JoeDude60: calls $0.10
maccount: folds 
Ionix1: folds 
okletsflip: calls $0.05
LanskyBanksy: checks 
*** FLOP *** [Js 8d 9s]
okletsflip: bets $0.20
LanskyBanksy: calls $0.20
JoeDude60: folds 
*** TURN *** [Js 8d 9s] [3c]
okletsflip: bets $0.10
LanskyBanksy: calls $0.10
*** RIVER *** [Js 8d 9s 3c] [As]
okletsflip: bets $0.50
LanskyBanksy: raises $1 to $1.50
okletsflip: calls $1
*** SHOW DOWN ***
LanskyBanksy: shows [4s 7s] (a flush, Ace high)
okletsflip: mucks hand 
LanskyBanksy collected $3.70 from pot
*** SUMMARY ***
Total pot $3.90 | Rake $0.20 
Board [Js 8d 9s 3c As]
Seat 1: Ionix1 (button) folded before Flop (didn't bet)
Seat 2: okletsflip (small blind) mucked [Jh 9h]
Seat 3: LanskyBanksy (big blind) showed [4s 7s] and won ($3.70) with a flush, Ace high
Seat 4: PlayTheBlues4U folded before Flop (didn't bet)
Seat 5: JoeDude60 folded on the Flop
Seat 6: maccount folded before Flop (didn't bet)



PokerStars Hand #204645133896:  Hold'em No Limit ($0.05/$0.10 USD) - 2019/10/17 18:33:24 ET
Table 'Crater' 6-max Seat #2 is the button
Seat 1: Ionix1 ($11.95 in chips) 
Seat 2: okletsflip ($15.99 in chips) 
Seat 3: LanskyBanksy ($11.80 in chips) 
Seat 4: PlayTheBlues4U ($10 in chips) 
Seat 5: JoeDude60 ($9.02 in chips) 
Seat 6: maccount ($10.60 in chips) 
LanskyBanksy: posts small blind $0.05
PlayTheBlues4U: posts big blind $0.10
*** HOLE CARDS ***
Dealt to PlayTheBlues4U [Ks 5h]
JoeDude60: calls $0.10
maccount: folds 
Ionix1: calls $0.10
okletsflip: calls $0.10
LanskyBanksy: calls $0.05
PlayTheBlues4U: checks 
*** FLOP *** [Th 3d Tc]
okletsflip said, " nh"
LanskyBanksy: checks 
PlayTheBlues4U: checks 
JoeDude60: checks 
Ionix1: checks 
okletsflip: checks 
*** TURN *** [Th 3d Tc] [9d]
LanskyBanksy: checks 
PlayTheBlues4U: checks 
JoeDude60: bets $0.10
Ionix1: calls $0.10
okletsflip: raises $0.10 to $0.20
LanskyBanksy: folds 
PlayTheBlues4U: folds 
JoeDude60: calls $0.10
Ionix1: calls $0.10
*** RIVER *** [Th 3d Tc 9d] [8d]
JoeDude60: bets $0.50
Ionix1: folds 
okletsflip: folds 
Uncalled bet ($0.50) returned to JoeDude60
JoeDude60 collected $1.04 from pot
JoeDude60: doesn't show hand 
*** SUMMARY ***
Total pot $1.10 | Rake $0.06 
Board [Th 3d Tc 9d 8d]
Seat 1: Ionix1 folded on the River
Seat 2: okletsflip (button) folded on the River
Seat 3: LanskyBanksy (small blind) folded on the Turn
Seat 4: PlayTheBlues4U (big blind) folded on the Turn
Seat 5: JoeDude60 collected ($1.04)
Seat 6: maccount folded before Flop (didn't bet)



PokerStars Hand #204645134055:  Hold'em No Limit ($0.05/$0.10 USD) - 2019/10/17 18:34:29 ET
Table 'Crater' 6-max Seat #3 is the button
Seat 1: Ionix1 ($11.65 in chips) 
Seat 2: okletsflip ($15.69 in chips) 
Seat 3: LanskyBanksy ($11.70 in chips) 
Seat 4: PlayTheBlues4U ($9.90 in chips) 
Seat 5: JoeDude60 ($9.76 in chips) 
Seat 6: maccount ($10.60 in chips) 
PlayTheBlues4U: posts small blind $0.05
JoeDude60: posts big blind $0.10
*** HOLE CARDS ***
Dealt to PlayTheBlues4U [8h 4h]
maccount: folds 
Ionix1: raises $0.10 to $0.20
okletsflip: calls $0.20
LanskyBanksy: folds 
PlayTheBlues4U: folds 
JoeDude60: calls $0.10
*** FLOP *** [Ts Qs Qc]
JoeDude60: checks 
Ionix1: bets $0.30
okletsflip: folds 
JoeDude60: folds 
Uncalled bet ($0.30) returned to Ionix1
Ionix1 collected $0.62 from pot
Ionix1: doesn't show hand 
*** SUMMARY ***
Total pot $0.65 | Rake $0.03 
Board [Ts Qs Qc]
Seat 1: Ionix1 collected ($0.62)
Seat 2: okletsflip folded on the Flop
Seat 3: LanskyBanksy (button) folded before Flop (didn't bet)
Seat 4: PlayTheBlues4U (small blind) folded before Flop
Seat 5: JoeDude60 (big blind) folded on the Flop
Seat 6: maccount folded before Flop (didn't bet)



PokerStars Hand #204645134124:  Hold'em No Limit ($0.05/$0.10 USD) - 2019/10/17 18:34:57 ET
Table 'Crater' 6-max Seat #4 is the button
Seat 1: Ionix1 ($12.07 in chips) 
Seat 2: okletsflip ($15.49 in chips) 
Seat 3: LanskyBanksy ($11.70 in chips) 
Seat 4: PlayTheBlues4U ($9.85 in chips) 
Seat 5: JoeDude60 ($9.56 in chips) 
Seat 6: maccount ($10.60 in chips) 
JoeDude60: posts small blind $0.05
maccount: posts big blind $0.10
*** HOLE CARDS ***
Dealt to PlayTheBlues4U [8s 6d]
Ionix1: raises $0.10 to $0.20
okletsflip: calls $0.20
LanskyBanksy: folds 
PlayTheBlues4U: folds 
JoeDude60: calls $0.15
maccount: calls $0.10
*** FLOP *** [Ad 6c 2h]
JoeDude60: checks 
maccount: checks 
Ionix1: checks 
okletsflip: bets $0.10
JoeDude60: calls $0.10
maccount: calls $0.10
Ionix1: calls $0.10
*** TURN *** [Ad 6c 2h] [3c]
JoeDude60: checks 
maccount: checks 
Ionix1: checks 
okletsflip: checks 
*** RIVER *** [Ad 6c 2h 3c] [Ah]
JoeDude60: checks 
maccount: checks 
Ionix1: bets $0.10
okletsflip: raises $0.50 to $0.60
JoeDude60: folds 
maccount: folds 
Ionix1: calls $0.50
*** SHOW DOWN ***
okletsflip: shows [Qd 9d] (a pair of Aces)
Ionix1: shows [Jd Jc] (two pair, Aces and Jacks)
Ionix1 collected $2.28 from pot
*** SUMMARY ***
Total pot $2.40 | Rake $0.12 
Board [Ad 6c 2h 3c Ah]
Seat 1: Ionix1 showed [Jd Jc] and won ($2.28) with two pair, Aces and Jacks
Seat 2: okletsflip showed [Qd 9d] and lost with a pair of Aces
Seat 3: LanskyBanksy folded before Flop (didn't bet)
Seat 4: PlayTheBlues4U (button) folded before Flop (didn't bet)
Seat 5: JoeDude60 (small blind) folded on the River
Seat 6: maccount (big blind) folded on the River



PokerStars Hand #204645134260:  Hold'em No Limit ($0.05/$0.10 USD) - 2019/10/17 18:35:50 ET
Table 'Crater' 6-max Seat #5 is the button
Seat 1: Ionix1 ($13.45 in chips) 
Seat 2: okletsflip ($14.59 in chips) 
Seat 3: LanskyBanksy ($11.70 in chips) 
Seat 4: PlayTheBlues4U ($9.85 in chips) 
Seat 5: JoeDude60 ($9.26 in chips) 
Seat 6: maccount ($10.30 in chips) 
maccount: posts small blind $0.05
Ionix1: posts big blind $0.10
*** HOLE CARDS ***
Dealt to PlayTheBlues4U [9c 6d]
Ionix1 said, "knew it!"
okletsflip: calls $0.10
LanskyBanksy: raises $0.30 to $0.40
okletsflip said, "nice"
Ionix1 said, "good hand :)"
PlayTheBlues4U: folds 
JoeDude60: folds 
maccount: folds 
Ionix1: folds 
okletsflip: calls $0.30
*** FLOP *** [5s Js 2d]
okletsflip: checks 
LanskyBanksy: bets $0.45
okletsflip: calls $0.45
*** TURN *** [5s Js 2d] [Kc]
okletsflip: bets $0.60
LanskyBanksy: raises $1.20 to $1.80
okletsflip: folds 
Uncalled bet ($1.20) returned to LanskyBanksy
LanskyBanksy collected $2.90 from pot
LanskyBanksy: doesn't show hand 
*** SUMMARY ***
Total pot $3.05 | Rake $0.15 
Board [5s Js 2d Kc]
Seat 1: Ionix1 (big blind) folded before Flop
Seat 2: okletsflip folded on the Turn
Seat 3: LanskyBanksy collected ($2.90)
Seat 4: PlayTheBlues4U folded before Flop (didn't bet)
Seat 5: JoeDude60 (button) folded before Flop (didn't bet)
Seat 6: maccount (small blind) folded before Flop



PokerStars Hand #204645134423:  Hold'em No Limit ($0.05/$0.10 USD) - 2019/10/17 18:37:02 ET
Table 'Crater' 6-max Seat #6 is the button
Seat 1: Ionix1 ($13.35 in chips) 
Seat 2: okletsflip ($13.14 in chips) 
Seat 3: LanskyBanksy ($13.15 in chips) 
Seat 4: PlayTheBlues4U ($9.85 in chips) 
Seat 5: JoeDude60 ($9.26 in chips) 
Seat 6: maccount ($10.25 in chips) 
okletsflip said, "nh"
Ionix1: posts small blind $0.05
okletsflip: posts big blind $0.10
*** HOLE CARDS ***
Dealt to PlayTheBlues4U [8c 5c]
LanskyBanksy: folds 
PlayTheBlues4U: folds 
JoeDude60: calls $0.10
maccount: folds 
Ionix1: calls $0.05
okletsflip: checks 
*** FLOP *** [8d 7h 7s]
Ionix1: checks 
okletsflip: bets $0.10
JoeDude60: calls $0.10
Ionix1: folds 
*** TURN *** [8d 7h 7s] [As]
okletsflip: bets $0.10
JoeDude60: calls $0.10
*** RIVER *** [8d 7h 7s As] [4s]
okletsflip: bets $0.30
JoeDude60: raises $0.60 to $0.90
okletsflip: folds 
Uncalled bet ($0.60) returned to JoeDude60
JoeDude60 collected $1.24 from pot
JoeDude60: doesn't show hand 
*** SUMMARY ***
Total pot $1.30 | Rake $0.06 
Board [8d 7h 7s As 4s]
Seat 1: Ionix1 (small blind) folded on the Flop
Seat 2: okletsflip (big blind) folded on the River
Seat 3: LanskyBanksy folded before Flop (didn't bet)
Seat 4: PlayTheBlues4U folded before Flop (didn't bet)
Seat 5: JoeDude60 collected ($1.24)
Seat 6: maccount (button) folded before Flop (didn't bet)



PokerStars Hand #204645134535:  Hold'em No Limit ($0.05/$0.10 USD) - 2019/10/17 18:37:51 ET
Table 'Crater' 6-max Seat #1 is the button
Seat 1: Ionix1 ($13.25 in chips) 
Seat 2: okletsflip ($12.54 in chips) 
Seat 3: LanskyBanksy ($13.15 in chips) 
Seat 4: PlayTheBlues4U ($9.85 in chips) 
Seat 5: JoeDude60 ($9.90 in chips) 
Seat 6: maccount ($10.25 in chips) 
okletsflip: posts small blind $0.05
LanskyBanksy: posts big blind $0.10
*** HOLE CARDS ***
Dealt to PlayTheBlues4U [Kd 2c]
PlayTheBlues4U: folds 
JoeDude60: calls $0.10
maccount: folds 
Ionix1: calls $0.10
okletsflip: calls $0.05
LanskyBanksy: checks 
*** FLOP *** [9c Qd Qc]
okletsflip: bets $0.20
LanskyBanksy: folds 
JoeDude60: folds 
Ionix1: folds 
Uncalled bet ($0.20) returned to okletsflip
okletsflip collected $0.38 from pot
okletsflip: doesn't show hand 
*** SUMMARY ***
Total pot $0.40 | Rake $0.02 
Board [9c Qd Qc]
Seat 1: Ionix1 (button) folded on the Flop
Seat 2: okletsflip (small blind) collected ($0.38)
Seat 3: LanskyBanksy (big blind) folded on the Flop
Seat 4: PlayTheBlues4U folded before Flop (didn't bet)
Seat 5: JoeDude60 folded on the Flop
Seat 6: maccount folded before Flop (didn't bet)



PokerStars Hand #204645134623:  Hold'em No Limit ($0.05/$0.10 USD) - 2019/10/17 18:38:31 ET
Table 'Crater' 6-max Seat #2 is the button
Seat 1: Ionix1 ($13.15 in chips) 
Seat 2: okletsflip ($12.82 in chips) 
Seat 3: LanskyBanksy ($13.05 in chips) 
Seat 4: PlayTheBlues4U ($9.85 in chips) 
Seat 5: JoeDude60 ($9.80 in chips) 
Seat 6: maccount ($10.25 in chips) 
LanskyBanksy: posts small blind $0.05
PlayTheBlues4U: posts big blind $0.10
*** HOLE CARDS ***
Dealt to PlayTheBlues4U [Kh Ac]
JoeDude60: calls $0.10
maccount: folds 
Ionix1: calls $0.10
okletsflip: calls $0.10
LanskyBanksy: calls $0.05
PlayTheBlues4U: raises $0.40 to $0.50
JoeDude60: calls $0.40
Ionix1: folds 
okletsflip: folds 
LanskyBanksy: folds 
*** FLOP *** [3s 5d Ts]
PlayTheBlues4U: bets $0.80
JoeDude60: folds 
Uncalled bet ($0.80) returned to PlayTheBlues4U
PlayTheBlues4U collected $1.24 from pot
PlayTheBlues4U: doesn't show hand 
*** SUMMARY ***
Total pot $1.30 | Rake $0.06 
Board [3s 5d Ts]
Seat 1: Ionix1 folded before Flop
Seat 2: okletsflip (button) folded before Flop
Seat 3: LanskyBanksy (small blind) folded before Flop
Seat 4: PlayTheBlues4U (big blind) collected ($1.24)
Seat 5: JoeDude60 folded on the Flop
Seat 6: maccount folded before Flop (didn't bet)



PokerStars Hand #204645134815:  Hold'em No Limit ($0.05/$0.10 USD) - 2019/10/17 18:39:55 ET
Table 'Crater' 6-max Seat #3 is the button
Seat 1: Ionix1 ($13.05 in chips) 
Seat 3: LanskyBanksy ($12.95 in chips) 
Seat 4: PlayTheBlues4U ($10.59 in chips) 
Seat 5: JoeDude60 ($9.30 in chips) 
Seat 6: maccount ($10.25 in chips) 
PlayTheBlues4U: posts small blind $0.05
JoeDude60: posts big blind $0.10
*** HOLE CARDS ***
Dealt to PlayTheBlues4U [5s 4d]
maccount: folds 
Ionix1: calls $0.10
LanskyBanksy: raises $0.20 to $0.30
PlayTheBlues4U: folds 
JoeDude60: calls $0.20
Ionix1: calls $0.20
*** FLOP *** [Kh Ad 7c]
JoeDude60: checks 
Ionix1: checks 
LanskyBanksy: bets $0.45
JoeDude60: calls $0.45
Ionix1: folds 
*** TURN *** [Kh Ad 7c] [9c]
JoeDude60: checks 
LanskyBanksy: checks 
*** RIVER *** [Kh Ad 7c 9c] [2s]
JoeDude60: bets $0.90
LanskyBanksy: calls $0.90
*** SHOW DOWN ***
JoeDude60: shows [2d Ah] (two pair, Aces and Deuces)
LanskyBanksy: mucks hand 
JoeDude60 collected $3.47 from pot
*** SUMMARY ***
Total pot $3.65 | Rake $0.18 
Board [Kh Ad 7c 9c 2s]
Seat 1: Ionix1 folded on the Flop
Seat 3: LanskyBanksy (button) mucked [Ks Qs]
Seat 4: PlayTheBlues4U (small blind) folded before Flop
Seat 5: JoeDude60 (big blind) showed [2d Ah] and won ($3.47) with two pair, Aces and Deuces
Seat 6: maccount folded before Flop (didn't bet)



PokerStars Hand #204645134898:  Hold'em No Limit ($0.05/$0.10 USD) - 2019/10/17 18:40:31 ET
Table 'Crater' 6-max Seat #4 is the button
Seat 1: Ionix1 ($12.75 in chips) 
Seat 2: okletsflip ($12.72 in chips) 
Seat 3: LanskyBanksy ($11.30 in chips) 
Seat 4: PlayTheBlues4U ($10.54 in chips) 
Seat 5: JoeDude60 ($11.12 in chips) 
Seat 6: maccount ($10.25 in chips) 
JoeDude60: posts small blind $0.05
maccount: posts big blind $0.10
*** HOLE CARDS ***
Dealt to PlayTheBlues4U [Ac Tc]
Ionix1: calls $0.10
okletsflip: calls $0.10
LanskyBanksy: raises $0.30 to $0.40
PlayTheBlues4U: calls $0.40
JoeDude60: folds 
maccount: folds 
Ionix1: folds 
okletsflip: folds 
*** FLOP *** [Jc 2s 8d]
LanskyBanksy: checks 
PlayTheBlues4U: checks 
*** TURN *** [Jc 2s 8d] [5d]
LanskyBanksy: bets $0.55
PlayTheBlues4U: calls $0.55
*** RIVER *** [Jc 2s 8d 5d] [2h]
LanskyBanksy: bets $1.07
PlayTheBlues4U: calls $1.07
*** SHOW DOWN ***
LanskyBanksy: shows [Th Td] (two pair, Tens and Deuces)
PlayTheBlues4U: mucks hand 
LanskyBanksy collected $4.17 from pot
*** SUMMARY ***
Total pot $4.39 | Rake $0.22 
Board [Jc 2s 8d 5d 2h]
Seat 1: Ionix1 folded before Flop
Seat 2: okletsflip folded before Flop
Seat 3: LanskyBanksy showed [Th Td] and won ($4.17) with two pair, Tens and Deuces
Seat 4: PlayTheBlues4U (button) mucked [Ac Tc]
Seat 5: JoeDude60 (small blind) folded before Flop
Seat 6: maccount (big blind) folded before Flop



PokerStars Hand #204645135078:  Hold'em No Limit ($0.05/$0.10 USD) - 2019/10/17 18:41:52 ET
Table 'Crater' 6-max Seat #5 is the button
Seat 1: Ionix1 ($12.65 in chips) 
Seat 2: okletsflip ($12.62 in chips) 
Seat 3: LanskyBanksy ($13.45 in chips) 
Seat 4: PlayTheBlues4U ($8.52 in chips) 
Seat 5: JoeDude60 ($11.07 in chips) 
Seat 6: maccount ($10.15 in chips) 
maccount: posts small blind $0.05
Ionix1: posts big blind $0.10
*** HOLE CARDS ***
Dealt to PlayTheBlues4U [8c 6c]
okletsflip: calls $0.10
LanskyBanksy: folds 
PlayTheBlues4U: folds 
JoeDude60: folds 
maccount: calls $0.05
Ionix1: raises $0.10 to $0.20
okletsflip: calls $0.10
maccount: calls $0.10
*** FLOP *** [Jc 4c 9c]
maccount: checks 
Ionix1: checks 
okletsflip: bets $0.30
maccount: calls $0.30
Ionix1: folds 
*** TURN *** [Jc 4c 9c] [Ah]
maccount: checks 
okletsflip: bets $0.30
maccount: calls $0.30
*** RIVER *** [Jc 4c 9c Ah] [As]
maccount: checks 
okletsflip: checks 
*** SHOW DOWN ***
maccount: shows [Ts Tc] (two pair, Aces and Tens)
okletsflip: mucks hand 
maccount collected $1.71 from pot
*** SUMMARY ***
Total pot $1.80 | Rake $0.09 
Board [Jc 4c 9c Ah As]
Seat 1: Ionix1 (big blind) folded on the Flop
Seat 2: okletsflip mucked [2s 3h]
Seat 3: LanskyBanksy folded before Flop (didn't bet)
Seat 4: PlayTheBlues4U folded before Flop (didn't bet)
Seat 5: JoeDude60 (button) folded before Flop (didn't bet)
Seat 6: maccount (small blind) showed [Ts Tc] and won ($1.71) with two pair, Aces and Tens



PokerStars Hand #204645135183:  Hold'em No Limit ($0.05/$0.10 USD) - 2019/10/17 18:42:36 ET
Table 'Crater' 6-max Seat #6 is the button
Seat 1: Ionix1 ($12.45 in chips) 
Seat 2: okletsflip ($11.82 in chips) 
Seat 3: LanskyBanksy ($13.45 in chips) 
Seat 4: PlayTheBlues4U ($8.52 in chips) 
Seat 5: JoeDude60 ($11.07 in chips) 
Seat 6: maccount ($11.06 in chips) 
Ionix1: posts small blind $0.05
okletsflip: posts big blind $0.10
*** HOLE CARDS ***
Dealt to PlayTheBlues4U [9s Ac]
LanskyBanksy: folds 
PlayTheBlues4U: folds 
JoeDude60: folds 
maccount: folds 
Ionix1: calls $0.05
Ionix1 said, "Let's flip!"
okletsflip: raises $0.30 to $0.40
Ionix1: folds 
Uncalled bet ($0.30) returned to okletsflip
okletsflip collected $0.20 from pot
okletsflip: doesn't show hand 
*** SUMMARY ***
Total pot $0.20 | Rake $0 
Seat 1: Ionix1 (small blind) folded before Flop
Seat 2: okletsflip (big blind) collected ($0.20)
Seat 3: LanskyBanksy folded before Flop (didn't bet)
Seat 4: PlayTheBlues4U folded before Flop (didn't bet)
Seat 5: JoeDude60 folded before Flop (didn't bet)
Seat 6: maccount (button) folded before Flop (didn't bet)



PokerStars Hand #204645135249:  Hold'em No Limit ($0.05/$0.10 USD) - 2019/10/17 18:42:59 ET
Table 'Crater' 6-max Seat #1 is the button
Seat 1: Ionix1 ($12.35 in chips) 
Seat 2: okletsflip ($11.92 in chips) 
Seat 3: LanskyBanksy ($13.45 in chips) 
Seat 4: PlayTheBlues4U ($8.52 in chips) 
Seat 5: JoeDude60 ($11.07 in chips) 
Seat 6: maccount ($11.06 in chips) 
okletsflip: posts small blind $0.05
LanskyBanksy: posts big blind $0.10
*** HOLE CARDS ***
Dealt to PlayTheBlues4U [5c 2c]
PlayTheBlues4U: folds 
JoeDude60: folds 
maccount: calls $0.10
Ionix1: calls $0.10
okletsflip: folds 
LanskyBanksy: checks 
*** FLOP *** [8c Qc 4s]
LanskyBanksy: checks 
maccount: checks 
Ionix1: checks 
*** TURN *** [8c Qc 4s] [Qh]
LanskyBanksy: checks 
maccount: checks 
Ionix1: checks 
*** RIVER *** [8c Qc 4s Qh] [4d]
LanskyBanksy: checks 
maccount: checks 
Ionix1: checks 
*** SHOW DOWN ***
LanskyBanksy: shows [9s 7c] (two pair, Queens and Fours)
maccount: mucks hand 
Ionix1: shows [Ts Kh] (two pair, Queens and Fours - King kicker)
Ionix1 collected $0.33 from pot
*** SUMMARY ***
Total pot $0.35 | Rake $0.02 
Board [8c Qc 4s Qh 4d]
Seat 1: Ionix1 (button) showed [Ts Kh] and won ($0.33) with two pair, Queens and Fours
Seat 2: okletsflip (small blind) folded before Flop
Seat 3: LanskyBanksy (big blind) showed [9s 7c] and lost with two pair, Queens and Fours
Seat 4: PlayTheBlues4U folded before Flop (didn't bet)
Seat 5: JoeDude60 folded before Flop (didn't bet)
Seat 6: maccount mucked [5d 6d]



PokerStars Hand #204645135342:  Hold'em No Limit ($0.05/$0.10 USD) - 2019/10/17 18:43:34 ET
Table 'Crater' 6-max Seat #2 is the button
Seat 1: Ionix1 ($12.58 in chips) 
Seat 2: okletsflip ($11.87 in chips) 
Seat 3: LanskyBanksy ($13.35 in chips) 
Seat 4: PlayTheBlues4U ($10 in chips) 
Seat 5: JoeDude60 ($11.07 in chips) 
Seat 6: maccount ($10.96 in chips) 
LanskyBanksy: posts small blind $0.05
PlayTheBlues4U: posts big blind $0.10
*** HOLE CARDS ***
Dealt to PlayTheBlues4U [5s 9d]
JoeDude60: calls $0.10
maccount: folds 
Ionix1: calls $0.10
okletsflip: raises $0.10 to $0.20
LanskyBanksy: folds 
PlayTheBlues4U: folds 
JoeDude60: calls $0.10
Ionix1: calls $0.10
*** FLOP *** [Kd 3s 3h]
JoeDude60: checks 
Ionix1: checks 
okletsflip: checks 
*** TURN *** [Kd 3s 3h] [7d]
JoeDude60: checks 
Ionix1: checks 
okletsflip: bets $0.30
JoeDude60: calls $0.30
Ionix1: folds 
*** RIVER *** [Kd 3s 3h 7d] [Ts]
JoeDude60: bets $1.30
okletsflip: raises $1.50 to $2.80
JoeDude60: raises $7.77 to $10.57 and is all-in
okletsflip: calls $7.77
*** SHOW DOWN ***
JoeDude60: shows [2d 3d] (three of a kind, Threes)
okletsflip: shows [7s 7c] (a full house, Sevens full of Threes)
okletsflip collected $21.37 from pot
*** SUMMARY ***
Total pot $22.49 | Rake $1.12 
Board [Kd 3s 3h 7d Ts]
Seat 1: Ionix1 folded on the Turn
Seat 2: okletsflip (button) showed [7s 7c] and won ($21.37) with a full house, Sevens full of Threes
Seat 3: LanskyBanksy (small blind) folded before Flop
Seat 4: PlayTheBlues4U (big blind) folded before Flop
Seat 5: JoeDude60 showed [2d 3d] and lost with three of a kind, Threes
Seat 6: maccount folded before Flop (didn't bet)



PokerStars Hand #204645135539:  Hold'em No Limit ($0.05/$0.10 USD) - 2019/10/17 18:45:01 ET
Table 'Crater' 6-max Seat #3 is the button
Seat 1: Ionix1 ($12.38 in chips) 
Seat 2: okletsflip ($22.17 in chips) 
Seat 3: LanskyBanksy ($13.30 in chips) 
Seat 4: PlayTheBlues4U ($9.90 in chips) 
Seat 6: maccount ($10.96 in chips) 
PlayTheBlues4U: posts small blind $0.05
maccount: posts big blind $0.10
*** HOLE CARDS ***
Dealt to PlayTheBlues4U [6d 5h]
Ionix1: calls $0.10
okletsflip: calls $0.10
LanskyBanksy: folds 
PlayTheBlues4U: folds 
maccount: checks 
*** FLOP *** [3d Kd 6h]
maccount: checks 
Ionix1: checks 
okletsflip: bets $0.20
maccount: folds 
Ionix1: folds 
Uncalled bet ($0.20) returned to okletsflip
okletsflip collected $0.33 from pot
okletsflip: doesn't show hand 
*** SUMMARY ***
Total pot $0.35 | Rake $0.02 
Board [3d Kd 6h]
Seat 1: Ionix1 folded on the Flop
Seat 2: okletsflip collected ($0.33)
Seat 3: LanskyBanksy (button) folded before Flop (didn't bet)
Seat 4: PlayTheBlues4U (small blind) folded before Flop
Seat 6: maccount (big blind) folded on the Flop



PokerStars Hand #204645135602:  Hold'em No Limit ($0.05/$0.10 USD) - 2019/10/17 18:45:32 ET
Table 'Crater' 6-max Seat #4 is the button
Seat 1: Ionix1 ($12.28 in chips) 
Seat 2: okletsflip ($22.40 in chips) 
Seat 3: LanskyBanksy ($13.30 in chips) 
Seat 4: PlayTheBlues4U ($9.85 in chips) 
Seat 6: maccount ($10.86 in chips) 
maccount: posts small blind $0.05
Ionix1: posts big blind $0.10
*** HOLE CARDS ***
Dealt to PlayTheBlues4U [8c 6h]
okletsflip: folds 
LanskyBanksy: folds 
JoeDude60 leaves the table
DeepMTPocket joins the table at seat #5 
PlayTheBlues4U: folds 
maccount: folds 
Uncalled bet ($0.05) returned to Ionix1
Ionix1 collected $0.10 from pot
Ionix1: doesn't show hand 
*** SUMMARY ***
Total pot $0.10 | Rake $0 
Seat 1: Ionix1 (big blind) collected ($0.10)
Seat 2: okletsflip folded before Flop (didn't bet)
Seat 3: LanskyBanksy folded before Flop (didn't bet)
Seat 4: PlayTheBlues4U (button) folded before Flop (didn't bet)
Seat 6: maccount (small blind) folded before Flop



PokerStars Hand #204645135636:  Hold'em No Limit ($0.05/$0.10 USD) - 2019/10/17 18:45:48 ET
Table 'Crater' 6-max Seat #6 is the button
Seat 1: Ionix1 ($12.33 in chips) 
Seat 2: okletsflip ($22.40 in chips) 
Seat 3: LanskyBanksy ($13.30 in chips) 
Seat 4: PlayTheBlues4U ($9.85 in chips) 
Seat 6: maccount ($10.81 in chips) 
Ionix1: posts small blind $0.05
okletsflip: posts big blind $0.10
DeepMTPocket: sits out 
*** HOLE CARDS ***
Dealt to PlayTheBlues4U [4s 3c]
LanskyBanksy: folds 
PlayTheBlues4U: folds 
maccount: folds 
Ionix1: calls $0.05
okletsflip: checks 
*** FLOP *** [Qd 7d Ad]
Ionix1: bets $0.10
okletsflip: raises $0.10 to $0.20
Ionix1: calls $0.10
*** TURN *** [Qd 7d Ad] [Js]
Ionix1: checks 
okletsflip: checks 
*** RIVER *** [Qd 7d Ad Js] [6d]
Ionix1: bets $0.10
okletsflip: raises $0.30 to $0.40
Ionix1: calls $0.30
*** SHOW DOWN ***
okletsflip: shows [Kd 5c] (a flush, Ace high)
Ionix1: mucks hand 
okletsflip collected $1.33 from pot
*** SUMMARY ***
Total pot $1.40 | Rake $0.07 
Board [Qd 7d Ad Js 6d]
Seat 1: Ionix1 (small blind) mucked [4d 9d]
Seat 2: okletsflip (big blind) showed [Kd 5c] and won ($1.33) with a flush, Ace high
Seat 3: LanskyBanksy folded before Flop (didn't bet)
Seat 4: PlayTheBlues4U folded before Flop (didn't bet)
Seat 6: maccount (button) folded before Flop (didn't bet)



PokerStars Hand #204645135800:  Hold'em No Limit ($0.05/$0.10 USD) - 2019/10/17 18:47:00 ET
Table 'Crater' 6-max Seat #1 is the button
Seat 1: Ionix1 ($11.63 in chips) 
Seat 2: okletsflip ($23.03 in chips) 
Seat 3: LanskyBanksy ($13.30 in chips) 
Seat 4: PlayTheBlues4U ($9.85 in chips) 
Seat 6: maccount ($10.81 in chips) 
okletsflip: posts small blind $0.05
LanskyBanksy: posts big blind $0.10
DeepMTPocket: sits out 
*** HOLE CARDS ***
Dealt to PlayTheBlues4U [Kh Ks]
PlayTheBlues4U: raises $0.20 to $0.30
maccount: folds 
Ionix1: folds 
okletsflip: calls $0.25
LanskyBanksy: folds 
*** FLOP *** [8c 9d 5h]
okletsflip: bets $0.10
PlayTheBlues4U: raises $0.30 to $0.40
okletsflip: folds 
Uncalled bet ($0.30) returned to PlayTheBlues4U
PlayTheBlues4U collected $0.86 from pot
PlayTheBlues4U: doesn't show hand 
*** SUMMARY ***
Total pot $0.90 | Rake $0.04 
Board [8c 9d 5h]
Seat 1: Ionix1 (button) folded before Flop (didn't bet)
Seat 2: okletsflip (small blind) folded on the Flop
Seat 3: LanskyBanksy (big blind) folded before Flop
Seat 4: PlayTheBlues4U collected ($0.86)
Seat 6: maccount folded before Flop (didn't bet)



PokerStars Hand #204645135892:  Hold'em No Limit ($0.05/$0.10 USD) - 2019/10/17 18:47:40 ET
Table 'Crater' 6-max Seat #2 is the button
Seat 1: Ionix1 ($11.63 in chips) 
Seat 2: okletsflip ($22.63 in chips) 
Seat 3: LanskyBanksy ($13.20 in chips) 
Seat 4: PlayTheBlues4U ($10.31 in chips) 
Seat 6: maccount ($10.81 in chips) 
LanskyBanksy: posts small blind $0.05
PlayTheBlues4U: posts big blind $0.10
DeepMTPocket: sits out 
*** HOLE CARDS ***
Dealt to PlayTheBlues4U [4s Ah]
maccount: folds 
Ionix1: folds 
okletsflip: raises $0.20 to $0.30
LanskyBanksy: folds 
PlayTheBlues4U: calls $0.20
*** FLOP *** [9c Jc 4h]
PlayTheBlues4U: checks 
okletsflip: bets $0.50
PlayTheBlues4U: calls $0.50
*** TURN *** [9c Jc 4h] [7h]
PlayTheBlues4U: checks 
okletsflip: bets $0.60
PlayTheBlues4U: calls $0.60
*** RIVER *** [9c Jc 4h 7h] [2s]
PlayTheBlues4U: checks 
okletsflip: checks 
*** SHOW DOWN ***
PlayTheBlues4U: shows [4s Ah] (a pair of Fours)
okletsflip: shows [Td Th] (a pair of Tens)
okletsflip collected $2.71 from pot
*** SUMMARY ***
Total pot $2.85 | Rake $0.14 
Board [9c Jc 4h 7h 2s]
Seat 1: Ionix1 folded before Flop (didn't bet)
Seat 2: okletsflip (button) showed [Td Th] and won ($2.71) with a pair of Tens
Seat 3: LanskyBanksy (small blind) folded before Flop
Seat 4: PlayTheBlues4U (big blind) showed [4s Ah] and lost with a pair of Fours
Seat 6: maccount folded before Flop (didn't bet)



PokerStars Hand #204645136020:  Hold'em No Limit ($0.05/$0.10 USD) - 2019/10/17 18:48:34 ET
Table 'Crater' 6-max Seat #3 is the button
Seat 1: Ionix1 ($11.63 in chips) 
Seat 2: okletsflip ($23.94 in chips) 
Seat 3: LanskyBanksy ($13.15 in chips) 
Seat 4: PlayTheBlues4U ($8.91 in chips) 
Seat 5: DeepMTPocket ($10 in chips) 
Seat 6: maccount ($10.81 in chips) 
PlayTheBlues4U: posts small blind $0.05
DeepMTPocket: posts big blind $0.10
*** HOLE CARDS ***
Dealt to PlayTheBlues4U [Kc 6s]
maccount: folds 
Ionix1: calls $0.10
okletsflip: raises $0.10 to $0.20
LanskyBanksy: folds 
PlayTheBlues4U: folds 
DeepMTPocket: folds 
Ionix1: calls $0.10
*** FLOP *** [8h Ts 5d]
Ionix1: checks 
okletsflip: bets $0.10
Ionix1: folds 
Uncalled bet ($0.10) returned to okletsflip
okletsflip collected $0.52 from pot
okletsflip: doesn't show hand 
*** SUMMARY ***
Total pot $0.55 | Rake $0.03 
Board [8h Ts 5d]
Seat 1: Ionix1 folded on the Flop
Seat 2: okletsflip collected ($0.52)
Seat 3: LanskyBanksy (button) folded before Flop (didn't bet)
Seat 4: PlayTheBlues4U (small blind) folded before Flop
Seat 5: DeepMTPocket (big blind) folded before Flop
Seat 6: maccount folded before Flop (didn't bet)



PokerStars Hand #204645136077:  Hold'em No Limit ($0.05/$0.10 USD) - 2019/10/17 18:48:57 ET
Table 'Crater' 6-max Seat #4 is the button
Seat 1: Ionix1 ($11.43 in chips) 
Seat 2: okletsflip ($24.26 in chips) 
Seat 3: LanskyBanksy ($13.15 in chips) 
Seat 4: PlayTheBlues4U ($8.86 in chips) 
Seat 5: DeepMTPocket ($9.90 in chips) 
Seat 6: maccount ($10.81 in chips) 
DeepMTPocket: posts small blind $0.05
maccount: posts big blind $0.10
*** HOLE CARDS ***
Dealt to PlayTheBlues4U [6c 3d]
Ionix1: calls $0.10
okletsflip has timed out
okletsflip: folds 
LanskyBanksy: folds 
PlayTheBlues4U: folds 
DeepMTPocket: calls $0.05
maccount: checks 
*** FLOP *** [2s 9d 9s]
DeepMTPocket: bets $0.14
maccount: folds 
Ionix1: folds 
Uncalled bet ($0.14) returned to DeepMTPocket
DeepMTPocket collected $0.28 from pot
DeepMTPocket: doesn't show hand 
*** SUMMARY ***
Total pot $0.30 | Rake $0.02 
Board [2s 9d 9s]
Seat 1: Ionix1 folded on the Flop
Seat 2: okletsflip folded before Flop (didn't bet)
Seat 3: LanskyBanksy folded before Flop (didn't bet)
Seat 4: PlayTheBlues4U (button) folded before Flop (didn't bet)
Seat 5: DeepMTPocket (small blind) collected ($0.28)
Seat 6: maccount (big blind) folded on the Flop



PokerStars Hand #204645136153:  Hold'em No Limit ($0.05/$0.10 USD) - 2019/10/17 18:49:33 ET
Table 'Crater' 6-max Seat #5 is the button
Seat 1: Ionix1 ($11.33 in chips) 
Seat 2: okletsflip ($24.26 in chips) 
Seat 3: LanskyBanksy ($13.15 in chips) 
Seat 4: PlayTheBlues4U ($8.86 in chips) 
Seat 5: DeepMTPocket ($10.08 in chips) 
Seat 6: maccount ($10.71 in chips) 
maccount: posts small blind $0.05
Ionix1: posts big blind $0.10
*** HOLE CARDS ***
Dealt to PlayTheBlues4U [Js Ad]
okletsflip: folds 
LanskyBanksy: folds 
PlayTheBlues4U: raises $0.20 to $0.30
DeepMTPocket: folds 
maccount: folds 
Ionix1: folds 
Uncalled bet ($0.20) returned to PlayTheBlues4U
PlayTheBlues4U collected $0.25 from pot
PlayTheBlues4U: doesn't show hand 
*** SUMMARY ***
Total pot $0.25 | Rake $0 
Seat 1: Ionix1 (big blind) folded before Flop
Seat 2: okletsflip folded before Flop (didn't bet)
Seat 3: LanskyBanksy folded before Flop (didn't bet)
Seat 4: PlayTheBlues4U collected ($0.25)
Seat 5: DeepMTPocket (button) folded before Flop (didn't bet)
Seat 6: maccount (small blind) folded before Flop



PokerStars Hand #204645136195:  Hold'em No Limit ($0.05/$0.10 USD) - 2019/10/17 18:49:51 ET
Table 'Crater' 6-max Seat #6 is the button
Seat 1: Ionix1 ($11.23 in chips) 
Seat 2: okletsflip ($24.26 in chips) 
Seat 3: LanskyBanksy ($13.15 in chips) 
Seat 4: PlayTheBlues4U ($9.01 in chips) 
Seat 5: DeepMTPocket ($10.08 in chips) 
Seat 6: maccount ($10.66 in chips) 
Ionix1: posts small blind $0.05
okletsflip: posts big blind $0.10
*** HOLE CARDS ***
Dealt to PlayTheBlues4U [Jd Qc]
LanskyBanksy: folds 
PlayTheBlues4U: folds 
DeepMTPocket: folds 
maccount: folds 
Ionix1: calls $0.05
okletsflip: raises $0.10 to $0.20
Ionix1: folds 
Uncalled bet ($0.10) returned to okletsflip
okletsflip collected $0.20 from pot
okletsflip: doesn't show hand 
*** SUMMARY ***
Total pot $0.20 | Rake $0 
Seat 1: Ionix1 (small blind) folded before Flop
Seat 2: okletsflip (big blind) collected ($0.20)
Seat 3: LanskyBanksy folded before Flop (didn't bet)
Seat 4: PlayTheBlues4U folded before Flop (didn't bet)
Seat 5: DeepMTPocket folded before Flop (didn't bet)
Seat 6: maccount (button) folded before Flop (didn't bet)



PokerStars Hand #204645136239:  Hold'em No Limit ($0.05/$0.10 USD) - 2019/10/17 18:50:10 ET
Table 'Crater' 6-max Seat #1 is the button
Seat 1: Ionix1 ($11.13 in chips) 
Seat 2: okletsflip ($24.36 in chips) 
Seat 3: LanskyBanksy ($13.15 in chips) 
Seat 4: PlayTheBlues4U ($9.01 in chips) 
Seat 5: DeepMTPocket ($10.08 in chips) 
Seat 6: maccount ($10.66 in chips) 
okletsflip: posts small blind $0.05
LanskyBanksy: posts big blind $0.10
*** HOLE CARDS ***
Dealt to PlayTheBlues4U [5h 6h]
PlayTheBlues4U: folds 
DeepMTPocket: folds 
maccount: calls $0.10
Ionix1: folds 
okletsflip: calls $0.05
LanskyBanksy: checks 
*** FLOP *** [Jc 9c 3c]
okletsflip: bets $0.20
LanskyBanksy: folds 
maccount: calls $0.20
*** TURN *** [Jc 9c 3c] [Kc]
okletsflip: bets $0.30
maccount: folds 
Uncalled bet ($0.30) returned to okletsflip
okletsflip collected $0.66 from pot
okletsflip: doesn't show hand 
*** SUMMARY ***
Total pot $0.70 | Rake $0.04 
Board [Jc 9c 3c Kc]
Seat 1: Ionix1 (button) folded before Flop (didn't bet)
Seat 2: okletsflip (small blind) collected ($0.66)
Seat 3: LanskyBanksy (big blind) folded on the Flop
Seat 4: PlayTheBlues4U folded before Flop (didn't bet)
Seat 5: DeepMTPocket folded before Flop (didn't bet)
Seat 6: maccount folded on the Turn



PokerStars Hand #204645136341:  Hold'em No Limit ($0.05/$0.10 USD) - 2019/10/17 18:50:55 ET
Table 'Crater' 6-max Seat #2 is the button
Seat 1: Ionix1 ($11.13 in chips) 
Seat 2: okletsflip ($24.72 in chips) 
Seat 3: LanskyBanksy ($13.05 in chips) 
Seat 4: PlayTheBlues4U ($9.01 in chips) 
Seat 5: DeepMTPocket ($10.08 in chips) 
Seat 6: maccount ($10.36 in chips) 
LanskyBanksy: posts small blind $0.05
PlayTheBlues4U: posts big blind $0.10
*** HOLE CARDS ***
Dealt to PlayTheBlues4U [8h Ts]
DeepMTPocket: folds 
maccount: folds 
Ionix1: calls $0.10
okletsflip: raises $0.10 to $0.20
LanskyBanksy: folds 
PlayTheBlues4U: calls $0.10
Ionix1: calls $0.10
*** FLOP *** [3h 4s Qc]
PlayTheBlues4U: checks 
Ionix1: checks 
okletsflip: checks 
*** TURN *** [3h 4s Qc] [Td]
PlayTheBlues4U: bets $0.30
Ionix1: folds 
okletsflip: folds 
Uncalled bet ($0.30) returned to PlayTheBlues4U
PlayTheBlues4U collected $0.62 from pot
PlayTheBlues4U: doesn't show hand 
*** SUMMARY ***
Total pot $0.65 | Rake $0.03 
Board [3h 4s Qc Td]
Seat 1: Ionix1 folded on the Turn
Seat 2: okletsflip (button) folded on the Turn
Seat 3: LanskyBanksy (small blind) folded before Flop
Seat 4: PlayTheBlues4U (big blind) collected ($0.62)
Seat 5: DeepMTPocket folded before Flop (didn't bet)
Seat 6: maccount folded before Flop (didn't bet)



PokerStars Hand #204645136480:  Hold'em No Limit ($0.05/$0.10 USD) - 2019/10/17 18:51:55 ET
Table 'Crater' 6-max Seat #3 is the button
Seat 1: Ionix1 ($10.93 in chips) 
Seat 2: okletsflip ($24.52 in chips) 
Seat 3: LanskyBanksy ($13 in chips) 
Seat 4: PlayTheBlues4U ($9.43 in chips) 
Seat 5: DeepMTPocket ($10.08 in chips) 
Seat 6: maccount ($10.36 in chips) 
PlayTheBlues4U: posts small blind $0.05
DeepMTPocket: posts big blind $0.10
*** HOLE CARDS ***
Dealt to PlayTheBlues4U [Ks Tc]
maccount: folds 
Ionix1: calls $0.10
okletsflip: raises $0.30 to $0.40
LanskyBanksy: folds 
PlayTheBlues4U: folds 
DeepMTPocket: folds 
Ionix1: folds 
Uncalled bet ($0.30) returned to okletsflip
Ionix1 leaves the table
okletsflip collected $0.35 from pot
okletsflip: doesn't show hand 
*** SUMMARY ***
Total pot $0.35 | Rake $0 
Seat 1: Ionix1 folded before Flop
Seat 2: okletsflip collected ($0.35)
Seat 3: LanskyBanksy (button) folded before Flop (didn't bet)
Seat 4: PlayTheBlues4U (small blind) folded before Flop
Seat 5: DeepMTPocket (big blind) folded before Flop
Seat 6: maccount folded before Flop (didn't bet)



PokerStars Hand #204645136532:  Hold'em No Limit ($0.05/$0.10 USD) - 2019/10/17 18:52:15 ET
Table 'Crater' 6-max Seat #4 is the button
Seat 2: okletsflip ($24.77 in chips) 
Seat 3: LanskyBanksy ($13 in chips) 
Seat 4: PlayTheBlues4U ($9.38 in chips) 
Seat 5: DeepMTPocket ($9.98 in chips) 
Seat 6: maccount ($10.36 in chips) 
DeepMTPocket: posts small blind $0.05
maccount: posts big blind $0.10
*** HOLE CARDS ***
Dealt to PlayTheBlues4U [Th Ts]
EddieMoney9 joins the table at seat #1 
okletsflip: calls $0.10
LanskyBanksy: calls $0.10
PlayTheBlues4U: raises $0.40 to $0.50
DeepMTPocket: folds 
maccount: folds 
okletsflip: folds 
LanskyBanksy: folds 
Uncalled bet ($0.40) returned to PlayTheBlues4U
PlayTheBlues4U collected $0.45 from pot
PlayTheBlues4U: doesn't show hand 
*** SUMMARY ***
Total pot $0.45 | Rake $0 
Seat 2: okletsflip folded before Flop
Seat 3: LanskyBanksy folded before Flop
Seat 4: PlayTheBlues4U (button) collected ($0.45)
Seat 5: DeepMTPocket (small blind) folded before Flop
Seat 6: maccount (big blind) folded before Flop



PokerStars Hand #204645136590:  Hold'em No Limit ($0.05/$0.10 USD) - 2019/10/17 18:52:37 ET
Table 'Crater' 6-max Seat #5 is the button
Seat 1: EddieMoney9 ($8 in chips) 
Seat 2: okletsflip ($24.67 in chips) 
Seat 3: LanskyBanksy ($12.90 in chips) 
Seat 4: PlayTheBlues4U ($9.73 in chips) 
Seat 5: DeepMTPocket ($9.93 in chips) 
Seat 6: maccount ($10.26 in chips) 
maccount: posts small blind $0.05
EddieMoney9: posts big blind $0.10
*** HOLE CARDS ***
Dealt to PlayTheBlues4U [7s 4c]
okletsflip: raises $0.10 to $0.20
LanskyBanksy: folds 
PlayTheBlues4U: folds 
DeepMTPocket: calls $0.20
maccount: calls $0.15
EddieMoney9: calls $0.10
*** FLOP *** [3s Ks 8c]
maccount: checks 
EddieMoney9: checks 
okletsflip: checks 
DeepMTPocket: checks 
*** TURN *** [3s Ks 8c] [Kc]
maccount: checks 
EddieMoney9: checks 
okletsflip: bets $0.30
DeepMTPocket: calls $0.30
maccount: folds 
EddieMoney9: folds 
*** RIVER *** [3s Ks 8c Kc] [3c]
okletsflip: bets $0.70
DeepMTPocket: folds 
Uncalled bet ($0.70) returned to okletsflip
okletsflip collected $1.33 from pot
okletsflip: doesn't show hand 
*** SUMMARY ***
Total pot $1.40 | Rake $0.07 
Board [3s Ks 8c Kc 3c]
Seat 1: EddieMoney9 (big blind) folded on the Turn
Seat 2: okletsflip collected ($1.33)
Seat 3: LanskyBanksy folded before Flop (didn't bet)
Seat 4: PlayTheBlues4U folded before Flop (didn't bet)
Seat 5: DeepMTPocket (button) folded on the River
Seat 6: maccount (small blind) folded on the Turn



PokerStars Hand #204645136727:  Hold'em No Limit ($0.05/$0.10 USD) - 2019/10/17 18:53:31 ET
Table 'Crater' 6-max Seat #6 is the button
Seat 1: EddieMoney9 ($7.80 in chips) 
Seat 2: okletsflip ($25.50 in chips) 
Seat 3: LanskyBanksy ($12.90 in chips) 
Seat 4: PlayTheBlues4U ($9.73 in chips) 
Seat 5: DeepMTPocket ($9.43 in chips) 
Seat 6: maccount ($10.06 in chips) 
EddieMoney9: posts small blind $0.05
okletsflip: posts big blind $0.10
*** HOLE CARDS ***
Dealt to PlayTheBlues4U [6d 6h]
LanskyBanksy has timed out
LanskyBanksy: folds 
PlayTheBlues4U: raises $0.20 to $0.30
DeepMTPocket: folds 
maccount: folds 
EddieMoney9: calls $0.25
okletsflip: calls $0.20
*** FLOP *** [4h 3h Qh]
EddieMoney9: checks 
okletsflip: bets $0.20
maccount leaves the table
7noodles joins the table at seat #6 
PlayTheBlues4U: calls $0.20
EddieMoney9: folds 
*** TURN *** [4h 3h Qh] [5s]
okletsflip: bets $0.40
PlayTheBlues4U: raises $0.60 to $1
okletsflip: calls $0.60
*** RIVER *** [4h 3h Qh 5s] [2d]
okletsflip: bets $0.70
PlayTheBlues4U: calls $0.70
*** SHOW DOWN ***
okletsflip: shows [2h Th] (a flush, Queen high)
PlayTheBlues4U: mucks hand 
okletsflip collected $4.46 from pot
*** SUMMARY ***
Total pot $4.70 | Rake $0.24 
Board [4h 3h Qh 5s 2d]
Seat 1: EddieMoney9 (small blind) folded on the Flop
Seat 2: okletsflip (big blind) showed [2h Th] and won ($4.46) with a flush, Queen high
Seat 3: LanskyBanksy folded before Flop (didn't bet)
Seat 4: PlayTheBlues4U mucked [6d 6h]
Seat 5: DeepMTPocket folded before Flop (didn't bet)
Seat 6: maccount (button) folded before Flop (didn't bet)



PokerStars Hand #204645136922:  Hold'em No Limit ($0.05/$0.10 USD) - 2019/10/17 18:54:51 ET
Table 'Crater' 6-max Seat #1 is the button
Seat 1: EddieMoney9 ($7.50 in chips) 
Seat 2: okletsflip ($27.76 in chips) 
Seat 3: LanskyBanksy ($12.90 in chips) 
Seat 4: PlayTheBlues4U ($7.53 in chips) 
Seat 5: DeepMTPocket ($10 in chips) 
okletsflip: posts small blind $0.05
LanskyBanksy: posts big blind $0.10
7noodles: sits out 
*** HOLE CARDS ***
Dealt to PlayTheBlues4U [9h 2s]
PlayTheBlues4U: folds 
DeepMTPocket: raises $0.15 to $0.25
EddieMoney9: folds 
okletsflip: folds 
LanskyBanksy: folds 
Uncalled bet ($0.15) returned to DeepMTPocket
DeepMTPocket collected $0.25 from pot
DeepMTPocket: doesn't show hand 
*** SUMMARY ***
Total pot $0.25 | Rake $0 
Seat 1: EddieMoney9 (button) folded before Flop (didn't bet)
Seat 2: okletsflip (small blind) folded before Flop
Seat 3: LanskyBanksy (big blind) folded before Flop
Seat 4: PlayTheBlues4U folded before Flop (didn't bet)
Seat 5: DeepMTPocket collected ($0.25)



PokerStars Hand #204645136990:  Hold'em No Limit ($0.05/$0.10 USD) - 2019/10/17 18:55:16 ET
Table 'Crater' 6-max Seat #2 is the button
Seat 1: EddieMoney9 ($10 in chips) 
Seat 2: okletsflip ($27.71 in chips) 
Seat 3: LanskyBanksy ($12.80 in chips) 
Seat 4: PlayTheBlues4U ($7.53 in chips) 
Seat 5: DeepMTPocket ($10.15 in chips) 
LanskyBanksy: posts small blind $0.05
PlayTheBlues4U: posts big blind $0.10
7noodles: sits out 
*** HOLE CARDS ***
Dealt to PlayTheBlues4U [Kd 6s]
DeepMTPocket: folds 
EddieMoney9: raises $0.20 to $0.30
okletsflip: folds 
LanskyBanksy: folds 
PlayTheBlues4U: folds 
Uncalled bet ($0.20) returned to EddieMoney9
EddieMoney9 collected $0.25 from pot
EddieMoney9: doesn't show hand 
*** SUMMARY ***
Total pot $0.25 | Rake $0 
Seat 1: EddieMoney9 collected ($0.25)
Seat 2: okletsflip (button) folded before Flop (didn't bet)
Seat 3: LanskyBanksy (small blind) folded before Flop
Seat 4: PlayTheBlues4U (big blind) folded before Flop
Seat 5: DeepMTPocket folded before Flop (didn't bet)



PokerStars Hand #204645137027:  Hold'em No Limit ($0.05/$0.10 USD) - 2019/10/17 18:55:34 ET
Table 'Crater' 6-max Seat #3 is the button
Seat 1: EddieMoney9 ($10.15 in chips) 
Seat 2: okletsflip ($27.71 in chips) 
Seat 3: LanskyBanksy ($12.75 in chips) 
Seat 4: PlayTheBlues4U ($7.43 in chips) 
Seat 5: DeepMTPocket ($10.15 in chips) 
PlayTheBlues4U: posts small blind $0.05
DeepMTPocket: posts big blind $0.10
7noodles: sits out 
*** HOLE CARDS ***
Dealt to PlayTheBlues4U [Td Qs]
EddieMoney9: folds 
okletsflip: calls $0.10
LanskyBanksy: folds 
PlayTheBlues4U: raises $0.20 to $0.30
DeepMTPocket: folds 
okletsflip: calls $0.20
*** FLOP *** [5h 9c Qc]
PlayTheBlues4U: bets $0.40
okletsflip: folds 
Uncalled bet ($0.40) returned to PlayTheBlues4U
PlayTheBlues4U collected $0.66 from pot
PlayTheBlues4U: doesn't show hand 
*** SUMMARY ***
Total pot $0.70 | Rake $0.04 
Board [5h 9c Qc]
Seat 1: EddieMoney9 folded before Flop (didn't bet)
Seat 2: okletsflip folded on the Flop
Seat 3: LanskyBanksy (button) folded before Flop (didn't bet)
Seat 4: PlayTheBlues4U (small blind) collected ($0.66)
Seat 5: DeepMTPocket (big blind) folded before Flop



PokerStars Hand #204645137151:  Hold'em No Limit ($0.05/$0.10 USD) - 2019/10/17 18:56:33 ET
Table 'Crater' 6-max Seat #4 is the button
Seat 1: EddieMoney9 ($10.15 in chips) 
Seat 2: okletsflip ($27.41 in chips) 
Seat 3: LanskyBanksy ($12.75 in chips) 
Seat 4: PlayTheBlues4U ($10 in chips) 
Seat 5: DeepMTPocket ($10.05 in chips) 
Seat 6: 7noodles ($10 in chips) 
DeepMTPocket: posts small blind $0.05
7noodles: posts big blind $0.10
*** HOLE CARDS ***
Dealt to PlayTheBlues4U [7s 2c]
EddieMoney9: folds 
okletsflip: folds 
LanskyBanksy: calls $0.10
PlayTheBlues4U: folds 
DeepMTPocket: calls $0.05
7noodles: checks 
*** FLOP *** [5d Qs 8c]
DeepMTPocket: checks 
7noodles: checks 
LanskyBanksy: checks 
*** TURN *** [5d Qs 8c] [6d]
DeepMTPocket: checks 
7noodles: checks 
LanskyBanksy: checks 
*** RIVER *** [5d Qs 8c 6d] [9c]
DeepMTPocket: bets $0.14
7noodles: calls $0.14
LanskyBanksy: calls $0.14
*** SHOW DOWN ***
DeepMTPocket: shows [7h As] (a straight, Five to Nine)
7noodles: mucks hand 
LanskyBanksy: mucks hand 
DeepMTPocket collected $0.68 from pot
*** SUMMARY ***
Total pot $0.72 | Rake $0.04 
Board [5d Qs 8c 6d 9c]
Seat 1: EddieMoney9 folded before Flop (didn't bet)
Seat 2: okletsflip folded before Flop (didn't bet)
Seat 3: LanskyBanksy mucked [9s Js]
Seat 4: PlayTheBlues4U (button) folded before Flop (didn't bet)
Seat 5: DeepMTPocket (small blind) showed [7h As] and won ($0.68) with a straight, Five to Nine
Seat 6: 7noodles (big blind) mucked [8s Kc]



PokerStars Hand #204645137443:  Hold'em No Limit ($0.05/$0.10 USD) - 2019/10/17 18:58:14 ET
Table 'Crater' 6-max Seat #5 is the button
Seat 1: EddieMoney9 ($10.15 in chips) 
Seat 2: okletsflip ($27.41 in chips) 
Seat 3: LanskyBanksy ($12.51 in chips) 
Seat 4: PlayTheBlues4U ($10 in chips) 
Seat 5: DeepMTPocket ($10.49 in chips) 
Seat 6: 7noodles ($9.76 in chips) 
7noodles: posts small blind $0.05
EddieMoney9: posts big blind $0.10
*** HOLE CARDS ***
Dealt to PlayTheBlues4U [9d 2h]
okletsflip: raises $0.10 to $0.20
LanskyBanksy: folds 
PlayTheBlues4U: folds 
DeepMTPocket: folds 
7noodles: folds 
EddieMoney9: folds 
Uncalled bet ($0.10) returned to okletsflip
okletsflip collected $0.25 from pot
okletsflip: doesn't show hand 
*** SUMMARY ***
Total pot $0.25 | Rake $0 
Seat 1: EddieMoney9 (big blind) folded before Flop
Seat 2: okletsflip collected ($0.25)
Seat 3: LanskyBanksy folded before Flop (didn't bet)
Seat 4: PlayTheBlues4U folded before Flop (didn't bet)
Seat 5: DeepMTPocket (button) folded before Flop (didn't bet)
Seat 6: 7noodles (small blind) folded before Flop



PokerStars Hand #204645137563:  Hold'em No Limit ($0.05/$0.10 USD) - 2019/10/17 18:58:56 ET
Table 'Crater' 6-max Seat #6 is the button
Seat 1: EddieMoney9 ($10.05 in chips) 
Seat 2: okletsflip ($27.56 in chips) 
Seat 4: PlayTheBlues4U ($10 in chips) 
Seat 5: DeepMTPocket ($10.49 in chips) 
Seat 6: 7noodles ($9.71 in chips) 
EddieMoney9: posts small blind $0.05
okletsflip: posts big blind $0.10
*** HOLE CARDS ***
Dealt to PlayTheBlues4U [Kh 3c]
PlayTheBlues4U: folds 
DeepMTPocket: raises $0.15 to $0.25
7noodles: folds 
EddieMoney9: folds 
okletsflip: raises $0.15 to $0.40
DeepMTPocket: calls $0.15
*** FLOP *** [6s Ad Jc]
okletsflip: checks 
DeepMTPocket: bets $0.50
okletsflip: raises $0.50 to $1
DeepMTPocket: calls $0.50
*** TURN *** [6s Ad Jc] [Kd]
okletsflip: checks 
DeepMTPocket: checks 
*** RIVER *** [6s Ad Jc Kd] [5h]
okletsflip: bets $2.70
DeepMTPocket: calls $2.70
*** SHOW DOWN ***
okletsflip: shows [3h 9d] (high card Ace)
DeepMTPocket: shows [As 4h] (a pair of Aces)
DeepMTPocket collected $7.84 from pot
*** SUMMARY ***
Total pot $8.25 | Rake $0.41 
Board [6s Ad Jc Kd 5h]
Seat 1: EddieMoney9 (small blind) folded before Flop
Seat 2: okletsflip (big blind) showed [3h 9d] and lost with high card Ace
Seat 4: PlayTheBlues4U folded before Flop (didn't bet)
Seat 5: DeepMTPocket showed [As 4h] and won ($7.84) with a pair of Aces
Seat 6: 7noodles (button) folded before Flop (didn't bet)



PokerStars Hand #204645137818:  Hold'em No Limit ($0.05/$0.10 USD) - 2019/10/17 19:00:35 ET
Table 'Crater' 6-max Seat #1 is the button
Seat 1: EddieMoney9 ($10 in chips) 
Seat 2: okletsflip ($23.46 in chips) 
Seat 4: PlayTheBlues4U ($10 in chips) 
Seat 5: DeepMTPocket ($14.23 in chips) 
Seat 6: 7noodles ($9.71 in chips) 
okletsflip: posts small blind $0.05
PlayTheBlues4U: posts big blind $0.10
*** HOLE CARDS ***
Dealt to PlayTheBlues4U [Qc Th]
DeepMTPocket: folds 
7noodles: folds 
EddieMoney9: folds 
okletsflip: calls $0.05
PlayTheBlues4U: checks 
*** FLOP *** [5d 8s 8c]
okletsflip: checks 
PlayTheBlues4U: checks 
*** TURN *** [5d 8s 8c] [4d]
okletsflip: bets $0.20
PlayTheBlues4U: folds 
Uncalled bet ($0.20) returned to okletsflip
okletsflip collected $0.19 from pot
okletsflip: doesn't show hand 
*** SUMMARY ***
Total pot $0.20 | Rake $0.01 
Board [5d 8s 8c 4d]
Seat 1: EddieMoney9 (button) folded before Flop (didn't bet)
Seat 2: okletsflip (small blind) collected ($0.19)
Seat 4: PlayTheBlues4U (big blind) folded on the Turn
Seat 5: DeepMTPocket folded before Flop (didn't bet)
Seat 6: 7noodles folded before Flop (didn't bet)



PokerStars Hand #204645137919:  Hold'em No Limit ($0.05/$0.10 USD) - 2019/10/17 19:01:13 ET
Table 'Crater' 6-max Seat #2 is the button
Seat 1: EddieMoney9 ($10 in chips) 
Seat 2: okletsflip ($23.55 in chips) 
Seat 4: PlayTheBlues4U ($9.90 in chips) 
Seat 5: DeepMTPocket ($14.23 in chips) 
Seat 6: 7noodles ($9.71 in chips) 
PlayTheBlues4U: posts small blind $0.05
DeepMTPocket: posts big blind $0.10
*** HOLE CARDS ***
Dealt to PlayTheBlues4U [Ah 4c]
7noodles: folds 
EddieMoney9: folds 
okletsflip: calls $0.10
PlayTheBlues4U: raises $0.20 to $0.30
DeepMTPocket: folds 
okletsflip: raises $0.20 to $0.50
PlayTheBlues4U: calls $0.20
*** FLOP *** [4s 8s Ac]
PlayTheBlues4U: bets $0.80
okletsflip: raises $0.80 to $1.60
PlayTheBlues4U: raises $1.20 to $2.80
okletsflip: folds 
Uncalled bet ($1.20) returned to PlayTheBlues4U
PlayTheBlues4U collected $4.08 from pot
PlayTheBlues4U: doesn't show hand 
*** SUMMARY ***
Total pot $4.30 | Rake $0.22 
Board [4s 8s Ac]
Seat 1: EddieMoney9 folded before Flop (didn't bet)
Seat 2: okletsflip (button) folded on the Flop
Seat 4: PlayTheBlues4U (small blind) collected ($4.08)
Seat 5: DeepMTPocket (big blind) folded before Flop
Seat 6: 7noodles folded before Flop (didn't bet)



PokerStars Hand #204645138163:  Hold'em No Limit ($0.05/$0.10 USD) - 2019/10/17 19:02:41 ET
Table 'Crater' 6-max Seat #4 is the button
Seat 1: EddieMoney9 ($10 in chips) 
Seat 2: okletsflip ($21.45 in chips) 
Seat 4: PlayTheBlues4U ($11.88 in chips) 
Seat 5: DeepMTPocket ($14.13 in chips) 
Seat 6: 7noodles ($9.71 in chips) 
DeepMTPocket: posts small blind $0.05
7noodles: posts big blind $0.10
*** HOLE CARDS ***
Dealt to PlayTheBlues4U [9s Qh]
EddieMoney9: folds 
okletsflip: calls $0.10
PlayTheBlues4U: folds 
DeepMTPocket: calls $0.05
7noodles: checks 
*** FLOP *** [Ks 6c Kd]
DeepMTPocket: bets $0.10
7noodles: folds 
okletsflip: folds 
Uncalled bet ($0.10) returned to DeepMTPocket
DeepMTPocket collected $0.28 from pot
DeepMTPocket: doesn't show hand 
*** SUMMARY ***
Total pot $0.30 | Rake $0.02 
Board [Ks 6c Kd]
Seat 1: EddieMoney9 folded before Flop (didn't bet)
Seat 2: okletsflip folded on the Flop
Seat 4: PlayTheBlues4U (button) folded before Flop (didn't bet)
Seat 5: DeepMTPocket (small blind) collected ($0.28)
Seat 6: 7noodles (big blind) folded on the Flop



PokerStars Hand #204645138288:  Hold'em No Limit ($0.05/$0.10 USD) - 2019/10/17 19:03:30 ET
Table 'Crater' 6-max Seat #5 is the button
Seat 1: EddieMoney9 ($10 in chips) 
Seat 2: okletsflip ($21.35 in chips) 
Seat 4: PlayTheBlues4U ($11.88 in chips) 
Seat 5: DeepMTPocket ($14.31 in chips) 
Seat 6: 7noodles ($9.61 in chips) 
7noodles: posts small blind $0.05
EddieMoney9: posts big blind $0.10
*** HOLE CARDS ***
Dealt to PlayTheBlues4U [9s Kh]
okletsflip: raises $0.10 to $0.20
PlayTheBlues4U: folds 
DeepMTPocket: calls $0.20
7noodles: folds 
EddieMoney9: calls $0.10
*** FLOP *** [5s 9c 7c]
EddieMoney9: checks 
okletsflip: bets $0.20
DeepMTPocket: calls $0.20
EddieMoney9: folds 
*** TURN *** [5s 9c 7c] [5h]
okletsflip: bets $0.20
DeepMTPocket: calls $0.20
*** RIVER *** [5s 9c 7c 5h] [7h]
okletsflip: bets $0.70
LanskyBanksy leaves the table
DeepMTPocket: raises $2.80 to $3.50
okletsflip: calls $2.80
*** SHOW DOWN ***
DeepMTPocket: shows [7d Ad] (a full house, Sevens full of Fives)
okletsflip: mucks hand 
DeepMTPocket collected $8.03 from pot
*** SUMMARY ***
Total pot $8.45 | Rake $0.42 
Board [5s 9c 7c 5h 7h]
Seat 1: EddieMoney9 (big blind) folded on the Flop
Seat 2: okletsflip mucked [6c 6h]
Seat 4: PlayTheBlues4U folded before Flop (didn't bet)
Seat 5: DeepMTPocket (button) showed [7d Ad] and won ($8.03) with a full house, Sevens full of Fives
Seat 6: 7noodles (small blind) folded before Flop



PokerStars Hand #204645138488:  Hold'em No Limit ($0.05/$0.10 USD) - 2019/10/17 19:04:55 ET
Table 'Crater' 6-max Seat #6 is the button
Seat 1: EddieMoney9 ($9.80 in chips) 
Seat 2: okletsflip ($17.25 in chips) 
Seat 4: PlayTheBlues4U ($11.88 in chips) 
Seat 5: DeepMTPocket ($18.24 in chips) 
Seat 6: 7noodles ($9.56 in chips) 
EddieMoney9: posts small blind $0.05
okletsflip: posts big blind $0.10
*** HOLE CARDS ***
Dealt to PlayTheBlues4U [7h As]
PlayTheBlues4U: folds 
DeepMTPocket: folds 
okletsflip said, "I MISL I KEE LOL"
okletsflip said, "i mislckcee"
Ionix1 joins the table at seat #3 
7noodles: folds 
EddieMoney9: calls $0.05
okletsflip: raises $0.10 to $0.20
EddieMoney9: calls $0.10
*** FLOP *** [5s Th Ad]
EddieMoney9: checks 
okletsflip: bets $0.40
EddieMoney9: folds 
Uncalled bet ($0.40) returned to okletsflip
okletsflip collected $0.38 from pot
okletsflip: doesn't show hand 
*** SUMMARY ***
Total pot $0.40 | Rake $0.02 
Board [5s Th Ad]
Seat 1: EddieMoney9 (small blind) folded on the Flop
Seat 2: okletsflip (big blind) collected ($0.38)
Seat 4: PlayTheBlues4U folded before Flop (didn't bet)
Seat 5: DeepMTPocket folded before Flop (didn't bet)
Seat 6: 7noodles (button) folded before Flop (didn't bet)



PokerStars Hand #204645138586:  Hold'em No Limit ($0.05/$0.10 USD) - 2019/10/17 19:05:33 ET
Table 'Crater' 6-max Seat #1 is the button
Seat 1: EddieMoney9 ($9.60 in chips) 
Seat 2: okletsflip ($17.43 in chips) 
Seat 3: Ionix1 ($10.83 in chips) 
Seat 4: PlayTheBlues4U ($11.88 in chips) 
Seat 5: DeepMTPocket ($18.24 in chips) 
Seat 6: 7noodles ($9.56 in chips) 
okletsflip: posts small blind $0.05
Ionix1: posts big blind $0.10
*** HOLE CARDS ***
Dealt to PlayTheBlues4U [6s 6d]
PlayTheBlues4U: raises $0.20 to $0.30
DeepMTPocket: calls $0.30
7noodles: folds 
EddieMoney9: folds 
okletsflip: calls $0.25
Ionix1: folds 
*** FLOP *** [Js 8c 4s]
okletsflip: bets $0.20
PlayTheBlues4U: folds 
DeepMTPocket: raises $0.80 to $1
okletsflip: calls $0.80
*** TURN *** [Js 8c 4s] [Ah]
okletsflip: bets $0.40
DeepMTPocket: calls $0.40
*** RIVER *** [Js 8c 4s Ah] [7d]
okletsflip: bets $3.60
DeepMTPocket: calls $3.60
*** SHOW DOWN ***
okletsflip: shows [Ac 8d] (two pair, Aces and Eights)
DeepMTPocket: mucks hand 
okletsflip collected $10.45 from pot
*** SUMMARY ***
Total pot $11 | Rake $0.55 
Board [Js 8c 4s Ah 7d]
Seat 1: EddieMoney9 (button) folded before Flop (didn't bet)
Seat 2: okletsflip (small blind) showed [Ac 8d] and won ($10.45) with two pair, Aces and Eights
Seat 3: Ionix1 (big blind) folded before Flop
Seat 4: PlayTheBlues4U folded on the Flop
Seat 5: DeepMTPocket mucked [Jc 9c]
Seat 6: 7noodles folded before Flop (didn't bet)



PokerStars Hand #204645138727:  Hold'em No Limit ($0.05/$0.10 USD) - 2019/10/17 19:06:29 ET
Table 'Crater' 6-max Seat #2 is the button
Seat 1: EddieMoney9 ($9.60 in chips) 
Seat 2: okletsflip ($22.58 in chips) 
Seat 3: Ionix1 ($10.73 in chips) 
Seat 4: PlayTheBlues4U ($11.58 in chips) 
Seat 5: DeepMTPocket ($12.94 in chips) 
Seat 6: 7noodles ($9.56 in chips) 
Ionix1: posts small blind $0.05
PlayTheBlues4U: posts big blind $0.10
*** HOLE CARDS ***
Dealt to PlayTheBlues4U [4h 8d]
DeepMTPocket: folds 
7noodles: raises $0.20 to $0.30
EddieMoney9: folds 
okletsflip: raises $0.20 to $0.50
Ionix1: calls $0.45
PlayTheBlues4U: folds 
7noodles: calls $0.20
*** FLOP *** [8c 5h Jc]
Ionix1: checks 
7noodles: checks 
okletsflip: bets $0.20
Ionix1: folds 
7noodles: calls $0.20
*** TURN *** [8c 5h Jc] [7s]
7noodles: checks 
okletsflip: checks 
*** RIVER *** [8c 5h Jc 7s] [9d]
7noodles: checks 
okletsflip: bets $0.90
7noodles: calls $0.90
*** SHOW DOWN ***
okletsflip: shows [Ac Ks] (high card Ace)
7noodles: shows [6d 7d] (a straight, Five to Nine)
7noodles collected $3.61 from pot
*** SUMMARY ***
Total pot $3.80 | Rake $0.19 
Board [8c 5h Jc 7s 9d]
Seat 1: EddieMoney9 folded before Flop (didn't bet)
Seat 2: okletsflip (button) showed [Ac Ks] and lost with high card Ace
Seat 3: Ionix1 (small blind) folded on the Flop
Seat 4: PlayTheBlues4U (big blind) folded before Flop
Seat 5: DeepMTPocket folded before Flop (didn't bet)
Seat 6: 7noodles showed [6d 7d] and won ($3.61) with a straight, Five to Nine



PokerStars Hand #204645138873:  Hold'em No Limit ($0.05/$0.10 USD) - 2019/10/17 19:07:29 ET
Table 'Crater' 6-max Seat #3 is the button
Seat 1: EddieMoney9 ($9.60 in chips) 
Seat 2: okletsflip ($20.98 in chips) 
Seat 3: Ionix1 ($10.23 in chips) 
Seat 4: PlayTheBlues4U ($11.48 in chips) 
Seat 5: DeepMTPocket ($12.94 in chips) 
Seat 6: 7noodles ($11.57 in chips) 
PlayTheBlues4U: posts small blind $0.05
DeepMTPocket: posts big blind $0.10
*** HOLE CARDS ***
Dealt to PlayTheBlues4U [2c Kc]
7noodles: folds 
EddieMoney9: folds 
okletsflip: folds 
Ionix1: calls $0.10
PlayTheBlues4U: folds 
DeepMTPocket: checks 
*** FLOP *** [Ah 6s 9d]
DeepMTPocket: checks 
Ionix1: checks 
*** TURN *** [Ah 6s 9d] [4d]
DeepMTPocket: checks 
Ionix1: checks 
*** RIVER *** [Ah 6s 9d 4d] [Jh]
DeepMTPocket: checks 
Ionix1: bets $0.10
DeepMTPocket: folds 
Uncalled bet ($0.10) returned to Ionix1
Ionix1 collected $0.24 from pot
Ionix1: doesn't show hand 
*** SUMMARY ***
Total pot $0.25 | Rake $0.01 
Board [Ah 6s 9d 4d Jh]
Seat 1: EddieMoney9 folded before Flop (didn't bet)
Seat 2: okletsflip folded before Flop (didn't bet)
Seat 3: Ionix1 (button) collected ($0.24)
Seat 4: PlayTheBlues4U (small blind) folded before Flop
Seat 5: DeepMTPocket (big blind) folded on the River
Seat 6: 7noodles folded before Flop (didn't bet)



PokerStars Hand #204645138964:  Hold'em No Limit ($0.05/$0.10 USD) - 2019/10/17 19:08:00 ET
Table 'Crater' 6-max Seat #4 is the button
Seat 1: EddieMoney9 ($9.60 in chips) 
Seat 2: okletsflip ($20.98 in chips) 
Seat 3: Ionix1 ($10.37 in chips) 
Seat 4: PlayTheBlues4U ($11.43 in chips) 
Seat 5: DeepMTPocket ($12.84 in chips) 
Seat 6: 7noodles ($11.57 in chips) 
DeepMTPocket: posts small blind $0.05
7noodles: posts big blind $0.10
*** HOLE CARDS ***
Dealt to PlayTheBlues4U [5d As]
EddieMoney9: folds 
okletsflip: raises $0.10 to $0.20
Ionix1: calls $0.20
PlayTheBlues4U: folds 
DeepMTPocket: folds 
7noodles: folds 
*** FLOP *** [4c Qh 9c]
okletsflip: bets $0.10
Ionix1: calls $0.10
*** TURN *** [4c Qh 9c] [Kc]
okletsflip: bets $0.10
Ionix1: calls $0.10
*** RIVER *** [4c Qh 9c Kc] [Jc]
okletsflip: bets $0.50
Ionix1: folds 
Uncalled bet ($0.50) returned to okletsflip
okletsflip collected $0.90 from pot
okletsflip: doesn't show hand 
*** SUMMARY ***
Total pot $0.95 | Rake $0.05 
Board [4c Qh 9c Kc Jc]
Seat 1: EddieMoney9 folded before Flop (didn't bet)
Seat 2: okletsflip collected ($0.90)
Seat 3: Ionix1 folded on the River
Seat 4: PlayTheBlues4U (button) folded before Flop (didn't bet)
Seat 5: DeepMTPocket (small blind) folded before Flop
Seat 6: 7noodles (big blind) folded before Flop



PokerStars Hand #204645139087:  Hold'em No Limit ($0.05/$0.10 USD) - 2019/10/17 19:08:46 ET
Table 'Crater' 6-max Seat #5 is the button
Seat 1: EddieMoney9 ($9.60 in chips) 
Seat 2: okletsflip ($21.48 in chips) 
Seat 3: Ionix1 ($9.97 in chips) 
Seat 4: PlayTheBlues4U ($11.43 in chips) 
Seat 5: DeepMTPocket ($12.79 in chips) 
Seat 6: 7noodles ($11.47 in chips) 
7noodles: posts small blind $0.05
EddieMoney9: posts big blind $0.10
*** HOLE CARDS ***
Dealt to PlayTheBlues4U [7c As]
okletsflip: raises $0.10 to $0.20
Ionix1: calls $0.20
PlayTheBlues4U: folds 
DeepMTPocket: calls $0.20
7noodles: raises $0.70 to $0.90
EddieMoney9: folds 
okletsflip: calls $0.70
Ionix1: folds 
DeepMTPocket: calls $0.70
*** FLOP *** [Js 3c 7h]
7noodles: bets $1.43
okletsflip: calls $1.43
DeepMTPocket: folds 
*** TURN *** [Js 3c 7h] [Ts]
7noodles: checks 
okletsflip: bets $19.15 and is all-in
7noodles: calls $9.14 and is all-in
Uncalled bet ($10.01) returned to okletsflip
*** RIVER *** [Js 3c 7h Ts] [3d]
*** SHOW DOWN ***
7noodles: shows [Qc Qd] (two pair, Queens and Threes)
okletsflip: shows [Ac 2h] (a pair of Threes)
7noodles collected $22.93 from pot
*** SUMMARY ***
Total pot $24.14 | Rake $1.21 
Board [Js 3c 7h Ts 3d]
Seat 1: EddieMoney9 (big blind) folded before Flop
Seat 2: okletsflip showed [Ac 2h] and lost with a pair of Threes
Seat 3: Ionix1 folded before Flop
Seat 4: PlayTheBlues4U folded before Flop (didn't bet)
Seat 5: DeepMTPocket (button) folded on the Flop
Seat 6: 7noodles (small blind) showed [Qc Qd] and won ($22.93) with two pair, Queens and Threes



PokerStars Hand #204645139390:  Hold'em No Limit ($0.05/$0.10 USD) - 2019/10/17 19:10:36 ET
Table 'Crater' 6-max Seat #6 is the button
Seat 1: EddieMoney9 ($10 in chips) 
Seat 2: okletsflip ($10.01 in chips) 
Seat 3: Ionix1 ($9.77 in chips) 
Seat 4: PlayTheBlues4U ($11.43 in chips) 
Seat 5: DeepMTPocket ($11.89 in chips) 
Seat 6: 7noodles ($22.93 in chips) 
EddieMoney9: posts small blind $0.05
okletsflip: posts big blind $0.10
*** HOLE CARDS ***
Dealt to PlayTheBlues4U [7c 6d]
okletsflip said, "oops"
7noodles said, "ty"
Ionix1: raises $0.10 to $0.20
PlayTheBlues4U: folds 
DeepMTPocket: folds 
7noodles: folds 
okletsflip said, "u need it more than me haha"
EddieMoney9: calls $0.15
okletsflip: calls $0.10
*** FLOP *** [Ts 3d 4h]
EddieMoney9: checks 
okletsflip: checks 
Ionix1: bets $0.10
EddieMoney9: calls $0.10
okletsflip: calls $0.10
*** TURN *** [Ts 3d 4h] [6c]
EddieMoney9: checks 
okletsflip: checks 
Ionix1: bets $0.20
EddieMoney9: folds 
okletsflip: calls $0.20
*** RIVER *** [Ts 3d 4h 6c] [6s]
okletsflip: checks 
Ionix1: bets $0.50
okletsflip: folds 
Uncalled bet ($0.50) returned to Ionix1
Ionix1 collected $1.24 from pot
Ionix1: doesn't show hand 
*** SUMMARY ***
Total pot $1.30 | Rake $0.06 
Board [Ts 3d 4h 6c 6s]
Seat 1: EddieMoney9 (small blind) folded on the Turn
Seat 2: okletsflip (big blind) folded on the River
Seat 3: Ionix1 collected ($1.24)
Seat 4: PlayTheBlues4U folded before Flop (didn't bet)
Seat 5: DeepMTPocket folded before Flop (didn't bet)
Seat 6: 7noodles (button) folded before Flop (didn't bet)



PokerStars Hand #204645139564:  Hold'em No Limit ($0.05/$0.10 USD) - 2019/10/17 19:11:44 ET
Table 'Crater' 6-max Seat #1 is the button
Seat 1: EddieMoney9 ($9.70 in chips) 
Seat 2: okletsflip ($9.51 in chips) 
Seat 3: Ionix1 ($10.51 in chips) 
Seat 4: PlayTheBlues4U ($11.43 in chips) 
Seat 5: DeepMTPocket ($11.89 in chips) 
Seat 6: 7noodles ($22.93 in chips) 
okletsflip: posts small blind $0.05
Ionix1: posts big blind $0.10
*** HOLE CARDS ***
Dealt to PlayTheBlues4U [8h Qs]
PlayTheBlues4U: folds 
DeepMTPocket: folds 
7noodles: folds 
EddieMoney9: folds 
okletsflip: calls $0.05
Ionix1: checks 
*** FLOP *** [As Ad Ac]
okletsflip: checks 
Ionix1: checks 
*** TURN *** [As Ad Ac] [9c]
okletsflip: bets $0.20
Ionix1: folds 
Uncalled bet ($0.20) returned to okletsflip
okletsflip collected $0.19 from pot
okletsflip: doesn't show hand 
*** SUMMARY ***
Total pot $0.20 | Rake $0.01 
Board [As Ad Ac 9c]
Seat 1: EddieMoney9 (button) folded before Flop (didn't bet)
Seat 2: okletsflip (small blind) collected ($0.19)
Seat 3: Ionix1 (big blind) folded on the Turn
Seat 4: PlayTheBlues4U folded before Flop (didn't bet)
Seat 5: DeepMTPocket folded before Flop (didn't bet)
Seat 6: 7noodles folded before Flop (didn't bet)



PokerStars Hand #204645692626:  Hold'em No Limit ($0.05/$0.10 USD) - 2019/10/17 19:16:48 ET
Table 'Crater' 6-max Seat #2 is the button
Seat 1: EddieMoney9 ($9.71 in chips) 
Seat 2: okletsflip ($8.66 in chips) 
Seat 3: Ionix1 ($9.97 in chips) 
Seat 4: PlayTheBlues4U ($11.43 in chips) 
Seat 5: DeepMTPocket ($11.24 in chips) 
Seat 6: 7noodles ($24.66 in chips) 
Ionix1: posts small blind $0.05
PlayTheBlues4U: posts big blind $0.10
*** HOLE CARDS ***
Dealt to PlayTheBlues4U [7c Ac]
DeepMTPocket: folds 
7noodles: folds 
EddieMoney9: raises $0.20 to $0.30
okletsflip: calls $0.30
Ionix1: calls $0.25
PlayTheBlues4U: calls $0.20
*** FLOP *** [6c Qc 5h]
Ionix1: bets $0.20
PlayTheBlues4U: raises $0.70 to $0.90
EddieMoney9: folds 
okletsflip: folds 
Ionix1: calls $0.70
*** TURN *** [6c Qc 5h] [4c]
Ionix1: checks 
PlayTheBlues4U: bets $1.43
Ionix1: folds 
Uncalled bet ($1.43) returned to PlayTheBlues4U
PlayTheBlues4U collected $2.85 from pot
PlayTheBlues4U: doesn't show hand 
*** SUMMARY ***
Total pot $3 | Rake $0.15 
Board [6c Qc 5h 4c]
Seat 1: EddieMoney9 folded on the Flop
Seat 2: okletsflip (button) folded on the Flop
Seat 3: Ionix1 (small blind) folded on the Turn
Seat 4: PlayTheBlues4U (big blind) collected ($2.85)
Seat 5: DeepMTPocket folded before Flop (didn't bet)
Seat 6: 7noodles folded before Flop (didn't bet)



PokerStars Hand #204645692883:  Hold'em No Limit ($0.05/$0.10 USD) - 2019/10/17 19:18:09 ET
Table 'Crater' 6-max Seat #3 is the button
Seat 1: EddieMoney9 ($9.41 in chips) 
Seat 2: okletsflip ($8.36 in chips) 
Seat 3: Ionix1 ($8.77 in chips) 
Seat 4: PlayTheBlues4U ($13.08 in chips) 
Seat 5: DeepMTPocket ($11.24 in chips) 
Seat 6: 7noodles ($24.66 in chips) 
PlayTheBlues4U: posts small blind $0.05
DeepMTPocket: posts big blind $0.10
*** HOLE CARDS ***
Dealt to PlayTheBlues4U [Ac 5c]
7noodles: folds 
EddieMoney9: folds 
okletsflip: calls $0.10
Ionix1: folds 
PlayTheBlues4U: raises $0.20 to $0.30
DeepMTPocket: calls $0.20
okletsflip: calls $0.20
*** FLOP *** [9s 4h 9d]
PlayTheBlues4U: bets $0.50
DeepMTPocket: calls $0.50
okletsflip: folds 
*** TURN *** [9s 4h 9d] [8c]
PlayTheBlues4U: checks 
DeepMTPocket: bets $0.90
PlayTheBlues4U: folds 
Uncalled bet ($0.90) returned to DeepMTPocket
DeepMTPocket collected $1.80 from pot
DeepMTPocket: doesn't show hand 
*** SUMMARY ***
Total pot $1.90 | Rake $0.10 
Board [9s 4h 9d 8c]
Seat 1: EddieMoney9 folded before Flop (didn't bet)
Seat 2: okletsflip folded on the Flop
Seat 3: Ionix1 (button) folded before Flop (didn't bet)
Seat 4: PlayTheBlues4U (small blind) folded on the Turn
Seat 5: DeepMTPocket (big blind) collected ($1.80)
Seat 6: 7noodles folded before Flop (didn't bet)



PokerStars Hand #204645693102:  Hold'em No Limit ($0.05/$0.10 USD) - 2019/10/17 19:19:33 ET
Table 'Crater' 6-max Seat #4 is the button
Seat 1: EddieMoney9 ($9.41 in chips) 
Seat 2: okletsflip ($8.06 in chips) 
Seat 3: Ionix1 ($8.77 in chips) 
Seat 4: PlayTheBlues4U ($12.28 in chips) 
Seat 5: DeepMTPocket ($12.24 in chips) 
Seat 6: 7noodles ($24.66 in chips) 
DeepMTPocket: posts small blind $0.05
7noodles: posts big blind $0.10
*** HOLE CARDS ***
Dealt to PlayTheBlues4U [Js Qc]
EddieMoney9: folds 
okletsflip: raises $0.10 to $0.20
Ionix1: folds 
PlayTheBlues4U: calls $0.20
DeepMTPocket: calls $0.15
7noodles: folds 
*** FLOP *** [As 3s Ts]
DeepMTPocket: checks 
okletsflip: checks 
PlayTheBlues4U: checks 
*** TURN *** [As 3s Ts] [Kd]
DeepMTPocket: checks 
okletsflip: bets $0.20
PlayTheBlues4U: raises $0.30 to $0.50
DeepMTPocket: folds 
okletsflip: calls $0.30
*** RIVER *** [As 3s Ts Kd] [6h]
okletsflip: bets $0.40
PlayTheBlues4U: calls $0.40
*** SHOW DOWN ***
okletsflip: shows [Ah 4h] (a pair of Aces)
PlayTheBlues4U: shows [Js Qc] (a straight, Ten to Ace)
PlayTheBlues4U collected $2.38 from pot
*** SUMMARY ***
Total pot $2.50 | Rake $0.12 
Board [As 3s Ts Kd 6h]
Seat 1: EddieMoney9 folded before Flop (didn't bet)
Seat 2: okletsflip showed [Ah 4h] and lost with a pair of Aces
Seat 3: Ionix1 folded before Flop (didn't bet)
Seat 4: PlayTheBlues4U (button) showed [Js Qc] and won ($2.38) with a straight, Ten to Ace
Seat 5: DeepMTPocket (small blind) folded on the Turn
Seat 6: 7noodles (big blind) folded before Flop



PokerStars Hand #204645693261:  Hold'em No Limit ($0.05/$0.10 USD) - 2019/10/17 19:20:38 ET
Table 'Crater' 6-max Seat #5 is the button
Seat 1: EddieMoney9 ($9.41 in chips) 
Seat 2: okletsflip ($6.96 in chips) 
Seat 3: Ionix1 ($8.77 in chips) 
Seat 4: PlayTheBlues4U ($13.56 in chips) 
Seat 5: DeepMTPocket ($12.04 in chips) 
Seat 6: 7noodles ($24.56 in chips) 
7noodles: posts small blind $0.05
EddieMoney9: posts big blind $0.10
*** HOLE CARDS ***
Dealt to PlayTheBlues4U [6s 7d]
okletsflip: folds 
Ionix1: folds 
PlayTheBlues4U: folds 
DeepMTPocket: folds 
okletsflip is disconnected 
7noodles: folds 
Uncalled bet ($0.05) returned to EddieMoney9
EddieMoney9 collected $0.10 from pot
EddieMoney9: doesn't show hand 
*** SUMMARY ***
Total pot $0.10 | Rake $0 
Seat 1: EddieMoney9 (big blind) collected ($0.10)
Seat 2: okletsflip folded before Flop (didn't bet)
Seat 3: Ionix1 folded before Flop (didn't bet)
Seat 4: PlayTheBlues4U folded before Flop (didn't bet)
Seat 5: DeepMTPocket (button) folded before Flop (didn't bet)
Seat 6: 7noodles (small blind) folded before Flop



PokerStars Hand #204645693309:  Hold'em No Limit ($0.05/$0.10 USD) - 2019/10/17 19:20:58 ET
Table 'Crater' 6-max Seat #6 is the button
Seat 1: EddieMoney9 ($9.46 in chips) 
Seat 3: Ionix1 ($8.77 in chips) 
Seat 4: PlayTheBlues4U ($13.56 in chips) 
Seat 5: DeepMTPocket ($12.04 in chips) 
Seat 6: 7noodles ($24.51 in chips) 
EddieMoney9: posts small blind $0.05
okletsflip has timed out while disconnected
okletsflip: is sitting out 
Ionix1: posts big blind $0.10
*** HOLE CARDS ***
Dealt to PlayTheBlues4U [Kd 8s]
PlayTheBlues4U: folds 
DeepMTPocket: folds 
7noodles: folds 
EddieMoney9: raises $0.20 to $0.30
Ionix1: folds 
Uncalled bet ($0.20) returned to EddieMoney9
EddieMoney9 collected $0.20 from pot
EddieMoney9: doesn't show hand 
*** SUMMARY ***
Total pot $0.20 | Rake $0 
Seat 1: EddieMoney9 (small blind) collected ($0.20)
Seat 3: Ionix1 (big blind) folded before Flop
Seat 4: PlayTheBlues4U folded before Flop (didn't bet)
Seat 5: DeepMTPocket folded before Flop (didn't bet)
Seat 6: 7noodles (button) folded before Flop (didn't bet)



PokerStars Hand #204645693393:  Hold'em No Limit ($0.05/$0.10 USD) - 2019/10/17 19:21:32 ET
Table 'Crater' 6-max Seat #1 is the button
Seat 1: EddieMoney9 ($9.56 in chips) 
Seat 3: Ionix1 ($8.67 in chips) 
Seat 4: PlayTheBlues4U ($13.56 in chips) 
Seat 5: DeepMTPocket ($12.04 in chips) 
Seat 6: 7noodles ($24.51 in chips) 
Ionix1: posts small blind $0.05
PlayTheBlues4U: posts big blind $0.10
*** HOLE CARDS ***
Dealt to PlayTheBlues4U [3c Jd]
DeepMTPocket: folds 
7noodles: folds 
DeepMTPocket leaves the table
EddieMoney9: raises $0.25 to $0.35
Ionix1: folds 
PlayTheBlues4U: folds 
Uncalled bet ($0.25) returned to EddieMoney9
EddieMoney9 collected $0.25 from pot
EddieMoney9: doesn't show hand 
The_BT_Show joins the table at seat #5 
*** SUMMARY ***
Total pot $0.25 | Rake $0 
Seat 1: EddieMoney9 (button) collected ($0.25)
Seat 3: Ionix1 (small blind) folded before Flop
Seat 4: PlayTheBlues4U (big blind) folded before Flop
Seat 5: DeepMTPocket folded before Flop (didn't bet)
Seat 6: 7noodles folded before Flop (didn't bet)



PokerStars Hand #204645693454:  Hold'em No Limit ($0.05/$0.10 USD) - 2019/10/17 19:21:52 ET
Table 'Crater' 6-max Seat #3 is the button
Seat 1: EddieMoney9 ($9.71 in chips) 
Seat 3: Ionix1 ($8.62 in chips) 
Seat 4: PlayTheBlues4U ($13.46 in chips) 
Seat 5: The_BT_Show ($10 in chips) 
Seat 6: 7noodles ($24.51 in chips) 
PlayTheBlues4U: posts small blind $0.05
The_BT_Show: posts big blind $0.10
*** HOLE CARDS ***
Dealt to PlayTheBlues4U [4s 2d]
7noodles: raises $0.20 to $0.30
EddieMoney9: folds 
Ionix1: calls $0.30
PlayTheBlues4U: folds 
The_BT_Show: folds 
*** FLOP *** [5d Js 9c]
7noodles: bets $0.36
Ionix1: folds 
Uncalled bet ($0.36) returned to 7noodles
7noodles collected $0.71 from pot
7noodles: doesn't show hand 
*** SUMMARY ***
Total pot $0.75 | Rake $0.04 
Board [5d Js 9c]
Seat 1: EddieMoney9 folded before Flop (didn't bet)
Seat 3: Ionix1 (button) folded on the Flop
Seat 4: PlayTheBlues4U (small blind) folded before Flop
Seat 5: The_BT_Show (big blind) folded before Flop
Seat 6: 7noodles collected ($0.71)



PokerStars Hand #204645693604:  Hold'em No Limit ($0.05/$0.10 USD) - 2019/10/17 19:22:42 ET
Table 'Crater' 6-max Seat #4 is the button
Seat 1: EddieMoney9 ($9.71 in chips) 
Seat 3: Ionix1 ($8.32 in chips) 
Seat 4: PlayTheBlues4U ($13.41 in chips) 
Seat 5: The_BT_Show ($9.90 in chips) 
Seat 6: 7noodles ($24.92 in chips) 
The_BT_Show: posts small blind $0.05
7noodles: posts big blind $0.10
*** HOLE CARDS ***
Dealt to PlayTheBlues4U [2h Kd]
EddieMoney9: folds 
Ionix1: folds 
PlayTheBlues4U: folds 
The_BT_Show: raises $0.20 to $0.30
7noodles: calls $0.20
*** FLOP *** [Qh 7d Qd]
The_BT_Show: bets $0.40
7noodles: folds 
Uncalled bet ($0.40) returned to The_BT_Show
The_BT_Show collected $0.57 from pot
The_BT_Show: doesn't show hand 
*** SUMMARY ***
Total pot $0.60 | Rake $0.03 
Board [Qh 7d Qd]
Seat 1: EddieMoney9 folded before Flop (didn't bet)
Seat 3: Ionix1 folded before Flop (didn't bet)
Seat 4: PlayTheBlues4U (button) folded before Flop (didn't bet)
Seat 5: The_BT_Show (small blind) collected ($0.57)
Seat 6: 7noodles (big blind) folded on the Flop



PokerStars Hand #204645693651:  Hold'em No Limit ($0.05/$0.10 USD) - 2019/10/17 19:23:01 ET
Table 'Crater' 6-max Seat #5 is the button
Seat 1: EddieMoney9 ($9.71 in chips) 
Seat 3: Ionix1 ($8.32 in chips) 
Seat 4: PlayTheBlues4U ($13.41 in chips) 
Seat 5: The_BT_Show ($10.17 in chips) 
Seat 6: 7noodles ($24.62 in chips) 
7noodles: posts small blind $0.05
EddieMoney9: posts big blind $0.10
*** HOLE CARDS ***
Dealt to PlayTheBlues4U [Jc 2c]
Ionix1: folds 
PlayTheBlues4U: folds 
The_BT_Show: folds 
7noodles: folds 
Uncalled bet ($0.05) returned to EddieMoney9
EddieMoney9 collected $0.10 from pot
EddieMoney9: doesn't show hand 
*** SUMMARY ***
Total pot $0.10 | Rake $0 
Seat 1: EddieMoney9 (big blind) collected ($0.10)
Seat 3: Ionix1 folded before Flop (didn't bet)
Seat 4: PlayTheBlues4U folded before Flop (didn't bet)
Seat 5: The_BT_Show (button) folded before Flop (didn't bet)
Seat 6: 7noodles (small blind) folded before Flop



PokerStars Hand #204645693688:  Hold'em No Limit ($0.05/$0.10 USD) - 2019/10/17 19:23:14 ET
Table 'Crater' 6-max Seat #6 is the button
Seat 1: EddieMoney9 ($9.76 in chips) 
Seat 3: Ionix1 ($8.32 in chips) 
Seat 4: PlayTheBlues4U ($13.41 in chips) 
Seat 5: The_BT_Show ($10.17 in chips) 
Seat 6: 7noodles ($24.57 in chips) 
EddieMoney9: posts small blind $0.05
Ionix1: posts big blind $0.10
*** HOLE CARDS ***
Dealt to PlayTheBlues4U [Ac Kh]
PlayTheBlues4U: raises $0.20 to $0.30
The_BT_Show: folds 
7noodles: folds 
EddieMoney9: folds 
Ionix1: folds 
Uncalled bet ($0.20) returned to PlayTheBlues4U
PlayTheBlues4U collected $0.25 from pot
PlayTheBlues4U: doesn't show hand 
*** SUMMARY ***
Total pot $0.25 | Rake $0 
Seat 1: EddieMoney9 (small blind) folded before Flop
Seat 3: Ionix1 (big blind) folded before Flop
Seat 4: PlayTheBlues4U collected ($0.25)
Seat 5: The_BT_Show folded before Flop (didn't bet)
Seat 6: 7noodles (button) folded before Flop (didn't bet)



PokerStars Hand #204645693730:  Hold'em No Limit ($0.05/$0.10 USD) - 2019/10/17 19:23:28 ET
Table 'Crater' 6-max Seat #1 is the button
Seat 1: EddieMoney9 ($9.71 in chips) 
Seat 3: Ionix1 ($8.22 in chips) 
Seat 4: PlayTheBlues4U ($13.56 in chips) 
Seat 5: The_BT_Show ($10.17 in chips) 
Seat 6: 7noodles ($24.57 in chips) 
Ionix1: posts small blind $0.05
PlayTheBlues4U: posts big blind $0.10
*** HOLE CARDS ***
Dealt to PlayTheBlues4U [Ts 2h]
The_BT_Show: folds 
7noodles: raises $0.15 to $0.25
EddieMoney9: folds 
Ionix1: folds 
PlayTheBlues4U: folds 
Uncalled bet ($0.15) returned to 7noodles
7noodles collected $0.25 from pot
7noodles: doesn't show hand 
*** SUMMARY ***
Total pot $0.25 | Rake $0 
Seat 1: EddieMoney9 (button) folded before Flop (didn't bet)
Seat 3: Ionix1 (small blind) folded before Flop
Seat 4: PlayTheBlues4U (big blind) folded before Flop
Seat 5: The_BT_Show folded before Flop (didn't bet)
Seat 6: 7noodles collected ($0.25)



PokerStars Hand #204645693859:  Hold'em No Limit ($0.05/$0.10 USD) - 2019/10/17 19:24:10 ET
Table 'Crater' 6-max Seat #3 is the button
Seat 1: EddieMoney9 ($9.71 in chips) 
Seat 3: Ionix1 ($8.17 in chips) 
Seat 4: PlayTheBlues4U ($13.46 in chips) 
Seat 5: The_BT_Show ($10.17 in chips) 
Seat 6: 7noodles ($24.72 in chips) 
PlayTheBlues4U: posts small blind $0.05
The_BT_Show: posts big blind $0.10
*** HOLE CARDS ***
Dealt to PlayTheBlues4U [Jd Kh]
7noodles: folds 
EddieMoney9: folds 
Ionix1: folds 
PlayTheBlues4U: raises $0.20 to $0.30
The_BT_Show: calls $0.20
*** FLOP *** [Kd 2h Ad]
PlayTheBlues4U: bets $0.30
The_BT_Show: calls $0.30
*** TURN *** [Kd 2h Ad] [Qh]
PlayTheBlues4U: checks 
The_BT_Show: checks 
*** RIVER *** [Kd 2h Ad Qh] [3c]
PlayTheBlues4U: checks 
The_BT_Show: bets $0.40
PlayTheBlues4U: calls $0.40
*** SHOW DOWN ***
The_BT_Show: shows [Qd Jc] (a pair of Queens)
PlayTheBlues4U: shows [Jd Kh] (a pair of Kings)
PlayTheBlues4U collected $1.90 from pot
*** SUMMARY ***
Total pot $2 | Rake $0.10 
Board [Kd 2h Ad Qh 3c]
Seat 1: EddieMoney9 folded before Flop (didn't bet)
Seat 3: Ionix1 (button) folded before Flop (didn't bet)
Seat 4: PlayTheBlues4U (small blind) showed [Jd Kh] and won ($1.90) with a pair of Kings
Seat 5: The_BT_Show (big blind) showed [Qd Jc] and lost with a pair of Queens
Seat 6: 7noodles folded before Flop (didn't bet)



PokerStars Hand #204645694025:  Hold'em No Limit ($0.05/$0.10 USD) - 2019/10/17 19:25:07 ET
Table 'Crater' 6-max Seat #4 is the button
Seat 1: EddieMoney9 ($9.71 in chips) 
Seat 3: Ionix1 ($8.17 in chips) 
Seat 4: PlayTheBlues4U ($14.36 in chips) 
Seat 5: The_BT_Show ($9.17 in chips) 
Seat 6: 7noodles ($24.72 in chips) 
The_BT_Show: posts small blind $0.05
7noodles: posts big blind $0.10
*** HOLE CARDS ***
Dealt to PlayTheBlues4U [7h 8h]
EddieMoney9: folds 
Ionix1: folds 
PlayTheBlues4U: raises $0.20 to $0.30
The_BT_Show: folds 
7noodles: calls $0.20
*** FLOP *** [Qd 6s Jh]
7noodles: checks 
PlayTheBlues4U: bets $0.30
7noodles: calls $0.30
*** TURN *** [Qd 6s Jh] [6d]
7noodles: checks 
PlayTheBlues4U: bets $0.70
7noodles: folds 
Uncalled bet ($0.70) returned to PlayTheBlues4U
PlayTheBlues4U collected $1.19 from pot
PlayTheBlues4U: doesn't show hand 
*** SUMMARY ***
Total pot $1.25 | Rake $0.06 
Board [Qd 6s Jh 6d]
Seat 1: EddieMoney9 folded before Flop (didn't bet)
Seat 3: Ionix1 folded before Flop (didn't bet)
Seat 4: PlayTheBlues4U (button) collected ($1.19)
Seat 5: The_BT_Show (small blind) folded before Flop
Seat 6: 7noodles (big blind) folded on the Turn



PokerStars Hand #204645694146:  Hold'em No Limit ($0.05/$0.10 USD) - 2019/10/17 19:25:49 ET
Table 'Crater' 6-max Seat #5 is the button
Seat 1: EddieMoney9 ($9.71 in chips) 
Seat 3: Ionix1 ($8.17 in chips) 
Seat 4: PlayTheBlues4U ($14.95 in chips) 
Seat 5: The_BT_Show ($9.12 in chips) 
Seat 6: 7noodles ($24.12 in chips) 
7noodles: posts small blind $0.05
EddieMoney9: posts big blind $0.10
*** HOLE CARDS ***
Dealt to PlayTheBlues4U [2s Kd]
Ionix1: raises $0.10 to $0.20
PlayTheBlues4U: folds 
The_BT_Show: folds 
7noodles: folds 
EddieMoney9: folds 
Uncalled bet ($0.10) returned to Ionix1
Ionix1 collected $0.25 from pot
Ionix1: doesn't show hand 
*** SUMMARY ***
Total pot $0.25 | Rake $0 
Seat 1: EddieMoney9 (big blind) folded before Flop
Seat 3: Ionix1 collected ($0.25)
Seat 4: PlayTheBlues4U folded before Flop (didn't bet)
Seat 5: The_BT_Show (button) folded before Flop (didn't bet)
Seat 6: 7noodles (small blind) folded before Flop



PokerStars Hand #204645694203:  Hold'em No Limit ($0.05/$0.10 USD) - 2019/10/17 19:26:09 ET
Table 'Crater' 6-max Seat #6 is the button
Seat 1: EddieMoney9 ($9.61 in chips) 
Seat 3: Ionix1 ($8.32 in chips) 
Seat 4: PlayTheBlues4U ($14.95 in chips) 
Seat 5: The_BT_Show ($9.12 in chips) 
Seat 6: 7noodles ($24.07 in chips) 
EddieMoney9: posts small blind $0.05
Ionix1: posts big blind $0.10
*** HOLE CARDS ***
Dealt to PlayTheBlues4U [4h 6s]
PlayTheBlues4U: folds 
The_BT_Show: calls $0.10
7noodles: folds 
EddieMoney9: calls $0.05
Ionix1: checks 
*** FLOP *** [Td Qh 4c]
EddieMoney9: checks 
Ionix1: bets $0.10
The_BT_Show: folds 
EddieMoney9: folds 
Uncalled bet ($0.10) returned to Ionix1
Ionix1 collected $0.28 from pot
Ionix1: doesn't show hand 
*** SUMMARY ***
Total pot $0.30 | Rake $0.02 
Board [Td Qh 4c]
Seat 1: EddieMoney9 (small blind) folded on the Flop
Seat 3: Ionix1 (big blind) collected ($0.28)
Seat 4: PlayTheBlues4U folded before Flop (didn't bet)
Seat 5: The_BT_Show folded on the Flop
Seat 6: 7noodles (button) folded before Flop (didn't bet)



PokerStars Hand #204645694314:  Hold'em No Limit ($0.05/$0.10 USD) - 2019/10/17 19:26:53 ET
Table 'Crater' 6-max Seat #1 is the button
Seat 1: EddieMoney9 ($9.51 in chips) 
Seat 3: Ionix1 ($8.50 in chips) 
Seat 4: PlayTheBlues4U ($14.95 in chips) 
Seat 5: The_BT_Show ($9.02 in chips) 
Seat 6: 7noodles ($24.07 in chips) 
Ionix1: posts small blind $0.05
PlayTheBlues4U: posts big blind $0.10
*** HOLE CARDS ***
Dealt to PlayTheBlues4U [3h Tc]
The_BT_Show: folds 
7noodles: folds 
EddieMoney9: raises $0.20 to $0.30
Ionix1: calls $0.25
PlayTheBlues4U: folds 
*** FLOP *** [6c Qs 6d]
Ionix1: bets $0.20
EddieMoney9: calls $0.20
*** TURN *** [6c Qs 6d] [8s]
Ionix1: bets $0.20
EddieMoney9: calls $0.20
*** RIVER *** [6c Qs 6d 8s] [As]
Ionix1: bets $0.20
EddieMoney9: raises $0.80 to $1
Ionix1: calls $0.80
*** SHOW DOWN ***
EddieMoney9: shows [2c Ac] (two pair, Aces and Sixes)
Ionix1: shows [6s Kh] (three of a kind, Sixes)
Ionix1 collected $3.32 from pot
*** SUMMARY ***
Total pot $3.50 | Rake $0.18 
Board [6c Qs 6d 8s As]
Seat 1: EddieMoney9 (button) showed [2c Ac] and lost with two pair, Aces and Sixes
Seat 3: Ionix1 (small blind) showed [6s Kh] and won ($3.32) with three of a kind, Sixes
Seat 4: PlayTheBlues4U (big blind) folded before Flop
Seat 5: The_BT_Show folded before Flop (didn't bet)
Seat 6: 7noodles folded before Flop (didn't bet)



PokerStars Hand #204645694471:  Hold'em No Limit ($0.05/$0.10 USD) - 2019/10/17 19:27:54 ET
Table 'Crater' 6-max Seat #3 is the button
Seat 1: EddieMoney9 ($7.81 in chips) 
Seat 3: Ionix1 ($10.12 in chips) 
Seat 4: PlayTheBlues4U ($14.85 in chips) 
Seat 5: The_BT_Show ($9.02 in chips) 
Seat 6: 7noodles ($24.07 in chips) 
PlayTheBlues4U: posts small blind $0.05
The_BT_Show: posts big blind $0.10
*** HOLE CARDS ***
Dealt to PlayTheBlues4U [9d 3s]
7noodles: folds 
EddieMoney9: folds 
Ionix1: calls $0.10
PlayTheBlues4U: folds 
The_BT_Show: checks 
*** FLOP *** [Jd Js 8h]
The_BT_Show: checks 
Ionix1: checks 
*** TURN *** [Jd Js 8h] [3d]
The_BT_Show: bets $0.30
Ionix1: folds 
Uncalled bet ($0.30) returned to The_BT_Show
The_BT_Show collected $0.24 from pot
The_BT_Show: doesn't show hand 
*** SUMMARY ***
Total pot $0.25 | Rake $0.01 
Board [Jd Js 8h 3d]
Seat 1: EddieMoney9 folded before Flop (didn't bet)
Seat 3: Ionix1 (button) folded on the Turn
Seat 4: PlayTheBlues4U (small blind) folded before Flop
Seat 5: The_BT_Show (big blind) collected ($0.24)
Seat 6: 7noodles folded before Flop (didn't bet)



PokerStars Hand #204645694515:  Hold'em No Limit ($0.05/$0.10 USD) - 2019/10/17 19:28:13 ET
Table 'Crater' 6-max Seat #4 is the button
Seat 1: EddieMoney9 ($7.81 in chips) 
Seat 3: Ionix1 ($10.02 in chips) 
Seat 4: PlayTheBlues4U ($14.80 in chips) 
Seat 5: The_BT_Show ($9.16 in chips) 
Seat 6: 7noodles ($24.07 in chips) 
The_BT_Show: posts small blind $0.05
7noodles: posts big blind $0.10
*** HOLE CARDS ***
Dealt to PlayTheBlues4U [2d Ks]
EddieMoney9: folds 
Ionix1: folds 
PlayTheBlues4U: folds 
The_BT_Show: folds 
Uncalled bet ($0.05) returned to 7noodles
7noodles collected $0.10 from pot
7noodles: doesn't show hand 
*** SUMMARY ***
Total pot $0.10 | Rake $0 
Seat 1: EddieMoney9 folded before Flop (didn't bet)
Seat 3: Ionix1 folded before Flop (didn't bet)
Seat 4: PlayTheBlues4U (button) folded before Flop (didn't bet)
Seat 5: The_BT_Show (small blind) folded before Flop
Seat 6: 7noodles (big blind) collected ($0.10)



PokerStars Hand #204645694553:  Hold'em No Limit ($0.05/$0.10 USD) - 2019/10/17 19:28:27 ET
Table 'Crater' 6-max Seat #5 is the button
Seat 1: EddieMoney9 ($7.81 in chips) 
Seat 3: Ionix1 ($10.02 in chips) 
Seat 4: PlayTheBlues4U ($14.80 in chips) 
Seat 5: The_BT_Show ($9.11 in chips) 
Seat 6: 7noodles ($24.12 in chips) 
7noodles: posts small blind $0.05
EddieMoney9: posts big blind $0.10
*** HOLE CARDS ***
Dealt to PlayTheBlues4U [6s 7h]
Ionix1: calls $0.10
PlayTheBlues4U: folds 
The_BT_Show: folds 
7noodles: folds 
EddieMoney9: checks 
*** FLOP *** [3h Qc Kd]
EddieMoney9: checks 
Ionix1: checks 
*** TURN *** [3h Qc Kd] [4s]
EddieMoney9: bets $0.17
Ionix1: calls $0.17
*** RIVER *** [3h Qc Kd 4s] [4d]
EddieMoney9: bets $0.39
Ionix1: calls $0.39
*** SHOW DOWN ***
EddieMoney9: shows [5h Qd] (two pair, Queens and Fours)
Ionix1: mucks hand 
EddieMoney9 collected $1.30 from pot
*** SUMMARY ***
Total pot $1.37 | Rake $0.07 
Board [3h Qc Kd 4s 4d]
Seat 1: EddieMoney9 (big blind) showed [5h Qd] and won ($1.30) with two pair, Queens and Fours
Seat 3: Ionix1 mucked [2s 2h]
Seat 4: PlayTheBlues4U folded before Flop (didn't bet)
Seat 5: The_BT_Show (button) folded before Flop (didn't bet)
Seat 6: 7noodles (small blind) folded before Flop



PokerStars Hand #204645694690:  Hold'em No Limit ($0.05/$0.10 USD) - 2019/10/17 19:29:20 ET
Table 'Crater' 6-max Seat #6 is the button
Seat 1: EddieMoney9 ($8.45 in chips) 
Seat 3: Ionix1 ($9.36 in chips) 
Seat 4: PlayTheBlues4U ($14.80 in chips) 
Seat 5: The_BT_Show ($9.11 in chips) 
Seat 6: 7noodles ($24.07 in chips) 
EddieMoney9: posts small blind $0.05
Ionix1: posts big blind $0.10
*** HOLE CARDS ***
Dealt to PlayTheBlues4U [8c 7d]
PlayTheBlues4U: folds 
The_BT_Show: raises $0.20 to $0.30
7noodles: folds 
EddieMoney9: folds 
Ionix1: calls $0.20
*** FLOP *** [5d 7h 2d]
Ionix1: checks 
The_BT_Show: bets $0.30
Ionix1: calls $0.30
*** TURN *** [5d 7h 2d] [6c]
Ionix1: checks 
The_BT_Show: bets $0.50
Ionix1: calls $0.50
*** RIVER *** [5d 7h 2d 6c] [Th]
Ionix1: checks 
The_BT_Show: checks 
*** SHOW DOWN ***
Ionix1: shows [9c 9d] (a pair of Nines)
The_BT_Show: shows [Td Jc] (a pair of Tens)
The_BT_Show collected $2.14 from pot
*** SUMMARY ***
Total pot $2.25 | Rake $0.11 
Board [5d 7h 2d 6c Th]
Seat 1: EddieMoney9 (small blind) folded before Flop
Seat 3: Ionix1 (big blind) showed [9c 9d] and lost with a pair of Nines
Seat 4: PlayTheBlues4U folded before Flop (didn't bet)
Seat 5: The_BT_Show showed [Td Jc] and won ($2.14) with a pair of Tens
Seat 6: 7noodles (button) folded before Flop (didn't bet)



PokerStars Hand #204645694804:  Hold'em No Limit ($0.05/$0.10 USD) - 2019/10/17 19:30:02 ET
Table 'Crater' 6-max Seat #1 is the button
Seat 1: EddieMoney9 ($8.40 in chips) 
Seat 3: Ionix1 ($8.26 in chips) 
Seat 4: PlayTheBlues4U ($14.80 in chips) 
Seat 5: The_BT_Show ($10.15 in chips) 
Seat 6: 7noodles ($24.07 in chips) 
Ionix1: posts small blind $0.05
PlayTheBlues4U: posts big blind $0.10
*** HOLE CARDS ***
Dealt to PlayTheBlues4U [9s Qc]
The_BT_Show: folds 
7noodles: folds 
EddieMoney9: raises $0.20 to $0.30
Ionix1: folds 
PlayTheBlues4U: calls $0.20
*** FLOP *** [8h Qh 3d]
Ionix1 leaves the table
PlayTheBlues4U: checks 
EddieMoney9: checks 
*** TURN *** [8h Qh 3d] [7c]
Duke323 joins the table at seat #3 
PlayTheBlues4U: bets $0.40
EddieMoney9: calls $0.40
*** RIVER *** [8h Qh 3d 7c] [Ac]
okletsflip was removed from the table for failing to post
okletsflip leaves the table
PlayTheBlues4U: checks 
EddieMoney9: bets $1
DeccaDan joins the table at seat #2 
PlayTheBlues4U: calls $1
*** SHOW DOWN ***
EddieMoney9: shows [8s As] (two pair, Aces and Eights)
PlayTheBlues4U: mucks hand 
EddieMoney9 collected $3.28 from pot
*** SUMMARY ***
Total pot $3.45 | Rake $0.17 
Board [8h Qh 3d 7c Ac]
Seat 1: EddieMoney9 (button) showed [8s As] and won ($3.28) with two pair, Aces and Eights
Seat 3: Ionix1 (small blind) folded before Flop
Seat 4: PlayTheBlues4U (big blind) mucked [9s Qc]
Seat 5: The_BT_Show folded before Flop (didn't bet)
Seat 6: 7noodles folded before Flop (didn't bet)



PokerStars Hand #204645694983:  Hold'em No Limit ($0.05/$0.10 USD) - 2019/10/17 19:31:15 ET
Table 'Crater' 6-max Seat #4 is the button
Seat 1: EddieMoney9 ($9.98 in chips) 
Seat 2: DeccaDan ($10 in chips) 
Seat 4: PlayTheBlues4U ($13.10 in chips) 
Seat 5: The_BT_Show ($10.15 in chips) 
The_BT_Show: posts small blind $0.05
7noodles: is sitting out 
7noodles leaves the table
EddieMoney9: posts big blind $0.10
DeccaDan: posts big blind $0.10
Duke323: sits out 
*** HOLE CARDS ***
Dealt to PlayTheBlues4U [Jh 5c]
DeccaDan: checks 
PlayTheBlues4U: folds 
The_BT_Show: folds 
EddieMoney9: checks 
*** FLOP *** [Ac 3c Qh]
EddieMoney9: checks 
DeccaDan: checks 
*** TURN *** [Ac 3c Qh] [5s]
MGermanio joins the table at seat #6 
EddieMoney9: checks 
DeccaDan: bets $0.15
EddieMoney9: folds 
Uncalled bet ($0.15) returned to DeccaDan
DeccaDan collected $0.24 from pot
DeccaDan: doesn't show hand 
*** SUMMARY ***
Total pot $0.25 | Rake $0.01 
Board [Ac 3c Qh 5s]
Seat 1: EddieMoney9 (big blind) folded on the Turn
Seat 2: DeccaDan collected ($0.24)
Seat 4: PlayTheBlues4U (button) folded before Flop (didn't bet)
Seat 5: The_BT_Show (small blind) folded before Flop



PokerStars Hand #204645695110:  Hold'em No Limit ($0.05/$0.10 USD) - 2019/10/17 19:32:01 ET
Table 'Crater' 6-max Seat #5 is the button
Seat 1: EddieMoney9 ($9.88 in chips) 
Seat 2: DeccaDan ($10.14 in chips) 
Seat 3: Duke323 ($8 in chips) 
Seat 4: PlayTheBlues4U ($13.10 in chips) 
Seat 5: The_BT_Show ($10.10 in chips) 
EddieMoney9: posts small blind $0.05
DeccaDan: posts big blind $0.10
Duke323: posts big blind $0.10
*** HOLE CARDS ***
Dealt to PlayTheBlues4U [3s 8d]
Duke323: checks 
PlayTheBlues4U: folds 
The_BT_Show: folds 
EddieMoney9: folds 
DeccaDan: checks 
*** FLOP *** [5c 4s Ts]
DeccaDan: checks 
Duke323: checks 
*** TURN *** [5c 4s Ts] [3d]
DeccaDan: checks 
Duke323: checks 
*** RIVER *** [5c 4s Ts 3d] [Th]
DeccaDan: bets $0.10
Duke323: folds 
Uncalled bet ($0.10) returned to DeccaDan
DeccaDan collected $0.24 from pot
DeccaDan: doesn't show hand 
*** SUMMARY ***
Total pot $0.25 | Rake $0.01 
Board [5c 4s Ts 3d Th]
Seat 1: EddieMoney9 (small blind) folded before Flop
Seat 2: DeccaDan (big blind) collected ($0.24)
Seat 3: Duke323 folded on the River (didn't bet)
Seat 4: PlayTheBlues4U folded before Flop (didn't bet)
Seat 5: The_BT_Show (button) folded before Flop (didn't bet)



PokerStars Hand #204645695179:  Hold'em No Limit ($0.05/$0.10 USD) - 2019/10/17 19:32:30 ET
Table 'Crater' 6-max Seat #1 is the button
Seat 1: EddieMoney9 ($9.83 in chips) 
Seat 2: DeccaDan ($10.28 in chips) 
Seat 3: Duke323 ($7.90 in chips) 
Seat 4: PlayTheBlues4U ($13.10 in chips) 
Seat 5: The_BT_Show ($10.10 in chips) 
Seat 6: MGermanio ($10 in chips) 
DeccaDan: posts small blind $0.05
Duke323: posts big blind $0.10
MGermanio: posts big blind $0.10
*** HOLE CARDS ***
Dealt to PlayTheBlues4U [Jd 5d]
PlayTheBlues4U: folds 
The_BT_Show: raises $0.20 to $0.30
MGermanio: folds 
EddieMoney9: raises $0.85 to $1.15
DeccaDan: folds 
Duke323: folds 
The_BT_Show: raises $1.95 to $3.10
EddieMoney9: calls $1.95
*** FLOP *** [3c 5s Kc]
The_BT_Show: bets $6.80
EddieMoney9: folds 
Uncalled bet ($6.80) returned to The_BT_Show
The_BT_Show collected $6.13 from pot
The_BT_Show: doesn't show hand 
*** SUMMARY ***
Total pot $6.45 | Rake $0.32 
Board [3c 5s Kc]
Seat 1: EddieMoney9 (button) folded on the Flop
Seat 2: DeccaDan (small blind) folded before Flop
Seat 3: Duke323 (big blind) folded before Flop
Seat 4: PlayTheBlues4U folded before Flop (didn't bet)
Seat 5: The_BT_Show collected ($6.13)
Seat 6: MGermanio folded before Flop (didn't bet)



PokerStars Hand #204645695368:  Hold'em No Limit ($0.05/$0.10 USD) - 2019/10/17 19:33:45 ET
Table 'Crater' 6-max Seat #2 is the button
Seat 1: EddieMoney9 ($6.73 in chips) 
Seat 2: DeccaDan ($10.23 in chips) 
Seat 3: Duke323 ($7.80 in chips) 
Seat 4: PlayTheBlues4U ($13.10 in chips) 
Seat 5: The_BT_Show ($13.13 in chips) 
Seat 6: MGermanio ($9.90 in chips) 
Duke323: posts small blind $0.05
PlayTheBlues4U: posts big blind $0.10
*** HOLE CARDS ***
Dealt to PlayTheBlues4U [6s 4h]
The_BT_Show: folds 
MGermanio: folds 
EddieMoney9: folds 
DeccaDan: calls $0.10
Duke323: raises $0.30 to $0.40
PlayTheBlues4U: folds 
DeccaDan: folds 
Uncalled bet ($0.30) returned to Duke323
Duke323 collected $0.30 from pot
Duke323: doesn't show hand 
*** SUMMARY ***
Total pot $0.30 | Rake $0 
Seat 1: EddieMoney9 folded before Flop (didn't bet)
Seat 2: DeccaDan (button) folded before Flop
Seat 3: Duke323 (small blind) collected ($0.30)
Seat 4: PlayTheBlues4U (big blind) folded before Flop
Seat 5: The_BT_Show folded before Flop (didn't bet)
Seat 6: MGermanio folded before Flop (didn't bet)



PokerStars Hand #204645695421:  Hold'em No Limit ($0.05/$0.10 USD) - 2019/10/17 19:34:05 ET
Table 'Crater' 6-max Seat #3 is the button
Seat 1: EddieMoney9 ($10 in chips) 
Seat 2: DeccaDan ($10.13 in chips) 
Seat 3: Duke323 ($8 in chips) 
Seat 4: PlayTheBlues4U ($13 in chips) 
Seat 5: The_BT_Show ($13.13 in chips) 
Seat 6: MGermanio ($9.90 in chips) 
PlayTheBlues4U: posts small blind $0.05
The_BT_Show: posts big blind $0.10
*** HOLE CARDS ***
Dealt to PlayTheBlues4U [5s 9h]
MGermanio: folds 
EddieMoney9: folds 
DeccaDan: calls $0.10
Duke323: calls $0.10
PlayTheBlues4U: folds 
The_BT_Show: checks 
*** FLOP *** [7s Qc 9d]
The_BT_Show: checks 
DeccaDan: checks 
Duke323: bets $0.30
The_BT_Show: folds 
DeccaDan: folds 
Uncalled bet ($0.30) returned to Duke323
Duke323 collected $0.33 from pot
Duke323: doesn't show hand 
*** SUMMARY ***
Total pot $0.35 | Rake $0.02 
Board [7s Qc 9d]
Seat 1: EddieMoney9 folded before Flop (didn't bet)
Seat 2: DeccaDan folded on the Flop
Seat 3: Duke323 (button) collected ($0.33)
Seat 4: PlayTheBlues4U (small blind) folded before Flop
Seat 5: The_BT_Show (big blind) folded on the Flop
Seat 6: MGermanio folded before Flop (didn't bet)



PokerStars Hand #204645695499:  Hold'em No Limit ($0.05/$0.10 USD) - 2019/10/17 19:34:37 ET
Table 'Crater' 6-max Seat #4 is the button
Seat 1: EddieMoney9 ($10 in chips) 
Seat 2: DeccaDan ($10.03 in chips) 
Seat 3: Duke323 ($8.23 in chips) 
Seat 4: PlayTheBlues4U ($12.95 in chips) 
Seat 5: The_BT_Show ($13.03 in chips) 
Seat 6: MGermanio ($9.90 in chips) 
The_BT_Show: posts small blind $0.05
MGermanio: posts big blind $0.10
*** HOLE CARDS ***
Dealt to PlayTheBlues4U [4h Tc]
EddieMoney9: folds 
DeccaDan: calls $0.10
Duke323: folds 
PlayTheBlues4U: folds 
The_BT_Show: folds 
MGermanio: checks 
*** FLOP *** [6c As Ad]
MGermanio: checks 
DeccaDan: checks 
*** TURN *** [6c As Ad] [Js]
MGermanio: checks 
DeccaDan: checks 
*** RIVER *** [6c As Ad Js] [3d]
MGermanio: checks 
DeccaDan: bets $0.60
MGermanio: folds 
Uncalled bet ($0.60) returned to DeccaDan
DeccaDan collected $0.24 from pot
DeccaDan: doesn't show hand 
*** SUMMARY ***
Total pot $0.25 | Rake $0.01 
Board [6c As Ad Js 3d]
Seat 1: EddieMoney9 folded before Flop (didn't bet)
Seat 2: DeccaDan collected ($0.24)
Seat 3: Duke323 folded before Flop (didn't bet)
Seat 4: PlayTheBlues4U (button) folded before Flop (didn't bet)
Seat 5: The_BT_Show (small blind) folded before Flop
Seat 6: MGermanio (big blind) folded on the River



PokerStars Hand #204645695642:  Hold'em No Limit ($0.05/$0.10 USD) - 2019/10/17 19:35:32 ET
Table 'Crater' 6-max Seat #5 is the button
Seat 1: EddieMoney9 ($10 in chips) 
Seat 2: DeccaDan ($10.17 in chips) 
Seat 3: Duke323 ($8.23 in chips) 
Seat 4: PlayTheBlues4U ($12.95 in chips) 
Seat 5: The_BT_Show ($12.98 in chips) 
Seat 6: MGermanio ($9.80 in chips) 
MGermanio: posts small blind $0.05
EddieMoney9: posts big blind $0.10
*** HOLE CARDS ***
Dealt to PlayTheBlues4U [Ts 2d]
DeccaDan: folds 
Duke323: folds 
PlayTheBlues4U: folds 
The_BT_Show: folds 
MGermanio: calls $0.05
EddieMoney9: checks 
*** FLOP *** [Qh Ac 2s]
MGermanio: checks 
EddieMoney9: checks 
*** TURN *** [Qh Ac 2s] [Kd]
MGermanio: checks 
EddieMoney9: checks 
*** RIVER *** [Qh Ac 2s Kd] [6h]
MGermanio: checks 
EddieMoney9: checks 
*** SHOW DOWN ***
MGermanio: shows [9h 3s] (high card Ace)
EddieMoney9: shows [6c Th] (a pair of Sixes)
EddieMoney9 collected $0.19 from pot
*** SUMMARY ***
Total pot $0.20 | Rake $0.01 
Board [Qh Ac 2s Kd 6h]
Seat 1: EddieMoney9 (big blind) showed [6c Th] and won ($0.19) with a pair of Sixes
Seat 2: DeccaDan folded before Flop (didn't bet)
Seat 3: Duke323 folded before Flop (didn't bet)
Seat 4: PlayTheBlues4U folded before Flop (didn't bet)
Seat 5: The_BT_Show (button) folded before Flop (didn't bet)
Seat 6: MGermanio (small blind) showed [9h 3s] and lost with high card Ace



PokerStars Hand #204645695781:  Hold'em No Limit ($0.05/$0.10 USD) - 2019/10/17 19:36:26 ET
Table 'Crater' 6-max Seat #6 is the button
Seat 1: EddieMoney9 ($10.09 in chips) 
Seat 2: DeccaDan ($10.17 in chips) 
Seat 3: Duke323 ($8.23 in chips) 
Seat 4: PlayTheBlues4U ($12.95 in chips) 
Seat 5: The_BT_Show ($12.98 in chips) 
Seat 6: MGermanio ($9.70 in chips) 
EddieMoney9: posts small blind $0.05
DeccaDan: posts big blind $0.10
*** HOLE CARDS ***
Dealt to PlayTheBlues4U [Qd Jh]
Duke323: folds 
PlayTheBlues4U: raises $0.20 to $0.30
The_BT_Show: folds 
MGermanio: folds 
Duke323 leaves the table
EddieMoney9: folds 
DeccaDan: calls $0.20
*** FLOP *** [2h Qc 9s]
DeccaDan: checks 
havea69vette joins the table at seat #3 
PlayTheBlues4U: bets $0.40
DeccaDan: folds 
Uncalled bet ($0.40) returned to PlayTheBlues4U
PlayTheBlues4U collected $0.62 from pot
PlayTheBlues4U: doesn't show hand 
*** SUMMARY ***
Total pot $0.65 | Rake $0.03 
Board [2h Qc 9s]
Seat 1: EddieMoney9 (small blind) folded before Flop
Seat 2: DeccaDan (big blind) folded on the Flop
Seat 3: Duke323 folded before Flop (didn't bet)
Seat 4: PlayTheBlues4U collected ($0.62)
Seat 5: The_BT_Show folded before Flop (didn't bet)
Seat 6: MGermanio (button) folded before Flop (didn't bet)



PokerStars Hand #204645695876:  Hold'em No Limit ($0.05/$0.10 USD) - 2019/10/17 19:37:02 ET
Table 'Crater' 6-max Seat #1 is the button
Seat 1: EddieMoney9 ($10.04 in chips) 
Seat 2: DeccaDan ($9.87 in chips) 
Seat 3: havea69vette ($11.42 in chips) 
Seat 4: PlayTheBlues4U ($13.27 in chips) 
Seat 5: The_BT_Show ($12.98 in chips) 
Seat 6: MGermanio ($9.70 in chips) 
DeccaDan: posts small blind $0.05
havea69vette: posts big blind $0.10
*** HOLE CARDS ***
Dealt to PlayTheBlues4U [5d 4s]
PlayTheBlues4U: folds 
The_BT_Show: raises $0.20 to $0.30
MGermanio: folds 
EddieMoney9: folds 
DeccaDan: folds 
havea69vette: folds 
Uncalled bet ($0.20) returned to The_BT_Show
The_BT_Show collected $0.25 from pot
The_BT_Show: doesn't show hand 
*** SUMMARY ***
Total pot $0.25 | Rake $0 
Seat 1: EddieMoney9 (button) folded before Flop (didn't bet)
Seat 2: DeccaDan (small blind) folded before Flop
Seat 3: havea69vette (big blind) folded before Flop
Seat 4: PlayTheBlues4U folded before Flop (didn't bet)
Seat 5: The_BT_Show collected ($0.25)
Seat 6: MGermanio folded before Flop (didn't bet)



PokerStars Hand #204645695920:  Hold'em No Limit ($0.05/$0.10 USD) - 2019/10/17 19:37:16 ET
Table 'Crater' 6-max Seat #2 is the button
Seat 1: EddieMoney9 ($10.04 in chips) 
Seat 2: DeccaDan ($9.82 in chips) 
Seat 3: havea69vette ($11.32 in chips) 
Seat 4: PlayTheBlues4U ($13.27 in chips) 
Seat 5: The_BT_Show ($13.13 in chips) 
Seat 6: MGermanio ($9.70 in chips) 
havea69vette: posts small blind $0.05
PlayTheBlues4U: posts big blind $0.10
*** HOLE CARDS ***
Dealt to PlayTheBlues4U [As Jc]
The_BT_Show: folds 
MGermanio: folds 
EddieMoney9: folds 
DeccaDan: raises $0.10 to $0.20
havea69vette: calls $0.15
PlayTheBlues4U: raises $0.30 to $0.50
DeccaDan: calls $0.30
havea69vette: raises $10.82 to $11.32 and is all-in
PlayTheBlues4U: folds 
DeccaDan: folds 
Uncalled bet ($10.82) returned to havea69vette
havea69vette collected $1.50 from pot
havea69vette: doesn't show hand 
*** SUMMARY ***
Total pot $1.50 | Rake $0 
Seat 1: EddieMoney9 folded before Flop (didn't bet)
Seat 2: DeccaDan (button) folded before Flop
Seat 3: havea69vette (small blind) collected ($1.50)
Seat 4: PlayTheBlues4U (big blind) folded before Flop
Seat 5: The_BT_Show folded before Flop (didn't bet)
Seat 6: MGermanio folded before Flop (didn't bet)



PokerStars Hand #204645696103:  Hold'em No Limit ($0.05/$0.10 USD) - 2019/10/17 19:38:28 ET
Table 'Crater' 6-max Seat #3 is the button
Seat 1: EddieMoney9 ($10.04 in chips) 
Seat 2: DeccaDan ($9.32 in chips) 
Seat 3: havea69vette ($12.32 in chips) 
Seat 4: PlayTheBlues4U ($12.77 in chips) 
Seat 5: The_BT_Show ($13.13 in chips) 
Seat 6: MGermanio ($9.70 in chips) 
PlayTheBlues4U: posts small blind $0.05
The_BT_Show: posts big blind $0.10
*** HOLE CARDS ***
Dealt to PlayTheBlues4U [4h 7d]
MGermanio: folds 
EddieMoney9: folds 
DeccaDan: calls $0.10
havea69vette: folds 
PlayTheBlues4U: folds 
The_BT_Show: checks 
*** FLOP *** [Kh Qd 3s]
The_BT_Show: checks 
DeccaDan: bets $0.10
The_BT_Show: raises $0.20 to $0.30
DeccaDan: calls $0.20
*** TURN *** [Kh Qd 3s] [Ad]
The_BT_Show: bets $0.40
DeccaDan: calls $0.40
*** RIVER *** [Kh Qd 3s Ad] [2s]
The_BT_Show: checks 
DeccaDan: bets $0.75
The_BT_Show: calls $0.75
*** SHOW DOWN ***
DeccaDan: shows [Tc Th] (a pair of Tens)
The_BT_Show: shows [Jc Ks] (a pair of Kings)
The_BT_Show collected $2.99 from pot
*** SUMMARY ***
Total pot $3.15 | Rake $0.16 
Board [Kh Qd 3s Ad 2s]
Seat 1: EddieMoney9 folded before Flop (didn't bet)
Seat 2: DeccaDan showed [Tc Th] and lost with a pair of Tens
Seat 3: havea69vette (button) folded before Flop (didn't bet)
Seat 4: PlayTheBlues4U (small blind) folded before Flop
Seat 5: The_BT_Show (big blind) showed [Jc Ks] and won ($2.99) with a pair of Kings
Seat 6: MGermanio folded before Flop (didn't bet)



PokerStars Hand #204645696247:  Hold'em No Limit ($0.05/$0.10 USD) - 2019/10/17 19:39:20 ET
Table 'Crater' 6-max Seat #4 is the button
Seat 1: EddieMoney9 ($10.04 in chips) 
Seat 2: DeccaDan ($7.77 in chips) 
Seat 3: havea69vette ($12.32 in chips) 
Seat 4: PlayTheBlues4U ($12.72 in chips) 
Seat 5: The_BT_Show ($14.57 in chips) 
Seat 6: MGermanio ($9.70 in chips) 
The_BT_Show: posts small blind $0.05
MGermanio: posts big blind $0.10
*** HOLE CARDS ***
Dealt to PlayTheBlues4U [Ks Qs]
EddieMoney9: folds 
DeccaDan: folds 
havea69vette: folds 
PlayTheBlues4U: raises $0.20 to $0.30
The_BT_Show: folds 
MGermanio: calls $0.20
*** FLOP *** [3s 3c Ah]
MGermanio: checks 
PlayTheBlues4U: bets $0.40
MGermanio: folds 
Uncalled bet ($0.40) returned to PlayTheBlues4U
PlayTheBlues4U collected $0.62 from pot
PlayTheBlues4U: doesn't show hand 
*** SUMMARY ***
Total pot $0.65 | Rake $0.03 
Board [3s 3c Ah]
Seat 1: EddieMoney9 folded before Flop (didn't bet)
Seat 2: DeccaDan folded before Flop (didn't bet)
Seat 3: havea69vette folded before Flop (didn't bet)
Seat 4: PlayTheBlues4U (button) collected ($0.62)
Seat 5: The_BT_Show (small blind) folded before Flop
Seat 6: MGermanio (big blind) folded on the Flop



PokerStars Hand #204645696356:  Hold'em No Limit ($0.05/$0.10 USD) - 2019/10/17 19:40:01 ET
Table 'Crater' 6-max Seat #5 is the button
Seat 1: EddieMoney9 ($10.04 in chips) 
Seat 2: DeccaDan ($7.77 in chips) 
Seat 3: havea69vette ($12.32 in chips) 
Seat 4: PlayTheBlues4U ($13.04 in chips) 
Seat 5: The_BT_Show ($14.52 in chips) 
Seat 6: MGermanio ($9.40 in chips) 
MGermanio: posts small blind $0.05
EddieMoney9: posts big blind $0.10
*** HOLE CARDS ***
Dealt to PlayTheBlues4U [9c Ad]
DeccaDan: calls $0.10
havea69vette: folds 
PlayTheBlues4U: folds 
The_BT_Show: folds 
MGermanio: calls $0.05
EddieMoney9: checks 
*** FLOP *** [3d Ks 3s]
MGermanio: checks 
EddieMoney9: checks 
DeccaDan: checks 
*** TURN *** [3d Ks 3s] [3h]
MGermanio: checks 
EddieMoney9: checks 
DeccaDan: bets $0.15
MGermanio: folds 
EddieMoney9: folds 
Uncalled bet ($0.15) returned to DeccaDan
DeccaDan collected $0.28 from pot
DeccaDan: doesn't show hand 
*** SUMMARY ***
Total pot $0.30 | Rake $0.02 
Board [3d Ks 3s 3h]
Seat 1: EddieMoney9 (big blind) folded on the Turn
Seat 2: DeccaDan collected ($0.28)
Seat 3: havea69vette folded before Flop (didn't bet)
Seat 4: PlayTheBlues4U folded before Flop (didn't bet)
Seat 5: The_BT_Show (button) folded before Flop (didn't bet)
Seat 6: MGermanio (small blind) folded on the Turn



PokerStars Hand #204645696479:  Hold'em No Limit ($0.05/$0.10 USD) - 2019/10/17 19:40:48 ET
Table 'Crater' 6-max Seat #6 is the button
Seat 1: EddieMoney9 ($9.94 in chips) 
Seat 2: DeccaDan ($7.95 in chips) 
Seat 3: havea69vette ($12.32 in chips) 
Seat 4: PlayTheBlues4U ($13.04 in chips) 
Seat 5: The_BT_Show ($14.52 in chips) 
Seat 6: MGermanio ($9.30 in chips) 
EddieMoney9: posts small blind $0.05
DeccaDan: posts big blind $0.10
*** HOLE CARDS ***
Dealt to PlayTheBlues4U [Jc 9h]
havea69vette: folds 
PlayTheBlues4U: folds 
The_BT_Show: raises $0.20 to $0.30
MGermanio: folds 
EddieMoney9: folds 
DeccaDan: calls $0.20
*** FLOP *** [Ac Jd 7d]
DeccaDan: checks 
The_BT_Show: bets $0.40
DeccaDan: folds 
Uncalled bet ($0.40) returned to The_BT_Show
The_BT_Show collected $0.62 from pot
The_BT_Show: doesn't show hand 
*** SUMMARY ***
Total pot $0.65 | Rake $0.03 
Board [Ac Jd 7d]
Seat 1: EddieMoney9 (small blind) folded before Flop
Seat 2: DeccaDan (big blind) folded on the Flop
Seat 3: havea69vette folded before Flop (didn't bet)
Seat 4: PlayTheBlues4U folded before Flop (didn't bet)
Seat 5: The_BT_Show collected ($0.62)
Seat 6: MGermanio (button) folded before Flop (didn't bet)



PokerStars Hand #204644608810:  Hold'em No Limit ($0.05/$0.10 USD) - 2019/10/17 18:21:18 ET
Table 'Sappho' 6-max Seat #4 is the button
Seat 1: xxzuluzuluxx ($10.42 in chips) 
Seat 2: Potzilla ($8 in chips) 
Seat 4: jdempjr ($9.48 in chips) 
Seat 5: daughterstuitio ($3.91 in chips) 
Seat 6: PlayTheBlues4U ($9.90 in chips) 
daughterstuitio: posts small blind $0.05
PlayTheBlues4U: posts big blind $0.10
Potzilla: posts big blind $0.10
*** HOLE CARDS ***
Dealt to PlayTheBlues4U [Jc Th]
xxzuluzuluxx: folds 
Potzilla: checks 
jdempjr: raises $0.10 to $0.20
daughterstuitio: folds 
PlayTheBlues4U: calls $0.10
Potzilla: raises $0.10 to $0.30
jdempjr: calls $0.10
PlayTheBlues4U: calls $0.10
*** FLOP *** [9c 7c 6d]
PlayTheBlues4U: checks 
Potzilla: checks 
jdempjr: checks 
*** TURN *** [9c 7c 6d] [2c]
PlayTheBlues4U: bets $0.50
Potzilla: folds 
jdempjr: folds 
Uncalled bet ($0.50) returned to PlayTheBlues4U
PlayTheBlues4U collected $0.90 from pot
PlayTheBlues4U: doesn't show hand 
*** SUMMARY ***
Total pot $0.95 | Rake $0.05 
Board [9c 7c 6d 2c]
Seat 1: xxzuluzuluxx folded before Flop (didn't bet)
Seat 2: Potzilla folded on the Turn
Seat 4: jdempjr (button) folded on the Turn
Seat 5: daughterstuitio (small blind) folded before Flop
Seat 6: PlayTheBlues4U (big blind) collected ($0.90)



PokerStars Hand #204644608937:  Hold'em No Limit ($0.05/$0.10 USD) - 2019/10/17 18:22:12 ET
Table 'Sappho' 6-max Seat #5 is the button
Seat 1: xxzuluzuluxx ($10.42 in chips) 
Seat 2: Potzilla ($7.70 in chips) 
Seat 5: daughterstuitio ($3.86 in chips) 
Seat 6: PlayTheBlues4U ($10.50 in chips) 
PlayTheBlues4U: posts small blind $0.05
xxzuluzuluxx: posts big blind $0.10
*** HOLE CARDS ***
Dealt to PlayTheBlues4U [6h Qs]
jdempjr leaves the table
Potzilla: calls $0.10
daughterstuitio: raises $0.40 to $0.50
PlayTheBlues4U: folds 
xxzuluzuluxx: folds 
Ryaniam1981 joins the table at seat #3 
Potzilla: calls $0.40
*** FLOP *** [2h Th 2d]
Potzilla: bets $0.55
daughterstuitio: calls $0.55
*** TURN *** [2h Th 2d] [4d]
Duke323 joins the table at seat #4 
Potzilla: checks 
daughterstuitio: bets $2.81 and is all-in
Potzilla: calls $2.81
*** RIVER *** [2h Th 2d 4d] [Jd]
*** SHOW DOWN ***
Potzilla: shows [9s 9c] (two pair, Nines and Deuces)
daughterstuitio: shows [As Tc] (two pair, Tens and Deuces)
daughterstuitio collected $7.48 from pot
*** SUMMARY ***
Total pot $7.87 | Rake $0.39 
Board [2h Th 2d 4d Jd]
Seat 1: xxzuluzuluxx (big blind) folded before Flop
Seat 2: Potzilla showed [9s 9c] and lost with two pair, Nines and Deuces
Seat 5: daughterstuitio (button) showed [As Tc] and won ($7.48) with two pair, Tens and Deuces
Seat 6: PlayTheBlues4U (small blind) folded before Flop



PokerStars Hand #204644609093:  Hold'em No Limit ($0.05/$0.10 USD) - 2019/10/17 18:23:14 ET
Table 'Sappho' 6-max Seat #6 is the button
Seat 1: xxzuluzuluxx ($10.32 in chips) 
Seat 2: Potzilla ($3.84 in chips) 
Seat 3: Ryaniam1981 ($10 in chips) 
Seat 5: daughterstuitio ($7.48 in chips) 
Seat 6: PlayTheBlues4U ($10.45 in chips) 
xxzuluzuluxx: posts small blind $0.05
Potzilla: posts big blind $0.10
Ryaniam1981: posts big blind $0.10
Duke323: sits out 
*** HOLE CARDS ***
Dealt to PlayTheBlues4U [6h As]
Ryaniam1981: checks 
daughterstuitio: folds 
PlayTheBlues4U: raises $0.20 to $0.30
xxzuluzuluxx: folds 
Potzilla: calls $0.20
Ryaniam1981: folds 
*** FLOP *** [Jd 6s 2d]
Potzilla: checks 
PlayTheBlues4U: bets $0.40
Potzilla: folds 
Uncalled bet ($0.40) returned to PlayTheBlues4U
PlayTheBlues4U collected $0.71 from pot
PlayTheBlues4U: doesn't show hand 
*** SUMMARY ***
Total pot $0.75 | Rake $0.04 
Board [Jd 6s 2d]
Seat 1: xxzuluzuluxx (small blind) folded before Flop
Seat 2: Potzilla (big blind) folded on the Flop
Seat 3: Ryaniam1981 folded before Flop (didn't bet)
Seat 5: daughterstuitio folded before Flop (didn't bet)
Seat 6: PlayTheBlues4U (button) collected ($0.71)



PokerStars Hand #204644609174:  Hold'em No Limit ($0.05/$0.10 USD) - 2019/10/17 18:23:48 ET
Table 'Sappho' 6-max Seat #1 is the button
Seat 1: xxzuluzuluxx ($10.27 in chips) 
Seat 2: Potzilla ($3.54 in chips) 
Seat 3: Ryaniam1981 ($9.90 in chips) 
Seat 5: daughterstuitio ($7.48 in chips) 
Seat 6: PlayTheBlues4U ($10.86 in chips) 
Potzilla: posts small blind $0.05
Ryaniam1981: posts big blind $0.10
Duke323: sits out 
*** HOLE CARDS ***
Dealt to PlayTheBlues4U [2d 5d]
daughterstuitio: folds 
PlayTheBlues4U: folds 
xxzuluzuluxx: folds 
Potzilla: calls $0.05
Ryaniam1981: checks 
*** FLOP *** [Ac Th 2h]
Potzilla: bets $0.10
Ryaniam1981: calls $0.10
*** TURN *** [Ac Th 2h] [3c]
Potzilla: bets $0.10
Ryaniam1981: calls $0.10
*** RIVER *** [Ac Th 2h 3c] [7h]
Potzilla: bets $0.10
Ryaniam1981: calls $0.10
*** SHOW DOWN ***
Potzilla: shows [Ks Td] (a pair of Tens)
Ryaniam1981: mucks hand 
Potzilla collected $0.76 from pot
*** SUMMARY ***
Total pot $0.80 | Rake $0.04 
Board [Ac Th 2h 3c 7h]
Seat 1: xxzuluzuluxx (button) folded before Flop (didn't bet)
Seat 2: Potzilla (small blind) showed [Ks Td] and won ($0.76) with a pair of Tens
Seat 3: Ryaniam1981 (big blind) mucked [4c 7c]
Seat 5: daughterstuitio folded before Flop (didn't bet)
Seat 6: PlayTheBlues4U folded before Flop (didn't bet)



PokerStars Hand #204644609281:  Hold'em No Limit ($0.05/$0.10 USD) - 2019/10/17 18:24:32 ET
Table 'Sappho' 6-max Seat #2 is the button
Seat 1: xxzuluzuluxx ($10.27 in chips) 
Seat 2: Potzilla ($3.90 in chips) 
Seat 3: Ryaniam1981 ($9.50 in chips) 
Seat 4: Duke323 ($8 in chips) 
Seat 5: daughterstuitio ($7.48 in chips) 
Seat 6: PlayTheBlues4U ($10.86 in chips) 
Ryaniam1981: posts small blind $0.05
Duke323: posts big blind $0.10
*** HOLE CARDS ***
Dealt to PlayTheBlues4U [Kd Ts]
daughterstuitio: raises $0.20 to $0.30
PlayTheBlues4U: folds 
xxzuluzuluxx: folds 
Potzilla: calls $0.30
Ryaniam1981: folds 
Duke323: folds 
*** FLOP *** [6d 7d 5h]
daughterstuitio: bets $0.40
Potzilla: calls $0.40
*** TURN *** [6d 7d 5h] [7h]
daughterstuitio: checks 
Potzilla: bets $0.74
daughterstuitio: calls $0.74
*** RIVER *** [6d 7d 5h 7h] [3c]
daughterstuitio: bets $2.90
Potzilla: calls $2.46 and is all-in
Uncalled bet ($0.44) returned to daughterstuitio
*** SHOW DOWN ***
daughterstuitio: shows [6s 6h] (a full house, Sixes full of Sevens)
Potzilla: shows [Ac 7c] (three of a kind, Sevens)
daughterstuitio collected $7.55 from pot
*** SUMMARY ***
Total pot $7.95 | Rake $0.40 
Board [6d 7d 5h 7h 3c]
Seat 1: xxzuluzuluxx folded before Flop (didn't bet)
Seat 2: Potzilla (button) showed [Ac 7c] and lost with three of a kind, Sevens
Seat 3: Ryaniam1981 (small blind) folded before Flop
Seat 4: Duke323 (big blind) folded before Flop
Seat 5: daughterstuitio showed [6s 6h] and won ($7.55) with a full house, Sixes full of Sevens
Seat 6: PlayTheBlues4U folded before Flop (didn't bet)



PokerStars Hand #204644609444:  Hold'em No Limit ($0.05/$0.10 USD) - 2019/10/17 18:25:42 ET
Table 'Sappho' 6-max Seat #3 is the button
Seat 1: xxzuluzuluxx ($10.27 in chips) 
Seat 3: Ryaniam1981 ($9.45 in chips) 
Seat 4: Duke323 ($7.90 in chips) 
Seat 5: daughterstuitio ($11.13 in chips) 
Seat 6: PlayTheBlues4U ($10.86 in chips) 
Duke323: posts small blind $0.05
daughterstuitio: posts big blind $0.10
*** HOLE CARDS ***
Dealt to PlayTheBlues4U [5s 3h]
PlayTheBlues4U: folds 
xxzuluzuluxx: calls $0.10
Ryaniam1981: calls $0.10
Duke323: folds 
daughterstuitio: checks 
*** FLOP *** [Jd 6c As]
daughterstuitio: checks 
xxzuluzuluxx: bets $0.10
Ryaniam1981: calls $0.10
Potzilla leaves the table
daughterstuitio: folds 
*** TURN *** [Jd 6c As] [Ts]
xxzuluzuluxx: bets $0.10
Ryaniam1981: calls $0.10
*** RIVER *** [Jd 6c As Ts] [7s]
xxzuluzuluxx: bets $0.10
Ryaniam1981: folds 
Uncalled bet ($0.10) returned to xxzuluzuluxx
xxzuluzuluxx collected $0.71 from pot
xxzuluzuluxx: doesn't show hand 
*** SUMMARY ***
Total pot $0.75 | Rake $0.04 
Board [Jd 6c As Ts 7s]
Seat 1: xxzuluzuluxx collected ($0.71)
Seat 3: Ryaniam1981 (button) folded on the River
Seat 4: Duke323 (small blind) folded before Flop
Seat 5: daughterstuitio (big blind) folded on the Flop
Seat 6: PlayTheBlues4U folded before Flop (didn't bet)



PokerStars Hand #204644609513:  Hold'em No Limit ($0.05/$0.10 USD) - 2019/10/17 18:26:11 ET
Table 'Sappho' 6-max Seat #4 is the button
Seat 1: xxzuluzuluxx ($10.68 in chips) 
Seat 3: Ryaniam1981 ($9.15 in chips) 
Seat 4: Duke323 ($7.85 in chips) 
Seat 5: daughterstuitio ($11.03 in chips) 
Seat 6: PlayTheBlues4U ($10.86 in chips) 
daughterstuitio: posts small blind $0.05
PlayTheBlues4U: posts big blind $0.10
*** HOLE CARDS ***
Dealt to PlayTheBlues4U [3h Ac]
xxzuluzuluxx: calls $0.10
Ryaniam1981: calls $0.10
Duke323: folds 
crazy turfer joins the table at seat #2 
daughterstuitio: folds 
PlayTheBlues4U: checks 
*** FLOP *** [2s 6h Ks]
PlayTheBlues4U: checks 
xxzuluzuluxx: bets $0.10
Ryaniam1981: folds 
PlayTheBlues4U: folds 
Uncalled bet ($0.10) returned to xxzuluzuluxx
xxzuluzuluxx collected $0.33 from pot
xxzuluzuluxx: doesn't show hand 
*** SUMMARY ***
Total pot $0.35 | Rake $0.02 
Board [2s 6h Ks]
Seat 1: xxzuluzuluxx collected ($0.33)
Seat 3: Ryaniam1981 folded on the Flop
Seat 4: Duke323 (button) folded before Flop (didn't bet)
Seat 5: daughterstuitio (small blind) folded before Flop
Seat 6: PlayTheBlues4U (big blind) folded on the Flop



PokerStars Hand #204644609664:  Hold'em No Limit ($0.05/$0.10 USD) - 2019/10/17 18:27:03 ET
Table 'Sappho' 6-max Seat #5 is the button
Seat 1: xxzuluzuluxx ($10.91 in chips) 
Seat 2: crazy turfer ($10 in chips) 
Seat 3: Ryaniam1981 ($9.05 in chips) 
Seat 4: Duke323 ($7.85 in chips) 
Seat 5: daughterstuitio ($10.98 in chips) 
Seat 6: PlayTheBlues4U ($10.76 in chips) 
PlayTheBlues4U: posts small blind $0.05
xxzuluzuluxx: posts big blind $0.10
crazy turfer: posts big blind $0.10
*** HOLE CARDS ***
Dealt to PlayTheBlues4U [3d Js]
crazy turfer: raises $0.20 to $0.30
Ryaniam1981: calls $0.30
Duke323: folds 
daughterstuitio: folds 
PlayTheBlues4U: folds 
xxzuluzuluxx: calls $0.20
*** FLOP *** [As 4d Ad]
xxzuluzuluxx: checks 
crazy turfer: checks 
Ryaniam1981: checks 
*** TURN *** [As 4d Ad] [4s]
xxzuluzuluxx: checks 
crazy turfer: bets $0.90
Ryaniam1981: folds 
xxzuluzuluxx: folds 
Uncalled bet ($0.90) returned to crazy turfer
crazy turfer collected $0.90 from pot
*** SUMMARY ***
Total pot $0.95 | Rake $0.05 
Board [As 4d Ad 4s]
Seat 1: xxzuluzuluxx (big blind) folded on the Turn
Seat 2: crazy turfer collected ($0.90)
Seat 3: Ryaniam1981 folded on the Turn
Seat 4: Duke323 folded before Flop (didn't bet)
Seat 5: daughterstuitio (button) folded before Flop (didn't bet)
Seat 6: PlayTheBlues4U (small blind) folded before Flop



PokerStars Hand #204644609735:  Hold'em No Limit ($0.05/$0.10 USD) - 2019/10/17 18:27:28 ET
Table 'Sappho' 6-max Seat #6 is the button
Seat 1: xxzuluzuluxx ($10.61 in chips) 
Seat 2: crazy turfer ($10.60 in chips) 
Seat 3: Ryaniam1981 ($8.75 in chips) 
Seat 4: Duke323 ($7.85 in chips) 
Seat 5: daughterstuitio ($10.98 in chips) 
Seat 6: PlayTheBlues4U ($10.71 in chips) 
xxzuluzuluxx: posts small blind $0.05
crazy turfer: posts big blind $0.10
*** HOLE CARDS ***
Dealt to PlayTheBlues4U [7c Td]
Ryaniam1981: folds 
Duke323: folds 
daughterstuitio: raises $0.20 to $0.30
PlayTheBlues4U: folds 
xxzuluzuluxx: calls $0.25
crazy turfer: folds 
*** FLOP *** [3s 8d 2d]
xxzuluzuluxx: checks 
daughterstuitio: bets $0.30
xxzuluzuluxx: calls $0.30
*** TURN *** [3s 8d 2d] [2s]
xxzuluzuluxx: checks 
daughterstuitio: bets $0.50
xxzuluzuluxx: calls $0.50
*** RIVER *** [3s 8d 2d 2s] [5d]
xxzuluzuluxx: checks 
daughterstuitio: checks 
*** SHOW DOWN ***
xxzuluzuluxx: shows [Kd Jh] (a pair of Deuces)
daughterstuitio: shows [8c 9h] (two pair, Eights and Deuces)
daughterstuitio collected $2.18 from pot
*** SUMMARY ***
Total pot $2.30 | Rake $0.12 
Board [3s 8d 2d 2s 5d]
Seat 1: xxzuluzuluxx (small blind) showed [Kd Jh] and lost with a pair of Deuces
Seat 2: crazy turfer (big blind) folded before Flop
Seat 3: Ryaniam1981 folded before Flop (didn't bet)
Seat 4: Duke323 folded before Flop (didn't bet)
Seat 5: daughterstuitio showed [8c 9h] and won ($2.18) with two pair, Eights and Deuces
Seat 6: PlayTheBlues4U (button) folded before Flop (didn't bet)



PokerStars Hand #204644609864:  Hold'em No Limit ($0.05/$0.10 USD) - 2019/10/17 18:28:14 ET
Table 'Sappho' 6-max Seat #1 is the button
Seat 1: xxzuluzuluxx ($9.51 in chips) 
Seat 2: crazy turfer ($10.50 in chips) 
Seat 3: Ryaniam1981 ($8.75 in chips) 
Seat 4: Duke323 ($7.85 in chips) 
Seat 5: daughterstuitio ($12.06 in chips) 
Seat 6: PlayTheBlues4U ($10.71 in chips) 
crazy turfer: posts small blind $0.05
Ryaniam1981: posts big blind $0.10
*** HOLE CARDS ***
Dealt to PlayTheBlues4U [8h 4h]
Duke323: raises $0.20 to $0.30
daughterstuitio: folds 
PlayTheBlues4U: folds 
xxzuluzuluxx: calls $0.30
crazy turfer: folds 
Ryaniam1981: calls $0.20
*** FLOP *** [5h 3d 6c]
Ryaniam1981: checks 
Duke323: bets $0.90
xxzuluzuluxx: calls $0.90
Ryaniam1981: folds 
*** TURN *** [5h 3d 6c] [7c]
Duke323: checks 
xxzuluzuluxx: checks 
*** RIVER *** [5h 3d 6c 7c] [8d]
Duke323: checks 
xxzuluzuluxx: checks 
*** SHOW DOWN ***
Duke323: shows [Qh Ks] (high card King)
xxzuluzuluxx: shows [As Ac] (a pair of Aces)
xxzuluzuluxx collected $2.61 from pot
*** SUMMARY ***
Total pot $2.75 | Rake $0.14 
Board [5h 3d 6c 7c 8d]
Seat 1: xxzuluzuluxx (button) showed [As Ac] and won ($2.61) with a pair of Aces
Seat 2: crazy turfer (small blind) folded before Flop
Seat 3: Ryaniam1981 (big blind) folded on the Flop
Seat 4: Duke323 showed [Qh Ks] and lost with high card King
Seat 5: daughterstuitio folded before Flop (didn't bet)
Seat 6: PlayTheBlues4U folded before Flop (didn't bet)



PokerStars Hand #204644609986:  Hold'em No Limit ($0.05/$0.10 USD) - 2019/10/17 18:28:59 ET
Table 'Sappho' 6-max Seat #2 is the button
Seat 1: xxzuluzuluxx ($10.92 in chips) 
Seat 2: crazy turfer ($10.45 in chips) 
Seat 3: Ryaniam1981 ($8.45 in chips) 
Seat 4: Duke323 ($6.65 in chips) 
Seat 5: daughterstuitio ($12.06 in chips) 
Seat 6: PlayTheBlues4U ($10.71 in chips) 
Ryaniam1981: posts small blind $0.05
Duke323: posts big blind $0.10
*** HOLE CARDS ***
Dealt to PlayTheBlues4U [Ac 4s]
daughterstuitio: folds 
PlayTheBlues4U: folds 
xxzuluzuluxx: folds 
crazy turfer: folds 
Ryaniam1981: calls $0.05
Duke323: checks 
*** FLOP *** [Ts 6d 7d]
Ryaniam1981: bets $0.10
Duke323: calls $0.10
*** TURN *** [Ts 6d 7d] [Kd]
Ryaniam1981: checks 
Duke323: bets $0.10
Ryaniam1981: calls $0.10
*** RIVER *** [Ts 6d 7d Kd] [Jh]
Ryaniam1981: checks 
Duke323: checks 
*** SHOW DOWN ***
Ryaniam1981: shows [8h 2d] (high card King)
Duke323: shows [6h Ad] (a pair of Sixes)
Duke323 collected $0.57 from pot
*** SUMMARY ***
Total pot $0.60 | Rake $0.03 
Board [Ts 6d 7d Kd Jh]
Seat 1: xxzuluzuluxx folded before Flop (didn't bet)
Seat 2: crazy turfer (button) folded before Flop (didn't bet)
Seat 3: Ryaniam1981 (small blind) showed [8h 2d] and lost with high card King
Seat 4: Duke323 (big blind) showed [6h Ad] and won ($0.57) with a pair of Sixes
Seat 5: daughterstuitio folded before Flop (didn't bet)
Seat 6: PlayTheBlues4U folded before Flop (didn't bet)



PokerStars Hand #204645133402:  Hold'em No Limit ($0.05/$0.10 USD) - 2019/10/17 18:29:45 ET
Table 'Sappho' 6-max Seat #3 is the button
Seat 1: xxzuluzuluxx ($10.92 in chips) 
Seat 2: crazy turfer ($10.45 in chips) 
Seat 3: Ryaniam1981 ($8.15 in chips) 
Seat 4: Duke323 ($6.92 in chips) 
Seat 5: daughterstuitio ($12.06 in chips) 
Seat 6: PlayTheBlues4U ($10.71 in chips) 
Duke323: posts small blind $0.05
daughterstuitio: posts big blind $0.10
*** HOLE CARDS ***
Dealt to PlayTheBlues4U [3s 6h]
PlayTheBlues4U: folds 
xxzuluzuluxx: folds 
crazy turfer: folds 
Ryaniam1981: calls $0.10
Duke323: folds 
daughterstuitio: raises $0.20 to $0.30
Ryaniam1981: calls $0.20
*** FLOP *** [6s 5s Tc]
daughterstuitio: bets $0.30
Ryaniam1981: folds 
Uncalled bet ($0.30) returned to daughterstuitio
daughterstuitio collected $0.62 from pot
daughterstuitio: doesn't show hand 
*** SUMMARY ***
Total pot $0.65 | Rake $0.03 
Board [6s 5s Tc]
Seat 1: xxzuluzuluxx folded before Flop (didn't bet)
Seat 2: crazy turfer folded before Flop (didn't bet)
Seat 3: Ryaniam1981 (button) folded on the Flop
Seat 4: Duke323 (small blind) folded before Flop
Seat 5: daughterstuitio (big blind) collected ($0.62)
Seat 6: PlayTheBlues4U folded before Flop (didn't bet)



PokerStars Hand #204645133463:  Hold'em No Limit ($0.05/$0.10 USD) - 2019/10/17 18:30:16 ET
Table 'Sappho' 6-max Seat #4 is the button
Seat 1: xxzuluzuluxx ($10.92 in chips) 
Seat 2: crazy turfer ($10.45 in chips) 
Seat 3: Ryaniam1981 ($7.85 in chips) 
Seat 4: Duke323 ($6.87 in chips) 
Seat 5: daughterstuitio ($12.38 in chips) 
Seat 6: PlayTheBlues4U ($10.71 in chips) 
daughterstuitio: posts small blind $0.05
PlayTheBlues4U: posts big blind $0.10
*** HOLE CARDS ***
Dealt to PlayTheBlues4U [Qh 5d]
xxzuluzuluxx: calls $0.10
crazy turfer: folds 
Ryaniam1981: folds 
Duke323: raises $0.35 to $0.45
daughterstuitio: folds 
PlayTheBlues4U: folds 
xxzuluzuluxx: calls $0.35
*** FLOP *** [7d 9s 4c]
xxzuluzuluxx: checks 
Duke323: bets $1
xxzuluzuluxx: folds [3s]
Uncalled bet ($1) returned to Duke323
Duke323 collected $1 from pot
Duke323: doesn't show hand 
*** SUMMARY ***
Total pot $1.05 | Rake $0.05 
Board [7d 9s 4c]
Seat 1: xxzuluzuluxx folded on the Flop
Seat 2: crazy turfer folded before Flop (didn't bet)
Seat 3: Ryaniam1981 folded before Flop (didn't bet)
Seat 4: Duke323 (button) collected ($1)
Seat 5: daughterstuitio (small blind) folded before Flop
Seat 6: PlayTheBlues4U (big blind) folded before Flop



PokerStars Hand #204645133527:  Hold'em No Limit ($0.05/$0.10 USD) - 2019/10/17 18:30:46 ET
Table 'Sappho' 6-max Seat #5 is the button
Seat 1: xxzuluzuluxx ($10.47 in chips) 
Seat 2: crazy turfer ($10.45 in chips) 
Seat 3: Ryaniam1981 ($7.85 in chips) 
Seat 4: Duke323 ($7.42 in chips) 
Seat 5: daughterstuitio ($12.33 in chips) 
Seat 6: PlayTheBlues4U ($10.61 in chips) 
PlayTheBlues4U: posts small blind $0.05
xxzuluzuluxx: posts big blind $0.10
*** HOLE CARDS ***
Dealt to PlayTheBlues4U [Qc 8c]
crazy turfer: folds 
Ryaniam1981: calls $0.10
Duke323: folds 
daughterstuitio: folds 
PlayTheBlues4U: folds 
xxzuluzuluxx: checks 
*** FLOP *** [Qd 6s Tc]
xxzuluzuluxx: checks 
Ryaniam1981: bets $0.10
xxzuluzuluxx: folds 
Uncalled bet ($0.10) returned to Ryaniam1981
Ryaniam1981 collected $0.24 from pot
Ryaniam1981: doesn't show hand 
*** SUMMARY ***
Total pot $0.25 | Rake $0.01 
Board [Qd 6s Tc]
Seat 1: xxzuluzuluxx (big blind) folded on the Flop
Seat 2: crazy turfer folded before Flop (didn't bet)
Seat 3: Ryaniam1981 collected ($0.24)
Seat 4: Duke323 folded before Flop (didn't bet)
Seat 5: daughterstuitio (button) folded before Flop (didn't bet)
Seat 6: PlayTheBlues4U (small blind) folded before Flop



PokerStars Hand #204645133563:  Hold'em No Limit ($0.05/$0.10 USD) - 2019/10/17 18:31:04 ET
Table 'Sappho' 6-max Seat #6 is the button
Seat 1: xxzuluzuluxx ($10.37 in chips) 
Seat 2: crazy turfer ($10.45 in chips) 
Seat 3: Ryaniam1981 ($7.99 in chips) 
Seat 4: Duke323 ($7.42 in chips) 
Seat 5: daughterstuitio ($12.33 in chips) 
Seat 6: PlayTheBlues4U ($10.56 in chips) 
xxzuluzuluxx: posts small blind $0.05
crazy turfer: posts big blind $0.10
*** HOLE CARDS ***
Dealt to PlayTheBlues4U [4s Kd]
Ryaniam1981: calls $0.10
Duke323: raises $0.20 to $0.30
daughterstuitio: calls $0.30
PlayTheBlues4U: folds 
xxzuluzuluxx: folds 
crazy turfer: folds 
Ryaniam1981: calls $0.20
*** FLOP *** [Th Js 8c]
Ryaniam1981: checks 
Duke323: bets $1
daughterstuitio: folds 
Ryaniam1981: folds 
Uncalled bet ($1) returned to Duke323
Duke323 collected $1 from pot
Duke323: doesn't show hand 
*** SUMMARY ***
Total pot $1.05 | Rake $0.05 
Board [Th Js 8c]
Seat 1: xxzuluzuluxx (small blind) folded before Flop
Seat 2: crazy turfer (big blind) folded before Flop
Seat 3: Ryaniam1981 folded on the Flop
Seat 4: Duke323 collected ($1)
Seat 5: daughterstuitio folded on the Flop
Seat 6: PlayTheBlues4U (button) folded before Flop (didn't bet)



PokerStars Hand #204645133660:  Hold'em No Limit ($0.05/$0.10 USD) - 2019/10/17 18:31:44 ET
Table 'Sappho' 6-max Seat #1 is the button
Seat 1: xxzuluzuluxx ($10.32 in chips) 
Seat 2: crazy turfer ($10.35 in chips) 
Seat 3: Ryaniam1981 ($7.69 in chips) 
Seat 4: Duke323 ($8.12 in chips) 
Seat 5: daughterstuitio ($12.03 in chips) 
Seat 6: PlayTheBlues4U ($10.56 in chips) 
crazy turfer: posts small blind $0.05
Ryaniam1981: posts big blind $0.10
*** HOLE CARDS ***
Dealt to PlayTheBlues4U [5c Ad]
Duke323: folds 
daughterstuitio: folds 
PlayTheBlues4U: folds 
xxzuluzuluxx: folds 
crazy turfer: calls $0.05
Ryaniam1981: checks 
*** FLOP *** [3h 4h 3s]
crazy turfer: checks 
Ryaniam1981: checks 
*** TURN *** [3h 4h 3s] [Kd]
crazy turfer: bets $0.10
Ryaniam1981: calls $0.10
*** RIVER *** [3h 4h 3s Kd] [9c]
crazy turfer: bets $0.10
Ryaniam1981: calls $0.10
*** SHOW DOWN ***
crazy turfer: shows [9h Qc] (two pair, Nines and Threes)
Ryaniam1981: shows [6s Kh] (two pair, Kings and Threes)
Ryaniam1981 collected $0.57 from pot
*** SUMMARY ***
Total pot $0.60 | Rake $0.03 
Board [3h 4h 3s Kd 9c]
Seat 1: xxzuluzuluxx (button) folded before Flop (didn't bet)
Seat 2: crazy turfer (small blind) showed [9h Qc] and lost with two pair, Nines and Threes
Seat 3: Ryaniam1981 (big blind) showed [6s Kh] and won ($0.57) with two pair, Kings and Threes
Seat 4: Duke323 folded before Flop (didn't bet)
Seat 5: daughterstuitio folded before Flop (didn't bet)
Seat 6: PlayTheBlues4U folded before Flop (didn't bet)



PokerStars Hand #204645133721:  Hold'em No Limit ($0.05/$0.10 USD) - 2019/10/17 18:32:13 ET
Table 'Sappho' 6-max Seat #2 is the button
Seat 1: xxzuluzuluxx ($10.32 in chips) 
Seat 2: crazy turfer ($10.05 in chips) 
Seat 3: Ryaniam1981 ($7.96 in chips) 
Seat 4: Duke323 ($8.12 in chips) 
Seat 5: daughterstuitio ($12.03 in chips) 
Seat 6: PlayTheBlues4U ($10.56 in chips) 
Ryaniam1981: posts small blind $0.05
Duke323: posts big blind $0.10
*** HOLE CARDS ***
Dealt to PlayTheBlues4U [7c Ks]
daughterstuitio: folds 
PlayTheBlues4U: folds 
xxzuluzuluxx: folds 
crazy turfer: folds 
Ryaniam1981: calls $0.05
Duke323: checks 
*** FLOP *** [8d Jd 9s]
Ryaniam1981: bets $0.10
Duke323: raises $0.40 to $0.50
Ryaniam1981: folds 
Uncalled bet ($0.40) returned to Duke323
Duke323 collected $0.38 from pot
Duke323: doesn't show hand 
*** SUMMARY ***
Total pot $0.40 | Rake $0.02 
Board [8d Jd 9s]
Seat 1: xxzuluzuluxx folded before Flop (didn't bet)
Seat 2: crazy turfer (button) folded before Flop (didn't bet)
Seat 3: Ryaniam1981 (small blind) folded on the Flop
Seat 4: Duke323 (big blind) collected ($0.38)
Seat 5: daughterstuitio folded before Flop (didn't bet)
Seat 6: PlayTheBlues4U folded before Flop (didn't bet)



PokerStars Hand #204645133823:  Hold'em No Limit ($0.05/$0.10 USD) - 2019/10/17 18:32:56 ET
Table 'Sappho' 6-max Seat #3 is the button
Seat 1: xxzuluzuluxx ($10.32 in chips) 
Seat 2: crazy turfer ($10.05 in chips) 
Seat 3: Ryaniam1981 ($7.76 in chips) 
Seat 4: Duke323 ($8.30 in chips) 
Seat 5: daughterstuitio ($12.03 in chips) 
Seat 6: PlayTheBlues4U ($10.56 in chips) 
Duke323: posts small blind $0.05
daughterstuitio: posts big blind $0.10
*** HOLE CARDS ***
Dealt to PlayTheBlues4U [Kh 2c]
PlayTheBlues4U: folds 
xxzuluzuluxx: calls $0.10
crazy turfer: calls $0.10
Ryaniam1981: folds 
Duke323: folds 
daughterstuitio: checks 
*** FLOP *** [5d 9s Th]
daughterstuitio: checks 
xxzuluzuluxx: checks 
crazy turfer: bets $0.20
daughterstuitio: folds 
xxzuluzuluxx: folds 
Uncalled bet ($0.20) returned to crazy turfer
crazy turfer collected $0.33 from pot
*** SUMMARY ***
Total pot $0.35 | Rake $0.02 
Board [5d 9s Th]
Seat 1: xxzuluzuluxx folded on the Flop
Seat 2: crazy turfer collected ($0.33)
Seat 3: Ryaniam1981 (button) folded before Flop (didn't bet)
Seat 4: Duke323 (small blind) folded before Flop
Seat 5: daughterstuitio (big blind) folded on the Flop
Seat 6: PlayTheBlues4U folded before Flop (didn't bet)



PokerStars Hand #204645133878:  Hold'em No Limit ($0.05/$0.10 USD) - 2019/10/17 18:33:18 ET
Table 'Sappho' 6-max Seat #4 is the button
Seat 1: xxzuluzuluxx ($10.22 in chips) 
Seat 2: crazy turfer ($10.28 in chips) 
Seat 3: Ryaniam1981 ($7.76 in chips) 
Seat 4: Duke323 ($8.25 in chips) 
Seat 5: daughterstuitio ($11.93 in chips) 
Seat 6: PlayTheBlues4U ($10.56 in chips) 
daughterstuitio: posts small blind $0.05
PlayTheBlues4U: posts big blind $0.10
*** HOLE CARDS ***
Dealt to PlayTheBlues4U [As Qs]
xxzuluzuluxx: calls $0.10
crazy turfer: folds 
Ryaniam1981: folds 
Duke323: folds 
daughterstuitio: raises $0.20 to $0.30
PlayTheBlues4U: raises $0.60 to $0.90
xxzuluzuluxx: calls $0.80
daughterstuitio: calls $0.60
*** FLOP *** [5c 6c 3s]
daughterstuitio: checks 
PlayTheBlues4U: bets $1.50
xxzuluzuluxx: folds 
daughterstuitio: folds 
Uncalled bet ($1.50) returned to PlayTheBlues4U
PlayTheBlues4U collected $2.56 from pot
PlayTheBlues4U: doesn't show hand 
*** SUMMARY ***
Total pot $2.70 | Rake $0.14 
Board [5c 6c 3s]
Seat 1: xxzuluzuluxx folded on the Flop
Seat 2: crazy turfer folded before Flop (didn't bet)
Seat 3: Ryaniam1981 folded before Flop (didn't bet)
Seat 4: Duke323 (button) folded before Flop (didn't bet)
Seat 5: daughterstuitio (small blind) folded on the Flop
Seat 6: PlayTheBlues4U (big blind) collected ($2.56)



PokerStars Hand #204645133991:  Hold'em No Limit ($0.05/$0.10 USD) - 2019/10/17 18:34:03 ET
Table 'Sappho' 6-max Seat #5 is the button
Seat 1: xxzuluzuluxx ($9.32 in chips) 
Seat 2: crazy turfer ($10.28 in chips) 
Seat 3: Ryaniam1981 ($7.76 in chips) 
Seat 4: Duke323 ($8.25 in chips) 
Seat 5: daughterstuitio ($11.03 in chips) 
Seat 6: PlayTheBlues4U ($12.22 in chips) 
PlayTheBlues4U: posts small blind $0.05
xxzuluzuluxx: posts big blind $0.10
*** HOLE CARDS ***
Dealt to PlayTheBlues4U [7c Jd]
crazy turfer: folds 
Ryaniam1981: folds 
Duke323: folds 
daughterstuitio: folds 
PlayTheBlues4U: folds 
Uncalled bet ($0.05) returned to xxzuluzuluxx
xxzuluzuluxx collected $0.10 from pot
xxzuluzuluxx: doesn't show hand 
*** SUMMARY ***
Total pot $0.10 | Rake $0 
Seat 1: xxzuluzuluxx (big blind) collected ($0.10)
Seat 2: crazy turfer folded before Flop (didn't bet)
Seat 3: Ryaniam1981 folded before Flop (didn't bet)
Seat 4: Duke323 folded before Flop (didn't bet)
Seat 5: daughterstuitio (button) folded before Flop (didn't bet)
Seat 6: PlayTheBlues4U (small blind) folded before Flop



PokerStars Hand #204645134030:  Hold'em No Limit ($0.05/$0.10 USD) - 2019/10/17 18:34:17 ET
Table 'Sappho' 6-max Seat #6 is the button
Seat 1: xxzuluzuluxx ($9.37 in chips) 
Seat 2: crazy turfer ($10.28 in chips) 
Seat 3: Ryaniam1981 ($7.76 in chips) 
Seat 4: Duke323 ($8.25 in chips) 
Seat 5: daughterstuitio ($11.03 in chips) 
Seat 6: PlayTheBlues4U ($12.17 in chips) 
xxzuluzuluxx: posts small blind $0.05
crazy turfer: posts big blind $0.10
*** HOLE CARDS ***
Dealt to PlayTheBlues4U [3c 5h]
Ryaniam1981: calls $0.10
Duke323: folds 
daughterstuitio: raises $0.30 to $0.40
PlayTheBlues4U: folds 
xxzuluzuluxx: folds 
crazy turfer: folds 
Ryaniam1981: calls $0.30
*** FLOP *** [Kh 3s Js]
Ryaniam1981: checks 
daughterstuitio: bets $0.50
Ryaniam1981: calls $0.50
*** TURN *** [Kh 3s Js] [3h]
Ryaniam1981: checks 
daughterstuitio: bets $1
Ryaniam1981: folds 
Uncalled bet ($1) returned to daughterstuitio
daughterstuitio collected $1.85 from pot
daughterstuitio: doesn't show hand 
*** SUMMARY ***
Total pot $1.95 | Rake $0.10 
Board [Kh 3s Js 3h]
Seat 1: xxzuluzuluxx (small blind) folded before Flop
Seat 2: crazy turfer (big blind) folded before Flop
Seat 3: Ryaniam1981 folded on the Turn
Seat 4: Duke323 folded before Flop (didn't bet)
Seat 5: daughterstuitio collected ($1.85)
Seat 6: PlayTheBlues4U (button) folded before Flop (didn't bet)



PokerStars Hand #204645134140:  Hold'em No Limit ($0.05/$0.10 USD) - 2019/10/17 18:35:03 ET
Table 'Sappho' 6-max Seat #1 is the button
Seat 1: xxzuluzuluxx ($9.32 in chips) 
Seat 2: crazy turfer ($10.18 in chips) 
Seat 3: Ryaniam1981 ($6.86 in chips) 
Seat 4: Duke323 ($8.25 in chips) 
Seat 5: daughterstuitio ($11.98 in chips) 
Seat 6: PlayTheBlues4U ($12.17 in chips) 
crazy turfer: posts small blind $0.05
Ryaniam1981: posts big blind $0.10
*** HOLE CARDS ***
Dealt to PlayTheBlues4U [6s 7s]
Duke323: folds 
daughterstuitio: raises $0.20 to $0.30
PlayTheBlues4U: folds 
xxzuluzuluxx: folds 
crazy turfer: calls $0.25
Ryaniam1981: folds 
*** FLOP *** [5c 8h 5d]
crazy turfer: checks 
daughterstuitio: checks 
*** TURN *** [5c 8h 5d] [Jc]
crazy turfer: bets $0.70
daughterstuitio: folds 
Uncalled bet ($0.70) returned to crazy turfer
crazy turfer collected $0.66 from pot
daughterstuitio leaves the table
*** SUMMARY ***
Total pot $0.70 | Rake $0.04 
Board [5c 8h 5d Jc]
Seat 1: xxzuluzuluxx (button) folded before Flop (didn't bet)
Seat 2: crazy turfer (small blind) collected ($0.66)
Seat 3: Ryaniam1981 (big blind) folded before Flop
Seat 4: Duke323 folded before Flop (didn't bet)
Seat 5: daughterstuitio folded on the Turn
Seat 6: PlayTheBlues4U folded before Flop (didn't bet)



PokerStars Hand #204645134229:  Hold'em No Limit ($0.05/$0.10 USD) - 2019/10/17 18:35:36 ET
Table 'Sappho' 6-max Seat #2 is the button
Seat 1: xxzuluzuluxx ($9.32 in chips) 
Seat 2: crazy turfer ($10.54 in chips) 
Seat 3: Ryaniam1981 ($6.76 in chips) 
Seat 4: Duke323 ($8.25 in chips) 
Seat 6: PlayTheBlues4U ($12.17 in chips) 
Ryaniam1981: posts small blind $0.05
Duke323: posts big blind $0.10
*** HOLE CARDS ***
Dealt to PlayTheBlues4U [Qc 4h]
PlayTheBlues4U: folds 
xxzuluzuluxx: folds 
crazy turfer: folds 
LanskyBanksy joins the table at seat #5 
Ryaniam1981: calls $0.05
Duke323: raises $0.20 to $0.30
Ryaniam1981: calls $0.20
*** FLOP *** [9h Qd 9s]
Ryaniam1981: checks 
Duke323: bets $0.60
Ryaniam1981: folds 
Uncalled bet ($0.60) returned to Duke323
Duke323 collected $0.57 from pot
Duke323: doesn't show hand 
*** SUMMARY ***
Total pot $0.60 | Rake $0.03 
Board [9h Qd 9s]
Seat 1: xxzuluzuluxx folded before Flop (didn't bet)
Seat 2: crazy turfer (button) folded before Flop (didn't bet)
Seat 3: Ryaniam1981 (small blind) folded on the Flop
Seat 4: Duke323 (big blind) collected ($0.57)
Seat 6: PlayTheBlues4U folded before Flop (didn't bet)



PokerStars Hand #204645134343:  Hold'em No Limit ($0.05/$0.10 USD) - 2019/10/17 18:36:28 ET
Table 'Sappho' 6-max Seat #3 is the button
Seat 1: xxzuluzuluxx ($9.32 in chips) 
Seat 2: crazy turfer ($10.54 in chips) 
Seat 3: Ryaniam1981 ($6.46 in chips) 
Seat 4: Duke323 ($8.52 in chips) 
Seat 5: LanskyBanksy ($10 in chips) 
Seat 6: PlayTheBlues4U ($12.17 in chips) 
Duke323: posts small blind $0.05
LanskyBanksy: posts big blind $0.10
*** HOLE CARDS ***
Dealt to PlayTheBlues4U [6c 6d]
PlayTheBlues4U: raises $0.20 to $0.30
xxzuluzuluxx: folds 
crazy turfer: folds 
Ryaniam1981: folds 
Ryaniam1981 leaves the table
DeepMTPocket joins the table at seat #3 
Duke323: calls $0.25
LanskyBanksy: folds 
*** FLOP *** [3s Qd Kc]
Duke323: checks 
PlayTheBlues4U: bets $0.40
Duke323: folds 
Uncalled bet ($0.40) returned to PlayTheBlues4U
PlayTheBlues4U collected $0.66 from pot
PlayTheBlues4U: doesn't show hand 
*** SUMMARY ***
Total pot $0.70 | Rake $0.04 
Board [3s Qd Kc]
Seat 1: xxzuluzuluxx folded before Flop (didn't bet)
Seat 2: crazy turfer folded before Flop (didn't bet)
Seat 3: Ryaniam1981 (button) folded before Flop (didn't bet)
Seat 4: Duke323 (small blind) folded on the Flop
Seat 5: LanskyBanksy (big blind) folded before Flop
Seat 6: PlayTheBlues4U collected ($0.66)



PokerStars Hand #204645134417:  Hold'em No Limit ($0.05/$0.10 USD) - 2019/10/17 18:36:59 ET
Table 'Sappho' 6-max Seat #4 is the button
Seat 1: xxzuluzuluxx ($9.32 in chips) 
Seat 2: crazy turfer ($10.54 in chips) 
Seat 4: Duke323 ($8.22 in chips) 
Seat 5: LanskyBanksy ($9.90 in chips) 
Seat 6: PlayTheBlues4U ($12.53 in chips) 
LanskyBanksy: posts small blind $0.05
PlayTheBlues4U: posts big blind $0.10
DeepMTPocket: sits out 
*** HOLE CARDS ***
Dealt to PlayTheBlues4U [8s Ac]
xxzuluzuluxx: folds 
crazy turfer: calls $0.10
Duke323: folds 
LanskyBanksy: calls $0.05
PlayTheBlues4U: checks 
*** FLOP *** [8d 2h 8h]
LanskyBanksy: checks 
PlayTheBlues4U: bets $0.20
crazy turfer: folds 
LanskyBanksy: folds 
Uncalled bet ($0.20) returned to PlayTheBlues4U
PlayTheBlues4U collected $0.28 from pot
PlayTheBlues4U: doesn't show hand 
*** SUMMARY ***
Total pot $0.30 | Rake $0.02 
Board [8d 2h 8h]
Seat 1: xxzuluzuluxx folded before Flop (didn't bet)
Seat 2: crazy turfer folded on the Flop
Seat 4: Duke323 (button) folded before Flop (didn't bet)
Seat 5: LanskyBanksy (small blind) folded on the Flop
Seat 6: PlayTheBlues4U (big blind) collected ($0.28)



PokerStars Hand #204645134510:  Hold'em No Limit ($0.05/$0.10 USD) - 2019/10/17 18:37:39 ET
Table 'Sappho' 6-max Seat #5 is the button
Seat 1: xxzuluzuluxx ($9.32 in chips) 
Seat 2: crazy turfer ($10.44 in chips) 
Seat 4: Duke323 ($8.22 in chips) 
Seat 5: LanskyBanksy ($9.80 in chips) 
Seat 6: PlayTheBlues4U ($12.71 in chips) 
PlayTheBlues4U: posts small blind $0.05
xxzuluzuluxx: posts big blind $0.10
DeepMTPocket: sits out 
*** HOLE CARDS ***
Dealt to PlayTheBlues4U [3s 8h]
crazy turfer: raises $0.20 to $0.30
Duke323: folds 
LanskyBanksy: folds 
PlayTheBlues4U: folds 
xxzuluzuluxx: calls $0.20
*** FLOP *** [5c Tc 2d]
xxzuluzuluxx: checks 
crazy turfer: checks 
*** TURN *** [5c Tc 2d] [7d]
xxzuluzuluxx: checks 
crazy turfer: checks 
*** RIVER *** [5c Tc 2d 7d] [7c]
xxzuluzuluxx: bets $0.62
crazy turfer: folds 
Uncalled bet ($0.62) returned to xxzuluzuluxx
xxzuluzuluxx collected $0.62 from pot
xxzuluzuluxx: doesn't show hand 
*** SUMMARY ***
Total pot $0.65 | Rake $0.03 
Board [5c Tc 2d 7d 7c]
Seat 1: xxzuluzuluxx (big blind) collected ($0.62)
Seat 2: crazy turfer folded on the River
Seat 4: Duke323 folded before Flop (didn't bet)
Seat 5: LanskyBanksy (button) folded before Flop (didn't bet)
Seat 6: PlayTheBlues4U (small blind) folded before Flop



PokerStars Hand #204645134572:  Hold'em No Limit ($0.05/$0.10 USD) - 2019/10/17 18:38:08 ET
Table 'Sappho' 6-max Seat #6 is the button
Seat 1: xxzuluzuluxx ($9.64 in chips) 
Seat 2: crazy turfer ($10.14 in chips) 
Seat 4: Duke323 ($8.22 in chips) 
Seat 5: LanskyBanksy ($9.80 in chips) 
Seat 6: PlayTheBlues4U ($12.66 in chips) 
xxzuluzuluxx: posts small blind $0.05
crazy turfer: posts big blind $0.10
DeepMTPocket: sits out 
*** HOLE CARDS ***
Dealt to PlayTheBlues4U [2d 7s]
Duke323: folds 
LanskyBanksy: folds 
PlayTheBlues4U: folds 
xxzuluzuluxx: calls $0.05
crazy turfer: checks 
*** FLOP *** [3h Js Td]
xxzuluzuluxx: checks 
crazy turfer: checks 
*** TURN *** [3h Js Td] [9c]
xxzuluzuluxx: bets $0.10
crazy turfer: folds 
Uncalled bet ($0.10) returned to xxzuluzuluxx
xxzuluzuluxx collected $0.19 from pot
xxzuluzuluxx: doesn't show hand 
*** SUMMARY ***
Total pot $0.20 | Rake $0.01 
Board [3h Js Td 9c]
Seat 1: xxzuluzuluxx (small blind) collected ($0.19)
Seat 2: crazy turfer (big blind) folded on the Turn
Seat 4: Duke323 folded before Flop (didn't bet)
Seat 5: LanskyBanksy folded before Flop (didn't bet)
Seat 6: PlayTheBlues4U (button) folded before Flop (didn't bet)



PokerStars Hand #204645134635:  Hold'em No Limit ($0.05/$0.10 USD) - 2019/10/17 18:38:36 ET
Table 'Sappho' 6-max Seat #1 is the button
Seat 1: xxzuluzuluxx ($9.73 in chips) 
Seat 2: crazy turfer ($10.04 in chips) 
Seat 3: DeepMTPocket ($10 in chips) 
Seat 4: Duke323 ($8.22 in chips) 
Seat 5: LanskyBanksy ($9.80 in chips) 
Seat 6: PlayTheBlues4U ($12.66 in chips) 
crazy turfer: posts small blind $0.05
DeepMTPocket: posts big blind $0.10
*** HOLE CARDS ***
Dealt to PlayTheBlues4U [7s 9d]
Duke323: folds 
LanskyBanksy: folds 
PlayTheBlues4U: folds 
xxzuluzuluxx: folds 
crazy turfer: raises $0.20 to $0.30
DeepMTPocket: calls $0.20
*** FLOP *** [Jc Kh Ac]
crazy turfer: bets $0.60
DeepMTPocket: calls $0.60
*** TURN *** [Jc Kh Ac] [2c]
crazy turfer: bets $1.70
DeepMTPocket: folds 
Uncalled bet ($1.70) returned to crazy turfer
crazy turfer collected $1.71 from pot
*** SUMMARY ***
Total pot $1.80 | Rake $0.09 
Board [Jc Kh Ac 2c]
Seat 1: xxzuluzuluxx (button) folded before Flop (didn't bet)
Seat 2: crazy turfer (small blind) collected ($1.71)
Seat 3: DeepMTPocket (big blind) folded on the Turn
Seat 4: Duke323 folded before Flop (didn't bet)
Seat 5: LanskyBanksy folded before Flop (didn't bet)
Seat 6: PlayTheBlues4U folded before Flop (didn't bet)



PokerStars Hand #204645134703:  Hold'em No Limit ($0.05/$0.10 USD) - 2019/10/17 18:39:06 ET
Table 'Sappho' 6-max Seat #2 is the button
Seat 1: xxzuluzuluxx ($9.73 in chips) 
Seat 2: crazy turfer ($10.85 in chips) 
Seat 3: DeepMTPocket ($9.10 in chips) 
Seat 4: Duke323 ($8.22 in chips) 
Seat 5: LanskyBanksy ($9.80 in chips) 
Seat 6: PlayTheBlues4U ($12.66 in chips) 
DeepMTPocket: posts small blind $0.05
Duke323: posts big blind $0.10
*** HOLE CARDS ***
Dealt to PlayTheBlues4U [5h Th]
LanskyBanksy: folds 
PlayTheBlues4U: folds 
xxzuluzuluxx: folds 
crazy turfer: folds 
DeepMTPocket: raises $0.20 to $0.30
Duke323: calls $0.20
*** FLOP *** [8h 7s As]
DeepMTPocket: bets $0.57
Duke323: calls $0.57
*** TURN *** [8h 7s As] [4c]
DeepMTPocket: bets $1.80
Duke323: folds 
Uncalled bet ($1.80) returned to DeepMTPocket
DeepMTPocket collected $1.65 from pot
DeepMTPocket: doesn't show hand 
*** SUMMARY ***
Total pot $1.74 | Rake $0.09 
Board [8h 7s As 4c]
Seat 1: xxzuluzuluxx folded before Flop (didn't bet)
Seat 2: crazy turfer (button) folded before Flop (didn't bet)
Seat 3: DeepMTPocket (small blind) collected ($1.65)
Seat 4: Duke323 (big blind) folded on the Turn
Seat 5: LanskyBanksy folded before Flop (didn't bet)
Seat 6: PlayTheBlues4U folded before Flop (didn't bet)



PokerStars Hand #204645134814:  Hold'em No Limit ($0.05/$0.10 USD) - 2019/10/17 18:39:54 ET
Table 'Sappho' 6-max Seat #3 is the button
Seat 1: xxzuluzuluxx ($9.73 in chips) 
Seat 2: crazy turfer ($10.85 in chips) 
Seat 3: DeepMTPocket ($9.88 in chips) 
Seat 4: Duke323 ($7.35 in chips) 
Seat 5: LanskyBanksy ($9.80 in chips) 
Seat 6: PlayTheBlues4U ($12.66 in chips) 
Duke323: posts small blind $0.05
LanskyBanksy: posts big blind $0.10
*** HOLE CARDS ***
Dealt to PlayTheBlues4U [4c 5h]
PlayTheBlues4U: folds 
xxzuluzuluxx: calls $0.10
crazy turfer: folds 
DeepMTPocket: calls $0.10
Duke323: folds 
LanskyBanksy: checks 
*** FLOP *** [Ks Kd 4h]
LanskyBanksy: checks 
xxzuluzuluxx: checks 
DeepMTPocket: checks 
*** TURN *** [Ks Kd 4h] [2c]
LanskyBanksy: checks 
xxzuluzuluxx: checks 
DeepMTPocket: checks 
*** RIVER *** [Ks Kd 4h 2c] [7c]
LanskyBanksy: checks 
xxzuluzuluxx: checks 
DeepMTPocket: bets $0.10
LanskyBanksy: folds 
xxzuluzuluxx: folds 
Uncalled bet ($0.10) returned to DeepMTPocket
DeepMTPocket collected $0.33 from pot
DeepMTPocket: doesn't show hand 
*** SUMMARY ***
Total pot $0.35 | Rake $0.02 
Board [Ks Kd 4h 2c 7c]
Seat 1: xxzuluzuluxx folded on the River
Seat 2: crazy turfer folded before Flop (didn't bet)
Seat 3: DeepMTPocket (button) collected ($0.33)
Seat 4: Duke323 (small blind) folded before Flop
Seat 5: LanskyBanksy (big blind) folded on the River
Seat 6: PlayTheBlues4U folded before Flop (didn't bet)



PokerStars Hand #204645134916:  Hold'em No Limit ($0.05/$0.10 USD) - 2019/10/17 18:40:38 ET
Table 'Sappho' 6-max Seat #4 is the button
Seat 1: xxzuluzuluxx ($9.63 in chips) 
Seat 2: crazy turfer ($10.85 in chips) 
Seat 3: DeepMTPocket ($10.11 in chips) 
Seat 4: Duke323 ($7.30 in chips) 
Seat 5: LanskyBanksy ($9.70 in chips) 
Seat 6: PlayTheBlues4U ($12.66 in chips) 
LanskyBanksy: posts small blind $0.05
PlayTheBlues4U: posts big blind $0.10
*** HOLE CARDS ***
Dealt to PlayTheBlues4U [Jh Ad]
xxzuluzuluxx: calls $0.10
crazy turfer: raises $0.35 to $0.45
DeepMTPocket: folds 
Duke323: folds 
LanskyBanksy: folds 
PlayTheBlues4U: folds 
xxzuluzuluxx: calls $0.35
*** FLOP *** [3s 9c 8c]
xxzuluzuluxx: checks 
crazy turfer: bets $1
xxzuluzuluxx: folds 
Uncalled bet ($1) returned to crazy turfer
crazy turfer collected $1 from pot
*** SUMMARY ***
Total pot $1.05 | Rake $0.05 
Board [3s 9c 8c]
Seat 1: xxzuluzuluxx folded on the Flop
Seat 2: crazy turfer collected ($1)
Seat 3: DeepMTPocket folded before Flop (didn't bet)
Seat 4: Duke323 (button) folded before Flop (didn't bet)
Seat 5: LanskyBanksy (small blind) folded before Flop
Seat 6: PlayTheBlues4U (big blind) folded before Flop



PokerStars Hand #204645134978:  Hold'em No Limit ($0.05/$0.10 USD) - 2019/10/17 18:41:06 ET
Table 'Sappho' 6-max Seat #5 is the button
Seat 1: xxzuluzuluxx ($9.18 in chips) 
Seat 2: crazy turfer ($11.40 in chips) 
Seat 3: DeepMTPocket ($10.11 in chips) 
Seat 4: Duke323 ($7.30 in chips) 
Seat 5: LanskyBanksy ($9.65 in chips) 
Seat 6: PlayTheBlues4U ($12.56 in chips) 
PlayTheBlues4U: posts small blind $0.05
xxzuluzuluxx: posts big blind $0.10
*** HOLE CARDS ***
Dealt to PlayTheBlues4U [8c 3d]
crazy turfer: folds 
DeepMTPocket: folds 
Duke323: folds 
LanskyBanksy: raises $0.20 to $0.30
PlayTheBlues4U: folds 
xxzuluzuluxx: calls $0.20
*** FLOP *** [9d Jd 3s]
xxzuluzuluxx: checks 
LanskyBanksy: bets $0.31
xxzuluzuluxx: calls $0.31
*** TURN *** [9d Jd 3s] [8s]
xxzuluzuluxx: checks 
LanskyBanksy: bets $0.80
xxzuluzuluxx: calls $0.80
*** RIVER *** [9d Jd 3s 8s] [5h]
xxzuluzuluxx: checks 
LanskyBanksy: bets $1.50
xxzuluzuluxx: calls $1.50
*** SHOW DOWN ***
LanskyBanksy: shows [Js As] (a pair of Jacks)
xxzuluzuluxx: mucks hand 
LanskyBanksy collected $5.58 from pot
*** SUMMARY ***
Total pot $5.87 | Rake $0.29 
Board [9d Jd 3s 8s 5h]
Seat 1: xxzuluzuluxx (big blind) mucked [Kd Jc]
Seat 2: crazy turfer folded before Flop (didn't bet)
Seat 3: DeepMTPocket folded before Flop (didn't bet)
Seat 4: Duke323 folded before Flop (didn't bet)
Seat 5: LanskyBanksy (button) showed [Js As] and won ($5.58) with a pair of Jacks
Seat 6: PlayTheBlues4U (small blind) folded before Flop



PokerStars Hand #204645135072:  Hold'em No Limit ($0.05/$0.10 USD) - 2019/10/17 18:41:50 ET
Table 'Sappho' 6-max Seat #6 is the button
Seat 1: xxzuluzuluxx ($6.27 in chips) 
Seat 2: crazy turfer ($11.40 in chips) 
Seat 3: DeepMTPocket ($10.11 in chips) 
Seat 4: Duke323 ($7.30 in chips) 
Seat 5: LanskyBanksy ($12.32 in chips) 
Seat 6: PlayTheBlues4U ($12.51 in chips) 
xxzuluzuluxx: posts small blind $0.05
crazy turfer: posts big blind $0.10
*** HOLE CARDS ***
Dealt to PlayTheBlues4U [Ac 3s]
DeepMTPocket: folds 
Duke323: folds 
LanskyBanksy: folds 
PlayTheBlues4U: folds 
xxzuluzuluxx: calls $0.05
crazy turfer: checks 
*** FLOP *** [Jh Qh 9s]
xxzuluzuluxx: checks 
crazy turfer: checks 
*** TURN *** [Jh Qh 9s] [2d]
xxzuluzuluxx: bets $0.10
crazy turfer: folds 
Uncalled bet ($0.10) returned to xxzuluzuluxx
xxzuluzuluxx collected $0.19 from pot
xxzuluzuluxx: doesn't show hand 
*** SUMMARY ***
Total pot $0.20 | Rake $0.01 
Board [Jh Qh 9s 2d]
Seat 1: xxzuluzuluxx (small blind) collected ($0.19)
Seat 2: crazy turfer (big blind) folded on the Turn
Seat 3: DeepMTPocket folded before Flop (didn't bet)
Seat 4: Duke323 folded before Flop (didn't bet)
Seat 5: LanskyBanksy folded before Flop (didn't bet)
Seat 6: PlayTheBlues4U (button) folded before Flop (didn't bet)



PokerStars Hand #204645135132:  Hold'em No Limit ($0.05/$0.10 USD) - 2019/10/17 18:42:15 ET
Table 'Sappho' 6-max Seat #1 is the button
Seat 1: xxzuluzuluxx ($6.36 in chips) 
Seat 2: crazy turfer ($11.30 in chips) 
Seat 3: DeepMTPocket ($10.11 in chips) 
Seat 4: Duke323 ($7.30 in chips) 
Seat 5: LanskyBanksy ($12.32 in chips) 
Seat 6: PlayTheBlues4U ($12.51 in chips) 
crazy turfer: posts small blind $0.05
DeepMTPocket: posts big blind $0.10
*** HOLE CARDS ***
Dealt to PlayTheBlues4U [6d 9d]
Duke323: folds 
LanskyBanksy: folds 
PlayTheBlues4U: raises $0.20 to $0.30
xxzuluzuluxx: folds 
crazy turfer: folds 
DeepMTPocket: calls $0.20
*** FLOP *** [9s Kc 2s]
DeepMTPocket: checks 
PlayTheBlues4U: bets $0.40
DeepMTPocket: folds 
Uncalled bet ($0.40) returned to PlayTheBlues4U
PlayTheBlues4U collected $0.62 from pot
PlayTheBlues4U: doesn't show hand 
*** SUMMARY ***
Total pot $0.65 | Rake $0.03 
Board [9s Kc 2s]
Seat 1: xxzuluzuluxx (button) folded before Flop (didn't bet)
Seat 2: crazy turfer (small blind) folded before Flop
Seat 3: DeepMTPocket (big blind) folded on the Flop
Seat 4: Duke323 folded before Flop (didn't bet)
Seat 5: LanskyBanksy folded before Flop (didn't bet)
Seat 6: PlayTheBlues4U collected ($0.62)



PokerStars Hand #204645135216:  Hold'em No Limit ($0.05/$0.10 USD) - 2019/10/17 18:42:49 ET
Table 'Sappho' 6-max Seat #2 is the button
Seat 1: xxzuluzuluxx ($6.36 in chips) 
Seat 2: crazy turfer ($11.25 in chips) 
Seat 3: DeepMTPocket ($9.81 in chips) 
Seat 4: Duke323 ($7.30 in chips) 
Seat 5: LanskyBanksy ($12.32 in chips) 
Seat 6: PlayTheBlues4U ($12.83 in chips) 
DeepMTPocket: posts small blind $0.05
Duke323: posts big blind $0.10
*** HOLE CARDS ***
Dealt to PlayTheBlues4U [7d 8s]
LanskyBanksy: raises $0.40 to $0.50
PlayTheBlues4U: folds 
xxzuluzuluxx: calls $0.50
crazy turfer: folds 
DeepMTPocket: folds 
Duke323: folds 
*** FLOP *** [2h 6s 4s]
LanskyBanksy: bets $0.60
xxzuluzuluxx: calls $0.60
*** TURN *** [2h 6s 4s] [6d]
LanskyBanksy: bets $1.20
xxzuluzuluxx: calls $1.20
*** RIVER *** [2h 6s 4s 6d] [Ts]
LanskyBanksy: bets $2.50
xxzuluzuluxx: folds 
Uncalled bet ($2.50) returned to LanskyBanksy
LanskyBanksy collected $4.51 from pot
LanskyBanksy: doesn't show hand 
*** SUMMARY ***
Total pot $4.75 | Rake $0.24 
Board [2h 6s 4s 6d Ts]
Seat 1: xxzuluzuluxx folded on the River
Seat 2: crazy turfer (button) folded before Flop (didn't bet)
Seat 3: DeepMTPocket (small blind) folded before Flop
Seat 4: Duke323 (big blind) folded before Flop
Seat 5: LanskyBanksy collected ($4.51)
Seat 6: PlayTheBlues4U folded before Flop (didn't bet)



PokerStars Hand #204645135320:  Hold'em No Limit ($0.05/$0.10 USD) - 2019/10/17 18:43:28 ET
Table 'Sappho' 6-max Seat #3 is the button
Seat 1: xxzuluzuluxx ($4.06 in chips) 
Seat 2: crazy turfer ($11.25 in chips) 
Seat 3: DeepMTPocket ($9.76 in chips) 
Seat 4: Duke323 ($7.20 in chips) 
Seat 5: LanskyBanksy ($14.53 in chips) 
Seat 6: PlayTheBlues4U ($12.83 in chips) 
Duke323: posts small blind $0.05
LanskyBanksy: posts big blind $0.10
*** HOLE CARDS ***
Dealt to PlayTheBlues4U [4s 9h]
PlayTheBlues4U: folds 
xxzuluzuluxx: calls $0.10
crazy turfer: folds 
DeepMTPocket: folds 
Duke323: calls $0.05
LanskyBanksy: checks 
*** FLOP *** [9c 8d Qs]
Duke323: checks 
LanskyBanksy: checks 
xxzuluzuluxx: checks 
*** TURN *** [9c 8d Qs] [Tc]
Duke323: checks 
LanskyBanksy: checks 
xxzuluzuluxx: checks 
*** RIVER *** [9c 8d Qs Tc] [Qc]
Duke323: checks 
LanskyBanksy: checks 
xxzuluzuluxx: checks 
*** SHOW DOWN ***
Duke323: shows [2h 2d] (two pair, Queens and Deuces)
LanskyBanksy: shows [5h Ts] (two pair, Queens and Tens)
xxzuluzuluxx: mucks hand 
LanskyBanksy collected $0.28 from pot
*** SUMMARY ***
Total pot $0.30 | Rake $0.02 
Board [9c 8d Qs Tc Qc]
Seat 1: xxzuluzuluxx mucked [3c Ad]
Seat 2: crazy turfer folded before Flop (didn't bet)
Seat 3: DeepMTPocket (button) folded before Flop (didn't bet)
Seat 4: Duke323 (small blind) showed [2h 2d] and lost with two pair, Queens and Deuces
Seat 5: LanskyBanksy (big blind) showed [5h Ts] and won ($0.28) with two pair, Queens and Tens
Seat 6: PlayTheBlues4U folded before Flop (didn't bet)



PokerStars Hand #204645135421:  Hold'em No Limit ($0.05/$0.10 USD) - 2019/10/17 18:44:07 ET
Table 'Sappho' 6-max Seat #4 is the button
Seat 1: xxzuluzuluxx ($3.96 in chips) 
Seat 2: crazy turfer ($11.25 in chips) 
Seat 3: DeepMTPocket ($9.76 in chips) 
Seat 4: Duke323 ($7.10 in chips) 
Seat 5: LanskyBanksy ($14.71 in chips) 
Seat 6: PlayTheBlues4U ($12.83 in chips) 
LanskyBanksy: posts small blind $0.05
PlayTheBlues4U: posts big blind $0.10
*** HOLE CARDS ***
Dealt to PlayTheBlues4U [2c 2d]
xxzuluzuluxx: folds 
crazy turfer: folds 
DeepMTPocket: raises $0.15 to $0.25
Duke323: folds 
LanskyBanksy: folds 
PlayTheBlues4U: calls $0.15
*** FLOP *** [8d Th 5c]
PlayTheBlues4U: checks 
DeepMTPocket: bets $0.40
PlayTheBlues4U: folds 
Uncalled bet ($0.40) returned to DeepMTPocket
DeepMTPocket collected $0.52 from pot
DeepMTPocket: doesn't show hand 
*** SUMMARY ***
Total pot $0.55 | Rake $0.03 
Board [8d Th 5c]
Seat 1: xxzuluzuluxx folded before Flop (didn't bet)
Seat 2: crazy turfer folded before Flop (didn't bet)
Seat 3: DeepMTPocket collected ($0.52)
Seat 4: Duke323 (button) folded before Flop (didn't bet)
Seat 5: LanskyBanksy (small blind) folded before Flop
Seat 6: PlayTheBlues4U (big blind) folded on the Flop



PokerStars Hand #204645135492:  Hold'em No Limit ($0.05/$0.10 USD) - 2019/10/17 18:44:41 ET
Table 'Sappho' 6-max Seat #5 is the button
Seat 1: xxzuluzuluxx ($3.96 in chips) 
Seat 2: crazy turfer ($11.25 in chips) 
Seat 3: DeepMTPocket ($10.03 in chips) 
Seat 4: Duke323 ($7.10 in chips) 
Seat 5: LanskyBanksy ($14.66 in chips) 
Seat 6: PlayTheBlues4U ($12.58 in chips) 
PlayTheBlues4U: posts small blind $0.05
xxzuluzuluxx: posts big blind $0.10
*** HOLE CARDS ***
Dealt to PlayTheBlues4U [6h 9s]
crazy turfer: raises $0.20 to $0.30
DeepMTPocket: calls $0.30
Duke323: calls $0.30
LanskyBanksy: calls $0.30
PlayTheBlues4U: folds 
xxzuluzuluxx: calls $0.20
*** FLOP *** [3d Ah 8c]
xxzuluzuluxx: checks 
crazy turfer: bets $0.50
DeepMTPocket: folds 
Duke323: folds 
LanskyBanksy: calls $0.50
xxzuluzuluxx: calls $0.50
*** TURN *** [3d Ah 8c] [Ts]
xxzuluzuluxx: checks 
crazy turfer: bets $3
LanskyBanksy: calls $3
xxzuluzuluxx: folds 
*** RIVER *** [3d Ah 8c Ts] [2h]
crazy turfer: bets $7.45 and is all-in
LanskyBanksy: calls $7.45
*** SHOW DOWN ***
crazy turfer: shows [3c 3h] (three of a kind, Threes)
LanskyBanksy: shows [Kc Ad] (a pair of Aces)
crazy turfer collected $22.75 from pot
*** SUMMARY ***
Total pot $23.95 | Rake $1.20 
Board [3d Ah 8c Ts 2h]
Seat 1: xxzuluzuluxx (big blind) folded on the Turn
Seat 2: crazy turfer showed [3c 3h] and won ($22.75) with three of a kind, Threes
Seat 3: DeepMTPocket folded on the Flop
Seat 4: Duke323 folded on the Flop
Seat 5: LanskyBanksy (button) showed [Kc Ad] and lost with a pair of Aces
Seat 6: PlayTheBlues4U (small blind) folded before Flop



PokerStars Hand #204645135601:  Hold'em No Limit ($0.05/$0.10 USD) - 2019/10/17 18:45:31 ET
Table 'Sappho' 6-max Seat #6 is the button
Seat 1: xxzuluzuluxx ($3.16 in chips) 
Seat 2: crazy turfer ($22.75 in chips) 
Seat 3: DeepMTPocket ($9.73 in chips) 
Seat 4: Duke323 ($6.80 in chips) 
Seat 5: LanskyBanksy ($3.41 in chips) 
Seat 6: PlayTheBlues4U ($12.53 in chips) 
xxzuluzuluxx: posts small blind $0.05
crazy turfer: posts big blind $0.10
*** HOLE CARDS ***
Dealt to PlayTheBlues4U [3c 3d]
DeepMTPocket: folds 
Duke323: raises $0.20 to $0.30
LanskyBanksy: folds 
PlayTheBlues4U: calls $0.30
xxzuluzuluxx: folds 
crazy turfer: calls $0.20
*** FLOP *** [Qh 7d 2c]
crazy turfer: checks 
Duke323: bets $0.90
PlayTheBlues4U: folds 
crazy turfer: raises $21.55 to $22.45 and is all-in
Duke323: calls $5.60 and is all-in
Uncalled bet ($15.95) returned to crazy turfer
*** TURN *** [Qh 7d 2c] [6d]
*** RIVER *** [Qh 7d 2c 6d] [9c]
*** SHOW DOWN ***
crazy turfer: shows [Qs As] (a pair of Queens)
Duke323: shows [Qc Ks] (a pair of Queens - lower kicker)
crazy turfer collected $13.25 from pot
*** SUMMARY ***
Total pot $13.95 | Rake $0.70 
Board [Qh 7d 2c 6d 9c]
Seat 1: xxzuluzuluxx (small blind) folded before Flop
Seat 2: crazy turfer (big blind) showed [Qs As] and won ($13.25) with a pair of Queens
Seat 3: DeepMTPocket folded before Flop (didn't bet)
Seat 4: Duke323 showed [Qc Ks] and lost with a pair of Queens
Seat 5: LanskyBanksy folded before Flop (didn't bet)
Seat 6: PlayTheBlues4U (button) folded on the Flop



PokerStars Hand #204645135703:  Hold'em No Limit ($0.05/$0.10 USD) - 2019/10/17 18:46:17 ET
Table 'Sappho' 6-max Seat #1 is the button
Seat 1: xxzuluzuluxx ($3.11 in chips) 
Seat 2: crazy turfer ($29.20 in chips) 
Seat 3: DeepMTPocket ($9.73 in chips) 
Seat 5: LanskyBanksy ($3.41 in chips) 
Seat 6: PlayTheBlues4U ($12.23 in chips) 
crazy turfer: posts small blind $0.05
DeepMTPocket: posts big blind $0.10
*** HOLE CARDS ***
Dealt to PlayTheBlues4U [4h As]
LanskyBanksy: folds 
PlayTheBlues4U: folds 
xxzuluzuluxx: folds 
crazy turfer: calls $0.05
DeepMTPocket: checks 
*** FLOP *** [7c 7h 7s]
crazy turfer: bets $0.10
DeepMTPocket: folds 
Uncalled bet ($0.10) returned to crazy turfer
crazy turfer collected $0.19 from pot
*** SUMMARY ***
Total pot $0.20 | Rake $0.01 
Board [7c 7h 7s]
Seat 1: xxzuluzuluxx (button) folded before Flop (didn't bet)
Seat 2: crazy turfer (small blind) collected ($0.19)
Seat 3: DeepMTPocket (big blind) folded on the Flop
Seat 5: LanskyBanksy folded before Flop (didn't bet)
Seat 6: PlayTheBlues4U folded before Flop (didn't bet)



PokerStars Hand #204645135753:  Hold'em No Limit ($0.05/$0.10 USD) - 2019/10/17 18:46:37 ET
Table 'Sappho' 6-max Seat #2 is the button
Seat 1: xxzuluzuluxx ($3.11 in chips) 
Seat 2: crazy turfer ($29.29 in chips) 
Seat 3: DeepMTPocket ($9.63 in chips) 
Seat 5: LanskyBanksy ($10 in chips) 
Seat 6: PlayTheBlues4U ($12.23 in chips) 
DeepMTPocket: posts small blind $0.05
LanskyBanksy: posts big blind $0.10
*** HOLE CARDS ***
Dealt to PlayTheBlues4U [4s Ks]
PlayTheBlues4U: folds 
xxzuluzuluxx: calls $0.10
crazy turfer: folds 
DeepMTPocket: calls $0.05
Duke323 leaves the table
Ribeye63 joins the table at seat #4 
LanskyBanksy: checks 
*** FLOP *** [Js Kc 3d]
DeepMTPocket: checks 
LanskyBanksy: checks 
xxzuluzuluxx: checks 
*** TURN *** [Js Kc 3d] [Jd]
DeepMTPocket: checks 
LanskyBanksy: checks 
xxzuluzuluxx: checks 
*** RIVER *** [Js Kc 3d Jd] [Qh]
DeepMTPocket: checks 
LanskyBanksy: checks 
xxzuluzuluxx: checks 
*** SHOW DOWN ***
DeepMTPocket: shows [5d 8d] (a pair of Jacks)
LanskyBanksy: shows [2d Th] (a pair of Jacks - King+Queen+Ten kicker)
xxzuluzuluxx: shows [5s Ac] (a pair of Jacks - Ace kicker)
xxzuluzuluxx collected $0.28 from pot
*** SUMMARY ***
Total pot $0.30 | Rake $0.02 
Board [Js Kc 3d Jd Qh]
Seat 1: xxzuluzuluxx showed [5s Ac] and won ($0.28) with a pair of Jacks
Seat 2: crazy turfer (button) folded before Flop (didn't bet)
Seat 3: DeepMTPocket (small blind) showed [5d 8d] and lost with a pair of Jacks
Seat 5: LanskyBanksy (big blind) showed [2d Th] and lost with a pair of Jacks
Seat 6: PlayTheBlues4U folded before Flop (didn't bet)



PokerStars Hand #204645135869:  Hold'em No Limit ($0.05/$0.10 USD) - 2019/10/17 18:47:30 ET
Table 'Sappho' 6-max Seat #3 is the button
Seat 1: xxzuluzuluxx ($3.29 in chips) 
Seat 2: crazy turfer ($29.29 in chips) 
Seat 3: DeepMTPocket ($9.53 in chips) 
Seat 5: LanskyBanksy ($9.90 in chips) 
Seat 6: PlayTheBlues4U ($12.23 in chips) 
LanskyBanksy: posts small blind $0.05
PlayTheBlues4U: posts big blind $0.10
*** HOLE CARDS ***
Dealt to PlayTheBlues4U [4s 2d]
xxzuluzuluxx: calls $0.10
crazy turfer: folds 
DeepMTPocket: raises $0.20 to $0.30
LanskyBanksy: folds 
PlayTheBlues4U: folds 
xxzuluzuluxx: calls $0.20
*** FLOP *** [As 6c 6h]
xxzuluzuluxx: checks 
DeepMTPocket: bets $0.36
xxzuluzuluxx: folds 
Uncalled bet ($0.36) returned to DeepMTPocket
DeepMTPocket collected $0.71 from pot
DeepMTPocket: doesn't show hand 
*** SUMMARY ***
Total pot $0.75 | Rake $0.04 
Board [As 6c 6h]
Seat 1: xxzuluzuluxx folded on the Flop
Seat 2: crazy turfer folded before Flop (didn't bet)
Seat 3: DeepMTPocket (button) collected ($0.71)
Seat 5: LanskyBanksy (small blind) folded before Flop
Seat 6: PlayTheBlues4U (big blind) folded before Flop



PokerStars Hand #204645135923:  Hold'em No Limit ($0.05/$0.10 USD) - 2019/10/17 18:47:52 ET
Table 'Sappho' 6-max Seat #5 is the button
Seat 1: xxzuluzuluxx ($2.99 in chips) 
Seat 2: crazy turfer ($29.29 in chips) 
Seat 3: DeepMTPocket ($9.94 in chips) 
Seat 5: LanskyBanksy ($9.85 in chips) 
Seat 6: PlayTheBlues4U ($12.13 in chips) 
PlayTheBlues4U: posts small blind $0.05
xxzuluzuluxx: posts big blind $0.10
Ribeye63: sits out 
*** HOLE CARDS ***
Dealt to PlayTheBlues4U [Th 8s]
crazy turfer: calls $0.10
DeepMTPocket: folds 
LanskyBanksy: folds 
PlayTheBlues4U: folds 
xxzuluzuluxx: checks 
*** FLOP *** [9c Qd 4s]
xxzuluzuluxx: checks 
crazy turfer: checks 
*** TURN *** [9c Qd 4s] [Kd]
xxzuluzuluxx: checks 
crazy turfer: checks 
*** RIVER *** [9c Qd 4s Kd] [Qs]
xxzuluzuluxx: checks 
crazy turfer: checks 
*** SHOW DOWN ***
xxzuluzuluxx: shows [8h 5c] (a pair of Queens)
crazy turfer: shows [As 6c] (a pair of Queens - Ace kicker)
crazy turfer collected $0.24 from pot
*** SUMMARY ***
Total pot $0.25 | Rake $0.01 
Board [9c Qd 4s Kd Qs]
Seat 1: xxzuluzuluxx (big blind) showed [8h 5c] and lost with a pair of Queens
Seat 2: crazy turfer showed [As 6c] and won ($0.24) with a pair of Queens
Seat 3: DeepMTPocket folded before Flop (didn't bet)
Seat 5: LanskyBanksy (button) folded before Flop (didn't bet)
Seat 6: PlayTheBlues4U (small blind) folded before Flop



PokerStars Hand #204645135999:  Hold'em No Limit ($0.05/$0.10 USD) - 2019/10/17 18:48:23 ET
Table 'Sappho' 6-max Seat #6 is the button
Seat 1: xxzuluzuluxx ($2.89 in chips) 
Seat 2: crazy turfer ($29.43 in chips) 
Seat 3: DeepMTPocket ($9.94 in chips) 
Seat 5: LanskyBanksy ($9.85 in chips) 
Seat 6: PlayTheBlues4U ($12.08 in chips) 
xxzuluzuluxx: posts small blind $0.05
crazy turfer: posts big blind $0.10
Ribeye63: sits out 
*** HOLE CARDS ***
Dealt to PlayTheBlues4U [6c 5h]
DeepMTPocket: folds 
LanskyBanksy: folds 
PlayTheBlues4U: folds 
xxzuluzuluxx: calls $0.05
crazy turfer: checks 
*** FLOP *** [5s Jh Js]
xxzuluzuluxx: checks 
crazy turfer: checks 
*** TURN *** [5s Jh Js] [Qc]
xxzuluzuluxx: checks 
crazy turfer: checks 
*** RIVER *** [5s Jh Js Qc] [5c]
xxzuluzuluxx: checks 
crazy turfer: checks 
*** SHOW DOWN ***
xxzuluzuluxx: shows [Kh 8s] (two pair, Jacks and Fives)
crazy turfer: mucks hand 
xxzuluzuluxx collected $0.19 from pot
*** SUMMARY ***
Total pot $0.20 | Rake $0.01 
Board [5s Jh Js Qc 5c]
Seat 1: xxzuluzuluxx (small blind) showed [Kh 8s] and won ($0.19) with two pair, Jacks and Fives
Seat 2: crazy turfer (big blind) mucked [Tc 3d]
Seat 3: DeepMTPocket folded before Flop (didn't bet)
Seat 5: LanskyBanksy folded before Flop (didn't bet)
Seat 6: PlayTheBlues4U (button) folded before Flop (didn't bet)



PokerStars Hand #204645136072:  Hold'em No Limit ($0.05/$0.10 USD) - 2019/10/17 18:48:54 ET
Table 'Sappho' 6-max Seat #1 is the button
Seat 1: xxzuluzuluxx ($2.98 in chips) 
Seat 2: crazy turfer ($29.33 in chips) 
Seat 3: DeepMTPocket ($9.94 in chips) 
Seat 5: LanskyBanksy ($9.85 in chips) 
Seat 6: PlayTheBlues4U ($12.08 in chips) 
crazy turfer: posts small blind $0.05
DeepMTPocket: posts big blind $0.10
Ribeye63: sits out 
*** HOLE CARDS ***
Dealt to PlayTheBlues4U [Qd 2c]
LanskyBanksy: calls $0.10
PlayTheBlues4U: folds 
xxzuluzuluxx: folds 
crazy turfer: folds 
DeepMTPocket: checks 
*** FLOP *** [6c Qh 5s]
DeepMTPocket: checks 
LanskyBanksy: bets $0.10
DeepMTPocket: folds 
Uncalled bet ($0.10) returned to LanskyBanksy
LanskyBanksy collected $0.24 from pot
LanskyBanksy: doesn't show hand 
*** SUMMARY ***
Total pot $0.25 | Rake $0.01 
Board [6c Qh 5s]
Seat 1: xxzuluzuluxx (button) folded before Flop (didn't bet)
Seat 2: crazy turfer (small blind) folded before Flop
Seat 3: DeepMTPocket (big blind) folded on the Flop
Seat 5: LanskyBanksy collected ($0.24)
Seat 6: PlayTheBlues4U folded before Flop (didn't bet)



PokerStars Hand #204645136134:  Hold'em No Limit ($0.05/$0.10 USD) - 2019/10/17 18:49:23 ET
Table 'Sappho' 6-max Seat #2 is the button
Seat 1: xxzuluzuluxx ($2.98 in chips) 
Seat 2: crazy turfer ($29.28 in chips) 
Seat 3: DeepMTPocket ($9.84 in chips) 
Seat 4: Ribeye63 ($10 in chips) 
Seat 5: LanskyBanksy ($9.99 in chips) 
Seat 6: PlayTheBlues4U ($12.08 in chips) 
DeepMTPocket: posts small blind $0.05
Ribeye63: posts big blind $0.10
*** HOLE CARDS ***
Dealt to PlayTheBlues4U [Ts 7d]
LanskyBanksy: folds 
PlayTheBlues4U: folds 
xxzuluzuluxx: folds 
crazy turfer: folds 
DeepMTPocket: raises $0.20 to $0.30
Ribeye63: folds 
Uncalled bet ($0.20) returned to DeepMTPocket
DeepMTPocket collected $0.20 from pot
DeepMTPocket: doesn't show hand 
*** SUMMARY ***
Total pot $0.20 | Rake $0 
Seat 1: xxzuluzuluxx folded before Flop (didn't bet)
Seat 2: crazy turfer (button) folded before Flop (didn't bet)
Seat 3: DeepMTPocket (small blind) collected ($0.20)
Seat 4: Ribeye63 (big blind) folded before Flop
Seat 5: LanskyBanksy folded before Flop (didn't bet)
Seat 6: PlayTheBlues4U folded before Flop (didn't bet)



PokerStars Hand #204645136181:  Hold'em No Limit ($0.05/$0.10 USD) - 2019/10/17 18:49:45 ET
Table 'Sappho' 6-max Seat #3 is the button
Seat 1: xxzuluzuluxx ($2.98 in chips) 
Seat 2: crazy turfer ($29.28 in chips) 
Seat 3: DeepMTPocket ($9.94 in chips) 
Seat 4: Ribeye63 ($9.90 in chips) 
Seat 5: LanskyBanksy ($9.99 in chips) 
Seat 6: PlayTheBlues4U ($12.08 in chips) 
Ribeye63: posts small blind $0.05
LanskyBanksy: posts big blind $0.10
*** HOLE CARDS ***
Dealt to PlayTheBlues4U [6h 8d]
PlayTheBlues4U: folds 
xxzuluzuluxx: calls $0.10
crazy turfer: folds 
DeepMTPocket: folds 
Ribeye63: folds 
LanskyBanksy: checks 
*** FLOP *** [Kh 5d Js]
LanskyBanksy: checks 
xxzuluzuluxx: checks 
*** TURN *** [Kh 5d Js] [8s]
LanskyBanksy: checks 
xxzuluzuluxx: checks 
*** RIVER *** [Kh 5d Js 8s] [Th]
LanskyBanksy: checks 
xxzuluzuluxx: checks 
*** SHOW DOWN ***
LanskyBanksy: shows [Qd 2d] (high card King)
xxzuluzuluxx: shows [4h 4d] (a pair of Fours)
xxzuluzuluxx collected $0.24 from pot
*** SUMMARY ***
Total pot $0.25 | Rake $0.01 
Board [Kh 5d Js 8s Th]
Seat 1: xxzuluzuluxx showed [4h 4d] and won ($0.24) with a pair of Fours
Seat 2: crazy turfer folded before Flop (didn't bet)
Seat 3: DeepMTPocket (button) folded before Flop (didn't bet)
Seat 4: Ribeye63 (small blind) folded before Flop
Seat 5: LanskyBanksy (big blind) showed [Qd 2d] and lost with high card King
Seat 6: PlayTheBlues4U folded before Flop (didn't bet)



PokerStars Hand #204645136262:  Hold'em No Limit ($0.05/$0.10 USD) - 2019/10/17 18:50:21 ET
Table 'Sappho' 6-max Seat #4 is the button
Seat 1: xxzuluzuluxx ($3.12 in chips) 
Seat 2: crazy turfer ($29.28 in chips) 
Seat 3: DeepMTPocket ($9.94 in chips) 
Seat 4: Ribeye63 ($9.85 in chips) 
Seat 5: LanskyBanksy ($9.89 in chips) 
Seat 6: PlayTheBlues4U ($12.08 in chips) 
LanskyBanksy: posts small blind $0.05
PlayTheBlues4U: posts big blind $0.10
*** HOLE CARDS ***
Dealt to PlayTheBlues4U [Js Qh]
xxzuluzuluxx: calls $0.10
crazy turfer: folds 
DeepMTPocket: calls $0.10
Ribeye63: raises $0.20 to $0.30
LanskyBanksy: folds 
PlayTheBlues4U: calls $0.20
xxzuluzuluxx: calls $0.20
DeepMTPocket: calls $0.20
*** FLOP *** [5s 5c 9s]
PlayTheBlues4U: bets $0.70
xxzuluzuluxx: calls $0.70
DeepMTPocket: folds 
Ribeye63: folds 
*** TURN *** [5s 5c 9s] [7d]
PlayTheBlues4U: bets $1.50
xxzuluzuluxx: calls $1.50
*** RIVER *** [5s 5c 9s 7d] [8h]
PlayTheBlues4U: bets $5.37
xxzuluzuluxx: calls $0.62 and is all-in
Uncalled bet ($4.75) returned to PlayTheBlues4U
*** SHOW DOWN ***
PlayTheBlues4U: shows [Js Qh] (a pair of Fives)
xxzuluzuluxx: shows [5d Ac] (three of a kind, Fives)
xxzuluzuluxx collected $6.55 from pot
*** SUMMARY ***
Total pot $6.89 | Rake $0.34 
Board [5s 5c 9s 7d 8h]
Seat 1: xxzuluzuluxx showed [5d Ac] and won ($6.55) with three of a kind, Fives
Seat 2: crazy turfer folded before Flop (didn't bet)
Seat 3: DeepMTPocket folded on the Flop
Seat 4: Ribeye63 (button) folded on the Flop
Seat 5: LanskyBanksy (small blind) folded before Flop
Seat 6: PlayTheBlues4U (big blind) showed [Js Qh] and lost with a pair of Fives



PokerStars Hand #204645136401:  Hold'em No Limit ($0.05/$0.10 USD) - 2019/10/17 18:51:21 ET
Table 'Sappho' 6-max Seat #5 is the button
Seat 1: xxzuluzuluxx ($6.55 in chips) 
Seat 2: crazy turfer ($29.28 in chips) 
Seat 3: DeepMTPocket ($9.64 in chips) 
Seat 4: Ribeye63 ($9.55 in chips) 
Seat 5: LanskyBanksy ($9.84 in chips) 
Seat 6: PlayTheBlues4U ($8.96 in chips) 
PlayTheBlues4U: posts small blind $0.05
xxzuluzuluxx: posts big blind $0.10
*** HOLE CARDS ***
Dealt to PlayTheBlues4U [9c Td]
crazy turfer: calls $0.10
DeepMTPocket: folds 
PlayTheBlues4U said, "well i guess if you have it"
Ribeye63: folds 
LanskyBanksy: folds 
PlayTheBlues4U: calls $0.05
xxzuluzuluxx: checks 
*** FLOP *** [2c Jc 4c]
PlayTheBlues4U: checks 
xxzuluzuluxx: checks 
crazy turfer: bets $0.10
PlayTheBlues4U: folds 
xxzuluzuluxx: folds [4d]
Uncalled bet ($0.10) returned to crazy turfer
crazy turfer collected $0.28 from pot
*** SUMMARY ***
Total pot $0.30 | Rake $0.02 
Board [2c Jc 4c]
Seat 1: xxzuluzuluxx (big blind) folded on the Flop
Seat 2: crazy turfer collected ($0.28)
Seat 3: DeepMTPocket folded before Flop (didn't bet)
Seat 4: Ribeye63 folded before Flop (didn't bet)
Seat 5: LanskyBanksy (button) folded before Flop (didn't bet)
Seat 6: PlayTheBlues4U (small blind) folded on the Flop



PokerStars Hand #204645136465:  Hold'em No Limit ($0.05/$0.10 USD) - 2019/10/17 18:51:50 ET
Table 'Sappho' 6-max Seat #6 is the button
Seat 1: xxzuluzuluxx ($6.45 in chips) 
Seat 2: crazy turfer ($29.46 in chips) 
Seat 3: DeepMTPocket ($9.64 in chips) 
Seat 4: Ribeye63 ($9.55 in chips) 
Seat 5: LanskyBanksy ($9.84 in chips) 
Seat 6: PlayTheBlues4U ($8.86 in chips) 
xxzuluzuluxx: posts small blind $0.05
crazy turfer: posts big blind $0.10
*** HOLE CARDS ***
Dealt to PlayTheBlues4U [3d Ac]
DeepMTPocket: folds 
Ribeye63: folds 
LanskyBanksy: folds 
PlayTheBlues4U: raises $0.15 to $0.25
xxzuluzuluxx: folds 
crazy turfer: calls $0.15
*** FLOP *** [8h 3h 3c]
crazy turfer: checks 
PlayTheBlues4U: bets $0.40
crazy turfer: folds 
Uncalled bet ($0.40) returned to PlayTheBlues4U
PlayTheBlues4U collected $0.52 from pot
PlayTheBlues4U: doesn't show hand 
*** SUMMARY ***
Total pot $0.55 | Rake $0.03 
Board [8h 3h 3c]
Seat 1: xxzuluzuluxx (small blind) folded before Flop
Seat 2: crazy turfer (big blind) folded on the Flop
Seat 3: DeepMTPocket folded before Flop (didn't bet)
Seat 4: Ribeye63 folded before Flop (didn't bet)
Seat 5: LanskyBanksy folded before Flop (didn't bet)
Seat 6: PlayTheBlues4U (button) collected ($0.52)



PokerStars Hand #204645136552:  Hold'em No Limit ($0.05/$0.10 USD) - 2019/10/17 18:52:23 ET
Table 'Sappho' 6-max Seat #1 is the button
Seat 1: xxzuluzuluxx ($6.40 in chips) 
Seat 2: crazy turfer ($29.21 in chips) 
Seat 3: DeepMTPocket ($9.64 in chips) 
Seat 4: Ribeye63 ($9.55 in chips) 
Seat 5: LanskyBanksy ($9.84 in chips) 
Seat 6: PlayTheBlues4U ($9.13 in chips) 
crazy turfer: posts small blind $0.05
DeepMTPocket: posts big blind $0.10
*** HOLE CARDS ***
Dealt to PlayTheBlues4U [Jc 2s]
Ribeye63: folds 
LanskyBanksy: folds 
PlayTheBlues4U: folds 
xxzuluzuluxx: folds 
crazy turfer: raises $0.20 to $0.30
DeepMTPocket: folds 
Uncalled bet ($0.20) returned to crazy turfer
crazy turfer collected $0.20 from pot
*** SUMMARY ***
Total pot $0.20 | Rake $0 
Seat 1: xxzuluzuluxx (button) folded before Flop (didn't bet)
Seat 2: crazy turfer (small blind) collected ($0.20)
Seat 3: DeepMTPocket (big blind) folded before Flop
Seat 4: Ribeye63 folded before Flop (didn't bet)
Seat 5: LanskyBanksy folded before Flop (didn't bet)
Seat 6: PlayTheBlues4U folded before Flop (didn't bet)



PokerStars Hand #204645136591:  Hold'em No Limit ($0.05/$0.10 USD) - 2019/10/17 18:52:38 ET
Table 'Sappho' 6-max Seat #2 is the button
Seat 1: xxzuluzuluxx ($6.40 in chips) 
Seat 2: crazy turfer ($29.31 in chips) 
Seat 3: DeepMTPocket ($9.54 in chips) 
Seat 4: Ribeye63 ($9.55 in chips) 
Seat 5: LanskyBanksy ($9.84 in chips) 
Seat 6: PlayTheBlues4U ($9.13 in chips) 
DeepMTPocket: posts small blind $0.05
Ribeye63: posts big blind $0.10
*** HOLE CARDS ***
Dealt to PlayTheBlues4U [8d 6h]
LanskyBanksy: folds 
PlayTheBlues4U: folds 
xxzuluzuluxx: calls $0.10
crazy turfer: folds 
DeepMTPocket: calls $0.05
Ribeye63: checks 
*** FLOP *** [3d Qs 9d]
DeepMTPocket: bets $0.14
Ribeye63: folds 
xxzuluzuluxx: folds 
Uncalled bet ($0.14) returned to DeepMTPocket
DeepMTPocket collected $0.28 from pot
DeepMTPocket: doesn't show hand 
*** SUMMARY ***
Total pot $0.30 | Rake $0.02 
Board [3d Qs 9d]
Seat 1: xxzuluzuluxx folded on the Flop
Seat 2: crazy turfer (button) folded before Flop (didn't bet)
Seat 3: DeepMTPocket (small blind) collected ($0.28)
Seat 4: Ribeye63 (big blind) folded on the Flop
Seat 5: LanskyBanksy folded before Flop (didn't bet)
Seat 6: PlayTheBlues4U folded before Flop (didn't bet)



PokerStars Hand #204645136630:  Hold'em No Limit ($0.05/$0.10 USD) - 2019/10/17 18:52:52 ET
Table 'Sappho' 6-max Seat #3 is the button
Seat 1: xxzuluzuluxx ($6.30 in chips) 
Seat 2: crazy turfer ($29.31 in chips) 
Seat 3: DeepMTPocket ($9.72 in chips) 
Seat 4: Ribeye63 ($9.45 in chips) 
Seat 5: LanskyBanksy ($9.84 in chips) 
Seat 6: PlayTheBlues4U ($9.13 in chips) 
Ribeye63: posts small blind $0.05
LanskyBanksy: posts big blind $0.10
*** HOLE CARDS ***
Dealt to PlayTheBlues4U [2c 3h]
PlayTheBlues4U: folds 
xxzuluzuluxx: folds 
crazy turfer: folds 
DeepMTPocket: raises $0.15 to $0.25
Ribeye63: folds 
LanskyBanksy: folds 
Uncalled bet ($0.15) returned to DeepMTPocket
DeepMTPocket collected $0.25 from pot
DeepMTPocket: doesn't show hand 
*** SUMMARY ***
Total pot $0.25 | Rake $0 
Seat 1: xxzuluzuluxx folded before Flop (didn't bet)
Seat 2: crazy turfer folded before Flop (didn't bet)
Seat 3: DeepMTPocket (button) collected ($0.25)
Seat 4: Ribeye63 (small blind) folded before Flop
Seat 5: LanskyBanksy (big blind) folded before Flop
Seat 6: PlayTheBlues4U folded before Flop (didn't bet)



PokerStars Hand #204645136686:  Hold'em No Limit ($0.05/$0.10 USD) - 2019/10/17 18:53:15 ET
Table 'Sappho' 6-max Seat #4 is the button
Seat 1: xxzuluzuluxx ($6.30 in chips) 
Seat 2: crazy turfer ($29.31 in chips) 
Seat 3: DeepMTPocket ($9.87 in chips) 
Seat 4: Ribeye63 ($9.40 in chips) 
Seat 5: LanskyBanksy ($9.74 in chips) 
Seat 6: PlayTheBlues4U ($9.13 in chips) 
LanskyBanksy: posts small blind $0.05
PlayTheBlues4U: posts big blind $0.10
*** HOLE CARDS ***
Dealt to PlayTheBlues4U [Ks 9s]
xxzuluzuluxx: calls $0.10
crazy turfer: calls $0.10
DeepMTPocket: folds 
Ribeye63: raises $0.40 to $0.50
LanskyBanksy: folds 
PlayTheBlues4U: folds 
xxzuluzuluxx: calls $0.40
crazy turfer: calls $0.40
*** FLOP *** [Kd 8s 2s]
xxzuluzuluxx: checks 
crazy turfer: checks 
Ribeye63: bets $0.80
xxzuluzuluxx: calls $0.80
crazy turfer: folds 
*** TURN *** [Kd 8s 2s] [As]
xxzuluzuluxx: checks 
Ribeye63: bets $1.55
xxzuluzuluxx: calls $1.55
*** RIVER *** [Kd 8s 2s As] [Kc]
xxzuluzuluxx: checks 
Ribeye63: checks 
*** SHOW DOWN ***
xxzuluzuluxx: shows [7h 7s] (two pair, Kings and Sevens)
Ribeye63: shows [5h Ah] (two pair, Aces and Kings)
Ribeye63 collected $6.03 from pot
*** SUMMARY ***
Total pot $6.35 | Rake $0.32 
Board [Kd 8s 2s As Kc]
Seat 1: xxzuluzuluxx showed [7h 7s] and lost with two pair, Kings and Sevens
Seat 2: crazy turfer folded on the Flop
Seat 3: DeepMTPocket folded before Flop (didn't bet)
Seat 4: Ribeye63 (button) showed [5h Ah] and won ($6.03) with two pair, Aces and Kings
Seat 5: LanskyBanksy (small blind) folded before Flop
Seat 6: PlayTheBlues4U (big blind) folded before Flop



PokerStars Hand #204645136837:  Hold'em No Limit ($0.05/$0.10 USD) - 2019/10/17 18:54:16 ET
Table 'Sappho' 6-max Seat #5 is the button
Seat 2: crazy turfer ($28.81 in chips) 
Seat 3: DeepMTPocket ($9.87 in chips) 
Seat 4: Ribeye63 ($12.58 in chips) 
Seat 5: LanskyBanksy ($9.69 in chips) 
Seat 6: PlayTheBlues4U ($9.03 in chips) 
PlayTheBlues4U: posts small blind $0.05
crazy turfer: posts big blind $0.10
*** HOLE CARDS ***
Dealt to PlayTheBlues4U [4h 4d]
DeepMTPocket: folds 
Ribeye63: folds 
LanskyBanksy: folds 
PlayTheBlues4U: raises $0.20 to $0.30
crazy turfer: folds 
Uncalled bet ($0.20) returned to PlayTheBlues4U
PlayTheBlues4U collected $0.20 from pot
PlayTheBlues4U: doesn't show hand 
*** SUMMARY ***
Total pot $0.20 | Rake $0 
Seat 2: crazy turfer (big blind) folded before Flop
Seat 3: DeepMTPocket folded before Flop (didn't bet)
Seat 4: Ribeye63 folded before Flop (didn't bet)
Seat 5: LanskyBanksy (button) folded before Flop (didn't bet)
Seat 6: PlayTheBlues4U (small blind) collected ($0.20)



PokerStars Hand #204645136940:  Hold'em No Limit ($0.05/$0.10 USD) - 2019/10/17 18:54:59 ET
Table 'Sappho' 6-max Seat #6 is the button
Seat 2: crazy turfer ($28.71 in chips) 
Seat 3: DeepMTPocket ($9.87 in chips) 
Seat 4: Ribeye63 ($12.58 in chips) 
Seat 5: LanskyBanksy ($9.69 in chips) 
Seat 6: PlayTheBlues4U ($9.13 in chips) 
crazy turfer: posts small blind $0.05
DeepMTPocket: posts big blind $0.10
*** HOLE CARDS ***
Dealt to PlayTheBlues4U [Kh 4d]
Ribeye63: folds 
LanskyBanksy: folds 
PlayTheBlues4U: raises $0.20 to $0.30
crazy turfer: folds 
DeepMTPocket: folds 
Uncalled bet ($0.20) returned to PlayTheBlues4U
PlayTheBlues4U collected $0.25 from pot
PlayTheBlues4U: doesn't show hand 
*** SUMMARY ***
Total pot $0.25 | Rake $0 
Seat 2: crazy turfer (small blind) folded before Flop
Seat 3: DeepMTPocket (big blind) folded before Flop
Seat 4: Ribeye63 folded before Flop (didn't bet)
Seat 5: LanskyBanksy folded before Flop (didn't bet)
Seat 6: PlayTheBlues4U (button) collected ($0.25)



PokerStars Hand #204645137025:  Hold'em No Limit ($0.05/$0.10 USD) - 2019/10/17 18:55:32 ET
Table 'Sappho' 6-max Seat #2 is the button
Seat 2: crazy turfer ($28.66 in chips) 
Seat 3: DeepMTPocket ($9.77 in chips) 
Seat 4: Ribeye63 ($12.58 in chips) 
Seat 5: LanskyBanksy ($9.69 in chips) 
Seat 6: PlayTheBlues4U ($9.28 in chips) 
DeepMTPocket: posts small blind $0.05
Ribeye63: posts big blind $0.10
*** HOLE CARDS ***
Dealt to PlayTheBlues4U [Ks 4d]
LanskyBanksy: raises $0.20 to $0.30
PlayTheBlues4U: folds 
crazy turfer: folds 
DeepMTPocket: folds 
Ribeye63: calls $0.20
*** FLOP *** [3c Qd Jd]
Ribeye63: checks 
LanskyBanksy: bets $0.20
Ribeye63: calls $0.20
*** TURN *** [3c Qd Jd] [2d]
Ribeye63: checks 
LanskyBanksy: bets $0.20
Ribeye63: calls $0.20
*** RIVER *** [3c Qd Jd 2d] [6h]
Ribeye63: checks 
LanskyBanksy: bets $0.20
Ribeye63: calls $0.20
*** SHOW DOWN ***
LanskyBanksy: shows [Ah Kc] (high card Ace)
Ribeye63: shows [9d 9s] (a pair of Nines)
Ribeye63 collected $1.76 from pot
*** SUMMARY ***
Total pot $1.85 | Rake $0.09 
Board [3c Qd Jd 2d 6h]
Seat 2: crazy turfer (button) folded before Flop (didn't bet)
Seat 3: DeepMTPocket (small blind) folded before Flop
Seat 4: Ribeye63 (big blind) showed [9d 9s] and won ($1.76) with a pair of Nines
Seat 5: LanskyBanksy showed [Ah Kc] and lost with high card Ace
Seat 6: PlayTheBlues4U folded before Flop (didn't bet)



PokerStars Hand #204645137097:  Hold'em No Limit ($0.05/$0.10 USD) - 2019/10/17 18:56:06 ET
Table 'Sappho' 6-max Seat #3 is the button
Seat 2: crazy turfer ($28.66 in chips) 
Seat 3: DeepMTPocket ($9.72 in chips) 
Seat 4: Ribeye63 ($13.44 in chips) 
Seat 5: LanskyBanksy ($8.79 in chips) 
Seat 6: PlayTheBlues4U ($9.28 in chips) 
Ribeye63: posts small blind $0.05
LanskyBanksy: posts big blind $0.10
*** HOLE CARDS ***
Dealt to PlayTheBlues4U [Ks 8h]
PlayTheBlues4U: folds 
crazy turfer: calls $0.10
DeepMTPocket: raises $0.20 to $0.30
Ribeye63: folds 
LanskyBanksy: folds 
crazy turfer: calls $0.20
*** FLOP *** [4h Js 8s]
crazy turfer: checks 
DeepMTPocket: bets $0.71
crazy turfer: folds 
Uncalled bet ($0.71) returned to DeepMTPocket
DeepMTPocket collected $0.71 from pot
DeepMTPocket: doesn't show hand 
*** SUMMARY ***
Total pot $0.75 | Rake $0.04 
Board [4h Js 8s]
Seat 2: crazy turfer folded on the Flop
Seat 3: DeepMTPocket (button) collected ($0.71)
Seat 4: Ribeye63 (small blind) folded before Flop
Seat 5: LanskyBanksy (big blind) folded before Flop
Seat 6: PlayTheBlues4U folded before Flop (didn't bet)



PokerStars Hand #204645137150:  Hold'em No Limit ($0.05/$0.10 USD) - 2019/10/17 18:56:33 ET
Table 'Sappho' 6-max Seat #4 is the button
Seat 2: crazy turfer ($28.36 in chips) 
Seat 3: DeepMTPocket ($10.13 in chips) 
Seat 4: Ribeye63 ($13.39 in chips) 
Seat 5: LanskyBanksy ($8.69 in chips) 
Seat 6: PlayTheBlues4U ($9.28 in chips) 
LanskyBanksy: posts small blind $0.05
PlayTheBlues4U: posts big blind $0.10
*** HOLE CARDS ***
Dealt to PlayTheBlues4U [5s Jd]
crazy turfer: folds 
DeepMTPocket: folds 
Ribeye63: raises $0.10 to $0.20
LanskyBanksy: folds 
PlayTheBlues4U: folds 
Uncalled bet ($0.10) returned to Ribeye63
Ribeye63 collected $0.25 from pot
Ribeye63: doesn't show hand 
*** SUMMARY ***
Total pot $0.25 | Rake $0 
Seat 2: crazy turfer folded before Flop (didn't bet)
Seat 3: DeepMTPocket folded before Flop (didn't bet)
Seat 4: Ribeye63 (button) collected ($0.25)
Seat 5: LanskyBanksy (small blind) folded before Flop
Seat 6: PlayTheBlues4U (big blind) folded before Flop



PokerStars Hand #204645137202:  Hold'em No Limit ($0.05/$0.10 USD) - 2019/10/17 18:56:52 ET
Table 'Sappho' 6-max Seat #5 is the button
Seat 2: crazy turfer ($28.36 in chips) 
Seat 3: DeepMTPocket ($10.13 in chips) 
Seat 4: Ribeye63 ($13.54 in chips) 
Seat 5: LanskyBanksy ($8.64 in chips) 
Seat 6: PlayTheBlues4U ($9.18 in chips) 
PlayTheBlues4U: posts small blind $0.05
crazy turfer: posts big blind $0.10
*** HOLE CARDS ***
Dealt to PlayTheBlues4U [3d 4s]
DeepMTPocket: folds 
Ribeye63: raises $0.20 to $0.30
LanskyBanksy: folds 
PlayTheBlues4U: folds 
crazy turfer: calls $0.20
*** FLOP *** [Tc 7c 6d]
crazy turfer: checks 
Ribeye63: bets $0.31
crazy turfer: calls $0.31
*** TURN *** [Tc 7c 6d] [2h]
crazy turfer: checks 
Ribeye63: checks 
*** RIVER *** [Tc 7c 6d 2h] [Kc]
crazy turfer: bets $0.60
Ribeye63: folds 
Uncalled bet ($0.60) returned to crazy turfer
crazy turfer collected $1.21 from pot
*** SUMMARY ***
Total pot $1.27 | Rake $0.06 
Board [Tc 7c 6d 2h Kc]
Seat 2: crazy turfer (big blind) collected ($1.21)
Seat 3: DeepMTPocket folded before Flop (didn't bet)
Seat 4: Ribeye63 folded on the River
Seat 5: LanskyBanksy (button) folded before Flop (didn't bet)
Seat 6: PlayTheBlues4U (small blind) folded before Flop



PokerStars Hand #204645137296:  Hold'em No Limit ($0.05/$0.10 USD) - 2019/10/17 18:57:26 ET
Table 'Sappho' 6-max Seat #6 is the button
Seat 2: crazy turfer ($28.96 in chips) 
Seat 3: DeepMTPocket ($10.13 in chips) 
Seat 4: Ribeye63 ($12.93 in chips) 
Seat 5: LanskyBanksy ($8.64 in chips) 
Seat 6: PlayTheBlues4U ($9.13 in chips) 
crazy turfer: posts small blind $0.05
DeepMTPocket: posts big blind $0.10
*** HOLE CARDS ***
Dealt to PlayTheBlues4U [6s Qh]
Ribeye63: folds 
LanskyBanksy: folds 
PlayTheBlues4U: raises $0.20 to $0.30
crazy turfer: calls $0.25
DeepMTPocket: folds 
*** FLOP *** [7c 4h 7s]
crazy turfer: checks 
PlayTheBlues4U: bets $0.40
crazy turfer: folds 
Uncalled bet ($0.40) returned to PlayTheBlues4U
PlayTheBlues4U collected $0.66 from pot
PlayTheBlues4U: doesn't show hand 
*** SUMMARY ***
Total pot $0.70 | Rake $0.04 
Board [7c 4h 7s]
Seat 2: crazy turfer (small blind) folded on the Flop
Seat 3: DeepMTPocket (big blind) folded before Flop
Seat 4: Ribeye63 folded before Flop (didn't bet)
Seat 5: LanskyBanksy folded before Flop (didn't bet)
Seat 6: PlayTheBlues4U (button) collected ($0.66)



PokerStars Hand #204645137385:  Hold'em No Limit ($0.05/$0.10 USD) - 2019/10/17 18:57:57 ET
Table 'Sappho' 6-max Seat #2 is the button
Seat 2: crazy turfer ($28.66 in chips) 
Seat 3: DeepMTPocket ($10.03 in chips) 
Seat 4: Ribeye63 ($12.93 in chips) 
Seat 5: LanskyBanksy ($8.64 in chips) 
Seat 6: PlayTheBlues4U ($9.49 in chips) 
DeepMTPocket: posts small blind $0.05
Ribeye63: posts big blind $0.10
*** HOLE CARDS ***
Dealt to PlayTheBlues4U [2h 8c]
LanskyBanksy has timed out
LanskyBanksy: folds 
PlayTheBlues4U: folds 
crazy turfer: calls $0.10
DeepMTPocket: folds 
Ribeye63: checks 
*** FLOP *** [3c 6d Ac]
Ribeye63: checks 
crazy turfer: checks 
*** TURN *** [3c 6d Ac] [3d]
Ribeye63: checks 
crazy turfer: checks 
*** RIVER *** [3c 6d Ac 3d] [Kh]
Ribeye63: checks 
crazy turfer: checks 
*** SHOW DOWN ***
Ribeye63: shows [Jh 5c] (a pair of Threes)
crazy turfer: mucks hand 
Ribeye63 collected $0.24 from pot
*** SUMMARY ***
Total pot $0.25 | Rake $0.01 
Board [3c 6d Ac 3d Kh]
Seat 2: crazy turfer (button) mucked [Th 4h]
Seat 3: DeepMTPocket (small blind) folded before Flop
Seat 4: Ribeye63 (big blind) showed [Jh 5c] and won ($0.24) with a pair of Threes
Seat 5: LanskyBanksy folded before Flop (didn't bet)
Seat 6: PlayTheBlues4U folded before Flop (didn't bet)



PokerStars Hand #204645137507:  Hold'em No Limit ($0.05/$0.10 USD) - 2019/10/17 18:58:37 ET
Table 'Sappho' 6-max Seat #3 is the button
Seat 2: crazy turfer ($28.56 in chips) 
Seat 3: DeepMTPocket ($9.98 in chips) 
Seat 4: Ribeye63 ($13.07 in chips) 
Seat 6: PlayTheBlues4U ($9.49 in chips) 
Ribeye63: posts small blind $0.05
PlayTheBlues4U: posts big blind $0.10
*** HOLE CARDS ***
Dealt to PlayTheBlues4U [3c Ks]
crazy turfer: folds 
DeepMTPocket: raises $0.15 to $0.25
Ribeye63: calls $0.20
PlayTheBlues4U: folds 
*** FLOP *** [4c Js 3d]
Ribeye63: checks 
DeepMTPocket: bets $0.30
Ribeye63: folds 
Uncalled bet ($0.30) returned to DeepMTPocket
DeepMTPocket collected $0.57 from pot
DeepMTPocket: doesn't show hand 
*** SUMMARY ***
Total pot $0.60 | Rake $0.03 
Board [4c Js 3d]
Seat 2: crazy turfer folded before Flop (didn't bet)
Seat 3: DeepMTPocket (button) collected ($0.57)
Seat 4: Ribeye63 (small blind) folded on the Flop
Seat 6: PlayTheBlues4U (big blind) folded before Flop



PokerStars Hand #204645137575:  Hold'em No Limit ($0.05/$0.10 USD) - 2019/10/17 18:59:00 ET
Table 'Sappho' 6-max Seat #4 is the button
Seat 2: crazy turfer ($28.56 in chips) 
Seat 3: DeepMTPocket ($10.30 in chips) 
Seat 4: Ribeye63 ($12.82 in chips) 
Seat 6: PlayTheBlues4U ($9.39 in chips) 
PlayTheBlues4U: posts small blind $0.05
crazy turfer: posts big blind $0.10
*** HOLE CARDS ***
Dealt to PlayTheBlues4U [9h 6s]
DeepMTPocket: folds 
Ribeye63: raises $0.20 to $0.30
PlayTheBlues4U: folds 
crazy turfer: calls $0.20
*** FLOP *** [Js 8c Ad]
crazy turfer: checks 
Ribeye63: checks 
*** TURN *** [Js 8c Ad] [Ts]
crazy turfer: checks 
Ribeye63: bets $0.47
crazy turfer: calls $0.47
*** RIVER *** [Js 8c Ad Ts] [6d]
crazy turfer: checks 
Ribeye63: checks 
*** SHOW DOWN ***
crazy turfer: shows [5s 7s] (high card Ace)
Ribeye63: shows [As 3s] (a pair of Aces)
Ribeye63 collected $1.51 from pot
*** SUMMARY ***
Total pot $1.59 | Rake $0.08 
Board [Js 8c Ad Ts 6d]
Seat 2: crazy turfer (big blind) showed [5s 7s] and lost with high card Ace
Seat 3: DeepMTPocket folded before Flop (didn't bet)
Seat 4: Ribeye63 (button) showed [As 3s] and won ($1.51) with a pair of Aces
Seat 6: PlayTheBlues4U (small blind) folded before Flop



PokerStars Hand #204645137650:  Hold'em No Limit ($0.05/$0.10 USD) - 2019/10/17 18:59:30 ET
Table 'Sappho' 6-max Seat #6 is the button
Seat 2: crazy turfer ($27.79 in chips) 
Seat 3: DeepMTPocket ($10.30 in chips) 
Seat 4: Ribeye63 ($13.56 in chips) 
Seat 6: PlayTheBlues4U ($9.34 in chips) 
crazy turfer: posts small blind $0.05
DeepMTPocket: posts big blind $0.10
*** HOLE CARDS ***
Dealt to PlayTheBlues4U [3d Jh]
Ribeye63: folds 
PlayTheBlues4U: folds 
crazy turfer: raises $0.20 to $0.30
DeepMTPocket: folds 
Uncalled bet ($0.20) returned to crazy turfer
crazy turfer collected $0.20 from pot
*** SUMMARY ***
Total pot $0.20 | Rake $0 
Seat 2: crazy turfer (small blind) collected ($0.20)
Seat 3: DeepMTPocket (big blind) folded before Flop
Seat 4: Ribeye63 folded before Flop (didn't bet)
Seat 6: PlayTheBlues4U (button) folded before Flop (didn't bet)



PokerStars Hand #204645137696:  Hold'em No Limit ($0.05/$0.10 USD) - 2019/10/17 18:59:50 ET
Table 'Sappho' 6-max Seat #2 is the button
Seat 2: crazy turfer ($27.89 in chips) 
Seat 3: DeepMTPocket ($10.20 in chips) 
Seat 4: Ribeye63 ($13.56 in chips) 
Seat 6: PlayTheBlues4U ($9.34 in chips) 
DeepMTPocket: posts small blind $0.05
Ribeye63: posts big blind $0.10
*** HOLE CARDS ***
Dealt to PlayTheBlues4U [4c Js]
PlayTheBlues4U: folds 
crazy turfer: raises $0.10 to $0.20
DeepMTPocket: folds 
Ribeye63: folds 
Uncalled bet ($0.10) returned to crazy turfer
crazy turfer collected $0.25 from pot
*** SUMMARY ***
Total pot $0.25 | Rake $0 
Seat 2: crazy turfer (button) collected ($0.25)
Seat 3: DeepMTPocket (small blind) folded before Flop
Seat 4: Ribeye63 (big blind) folded before Flop
Seat 6: PlayTheBlues4U folded before Flop (didn't bet)



PokerStars Hand #204645137720:  Hold'em No Limit ($0.05/$0.10 USD) - 2019/10/17 19:00:00 ET
Table 'Sappho' 6-max Seat #3 is the button
Seat 2: crazy turfer ($28.04 in chips) 
Seat 3: DeepMTPocket ($10.15 in chips) 
Seat 4: Ribeye63 ($13.46 in chips) 
Seat 6: PlayTheBlues4U ($9.34 in chips) 
Ribeye63: posts small blind $0.05
PlayTheBlues4U: posts big blind $0.10
*** HOLE CARDS ***
Dealt to PlayTheBlues4U [2s 2d]
crazy turfer: raises $0.10 to $0.20
DeepMTPocket: folds 
Ribeye63: folds 
PlayTheBlues4U: calls $0.10
*** FLOP *** [8s Kh 7s]
PlayTheBlues4U: checks 
crazy turfer: bets $0.40
PlayTheBlues4U: folds 
Uncalled bet ($0.40) returned to crazy turfer
crazy turfer collected $0.43 from pot
*** SUMMARY ***
Total pot $0.45 | Rake $0.02 
Board [8s Kh 7s]
Seat 2: crazy turfer collected ($0.43)
Seat 3: DeepMTPocket (button) folded before Flop (didn't bet)
Seat 4: Ribeye63 (small blind) folded before Flop
Seat 6: PlayTheBlues4U (big blind) folded on the Flop



PokerStars Hand #204645137783:  Hold'em No Limit ($0.05/$0.10 USD) - 2019/10/17 19:00:21 ET
Table 'Sappho' 6-max Seat #4 is the button
Seat 1: xxzuluzuluxx ($3.45 in chips) 
Seat 2: crazy turfer ($28.27 in chips) 
Seat 3: DeepMTPocket ($10.15 in chips) 
Seat 4: Ribeye63 ($13.41 in chips) 
Seat 6: PlayTheBlues4U ($9.14 in chips) 
PlayTheBlues4U: posts small blind $0.05
xxzuluzuluxx: posts big blind $0.10
*** HOLE CARDS ***
Dealt to PlayTheBlues4U [Ac 4d]
crazy turfer: folds 
DeepMTPocket: folds 
Ribeye63: folds 
PlayTheBlues4U: raises $0.20 to $0.30
xxzuluzuluxx: calls $0.20
*** FLOP *** [Ad 2d Th]
PlayTheBlues4U: bets $0.40
xxzuluzuluxx: calls $0.40
*** TURN *** [Ad 2d Th] [Ks]
PlayTheBlues4U: bets $0.90
xxzuluzuluxx: calls $0.90
*** RIVER *** [Ad 2d Th Ks] [Kc]
PlayTheBlues4U: bets $7.54 and is all-in
xxzuluzuluxx: folds 
Uncalled bet ($7.54) returned to PlayTheBlues4U
PlayTheBlues4U collected $3.04 from pot
PlayTheBlues4U: doesn't show hand 
*** SUMMARY ***
Total pot $3.20 | Rake $0.16 
Board [Ad 2d Th Ks Kc]
Seat 1: xxzuluzuluxx (big blind) folded on the River
Seat 2: crazy turfer folded before Flop (didn't bet)
Seat 3: DeepMTPocket folded before Flop (didn't bet)
Seat 4: Ribeye63 (button) folded before Flop (didn't bet)
Seat 6: PlayTheBlues4U (small blind) collected ($3.04)



PokerStars Hand #204645137886:  Hold'em No Limit ($0.05/$0.10 USD) - 2019/10/17 19:01:01 ET
Table 'Sappho' 6-max Seat #6 is the button
Seat 1: xxzuluzuluxx ($1.85 in chips) 
Seat 2: crazy turfer ($28.27 in chips) 
Seat 3: DeepMTPocket ($10.15 in chips) 
Seat 4: Ribeye63 ($13.41 in chips) 
Seat 6: PlayTheBlues4U ($10.58 in chips) 
xxzuluzuluxx: posts small blind $0.05
crazy turfer: posts big blind $0.10
*** HOLE CARDS ***
Dealt to PlayTheBlues4U [7h Js]
DeepMTPocket: folds 
Ribeye63: folds 
PlayTheBlues4U: folds 
xxzuluzuluxx: calls $0.05
crazy turfer: raises $0.20 to $0.30
xxzuluzuluxx: calls $0.20
*** FLOP *** [Qd Jd Tc]
xxzuluzuluxx: checks 
crazy turfer: checks 
*** TURN *** [Qd Jd Tc] [Ac]
xxzuluzuluxx: checks 
crazy turfer: bets $0.20
xxzuluzuluxx: folds 
Uncalled bet ($0.20) returned to crazy turfer
crazy turfer collected $0.57 from pot
*** SUMMARY ***
Total pot $0.60 | Rake $0.03 
Board [Qd Jd Tc Ac]
Seat 1: xxzuluzuluxx (small blind) folded on the Turn
Seat 2: crazy turfer (big blind) collected ($0.57)
Seat 3: DeepMTPocket folded before Flop (didn't bet)
Seat 4: Ribeye63 folded before Flop (didn't bet)
Seat 6: PlayTheBlues4U (button) folded before Flop (didn't bet)



PokerStars Hand #204645137990:  Hold'em No Limit ($0.05/$0.10 USD) - 2019/10/17 19:01:37 ET
Table 'Sappho' 6-max Seat #1 is the button
Seat 1: xxzuluzuluxx ($1.55 in chips) 
Seat 2: crazy turfer ($28.54 in chips) 
Seat 3: DeepMTPocket ($10.15 in chips) 
Seat 4: Ribeye63 ($13.41 in chips) 
Seat 6: PlayTheBlues4U ($10.58 in chips) 
crazy turfer: posts small blind $0.05
DeepMTPocket: posts big blind $0.10
*** HOLE CARDS ***
Dealt to PlayTheBlues4U [9c Ah]
Ribeye63: folds 
PlayTheBlues4U: folds 
xxzuluzuluxx: folds 
crazy turfer: folds 
Uncalled bet ($0.05) returned to DeepMTPocket
DeepMTPocket collected $0.10 from pot
DeepMTPocket: doesn't show hand 
*** SUMMARY ***
Total pot $0.10 | Rake $0 
Seat 1: xxzuluzuluxx (button) folded before Flop (didn't bet)
Seat 2: crazy turfer (small blind) folded before Flop
Seat 3: DeepMTPocket (big blind) collected ($0.10)
Seat 4: Ribeye63 folded before Flop (didn't bet)
Seat 6: PlayTheBlues4U folded before Flop (didn't bet)



PokerStars Hand #204645138027:  Hold'em No Limit ($0.05/$0.10 USD) - 2019/10/17 19:01:48 ET
Table 'Sappho' 6-max Seat #2 is the button
Seat 1: xxzuluzuluxx ($1.55 in chips) 
Seat 2: crazy turfer ($28.49 in chips) 
Seat 3: DeepMTPocket ($10.20 in chips) 
Seat 4: Ribeye63 ($13.41 in chips) 
Seat 6: PlayTheBlues4U ($10.58 in chips) 
DeepMTPocket: posts small blind $0.05
Ribeye63: posts big blind $0.10
*** HOLE CARDS ***
Dealt to PlayTheBlues4U [Ah Jc]
PlayTheBlues4U: raises $0.20 to $0.30
xxzuluzuluxx: folds 
crazy turfer: folds 
DeepMTPocket: folds 
Ribeye63: folds 
Uncalled bet ($0.20) returned to PlayTheBlues4U
PlayTheBlues4U collected $0.25 from pot
PlayTheBlues4U: doesn't show hand 
*** SUMMARY ***
Total pot $0.25 | Rake $0 
Seat 1: xxzuluzuluxx folded before Flop (didn't bet)
Seat 2: crazy turfer (button) folded before Flop (didn't bet)
Seat 3: DeepMTPocket (small blind) folded before Flop
Seat 4: Ribeye63 (big blind) folded before Flop
Seat 6: PlayTheBlues4U collected ($0.25)



PokerStars Hand #204645138054:  Hold'em No Limit ($0.05/$0.10 USD) - 2019/10/17 19:01:59 ET
Table 'Sappho' 6-max Seat #3 is the button
Seat 1: xxzuluzuluxx ($1.55 in chips) 
Seat 2: crazy turfer ($28.49 in chips) 
Seat 3: DeepMTPocket ($10.15 in chips) 
Seat 4: Ribeye63 ($13.31 in chips) 
Seat 6: PlayTheBlues4U ($10.73 in chips) 
Ribeye63: posts small blind $0.05
PlayTheBlues4U: posts big blind $0.10
*** HOLE CARDS ***
Dealt to PlayTheBlues4U [4c Kc]
xxzuluzuluxx: calls $0.10
crazy turfer: raises $0.20 to $0.30
DeepMTPocket: folds 
Ribeye63: calls $0.25
PlayTheBlues4U: folds 
xxzuluzuluxx: calls $0.20
*** FLOP *** [4d Qs 2h]
Ribeye63: checks 
xxzuluzuluxx: checks 
crazy turfer: bets $0.90
Ribeye63: folds 
xxzuluzuluxx: raises $0.35 to $1.25 and is all-in
crazy turfer: calls $0.35
*** TURN *** [4d Qs 2h] [5h]
*** RIVER *** [4d Qs 2h 5h] [3h]
*** SHOW DOWN ***
xxzuluzuluxx: shows [Js Qd] (a pair of Queens)
crazy turfer: shows [Ks Kd] (a pair of Kings)
crazy turfer collected $3.32 from pot
*** SUMMARY ***
Total pot $3.50 | Rake $0.18 
Board [4d Qs 2h 5h 3h]
Seat 1: xxzuluzuluxx showed [Js Qd] and lost with a pair of Queens
Seat 2: crazy turfer showed [Ks Kd] and won ($3.32) with a pair of Kings
Seat 3: DeepMTPocket (button) folded before Flop (didn't bet)
Seat 4: Ribeye63 (small blind) folded on the Flop
Seat 6: PlayTheBlues4U (big blind) folded before Flop



PokerStars Hand #204645138145:  Hold'em No Limit ($0.05/$0.10 USD) - 2019/10/17 19:02:36 ET
Table 'Sappho' 6-max Seat #4 is the button
Seat 2: crazy turfer ($30.26 in chips) 
Seat 3: DeepMTPocket ($10.15 in chips) 
Seat 4: Ribeye63 ($13.01 in chips) 
Seat 6: PlayTheBlues4U ($10.63 in chips) 
PlayTheBlues4U: posts small blind $0.05
crazy turfer: posts big blind $0.10
*** HOLE CARDS ***
Dealt to PlayTheBlues4U [7d 2d]
DeepMTPocket: raises $0.15 to $0.25
Ribeye63: folds 
PlayTheBlues4U: folds 
crazy turfer: calls $0.15
*** FLOP *** [6d 3h 5s]
crazy turfer: checks 
DeepMTPocket: checks 
*** TURN *** [6d 3h 5s] [Jd]
crazy turfer: checks 
DeepMTPocket: bets $0.35
crazy turfer: folds 
Uncalled bet ($0.35) returned to DeepMTPocket
DeepMTPocket collected $0.52 from pot
DeepMTPocket: doesn't show hand 
*** SUMMARY ***
Total pot $0.55 | Rake $0.03 
Board [6d 3h 5s Jd]
Seat 2: crazy turfer (big blind) folded on the Turn
Seat 3: DeepMTPocket collected ($0.52)
Seat 4: Ribeye63 (button) folded before Flop (didn't bet)
Seat 6: PlayTheBlues4U (small blind) folded before Flop



PokerStars Hand #204645138222:  Hold'em No Limit ($0.05/$0.10 USD) - 2019/10/17 19:03:02 ET
Table 'Sappho' 6-max Seat #6 is the button
Seat 2: crazy turfer ($30.01 in chips) 
Seat 3: DeepMTPocket ($10.42 in chips) 
Seat 4: Ribeye63 ($13.01 in chips) 
Seat 6: PlayTheBlues4U ($10.58 in chips) 
crazy turfer: posts small blind $0.05
DeepMTPocket: posts big blind $0.10
*** HOLE CARDS ***
Dealt to PlayTheBlues4U [5d 6h]
Ribeye63: folds 
PlayTheBlues4U: raises $0.20 to $0.30
crazy turfer: folds 
DeepMTPocket: folds 
Uncalled bet ($0.20) returned to PlayTheBlues4U
PlayTheBlues4U collected $0.25 from pot
PlayTheBlues4U: doesn't show hand 
*** SUMMARY ***
Total pot $0.25 | Rake $0 
Seat 2: crazy turfer (small blind) folded before Flop
Seat 3: DeepMTPocket (big blind) folded before Flop
Seat 4: Ribeye63 folded before Flop (didn't bet)
Seat 6: PlayTheBlues4U (button) collected ($0.25)



PokerStars Hand #204645138260:  Hold'em No Limit ($0.05/$0.10 USD) - 2019/10/17 19:03:18 ET
Table 'Sappho' 6-max Seat #2 is the button
Seat 1: xxzuluzuluxx ($4 in chips) 
Seat 2: crazy turfer ($29.96 in chips) 
Seat 3: DeepMTPocket ($10.32 in chips) 
Seat 4: Ribeye63 ($13.01 in chips) 
Seat 6: PlayTheBlues4U ($10.73 in chips) 
DeepMTPocket: posts small blind $0.05
Ribeye63: posts big blind $0.10
xxzuluzuluxx: posts small & big blinds $0.15
*** HOLE CARDS ***
Dealt to PlayTheBlues4U [7s 3h]
PlayTheBlues4U: folds 
xxzuluzuluxx: checks 
crazy turfer: folds 
DeepMTPocket: folds 
Ribeye63: checks 
*** FLOP *** [Jc Ac Qs]
Ribeye63: checks 
xxzuluzuluxx: bets $0.28
Ribeye63: folds 
Uncalled bet ($0.28) returned to xxzuluzuluxx
xxzuluzuluxx collected $0.28 from pot
xxzuluzuluxx: doesn't show hand 
*** SUMMARY ***
Total pot $0.30 | Rake $0.02 
Board [Jc Ac Qs]
Seat 1: xxzuluzuluxx collected ($0.28)
Seat 2: crazy turfer (button) folded before Flop (didn't bet)
Seat 3: DeepMTPocket (small blind) folded before Flop
Seat 4: Ribeye63 (big blind) folded on the Flop
Seat 6: PlayTheBlues4U folded before Flop (didn't bet)



PokerStars Hand #204645138312:  Hold'em No Limit ($0.05/$0.10 USD) - 2019/10/17 19:03:39 ET
Table 'Sappho' 6-max Seat #3 is the button
Seat 1: xxzuluzuluxx ($4.13 in chips) 
Seat 2: crazy turfer ($29.96 in chips) 
Seat 3: DeepMTPocket ($10.27 in chips) 
Seat 4: Ribeye63 ($12.91 in chips) 
Seat 6: PlayTheBlues4U ($10.73 in chips) 
Ribeye63: posts small blind $0.05
PlayTheBlues4U: posts big blind $0.10
*** HOLE CARDS ***
Dealt to PlayTheBlues4U [Ts Jh]
xxzuluzuluxx: folds 
crazy turfer: folds 
DeepMTPocket: raises $0.15 to $0.25
Ribeye63: folds 
PlayTheBlues4U: calls $0.15
*** FLOP *** [8h 8d Kd]
PlayTheBlues4U: checks 
DeepMTPocket: bets $0.26
PlayTheBlues4U: folds 
Uncalled bet ($0.26) returned to DeepMTPocket
DeepMTPocket collected $0.52 from pot
LanskyBanksy leaves the table
DeepMTPocket: doesn't show hand 
*** SUMMARY ***
Total pot $0.55 | Rake $0.03 
Board [8h 8d Kd]
Seat 1: xxzuluzuluxx folded before Flop (didn't bet)
Seat 2: crazy turfer folded before Flop (didn't bet)
Seat 3: DeepMTPocket (button) collected ($0.52)
Seat 4: Ribeye63 (small blind) folded before Flop
Seat 6: PlayTheBlues4U (big blind) folded on the Flop



PokerStars Hand #204645138378:  Hold'em No Limit ($0.05/$0.10 USD) - 2019/10/17 19:04:07 ET
Table 'Sappho' 6-max Seat #4 is the button
Seat 1: xxzuluzuluxx ($4.13 in chips) 
Seat 2: crazy turfer ($29.96 in chips) 
Seat 3: DeepMTPocket ($10.54 in chips) 
Seat 4: Ribeye63 ($12.86 in chips) 
Seat 6: PlayTheBlues4U ($10.48 in chips) 
PlayTheBlues4U: posts small blind $0.05
xxzuluzuluxx: posts big blind $0.10
*** HOLE CARDS ***
Dealt to PlayTheBlues4U [2d Ah]
EddieMoney9 joins the table at seat #5 
crazy turfer: calls $0.10
DeepMTPocket: folds 
Ribeye63: raises $0.30 to $0.40
PlayTheBlues4U: folds 
xxzuluzuluxx: folds 
crazy turfer: folds 
Uncalled bet ($0.30) returned to Ribeye63
Ribeye63 collected $0.35 from pot
Ribeye63: doesn't show hand 
*** SUMMARY ***
Total pot $0.35 | Rake $0 
Seat 1: xxzuluzuluxx (big blind) folded before Flop
Seat 2: crazy turfer folded before Flop
Seat 3: DeepMTPocket folded before Flop (didn't bet)
Seat 4: Ribeye63 (button) collected ($0.35)
Seat 6: PlayTheBlues4U (small blind) folded before Flop



PokerStars Hand #204645138418:  Hold'em No Limit ($0.05/$0.10 USD) - 2019/10/17 19:04:24 ET
Table 'Sappho' 6-max Seat #6 is the button
Seat 1: xxzuluzuluxx ($4.03 in chips) 
Seat 2: crazy turfer ($29.86 in chips) 
Seat 3: DeepMTPocket ($10.54 in chips) 
Seat 4: Ribeye63 ($13.11 in chips) 
Seat 6: PlayTheBlues4U ($10.43 in chips) 
xxzuluzuluxx: posts small blind $0.05
crazy turfer: posts big blind $0.10
EddieMoney9: sits out 
*** HOLE CARDS ***
Dealt to PlayTheBlues4U [7s 4h]
DeepMTPocket: folds 
Ribeye63: folds 
PlayTheBlues4U: folds 
xxzuluzuluxx: folds 
Uncalled bet ($0.05) returned to crazy turfer
crazy turfer collected $0.10 from pot
*** SUMMARY ***
Total pot $0.10 | Rake $0 
Seat 1: xxzuluzuluxx (small blind) folded before Flop
Seat 2: crazy turfer (big blind) collected ($0.10)
Seat 3: DeepMTPocket folded before Flop (didn't bet)
Seat 4: Ribeye63 folded before Flop (didn't bet)
Seat 6: PlayTheBlues4U (button) folded before Flop (didn't bet)



PokerStars Hand #204645138465:  Hold'em No Limit ($0.05/$0.10 USD) - 2019/10/17 19:04:45 ET
Table 'Sappho' 6-max Seat #1 is the button
Seat 1: xxzuluzuluxx ($3.98 in chips) 
Seat 2: crazy turfer ($29.91 in chips) 
Seat 3: DeepMTPocket ($10.54 in chips) 
Seat 4: Ribeye63 ($13.11 in chips) 
Seat 6: PlayTheBlues4U ($10.43 in chips) 
crazy turfer: posts small blind $0.05
DeepMTPocket: posts big blind $0.10
EddieMoney9: sits out 
*** HOLE CARDS ***
Dealt to PlayTheBlues4U [7s Qs]
Ribeye63: raises $0.20 to $0.30
PlayTheBlues4U: folds 
xxzuluzuluxx: folds 
crazy turfer: folds 
DeepMTPocket: folds 
Uncalled bet ($0.20) returned to Ribeye63
Ribeye63 collected $0.25 from pot
Ribeye63: doesn't show hand 
*** SUMMARY ***
Total pot $0.25 | Rake $0 
Seat 1: xxzuluzuluxx (button) folded before Flop (didn't bet)
Seat 2: crazy turfer (small blind) folded before Flop
Seat 3: DeepMTPocket (big blind) folded before Flop
Seat 4: Ribeye63 collected ($0.25)
Seat 6: PlayTheBlues4U folded before Flop (didn't bet)



PokerStars Hand #204645138499:  Hold'em No Limit ($0.05/$0.10 USD) - 2019/10/17 19:04:58 ET
Table 'Sappho' 6-max Seat #2 is the button
Seat 1: xxzuluzuluxx ($3.98 in chips) 
Seat 2: crazy turfer ($29.86 in chips) 
Seat 3: DeepMTPocket ($10.44 in chips) 
Seat 4: Ribeye63 ($13.26 in chips) 
Seat 6: PlayTheBlues4U ($10.43 in chips) 
DeepMTPocket: posts small blind $0.05
Ribeye63: posts big blind $0.10
EddieMoney9: sits out 
*** HOLE CARDS ***
Dealt to PlayTheBlues4U [8h 9s]
PlayTheBlues4U: folds 
xxzuluzuluxx: calls $0.10
crazy turfer: calls $0.10
DeepMTPocket: folds 
Ribeye63: checks 
*** FLOP *** [7s As 2c]
Ribeye63: checks 
xxzuluzuluxx: checks 
crazy turfer: checks 
*** TURN *** [7s As 2c] [6c]
Ribeye63: bets $0.17
xxzuluzuluxx: folds 
crazy turfer: calls $0.17
*** RIVER *** [7s As 2c 6c] [4d]
Ribeye63: checks 
crazy turfer: checks 
*** SHOW DOWN ***
Ribeye63: shows [Jd Ac] (a pair of Aces)
crazy turfer: mucks hand 
Ribeye63 collected $0.66 from pot
*** SUMMARY ***
Total pot $0.69 | Rake $0.03 
Board [7s As 2c 6c 4d]
Seat 1: xxzuluzuluxx folded on the Turn
Seat 2: crazy turfer (button) mucked [6d 3c]
Seat 3: DeepMTPocket (small blind) folded before Flop
Seat 4: Ribeye63 (big blind) showed [Jd Ac] and won ($0.66) with a pair of Aces
Seat 6: PlayTheBlues4U folded before Flop (didn't bet)



PokerStars Hand #204645138588:  Hold'em No Limit ($0.05/$0.10 USD) - 2019/10/17 19:05:33 ET
Table 'Sappho' 6-max Seat #3 is the button
Seat 1: xxzuluzuluxx ($3.88 in chips) 
Seat 2: crazy turfer ($29.59 in chips) 
Seat 3: DeepMTPocket ($10.39 in chips) 
Seat 4: Ribeye63 ($13.65 in chips) 
Seat 5: EddieMoney9 ($10 in chips) 
Seat 6: PlayTheBlues4U ($10.43 in chips) 
Ribeye63: posts small blind $0.05
EddieMoney9: posts big blind $0.10
*** HOLE CARDS ***
Dealt to PlayTheBlues4U [3h Qs]
PlayTheBlues4U: folds 
xxzuluzuluxx: folds 
crazy turfer: folds 
DeepMTPocket: folds 
Ribeye63: folds 
Uncalled bet ($0.05) returned to EddieMoney9
EddieMoney9 collected $0.10 from pot
EddieMoney9: doesn't show hand 
*** SUMMARY ***
Total pot $0.10 | Rake $0 
Seat 1: xxzuluzuluxx folded before Flop (didn't bet)
Seat 2: crazy turfer folded before Flop (didn't bet)
Seat 3: DeepMTPocket (button) folded before Flop (didn't bet)
Seat 4: Ribeye63 (small blind) folded before Flop
Seat 5: EddieMoney9 (big blind) collected ($0.10)
Seat 6: PlayTheBlues4U folded before Flop (didn't bet)



PokerStars Hand #204645138614:  Hold'em No Limit ($0.05/$0.10 USD) - 2019/10/17 19:05:44 ET
Table 'Sappho' 6-max Seat #4 is the button
Seat 1: xxzuluzuluxx ($3.88 in chips) 
Seat 2: crazy turfer ($29.59 in chips) 
Seat 3: DeepMTPocket ($10.39 in chips) 
Seat 4: Ribeye63 ($13.60 in chips) 
Seat 5: EddieMoney9 ($10.05 in chips) 
Seat 6: PlayTheBlues4U ($10.43 in chips) 
EddieMoney9: posts small blind $0.05
PlayTheBlues4U: posts big blind $0.10
*** HOLE CARDS ***
Dealt to PlayTheBlues4U [5c 2h]
xxzuluzuluxx: folds 
crazy turfer: folds 
DeepMTPocket: folds 
Ribeye63: folds 
EddieMoney9: folds 
Uncalled bet ($0.05) returned to PlayTheBlues4U
PlayTheBlues4U collected $0.10 from pot
PlayTheBlues4U: doesn't show hand 
*** SUMMARY ***
Total pot $0.10 | Rake $0 
Seat 1: xxzuluzuluxx folded before Flop (didn't bet)
Seat 2: crazy turfer folded before Flop (didn't bet)
Seat 3: DeepMTPocket folded before Flop (didn't bet)
Seat 4: Ribeye63 (button) folded before Flop (didn't bet)
Seat 5: EddieMoney9 (small blind) folded before Flop
Seat 6: PlayTheBlues4U (big blind) collected ($0.10)



PokerStars Hand #204645138649:  Hold'em No Limit ($0.05/$0.10 USD) - 2019/10/17 19:05:59 ET
Table 'Sappho' 6-max Seat #5 is the button
Seat 1: xxzuluzuluxx ($3.88 in chips) 
Seat 2: crazy turfer ($29.59 in chips) 
Seat 3: DeepMTPocket ($10.39 in chips) 
Seat 4: Ribeye63 ($13.60 in chips) 
Seat 5: EddieMoney9 ($10 in chips) 
Seat 6: PlayTheBlues4U ($10.48 in chips) 
PlayTheBlues4U: posts small blind $0.05
xxzuluzuluxx: posts big blind $0.10
*** HOLE CARDS ***
Dealt to PlayTheBlues4U [8s 2c]
crazy turfer: folds 
DeepMTPocket: folds 
Ribeye63: raises $0.20 to $0.30
EddieMoney9: folds 
PlayTheBlues4U: folds 
xxzuluzuluxx: calls $0.20
*** FLOP *** [Js 3s 8d]
xxzuluzuluxx: checks 
Ribeye63: bets $0.31
xxzuluzuluxx: calls $0.31
*** TURN *** [Js 3s 8d] [2s]
xxzuluzuluxx: checks 
Ribeye63: bets $0.60
xxzuluzuluxx: calls $0.60
*** RIVER *** [Js 3s 8d 2s] [7c]
xxzuluzuluxx: checks 
Ribeye63: bets $1.76
xxzuluzuluxx: folds 
Uncalled bet ($1.76) returned to Ribeye63
Ribeye63 collected $2.35 from pot
Ribeye63: doesn't show hand 
*** SUMMARY ***
Total pot $2.47 | Rake $0.12 
Board [Js 3s 8d 2s 7c]
Seat 1: xxzuluzuluxx (big blind) folded on the River
Seat 2: crazy turfer folded before Flop (didn't bet)
Seat 3: DeepMTPocket folded before Flop (didn't bet)
Seat 4: Ribeye63 collected ($2.35)
Seat 5: EddieMoney9 (button) folded before Flop (didn't bet)
Seat 6: PlayTheBlues4U (small blind) folded before Flop



PokerStars Hand #204645138755:  Hold'em No Limit ($0.05/$0.10 USD) - 2019/10/17 19:06:41 ET
Table 'Sappho' 6-max Seat #6 is the button
Seat 1: xxzuluzuluxx ($2.67 in chips) 
Seat 2: crazy turfer ($29.59 in chips) 
Seat 3: DeepMTPocket ($10.39 in chips) 
Seat 4: Ribeye63 ($14.74 in chips) 
Seat 5: EddieMoney9 ($10 in chips) 
Seat 6: PlayTheBlues4U ($10.43 in chips) 
xxzuluzuluxx: posts small blind $0.05
crazy turfer: posts big blind $0.10
*** HOLE CARDS ***
Dealt to PlayTheBlues4U [6c Ad]
DeepMTPocket: raises $0.15 to $0.25
Ribeye63: calls $0.25
EddieMoney9: folds 
PlayTheBlues4U: folds 
xxzuluzuluxx: folds 
crazy turfer: folds 
*** FLOP *** [Ah 8s Kc]
DeepMTPocket: bets $0.31
Ribeye63: folds 
Uncalled bet ($0.31) returned to DeepMTPocket
DeepMTPocket collected $0.62 from pot
DeepMTPocket: doesn't show hand 
*** SUMMARY ***
Total pot $0.65 | Rake $0.03 
Board [Ah 8s Kc]
Seat 1: xxzuluzuluxx (small blind) folded before Flop
Seat 2: crazy turfer (big blind) folded before Flop
Seat 3: DeepMTPocket collected ($0.62)
Seat 4: Ribeye63 folded on the Flop
Seat 5: EddieMoney9 folded before Flop (didn't bet)
Seat 6: PlayTheBlues4U (button) folded before Flop (didn't bet)



PokerStars Hand #204645138815:  Hold'em No Limit ($0.05/$0.10 USD) - 2019/10/17 19:07:05 ET
Table 'Sappho' 6-max Seat #1 is the button
Seat 1: xxzuluzuluxx ($2.62 in chips) 
Seat 2: crazy turfer ($29.49 in chips) 
Seat 3: DeepMTPocket ($10.76 in chips) 
Seat 4: Ribeye63 ($14.49 in chips) 
Seat 5: EddieMoney9 ($10 in chips) 
Seat 6: PlayTheBlues4U ($10.43 in chips) 
crazy turfer: posts small blind $0.05
DeepMTPocket: posts big blind $0.10
*** HOLE CARDS ***
Dealt to PlayTheBlues4U [Kc Qh]
Ribeye63: calls $0.10
EddieMoney9: folds 
PlayTheBlues4U has timed out
PlayTheBlues4U: folds 
xxzuluzuluxx: folds 
crazy turfer: folds 
DeepMTPocket: checks 
*** FLOP *** [Jh Ad 6h]
DeepMTPocket: checks 
Ribeye63: checks 
*** TURN *** [Jh Ad 6h] [7h]
DeepMTPocket: checks 
Ribeye63: checks 
*** RIVER *** [Jh Ad 6h 7h] [8c]
DeepMTPocket: checks 
Ribeye63: checks 
*** SHOW DOWN ***
DeepMTPocket: shows [8s 9d] (a pair of Eights)
Ribeye63: shows [Jd Td] (a pair of Jacks)
Ribeye63 collected $0.24 from pot
*** SUMMARY ***
Total pot $0.25 | Rake $0.01 
Board [Jh Ad 6h 7h 8c]
Seat 1: xxzuluzuluxx (button) folded before Flop (didn't bet)
Seat 2: crazy turfer (small blind) folded before Flop
Seat 3: DeepMTPocket (big blind) showed [8s 9d] and lost with a pair of Eights
Seat 4: Ribeye63 showed [Jd Td] and won ($0.24) with a pair of Jacks
Seat 5: EddieMoney9 folded before Flop (didn't bet)
Seat 6: PlayTheBlues4U folded before Flop (didn't bet)



PokerStars Hand #204645138930:  Hold'em No Limit ($0.05/$0.10 USD) - 2019/10/17 19:07:49 ET
Table 'Sappho' 6-max Seat #2 is the button
Seat 1: xxzuluzuluxx ($2.62 in chips) 
Seat 2: crazy turfer ($29.44 in chips) 
Seat 3: DeepMTPocket ($10.66 in chips) 
Seat 4: Ribeye63 ($14.63 in chips) 
Seat 5: EddieMoney9 ($10 in chips) 
Seat 6: PlayTheBlues4U ($10.43 in chips) 
DeepMTPocket: posts small blind $0.05
Ribeye63: posts big blind $0.10
*** HOLE CARDS ***
Dealt to PlayTheBlues4U [2c 6c]
EddieMoney9: folds 
PlayTheBlues4U: folds 
xxzuluzuluxx: folds 
crazy turfer: folds 
DeepMTPocket: folds 
Uncalled bet ($0.05) returned to Ribeye63
Ribeye63 collected $0.10 from pot
Ribeye63: doesn't show hand 
*** SUMMARY ***
Total pot $0.10 | Rake $0 
Seat 1: xxzuluzuluxx folded before Flop (didn't bet)
Seat 2: crazy turfer (button) folded before Flop (didn't bet)
Seat 3: DeepMTPocket (small blind) folded before Flop
Seat 4: Ribeye63 (big blind) collected ($0.10)
Seat 5: EddieMoney9 folded before Flop (didn't bet)
Seat 6: PlayTheBlues4U folded before Flop (didn't bet)



PokerStars Hand #204645138962:  Hold'em No Limit ($0.05/$0.10 USD) - 2019/10/17 19:08:00 ET
Table 'Sappho' 6-max Seat #3 is the button
Seat 1: xxzuluzuluxx ($2.62 in chips) 
Seat 2: crazy turfer ($29.44 in chips) 
Seat 3: DeepMTPocket ($10.61 in chips) 
Seat 4: Ribeye63 ($14.68 in chips) 
Seat 5: EddieMoney9 ($10 in chips) 
Seat 6: PlayTheBlues4U ($10.43 in chips) 
Ribeye63: posts small blind $0.05
EddieMoney9: posts big blind $0.10
*** HOLE CARDS ***
Dealt to PlayTheBlues4U [4c Qh]
PlayTheBlues4U: folds 
xxzuluzuluxx: calls $0.10
crazy turfer: calls $0.10
DeepMTPocket: raises $0.50 to $0.60
Ribeye63: folds 
EddieMoney9: calls $0.50
xxzuluzuluxx: calls $0.50
crazy turfer: folds 
*** FLOP *** [5c 3h 6d]
EddieMoney9: checks 
xxzuluzuluxx: checks 
DeepMTPocket: bets $1.90
EddieMoney9: folds 
xxzuluzuluxx: folds [2s]
Uncalled bet ($1.90) returned to DeepMTPocket
DeepMTPocket collected $1.85 from pot
DeepMTPocket: doesn't show hand 
*** SUMMARY ***
Total pot $1.95 | Rake $0.10 
Board [5c 3h 6d]
Seat 1: xxzuluzuluxx folded on the Flop
Seat 2: crazy turfer folded before Flop
Seat 3: DeepMTPocket (button) collected ($1.85)
Seat 4: Ribeye63 (small blind) folded before Flop
Seat 5: EddieMoney9 (big blind) folded on the Flop
Seat 6: PlayTheBlues4U folded before Flop (didn't bet)



PokerStars Hand #204645139072:  Hold'em No Limit ($0.05/$0.10 USD) - 2019/10/17 19:08:42 ET
Table 'Sappho' 6-max Seat #4 is the button
Seat 1: xxzuluzuluxx ($2.02 in chips) 
Seat 2: crazy turfer ($29.34 in chips) 
Seat 3: DeepMTPocket ($11.86 in chips) 
Seat 4: Ribeye63 ($14.63 in chips) 
Seat 5: EddieMoney9 ($9.40 in chips) 
Seat 6: PlayTheBlues4U ($10.43 in chips) 
EddieMoney9: posts small blind $0.05
PlayTheBlues4U: posts big blind $0.10
*** HOLE CARDS ***
Dealt to PlayTheBlues4U [3h 9d]
xxzuluzuluxx: folds 
crazy turfer: calls $0.10
DeepMTPocket: folds 
Ribeye63: raises $0.30 to $0.40
EddieMoney9: folds 
PlayTheBlues4U: folds 
crazy turfer: calls $0.30
*** FLOP *** [5s Ts Jd]
crazy turfer: checks 
Ribeye63: bets $0.40
crazy turfer: folds 
Uncalled bet ($0.40) returned to Ribeye63
Ribeye63 collected $0.90 from pot
Ribeye63: doesn't show hand 
*** SUMMARY ***
Total pot $0.95 | Rake $0.05 
Board [5s Ts Jd]
Seat 1: xxzuluzuluxx folded before Flop (didn't bet)
Seat 2: crazy turfer folded on the Flop
Seat 3: DeepMTPocket folded before Flop (didn't bet)
Seat 4: Ribeye63 (button) collected ($0.90)
Seat 5: EddieMoney9 (small blind) folded before Flop
Seat 6: PlayTheBlues4U (big blind) folded before Flop



PokerStars Hand #204645139156:  Hold'em No Limit ($0.05/$0.10 USD) - 2019/10/17 19:09:12 ET
Table 'Sappho' 6-max Seat #5 is the button
Seat 1: xxzuluzuluxx ($2.02 in chips) 
Seat 2: crazy turfer ($28.94 in chips) 
Seat 3: DeepMTPocket ($11.86 in chips) 
Seat 4: Ribeye63 ($15.13 in chips) 
Seat 5: EddieMoney9 ($10 in chips) 
Seat 6: PlayTheBlues4U ($10.33 in chips) 
PlayTheBlues4U: posts small blind $0.05
xxzuluzuluxx: posts big blind $0.10
*** HOLE CARDS ***
Dealt to PlayTheBlues4U [Qd Kh]
crazy turfer: raises $0.10 to $0.20
DeepMTPocket: folds 
Ribeye63: folds 
EddieMoney9: folds 
PlayTheBlues4U: calls $0.15
xxzuluzuluxx: calls $0.10
*** FLOP *** [Td 9d 5d]
PlayTheBlues4U: checks 
xxzuluzuluxx: checks 
crazy turfer: checks 
*** TURN *** [Td 9d 5d] [Ks]
PlayTheBlues4U: bets $0.40
xxzuluzuluxx: folds 
crazy turfer: folds 
Uncalled bet ($0.40) returned to PlayTheBlues4U
PlayTheBlues4U collected $0.57 from pot
PlayTheBlues4U: doesn't show hand 
*** SUMMARY ***
Total pot $0.60 | Rake $0.03 
Board [Td 9d 5d Ks]
Seat 1: xxzuluzuluxx (big blind) folded on the Turn
Seat 2: crazy turfer folded on the Turn
Seat 3: DeepMTPocket folded before Flop (didn't bet)
Seat 4: Ribeye63 folded before Flop (didn't bet)
Seat 5: EddieMoney9 (button) folded before Flop (didn't bet)
Seat 6: PlayTheBlues4U (small blind) collected ($0.57)



PokerStars Hand #204645139242:  Hold'em No Limit ($0.05/$0.10 USD) - 2019/10/17 19:09:41 ET
Table 'Sappho' 6-max Seat #6 is the button
Seat 1: xxzuluzuluxx ($1.82 in chips) 
Seat 2: crazy turfer ($28.74 in chips) 
Seat 3: DeepMTPocket ($11.86 in chips) 
Seat 4: Ribeye63 ($15.13 in chips) 
Seat 5: EddieMoney9 ($10 in chips) 
Seat 6: PlayTheBlues4U ($10.70 in chips) 
xxzuluzuluxx: posts small blind $0.05
crazy turfer: posts big blind $0.10
*** HOLE CARDS ***
Dealt to PlayTheBlues4U [9h 7h]
DeepMTPocket: folds 
Ribeye63: folds 
EddieMoney9: folds 
PlayTheBlues4U: raises $0.20 to $0.30
xxzuluzuluxx: folds 
crazy turfer: folds 
Uncalled bet ($0.20) returned to PlayTheBlues4U
PlayTheBlues4U collected $0.25 from pot
PlayTheBlues4U: doesn't show hand 
*** SUMMARY ***
Total pot $0.25 | Rake $0 
Seat 1: xxzuluzuluxx (small blind) folded before Flop
Seat 2: crazy turfer (big blind) folded before Flop
Seat 3: DeepMTPocket folded before Flop (didn't bet)
Seat 4: Ribeye63 folded before Flop (didn't bet)
Seat 5: EddieMoney9 folded before Flop (didn't bet)
Seat 6: PlayTheBlues4U (button) collected ($0.25)



PokerStars Hand #204645139273:  Hold'em No Limit ($0.05/$0.10 USD) - 2019/10/17 19:09:54 ET
Table 'Sappho' 6-max Seat #1 is the button
Seat 1: xxzuluzuluxx ($1.77 in chips) 
Seat 2: crazy turfer ($28.64 in chips) 
Seat 3: DeepMTPocket ($11.86 in chips) 
Seat 4: Ribeye63 ($15.13 in chips) 
Seat 5: EddieMoney9 ($10 in chips) 
Seat 6: PlayTheBlues4U ($10.85 in chips) 
crazy turfer: posts small blind $0.05
DeepMTPocket: posts big blind $0.10
*** HOLE CARDS ***
Dealt to PlayTheBlues4U [Js Th]
Ribeye63: folds 
EddieMoney9: folds 
PlayTheBlues4U: raises $0.20 to $0.30
xxzuluzuluxx: folds 
crazy turfer: folds 
DeepMTPocket: folds 
Uncalled bet ($0.20) returned to PlayTheBlues4U
PlayTheBlues4U collected $0.25 from pot
PlayTheBlues4U: doesn't show hand 
*** SUMMARY ***
Total pot $0.25 | Rake $0 
Seat 1: xxzuluzuluxx (button) folded before Flop (didn't bet)
Seat 2: crazy turfer (small blind) folded before Flop
Seat 3: DeepMTPocket (big blind) folded before Flop
Seat 4: Ribeye63 folded before Flop (didn't bet)
Seat 5: EddieMoney9 folded before Flop (didn't bet)
Seat 6: PlayTheBlues4U collected ($0.25)



PokerStars Hand #204645139319:  Hold'em No Limit ($0.05/$0.10 USD) - 2019/10/17 19:10:11 ET
Table 'Sappho' 6-max Seat #2 is the button
Seat 1: xxzuluzuluxx ($1.77 in chips) 
Seat 2: crazy turfer ($28.59 in chips) 
Seat 3: DeepMTPocket ($11.76 in chips) 
Seat 4: Ribeye63 ($15.13 in chips) 
Seat 5: EddieMoney9 ($10 in chips) 
Seat 6: PlayTheBlues4U ($11 in chips) 
DeepMTPocket: posts small blind $0.05
Ribeye63: posts big blind $0.10
*** HOLE CARDS ***
Dealt to PlayTheBlues4U [Kc 5s]
EddieMoney9: folds 
PlayTheBlues4U: folds 
xxzuluzuluxx: calls $0.10
crazy turfer: calls $0.10
DeepMTPocket: calls $0.05
Ribeye63: checks 
*** FLOP *** [4h Kd Kh]
DeepMTPocket: checks 
Ribeye63: checks 
xxzuluzuluxx: checks 
crazy turfer: checks 
*** TURN *** [4h Kd Kh] [8h]
DeepMTPocket: checks 
Ribeye63: checks 
xxzuluzuluxx: checks 
crazy turfer: checks 
*** RIVER *** [4h Kd Kh 8h] [8s]
DeepMTPocket: checks 
Ribeye63: checks 
xxzuluzuluxx: checks 
crazy turfer: checks 
*** SHOW DOWN ***
DeepMTPocket: shows [9s 7c] (two pair, Kings and Eights)
Ribeye63: shows [2c Js] (two pair, Kings and Eights - Jack kicker)
xxzuluzuluxx: shows [Qs 9c] (two pair, Kings and Eights - Queen kicker)
crazy turfer: mucks hand 
xxzuluzuluxx collected $0.38 from pot
*** SUMMARY ***
Total pot $0.40 | Rake $0.02 
Board [4h Kd Kh 8h 8s]
Seat 1: xxzuluzuluxx showed [Qs 9c] and won ($0.38) with two pair, Kings and Eights
Seat 2: crazy turfer (button) mucked [5c 3s]
Seat 3: DeepMTPocket (small blind) showed [9s 7c] and lost with two pair, Kings and Eights
Seat 4: Ribeye63 (big blind) showed [2c Js] and lost with two pair, Kings and Eights
Seat 5: EddieMoney9 folded before Flop (didn't bet)
Seat 6: PlayTheBlues4U folded before Flop (didn't bet)



PokerStars Hand #204645139432:  Hold'em No Limit ($0.05/$0.10 USD) - 2019/10/17 19:10:54 ET
Table 'Sappho' 6-max Seat #3 is the button
Seat 1: xxzuluzuluxx ($2.05 in chips) 
Seat 2: crazy turfer ($28.49 in chips) 
Seat 3: DeepMTPocket ($11.66 in chips) 
Seat 4: Ribeye63 ($15.03 in chips) 
Seat 5: EddieMoney9 ($10 in chips) 
Seat 6: PlayTheBlues4U ($11 in chips) 
Ribeye63: posts small blind $0.05
EddieMoney9: posts big blind $0.10
*** HOLE CARDS ***
Dealt to PlayTheBlues4U [2s 8h]
PlayTheBlues4U: folds 
xxzuluzuluxx: calls $0.10
crazy turfer: calls $0.10
DeepMTPocket: folds 
Ribeye63: raises $0.40 to $0.50
EddieMoney9: folds 
xxzuluzuluxx: calls $0.40
crazy turfer: folds 
*** FLOP *** [5h 9s 5s]
Ribeye63: bets $0.57
xxzuluzuluxx: calls $0.57
*** TURN *** [5h 9s 5s] [4s]
Ribeye63: checks 
xxzuluzuluxx: checks 
*** RIVER *** [5h 9s 5s 4s] [Tc]
Ribeye63: checks 
xxzuluzuluxx: bets $0.40
Ribeye63: calls $0.40
*** SHOW DOWN ***
xxzuluzuluxx: shows [Td Qh] (two pair, Tens and Fives)
Ribeye63: shows [Qd Qs] (two pair, Queens and Fives)
Ribeye63 collected $2.98 from pot
*** SUMMARY ***
Total pot $3.14 | Rake $0.16 
Board [5h 9s 5s 4s Tc]
Seat 1: xxzuluzuluxx showed [Td Qh] and lost with two pair, Tens and Fives
Seat 2: crazy turfer folded before Flop
Seat 3: DeepMTPocket (button) folded before Flop (didn't bet)
Seat 4: Ribeye63 (small blind) showed [Qd Qs] and won ($2.98) with two pair, Queens and Fives
Seat 5: EddieMoney9 (big blind) folded before Flop
Seat 6: PlayTheBlues4U folded before Flop (didn't bet)



PokerStars Hand #204645139525:  Hold'em No Limit ($0.05/$0.10 USD) - 2019/10/17 19:11:29 ET
Table 'Sappho' 6-max Seat #4 is the button
Seat 1: xxzuluzuluxx ($0.58 in chips) 
Seat 2: crazy turfer ($28.39 in chips) 
Seat 3: DeepMTPocket ($11.66 in chips) 
Seat 4: Ribeye63 ($16.54 in chips) 
Seat 5: EddieMoney9 ($9.90 in chips) 
Seat 6: PlayTheBlues4U ($11 in chips) 
EddieMoney9: posts small blind $0.05
PlayTheBlues4U: posts big blind $0.10
*** HOLE CARDS ***
Dealt to PlayTheBlues4U [Jc Kh]
xxzuluzuluxx: folds 
crazy turfer: raises $0.20 to $0.30
DeepMTPocket: calls $0.30
Ribeye63: folds 
EddieMoney9: folds 
PlayTheBlues4U: calls $0.20
*** FLOP *** [4s 8d Js]
PlayTheBlues4U: bets $0.50
crazy turfer: folds 
DeepMTPocket: calls $0.50
*** TURN *** [4s 8d Js] [Qd]
PlayTheBlues4U: checks 
DeepMTPocket: checks 
*** RIVER *** [4s 8d Js Qd] [Tc]
PlayTheBlues4U: checks 
DeepMTPocket: bets $0.93
PlayTheBlues4U: calls $0.93
*** SHOW DOWN ***
DeepMTPocket: shows [8c 9h] (a straight, Eight to Queen)
PlayTheBlues4U: mucks hand 
DeepMTPocket collected $3.62 from pot
*** SUMMARY ***
Total pot $3.81 | Rake $0.19 
Board [4s 8d Js Qd Tc]
Seat 1: xxzuluzuluxx folded before Flop (didn't bet)
Seat 2: crazy turfer folded on the Flop
Seat 3: DeepMTPocket showed [8c 9h] and won ($3.62) with a straight, Eight to Queen
Seat 4: Ribeye63 (button) folded before Flop (didn't bet)
Seat 5: EddieMoney9 (small blind) folded before Flop
Seat 6: PlayTheBlues4U (big blind) mucked [Jc Kh]



PokerStars Hand #204645139708:  Hold'em No Limit ($0.05/$0.10 USD) - 2019/10/17 19:12:37 ET
Table 'Sappho' 6-max Seat #5 is the button
Seat 1: xxzuluzuluxx ($0.58 in chips) 
Seat 2: crazy turfer ($28.09 in chips) 
Seat 3: DeepMTPocket ($13.55 in chips) 
Seat 4: Ribeye63 ($16.54 in chips) 
Seat 5: EddieMoney9 ($9.85 in chips) 
Seat 6: PlayTheBlues4U ($9.27 in chips) 
PlayTheBlues4U: posts small blind $0.05
xxzuluzuluxx: posts big blind $0.10
*** HOLE CARDS ***
Dealt to PlayTheBlues4U [3s 6c]
crazy turfer: raises $0.10 to $0.20
DeepMTPocket: raises $0.80 to $1
Ribeye63: folds 
EddieMoney9: folds 
PlayTheBlues4U: folds 
xxzuluzuluxx: folds 
crazy turfer: folds 
Uncalled bet ($0.80) returned to DeepMTPocket
DeepMTPocket collected $0.55 from pot
DeepMTPocket: doesn't show hand 
*** SUMMARY ***
Total pot $0.55 | Rake $0 
Seat 1: xxzuluzuluxx (big blind) folded before Flop
Seat 2: crazy turfer folded before Flop
Seat 3: DeepMTPocket collected ($0.55)
Seat 4: Ribeye63 folded before Flop (didn't bet)
Seat 5: EddieMoney9 (button) folded before Flop (didn't bet)
Seat 6: PlayTheBlues4U (small blind) folded before Flop



PokerStars Hand #204645139749:  Hold'em No Limit ($0.05/$0.10 USD) - 2019/10/17 19:12:52 ET
Table 'Sappho' 6-max Seat #6 is the button
Seat 1: xxzuluzuluxx ($0.48 in chips) 
Seat 2: crazy turfer ($27.89 in chips) 
Seat 3: DeepMTPocket ($13.90 in chips) 
Seat 4: Ribeye63 ($16.54 in chips) 
Seat 5: EddieMoney9 ($9.85 in chips) 
Seat 6: PlayTheBlues4U ($9.22 in chips) 
xxzuluzuluxx: posts small blind $0.05
crazy turfer: posts big blind $0.10
*** HOLE CARDS ***
Dealt to PlayTheBlues4U [3s 9c]
DeepMTPocket: folds 
Ribeye63: raises $0.20 to $0.30
EddieMoney9: folds 
PlayTheBlues4U: folds 
xxzuluzuluxx: folds 
crazy turfer: folds 
Uncalled bet ($0.20) returned to Ribeye63
Ribeye63 collected $0.25 from pot
Ribeye63: doesn't show hand 
*** SUMMARY ***
Total pot $0.25 | Rake $0 
Seat 1: xxzuluzuluxx (small blind) folded before Flop
Seat 2: crazy turfer (big blind) folded before Flop
Seat 3: DeepMTPocket folded before Flop (didn't bet)
Seat 4: Ribeye63 collected ($0.25)
Seat 5: EddieMoney9 folded before Flop (didn't bet)
Seat 6: PlayTheBlues4U (button) folded before Flop (didn't bet)



PokerStars Hand #204645139787:  Hold'em No Limit ($0.05/$0.10 USD) - 2019/10/17 19:13:05 ET
Table 'Sappho' 6-max Seat #1 is the button
Seat 1: xxzuluzuluxx ($0.43 in chips) 
Seat 2: crazy turfer ($27.79 in chips) 
Seat 3: DeepMTPocket ($13.90 in chips) 
Seat 4: Ribeye63 ($16.69 in chips) 
Seat 5: EddieMoney9 ($9.85 in chips) 
Seat 6: PlayTheBlues4U ($9.22 in chips) 
crazy turfer: posts small blind $0.05
DeepMTPocket: posts big blind $0.10
*** HOLE CARDS ***
Dealt to PlayTheBlues4U [2d 6d]
Ribeye63: folds 
EddieMoney9: folds 
PlayTheBlues4U has timed out
PlayTheBlues4U: folds 
xxzuluzuluxx: calls $0.10
crazy turfer: calls $0.05
DeepMTPocket: checks 
*** FLOP *** [Td 4d Kd]
crazy turfer: checks 
DeepMTPocket: checks 
xxzuluzuluxx: bets $0.33 and is all-in
crazy turfer: folds 
DeepMTPocket: folds 
Uncalled bet ($0.33) returned to xxzuluzuluxx
xxzuluzuluxx collected $0.28 from pot
xxzuluzuluxx: doesn't show hand 
*** SUMMARY ***
Total pot $0.30 | Rake $0.02 
Board [Td 4d Kd]
Seat 1: xxzuluzuluxx (button) collected ($0.28)
Seat 2: crazy turfer (small blind) folded on the Flop
Seat 3: DeepMTPocket (big blind) folded on the Flop
Seat 4: Ribeye63 folded before Flop (didn't bet)
Seat 5: EddieMoney9 folded before Flop (didn't bet)
Seat 6: PlayTheBlues4U folded before Flop (didn't bet)



PokerStars Hand #204645692596:  Hold'em No Limit ($0.05/$0.10 USD) - 2019/10/17 19:16:39 ET
Table 'Sappho' 6-max Seat #4 is the button
Seat 1: xxzuluzuluxx ($3.65 in chips) 
Seat 2: crazy turfer ($27.96 in chips) 
Seat 3: DeepMTPocket ($14.12 in chips) 
Seat 4: Ribeye63 ($16.29 in chips) 
Seat 5: EddieMoney9 ($10.43 in chips) 
Seat 6: PlayTheBlues4U ($9.22 in chips) 
EddieMoney9: posts small blind $0.05
PlayTheBlues4U: posts big blind $0.10
*** HOLE CARDS ***
Dealt to PlayTheBlues4U [6d 2s]
xxzuluzuluxx: calls $0.10
crazy turfer: calls $0.10
DeepMTPocket: folds 
Ribeye63: folds 
EddieMoney9: folds 
PlayTheBlues4U: checks 
*** FLOP *** [5s 5h Qs]
PlayTheBlues4U: checks 
xxzuluzuluxx: bets $0.33
crazy turfer: folds 
PlayTheBlues4U: folds 
Uncalled bet ($0.33) returned to xxzuluzuluxx
xxzuluzuluxx collected $0.33 from pot
xxzuluzuluxx: doesn't show hand 
*** SUMMARY ***
Total pot $0.35 | Rake $0.02 
Board [5s 5h Qs]
Seat 1: xxzuluzuluxx collected ($0.33)
Seat 2: crazy turfer folded on the Flop
Seat 3: DeepMTPocket folded before Flop (didn't bet)
Seat 4: Ribeye63 (button) folded before Flop (didn't bet)
Seat 5: EddieMoney9 (small blind) folded before Flop
Seat 6: PlayTheBlues4U (big blind) folded on the Flop



PokerStars Hand #204645692675:  Hold'em No Limit ($0.05/$0.10 USD) - 2019/10/17 19:17:03 ET
Table 'Sappho' 6-max Seat #5 is the button
Seat 1: xxzuluzuluxx ($3.88 in chips) 
Seat 2: crazy turfer ($27.86 in chips) 
Seat 3: DeepMTPocket ($14.12 in chips) 
Seat 4: Ribeye63 ($16.29 in chips) 
Seat 5: EddieMoney9 ($10.38 in chips) 
Seat 6: PlayTheBlues4U ($9.12 in chips) 
PlayTheBlues4U: posts small blind $0.05
xxzuluzuluxx: posts big blind $0.10
*** HOLE CARDS ***
Dealt to PlayTheBlues4U [8h Kd]
crazy turfer: folds 
DeepMTPocket: folds 
Ribeye63: raises $0.20 to $0.30
EddieMoney9: folds 
PlayTheBlues4U: folds 
xxzuluzuluxx: folds 
Uncalled bet ($0.20) returned to Ribeye63
Ribeye63 collected $0.25 from pot
Ribeye63: doesn't show hand 
*** SUMMARY ***
Total pot $0.25 | Rake $0 
Seat 1: xxzuluzuluxx (big blind) folded before Flop
Seat 2: crazy turfer folded before Flop (didn't bet)
Seat 3: DeepMTPocket folded before Flop (didn't bet)
Seat 4: Ribeye63 collected ($0.25)
Seat 5: EddieMoney9 (button) folded before Flop (didn't bet)
Seat 6: PlayTheBlues4U (small blind) folded before Flop



PokerStars Hand #204645692715:  Hold'em No Limit ($0.05/$0.10 USD) - 2019/10/17 19:17:18 ET
Table 'Sappho' 6-max Seat #6 is the button
Seat 1: xxzuluzuluxx ($3.78 in chips) 
Seat 2: crazy turfer ($27.86 in chips) 
Seat 3: DeepMTPocket ($14.12 in chips) 
Seat 4: Ribeye63 ($16.44 in chips) 
Seat 5: EddieMoney9 ($10.38 in chips) 
Seat 6: PlayTheBlues4U ($9.07 in chips) 
xxzuluzuluxx: posts small blind $0.05
crazy turfer: posts big blind $0.10
*** HOLE CARDS ***
Dealt to PlayTheBlues4U [Jh 7c]
DeepMTPocket: folds 
Ribeye63: folds 
EddieMoney9: folds 
PlayTheBlues4U: folds 
xxzuluzuluxx: folds 
Uncalled bet ($0.05) returned to crazy turfer
crazy turfer collected $0.10 from pot
*** SUMMARY ***
Total pot $0.10 | Rake $0 
Seat 1: xxzuluzuluxx (small blind) folded before Flop
Seat 2: crazy turfer (big blind) collected ($0.10)
Seat 3: DeepMTPocket folded before Flop (didn't bet)
Seat 4: Ribeye63 folded before Flop (didn't bet)
Seat 5: EddieMoney9 folded before Flop (didn't bet)
Seat 6: PlayTheBlues4U (button) folded before Flop (didn't bet)



PokerStars Hand #204645692762:  Hold'em No Limit ($0.05/$0.10 USD) - 2019/10/17 19:17:32 ET
Table 'Sappho' 6-max Seat #1 is the button
Seat 1: xxzuluzuluxx ($3.73 in chips) 
Seat 2: crazy turfer ($27.91 in chips) 
Seat 3: DeepMTPocket ($14.12 in chips) 
Seat 4: Ribeye63 ($16.44 in chips) 
Seat 5: EddieMoney9 ($10.38 in chips) 
Seat 6: PlayTheBlues4U ($9.07 in chips) 
crazy turfer: posts small blind $0.05
DeepMTPocket: posts big blind $0.10
*** HOLE CARDS ***
Dealt to PlayTheBlues4U [9c 8h]
Ribeye63: folds 
EddieMoney9: folds 
PlayTheBlues4U: folds 
xxzuluzuluxx: calls $0.10
crazy turfer: raises $0.40 to $0.50
DeepMTPocket: folds 
xxzuluzuluxx: calls $0.40
*** FLOP *** [8s 4s 9h]
crazy turfer: bets $1.40
xxzuluzuluxx: folds 
Uncalled bet ($1.40) returned to crazy turfer
crazy turfer collected $1.04 from pot
*** SUMMARY ***
Total pot $1.10 | Rake $0.06 
Board [8s 4s 9h]
Seat 1: xxzuluzuluxx (button) folded on the Flop
Seat 2: crazy turfer (small blind) collected ($1.04)
Seat 3: DeepMTPocket (big blind) folded before Flop
Seat 4: Ribeye63 folded before Flop (didn't bet)
Seat 5: EddieMoney9 folded before Flop (didn't bet)
Seat 6: PlayTheBlues4U folded before Flop (didn't bet)



PokerStars Hand #204645692857:  Hold'em No Limit ($0.05/$0.10 USD) - 2019/10/17 19:18:04 ET
Table 'Sappho' 6-max Seat #2 is the button
Seat 1: xxzuluzuluxx ($3.23 in chips) 
Seat 2: crazy turfer ($28.45 in chips) 
Seat 3: DeepMTPocket ($14.02 in chips) 
Seat 4: Ribeye63 ($16.44 in chips) 
Seat 5: EddieMoney9 ($10.38 in chips) 
Seat 6: PlayTheBlues4U ($9.07 in chips) 
DeepMTPocket: posts small blind $0.05
Ribeye63: posts big blind $0.10
*** HOLE CARDS ***
Dealt to PlayTheBlues4U [Tc 3c]
EddieMoney9: folds 
PlayTheBlues4U: folds 
xxzuluzuluxx: folds 
crazy turfer: folds 
DeepMTPocket: folds 
Uncalled bet ($0.05) returned to Ribeye63
Ribeye63 collected $0.10 from pot
Ribeye63: doesn't show hand 
*** SUMMARY ***
Total pot $0.10 | Rake $0 
Seat 1: xxzuluzuluxx folded before Flop (didn't bet)
Seat 2: crazy turfer (button) folded before Flop (didn't bet)
Seat 3: DeepMTPocket (small blind) folded before Flop
Seat 4: Ribeye63 (big blind) collected ($0.10)
Seat 5: EddieMoney9 folded before Flop (didn't bet)
Seat 6: PlayTheBlues4U folded before Flop (didn't bet)



PokerStars Hand #204645692893:  Hold'em No Limit ($0.05/$0.10 USD) - 2019/10/17 19:18:16 ET
Table 'Sappho' 6-max Seat #3 is the button
Seat 1: xxzuluzuluxx ($3.23 in chips) 
Seat 2: crazy turfer ($28.45 in chips) 
Seat 3: DeepMTPocket ($13.97 in chips) 
Seat 4: Ribeye63 ($16.49 in chips) 
Seat 5: EddieMoney9 ($10.38 in chips) 
Seat 6: PlayTheBlues4U ($9.07 in chips) 
Ribeye63: posts small blind $0.05
EddieMoney9: posts big blind $0.10
*** HOLE CARDS ***
Dealt to PlayTheBlues4U [Qd 5d]
PlayTheBlues4U: folds 
xxzuluzuluxx: calls $0.10
crazy turfer: folds 
DeepMTPocket: calls $0.10
Ribeye63: folds 
EddieMoney9: checks 
*** FLOP *** [5h 3h 2c]
EddieMoney9: bets $0.23
xxzuluzuluxx: calls $0.23
DeepMTPocket: folds 
*** TURN *** [5h 3h 2c] [7h]
EddieMoney9: checks 
xxzuluzuluxx: checks 
*** RIVER *** [5h 3h 2c 7h] [9d]
EddieMoney9: bets $0.54
xxzuluzuluxx: folds 
Uncalled bet ($0.54) returned to EddieMoney9
EddieMoney9 collected $0.77 from pot
EddieMoney9: doesn't show hand 
*** SUMMARY ***
Total pot $0.81 | Rake $0.04 
Board [5h 3h 2c 7h 9d]
Seat 1: xxzuluzuluxx folded on the River
Seat 2: crazy turfer folded before Flop (didn't bet)
Seat 3: DeepMTPocket (button) folded on the Flop
Seat 4: Ribeye63 (small blind) folded before Flop
Seat 5: EddieMoney9 (big blind) collected ($0.77)
Seat 6: PlayTheBlues4U folded before Flop (didn't bet)



PokerStars Hand #204645693028:  Hold'em No Limit ($0.05/$0.10 USD) - 2019/10/17 19:19:03 ET
Table 'Sappho' 6-max Seat #4 is the button
Seat 1: xxzuluzuluxx ($2.90 in chips) 
Seat 2: crazy turfer ($28.45 in chips) 
Seat 3: DeepMTPocket ($13.87 in chips) 
Seat 4: Ribeye63 ($16.44 in chips) 
Seat 5: EddieMoney9 ($10.82 in chips) 
Seat 6: PlayTheBlues4U ($9.07 in chips) 
EddieMoney9: posts small blind $0.05
PlayTheBlues4U: posts big blind $0.10
*** HOLE CARDS ***
Dealt to PlayTheBlues4U [7s 9h]
xxzuluzuluxx: calls $0.10
crazy turfer: raises $0.35 to $0.45
DeepMTPocket: folds 
Ribeye63: folds 
EddieMoney9: folds 
PlayTheBlues4U: folds 
xxzuluzuluxx: calls $0.35
*** FLOP *** [3s Qc Ts]
xxzuluzuluxx: checks 
crazy turfer: bets $0.30
xxzuluzuluxx: calls $0.30
*** TURN *** [3s Qc Ts] [Jc]
xxzuluzuluxx: checks 
crazy turfer: bets $1.60
xxzuluzuluxx: folds 
Uncalled bet ($1.60) returned to crazy turfer
crazy turfer collected $1.57 from pot
crazy turfer: shows [Jh Js] (three of a kind, Jacks)
*** SUMMARY ***
Total pot $1.65 | Rake $0.08 
Board [3s Qc Ts Jc]
Seat 1: xxzuluzuluxx folded on the Turn
Seat 2: crazy turfer collected ($1.57)
Seat 3: DeepMTPocket folded before Flop (didn't bet)
Seat 4: Ribeye63 (button) folded before Flop (didn't bet)
Seat 5: EddieMoney9 (small blind) folded before Flop
Seat 6: PlayTheBlues4U (big blind) folded before Flop



PokerStars Hand #204645693132:  Hold'em No Limit ($0.05/$0.10 USD) - 2019/10/17 19:19:46 ET
Table 'Sappho' 6-max Seat #5 is the button
Seat 1: xxzuluzuluxx ($2.15 in chips) 
Seat 2: crazy turfer ($29.27 in chips) 
Seat 3: DeepMTPocket ($13.87 in chips) 
Seat 4: Ribeye63 ($16.44 in chips) 
Seat 5: EddieMoney9 ($10.77 in chips) 
Seat 6: PlayTheBlues4U ($8.97 in chips) 
PlayTheBlues4U: posts small blind $0.05
xxzuluzuluxx: posts big blind $0.10
*** HOLE CARDS ***
Dealt to PlayTheBlues4U [8h Qd]
crazy turfer: folds 
DeepMTPocket: folds 
Ribeye63: raises $0.20 to $0.30
EddieMoney9: folds 
PlayTheBlues4U: folds 
xxzuluzuluxx: calls $0.20
*** FLOP *** [3c Jh 7d]
xxzuluzuluxx: bets $1.85 and is all-in
Ribeye63: folds 
Uncalled bet ($1.85) returned to xxzuluzuluxx
xxzuluzuluxx collected $0.62 from pot
xxzuluzuluxx: doesn't show hand 
*** SUMMARY ***
Total pot $0.65 | Rake $0.03 
Board [3c Jh 7d]
Seat 1: xxzuluzuluxx (big blind) collected ($0.62)
Seat 2: crazy turfer folded before Flop (didn't bet)
Seat 3: DeepMTPocket folded before Flop (didn't bet)
Seat 4: Ribeye63 folded on the Flop
Seat 5: EddieMoney9 (button) folded before Flop (didn't bet)
Seat 6: PlayTheBlues4U (small blind) folded before Flop



PokerStars Hand #204645693189:  Hold'em No Limit ($0.05/$0.10 USD) - 2019/10/17 19:20:10 ET
Table 'Sappho' 6-max Seat #6 is the button
Seat 1: xxzuluzuluxx ($2.47 in chips) 
Seat 2: crazy turfer ($29.27 in chips) 
Seat 3: DeepMTPocket ($13.87 in chips) 
Seat 4: Ribeye63 ($16.14 in chips) 
Seat 5: EddieMoney9 ($10.77 in chips) 
Seat 6: PlayTheBlues4U ($8.92 in chips) 
xxzuluzuluxx: posts small blind $0.05
crazy turfer: posts big blind $0.10
*** HOLE CARDS ***
Dealt to PlayTheBlues4U [Tc Ac]
DeepMTPocket: folds 
Ribeye63: folds 
EddieMoney9: folds 
PlayTheBlues4U: raises $0.20 to $0.30
xxzuluzuluxx: folds 
crazy turfer: calls $0.20
*** FLOP *** [Ts Jh 6s]
crazy turfer: checks 
PlayTheBlues4U: bets $0.40
crazy turfer: folds 
Uncalled bet ($0.40) returned to PlayTheBlues4U
PlayTheBlues4U collected $0.62 from pot
PlayTheBlues4U: doesn't show hand 
*** SUMMARY ***
Total pot $0.65 | Rake $0.03 
Board [Ts Jh 6s]
Seat 1: xxzuluzuluxx (small blind) folded before Flop
Seat 2: crazy turfer (big blind) folded on the Flop
Seat 3: DeepMTPocket folded before Flop (didn't bet)
Seat 4: Ribeye63 folded before Flop (didn't bet)
Seat 5: EddieMoney9 folded before Flop (didn't bet)
Seat 6: PlayTheBlues4U (button) collected ($0.62)



PokerStars Hand #204645693312:  Hold'em No Limit ($0.05/$0.10 USD) - 2019/10/17 19:20:59 ET
Table 'Sappho' 6-max Seat #1 is the button
Seat 1: xxzuluzuluxx ($2.42 in chips) 
Seat 2: crazy turfer ($28.97 in chips) 
Seat 3: DeepMTPocket ($13.87 in chips) 
Seat 4: Ribeye63 ($16.14 in chips) 
Seat 5: EddieMoney9 ($10.77 in chips) 
Seat 6: PlayTheBlues4U ($9.24 in chips) 
crazy turfer: posts small blind $0.05
DeepMTPocket: posts big blind $0.10
*** HOLE CARDS ***
Dealt to PlayTheBlues4U [5d 3c]
Ribeye63: folds 
Ribeye63 leaves the table
EddieMoney9: folds 
PlayTheBlues4U: folds 
xxzuluzuluxx: calls $0.10
crazy turfer: raises $0.20 to $0.30
DeepMTPocket: folds 
xxzuluzuluxx: calls $0.20
*** FLOP *** [9s 4h Jd]
crazy turfer: checks 
xxzuluzuluxx: bets $0.33
crazy turfer: folds 
Uncalled bet ($0.33) returned to xxzuluzuluxx
xxzuluzuluxx collected $0.66 from pot
xxzuluzuluxx: doesn't show hand 
*** SUMMARY ***
Total pot $0.70 | Rake $0.04 
Board [9s 4h Jd]
Seat 1: xxzuluzuluxx (button) collected ($0.66)
Seat 2: crazy turfer (small blind) folded on the Flop
Seat 3: DeepMTPocket (big blind) folded before Flop
Seat 4: Ribeye63 folded before Flop (didn't bet)
Seat 5: EddieMoney9 folded before Flop (didn't bet)
Seat 6: PlayTheBlues4U folded before Flop (didn't bet)



PokerStars Hand #204645693361:  Hold'em No Limit ($0.05/$0.10 USD) - 2019/10/17 19:21:22 ET
Table 'Sappho' 6-max Seat #2 is the button
Seat 1: xxzuluzuluxx ($2.78 in chips) 
Seat 2: crazy turfer ($28.67 in chips) 
Seat 3: DeepMTPocket ($13.77 in chips) 
Seat 5: EddieMoney9 ($10.77 in chips) 
Seat 6: PlayTheBlues4U ($9.24 in chips) 
DeepMTPocket: posts small blind $0.05
EddieMoney9: posts big blind $0.10
*** HOLE CARDS ***
Dealt to PlayTheBlues4U [6d 4s]
PlayTheBlues4U: folds 
xxzuluzuluxx: calls $0.10
crazy turfer: raises $0.10 to $0.20
DeepMTPocket: folds 
1212wjf joins the table at seat #4 
EddieMoney9: calls $0.10
xxzuluzuluxx: calls $0.10
*** FLOP *** [9s 8c Td]
DeepMTPocket leaves the table
EddieMoney9: checks 
xxzuluzuluxx: checks 
crazy turfer: checks 
*** TURN *** [9s 8c Td] [Jc]
EddieMoney9: bets $0.43
xxzuluzuluxx: calls $0.43
crazy turfer: folds 
*** RIVER *** [9s 8c Td Jc] [3d]
EddieMoney9: bets $1
xxzuluzuluxx: folds [Ks]
Uncalled bet ($1) returned to EddieMoney9
EddieMoney9 collected $1.43 from pot
EddieMoney9: doesn't show hand 
*** SUMMARY ***
Total pot $1.51 | Rake $0.08 
Board [9s 8c Td Jc 3d]
Seat 1: xxzuluzuluxx folded on the River
Seat 2: crazy turfer (button) folded on the Turn
Seat 3: DeepMTPocket (small blind) folded before Flop
Seat 5: EddieMoney9 (big blind) collected ($1.43)
Seat 6: PlayTheBlues4U folded before Flop (didn't bet)



PokerStars Hand #204645693534:  Hold'em No Limit ($0.05/$0.10 USD) - 2019/10/17 19:22:20 ET
Table 'Sappho' 6-max Seat #5 is the button
Seat 1: xxzuluzuluxx ($2.15 in chips) 
Seat 2: crazy turfer ($28.47 in chips) 
Seat 5: EddieMoney9 ($11.57 in chips) 
Seat 6: PlayTheBlues4U ($9.24 in chips) 
PlayTheBlues4U: posts small blind $0.05
xxzuluzuluxx: posts big blind $0.10
1212wjf: sits out 
*** HOLE CARDS ***
Dealt to PlayTheBlues4U [5s 3d]
crazy turfer: folds 
EddieMoney9: raises $0.20 to $0.30
PlayTheBlues4U: folds 
xxzuluzuluxx: folds 
Uncalled bet ($0.20) returned to EddieMoney9
EddieMoney9 collected $0.25 from pot
EddieMoney9: doesn't show hand 
*** SUMMARY ***
Total pot $0.25 | Rake $0 
Seat 1: xxzuluzuluxx (big blind) folded before Flop
Seat 2: crazy turfer folded before Flop (didn't bet)
Seat 5: EddieMoney9 (button) collected ($0.25)
Seat 6: PlayTheBlues4U (small blind) folded before Flop



PokerStars Hand #204645693596:  Hold'em No Limit ($0.05/$0.10 USD) - 2019/10/17 19:22:37 ET
Table 'Sappho' 6-max Seat #6 is the button
Seat 1: xxzuluzuluxx ($2.05 in chips) 
Seat 2: crazy turfer ($28.47 in chips) 
Seat 5: EddieMoney9 ($11.72 in chips) 
Seat 6: PlayTheBlues4U ($9.19 in chips) 
xxzuluzuluxx: posts small blind $0.05
crazy turfer: posts big blind $0.10
1212wjf: sits out 
*** HOLE CARDS ***
Dealt to PlayTheBlues4U [Ah 5h]
EddieMoney9: folds 
PlayTheBlues4U: raises $0.20 to $0.30
xxzuluzuluxx: folds 
crazy turfer: folds 
Uncalled bet ($0.20) returned to PlayTheBlues4U
PlayTheBlues4U collected $0.25 from pot
PlayTheBlues4U: doesn't show hand 
*** SUMMARY ***
Total pot $0.25 | Rake $0 
Seat 1: xxzuluzuluxx (small blind) folded before Flop
Seat 2: crazy turfer (big blind) folded before Flop
Seat 5: EddieMoney9 folded before Flop (didn't bet)
Seat 6: PlayTheBlues4U (button) collected ($0.25)



PokerStars Hand #204645693631:  Hold'em No Limit ($0.05/$0.10 USD) - 2019/10/17 19:22:52 ET
Table 'Sappho' 6-max Seat #1 is the button
Seat 1: xxzuluzuluxx ($2 in chips) 
Seat 2: crazy turfer ($28.37 in chips) 
Seat 4: 1212wjf ($10 in chips) 
Seat 5: EddieMoney9 ($11.72 in chips) 
Seat 6: PlayTheBlues4U ($9.34 in chips) 
crazy turfer: posts small blind $0.05
1212wjf: posts big blind $0.10
*** HOLE CARDS ***
Dealt to PlayTheBlues4U [Js 8s]
EddieMoney9: folds 
PlayTheBlues4U: folds 
xxzuluzuluxx: folds 
crazy turfer: raises $0.20 to $0.30
1212wjf: folds 
Uncalled bet ($0.20) returned to crazy turfer
crazy turfer collected $0.20 from pot
*** SUMMARY ***
Total pot $0.20 | Rake $0 
Seat 1: xxzuluzuluxx (button) folded before Flop (didn't bet)
Seat 2: crazy turfer (small blind) collected ($0.20)
Seat 4: 1212wjf (big blind) folded before Flop
Seat 5: EddieMoney9 folded before Flop (didn't bet)
Seat 6: PlayTheBlues4U folded before Flop (didn't bet)



PokerStars Hand #204645693661:  Hold'em No Limit ($0.05/$0.10 USD) - 2019/10/17 19:23:04 ET
Table 'Sappho' 6-max Seat #2 is the button
Seat 1: xxzuluzuluxx ($2 in chips) 
Seat 2: crazy turfer ($28.47 in chips) 
Seat 4: 1212wjf ($9.90 in chips) 
Seat 5: EddieMoney9 ($11.72 in chips) 
Seat 6: PlayTheBlues4U ($9.34 in chips) 
1212wjf: posts small blind $0.05
EddieMoney9: posts big blind $0.10
*** HOLE CARDS ***
Dealt to PlayTheBlues4U [7s 5h]
PlayTheBlues4U: folds 
xxzuluzuluxx: calls $0.10
crazy turfer: folds 
1212wjf: folds 
EddieMoney9: checks 
*** FLOP *** [6h 9h Tc]
EddieMoney9: checks 
xxzuluzuluxx: bets $0.10
EddieMoney9: folds 
Uncalled bet ($0.10) returned to xxzuluzuluxx
xxzuluzuluxx collected $0.24 from pot
xxzuluzuluxx: doesn't show hand 
*** SUMMARY ***
Total pot $0.25 | Rake $0.01 
Board [6h 9h Tc]
Seat 1: xxzuluzuluxx collected ($0.24)
Seat 2: crazy turfer (button) folded before Flop (didn't bet)
Seat 4: 1212wjf (small blind) folded before Flop
Seat 5: EddieMoney9 (big blind) folded on the Flop
Seat 6: PlayTheBlues4U folded before Flop (didn't bet)



PokerStars Hand #204645693763:  Hold'em No Limit ($0.05/$0.10 USD) - 2019/10/17 19:23:36 ET
Table 'Sappho' 6-max Seat #4 is the button
Seat 1: xxzuluzuluxx ($2.14 in chips) 
Seat 2: crazy turfer ($28.47 in chips) 
Seat 4: 1212wjf ($9.85 in chips) 
Seat 5: EddieMoney9 ($11.62 in chips) 
Seat 6: PlayTheBlues4U ($9.34 in chips) 
EddieMoney9: posts small blind $0.05
PlayTheBlues4U: posts big blind $0.10
*** HOLE CARDS ***
Dealt to PlayTheBlues4U [2c 2d]
xxzuluzuluxx: folds 
crazy turfer: folds 
1212wjf: folds 
EddieMoney9: raises $0.20 to $0.30
PlayTheBlues4U: calls $0.20
*** FLOP *** [3d 9h 9c]
EddieMoney9: checks 
PlayTheBlues4U: bets $0.30
EddieMoney9: raises $0.82 to $1.12
PlayTheBlues4U: folds 
Uncalled bet ($0.82) returned to EddieMoney9
EddieMoney9 collected $1.14 from pot
EddieMoney9: doesn't show hand 
*** SUMMARY ***
Total pot $1.20 | Rake $0.06 
Board [3d 9h 9c]
Seat 1: xxzuluzuluxx folded before Flop (didn't bet)
Seat 2: crazy turfer folded before Flop (didn't bet)
Seat 4: 1212wjf (button) folded before Flop (didn't bet)
Seat 5: EddieMoney9 (small blind) collected ($1.14)
Seat 6: PlayTheBlues4U (big blind) folded on the Flop



PokerStars Hand #204645693886:  Hold'em No Limit ($0.05/$0.10 USD) - 2019/10/17 19:24:20 ET
Table 'Sappho' 6-max Seat #5 is the button
Seat 1: xxzuluzuluxx ($2.14 in chips) 
Seat 2: crazy turfer ($28.47 in chips) 
Seat 4: 1212wjf ($9.85 in chips) 
Seat 5: EddieMoney9 ($12.16 in chips) 
Seat 6: PlayTheBlues4U ($8.74 in chips) 
PlayTheBlues4U: posts small blind $0.05
xxzuluzuluxx: posts big blind $0.10
*** HOLE CARDS ***
Dealt to PlayTheBlues4U [Ah 5d]
crazy turfer: folds 
1212wjf: folds 
EddieMoney9: folds 
TeterboroJCL joins the table at seat #3 
PlayTheBlues4U: raises $0.20 to $0.30
xxzuluzuluxx: calls $0.20
*** FLOP *** [6s 8c 2h]
PlayTheBlues4U: bets $0.30
xxzuluzuluxx: folds 
Uncalled bet ($0.30) returned to PlayTheBlues4U
PlayTheBlues4U collected $0.57 from pot
PlayTheBlues4U: doesn't show hand 
*** SUMMARY ***
Total pot $0.60 | Rake $0.03 
Board [6s 8c 2h]
Seat 1: xxzuluzuluxx (big blind) folded on the Flop
Seat 2: crazy turfer folded before Flop (didn't bet)
Seat 4: 1212wjf folded before Flop (didn't bet)
Seat 5: EddieMoney9 (button) folded before Flop (didn't bet)
Seat 6: PlayTheBlues4U (small blind) collected ($0.57)



PokerStars Hand #204645693978:  Hold'em No Limit ($0.05/$0.10 USD) - 2019/10/17 19:24:50 ET
Table 'Sappho' 6-max Seat #6 is the button
Seat 1: xxzuluzuluxx ($1.84 in chips) 
Seat 2: crazy turfer ($28.47 in chips) 
Seat 3: TeterboroJCL ($8 in chips) 
Seat 4: 1212wjf ($9.85 in chips) 
Seat 5: EddieMoney9 ($12.16 in chips) 
Seat 6: PlayTheBlues4U ($9.01 in chips) 
xxzuluzuluxx: posts small blind $0.05
crazy turfer: posts big blind $0.10
TeterboroJCL: posts big blind $0.10
*** HOLE CARDS ***
Dealt to PlayTheBlues4U [Ah Jc]
TeterboroJCL: checks 
1212wjf: folds 
EddieMoney9: raises $0.35 to $0.45
PlayTheBlues4U: calls $0.45
xxzuluzuluxx: calls $0.40
crazy turfer: folds 
TeterboroJCL: folds 
*** FLOP *** [5h 9c Kc]
xxzuluzuluxx: checks 
EddieMoney9: checks 
PlayTheBlues4U: checks 
*** TURN *** [5h 9c Kc] [2h]
xxzuluzuluxx: bets $1.39 and is all-in
EddieMoney9: folds 
PlayTheBlues4U: folds 
Uncalled bet ($1.39) returned to xxzuluzuluxx
xxzuluzuluxx collected $1.47 from pot
xxzuluzuluxx: doesn't show hand 
*** SUMMARY ***
Total pot $1.55 | Rake $0.08 
Board [5h 9c Kc 2h]
Seat 1: xxzuluzuluxx (small blind) collected ($1.47)
Seat 2: crazy turfer (big blind) folded before Flop
Seat 3: TeterboroJCL folded before Flop (didn't bet)
Seat 4: 1212wjf folded before Flop (didn't bet)
Seat 5: EddieMoney9 folded on the Turn
Seat 6: PlayTheBlues4U (button) folded on the Turn



PokerStars Hand #204645694156:  Hold'em No Limit ($0.05/$0.10 USD) - 2019/10/17 19:25:52 ET
Table 'Sappho' 6-max Seat #1 is the button
Seat 1: xxzuluzuluxx ($2.86 in chips) 
Seat 2: crazy turfer ($28.37 in chips) 
Seat 3: TeterboroJCL ($7.90 in chips) 
Seat 4: 1212wjf ($9.85 in chips) 
Seat 5: EddieMoney9 ($11.71 in chips) 
Seat 6: PlayTheBlues4U ($8.56 in chips) 
crazy turfer: posts small blind $0.05
TeterboroJCL: posts big blind $0.10
*** HOLE CARDS ***
Dealt to PlayTheBlues4U [8c 7s]
1212wjf: folds 
EddieMoney9: folds 
PlayTheBlues4U: folds 
xxzuluzuluxx: folds 
crazy turfer: raises $0.10 to $0.20
TeterboroJCL: folds 
Uncalled bet ($0.10) returned to crazy turfer
crazy turfer collected $0.20 from pot
*** SUMMARY ***
Total pot $0.20 | Rake $0 
Seat 1: xxzuluzuluxx (button) folded before Flop (didn't bet)
Seat 2: crazy turfer (small blind) collected ($0.20)
Seat 3: TeterboroJCL (big blind) folded before Flop
Seat 4: 1212wjf folded before Flop (didn't bet)
Seat 5: EddieMoney9 folded before Flop (didn't bet)
Seat 6: PlayTheBlues4U folded before Flop (didn't bet)



PokerStars Hand #204645694189:  Hold'em No Limit ($0.05/$0.10 USD) - 2019/10/17 19:26:05 ET
Table 'Sappho' 6-max Seat #2 is the button
Seat 1: xxzuluzuluxx ($2.86 in chips) 
Seat 2: crazy turfer ($28.47 in chips) 
Seat 3: TeterboroJCL ($7.80 in chips) 
Seat 4: 1212wjf ($9.85 in chips) 
Seat 5: EddieMoney9 ($11.71 in chips) 
Seat 6: PlayTheBlues4U ($8.56 in chips) 
TeterboroJCL: posts small blind $0.05
1212wjf: posts big blind $0.10
*** HOLE CARDS ***
Dealt to PlayTheBlues4U [5d 8c]
EddieMoney9: folds 
PlayTheBlues4U: folds 
xxzuluzuluxx: calls $0.10
crazy turfer: calls $0.10
TeterboroJCL: calls $0.05
1212wjf: checks 
*** FLOP *** [Tc 5h 8h]
TeterboroJCL: checks 
1212wjf: bets $0.40
xxzuluzuluxx: calls $0.40
crazy turfer: calls $0.40
TeterboroJCL: folds 
*** TURN *** [Tc 5h 8h] [Ah]
1212wjf: checks 
xxzuluzuluxx: bets $0.40
crazy turfer: calls $0.40
1212wjf: folds 
*** RIVER *** [Tc 5h 8h Ah] [6h]
xxzuluzuluxx: bets $0.50
crazy turfer: raises $1.60 to $2.10
xxzuluzuluxx: folds [8d]
Uncalled bet ($1.60) returned to crazy turfer
crazy turfer collected $3.23 from pot
*** SUMMARY ***
Total pot $3.40 | Rake $0.17 
Board [Tc 5h 8h Ah 6h]
Seat 1: xxzuluzuluxx folded on the River
Seat 2: crazy turfer (button) collected ($3.23)
Seat 3: TeterboroJCL (small blind) folded on the Flop
Seat 4: 1212wjf (big blind) folded on the Turn
Seat 5: EddieMoney9 folded before Flop (didn't bet)
Seat 6: PlayTheBlues4U folded before Flop (didn't bet)



PokerStars Hand #204645694374:  Hold'em No Limit ($0.05/$0.10 USD) - 2019/10/17 19:27:16 ET
Table 'Sappho' 6-max Seat #3 is the button
Seat 1: xxzuluzuluxx ($1.46 in chips) 
Seat 2: crazy turfer ($30.30 in chips) 
Seat 3: TeterboroJCL ($7.70 in chips) 
Seat 4: 1212wjf ($9.35 in chips) 
Seat 5: EddieMoney9 ($11.71 in chips) 
Seat 6: PlayTheBlues4U ($8.56 in chips) 
1212wjf: posts small blind $0.05
EddieMoney9: posts big blind $0.10
*** HOLE CARDS ***
Dealt to PlayTheBlues4U [6d Ac]
PlayTheBlues4U: folds 
xxzuluzuluxx: folds 
crazy turfer: folds 
TeterboroJCL: folds 
1212wjf: folds 
Uncalled bet ($0.05) returned to EddieMoney9
EddieMoney9 collected $0.10 from pot
EddieMoney9: doesn't show hand 
*** SUMMARY ***
Total pot $0.10 | Rake $0 
Seat 1: xxzuluzuluxx folded before Flop (didn't bet)
Seat 2: crazy turfer folded before Flop (didn't bet)
Seat 3: TeterboroJCL (button) folded before Flop (didn't bet)
Seat 4: 1212wjf (small blind) folded before Flop
Seat 5: EddieMoney9 (big blind) collected ($0.10)
Seat 6: PlayTheBlues4U folded before Flop (didn't bet)



PokerStars Hand #204645694423:  Hold'em No Limit ($0.05/$0.10 USD) - 2019/10/17 19:27:33 ET
Table 'Sappho' 6-max Seat #4 is the button
Seat 1: xxzuluzuluxx ($1.46 in chips) 
Seat 2: crazy turfer ($30.30 in chips) 
Seat 3: TeterboroJCL ($7.70 in chips) 
Seat 4: 1212wjf ($9.30 in chips) 
Seat 5: EddieMoney9 ($11.76 in chips) 
Seat 6: PlayTheBlues4U ($8.56 in chips) 
EddieMoney9: posts small blind $0.05
PlayTheBlues4U: posts big blind $0.10
*** HOLE CARDS ***
Dealt to PlayTheBlues4U [2s 7c]
xxzuluzuluxx: calls $0.10
crazy turfer: folds 
TeterboroJCL: calls $0.10
1212wjf: folds 
EddieMoney9: calls $0.05
PlayTheBlues4U: checks 
*** FLOP *** [7h Qh Qc]
EddieMoney9: checks 
PlayTheBlues4U: bets $0.20
xxzuluzuluxx: folds 
TeterboroJCL: folds 
EddieMoney9: calls $0.20
*** TURN *** [7h Qh Qc] [6d]
EddieMoney9: checks 
PlayTheBlues4U: checks 
*** RIVER *** [7h Qh Qc 6d] [9s]
EddieMoney9: bets $0.70
PlayTheBlues4U: calls $0.70
*** SHOW DOWN ***
EddieMoney9: shows [Qd 2d] (three of a kind, Queens)
PlayTheBlues4U: mucks hand 
EddieMoney9 collected $2.09 from pot
*** SUMMARY ***
Total pot $2.20 | Rake $0.11 
Board [7h Qh Qc 6d 9s]
Seat 1: xxzuluzuluxx folded on the Flop
Seat 2: crazy turfer folded before Flop (didn't bet)
Seat 3: TeterboroJCL folded on the Flop
Seat 4: 1212wjf (button) folded before Flop (didn't bet)
Seat 5: EddieMoney9 (small blind) showed [Qd 2d] and won ($2.09) with three of a kind, Queens
Seat 6: PlayTheBlues4U (big blind) mucked [2s 7c]



PokerStars Hand #204645694626:  Hold'em No Limit ($0.05/$0.10 USD) - 2019/10/17 19:28:52 ET
Table 'Sappho' 6-max Seat #5 is the button
Seat 1: xxzuluzuluxx ($1.36 in chips) 
Seat 2: crazy turfer ($30.30 in chips) 
Seat 3: TeterboroJCL ($7.60 in chips) 
Seat 4: 1212wjf ($9.30 in chips) 
Seat 5: EddieMoney9 ($12.85 in chips) 
Seat 6: PlayTheBlues4U ($7.56 in chips) 
PlayTheBlues4U: posts small blind $0.05
xxzuluzuluxx: posts big blind $0.10
*** HOLE CARDS ***
Dealt to PlayTheBlues4U [Ts Qd]
crazy turfer: folds 
TeterboroJCL: folds 
1212wjf: folds 
EddieMoney9: folds 
PlayTheBlues4U: raises $0.10 to $0.20
xxzuluzuluxx: calls $0.10
*** FLOP *** [Jh 8d 9d]
PlayTheBlues4U: bets $0.30
xxzuluzuluxx: calls $0.30
*** TURN *** [Jh 8d 9d] [3c]
PlayTheBlues4U: bets $7.06 and is all-in
xxzuluzuluxx: calls $0.86 and is all-in
Uncalled bet ($6.20) returned to PlayTheBlues4U
*** RIVER *** [Jh 8d 9d 3c] [9c]
*** SHOW DOWN ***
PlayTheBlues4U: shows [Ts Qd] (a straight, Eight to Queen)
xxzuluzuluxx: shows [9h Qs] (three of a kind, Nines)
PlayTheBlues4U collected $2.58 from pot
*** SUMMARY ***
Total pot $2.72 | Rake $0.14 
Board [Jh 8d 9d 3c 9c]
Seat 1: xxzuluzuluxx (big blind) showed [9h Qs] and lost with three of a kind, Nines
Seat 2: crazy turfer folded before Flop (didn't bet)
Seat 3: TeterboroJCL folded before Flop (didn't bet)
Seat 4: 1212wjf folded before Flop (didn't bet)
Seat 5: EddieMoney9 (button) folded before Flop (didn't bet)
Seat 6: PlayTheBlues4U (small blind) showed [Ts Qd] and won ($2.58) with a straight, Eight to Queen



PokerStars Hand #204645694703:  Hold'em No Limit ($0.05/$0.10 USD) - 2019/10/17 19:29:25 ET
Table 'Sappho' 6-max Seat #6 is the button
Seat 2: crazy turfer ($30.30 in chips) 
Seat 3: TeterboroJCL ($7.60 in chips) 
Seat 4: 1212wjf ($9.30 in chips) 
Seat 5: EddieMoney9 ($12.85 in chips) 
Seat 6: PlayTheBlues4U ($8.78 in chips) 
crazy turfer: posts small blind $0.05
TeterboroJCL: posts big blind $0.10
*** HOLE CARDS ***
Dealt to PlayTheBlues4U [Kd Qs]
1212wjf: folds 
EddieMoney9: raises $0.20 to $0.30
PlayTheBlues4U: calls $0.30
crazy turfer: calls $0.25
TeterboroJCL: folds 
*** FLOP *** [7d 8h 4c]
crazy turfer: checks 
EddieMoney9: bets $0.67
PlayTheBlues4U: folds 
crazy turfer: calls $0.67
*** TURN *** [7d 8h 4c] [2d]
crazy turfer: checks 
EddieMoney9: bets $1.55
crazy turfer: calls $1.55
*** RIVER *** [7d 8h 4c 2d] [Kc]
crazy turfer: checks 
EddieMoney9: checks 
*** SHOW DOWN ***
crazy turfer: shows [7c Ad] (a pair of Sevens)
EddieMoney9: shows [Ac As] (a pair of Aces)
EddieMoney9 collected $5.17 from pot
*** SUMMARY ***
Total pot $5.44 | Rake $0.27 
Board [7d 8h 4c 2d Kc]
Seat 2: crazy turfer (small blind) showed [7c Ad] and lost with a pair of Sevens
Seat 3: TeterboroJCL (big blind) folded before Flop
Seat 4: 1212wjf folded before Flop (didn't bet)
Seat 5: EddieMoney9 showed [Ac As] and won ($5.17) with a pair of Aces
Seat 6: PlayTheBlues4U (button) folded on the Flop



PokerStars Hand #204645694866:  Hold'em No Limit ($0.05/$0.10 USD) - 2019/10/17 19:30:27 ET
Table 'Sappho' 6-max Seat #2 is the button
Seat 1: xxzuluzuluxx ($4 in chips) 
Seat 2: crazy turfer ($27.78 in chips) 
Seat 3: TeterboroJCL ($7.50 in chips) 
Seat 4: 1212wjf ($9.30 in chips) 
Seat 5: EddieMoney9 ($15.50 in chips) 
Seat 6: PlayTheBlues4U ($8.48 in chips) 
TeterboroJCL: posts small blind $0.05
1212wjf: posts big blind $0.10
xxzuluzuluxx: posts small blind $0.05
*** HOLE CARDS ***
Dealt to PlayTheBlues4U [5d 6d]
EddieMoney9: folds 
PlayTheBlues4U: folds 
xxzuluzuluxx: folds 
crazy turfer: folds 
TeterboroJCL: raises $0.10 to $0.20
1212wjf: folds 
Uncalled bet ($0.10) returned to TeterboroJCL
TeterboroJCL collected $0.25 from pot
TeterboroJCL: doesn't show hand 
*** SUMMARY ***
Total pot $0.25 | Rake $0 
Seat 1: xxzuluzuluxx folded before Flop (didn't bet)
Seat 2: crazy turfer (button) folded before Flop (didn't bet)
Seat 3: TeterboroJCL (small blind) collected ($0.25)
Seat 4: 1212wjf (big blind) folded before Flop
Seat 5: EddieMoney9 folded before Flop (didn't bet)
Seat 6: PlayTheBlues4U folded before Flop (didn't bet)



PokerStars Hand #204645694943:  Hold'em No Limit ($0.05/$0.10 USD) - 2019/10/17 19:30:57 ET
Table 'Sappho' 6-max Seat #3 is the button
Seat 1: xxzuluzuluxx ($3.95 in chips) 
Seat 2: crazy turfer ($27.78 in chips) 
Seat 3: TeterboroJCL ($7.65 in chips) 
Seat 4: 1212wjf ($9.20 in chips) 
Seat 5: EddieMoney9 ($15.50 in chips) 
Seat 6: PlayTheBlues4U ($8.48 in chips) 
1212wjf: posts small blind $0.05
EddieMoney9: posts big blind $0.10
*** HOLE CARDS ***
Dealt to PlayTheBlues4U [3s Ac]
PlayTheBlues4U: folds 
xxzuluzuluxx: folds 
crazy turfer: calls $0.10
TeterboroJCL: calls $0.10
1212wjf: folds 
EddieMoney9: checks 
*** FLOP *** [2d 2s 7c]
EddieMoney9: checks 
crazy turfer: bets $0.30
TeterboroJCL: calls $0.30
EddieMoney9: folds 
*** TURN *** [2d 2s 7c] [9s]
crazy turfer: bets $0.30
TeterboroJCL: calls $0.30
*** RIVER *** [2d 2s 7c 9s] [Ah]
crazy turfer: bets $0.30
TeterboroJCL: calls $0.30
*** SHOW DOWN ***
crazy turfer: shows [Js 7s] (two pair, Sevens and Deuces)
TeterboroJCL: shows [7h 6s] (two pair, Sevens and Deuces)
crazy turfer collected $1.02 from pot
TeterboroJCL collected $1.02 from pot
*** SUMMARY ***
Total pot $2.15 | Rake $0.11 
Board [2d 2s 7c 9s Ah]
Seat 1: xxzuluzuluxx folded before Flop (didn't bet)
Seat 2: crazy turfer showed [Js 7s] and won ($1.02) with two pair, Sevens and Deuces
Seat 3: TeterboroJCL (button) showed [7h 6s] and won ($1.02) with two pair, Sevens and Deuces
Seat 4: 1212wjf (small blind) folded before Flop
Seat 5: EddieMoney9 (big blind) folded on the Flop
Seat 6: PlayTheBlues4U folded before Flop (didn't bet)



PokerStars Hand #204645695115:  Hold'em No Limit ($0.05/$0.10 USD) - 2019/10/17 19:32:03 ET
Table 'Sappho' 6-max Seat #4 is the button
Seat 1: xxzuluzuluxx ($3.95 in chips) 
Seat 2: crazy turfer ($27.80 in chips) 
Seat 3: TeterboroJCL ($7.67 in chips) 
Seat 4: 1212wjf ($9.15 in chips) 
Seat 5: EddieMoney9 ($15.40 in chips) 
Seat 6: PlayTheBlues4U ($8.48 in chips) 
EddieMoney9: posts small blind $0.05
PlayTheBlues4U: posts big blind $0.10
*** HOLE CARDS ***
Dealt to PlayTheBlues4U [7d Td]
xxzuluzuluxx: calls $0.10
crazy turfer: folds 
TeterboroJCL: folds 
1212wjf: raises $0.35 to $0.45
EddieMoney9: folds 
PlayTheBlues4U: folds 
xxzuluzuluxx: calls $0.35
*** FLOP *** [4h Ac 6s]
xxzuluzuluxx: checks 
1212wjf: bets $0.50
xxzuluzuluxx: folds 
Uncalled bet ($0.50) returned to 1212wjf
1212wjf collected $1 from pot
1212wjf: doesn't show hand 
*** SUMMARY ***
Total pot $1.05 | Rake $0.05 
Board [4h Ac 6s]
Seat 1: xxzuluzuluxx folded on the Flop
Seat 2: crazy turfer folded before Flop (didn't bet)
Seat 3: TeterboroJCL folded before Flop (didn't bet)
Seat 4: 1212wjf (button) collected ($1)
Seat 5: EddieMoney9 (small blind) folded before Flop
Seat 6: PlayTheBlues4U (big blind) folded before Flop



PokerStars Hand #204645695165:  Hold'em No Limit ($0.05/$0.10 USD) - 2019/10/17 19:32:26 ET
Table 'Sappho' 6-max Seat #5 is the button
Seat 1: xxzuluzuluxx ($3.50 in chips) 
Seat 2: crazy turfer ($27.80 in chips) 
Seat 3: TeterboroJCL ($7.67 in chips) 
Seat 4: 1212wjf ($9.70 in chips) 
Seat 5: EddieMoney9 ($15.35 in chips) 
Seat 6: PlayTheBlues4U ($8.38 in chips) 
PlayTheBlues4U: posts small blind $0.05
xxzuluzuluxx: posts big blind $0.10
*** HOLE CARDS ***
Dealt to PlayTheBlues4U [Jc Qd]
crazy turfer: folds 
TeterboroJCL: folds 
1212wjf: calls $0.10
EddieMoney9: folds 
PlayTheBlues4U: raises $0.20 to $0.30
xxzuluzuluxx: calls $0.20
1212wjf: folds 
*** FLOP *** [Qs 5s 6s]
PlayTheBlues4U: bets $0.50
xxzuluzuluxx: folds 
Uncalled bet ($0.50) returned to PlayTheBlues4U
PlayTheBlues4U collected $0.66 from pot
PlayTheBlues4U: doesn't show hand 
*** SUMMARY ***
Total pot $0.70 | Rake $0.04 
Board [Qs 5s 6s]
Seat 1: xxzuluzuluxx (big blind) folded on the Flop
Seat 2: crazy turfer folded before Flop (didn't bet)
Seat 3: TeterboroJCL folded before Flop (didn't bet)
Seat 4: 1212wjf folded before Flop
Seat 5: EddieMoney9 (button) folded before Flop (didn't bet)
Seat 6: PlayTheBlues4U (small blind) collected ($0.66)



PokerStars Hand #204645695258:  Hold'em No Limit ($0.05/$0.10 USD) - 2019/10/17 19:33:00 ET
Table 'Sappho' 6-max Seat #6 is the button
Seat 1: xxzuluzuluxx ($3.20 in chips) 
Seat 2: crazy turfer ($27.80 in chips) 
Seat 3: TeterboroJCL ($7.67 in chips) 
Seat 4: 1212wjf ($9.60 in chips) 
Seat 5: EddieMoney9 ($15.35 in chips) 
Seat 6: PlayTheBlues4U ($8.74 in chips) 
xxzuluzuluxx: posts small blind $0.05
crazy turfer: posts big blind $0.10
*** HOLE CARDS ***
Dealt to PlayTheBlues4U [7h 8h]
TeterboroJCL: folds 
1212wjf: raises $0.25 to $0.35
EddieMoney9: folds 
PlayTheBlues4U: folds 
xxzuluzuluxx: calls $0.30
crazy turfer: folds 
*** FLOP *** [Qs 4c 3h]
xxzuluzuluxx: checks 
1212wjf: bets $0.40
xxzuluzuluxx: raises $0.40 to $0.80
1212wjf: folds 
Uncalled bet ($0.40) returned to xxzuluzuluxx
xxzuluzuluxx collected $1.52 from pot
xxzuluzuluxx: doesn't show hand 
*** SUMMARY ***
Total pot $1.60 | Rake $0.08 
Board [Qs 4c 3h]
Seat 1: xxzuluzuluxx (small blind) collected ($1.52)
Seat 2: crazy turfer (big blind) folded before Flop
Seat 3: TeterboroJCL folded before Flop (didn't bet)
Seat 4: 1212wjf folded on the Flop
Seat 5: EddieMoney9 folded before Flop (didn't bet)
Seat 6: PlayTheBlues4U (button) folded before Flop (didn't bet)



PokerStars Hand #204645695341:  Hold'em No Limit ($0.05/$0.10 USD) - 2019/10/17 19:33:34 ET
Table 'Sappho' 6-max Seat #1 is the button
Seat 1: xxzuluzuluxx ($3.97 in chips) 
Seat 2: crazy turfer ($27.70 in chips) 
Seat 3: TeterboroJCL ($7.67 in chips) 
Seat 4: 1212wjf ($8.85 in chips) 
Seat 5: EddieMoney9 ($15.35 in chips) 
Seat 6: PlayTheBlues4U ($8.74 in chips) 
crazy turfer: posts small blind $0.05
TeterboroJCL: posts big blind $0.10
*** HOLE CARDS ***
Dealt to PlayTheBlues4U [9s 7s]
1212wjf: calls $0.10
EddieMoney9: folds 
PlayTheBlues4U: raises $0.30 to $0.40
xxzuluzuluxx: folds 
crazy turfer: calls $0.35
TeterboroJCL: folds 
1212wjf: calls $0.30
*** FLOP *** [Qs 3s Jd]
crazy turfer: checks 
1212wjf: bets $0.60
PlayTheBlues4U: calls $0.60
crazy turfer: calls $0.60
*** TURN *** [Qs 3s Jd] [8h]
crazy turfer: checks 
1212wjf: bets $1.50
PlayTheBlues4U: calls $1.50
crazy turfer: calls $1.50
*** RIVER *** [Qs 3s Jd 8h] [Js]
crazy turfer: checks 
1212wjf: checks 
PlayTheBlues4U: bets $3.30
crazy turfer: folds 
1212wjf: calls $3.30
*** SHOW DOWN ***
PlayTheBlues4U: shows [9s 7s] (a flush, Queen high)
1212wjf: mucks hand 
PlayTheBlues4U collected $13.49 from pot
*** SUMMARY ***
Total pot $14.20 | Rake $0.71 
Board [Qs 3s Jd 8h Js]
Seat 1: xxzuluzuluxx (button) folded before Flop (didn't bet)
Seat 2: crazy turfer (small blind) folded on the River
Seat 3: TeterboroJCL (big blind) folded before Flop
Seat 4: 1212wjf mucked [Qh Ts]
Seat 5: EddieMoney9 folded before Flop (didn't bet)
Seat 6: PlayTheBlues4U showed [9s 7s] and won ($13.49) with a flush, Queen high



PokerStars Hand #204645695569:  Hold'em No Limit ($0.05/$0.10 USD) - 2019/10/17 19:35:06 ET
Table 'Sappho' 6-max Seat #2 is the button
Seat 1: xxzuluzuluxx ($3.97 in chips) 
Seat 2: crazy turfer ($25.20 in chips) 
Seat 3: TeterboroJCL ($7.57 in chips) 
Seat 5: EddieMoney9 ($15.35 in chips) 
Seat 6: PlayTheBlues4U ($16.43 in chips) 
TeterboroJCL: posts small blind $0.05
1212wjf: is sitting out 
EddieMoney9: posts big blind $0.10
*** HOLE CARDS ***
Dealt to PlayTheBlues4U [9c 2c]
PlayTheBlues4U: folds 
xxzuluzuluxx: calls $0.10
crazy turfer: calls $0.10
1212wjf leaves the table
havea69vette joins the table at seat #4 
TeterboroJCL: calls $0.05
EddieMoney9: checks 
*** FLOP *** [Kh Ah 7d]
TeterboroJCL: checks 
EddieMoney9: bets $0.27
xxzuluzuluxx: calls $0.27
crazy turfer: folds 
TeterboroJCL: folds 
*** TURN *** [Kh Ah 7d] [5s]
EddieMoney9: bets $0.36
xxzuluzuluxx: folds 
Uncalled bet ($0.36) returned to EddieMoney9
EddieMoney9 collected $0.89 from pot
EddieMoney9: doesn't show hand 
*** SUMMARY ***
Total pot $0.94 | Rake $0.05 
Board [Kh Ah 7d 5s]
Seat 1: xxzuluzuluxx folded on the Turn
Seat 2: crazy turfer (button) folded on the Flop
Seat 3: TeterboroJCL (small blind) folded on the Flop
Seat 5: EddieMoney9 (big blind) collected ($0.89)
Seat 6: PlayTheBlues4U folded before Flop (didn't bet)



PokerStars Hand #204645695692:  Hold'em No Limit ($0.05/$0.10 USD) - 2019/10/17 19:35:50 ET
Table 'Sappho' 6-max Seat #3 is the button
Seat 1: xxzuluzuluxx ($3.60 in chips) 
Seat 2: crazy turfer ($25.10 in chips) 
Seat 3: TeterboroJCL ($7.47 in chips) 
Seat 5: EddieMoney9 ($15.87 in chips) 
Seat 6: PlayTheBlues4U ($16.43 in chips) 
EddieMoney9: posts small blind $0.05
PlayTheBlues4U: posts big blind $0.10
*** HOLE CARDS ***
Dealt to PlayTheBlues4U [6h Jd]
xxzuluzuluxx: folds 
crazy turfer: folds 
TeterboroJCL: folds 
EddieMoney9: folds 
Uncalled bet ($0.05) returned to PlayTheBlues4U
PlayTheBlues4U collected $0.10 from pot
PlayTheBlues4U: doesn't show hand 
*** SUMMARY ***
Total pot $0.10 | Rake $0 
Seat 1: xxzuluzuluxx folded before Flop (didn't bet)
Seat 2: crazy turfer folded before Flop (didn't bet)
Seat 3: TeterboroJCL (button) folded before Flop (didn't bet)
Seat 5: EddieMoney9 (small blind) folded before Flop
Seat 6: PlayTheBlues4U (big blind) collected ($0.10)



PokerStars Hand #204645695724:  Hold'em No Limit ($0.05/$0.10 USD) - 2019/10/17 19:36:03 ET
Table 'Sappho' 6-max Seat #5 is the button
Seat 2: crazy turfer ($25.10 in chips) 
Seat 3: TeterboroJCL ($7.47 in chips) 
Seat 5: EddieMoney9 ($15.82 in chips) 
Seat 6: PlayTheBlues4U ($16.48 in chips) 
PlayTheBlues4U: posts small blind $0.05
crazy turfer: posts big blind $0.10
havea69vette: sits out 
*** HOLE CARDS ***
Dealt to PlayTheBlues4U [Jc 8d]
TeterboroJCL: folds 
EddieMoney9: folds 
PlayTheBlues4U: folds 
Uncalled bet ($0.05) returned to crazy turfer
crazy turfer collected $0.10 from pot
*** SUMMARY ***
Total pot $0.10 | Rake $0 
Seat 2: crazy turfer (big blind) collected ($0.10)
Seat 3: TeterboroJCL folded before Flop (didn't bet)
Seat 5: EddieMoney9 (button) folded before Flop (didn't bet)
Seat 6: PlayTheBlues4U (small blind) folded before Flop



PokerStars Hand #204645695763:  Hold'em No Limit ($0.05/$0.10 USD) - 2019/10/17 19:36:18 ET
Table 'Sappho' 6-max Seat #6 is the button
Seat 2: crazy turfer ($25.15 in chips) 
Seat 3: TeterboroJCL ($7.47 in chips) 
Seat 5: EddieMoney9 ($15.82 in chips) 
Seat 6: PlayTheBlues4U ($16.43 in chips) 
crazy turfer: posts small blind $0.05
TeterboroJCL: posts big blind $0.10
havea69vette: sits out 
*** HOLE CARDS ***
Dealt to PlayTheBlues4U [Td 6c]
EddieMoney9: folds 
PlayTheBlues4U: folds 
crazy turfer: calls $0.05
TeterboroJCL: raises $0.20 to $0.30
crazy turfer: calls $0.20
*** FLOP *** [Th Kd Qh]
crazy turfer: bets $0.20
TeterboroJCL: raises $0.49 to $0.69
crazy turfer: calls $0.49
*** TURN *** [Th Kd Qh] [As]
crazy turfer: checks 
TeterboroJCL: bets $1
crazy turfer: calls $1
*** RIVER *** [Th Kd Qh As] [7s]
crazy turfer: checks 
TeterboroJCL: checks 
*** SHOW DOWN ***
crazy turfer: shows [3h 6h] (high card Ace)
TeterboroJCL: shows [Ah Qs] (two pair, Aces and Queens)
TeterboroJCL collected $3.78 from pot
*** SUMMARY ***
Total pot $3.98 | Rake $0.20 
Board [Th Kd Qh As 7s]
Seat 2: crazy turfer (small blind) showed [3h 6h] and lost with high card Ace
Seat 3: TeterboroJCL (big blind) showed [Ah Qs] and won ($3.78) with two pair, Aces and Queens
Seat 5: EddieMoney9 folded before Flop (didn't bet)
Seat 6: PlayTheBlues4U (button) folded before Flop (didn't bet)



PokerStars Hand #204645695938:  Hold'em No Limit ($0.05/$0.10 USD) - 2019/10/17 19:37:25 ET
Table 'Sappho' 6-max Seat #2 is the button
Seat 2: crazy turfer ($23.16 in chips) 
Seat 3: TeterboroJCL ($9.26 in chips) 
Seat 4: havea69vette ($10.10 in chips) 
Seat 5: EddieMoney9 ($15.82 in chips) 
Seat 6: PlayTheBlues4U ($16.43 in chips) 
TeterboroJCL: posts small blind $0.05
havea69vette: posts big blind $0.10
*** HOLE CARDS ***
Dealt to PlayTheBlues4U [Ks 9s]
EddieMoney9: folds 
PlayTheBlues4U: folds 
crazy turfer: calls $0.10
TeterboroJCL: folds 
havea69vette: checks 
*** FLOP *** [Ah 6s Jh]
havea69vette: checks 
crazy turfer: bets $0.10
havea69vette: folds 
Uncalled bet ($0.10) returned to crazy turfer
crazy turfer collected $0.24 from pot
*** SUMMARY ***
Total pot $0.25 | Rake $0.01 
Board [Ah 6s Jh]
Seat 2: crazy turfer (button) collected ($0.24)
Seat 3: TeterboroJCL (small blind) folded before Flop
Seat 4: havea69vette (big blind) folded on the Flop
Seat 5: EddieMoney9 folded before Flop (didn't bet)
Seat 6: PlayTheBlues4U folded before Flop (didn't bet)



PokerStars Hand #204645695994:  Hold'em No Limit ($0.05/$0.10 USD) - 2019/10/17 19:37:46 ET
Table 'Sappho' 6-max Seat #3 is the button
Seat 2: crazy turfer ($23.30 in chips) 
Seat 3: TeterboroJCL ($9.21 in chips) 
Seat 4: havea69vette ($10 in chips) 
Seat 5: EddieMoney9 ($15.82 in chips) 
Seat 6: PlayTheBlues4U ($16.43 in chips) 
havea69vette: posts small blind $0.05
EddieMoney9: posts big blind $0.10
*** HOLE CARDS ***
Dealt to PlayTheBlues4U [2s As]
PlayTheBlues4U: folds 
crazy turfer: folds 
crazy turfer leaves the table
TeterboroJCL: folds 
havea69vette: folds 
Uncalled bet ($0.05) returned to EddieMoney9
EddieMoney9 collected $0.10 from pot
EddieMoney9: doesn't show hand 
*** SUMMARY ***
Total pot $0.10 | Rake $0 
Seat 2: crazy turfer folded before Flop (didn't bet)
Seat 3: TeterboroJCL (button) folded before Flop (didn't bet)
Seat 4: havea69vette (small blind) folded before Flop
Seat 5: EddieMoney9 (big blind) collected ($0.10)
Seat 6: PlayTheBlues4U folded before Flop (didn't bet)



PokerStars Hand #204645696047:  Hold'em No Limit ($0.05/$0.10 USD) - 2019/10/17 19:38:06 ET
Table 'Sappho' 6-max Seat #4 is the button
Seat 3: TeterboroJCL ($9.21 in chips) 
Seat 4: havea69vette ($10 in chips) 
Seat 5: EddieMoney9 ($15.87 in chips) 
Seat 6: PlayTheBlues4U ($16.43 in chips) 
EddieMoney9: posts small blind $0.05
PlayTheBlues4U: posts big blind $0.10
*** HOLE CARDS ***
Dealt to PlayTheBlues4U [8h 5s]
TeterboroJCL: raises $0.20 to $0.30
havea69vette: calls $0.30
EddieMoney9: folds 
PlayTheBlues4U: folds 
*** FLOP *** [Jc 4s 8s]
TeterboroJCL: bets $0.36
havea69vette: raises $1.43 to $1.79
TeterboroJCL: calls $1.43
*** TURN *** [Jc 4s 8s] [4h]
TeterboroJCL: checks 
havea69vette: bets $2.06
TeterboroJCL: raises $5.06 to $7.12 and is all-in
havea69vette: calls $5.06
*** RIVER *** [Jc 4s 8s 4h] [7s]
*** SHOW DOWN ***
TeterboroJCL: shows [Jd Qd] (two pair, Jacks and Fours)
havea69vette: shows [Js Qc] (two pair, Jacks and Fours)
TeterboroJCL collected $8.82 from pot
havea69vette collected $8.82 from pot
*** SUMMARY ***
Total pot $18.57 | Rake $0.93 
Board [Jc 4s 8s 4h 7s]
Seat 3: TeterboroJCL showed [Jd Qd] and won ($8.82) with two pair, Jacks and Fours
Seat 4: havea69vette (button) showed [Js Qc] and won ($8.82) with two pair, Jacks and Fours
Seat 5: EddieMoney9 (small blind) folded before Flop
Seat 6: PlayTheBlues4U (big blind) folded before Flop



PokerStars Hand #204645696193:  Hold'em No Limit ($0.05/$0.10 USD) - 2019/10/17 19:39:01 ET
Table 'Sappho' 6-max Seat #5 is the button
Seat 1: xxzuluzuluxx ($3.60 in chips) 
Seat 3: TeterboroJCL ($8.82 in chips) 
Seat 4: havea69vette ($10 in chips) 
Seat 5: EddieMoney9 ($15.82 in chips) 
Seat 6: PlayTheBlues4U ($16.33 in chips) 
PlayTheBlues4U: posts small blind $0.05
xxzuluzuluxx: posts big blind $0.10
*** HOLE CARDS ***
Dealt to PlayTheBlues4U [2s 9d]
TeterboroJCL: raises $0.10 to $0.20
havea69vette: calls $0.20
EddieMoney9: folds 
PlayTheBlues4U: folds 
xxzuluzuluxx: calls $0.10
*** FLOP *** [Kc 3c Js]
xxzuluzuluxx: checks 
TeterboroJCL: checks 
havea69vette: bets $0.62
xxzuluzuluxx: folds 
TeterboroJCL: folds 
Uncalled bet ($0.62) returned to havea69vette
havea69vette collected $0.62 from pot
havea69vette: doesn't show hand 
*** SUMMARY ***
Total pot $0.65 | Rake $0.03 
Board [Kc 3c Js]
Seat 1: xxzuluzuluxx (big blind) folded on the Flop
Seat 3: TeterboroJCL folded on the Flop
Seat 4: havea69vette collected ($0.62)
Seat 5: EddieMoney9 (button) folded before Flop (didn't bet)
Seat 6: PlayTheBlues4U (small blind) folded before Flop



PokerStars Hand #204645696335:  Hold'em No Limit ($0.05/$0.10 USD) - 2019/10/17 19:39:53 ET
Table 'Sappho' 6-max Seat #6 is the button
Seat 1: xxzuluzuluxx ($3.40 in chips) 
Seat 3: TeterboroJCL ($8.62 in chips) 
Seat 4: havea69vette ($10.42 in chips) 
Seat 5: EddieMoney9 ($15.82 in chips) 
Seat 6: PlayTheBlues4U ($16.28 in chips) 
xxzuluzuluxx: posts small blind $0.05
TeterboroJCL: posts big blind $0.10
*** HOLE CARDS ***
Dealt to PlayTheBlues4U [8s 8h]
havea69vette: raises $0.25 to $0.35
EddieMoney9: folds 
PlayTheBlues4U: calls $0.35
xxzuluzuluxx: folds 
TeterboroJCL: folds 
*** FLOP *** [Ac 8d 3h]
havea69vette: bets $0.81
PlayTheBlues4U: calls $0.81
*** TURN *** [Ac 8d 3h] [Td]
davetass joins the table at seat #2 
havea69vette: checks 
PlayTheBlues4U: bets $1.90
havea69vette: folds 
Uncalled bet ($1.90) returned to PlayTheBlues4U
PlayTheBlues4U collected $2.35 from pot
PlayTheBlues4U: doesn't show hand 
*** SUMMARY ***
Total pot $2.47 | Rake $0.12 
Board [Ac 8d 3h Td]
Seat 1: xxzuluzuluxx (small blind) folded before Flop
Seat 3: TeterboroJCL (big blind) folded before Flop
Seat 4: havea69vette folded on the Turn
Seat 5: EddieMoney9 folded before Flop (didn't bet)
Seat 6: PlayTheBlues4U (button) collected ($2.35)



PokerStars Hand #204645696461:  Hold'em No Limit ($0.05/$0.10 USD) - 2019/10/17 19:40:41 ET
Table 'Sappho' 6-max Seat #1 is the button
Seat 1: xxzuluzuluxx ($3.35 in chips) 
Seat 3: TeterboroJCL ($8.52 in chips) 
Seat 4: havea69vette ($10 in chips) 
Seat 5: EddieMoney9 ($15.82 in chips) 
Seat 6: PlayTheBlues4U ($17.47 in chips) 
TeterboroJCL: posts small blind $0.05
havea69vette: posts big blind $0.10
*** HOLE CARDS ***
Dealt to PlayTheBlues4U [6s 8d]
EddieMoney9: folds 
PlayTheBlues4U: folds 
xxzuluzuluxx: folds 
TeterboroJCL: folds 
Uncalled bet ($0.05) returned to havea69vette
havea69vette collected $0.10 from pot
havea69vette: doesn't show hand 
*** SUMMARY ***
Total pot $0.10 | Rake $0 
Seat 1: xxzuluzuluxx (button) folded before Flop (didn't bet)
Seat 3: TeterboroJCL (small blind) folded before Flop
Seat 4: havea69vette (big blind) collected ($0.10)
Seat 5: EddieMoney9 folded before Flop (didn't bet)
Seat 6: PlayTheBlues4U folded before Flop (didn't bet)



PokerStars Hand #204846334862:  Hold'em No Limit ($0.05/$0.10 USD) - 2019/10/21 20:52:13 ET
Table 'Draco' 6-max Seat #3 is the button
Seat 3: PlayTheBlues4U ($10 in chips) 
Seat 5: Klytu ($10 in chips) 
Seat 6: skillzplumber ($9 in chips) 
Klytu: posts small blind $0.05
skillzplumber: posts big blind $0.10
*** HOLE CARDS ***
Dealt to PlayTheBlues4U [Ah Td]
PlayTheBlues4U: raises $0.20 to $0.30
Klytu: folds 
skillzplumber: folds 
Uncalled bet ($0.20) returned to PlayTheBlues4U
PlayTheBlues4U collected $0.25 from pot
PlayTheBlues4U: doesn't show hand 
*** SUMMARY ***
Total pot $0.25 | Rake $0 
Seat 3: PlayTheBlues4U (button) collected ($0.25)
Seat 5: Klytu (small blind) folded before Flop
Seat 6: skillzplumber (big blind) folded before Flop



PokerStars Hand #204846334918:  Hold'em No Limit ($0.05/$0.10 USD) - 2019/10/21 20:52:25 ET
Table 'Draco' 6-max Seat #5 is the button
Seat 3: PlayTheBlues4U ($10.15 in chips) 
Seat 5: Klytu ($9.95 in chips) 
Seat 6: skillzplumber ($8.90 in chips) 
skillzplumber: posts small blind $0.05
PlayTheBlues4U: posts big blind $0.10
*** HOLE CARDS ***
Dealt to PlayTheBlues4U [As 7h]
Klytu: raises $0.15 to $0.25
skillzplumber: calls $0.20
PlayTheBlues4U: calls $0.15
*** FLOP *** [9c 3c Qh]
skillzplumber: checks 
PlayTheBlues4U: checks 
Klytu: bets $0.40
skillzplumber: calls $0.40
PlayTheBlues4U: folds 
*** TURN *** [9c 3c Qh] [Qs]
skillzplumber: bets $1.10
Klytu: folds 
Uncalled bet ($1.10) returned to skillzplumber
skillzplumber collected $1.47 from pot
skillzplumber: doesn't show hand 
*** SUMMARY ***
Total pot $1.55 | Rake $0.08 
Board [9c 3c Qh Qs]
Seat 3: PlayTheBlues4U (big blind) folded on the Flop
Seat 5: Klytu (button) folded on the Turn
Seat 6: skillzplumber (small blind) collected ($1.47)



PokerStars Hand #204846335065:  Hold'em No Limit ($0.05/$0.10 USD) - 2019/10/21 20:53:00 ET
Table 'Draco' 6-max Seat #6 is the button
Seat 3: PlayTheBlues4U ($9.90 in chips) 
Seat 5: Klytu ($9.30 in chips) 
Seat 6: skillzplumber ($9.72 in chips) 
PlayTheBlues4U: posts small blind $0.05
Klytu: posts big blind $0.10
*** HOLE CARDS ***
Dealt to PlayTheBlues4U [Jh 2s]
skillzplumber: folds 
PlayTheBlues4U: folds 
Uncalled bet ($0.05) returned to Klytu
Klytu collected $0.10 from pot
Klytu: doesn't show hand 
*** SUMMARY ***
Total pot $0.10 | Rake $0 
Seat 3: PlayTheBlues4U (small blind) folded before Flop
Seat 5: Klytu (big blind) collected ($0.10)
Seat 6: skillzplumber (button) folded before Flop (didn't bet)



PokerStars Hand #204846335122:  Hold'em No Limit ($0.05/$0.10 USD) - 2019/10/21 20:53:12 ET
Table 'Draco' 6-max Seat #3 is the button
Seat 3: PlayTheBlues4U ($9.85 in chips) 
Seat 5: Klytu ($9.35 in chips) 
Seat 6: skillzplumber ($9.72 in chips) 
Klytu: posts small blind $0.05
skillzplumber: posts big blind $0.10
*** HOLE CARDS ***
Dealt to PlayTheBlues4U [9s Ah]
PlayTheBlues4U: raises $0.20 to $0.30
Klytu: calls $0.25
skillzplumber: calls $0.20
*** FLOP *** [2c Kc Jh]
Klytu: checks 
skillzplumber: checks 
PlayTheBlues4U: checks 
*** TURN *** [2c Kc Jh] [Tc]
Klytu: bets $0.45
skillzplumber: raises $0.45 to $0.90
123tiger711a joins the table at seat #1 
PlayTheBlues4U: folds 
Klytu: folds 
Uncalled bet ($0.45) returned to skillzplumber
skillzplumber collected $1.71 from pot
skillzplumber: doesn't show hand 
*** SUMMARY ***
Total pot $1.80 | Rake $0.09 
Board [2c Kc Jh Tc]
Seat 3: PlayTheBlues4U (button) folded on the Turn
Seat 5: Klytu (small blind) folded on the Turn
Seat 6: skillzplumber (big blind) collected ($1.71)



PokerStars Hand #204846335343:  Hold'em No Limit ($0.05/$0.10 USD) - 2019/10/21 20:54:02 ET
Table 'Draco' 6-max Seat #5 is the button
Seat 1: 123tiger711a ($10 in chips) 
Seat 3: PlayTheBlues4U ($9.55 in chips) 
Seat 5: Klytu ($8.60 in chips) 
Seat 6: skillzplumber ($10.68 in chips) 
skillzplumber: posts small blind $0.05
123tiger711a: posts big blind $0.10
*** HOLE CARDS ***
Dealt to PlayTheBlues4U [9d 6s]
PlayTheBlues4U: folds 
Klytu: raises $0.15 to $0.25
skillzplumber: folds 
123tiger711a: calls $0.15
*** FLOP *** [6c Qs Jh]
123tiger711a: checks 
Klytu: bets $0.30
123tiger711a: calls $0.30
*** TURN *** [6c Qs Jh] [8s]
123tiger711a: checks 
Klytu: checks 
*** RIVER *** [6c Qs Jh 8s] [9s]
123tiger711a: bets $0.55
Klytu: folds 
Uncalled bet ($0.55) returned to 123tiger711a
123tiger711a collected $1.09 from pot
*** SUMMARY ***
Total pot $1.15 | Rake $0.06 
Board [6c Qs Jh 8s 9s]
Seat 1: 123tiger711a (big blind) collected ($1.09)
Seat 3: PlayTheBlues4U folded before Flop (didn't bet)
Seat 5: Klytu (button) folded on the River
Seat 6: skillzplumber (small blind) folded before Flop



PokerStars Hand #204846335452:  Hold'em No Limit ($0.05/$0.10 USD) - 2019/10/21 20:54:26 ET
Table 'Draco' 6-max Seat #6 is the button
Seat 1: 123tiger711a ($10.54 in chips) 
Seat 3: PlayTheBlues4U ($9.55 in chips) 
Seat 5: Klytu ($8.05 in chips) 
Seat 6: skillzplumber ($10.63 in chips) 
123tiger711a: posts small blind $0.05
PlayTheBlues4U: posts big blind $0.10
*** HOLE CARDS ***
Dealt to PlayTheBlues4U [Ac 2h]
Klytu: raises $0.20 to $0.30
skillzplumber: folds 
123tiger711a: folds 
PlayTheBlues4U: calls $0.20
*** FLOP *** [8h 4c 8s]
PlayTheBlues4U: checks 
Klytu: checks 
*** TURN *** [8h 4c 8s] [Qs]
PlayTheBlues4U: bets $0.40
Klytu: folds 
Uncalled bet ($0.40) returned to PlayTheBlues4U
PlayTheBlues4U collected $0.62 from pot
PlayTheBlues4U: doesn't show hand 
*** SUMMARY ***
Total pot $0.65 | Rake $0.03 
Board [8h 4c 8s Qs]
Seat 1: 123tiger711a (small blind) folded before Flop
Seat 3: PlayTheBlues4U (big blind) collected ($0.62)
Seat 5: Klytu folded on the Turn
Seat 6: skillzplumber (button) folded before Flop (didn't bet)



PokerStars Hand #204846335580:  Hold'em No Limit ($0.05/$0.10 USD) - 2019/10/21 20:54:56 ET
Table 'Draco' 6-max Seat #1 is the button
Seat 1: 123tiger711a ($10.49 in chips) 
Seat 3: PlayTheBlues4U ($9.87 in chips) 
Seat 5: Klytu ($7.75 in chips) 
Seat 6: skillzplumber ($10.63 in chips) 
PlayTheBlues4U: posts small blind $0.05
Klytu: posts big blind $0.10
*** HOLE CARDS ***
Dealt to PlayTheBlues4U [6d Ts]
skillzplumber: folds 
123tiger711a: calls $0.10
PlayTheBlues4U: folds 
Klytu: checks 
*** FLOP *** [3d 2s 8c]
Klytu: bets $0.15
123tiger711a: calls $0.15
*** TURN *** [3d 2s 8c] [Js]
Klytu: checks 
123tiger711a: checks 
*** RIVER *** [3d 2s 8c Js] [Jc]
Klytu: checks 
123tiger711a: checks 
*** SHOW DOWN ***
Klytu: shows [2c Ks] (two pair, Jacks and Deuces)
123tiger711a: shows [2h Ah] (two pair, Jacks and Deuces - Ace kicker)
123tiger711a collected $0.52 from pot
*** SUMMARY ***
Total pot $0.55 | Rake $0.03 
Board [3d 2s 8c Js Jc]
Seat 1: 123tiger711a (button) showed [2h Ah] and won ($0.52) with two pair, Jacks and Deuces
Seat 3: PlayTheBlues4U (small blind) folded before Flop
Seat 5: Klytu (big blind) showed [2c Ks] and lost with two pair, Jacks and Deuces
Seat 6: skillzplumber folded before Flop (didn't bet)



PokerStars Hand #204846335665:  Hold'em No Limit ($0.05/$0.10 USD) - 2019/10/21 20:55:18 ET
Table 'Draco' 6-max Seat #3 is the button
Seat 1: 123tiger711a ($10.76 in chips) 
Seat 3: PlayTheBlues4U ($9.82 in chips) 
Seat 5: Klytu ($7.50 in chips) 
Seat 6: skillzplumber ($10.63 in chips) 
Klytu: posts small blind $0.05
skillzplumber: posts big blind $0.10
*** HOLE CARDS ***
Dealt to PlayTheBlues4U [9s 5d]
123tiger711a: calls $0.10
PlayTheBlues4U: folds 
Klytu: folds 
skillzplumber: checks 
*** FLOP *** [Ad Td As]
skillzplumber: checks 
123tiger711a: bets $0.12
skillzplumber: folds 
Uncalled bet ($0.12) returned to 123tiger711a
123tiger711a collected $0.24 from pot
*** SUMMARY ***
Total pot $0.25 | Rake $0.01 
Board [Ad Td As]
Seat 1: 123tiger711a collected ($0.24)
Seat 3: PlayTheBlues4U (button) folded before Flop (didn't bet)
Seat 5: Klytu (small blind) folded before Flop
Seat 6: skillzplumber (big blind) folded on the Flop



PokerStars Hand #204846335728:  Hold'em No Limit ($0.05/$0.10 USD) - 2019/10/21 20:55:37 ET
Table 'Draco' 6-max Seat #5 is the button
Seat 1: 123tiger711a ($10.90 in chips) 
Seat 3: PlayTheBlues4U ($9.82 in chips) 
Seat 5: Klytu ($7.45 in chips) 
Seat 6: skillzplumber ($10.53 in chips) 
skillzplumber: posts small blind $0.05
123tiger711a: posts big blind $0.10
*** HOLE CARDS ***
Dealt to PlayTheBlues4U [2h 9h]
PlayTheBlues4U: folds 
Klytu: calls $0.10
skillzplumber: calls $0.05
123tiger711a: checks 
*** FLOP *** [Jh Qh Ks]
skillzplumber: checks 
123tiger711a: checks 
Klytu: checks 
*** TURN *** [Jh Qh Ks] [Kd]
skillzplumber: checks 
123tiger711a: checks 
Klytu: bets $0.15
skillzplumber: folds 
123tiger711a: folds 
Uncalled bet ($0.15) returned to Klytu
Klytu collected $0.28 from pot
Klytu: doesn't show hand 
*** SUMMARY ***
Total pot $0.30 | Rake $0.02 
Board [Jh Qh Ks Kd]
Seat 1: 123tiger711a (big blind) folded on the Turn
Seat 3: PlayTheBlues4U folded before Flop (didn't bet)
Seat 5: Klytu (button) collected ($0.28)
Seat 6: skillzplumber (small blind) folded on the Turn



PokerStars Hand #204846335839:  Hold'em No Limit ($0.05/$0.10 USD) - 2019/10/21 20:56:08 ET
Table 'Draco' 6-max Seat #6 is the button
Seat 1: 123tiger711a ($10.80 in chips) 
Seat 3: PlayTheBlues4U ($9.82 in chips) 
Seat 5: Klytu ($7.63 in chips) 
Seat 6: skillzplumber ($10.43 in chips) 
123tiger711a: posts small blind $0.05
PlayTheBlues4U: posts big blind $0.10
*** HOLE CARDS ***
Dealt to PlayTheBlues4U [5c Kd]
Klytu: folds 
skillzplumber: folds 
bsdnj joins the table at seat #4 
123tiger711a: calls $0.05
PlayTheBlues4U: checks 
*** FLOP *** [5d 4h 7d]
123tiger711a: checks 
JumboSoup joins the table at seat #2 
PlayTheBlues4U: checks 
*** TURN *** [5d 4h 7d] [8s]
123tiger711a: checks 
PlayTheBlues4U: checks 
*** RIVER *** [5d 4h 7d 8s] [8h]
123tiger711a: checks 
PlayTheBlues4U: checks 
*** SHOW DOWN ***
123tiger711a: shows [Ad Qc] (a pair of Eights)
PlayTheBlues4U: shows [5c Kd] (two pair, Eights and Fives)
PlayTheBlues4U collected $0.19 from pot
*** SUMMARY ***
Total pot $0.20 | Rake $0.01 
Board [5d 4h 7d 8s 8h]
Seat 1: 123tiger711a (small blind) showed [Ad Qc] and lost with a pair of Eights
Seat 3: PlayTheBlues4U (big blind) showed [5c Kd] and won ($0.19) with two pair, Eights and Fives
Seat 5: Klytu folded before Flop (didn't bet)
Seat 6: skillzplumber (button) folded before Flop (didn't bet)



PokerStars Hand #204846335922:  Hold'em No Limit ($0.05/$0.10 USD) - 2019/10/21 20:56:34 ET
Table 'Draco' 6-max Seat #1 is the button
Seat 1: 123tiger711a ($10.70 in chips) 
Seat 3: PlayTheBlues4U ($9.91 in chips) 
Seat 4: bsdnj ($10.09 in chips) 
Seat 5: Klytu ($10 in chips) 
Seat 6: skillzplumber ($10.43 in chips) 
PlayTheBlues4U: posts small blind $0.05
bsdnj: posts big blind $0.10
*** HOLE CARDS ***
Dealt to PlayTheBlues4U [Ad 2h]
Klytu: folds 
skillzplumber: calls $0.10
123tiger711a: calls $0.10
PlayTheBlues4U: calls $0.05
bsdnj: checks 
*** FLOP *** [Kc 5d 6d]
PlayTheBlues4U: checks 
bsdnj: checks 
skillzplumber: checks 
123tiger711a: checks 
*** TURN *** [Kc 5d 6d] [Ks]
PlayTheBlues4U: checks 
bsdnj: checks 
skillzplumber: checks 
123tiger711a: checks 
*** RIVER *** [Kc 5d 6d Ks] [Td]
PlayTheBlues4U: checks 
bsdnj: bets $0.30
skillzplumber: folds 
123tiger711a: calls $0.30
PlayTheBlues4U: folds 
*** SHOW DOWN ***
bsdnj: shows [8h Th] (two pair, Kings and Tens)
123tiger711a: shows [Ts 9c] (two pair, Kings and Tens - Nine kicker)
123tiger711a collected $0.95 from pot
*** SUMMARY ***
Total pot $1 | Rake $0.05 
Board [Kc 5d 6d Ks Td]
Seat 1: 123tiger711a (button) showed [Ts 9c] and won ($0.95) with two pair, Kings and Tens
Seat 3: PlayTheBlues4U (small blind) folded on the River
Seat 4: bsdnj (big blind) showed [8h Th] and lost with two pair, Kings and Tens
Seat 5: Klytu folded before Flop (didn't bet)
Seat 6: skillzplumber folded on the River



PokerStars Hand #204846336057:  Hold'em No Limit ($0.05/$0.10 USD) - 2019/10/21 20:57:13 ET
Table 'Draco' 6-max Seat #3 is the button
Seat 1: 123tiger711a ($11.25 in chips) 
Seat 2: JumboSoup ($8 in chips) 
Seat 3: PlayTheBlues4U ($9.81 in chips) 
Seat 4: bsdnj ($9.69 in chips) 
Seat 5: Klytu ($10 in chips) 
Seat 6: skillzplumber ($10.33 in chips) 
bsdnj: posts small blind $0.05
Klytu: posts big blind $0.10
JumboSoup: posts big blind $0.10
*** HOLE CARDS ***
Dealt to PlayTheBlues4U [2d Ah]
skillzplumber: folds 
123tiger711a: folds 
JumboSoup: checks 
PlayTheBlues4U: raises $0.20 to $0.30
bsdnj: folds 
Klytu: calls $0.20
JumboSoup: calls $0.20
*** FLOP *** [Ts 7c 2c]
Klytu: checks 
JumboSoup: bets $0.30
PlayTheBlues4U: calls $0.30
Klytu: calls $0.30
*** TURN *** [Ts 7c 2c] [Kh]
Klytu: checks 
JumboSoup: checks 
PlayTheBlues4U: checks 
*** RIVER *** [Ts 7c 2c Kh] [5s]
Klytu: checks 
JumboSoup: checks 
PlayTheBlues4U: checks 
*** SHOW DOWN ***
Klytu: shows [9s 7d] (a pair of Sevens)
JumboSoup: shows [Tc 8d] (a pair of Tens)
PlayTheBlues4U: mucks hand 
JumboSoup collected $1.76 from pot
*** SUMMARY ***
Total pot $1.85 | Rake $0.09 
Board [Ts 7c 2c Kh 5s]
Seat 1: 123tiger711a folded before Flop (didn't bet)
Seat 2: JumboSoup showed [Tc 8d] and won ($1.76) with a pair of Tens
Seat 3: PlayTheBlues4U (button) mucked [2d Ah]
Seat 4: bsdnj (small blind) folded before Flop
Seat 5: Klytu (big blind) showed [9s 7d] and lost with a pair of Sevens
Seat 6: skillzplumber folded before Flop (didn't bet)



PokerStars Hand #204846336192:  Hold'em No Limit ($0.05/$0.10 USD) - 2019/10/21 20:57:54 ET
Table 'Draco' 6-max Seat #4 is the button
Seat 1: 123tiger711a ($11.25 in chips) 
Seat 2: JumboSoup ($9.16 in chips) 
Seat 3: PlayTheBlues4U ($9.21 in chips) 
Seat 4: bsdnj ($9.64 in chips) 
Seat 5: Klytu ($9.40 in chips) 
Seat 6: skillzplumber ($10.33 in chips) 
Klytu: posts small blind $0.05
skillzplumber: posts big blind $0.10
*** HOLE CARDS ***
Dealt to PlayTheBlues4U [5s Qd]
123tiger711a: folds 
JumboSoup: calls $0.10
PlayTheBlues4U: folds 
bsdnj: folds 
Klytu: calls $0.05
skillzplumber: checks 
*** FLOP *** [4s 5h 3s]
Klytu: checks 
skillzplumber: bets $0.30
JumboSoup: calls $0.30
Klytu: calls $0.30
*** TURN *** [4s 5h 3s] [7d]
Klytu: checks 
skillzplumber: checks 
JumboSoup: bets $0.60
Klytu: calls $0.60
skillzplumber: calls $0.60
*** RIVER *** [4s 5h 3s 7d] [6h]
Klytu: checks 
skillzplumber: bets $1.10
JumboSoup: folds 
Klytu: folds 
Uncalled bet ($1.10) returned to skillzplumber
skillzplumber collected $2.85 from pot
skillzplumber: doesn't show hand 
*** SUMMARY ***
Total pot $3 | Rake $0.15 
Board [4s 5h 3s 7d 6h]
Seat 1: 123tiger711a folded before Flop (didn't bet)
Seat 2: JumboSoup folded on the River
Seat 3: PlayTheBlues4U folded before Flop (didn't bet)
Seat 4: bsdnj (button) folded before Flop (didn't bet)
Seat 5: Klytu (small blind) folded on the River
Seat 6: skillzplumber (big blind) collected ($2.85)



PokerStars Hand #204846336376:  Hold'em No Limit ($0.05/$0.10 USD) - 2019/10/21 20:58:50 ET
Table 'Draco' 6-max Seat #5 is the button
Seat 1: 123tiger711a ($11.25 in chips) 
Seat 2: JumboSoup ($8.16 in chips) 
Seat 3: PlayTheBlues4U ($9.21 in chips) 
Seat 4: bsdnj ($9.64 in chips) 
Seat 5: Klytu ($8.40 in chips) 
Seat 6: skillzplumber ($12.18 in chips) 
skillzplumber: posts small blind $0.05
123tiger711a: posts big blind $0.10
*** HOLE CARDS ***
Dealt to PlayTheBlues4U [2s 6s]
JumboSoup: folds 
PlayTheBlues4U: folds 
bsdnj: folds 
Klytu: folds 
skillzplumber: calls $0.05
123tiger711a: raises $1 to $1.10
skillzplumber: folds 
Uncalled bet ($1) returned to 123tiger711a
123tiger711a collected $0.20 from pot
*** SUMMARY ***
Total pot $0.20 | Rake $0 
Seat 1: 123tiger711a (big blind) collected ($0.20)
Seat 2: JumboSoup folded before Flop (didn't bet)
Seat 3: PlayTheBlues4U folded before Flop (didn't bet)
Seat 4: bsdnj folded before Flop (didn't bet)
Seat 5: Klytu (button) folded before Flop (didn't bet)
Seat 6: skillzplumber (small blind) folded before Flop



PokerStars Hand #204846336424:  Hold'em No Limit ($0.05/$0.10 USD) - 2019/10/21 20:59:05 ET
Table 'Draco' 6-max Seat #6 is the button
Seat 1: 123tiger711a ($11.35 in chips) 
Seat 2: JumboSoup ($8.16 in chips) 
Seat 3: PlayTheBlues4U ($9.21 in chips) 
Seat 4: bsdnj ($9.64 in chips) 
Seat 5: Klytu ($10 in chips) 
Seat 6: skillzplumber ($12.08 in chips) 
123tiger711a: posts small blind $0.05
JumboSoup: posts big blind $0.10
*** HOLE CARDS ***
Dealt to PlayTheBlues4U [7d 5c]
PlayTheBlues4U: folds 
bsdnj: folds 
Klytu: folds 
skillzplumber: folds 
123tiger711a: calls $0.05
JumboSoup: checks 
*** FLOP *** [Th Qs 4c]
123tiger711a: checks 
JumboSoup: checks 
*** TURN *** [Th Qs 4c] [Ad]
123tiger711a: bets $0.19
JumboSoup: calls $0.19
*** RIVER *** [Th Qs 4c Ad] [5h]
123tiger711a: checks 
JumboSoup: bets $1
123tiger711a: calls $1
*** SHOW DOWN ***
JumboSoup: shows [9s Jh] (high card Ace)
123tiger711a: shows [As 8c] (a pair of Aces)
123tiger711a collected $2.45 from pot
*** SUMMARY ***
Total pot $2.58 | Rake $0.13 
Board [Th Qs 4c Ad 5h]
Seat 1: 123tiger711a (small blind) showed [As 8c] and won ($2.45) with a pair of Aces
Seat 2: JumboSoup (big blind) showed [9s Jh] and lost with high card Ace
Seat 3: PlayTheBlues4U folded before Flop (didn't bet)
Seat 4: bsdnj folded before Flop (didn't bet)
Seat 5: Klytu folded before Flop (didn't bet)
Seat 6: skillzplumber (button) folded before Flop (didn't bet)



PokerStars Hand #204846336524:  Hold'em No Limit ($0.05/$0.10 USD) - 2019/10/21 20:59:35 ET
Table 'Draco' 6-max Seat #1 is the button
Seat 1: 123tiger711a ($12.51 in chips) 
Seat 2: JumboSoup ($6.87 in chips) 
Seat 3: PlayTheBlues4U ($9.21 in chips) 
Seat 4: bsdnj ($9.64 in chips) 
Seat 5: Klytu ($10 in chips) 
Seat 6: skillzplumber ($12.08 in chips) 
JumboSoup: posts small blind $0.05
PlayTheBlues4U: posts big blind $0.10
*** HOLE CARDS ***
Dealt to PlayTheBlues4U [5c Jd]
bsdnj: raises $0.20 to $0.30
Klytu: folds 
skillzplumber: raises $0.40 to $0.70
123tiger711a: folds 
JumboSoup: folds 
PlayTheBlues4U: folds 
bsdnj: calls $0.40
*** FLOP *** [7s Kd 4d]
bsdnj: bets $0.80
skillzplumber: folds 
Uncalled bet ($0.80) returned to bsdnj
bsdnj collected $1.47 from pot
bsdnj: doesn't show hand 
*** SUMMARY ***
Total pot $1.55 | Rake $0.08 
Board [7s Kd 4d]
Seat 1: 123tiger711a (button) folded before Flop (didn't bet)
Seat 2: JumboSoup (small blind) folded before Flop
Seat 3: PlayTheBlues4U (big blind) folded before Flop
Seat 4: bsdnj collected ($1.47)
Seat 5: Klytu folded before Flop (didn't bet)
Seat 6: skillzplumber folded on the Flop



PokerStars Hand #204846336639:  Hold'em No Limit ($0.05/$0.10 USD) - 2019/10/21 21:00:08 ET
Table 'Draco' 6-max Seat #2 is the button
Seat 1: 123tiger711a ($12.51 in chips) 
Seat 2: JumboSoup ($6.82 in chips) 
Seat 3: PlayTheBlues4U ($9.11 in chips) 
Seat 4: bsdnj ($10.41 in chips) 
Seat 5: Klytu ($10 in chips) 
Seat 6: skillzplumber ($11.38 in chips) 
PlayTheBlues4U: posts small blind $0.05
bsdnj: posts big blind $0.10
*** HOLE CARDS ***
Dealt to PlayTheBlues4U [5h 7h]
Klytu: folds 
skillzplumber: folds 
123tiger711a: folds 
JumboSoup: raises $0.40 to $0.50
PlayTheBlues4U: folds 
bsdnj: folds 
Uncalled bet ($0.40) returned to JumboSoup
JumboSoup collected $0.25 from pot
JumboSoup: doesn't show hand 
*** SUMMARY ***
Total pot $0.25 | Rake $0 
Seat 1: 123tiger711a folded before Flop (didn't bet)
Seat 2: JumboSoup (button) collected ($0.25)
Seat 3: PlayTheBlues4U (small blind) folded before Flop
Seat 4: bsdnj (big blind) folded before Flop
Seat 5: Klytu folded before Flop (didn't bet)
Seat 6: skillzplumber folded before Flop (didn't bet)



PokerStars Hand #204846336714:  Hold'em No Limit ($0.05/$0.10 USD) - 2019/10/21 21:00:27 ET
Table 'Draco' 6-max Seat #3 is the button
Seat 1: 123tiger711a ($12.51 in chips) 
Seat 2: JumboSoup ($6.97 in chips) 
Seat 3: PlayTheBlues4U ($9.06 in chips) 
Seat 4: bsdnj ($10.31 in chips) 
Seat 5: Klytu ($10 in chips) 
Seat 6: skillzplumber ($11.38 in chips) 
bsdnj: posts small blind $0.05
Klytu: posts big blind $0.10
*** HOLE CARDS ***
Dealt to PlayTheBlues4U [5d 8d]
skillzplumber: folds 
123tiger711a: folds 
JumboSoup: folds 
PlayTheBlues4U: folds 
bsdnj: folds 
Uncalled bet ($0.05) returned to Klytu
Klytu collected $0.10 from pot
Klytu: doesn't show hand 
*** SUMMARY ***
Total pot $0.10 | Rake $0 
Seat 1: 123tiger711a folded before Flop (didn't bet)
Seat 2: JumboSoup folded before Flop (didn't bet)
Seat 3: PlayTheBlues4U (button) folded before Flop (didn't bet)
Seat 4: bsdnj (small blind) folded before Flop
Seat 5: Klytu (big blind) collected ($0.10)
Seat 6: skillzplumber folded before Flop (didn't bet)



PokerStars Hand #204846336765:  Hold'em No Limit ($0.05/$0.10 USD) - 2019/10/21 21:00:38 ET
Table 'Draco' 6-max Seat #4 is the button
Seat 1: 123tiger711a ($12.51 in chips) 
Seat 2: JumboSoup ($6.97 in chips) 
Seat 3: PlayTheBlues4U ($9.06 in chips) 
Seat 4: bsdnj ($10.26 in chips) 
Seat 5: Klytu ($10.05 in chips) 
Seat 6: skillzplumber ($11.38 in chips) 
Klytu: posts small blind $0.05
skillzplumber: posts big blind $0.10
*** HOLE CARDS ***
Dealt to PlayTheBlues4U [Qh 8h]
123tiger711a: folds 
JumboSoup: calls $0.10
PlayTheBlues4U: folds 
bsdnj: folds 
Klytu: folds 
skillzplumber: checks 
*** FLOP *** [Ah 6c 7h]
skillzplumber: checks 
JumboSoup: checks 
*** TURN *** [Ah 6c 7h] [Kh]
skillzplumber: checks 
JumboSoup: checks 
*** RIVER *** [Ah 6c 7h Kh] [Ks]
skillzplumber: checks 
JumboSoup: bets $0.10
skillzplumber: raises $0.40 to $0.50
JumboSoup: folds 
Uncalled bet ($0.40) returned to skillzplumber
skillzplumber collected $0.43 from pot
skillzplumber: doesn't show hand 
*** SUMMARY ***
Total pot $0.45 | Rake $0.02 
Board [Ah 6c 7h Kh Ks]
Seat 1: 123tiger711a folded before Flop (didn't bet)
Seat 2: JumboSoup folded on the River
Seat 3: PlayTheBlues4U folded before Flop (didn't bet)
Seat 4: bsdnj (button) folded before Flop (didn't bet)
Seat 5: Klytu (small blind) folded before Flop
Seat 6: skillzplumber (big blind) collected ($0.43)



PokerStars Hand #204846336929:  Hold'em No Limit ($0.05/$0.10 USD) - 2019/10/21 21:01:14 ET
Table 'Draco' 6-max Seat #5 is the button
Seat 1: 123tiger711a ($12.51 in chips) 
Seat 2: JumboSoup ($6.77 in chips) 
Seat 3: PlayTheBlues4U ($9.06 in chips) 
Seat 4: bsdnj ($10.26 in chips) 
Seat 5: Klytu ($10 in chips) 
Seat 6: skillzplumber ($11.61 in chips) 
skillzplumber: posts small blind $0.05
123tiger711a: posts big blind $0.10
*** HOLE CARDS ***
Dealt to PlayTheBlues4U [As Qd]
JumboSoup: folds 
PlayTheBlues4U: raises $0.20 to $0.30
bsdnj: calls $0.30
Klytu: calls $0.30
skillzplumber: calls $0.25
123tiger711a: calls $0.20
*** FLOP *** [4h 4s 4d]
skillzplumber: bets $0.50
123tiger711a: folds 
PlayTheBlues4U: folds 
bsdnj: calls $0.50
Klytu: folds 
*** TURN *** [4h 4s 4d] [5c]
skillzplumber: bets $0.90
bsdnj: calls $0.90
*** RIVER *** [4h 4s 4d 5c] [6c]
skillzplumber: checks 
bsdnj: checks 
*** SHOW DOWN ***
skillzplumber: shows [3c 3s] (a full house, Fours full of Threes)
bsdnj: mucks hand 
skillzplumber collected $4.08 from pot
*** SUMMARY ***
Total pot $4.30 | Rake $0.22 
Board [4h 4s 4d 5c 6c]
Seat 1: 123tiger711a (big blind) folded on the Flop
Seat 2: JumboSoup folded before Flop (didn't bet)
Seat 3: PlayTheBlues4U folded on the Flop
Seat 4: bsdnj mucked [2c 2h]
Seat 5: Klytu (button) folded on the Flop
Seat 6: skillzplumber (small blind) showed [3c 3s] and won ($4.08) with a full house, Fours full of Threes



PokerStars Hand #204846337157:  Hold'em No Limit ($0.05/$0.10 USD) - 2019/10/21 21:02:06 ET
Table 'Draco' 6-max Seat #6 is the button
Seat 1: 123tiger711a ($12.21 in chips) 
Seat 2: JumboSoup ($6.77 in chips) 
Seat 3: PlayTheBlues4U ($8.76 in chips) 
Seat 4: bsdnj ($8.56 in chips) 
Seat 5: Klytu ($10 in chips) 
Seat 6: skillzplumber ($13.99 in chips) 
123tiger711a: posts small blind $0.05
JumboSoup: posts big blind $0.10
*** HOLE CARDS ***
Dealt to PlayTheBlues4U [7s 6h]
PlayTheBlues4U: folds 
bsdnj: folds 
Klytu: folds 
skillzplumber: folds 
123tiger711a: calls $0.05
JumboSoup: raises $0.10 to $0.20
123tiger711a: calls $0.10
*** FLOP *** [Kh Ah 6s]
123tiger711a: checks 
JumboSoup: checks 
*** TURN *** [Kh Ah 6s] [Qh]
123tiger711a: checks 
JumboSoup: checks 
*** RIVER *** [Kh Ah 6s Qh] [4d]
123tiger711a: checks 
JumboSoup: checks 
*** SHOW DOWN ***
123tiger711a: shows [9s 2h] (high card Ace)
JumboSoup: shows [9c 8c] (high card Ace - King+Queen+Nine+Eight kicker)
JumboSoup collected $0.38 from pot
*** SUMMARY ***
Total pot $0.40 | Rake $0.02 
Board [Kh Ah 6s Qh 4d]
Seat 1: 123tiger711a (small blind) showed [9s 2h] and lost with high card Ace
Seat 2: JumboSoup (big blind) showed [9c 8c] and won ($0.38) with high card Ace
Seat 3: PlayTheBlues4U folded before Flop (didn't bet)
Seat 4: bsdnj folded before Flop (didn't bet)
Seat 5: Klytu folded before Flop (didn't bet)
Seat 6: skillzplumber (button) folded before Flop (didn't bet)



PokerStars Hand #204846337319:  Hold'em No Limit ($0.05/$0.10 USD) - 2019/10/21 21:02:42 ET
Table 'Draco' 6-max Seat #1 is the button
Seat 1: 123tiger711a ($12.01 in chips) 
Seat 2: JumboSoup ($6.95 in chips) 
Seat 3: PlayTheBlues4U ($10 in chips) 
Seat 4: bsdnj ($8.56 in chips) 
Seat 5: Klytu ($10 in chips) 
Seat 6: skillzplumber ($13.99 in chips) 
JumboSoup: posts small blind $0.05
PlayTheBlues4U: posts big blind $0.10
*** HOLE CARDS ***
Dealt to PlayTheBlues4U [7h 6c]
bsdnj: folds 
Klytu: folds 
skillzplumber: folds 
123tiger711a: calls $0.10
JumboSoup: folds 
PlayTheBlues4U: checks 
*** FLOP *** [Jd Qh 2d]
PlayTheBlues4U: checks 
123tiger711a: bets $0.10
PlayTheBlues4U: folds 
Uncalled bet ($0.10) returned to 123tiger711a
123tiger711a collected $0.24 from pot
*** SUMMARY ***
Total pot $0.25 | Rake $0.01 
Board [Jd Qh 2d]
Seat 1: 123tiger711a (button) collected ($0.24)
Seat 2: JumboSoup (small blind) folded before Flop
Seat 3: PlayTheBlues4U (big blind) folded on the Flop
Seat 4: bsdnj folded before Flop (didn't bet)
Seat 5: Klytu folded before Flop (didn't bet)
Seat 6: skillzplumber folded before Flop (didn't bet)



PokerStars Hand #204846337432:  Hold'em No Limit ($0.05/$0.10 USD) - 2019/10/21 21:03:08 ET
Table 'Draco' 6-max Seat #2 is the button
Seat 1: 123tiger711a ($12.15 in chips) 
Seat 2: JumboSoup ($6.90 in chips) 
Seat 3: PlayTheBlues4U ($9.90 in chips) 
Seat 4: bsdnj ($8.56 in chips) 
Seat 5: Klytu ($10 in chips) 
Seat 6: skillzplumber ($13.99 in chips) 
PlayTheBlues4U: posts small blind $0.05
bsdnj: posts big blind $0.10
*** HOLE CARDS ***
Dealt to PlayTheBlues4U [4s 7s]
Klytu: folds 
skillzplumber: folds 
123tiger711a: folds 
JumboSoup: calls $0.10
PlayTheBlues4U: calls $0.05
bsdnj: checks 
*** FLOP *** [Td As Js]
PlayTheBlues4U: bets $0.15
bsdnj: folds 
JumboSoup: folds 
Uncalled bet ($0.15) returned to PlayTheBlues4U
PlayTheBlues4U collected $0.28 from pot
PlayTheBlues4U: doesn't show hand 
*** SUMMARY ***
Total pot $0.30 | Rake $0.02 
Board [Td As Js]
Seat 1: 123tiger711a folded before Flop (didn't bet)
Seat 2: JumboSoup (button) folded on the Flop
Seat 3: PlayTheBlues4U (small blind) collected ($0.28)
Seat 4: bsdnj (big blind) folded on the Flop
Seat 5: Klytu folded before Flop (didn't bet)
Seat 6: skillzplumber folded before Flop (didn't bet)



PokerStars Hand #204846337574:  Hold'em No Limit ($0.05/$0.10 USD) - 2019/10/21 21:03:38 ET
Table 'Draco' 6-max Seat #3 is the button
Seat 1: 123tiger711a ($12.15 in chips) 
Seat 2: JumboSoup ($6.80 in chips) 
Seat 3: PlayTheBlues4U ($10.08 in chips) 
Seat 4: bsdnj ($8.46 in chips) 
Seat 5: Klytu ($10 in chips) 
Seat 6: skillzplumber ($13.99 in chips) 
bsdnj: posts small blind $0.05
Klytu: posts big blind $0.10
*** HOLE CARDS ***
Dealt to PlayTheBlues4U [Kd 5d]
skillzplumber: folds 
123tiger711a: folds 
JumboSoup: folds 
PlayTheBlues4U: raises $0.15 to $0.25
bsdnj: folds 
Klytu: folds 
Uncalled bet ($0.15) returned to PlayTheBlues4U
PlayTheBlues4U collected $0.25 from pot
PlayTheBlues4U: doesn't show hand 
*** SUMMARY ***
Total pot $0.25 | Rake $0 
Seat 1: 123tiger711a folded before Flop (didn't bet)
Seat 2: JumboSoup folded before Flop (didn't bet)
Seat 3: PlayTheBlues4U (button) collected ($0.25)
Seat 4: bsdnj (small blind) folded before Flop
Seat 5: Klytu (big blind) folded before Flop
Seat 6: skillzplumber folded before Flop (didn't bet)



PokerStars Hand #204846337645:  Hold'em No Limit ($0.05/$0.10 USD) - 2019/10/21 21:03:54 ET
Table 'Draco' 6-max Seat #4 is the button
Seat 1: 123tiger711a ($12.15 in chips) 
Seat 2: JumboSoup ($6.80 in chips) 
Seat 3: PlayTheBlues4U ($10.23 in chips) 
Seat 4: bsdnj ($8.41 in chips) 
Seat 5: Klytu ($9.90 in chips) 
Seat 6: skillzplumber ($13.99 in chips) 
Klytu: posts small blind $0.05
skillzplumber: posts big blind $0.10
*** HOLE CARDS ***
Dealt to PlayTheBlues4U [Qs 8h]
123tiger711a: raises $0.30 to $0.40
JumboSoup: folds 
PlayTheBlues4U: folds 
bsdnj: folds 
Klytu: calls $0.35
skillzplumber: calls $0.30
*** FLOP *** [8s 4c 3c]
Klytu: checks 
skillzplumber: checks 
123tiger711a: checks 
*** TURN *** [8s 4c 3c] [3h]
Klytu: checks 
skillzplumber: checks 
123tiger711a: checks 
*** RIVER *** [8s 4c 3c 3h] [2h]
Klytu: checks 
skillzplumber: checks 
123tiger711a: checks 
*** SHOW DOWN ***
Klytu: shows [Ts Js] (a pair of Threes)
skillzplumber: shows [5d Qd] (a pair of Threes - Queen kicker)
123tiger711a: shows [Ad Kd] (a pair of Threes - Ace kicker)
123tiger711a collected $1.14 from pot
*** SUMMARY ***
Total pot $1.20 | Rake $0.06 
Board [8s 4c 3c 3h 2h]
Seat 1: 123tiger711a showed [Ad Kd] and won ($1.14) with a pair of Threes
Seat 2: JumboSoup folded before Flop (didn't bet)
Seat 3: PlayTheBlues4U folded before Flop (didn't bet)
Seat 4: bsdnj (button) folded before Flop (didn't bet)
Seat 5: Klytu (small blind) showed [Ts Js] and lost with a pair of Threes
Seat 6: skillzplumber (big blind) showed [5d Qd] and lost with a pair of Threes



PokerStars Hand #204846337927:  Hold'em No Limit ($0.05/$0.10 USD) - 2019/10/21 21:04:53 ET
Table 'Draco' 6-max Seat #5 is the button
Seat 1: 123tiger711a ($12.89 in chips) 
Seat 2: JumboSoup ($6.80 in chips) 
Seat 3: PlayTheBlues4U ($10.23 in chips) 
Seat 4: bsdnj ($8.41 in chips) 
Seat 5: Klytu ($9.50 in chips) 
Seat 6: skillzplumber ($13.59 in chips) 
skillzplumber: posts small blind $0.05
123tiger711a: posts big blind $0.10
*** HOLE CARDS ***
Dealt to PlayTheBlues4U [As Th]
JumboSoup: folds 
PlayTheBlues4U: raises $0.20 to $0.30
bsdnj: calls $0.30
Klytu: calls $0.30
skillzplumber: raises $0.50 to $0.80
123tiger711a: folds 
PlayTheBlues4U: folds 
bsdnj: calls $0.50
Klytu: calls $0.50
*** FLOP *** [Kh 5d Tc]
skillzplumber: checks 
bsdnj: checks 
Klytu: checks 
*** TURN *** [Kh 5d Tc] [Jh]
skillzplumber: checks 
bsdnj: checks 
Klytu: checks 
*** RIVER *** [Kh 5d Tc Jh] [3h]
skillzplumber: checks 
bsdnj: checks 
Klytu: checks 
*** SHOW DOWN ***
skillzplumber: shows [8c 8d] (a pair of Eights)
bsdnj: mucks hand 
Klytu: mucks hand 
skillzplumber collected $2.66 from pot
*** SUMMARY ***
Total pot $2.80 | Rake $0.14 
Board [Kh 5d Tc Jh 3h]
Seat 1: 123tiger711a (big blind) folded before Flop
Seat 2: JumboSoup folded before Flop (didn't bet)
Seat 3: PlayTheBlues4U folded before Flop
Seat 4: bsdnj mucked [6s 6h]
Seat 5: Klytu (button) mucked [7s 7h]
Seat 6: skillzplumber (small blind) showed [8c 8d] and won ($2.66) with a pair of Eights



PokerStars Hand #204846338171:  Hold'em No Limit ($0.05/$0.10 USD) - 2019/10/21 21:05:44 ET
Table 'Draco' 6-max Seat #6 is the button
Seat 1: 123tiger711a ($12.79 in chips) 
Seat 2: JumboSoup ($6.80 in chips) 
Seat 3: PlayTheBlues4U ($9.93 in chips) 
Seat 4: bsdnj ($7.61 in chips) 
Seat 5: Klytu ($10 in chips) 
Seat 6: skillzplumber ($15.45 in chips) 
123tiger711a: posts small blind $0.05
JumboSoup: posts big blind $0.10
*** HOLE CARDS ***
Dealt to PlayTheBlues4U [5c Qs]
PlayTheBlues4U: folds 
bsdnj: folds 
Klytu: folds 
skillzplumber: folds 
123tiger711a: calls $0.05
JumboSoup: checks 
*** FLOP *** [Jc Td 5d]
123tiger711a: bets $0.19
JumboSoup: folds 
Uncalled bet ($0.19) returned to 123tiger711a
123tiger711a collected $0.19 from pot
*** SUMMARY ***
Total pot $0.20 | Rake $0.01 
Board [Jc Td 5d]
Seat 1: 123tiger711a (small blind) collected ($0.19)
Seat 2: JumboSoup (big blind) folded on the Flop
Seat 3: PlayTheBlues4U folded before Flop (didn't bet)
Seat 4: bsdnj folded before Flop (didn't bet)
Seat 5: Klytu folded before Flop (didn't bet)
Seat 6: skillzplumber (button) folded before Flop (didn't bet)



PokerStars Hand #204846338244:  Hold'em No Limit ($0.05/$0.10 USD) - 2019/10/21 21:06:00 ET
Table 'Draco' 6-max Seat #1 is the button
Seat 1: 123tiger711a ($12.88 in chips) 
Seat 2: JumboSoup ($6.70 in chips) 
Seat 3: PlayTheBlues4U ($9.93 in chips) 
Seat 4: bsdnj ($7.61 in chips) 
Seat 5: Klytu ($10 in chips) 
Seat 6: skillzplumber ($15.45 in chips) 
JumboSoup: posts small blind $0.05
PlayTheBlues4U: posts big blind $0.10
*** HOLE CARDS ***
Dealt to PlayTheBlues4U [6c 5h]
bsdnj: raises $0.20 to $0.30
Klytu: calls $0.30
skillzplumber: folds 
123tiger711a: folds 
JumboSoup: raises $0.20 to $0.50
PlayTheBlues4U: folds 
bsdnj: calls $0.20
Klytu: calls $0.20
*** FLOP *** [9d 9s 3s]
JumboSoup: checks 
bsdnj: bets $0.80
Klytu: folds 
JumboSoup: calls $0.80
*** TURN *** [9d 9s 3s] [4c]
JumboSoup: checks 
bsdnj: bets $3
JumboSoup: folds 
Uncalled bet ($3) returned to bsdnj
bsdnj collected $3.04 from pot
bsdnj: doesn't show hand 
*** SUMMARY ***
Total pot $3.20 | Rake $0.16 
Board [9d 9s 3s 4c]
Seat 1: 123tiger711a (button) folded before Flop (didn't bet)
Seat 2: JumboSoup (small blind) folded on the Turn
Seat 3: PlayTheBlues4U (big blind) folded before Flop
Seat 4: bsdnj collected ($3.04)
Seat 5: Klytu folded on the Flop
Seat 6: skillzplumber folded before Flop (didn't bet)



PokerStars Hand #204846338423:  Hold'em No Limit ($0.05/$0.10 USD) - 2019/10/21 21:06:36 ET
Table 'Draco' 6-max Seat #2 is the button
Seat 1: 123tiger711a ($12.88 in chips) 
Seat 2: JumboSoup ($5.40 in chips) 
Seat 3: PlayTheBlues4U ($9.83 in chips) 
Seat 4: bsdnj ($9.35 in chips) 
Seat 5: Klytu ($10 in chips) 
Seat 6: skillzplumber ($15.45 in chips) 
PlayTheBlues4U: posts small blind $0.05
bsdnj: posts big blind $0.10
*** HOLE CARDS ***
Dealt to PlayTheBlues4U [8d Kc]
Klytu: folds 
skillzplumber: calls $0.10
123tiger711a: folds 
JumboSoup: folds 
PlayTheBlues4U: calls $0.05
bsdnj: checks 
*** FLOP *** [2d 2c 8h]
PlayTheBlues4U: bets $0.20
bsdnj: folds 
skillzplumber: folds 
Uncalled bet ($0.20) returned to PlayTheBlues4U
PlayTheBlues4U collected $0.28 from pot
PlayTheBlues4U: doesn't show hand 
*** SUMMARY ***
Total pot $0.30 | Rake $0.02 
Board [2d 2c 8h]
Seat 1: 123tiger711a folded before Flop (didn't bet)
Seat 2: JumboSoup (button) folded before Flop (didn't bet)
Seat 3: PlayTheBlues4U (small blind) collected ($0.28)
Seat 4: bsdnj (big blind) folded on the Flop
Seat 5: Klytu folded before Flop (didn't bet)
Seat 6: skillzplumber folded on the Flop



PokerStars Hand #204846338521:  Hold'em No Limit ($0.05/$0.10 USD) - 2019/10/21 21:06:54 ET
Table 'Draco' 6-max Seat #3 is the button
Seat 1: 123tiger711a ($12.88 in chips) 
Seat 3: PlayTheBlues4U ($10.01 in chips) 
Seat 4: bsdnj ($9.25 in chips) 
Seat 5: Klytu ($10 in chips) 
Seat 6: skillzplumber ($15.35 in chips) 
bsdnj: posts small blind $0.05
JumboSoup leaves the table
Klytu: posts big blind $0.10
*** HOLE CARDS ***
Dealt to PlayTheBlues4U [Tc 3h]
SeaofLove joins the table at seat #2 
skillzplumber: folds 
123tiger711a: folds 
PlayTheBlues4U: folds 
bsdnj: calls $0.05
Klytu: checks 
*** FLOP *** [9c 8d Qd]
bsdnj: checks 
Klytu: bets $0.15
bsdnj: folds 
Uncalled bet ($0.15) returned to Klytu
Klytu collected $0.19 from pot
Klytu: doesn't show hand 
*** SUMMARY ***
Total pot $0.20 | Rake $0.01 
Board [9c 8d Qd]
Seat 1: 123tiger711a folded before Flop (didn't bet)
Seat 3: PlayTheBlues4U (button) folded before Flop (didn't bet)
Seat 4: bsdnj (small blind) folded on the Flop
Seat 5: Klytu (big blind) collected ($0.19)
Seat 6: skillzplumber folded before Flop (didn't bet)



PokerStars Hand #204846338634:  Hold'em No Limit ($0.05/$0.10 USD) - 2019/10/21 21:07:20 ET
Table 'Draco' 6-max Seat #4 is the button
Seat 1: 123tiger711a ($12.88 in chips) 
Seat 3: PlayTheBlues4U ($10.01 in chips) 
Seat 4: bsdnj ($9.15 in chips) 
Seat 5: Klytu ($10.09 in chips) 
Seat 6: skillzplumber ($15.35 in chips) 
Klytu: posts small blind $0.05
skillzplumber: posts big blind $0.10
SeaofLove: sits out 
*** HOLE CARDS ***
Dealt to PlayTheBlues4U [5h 2s]
123tiger711a: folds 
PlayTheBlues4U: folds 
bsdnj: folds 
Klytu: folds 
Uncalled bet ($0.05) returned to skillzplumber
skillzplumber collected $0.10 from pot
skillzplumber: doesn't show hand 
*** SUMMARY ***
Total pot $0.10 | Rake $0 
Seat 1: 123tiger711a folded before Flop (didn't bet)
Seat 3: PlayTheBlues4U folded before Flop (didn't bet)
Seat 4: bsdnj (button) folded before Flop (didn't bet)
Seat 5: Klytu (small blind) folded before Flop
Seat 6: skillzplumber (big blind) collected ($0.10)



PokerStars Hand #204846338701:  Hold'em No Limit ($0.05/$0.10 USD) - 2019/10/21 21:07:33 ET
Table 'Draco' 6-max Seat #5 is the button
Seat 1: 123tiger711a ($12.88 in chips) 
Seat 3: PlayTheBlues4U ($10.01 in chips) 
Seat 4: bsdnj ($9.15 in chips) 
Seat 5: Klytu ($10.04 in chips) 
Seat 6: skillzplumber ($15.40 in chips) 
skillzplumber: posts small blind $0.05
123tiger711a: posts big blind $0.10
SeaofLove: sits out 
*** HOLE CARDS ***
Dealt to PlayTheBlues4U [Js 3s]
PlayTheBlues4U: folds 
bsdnj: folds 
Klytu: raises $0.15 to $0.25
skillzplumber: folds 
123tiger711a: folds 
Uncalled bet ($0.15) returned to Klytu
Klytu collected $0.25 from pot
Klytu: doesn't show hand 
*** SUMMARY ***
Total pot $0.25 | Rake $0 
Seat 1: 123tiger711a (big blind) folded before Flop
Seat 3: PlayTheBlues4U folded before Flop (didn't bet)
Seat 4: bsdnj folded before Flop (didn't bet)
Seat 5: Klytu (button) collected ($0.25)
Seat 6: skillzplumber (small blind) folded before Flop



PokerStars Hand #204846338804:  Hold'em No Limit ($0.05/$0.10 USD) - 2019/10/21 21:07:56 ET
Table 'Draco' 6-max Seat #6 is the button
Seat 1: 123tiger711a ($12.78 in chips) 
Seat 2: SeaofLove ($10 in chips) 
Seat 3: PlayTheBlues4U ($10.01 in chips) 
Seat 4: bsdnj ($9.15 in chips) 
Seat 5: Klytu ($10.19 in chips) 
Seat 6: skillzplumber ($15.35 in chips) 
123tiger711a: posts small blind $0.05
SeaofLove: posts big blind $0.10
*** HOLE CARDS ***
Dealt to PlayTheBlues4U [6h 2c]
PlayTheBlues4U: folds 
bsdnj: calls $0.10
Klytu: folds 
skillzplumber: raises $0.30 to $0.40
123tiger711a: folds 
SeaofLove: calls $0.30
bsdnj: folds 
*** FLOP *** [9s 5h Qc]
SeaofLove: bets $0.60
skillzplumber: calls $0.60
*** TURN *** [9s 5h Qc] [9h]
SeaofLove: bets $1.10
skillzplumber: folds 
Uncalled bet ($1.10) returned to SeaofLove
SeaofLove collected $2.04 from pot
SeaofLove: doesn't show hand 
*** SUMMARY ***
Total pot $2.15 | Rake $0.11 
Board [9s 5h Qc 9h]
Seat 1: 123tiger711a (small blind) folded before Flop
Seat 2: SeaofLove (big blind) collected ($2.04)
Seat 3: PlayTheBlues4U folded before Flop (didn't bet)
Seat 4: bsdnj folded before Flop
Seat 5: Klytu folded before Flop (didn't bet)
Seat 6: skillzplumber (button) folded on the Turn



PokerStars Hand #204846338963:  Hold'em No Limit ($0.05/$0.10 USD) - 2019/10/21 21:08:29 ET
Table 'Draco' 6-max Seat #1 is the button
Seat 1: 123tiger711a ($12.73 in chips) 
Seat 2: SeaofLove ($11.04 in chips) 
Seat 3: PlayTheBlues4U ($10.01 in chips) 
Seat 4: bsdnj ($9.05 in chips) 
Seat 5: Klytu ($10.19 in chips) 
Seat 6: skillzplumber ($14.35 in chips) 
SeaofLove: posts small blind $0.05
PlayTheBlues4U: posts big blind $0.10
*** HOLE CARDS ***
Dealt to PlayTheBlues4U [Tc 7d]
bsdnj: folds 
Klytu: raises $0.20 to $0.30
skillzplumber: raises $14.05 to $14.35 and is all-in
123tiger711a: folds 
SeaofLove: folds 
PlayTheBlues4U: folds 
Klytu: calls $9.89 and is all-in
Uncalled bet ($4.16) returned to skillzplumber
*** FLOP *** [Th 6c Js]
*** TURN *** [Th 6c Js] [6d]
*** RIVER *** [Th 6c Js 6d] [2h]
*** SHOW DOWN ***
Klytu: shows [Qc Ad] (a pair of Sixes)
skillzplumber: shows [Jh Jd] (a full house, Jacks full of Sixes)
skillzplumber collected $19.50 from pot
*** SUMMARY ***
Total pot $20.53 | Rake $1.03 
Board [Th 6c Js 6d 2h]
Seat 1: 123tiger711a (button) folded before Flop (didn't bet)
Seat 2: SeaofLove (small blind) folded before Flop
Seat 3: PlayTheBlues4U (big blind) folded before Flop
Seat 4: bsdnj folded before Flop (didn't bet)
Seat 5: Klytu showed [Qc Ad] and lost with a pair of Sixes
Seat 6: skillzplumber showed [Jh Jd] and won ($19.50) with a full house, Jacks full of Sixes



PokerStars Hand #204846339053:  Hold'em No Limit ($0.05/$0.10 USD) - 2019/10/21 21:08:48 ET
Table 'Draco' 6-max Seat #2 is the button
Seat 1: 123tiger711a ($12.73 in chips) 
Seat 2: SeaofLove ($10.99 in chips) 
Seat 3: PlayTheBlues4U ($9.91 in chips) 
Seat 4: bsdnj ($9.05 in chips) 
Seat 5: Klytu ($10 in chips) 
Seat 6: skillzplumber ($23.66 in chips) 
PlayTheBlues4U: posts small blind $0.05
bsdnj: posts big blind $0.10
*** HOLE CARDS ***
Dealt to PlayTheBlues4U [9d Ks]
Klytu: folds 
skillzplumber: raises $0.30 to $0.40
PlayTheBlues4U said, "solid flip"
123tiger711a: folds 
SeaofLove: folds 
PlayTheBlues4U: folds 
bsdnj: calls $0.30
*** FLOP *** [3h 8c 7h]
skillzplumber said, "bet"
bsdnj: checks 
skillzplumber: checks 
*** TURN *** [3h 8c 7h] [6d]
bsdnj: checks 
skillzplumber: checks 
*** RIVER *** [3h 8c 7h 6d] [9c]
bsdnj: bets $0.80
skillzplumber: folds 
Uncalled bet ($0.80) returned to bsdnj
bsdnj collected $0.81 from pot
bsdnj: doesn't show hand 
*** SUMMARY ***
Total pot $0.85 | Rake $0.04 
Board [3h 8c 7h 6d 9c]
Seat 1: 123tiger711a folded before Flop (didn't bet)
Seat 2: SeaofLove (button) folded before Flop (didn't bet)
Seat 3: PlayTheBlues4U (small blind) folded before Flop
Seat 4: bsdnj (big blind) collected ($0.81)
Seat 5: Klytu folded before Flop (didn't bet)
Seat 6: skillzplumber folded on the River



PokerStars Hand #204846339185:  Hold'em No Limit ($0.05/$0.10 USD) - 2019/10/21 21:09:18 ET
Table 'Draco' 6-max Seat #3 is the button
Seat 1: 123tiger711a ($12.73 in chips) 
Seat 2: SeaofLove ($10.99 in chips) 
Seat 3: PlayTheBlues4U ($9.86 in chips) 
Seat 4: bsdnj ($9.46 in chips) 
Seat 5: Klytu ($10 in chips) 
Seat 6: skillzplumber ($23.26 in chips) 
bsdnj: posts small blind $0.05
Klytu: posts big blind $0.10
*** HOLE CARDS ***
Dealt to PlayTheBlues4U [7s 5h]
skillzplumber: raises $0.30 to $0.40
123tiger711a: folds 
SeaofLove: folds 
PlayTheBlues4U: folds 
bsdnj: folds 
Klytu: folds 
Uncalled bet ($0.30) returned to skillzplumber
skillzplumber collected $0.25 from pot
skillzplumber: doesn't show hand 
*** SUMMARY ***
Total pot $0.25 | Rake $0 
Seat 1: 123tiger711a folded before Flop (didn't bet)
Seat 2: SeaofLove folded before Flop (didn't bet)
Seat 3: PlayTheBlues4U (button) folded before Flop (didn't bet)
Seat 4: bsdnj (small blind) folded before Flop
Seat 5: Klytu (big blind) folded before Flop
Seat 6: skillzplumber collected ($0.25)



PokerStars Hand #204846339245:  Hold'em No Limit ($0.05/$0.10 USD) - 2019/10/21 21:09:29 ET
Table 'Draco' 6-max Seat #4 is the button
Seat 1: 123tiger711a ($12.73 in chips) 
Seat 2: SeaofLove ($10.99 in chips) 
Seat 3: PlayTheBlues4U ($9.86 in chips) 
Seat 4: bsdnj ($9.41 in chips) 
Seat 5: Klytu ($9.90 in chips) 
Seat 6: skillzplumber ($23.41 in chips) 
Klytu: posts small blind $0.05
skillzplumber: posts big blind $0.10
*** HOLE CARDS ***
Dealt to PlayTheBlues4U [Tc 7c]
123tiger711a: folds 
SeaofLove: folds 
PlayTheBlues4U: raises $0.20 to $0.30
bsdnj: folds 
Klytu: raises $0.70 to $1
skillzplumber: folds 
PlayTheBlues4U: folds 
Uncalled bet ($0.70) returned to Klytu
Klytu collected $0.70 from pot
Klytu: doesn't show hand 
*** SUMMARY ***
Total pot $0.70 | Rake $0 
Seat 1: 123tiger711a folded before Flop (didn't bet)
Seat 2: SeaofLove folded before Flop (didn't bet)
Seat 3: PlayTheBlues4U folded before Flop
Seat 4: bsdnj (button) folded before Flop (didn't bet)
Seat 5: Klytu (small blind) collected ($0.70)
Seat 6: skillzplumber (big blind) folded before Flop



PokerStars Hand #204846339358:  Hold'em No Limit ($0.05/$0.10 USD) - 2019/10/21 21:09:53 ET
Table 'Draco' 6-max Seat #5 is the button
Seat 1: 123tiger711a ($12.73 in chips) 
Seat 2: SeaofLove ($10.99 in chips) 
Seat 3: PlayTheBlues4U ($9.56 in chips) 
Seat 4: bsdnj ($9.41 in chips) 
Seat 5: Klytu ($10.30 in chips) 
Seat 6: skillzplumber ($23.31 in chips) 
skillzplumber: posts small blind $0.05
123tiger711a: posts big blind $0.10
*** HOLE CARDS ***
Dealt to PlayTheBlues4U [6s Ac]
SeaofLove: folds 
PlayTheBlues4U: folds 
bsdnj: raises $0.20 to $0.30
Klytu: folds 
skillzplumber: folds 
123tiger711a: folds 
Uncalled bet ($0.20) returned to bsdnj
bsdnj collected $0.25 from pot
bsdnj: doesn't show hand 
*** SUMMARY ***
Total pot $0.25 | Rake $0 
Seat 1: 123tiger711a (big blind) folded before Flop
Seat 2: SeaofLove folded before Flop (didn't bet)
Seat 3: PlayTheBlues4U folded before Flop (didn't bet)
Seat 4: bsdnj collected ($0.25)
Seat 5: Klytu (button) folded before Flop (didn't bet)
Seat 6: skillzplumber (small blind) folded before Flop



PokerStars Hand #204846339426:  Hold'em No Limit ($0.05/$0.10 USD) - 2019/10/21 21:10:08 ET
Table 'Draco' 6-max Seat #6 is the button
Seat 1: 123tiger711a ($12.63 in chips) 
Seat 2: SeaofLove ($10.99 in chips) 
Seat 3: PlayTheBlues4U ($9.56 in chips) 
Seat 4: bsdnj ($9.56 in chips) 
Seat 5: Klytu ($10.30 in chips) 
Seat 6: skillzplumber ($23.26 in chips) 
123tiger711a: posts small blind $0.05
SeaofLove: posts big blind $0.10
*** HOLE CARDS ***
Dealt to PlayTheBlues4U [Jd Kh]
PlayTheBlues4U: raises $0.20 to $0.30
bsdnj: calls $0.30
Klytu: folds 
skillzplumber: calls $0.30
123tiger711a: folds 
SeaofLove: folds 
*** FLOP *** [9d 3c 9h]
PlayTheBlues4U: bets $0.70
bsdnj: calls $0.70
skillzplumber: calls $0.70
*** TURN *** [9d 3c 9h] [3h]
PlayTheBlues4U: checks 
bsdnj: checks 
skillzplumber: checks 
*** RIVER *** [9d 3c 9h 3h] [2d]
PlayTheBlues4U: checks 
bsdnj: bets $1.20
skillzplumber: raises $1.70 to $2.90
PlayTheBlues4U: folds 
bsdnj: folds 
Uncalled bet ($1.70) returned to skillzplumber
skillzplumber collected $5.27 from pot
skillzplumber: doesn't show hand 
*** SUMMARY ***
Total pot $5.55 | Rake $0.28 
Board [9d 3c 9h 3h 2d]
Seat 1: 123tiger711a (small blind) folded before Flop
Seat 2: SeaofLove (big blind) folded before Flop
Seat 3: PlayTheBlues4U folded on the River
Seat 4: bsdnj folded on the River
Seat 5: Klytu folded before Flop (didn't bet)
Seat 6: skillzplumber (button) collected ($5.27)



PokerStars Hand #204846339732:  Hold'em No Limit ($0.05/$0.10 USD) - 2019/10/21 21:11:17 ET
Table 'Draco' 6-max Seat #1 is the button
Seat 1: 123tiger711a ($12.58 in chips) 
Seat 2: SeaofLove ($10.89 in chips) 
Seat 3: PlayTheBlues4U ($8.56 in chips) 
Seat 4: bsdnj ($7.36 in chips) 
Seat 5: Klytu ($10.30 in chips) 
Seat 6: skillzplumber ($26.33 in chips) 
SeaofLove: posts small blind $0.05
PlayTheBlues4U: posts big blind $0.10
*** HOLE CARDS ***
Dealt to PlayTheBlues4U [2d Ks]
bsdnj: calls $0.10
Klytu: folds 
skillzplumber: folds 
123tiger711a: folds 
SeaofLove: folds 
PlayTheBlues4U: checks 
*** FLOP *** [Jc Td Th]
PlayTheBlues4U: checks 
bsdnj: bets $0.30
PlayTheBlues4U: folds 
Uncalled bet ($0.30) returned to bsdnj
bsdnj collected $0.24 from pot
bsdnj: doesn't show hand 
*** SUMMARY ***
Total pot $0.25 | Rake $0.01 
Board [Jc Td Th]
Seat 1: 123tiger711a (button) folded before Flop (didn't bet)
Seat 2: SeaofLove (small blind) folded before Flop
Seat 3: PlayTheBlues4U (big blind) folded on the Flop
Seat 4: bsdnj collected ($0.24)
Seat 5: Klytu folded before Flop (didn't bet)
Seat 6: skillzplumber folded before Flop (didn't bet)



PokerStars Hand #204846339823:  Hold'em No Limit ($0.05/$0.10 USD) - 2019/10/21 21:11:38 ET
Table 'Draco' 6-max Seat #2 is the button
Seat 1: 123tiger711a ($12.58 in chips) 
Seat 2: SeaofLove ($10.84 in chips) 
Seat 3: PlayTheBlues4U ($8.46 in chips) 
Seat 4: bsdnj ($7.50 in chips) 
Seat 5: Klytu ($10.30 in chips) 
Seat 6: skillzplumber ($26.33 in chips) 
PlayTheBlues4U: posts small blind $0.05
bsdnj: posts big blind $0.10
*** HOLE CARDS ***
Dealt to PlayTheBlues4U [4s 8d]
Klytu: raises $0.25 to $0.35
skillzplumber: folds 
123tiger711a: folds 
SeaofLove: folds 
PlayTheBlues4U: folds 
bsdnj: calls $0.25
*** FLOP *** [Tc Qc 6c]
bsdnj: bets $0.40
Klytu: folds 
Uncalled bet ($0.40) returned to bsdnj
bsdnj collected $0.71 from pot
bsdnj: doesn't show hand 
*** SUMMARY ***
Total pot $0.75 | Rake $0.04 
Board [Tc Qc 6c]
Seat 1: 123tiger711a folded before Flop (didn't bet)
Seat 2: SeaofLove (button) folded before Flop (didn't bet)
Seat 3: PlayTheBlues4U (small blind) folded before Flop
Seat 4: bsdnj (big blind) collected ($0.71)
Seat 5: Klytu folded on the Flop
Seat 6: skillzplumber folded before Flop (didn't bet)



PokerStars Hand #204846339920:  Hold'em No Limit ($0.05/$0.10 USD) - 2019/10/21 21:11:57 ET
Table 'Draco' 6-max Seat #3 is the button
Seat 1: 123tiger711a ($12.58 in chips) 
Seat 2: SeaofLove ($10.84 in chips) 
Seat 3: PlayTheBlues4U ($8.41 in chips) 
Seat 4: bsdnj ($7.86 in chips) 
Seat 5: Klytu ($10 in chips) 
Seat 6: skillzplumber ($26.33 in chips) 
bsdnj: posts small blind $0.05
Klytu: posts big blind $0.10
*** HOLE CARDS ***
Dealt to PlayTheBlues4U [Jc 7c]
skillzplumber: folds 
123tiger711a: folds 
SeaofLove: folds 
PlayTheBlues4U: raises $0.20 to $0.30
bsdnj: calls $0.25
Klytu: calls $0.20
*** FLOP *** [7s Qs 3d]
bsdnj: checks 
Klytu: bets $0.60
PlayTheBlues4U: calls $0.60
bsdnj: folds 
*** TURN *** [7s Qs 3d] [Js]
Klytu: bets $1.30
PlayTheBlues4U: calls $1.30
*** RIVER *** [7s Qs 3d Js] [Td]
Klytu: bets $2.25
PlayTheBlues4U: calls $2.25
*** SHOW DOWN ***
Klytu: shows [Qd Jd] (two pair, Queens and Jacks)
PlayTheBlues4U: mucks hand 
Klytu collected $8.74 from pot
*** SUMMARY ***
Total pot $9.20 | Rake $0.46 
Board [7s Qs 3d Js Td]
Seat 1: 123tiger711a folded before Flop (didn't bet)
Seat 2: SeaofLove folded before Flop (didn't bet)
Seat 3: PlayTheBlues4U (button) mucked [Jc 7c]
Seat 4: bsdnj (small blind) folded on the Flop
Seat 5: Klytu (big blind) showed [Qd Jd] and won ($8.74) with two pair, Queens and Jacks
Seat 6: skillzplumber folded before Flop (didn't bet)



PokerStars Hand #204848294107:  Hold'em No Limit ($0.05/$0.10 USD) - 2019/10/21 21:12:42 ET
Table 'Draco' 6-max Seat #4 is the button
Seat 1: 123tiger711a ($12.58 in chips) 
Seat 2: SeaofLove ($10.84 in chips) 
Seat 3: PlayTheBlues4U ($3.96 in chips) 
Seat 4: bsdnj ($7.56 in chips) 
Seat 5: Klytu ($14.29 in chips) 
Seat 6: skillzplumber ($26.33 in chips) 
Klytu: posts small blind $0.05
skillzplumber: posts big blind $0.10
*** HOLE CARDS ***
Dealt to PlayTheBlues4U [7c 4h]
123tiger711a: folds 
SeaofLove: folds 
PlayTheBlues4U: folds 
bsdnj: folds 
Klytu: folds 
Uncalled bet ($0.05) returned to skillzplumber
skillzplumber collected $0.10 from pot
skillzplumber: doesn't show hand 
*** SUMMARY ***
Total pot $0.10 | Rake $0 
Seat 1: 123tiger711a folded before Flop (didn't bet)
Seat 2: SeaofLove folded before Flop (didn't bet)
Seat 3: PlayTheBlues4U folded before Flop (didn't bet)
Seat 4: bsdnj (button) folded before Flop (didn't bet)
Seat 5: Klytu (small blind) folded before Flop
Seat 6: skillzplumber (big blind) collected ($0.10)



PokerStars Hand #204848294135:  Hold'em No Limit ($0.05/$0.10 USD) - 2019/10/21 21:12:49 ET
Table 'Draco' 6-max Seat #5 is the button
Seat 1: 123tiger711a ($12.58 in chips) 
Seat 2: SeaofLove ($10.84 in chips) 
Seat 3: PlayTheBlues4U ($3.96 in chips) 
Seat 4: bsdnj ($7.56 in chips) 
Seat 5: Klytu ($14.24 in chips) 
Seat 6: skillzplumber ($26.38 in chips) 
skillzplumber: posts small blind $0.05
123tiger711a: posts big blind $0.10
*** HOLE CARDS ***
Dealt to PlayTheBlues4U [Kh 3c]
SeaofLove: folds 
PlayTheBlues4U: folds 
bsdnj: folds 
Klytu: folds 
skillzplumber: calls $0.05
123tiger711a: checks 
*** FLOP *** [5d 2h 4h]
skillzplumber: checks 
123tiger711a: bets $0.10
skillzplumber: folds 
Uncalled bet ($0.10) returned to 123tiger711a
123tiger711a collected $0.19 from pot
*** SUMMARY ***
Total pot $0.20 | Rake $0.01 
Board [5d 2h 4h]
Seat 1: 123tiger711a (big blind) collected ($0.19)
Seat 2: SeaofLove folded before Flop (didn't bet)
Seat 3: PlayTheBlues4U folded before Flop (didn't bet)
Seat 4: bsdnj folded before Flop (didn't bet)
Seat 5: Klytu (button) folded before Flop (didn't bet)
Seat 6: skillzplumber (small blind) folded on the Flop



PokerStars Hand #204848294204:  Hold'em No Limit ($0.05/$0.10 USD) - 2019/10/21 21:13:06 ET
Table 'Draco' 6-max Seat #6 is the button
Seat 1: 123tiger711a ($12.67 in chips) 
Seat 2: SeaofLove ($10.84 in chips) 
Seat 3: PlayTheBlues4U ($10 in chips) 
Seat 4: bsdnj ($7.56 in chips) 
Seat 5: Klytu ($14.24 in chips) 
Seat 6: skillzplumber ($26.28 in chips) 
123tiger711a: posts small blind $0.05
SeaofLove: posts big blind $0.10
*** HOLE CARDS ***
Dealt to PlayTheBlues4U [5c Ac]
PlayTheBlues4U: raises $0.20 to $0.30
bsdnj: folds 
Klytu: calls $0.30
skillzplumber: folds 
123tiger711a: folds 
SeaofLove: folds 
*** FLOP *** [2s Qc 3h]
PlayTheBlues4U: bets $0.50
Klytu: folds 
Uncalled bet ($0.50) returned to PlayTheBlues4U
PlayTheBlues4U collected $0.71 from pot
PlayTheBlues4U: doesn't show hand 
*** SUMMARY ***
Total pot $0.75 | Rake $0.04 
Board [2s Qc 3h]
Seat 1: 123tiger711a (small blind) folded before Flop
Seat 2: SeaofLove (big blind) folded before Flop
Seat 3: PlayTheBlues4U collected ($0.71)
Seat 4: bsdnj folded before Flop (didn't bet)
Seat 5: Klytu folded on the Flop
Seat 6: skillzplumber (button) folded before Flop (didn't bet)



PokerStars Hand #204848294329:  Hold'em No Limit ($0.05/$0.10 USD) - 2019/10/21 21:13:33 ET
Table 'Draco' 6-max Seat #1 is the button
Seat 1: 123tiger711a ($12.62 in chips) 
Seat 2: SeaofLove ($10.74 in chips) 
Seat 3: PlayTheBlues4U ($10.41 in chips) 
Seat 4: bsdnj ($7.56 in chips) 
Seat 5: Klytu ($13.94 in chips) 
Seat 6: skillzplumber ($26.28 in chips) 
SeaofLove: posts small blind $0.05
PlayTheBlues4U: posts big blind $0.10
*** HOLE CARDS ***
Dealt to PlayTheBlues4U [9c 8h]
bsdnj: folds 
Klytu: folds 
skillzplumber: calls $0.10
123tiger711a: folds 
SeaofLove: folds 
PlayTheBlues4U: checks 
*** FLOP *** [Qs Js 5d]
PlayTheBlues4U: checks 
skillzplumber: checks 
*** TURN *** [Qs Js 5d] [Ts]
PlayTheBlues4U: bets $0.20
skillzplumber: folds 
Uncalled bet ($0.20) returned to PlayTheBlues4U
PlayTheBlues4U collected $0.24 from pot
PlayTheBlues4U: doesn't show hand 
*** SUMMARY ***
Total pot $0.25 | Rake $0.01 
Board [Qs Js 5d Ts]
Seat 1: 123tiger711a (button) folded before Flop (didn't bet)
Seat 2: SeaofLove (small blind) folded before Flop
Seat 3: PlayTheBlues4U (big blind) collected ($0.24)
Seat 4: bsdnj folded before Flop (didn't bet)
Seat 5: Klytu folded before Flop (didn't bet)
Seat 6: skillzplumber folded on the Turn



PokerStars Hand #204848294444:  Hold'em No Limit ($0.05/$0.10 USD) - 2019/10/21 21:13:57 ET
Table 'Draco' 6-max Seat #2 is the button
Seat 1: 123tiger711a ($12.62 in chips) 
Seat 2: SeaofLove ($10.69 in chips) 
Seat 3: PlayTheBlues4U ($10.55 in chips) 
Seat 4: bsdnj ($7.56 in chips) 
Seat 5: Klytu ($13.94 in chips) 
Seat 6: skillzplumber ($26.18 in chips) 
PlayTheBlues4U: posts small blind $0.05
bsdnj: posts big blind $0.10
*** HOLE CARDS ***
Dealt to PlayTheBlues4U [2s Kc]
Klytu: calls $0.10
skillzplumber: folds 
123tiger711a: folds 
SeaofLove: folds 
PlayTheBlues4U: folds 
bsdnj: checks 
*** FLOP *** [Kh 9d 6d]
bsdnj: checks 
Klytu: bets $0.15
bsdnj: folds 
Uncalled bet ($0.15) returned to Klytu
Klytu collected $0.24 from pot
Klytu: doesn't show hand 
*** SUMMARY ***
Total pot $0.25 | Rake $0.01 
Board [Kh 9d 6d]
Seat 1: 123tiger711a folded before Flop (didn't bet)
Seat 2: SeaofLove (button) folded before Flop (didn't bet)
Seat 3: PlayTheBlues4U (small blind) folded before Flop
Seat 4: bsdnj (big blind) folded on the Flop
Seat 5: Klytu collected ($0.24)
Seat 6: skillzplumber folded before Flop (didn't bet)



PokerStars Hand #204848294590:  Hold'em No Limit ($0.05/$0.10 USD) - 2019/10/21 21:14:30 ET
Table 'Draco' 6-max Seat #3 is the button
Seat 1: 123tiger711a ($12.62 in chips) 
Seat 2: SeaofLove ($10.69 in chips) 
Seat 3: PlayTheBlues4U ($10.50 in chips) 
Seat 4: bsdnj ($7.46 in chips) 
Seat 5: Klytu ($14.08 in chips) 
Seat 6: skillzplumber ($26.18 in chips) 
bsdnj: posts small blind $0.05
Klytu: posts big blind $0.10
*** HOLE CARDS ***
Dealt to PlayTheBlues4U [5c Jh]
skillzplumber: raises $0.20 to $0.30
123tiger711a: calls $0.30
SeaofLove: folds 
PlayTheBlues4U: folds 
bsdnj: calls $0.25
Klytu: folds 
*** FLOP *** [Qh 9h Jc]
bsdnj: checks 
skillzplumber: checks 
123tiger711a: checks 
*** TURN *** [Qh 9h Jc] [2h]
bsdnj: checks 
skillzplumber: bets $0.30
123tiger711a: folds 
bsdnj: folds 
Uncalled bet ($0.30) returned to skillzplumber
skillzplumber collected $0.95 from pot
skillzplumber: doesn't show hand 
*** SUMMARY ***
Total pot $1 | Rake $0.05 
Board [Qh 9h Jc 2h]
Seat 1: 123tiger711a folded on the Turn
Seat 2: SeaofLove folded before Flop (didn't bet)
Seat 3: PlayTheBlues4U (button) folded before Flop (didn't bet)
Seat 4: bsdnj (small blind) folded on the Turn
Seat 5: Klytu (big blind) folded before Flop
Seat 6: skillzplumber collected ($0.95)



PokerStars Hand #204848294754:  Hold'em No Limit ($0.05/$0.10 USD) - 2019/10/21 21:15:08 ET
Table 'Draco' 6-max Seat #4 is the button
Seat 1: 123tiger711a ($12.32 in chips) 
Seat 2: SeaofLove ($10.69 in chips) 
Seat 3: PlayTheBlues4U ($10.50 in chips) 
Seat 4: bsdnj ($7.16 in chips) 
Seat 5: Klytu ($13.98 in chips) 
Seat 6: skillzplumber ($26.83 in chips) 
Klytu: posts small blind $0.05
skillzplumber: posts big blind $0.10
*** HOLE CARDS ***
Dealt to PlayTheBlues4U [Js 3c]
123tiger711a: calls $0.10
SeaofLove: folds 
PlayTheBlues4U: folds 
bsdnj: calls $0.10
Klytu: calls $0.05
skillzplumber: checks 
*** FLOP *** [Ah 2d Td]
Klytu: checks 
skillzplumber: bets $0.40
123tiger711a: folds 
bsdnj: folds 
Klytu: folds 
Uncalled bet ($0.40) returned to skillzplumber
skillzplumber collected $0.38 from pot
skillzplumber: doesn't show hand 
*** SUMMARY ***
Total pot $0.40 | Rake $0.02 
Board [Ah 2d Td]
Seat 1: 123tiger711a folded on the Flop
Seat 2: SeaofLove folded before Flop (didn't bet)
Seat 3: PlayTheBlues4U folded before Flop (didn't bet)
Seat 4: bsdnj (button) folded on the Flop
Seat 5: Klytu (small blind) folded on the Flop
Seat 6: skillzplumber (big blind) collected ($0.38)



PokerStars Hand #204848294876:  Hold'em No Limit ($0.05/$0.10 USD) - 2019/10/21 21:15:35 ET
Table 'Draco' 6-max Seat #5 is the button
Seat 1: 123tiger711a ($12.22 in chips) 
Seat 2: SeaofLove ($10.69 in chips) 
Seat 3: PlayTheBlues4U ($10.50 in chips) 
Seat 4: bsdnj ($7.06 in chips) 
Seat 5: Klytu ($13.88 in chips) 
Seat 6: skillzplumber ($27.11 in chips) 
skillzplumber: posts small blind $0.05
123tiger711a: posts big blind $0.10
*** HOLE CARDS ***
Dealt to PlayTheBlues4U [5s Qd]
SeaofLove: raises $0.25 to $0.35
PlayTheBlues4U: folds 
bsdnj: folds 
Klytu: folds 
skillzplumber: folds 
123tiger711a: folds 
Uncalled bet ($0.25) returned to SeaofLove
SeaofLove collected $0.25 from pot
SeaofLove: doesn't show hand 
*** SUMMARY ***
Total pot $0.25 | Rake $0 
Seat 1: 123tiger711a (big blind) folded before Flop
Seat 2: SeaofLove collected ($0.25)
Seat 3: PlayTheBlues4U folded before Flop (didn't bet)
Seat 4: bsdnj folded before Flop (didn't bet)
Seat 5: Klytu (button) folded before Flop (didn't bet)
Seat 6: skillzplumber (small blind) folded before Flop



PokerStars Hand #204848294933:  Hold'em No Limit ($0.05/$0.10 USD) - 2019/10/21 21:15:48 ET
Table 'Draco' 6-max Seat #6 is the button
Seat 1: 123tiger711a ($12.12 in chips) 
Seat 2: SeaofLove ($10.84 in chips) 
Seat 3: PlayTheBlues4U ($10.50 in chips) 
Seat 4: bsdnj ($7.06 in chips) 
Seat 5: Klytu ($13.88 in chips) 
Seat 6: skillzplumber ($27.06 in chips) 
123tiger711a: posts small blind $0.05
SeaofLove: posts big blind $0.10
*** HOLE CARDS ***
Dealt to PlayTheBlues4U [Th 3s]
PlayTheBlues4U: folds 
bsdnj: folds 
Klytu: raises $0.15 to $0.25
skillzplumber: folds 
123tiger711a: calls $0.20
SeaofLove: calls $0.15
*** FLOP *** [6h 7s Ts]
123tiger711a: checks 
SeaofLove: checks 
Klytu: bets $0.45
123tiger711a: folds 
SeaofLove: folds 
Uncalled bet ($0.45) returned to Klytu
Klytu collected $0.71 from pot
Klytu: doesn't show hand 
*** SUMMARY ***
Total pot $0.75 | Rake $0.04 
Board [6h 7s Ts]
Seat 1: 123tiger711a (small blind) folded on the Flop
Seat 2: SeaofLove (big blind) folded on the Flop
Seat 3: PlayTheBlues4U folded before Flop (didn't bet)
Seat 4: bsdnj folded before Flop (didn't bet)
Seat 5: Klytu collected ($0.71)
Seat 6: skillzplumber (button) folded before Flop (didn't bet)



PokerStars Hand #204848295060:  Hold'em No Limit ($0.05/$0.10 USD) - 2019/10/21 21:16:16 ET
Table 'Draco' 6-max Seat #1 is the button
Seat 1: 123tiger711a ($11.87 in chips) 
Seat 2: SeaofLove ($10.59 in chips) 
Seat 3: PlayTheBlues4U ($10.50 in chips) 
Seat 4: bsdnj ($7.06 in chips) 
Seat 5: Klytu ($14.34 in chips) 
Seat 6: skillzplumber ($27.06 in chips) 
SeaofLove: posts small blind $0.05
PlayTheBlues4U: posts big blind $0.10
*** HOLE CARDS ***
Dealt to PlayTheBlues4U [9c 9s]
bsdnj: calls $0.10
Klytu: folds 
skillzplumber: raises $0.20 to $0.30
123tiger711a: folds 
SeaofLove: raises $0.80 to $1.10
PlayTheBlues4U: folds 
bsdnj: folds 
skillzplumber: calls $0.80
*** FLOP *** [Ad Qh Qc]
SeaofLove: bets $1.20
skillzplumber: calls $1.20
*** TURN *** [Ad Qh Qc] [9h]
SeaofLove: bets $2.30
skillzplumber: calls $2.30
*** RIVER *** [Ad Qh Qc 9h] [2s]
SeaofLove: bets $5.99 and is all-in
skillzplumber: calls $5.99
*** SHOW DOWN ***
SeaofLove: shows [As Kc] (two pair, Aces and Queens)
skillzplumber: shows [Ts Ah] (two pair, Aces and Queens - lower kicker)
SeaofLove collected $20.31 from pot
*** SUMMARY ***
Total pot $21.38 | Rake $1.07 
Board [Ad Qh Qc 9h 2s]
Seat 1: 123tiger711a (button) folded before Flop (didn't bet)
Seat 2: SeaofLove (small blind) showed [As Kc] and won ($20.31) with two pair, Aces and Queens
Seat 3: PlayTheBlues4U (big blind) folded before Flop
Seat 4: bsdnj folded before Flop
Seat 5: Klytu folded before Flop (didn't bet)
Seat 6: skillzplumber showed [Ts Ah] and lost with two pair, Aces and Queens



PokerStars Hand #204848295265:  Hold'em No Limit ($0.05/$0.10 USD) - 2019/10/21 21:17:07 ET
Table 'Draco' 6-max Seat #2 is the button
Seat 1: 123tiger711a ($11.87 in chips) 
Seat 2: SeaofLove ($20.31 in chips) 
Seat 3: PlayTheBlues4U ($10.40 in chips) 
Seat 4: bsdnj ($6.96 in chips) 
Seat 5: Klytu ($14.34 in chips) 
Seat 6: skillzplumber ($16.47 in chips) 
PlayTheBlues4U: posts small blind $0.05
bsdnj: posts big blind $0.10
*** HOLE CARDS ***
Dealt to PlayTheBlues4U [6h Jd]
Klytu: folds 
skillzplumber: folds 
skillzplumber leaves the table
123tiger711a: calls $0.10
SeaofLove: folds 
EddieMoney9 joins the table at seat #6 
PlayTheBlues4U: folds 
bsdnj: checks 
*** FLOP *** [3c Ah As]
bsdnj: checks 
123tiger711a: bets $0.12
bsdnj: folds 
Uncalled bet ($0.12) returned to 123tiger711a
123tiger711a collected $0.24 from pot
*** SUMMARY ***
Total pot $0.25 | Rake $0.01 
Board [3c Ah As]
Seat 1: 123tiger711a collected ($0.24)
Seat 2: SeaofLove (button) folded before Flop (didn't bet)
Seat 3: PlayTheBlues4U (small blind) folded before Flop
Seat 4: bsdnj (big blind) folded on the Flop
Seat 5: Klytu folded before Flop (didn't bet)
Seat 6: skillzplumber folded before Flop (didn't bet)



PokerStars Hand #204848295346:  Hold'em No Limit ($0.05/$0.10 USD) - 2019/10/21 21:17:26 ET
Table 'Draco' 6-max Seat #3 is the button
Seat 1: 123tiger711a ($12.01 in chips) 
Seat 2: SeaofLove ($20.31 in chips) 
Seat 3: PlayTheBlues4U ($10.35 in chips) 
Seat 4: bsdnj ($6.86 in chips) 
Seat 5: Klytu ($14.34 in chips) 
bsdnj: posts small blind $0.05
Klytu: posts big blind $0.10
EddieMoney9: sits out 
*** HOLE CARDS ***
Dealt to PlayTheBlues4U [Kh 3d]
123tiger711a: folds 
SeaofLove: folds 
PlayTheBlues4U: folds 
bsdnj: folds 
Uncalled bet ($0.05) returned to Klytu
Klytu collected $0.10 from pot
Klytu: doesn't show hand 
*** SUMMARY ***
Total pot $0.10 | Rake $0 
Seat 1: 123tiger711a folded before Flop (didn't bet)
Seat 2: SeaofLove folded before Flop (didn't bet)
Seat 3: PlayTheBlues4U (button) folded before Flop (didn't bet)
Seat 4: bsdnj (small blind) folded before Flop
Seat 5: Klytu (big blind) collected ($0.10)



PokerStars Hand #204848295397:  Hold'em No Limit ($0.05/$0.10 USD) - 2019/10/21 21:17:37 ET
Table 'Draco' 6-max Seat #4 is the button
Seat 1: 123tiger711a ($12.01 in chips) 
Seat 2: SeaofLove ($20.31 in chips) 
Seat 3: PlayTheBlues4U ($10.35 in chips) 
Seat 4: bsdnj ($6.81 in chips) 
Seat 5: Klytu ($14.39 in chips) 
Seat 6: EddieMoney9 ($10 in chips) 
Klytu: posts small blind $0.05
EddieMoney9: posts big blind $0.10
*** HOLE CARDS ***
Dealt to PlayTheBlues4U [Th 8h]
123tiger711a: folds 
SeaofLove: folds 
PlayTheBlues4U: raises $0.20 to $0.30
bsdnj: folds 
Klytu: folds 
EddieMoney9: raises $0.70 to $1
PlayTheBlues4U: folds 
Uncalled bet ($0.70) returned to EddieMoney9
EddieMoney9 collected $0.65 from pot
EddieMoney9: doesn't show hand 
*** SUMMARY ***
Total pot $0.65 | Rake $0 
Seat 1: 123tiger711a folded before Flop (didn't bet)
Seat 2: SeaofLove folded before Flop (didn't bet)
Seat 3: PlayTheBlues4U folded before Flop
Seat 4: bsdnj (button) folded before Flop (didn't bet)
Seat 5: Klytu (small blind) folded before Flop
Seat 6: EddieMoney9 (big blind) collected ($0.65)



PokerStars Hand #204848295526:  Hold'em No Limit ($0.05/$0.10 USD) - 2019/10/21 21:18:08 ET
Table 'Draco' 6-max Seat #5 is the button
Seat 1: 123tiger711a ($12.01 in chips) 
Seat 2: SeaofLove ($20.31 in chips) 
Seat 3: PlayTheBlues4U ($10.05 in chips) 
Seat 4: bsdnj ($6.81 in chips) 
Seat 5: Klytu ($14.34 in chips) 
Seat 6: EddieMoney9 ($10.35 in chips) 
EddieMoney9: posts small blind $0.05
123tiger711a: posts big blind $0.10
*** HOLE CARDS ***
Dealt to PlayTheBlues4U [9s Qs]
SeaofLove: folds 
PlayTheBlues4U: folds 
bsdnj: calls $0.10
Klytu: calls $0.10
EddieMoney9: folds 
123tiger711a: checks 
*** FLOP *** [9d 7h 8h]
123tiger711a: checks 
bsdnj: checks 
Klytu: bets $0.20
123tiger711a: folds 
bsdnj: calls $0.20
*** TURN *** [9d 7h 8h] [Ks]
bsdnj: checks 
Klytu: bets $0.40
bsdnj: folds 
Uncalled bet ($0.40) returned to Klytu
Klytu collected $0.71 from pot
Klytu: doesn't show hand 
*** SUMMARY ***
Total pot $0.75 | Rake $0.04 
Board [9d 7h 8h Ks]
Seat 1: 123tiger711a (big blind) folded on the Flop
Seat 2: SeaofLove folded before Flop (didn't bet)
Seat 3: PlayTheBlues4U folded before Flop (didn't bet)
Seat 4: bsdnj folded on the Turn
Seat 5: Klytu (button) collected ($0.71)
Seat 6: EddieMoney9 (small blind) folded before Flop



PokerStars Hand #204848295746:  Hold'em No Limit ($0.05/$0.10 USD) - 2019/10/21 21:19:01 ET
Table 'Draco' 6-max Seat #6 is the button
Seat 1: 123tiger711a ($11.91 in chips) 
Seat 2: SeaofLove ($20.31 in chips) 
Seat 3: PlayTheBlues4U ($10.05 in chips) 
Seat 4: bsdnj ($6.51 in chips) 
Seat 5: Klytu ($14.75 in chips) 
Seat 6: EddieMoney9 ($10.30 in chips) 
123tiger711a: posts small blind $0.05
SeaofLove: posts big blind $0.10
*** HOLE CARDS ***
Dealt to PlayTheBlues4U [4h Kh]
PlayTheBlues4U: folds 
bsdnj: folds 
Klytu: folds 
EddieMoney9: raises $0.25 to $0.35
123tiger711a: folds 
SeaofLove: calls $0.25
*** FLOP *** [2s 2d 9s]
SeaofLove: checks 
EddieMoney9: checks 
*** TURN *** [2s 2d 9s] [Qs]
SeaofLove: bets $0.47
EddieMoney9: calls $0.47
*** RIVER *** [2s 2d 9s Qs] [Ts]
SeaofLove: bets $1.07
EddieMoney9: folds [Qc]
Uncalled bet ($1.07) returned to SeaofLove
SeaofLove collected $1.61 from pot
SeaofLove: doesn't show hand 
*** SUMMARY ***
Total pot $1.69 | Rake $0.08 
Board [2s 2d 9s Qs Ts]
Seat 1: 123tiger711a (small blind) folded before Flop
Seat 2: SeaofLove (big blind) collected ($1.61)
Seat 3: PlayTheBlues4U folded before Flop (didn't bet)
Seat 4: bsdnj folded before Flop (didn't bet)
Seat 5: Klytu folded before Flop (didn't bet)
Seat 6: EddieMoney9 (button) folded on the River



PokerStars Hand #204848295938:  Hold'em No Limit ($0.05/$0.10 USD) - 2019/10/21 21:19:50 ET
Table 'Draco' 6-max Seat #1 is the button
Seat 1: 123tiger711a ($11.86 in chips) 
Seat 2: SeaofLove ($21.10 in chips) 
Seat 3: PlayTheBlues4U ($10.05 in chips) 
Seat 4: bsdnj ($6.51 in chips) 
Seat 5: Klytu ($14.75 in chips) 
Seat 6: EddieMoney9 ($9.48 in chips) 
SeaofLove: posts small blind $0.05
PlayTheBlues4U: posts big blind $0.10
*** HOLE CARDS ***
Dealt to PlayTheBlues4U [8c 2d]
bsdnj: folds 
Klytu: folds 
EddieMoney9: folds 
123tiger711a: calls $0.10
SeaofLove: folds 
PlayTheBlues4U: checks 
*** FLOP *** [5d 6s As]
PlayTheBlues4U: checks 
123tiger711a: bets $0.12
PlayTheBlues4U: folds 
Uncalled bet ($0.12) returned to 123tiger711a
123tiger711a collected $0.24 from pot
*** SUMMARY ***
Total pot $0.25 | Rake $0.01 
Board [5d 6s As]
Seat 1: 123tiger711a (button) collected ($0.24)
Seat 2: SeaofLove (small blind) folded before Flop
Seat 3: PlayTheBlues4U (big blind) folded on the Flop
Seat 4: bsdnj folded before Flop (didn't bet)
Seat 5: Klytu folded before Flop (didn't bet)
Seat 6: EddieMoney9 folded before Flop (didn't bet)



PokerStars Hand #204848296008:  Hold'em No Limit ($0.05/$0.10 USD) - 2019/10/21 21:20:06 ET
Table 'Draco' 6-max Seat #2 is the button
Seat 1: 123tiger711a ($12 in chips) 
Seat 2: SeaofLove ($21.05 in chips) 
Seat 3: PlayTheBlues4U ($9.95 in chips) 
Seat 4: bsdnj ($6.51 in chips) 
Seat 5: Klytu ($14.75 in chips) 
Seat 6: EddieMoney9 ($9.48 in chips) 
PlayTheBlues4U: posts small blind $0.05
bsdnj: posts big blind $0.10
*** HOLE CARDS ***
Dealt to PlayTheBlues4U [9c 8s]
Klytu: folds 
EddieMoney9: raises $0.20 to $0.30
123tiger711a: folds 
SeaofLove: raises $0.75 to $1.05
PlayTheBlues4U: folds 
bsdnj: calls $0.95
EddieMoney9: folds 
*** FLOP *** [Th Qh Td]
bsdnj: checks 
SeaofLove: bets $1.20
bsdnj: calls $1.20
*** TURN *** [Th Qh Td] [9d]
bsdnj: bets $4.26 and is all-in
SeaofLove: folds 
Uncalled bet ($4.26) returned to bsdnj
bsdnj collected $4.61 from pot
bsdnj: doesn't show hand 
*** SUMMARY ***
Total pot $4.85 | Rake $0.24 
Board [Th Qh Td 9d]
Seat 1: 123tiger711a folded before Flop (didn't bet)
Seat 2: SeaofLove (button) folded on the Turn
Seat 3: PlayTheBlues4U (small blind) folded before Flop
Seat 4: bsdnj (big blind) collected ($4.61)
Seat 5: Klytu folded before Flop (didn't bet)
Seat 6: EddieMoney9 folded before Flop



PokerStars Hand #204848296187:  Hold'em No Limit ($0.05/$0.10 USD) - 2019/10/21 21:20:49 ET
Table 'Draco' 6-max Seat #3 is the button
Seat 1: 123tiger711a ($12 in chips) 
Seat 2: SeaofLove ($18.80 in chips) 
Seat 3: PlayTheBlues4U ($9.90 in chips) 
Seat 4: bsdnj ($8.87 in chips) 
Seat 5: Klytu ($14.75 in chips) 
Seat 6: EddieMoney9 ($9.18 in chips) 
bsdnj: posts small blind $0.05
Klytu: posts big blind $0.10
*** HOLE CARDS ***
Dealt to PlayTheBlues4U [Qd 8h]
EddieMoney9: folds 
123tiger711a: folds 
SeaofLove: folds 
PlayTheBlues4U: folds 
bsdnj: calls $0.05
Klytu: checks 
*** FLOP *** [Kd 7s Ac]
bsdnj: checks 
Klytu: checks 
*** TURN *** [Kd 7s Ac] [Th]
bsdnj: bets $0.20
Klytu: calls $0.20
*** RIVER *** [Kd 7s Ac Th] [3h]
bsdnj: bets $0.90
Klytu: calls $0.90
*** SHOW DOWN ***
bsdnj: shows [Qc Jh] (a straight, Ten to Ace)
Klytu: mucks hand 
bsdnj collected $2.28 from pot
*** SUMMARY ***
Total pot $2.40 | Rake $0.12 
Board [Kd 7s Ac Th 3h]
Seat 1: 123tiger711a folded before Flop (didn't bet)
Seat 2: SeaofLove folded before Flop (didn't bet)
Seat 3: PlayTheBlues4U (button) folded before Flop (didn't bet)
Seat 4: bsdnj (small blind) showed [Qc Jh] and won ($2.28) with a straight, Ten to Ace
Seat 5: Klytu (big blind) mucked [As 6d]
Seat 6: EddieMoney9 folded before Flop (didn't bet)



PokerStars Hand #204848296353:  Hold'em No Limit ($0.05/$0.10 USD) - 2019/10/21 21:21:31 ET
Table 'Draco' 6-max Seat #4 is the button
Seat 1: 123tiger711a ($12 in chips) 
Seat 2: SeaofLove ($18.80 in chips) 
Seat 3: PlayTheBlues4U ($9.90 in chips) 
Seat 4: bsdnj ($9.95 in chips) 
Seat 5: Klytu ($13.55 in chips) 
Seat 6: EddieMoney9 ($9.18 in chips) 
Klytu: posts small blind $0.05
EddieMoney9: posts big blind $0.10
*** HOLE CARDS ***
Dealt to PlayTheBlues4U [6c 3d]
123tiger711a: folds 
SeaofLove: folds 
PlayTheBlues4U: folds 
bsdnj: folds 
Klytu: folds 
Uncalled bet ($0.05) returned to EddieMoney9
EddieMoney9 collected $0.10 from pot
EddieMoney9: doesn't show hand 
*** SUMMARY ***
Total pot $0.10 | Rake $0 
Seat 1: 123tiger711a folded before Flop (didn't bet)
Seat 2: SeaofLove folded before Flop (didn't bet)
Seat 3: PlayTheBlues4U folded before Flop (didn't bet)
Seat 4: bsdnj (button) folded before Flop (didn't bet)
Seat 5: Klytu (small blind) folded before Flop
Seat 6: EddieMoney9 (big blind) collected ($0.10)



PokerStars Hand #204848296391:  Hold'em No Limit ($0.05/$0.10 USD) - 2019/10/21 21:21:41 ET
Table 'Draco' 6-max Seat #5 is the button
Seat 1: 123tiger711a ($12 in chips) 
Seat 2: SeaofLove ($18.80 in chips) 
Seat 3: PlayTheBlues4U ($9.90 in chips) 
Seat 4: bsdnj ($9.95 in chips) 
Seat 5: Klytu ($13.50 in chips) 
Seat 6: EddieMoney9 ($9.23 in chips) 
EddieMoney9: posts small blind $0.05
123tiger711a: posts big blind $0.10
*** HOLE CARDS ***
Dealt to PlayTheBlues4U [As 3c]
SeaofLove: raises $0.20 to $0.30
PlayTheBlues4U: folds 
bsdnj: calls $0.30
Klytu: folds 
EddieMoney9: folds 
123tiger711a: folds 
*** FLOP *** [Ad Ac Kc]
SeaofLove: checks 
bsdnj: checks 
*** TURN *** [Ad Ac Kc] [Jc]
SeaofLove: bets $0.36
bsdnj: folds 
Uncalled bet ($0.36) returned to SeaofLove
SeaofLove collected $0.71 from pot
SeaofLove: doesn't show hand 
*** SUMMARY ***
Total pot $0.75 | Rake $0.04 
Board [Ad Ac Kc Jc]
Seat 1: 123tiger711a (big blind) folded before Flop
Seat 2: SeaofLove collected ($0.71)
Seat 3: PlayTheBlues4U folded before Flop (didn't bet)
Seat 4: bsdnj folded on the Turn
Seat 5: Klytu (button) folded before Flop (didn't bet)
Seat 6: EddieMoney9 (small blind) folded before Flop



PokerStars Hand #204848296535:  Hold'em No Limit ($0.05/$0.10 USD) - 2019/10/21 21:22:15 ET
Table 'Draco' 6-max Seat #6 is the button
Seat 1: 123tiger711a ($11.90 in chips) 
Seat 2: SeaofLove ($19.21 in chips) 
Seat 3: PlayTheBlues4U ($9.90 in chips) 
Seat 4: bsdnj ($9.65 in chips) 
Seat 5: Klytu ($13.50 in chips) 
Seat 6: EddieMoney9 ($9.18 in chips) 
123tiger711a: posts small blind $0.05
SeaofLove: posts big blind $0.10
*** HOLE CARDS ***
Dealt to PlayTheBlues4U [Td Jh]
PlayTheBlues4U: folds 
bsdnj: folds 
Klytu: folds 
EddieMoney9: raises $0.20 to $0.30
123tiger711a: calls $0.25
SeaofLove: calls $0.20
*** FLOP *** [Qd As 7h]
123tiger711a: checks 
SeaofLove: checks 
EddieMoney9: bets $0.50
123tiger711a: raises $0.50 to $1
SeaofLove: folds 
EddieMoney9: calls $0.50
*** TURN *** [Qd As 7h] [5h]
123tiger711a: checks 
EddieMoney9: checks 
*** RIVER *** [Qd As 7h 5h] [Qs]
123tiger711a: bets $1.38
EddieMoney9: calls $1.38
*** SHOW DOWN ***
123tiger711a: shows [Kd Qc] (three of a kind, Queens)
EddieMoney9: mucks hand 
123tiger711a collected $5.38 from pot
*** SUMMARY ***
Total pot $5.66 | Rake $0.28 
Board [Qd As 7h 5h Qs]
Seat 1: 123tiger711a (small blind) showed [Kd Qc] and won ($5.38) with three of a kind, Queens
Seat 2: SeaofLove (big blind) folded on the Flop
Seat 3: PlayTheBlues4U folded before Flop (didn't bet)
Seat 4: bsdnj folded before Flop (didn't bet)
Seat 5: Klytu folded before Flop (didn't bet)
Seat 6: EddieMoney9 (button) mucked [Ah Js]



PokerStars Hand #204848296805:  Hold'em No Limit ($0.05/$0.10 USD) - 2019/10/21 21:23:25 ET
Table 'Draco' 6-max Seat #1 is the button
Seat 1: 123tiger711a ($14.60 in chips) 
Seat 2: SeaofLove ($18.91 in chips) 
Seat 3: PlayTheBlues4U ($9.90 in chips) 
Seat 4: bsdnj ($9.65 in chips) 
Seat 5: Klytu ($13.50 in chips) 
Seat 6: EddieMoney9 ($6.50 in chips) 
SeaofLove: posts small blind $0.05
PlayTheBlues4U: posts big blind $0.10
*** HOLE CARDS ***
Dealt to PlayTheBlues4U [Ah 7h]
bsdnj: calls $0.10
Klytu: folds 
EddieMoney9: folds 
123tiger711a: folds 
SeaofLove: calls $0.05
PlayTheBlues4U: checks 
*** FLOP *** [Kh 2s Kc]
SeaofLove: checks 
PlayTheBlues4U: bets $0.17
bsdnj: folds 
SeaofLove: folds 
Uncalled bet ($0.17) returned to PlayTheBlues4U
PlayTheBlues4U collected $0.28 from pot
PlayTheBlues4U: doesn't show hand 
*** SUMMARY ***
Total pot $0.30 | Rake $0.02 
Board [Kh 2s Kc]
Seat 1: 123tiger711a (button) folded before Flop (didn't bet)
Seat 2: SeaofLove (small blind) folded on the Flop
Seat 3: PlayTheBlues4U (big blind) collected ($0.28)
Seat 4: bsdnj folded on the Flop
Seat 5: Klytu folded before Flop (didn't bet)
Seat 6: EddieMoney9 folded before Flop (didn't bet)



PokerStars Hand #204848296927:  Hold'em No Limit ($0.05/$0.10 USD) - 2019/10/21 21:23:56 ET
Table 'Draco' 6-max Seat #2 is the button
Seat 1: 123tiger711a ($14.60 in chips) 
Seat 2: SeaofLove ($18.81 in chips) 
Seat 3: PlayTheBlues4U ($10.08 in chips) 
Seat 4: bsdnj ($9.55 in chips) 
Seat 5: Klytu ($13.50 in chips) 
Seat 6: EddieMoney9 ($10 in chips) 
PlayTheBlues4U: posts small blind $0.05
bsdnj: posts big blind $0.10
*** HOLE CARDS ***
Dealt to PlayTheBlues4U [7s 9s]
Klytu: folds 
EddieMoney9: folds 
123tiger711a: calls $0.10
SeaofLove: raises $0.35 to $0.45
PlayTheBlues4U: folds 
bsdnj: calls $0.35
123tiger711a: folds 
*** FLOP *** [Qc 7c 2c]
bsdnj: checks 
SeaofLove: bets $0.67
bsdnj: folds 
Uncalled bet ($0.67) returned to SeaofLove
SeaofLove collected $1 from pot
SeaofLove: doesn't show hand 
*** SUMMARY ***
Total pot $1.05 | Rake $0.05 
Board [Qc 7c 2c]
Seat 1: 123tiger711a folded before Flop
Seat 2: SeaofLove (button) collected ($1)
Seat 3: PlayTheBlues4U (small blind) folded before Flop
Seat 4: bsdnj (big blind) folded on the Flop
Seat 5: Klytu folded before Flop (didn't bet)
Seat 6: EddieMoney9 folded before Flop (didn't bet)



PokerStars Hand #204848297056:  Hold'em No Limit ($0.05/$0.10 USD) - 2019/10/21 21:24:27 ET
Table 'Draco' 6-max Seat #3 is the button
Seat 1: 123tiger711a ($14.50 in chips) 
Seat 2: SeaofLove ($19.36 in chips) 
Seat 3: PlayTheBlues4U ($10.03 in chips) 
Seat 4: bsdnj ($9.10 in chips) 
Seat 5: Klytu ($13.50 in chips) 
Seat 6: EddieMoney9 ($10 in chips) 
bsdnj: posts small blind $0.05
Klytu: posts big blind $0.10
*** HOLE CARDS ***
Dealt to PlayTheBlues4U [8c 2c]
EddieMoney9: calls $0.10
123tiger711a: folds 
SeaofLove: calls $0.10
PlayTheBlues4U: folds 
bsdnj: calls $0.05
Klytu: checks 
*** FLOP *** [Js 7h Jd]
bsdnj: checks 
Klytu: checks 
EddieMoney9: checks 
SeaofLove: checks 
*** TURN *** [Js 7h Jd] [9d]
bsdnj: checks 
Klytu: checks 
EddieMoney9: bets $0.15
SeaofLove: folds 
bsdnj: folds 
Klytu: folds 
Uncalled bet ($0.15) returned to EddieMoney9
EddieMoney9 collected $0.38 from pot
EddieMoney9: doesn't show hand 
*** SUMMARY ***
Total pot $0.40 | Rake $0.02 
Board [Js 7h Jd 9d]
Seat 1: 123tiger711a folded before Flop (didn't bet)
Seat 2: SeaofLove folded on the Turn
Seat 3: PlayTheBlues4U (button) folded before Flop (didn't bet)
Seat 4: bsdnj (small blind) folded on the Turn
Seat 5: Klytu (big blind) folded on the Turn
Seat 6: EddieMoney9 collected ($0.38)



PokerStars Hand #204848297292:  Hold'em No Limit ($0.05/$0.10 USD) - 2019/10/21 21:25:25 ET
Table 'Draco' 6-max Seat #4 is the button
Seat 1: 123tiger711a ($14.50 in chips) 
Seat 2: SeaofLove ($19.26 in chips) 
Seat 3: PlayTheBlues4U ($10.03 in chips) 
Seat 4: bsdnj ($9 in chips) 
Seat 5: Klytu ($13.40 in chips) 
Seat 6: EddieMoney9 ($10.28 in chips) 
Klytu: posts small blind $0.05
EddieMoney9: posts big blind $0.10
*** HOLE CARDS ***
Dealt to PlayTheBlues4U [Jc Td]
123tiger711a: folds 
SeaofLove: folds 
PlayTheBlues4U: folds 
bsdnj: folds 
Klytu: calls $0.05
EddieMoney9: checks 
*** FLOP *** [9h 5c 6h]
Klytu: checks 
EddieMoney9: checks 
*** TURN *** [9h 5c 6h] [6s]
Klytu: checks 
EddieMoney9: checks 
*** RIVER *** [9h 5c 6h 6s] [7c]
Klytu: checks 
EddieMoney9: checks 
*** SHOW DOWN ***
Klytu: shows [Qh Kc] (a pair of Sixes)
EddieMoney9: shows [2c As] (a pair of Sixes - Ace kicker)
EddieMoney9 collected $0.19 from pot
*** SUMMARY ***
Total pot $0.20 | Rake $0.01 
Board [9h 5c 6h 6s 7c]
Seat 1: 123tiger711a folded before Flop (didn't bet)
Seat 2: SeaofLove folded before Flop (didn't bet)
Seat 3: PlayTheBlues4U folded before Flop (didn't bet)
Seat 4: bsdnj (button) folded before Flop (didn't bet)
Seat 5: Klytu (small blind) showed [Qh Kc] and lost with a pair of Sixes
Seat 6: EddieMoney9 (big blind) showed [2c As] and won ($0.19) with a pair of Sixes



PokerStars Hand #204848297550:  Hold'em No Limit ($0.05/$0.10 USD) - 2019/10/21 21:26:23 ET
Table 'Draco' 6-max Seat #5 is the button
Seat 1: 123tiger711a ($14.50 in chips) 
Seat 2: SeaofLove ($19.26 in chips) 
Seat 3: PlayTheBlues4U ($10.03 in chips) 
Seat 4: bsdnj ($9 in chips) 
Seat 5: Klytu ($13.30 in chips) 
Seat 6: EddieMoney9 ($10.37 in chips) 
EddieMoney9: posts small blind $0.05
123tiger711a: posts big blind $0.10
*** HOLE CARDS ***
Dealt to PlayTheBlues4U [5c 4c]
SeaofLove: folds 
PlayTheBlues4U: folds 
bsdnj: folds 
Klytu: folds 
EddieMoney9: folds 
Uncalled bet ($0.05) returned to 123tiger711a
123tiger711a collected $0.10 from pot
*** SUMMARY ***
Total pot $0.10 | Rake $0 
Seat 1: 123tiger711a (big blind) collected ($0.10)
Seat 2: SeaofLove folded before Flop (didn't bet)
Seat 3: PlayTheBlues4U folded before Flop (didn't bet)
Seat 4: bsdnj folded before Flop (didn't bet)
Seat 5: Klytu (button) folded before Flop (didn't bet)
Seat 6: EddieMoney9 (small blind) folded before Flop



PokerStars Hand #204848297614:  Hold'em No Limit ($0.05/$0.10 USD) - 2019/10/21 21:26:37 ET
Table 'Draco' 6-max Seat #6 is the button
Seat 1: 123tiger711a ($14.55 in chips) 
Seat 2: SeaofLove ($19.26 in chips) 
Seat 3: PlayTheBlues4U ($10.03 in chips) 
Seat 4: bsdnj ($9 in chips) 
Seat 5: Klytu ($13.30 in chips) 
Seat 6: EddieMoney9 ($10.32 in chips) 
123tiger711a: posts small blind $0.05
SeaofLove: posts big blind $0.10
*** HOLE CARDS ***
Dealt to PlayTheBlues4U [Qc Qd]
PlayTheBlues4U: raises $0.20 to $0.30
bsdnj: folds 
Klytu: folds 
EddieMoney9: folds 
123tiger711a: folds 
SeaofLove: folds 
Uncalled bet ($0.20) returned to PlayTheBlues4U
PlayTheBlues4U collected $0.25 from pot
PlayTheBlues4U: doesn't show hand 
*** SUMMARY ***
Total pot $0.25 | Rake $0 
Seat 1: 123tiger711a (small blind) folded before Flop
Seat 2: SeaofLove (big blind) folded before Flop
Seat 3: PlayTheBlues4U collected ($0.25)
Seat 4: bsdnj folded before Flop (didn't bet)
Seat 5: Klytu folded before Flop (didn't bet)
Seat 6: EddieMoney9 (button) folded before Flop (didn't bet)



PokerStars Hand #204848297735:  Hold'em No Limit ($0.05/$0.10 USD) - 2019/10/21 21:27:05 ET
Table 'Draco' 6-max Seat #1 is the button
Seat 1: 123tiger711a ($14.50 in chips) 
Seat 2: SeaofLove ($19.16 in chips) 
Seat 3: PlayTheBlues4U ($10.18 in chips) 
Seat 4: bsdnj ($9 in chips) 
Seat 5: Klytu ($13.30 in chips) 
Seat 6: EddieMoney9 ($10.32 in chips) 
SeaofLove: posts small blind $0.05
PlayTheBlues4U: posts big blind $0.10
*** HOLE CARDS ***
Dealt to PlayTheBlues4U [Th Ts]
bsdnj: calls $0.10
Klytu: folds 
EddieMoney9: folds 
123tiger711a: folds 
SeaofLove: folds 
PlayTheBlues4U: raises $0.20 to $0.30
bsdnj: calls $0.20
*** FLOP *** [3h Kc 5h]
PlayTheBlues4U: bets $0.40
bsdnj: folds 
Uncalled bet ($0.40) returned to PlayTheBlues4U
PlayTheBlues4U collected $0.62 from pot
PlayTheBlues4U: doesn't show hand 
*** SUMMARY ***
Total pot $0.65 | Rake $0.03 
Board [3h Kc 5h]
Seat 1: 123tiger711a (button) folded before Flop (didn't bet)
Seat 2: SeaofLove (small blind) folded before Flop
Seat 3: PlayTheBlues4U (big blind) collected ($0.62)
Seat 4: bsdnj folded on the Flop
Seat 5: Klytu folded before Flop (didn't bet)
Seat 6: EddieMoney9 folded before Flop (didn't bet)



PokerStars Hand #204848297859:  Hold'em No Limit ($0.05/$0.10 USD) - 2019/10/21 21:27:34 ET
Table 'Draco' 6-max Seat #2 is the button
Seat 1: 123tiger711a ($14.50 in chips) 
Seat 2: SeaofLove ($19.11 in chips) 
Seat 3: PlayTheBlues4U ($10.50 in chips) 
Seat 4: bsdnj ($8.70 in chips) 
Seat 5: Klytu ($13.30 in chips) 
Seat 6: EddieMoney9 ($10.32 in chips) 
PlayTheBlues4U: posts small blind $0.05
bsdnj: posts big blind $0.10
*** HOLE CARDS ***
Dealt to PlayTheBlues4U [3d 9h]
Klytu: folds 
EddieMoney9: calls $0.10
123tiger711a: folds 
SeaofLove: folds 
PlayTheBlues4U: folds 
bsdnj: checks 
*** FLOP *** [8s 3c 6d]
bsdnj: checks 
EddieMoney9: checks 
*** TURN *** [8s 3c 6d] [2d]
bsdnj: bets $0.30
EddieMoney9: calls $0.30
*** RIVER *** [8s 3c 6d 2d] [7s]
bsdnj: checks 
EddieMoney9: bets $0.32
bsdnj: folds 
Uncalled bet ($0.32) returned to EddieMoney9
EddieMoney9 collected $0.81 from pot
EddieMoney9: doesn't show hand 
*** SUMMARY ***
Total pot $0.85 | Rake $0.04 
Board [8s 3c 6d 2d 7s]
Seat 1: 123tiger711a folded before Flop (didn't bet)
Seat 2: SeaofLove (button) folded before Flop (didn't bet)
Seat 3: PlayTheBlues4U (small blind) folded before Flop
Seat 4: bsdnj (big blind) folded on the River
Seat 5: Klytu folded before Flop (didn't bet)
Seat 6: EddieMoney9 collected ($0.81)



PokerStars Hand #204848298059:  Hold'em No Limit ($0.05/$0.10 USD) - 2019/10/21 21:28:21 ET
Table 'Draco' 6-max Seat #3 is the button
Seat 1: 123tiger711a ($14.50 in chips) 
Seat 2: SeaofLove ($19.11 in chips) 
Seat 3: PlayTheBlues4U ($10.45 in chips) 
Seat 4: bsdnj ($8.30 in chips) 
Seat 5: Klytu ($13.30 in chips) 
Seat 6: EddieMoney9 ($10.73 in chips) 
bsdnj: posts small blind $0.05
Klytu: posts big blind $0.10
*** HOLE CARDS ***
Dealt to PlayTheBlues4U [5h 8c]
EddieMoney9: folds 
123tiger711a: folds 
SeaofLove: folds 
PlayTheBlues4U: folds 
bsdnj: folds 
Uncalled bet ($0.05) returned to Klytu
Klytu collected $0.10 from pot
Klytu: doesn't show hand 
*** SUMMARY ***
Total pot $0.10 | Rake $0 
Seat 1: 123tiger711a folded before Flop (didn't bet)
Seat 2: SeaofLove folded before Flop (didn't bet)
Seat 3: PlayTheBlues4U (button) folded before Flop (didn't bet)
Seat 4: bsdnj (small blind) folded before Flop
Seat 5: Klytu (big blind) collected ($0.10)
Seat 6: EddieMoney9 folded before Flop (didn't bet)



PokerStars Hand #204848298120:  Hold'em No Limit ($0.05/$0.10 USD) - 2019/10/21 21:28:37 ET
Table 'Draco' 6-max Seat #4 is the button
Seat 1: 123tiger711a ($14.50 in chips) 
Seat 2: SeaofLove ($19.11 in chips) 
Seat 3: PlayTheBlues4U ($10.45 in chips) 
Seat 4: bsdnj ($8.25 in chips) 
Seat 5: Klytu ($13.35 in chips) 
Seat 6: EddieMoney9 ($10.73 in chips) 
Klytu: posts small blind $0.05
EddieMoney9: posts big blind $0.10
*** HOLE CARDS ***
Dealt to PlayTheBlues4U [6h 3s]
123tiger711a: folds 
SeaofLove: folds 
PlayTheBlues4U: folds 
bsdnj: calls $0.10
Klytu: folds 
EddieMoney9: checks 
*** FLOP *** [Jc Qc 5s]
EddieMoney9: checks 
bsdnj: checks 
*** TURN *** [Jc Qc 5s] [Jh]
EddieMoney9: checks 
bsdnj: checks 
*** RIVER *** [Jc Qc 5s Jh] [4s]
EddieMoney9: bets $0.20
bsdnj: calls $0.20
*** SHOW DOWN ***
EddieMoney9: shows [Ac 5d] (two pair, Jacks and Fives)
bsdnj: mucks hand 
EddieMoney9 collected $0.62 from pot
*** SUMMARY ***
Total pot $0.65 | Rake $0.03 
Board [Jc Qc 5s Jh 4s]
Seat 1: 123tiger711a folded before Flop (didn't bet)
Seat 2: SeaofLove folded before Flop (didn't bet)
Seat 3: PlayTheBlues4U folded before Flop (didn't bet)
Seat 4: bsdnj (button) mucked [4d 2d]
Seat 5: Klytu (small blind) folded before Flop
Seat 6: EddieMoney9 (big blind) showed [Ac 5d] and won ($0.62) with two pair, Jacks and Fives



PokerStars Hand #204848298240:  Hold'em No Limit ($0.05/$0.10 USD) - 2019/10/21 21:29:04 ET
Table 'Draco' 6-max Seat #5 is the button
Seat 1: 123tiger711a ($14.50 in chips) 
Seat 2: SeaofLove ($19.11 in chips) 
Seat 3: PlayTheBlues4U ($10.45 in chips) 
Seat 4: bsdnj ($7.95 in chips) 
Seat 5: Klytu ($13.30 in chips) 
Seat 6: EddieMoney9 ($11.05 in chips) 
EddieMoney9: posts small blind $0.05
123tiger711a: posts big blind $0.10
*** HOLE CARDS ***
Dealt to PlayTheBlues4U [Jc 3d]
SeaofLove: folds 
PlayTheBlues4U: folds 
bsdnj: folds 
Klytu: folds 
EddieMoney9: raises $0.20 to $0.30
123tiger711a: folds 
Uncalled bet ($0.20) returned to EddieMoney9
EddieMoney9 collected $0.20 from pot
EddieMoney9: doesn't show hand 
*** SUMMARY ***
Total pot $0.20 | Rake $0 
Seat 1: 123tiger711a (big blind) folded before Flop
Seat 2: SeaofLove folded before Flop (didn't bet)
Seat 3: PlayTheBlues4U folded before Flop (didn't bet)
Seat 4: bsdnj folded before Flop (didn't bet)
Seat 5: Klytu (button) folded before Flop (didn't bet)
Seat 6: EddieMoney9 (small blind) collected ($0.20)



PokerStars Hand #204848298310:  Hold'em No Limit ($0.05/$0.10 USD) - 2019/10/21 21:29:21 ET
Table 'Draco' 6-max Seat #6 is the button
Seat 1: 123tiger711a ($14.40 in chips) 
Seat 2: SeaofLove ($19.11 in chips) 
Seat 3: PlayTheBlues4U ($10.45 in chips) 
Seat 4: bsdnj ($7.95 in chips) 
Seat 5: Klytu ($13.30 in chips) 
Seat 6: EddieMoney9 ($11.15 in chips) 
123tiger711a: posts small blind $0.05
SeaofLove: posts big blind $0.10
*** HOLE CARDS ***
Dealt to PlayTheBlues4U [8s 6h]
PlayTheBlues4U: folds 
bsdnj: folds 
Klytu: raises $0.15 to $0.25
EddieMoney9: folds 
123tiger711a: calls $0.20
SeaofLove: folds 
*** FLOP *** [5c 5h Qs]
123tiger711a: checks 
Klytu: bets $0.25
123tiger711a: folds 
Uncalled bet ($0.25) returned to Klytu
Klytu collected $0.57 from pot
Klytu: doesn't show hand 
*** SUMMARY ***
Total pot $0.60 | Rake $0.03 
Board [5c 5h Qs]
Seat 1: 123tiger711a (small blind) folded on the Flop
Seat 2: SeaofLove (big blind) folded before Flop
Seat 3: PlayTheBlues4U folded before Flop (didn't bet)
Seat 4: bsdnj folded before Flop (didn't bet)
Seat 5: Klytu collected ($0.57)
Seat 6: EddieMoney9 (button) folded before Flop (didn't bet)



PokerStars Hand #204848298396:  Hold'em No Limit ($0.05/$0.10 USD) - 2019/10/21 21:29:40 ET
Table 'Draco' 6-max Seat #1 is the button
Seat 1: 123tiger711a ($14.15 in chips) 
Seat 2: SeaofLove ($19.01 in chips) 
Seat 3: PlayTheBlues4U ($10.45 in chips) 
Seat 4: bsdnj ($7.95 in chips) 
Seat 5: Klytu ($13.62 in chips) 
Seat 6: EddieMoney9 ($11.15 in chips) 
SeaofLove: posts small blind $0.05
PlayTheBlues4U: posts big blind $0.10
*** HOLE CARDS ***
Dealt to PlayTheBlues4U [3s 3h]
bsdnj: raises $0.20 to $0.30
Klytu: folds 
EddieMoney9: folds 
123tiger711a: folds 
SeaofLove: folds 
PlayTheBlues4U: calls $0.20
*** FLOP *** [9c 8c 5d]
PlayTheBlues4U: checks 
bsdnj: checks 
*** TURN *** [9c 8c 5d] [2h]
PlayTheBlues4U: bets $0.40
bsdnj: folds 
Uncalled bet ($0.40) returned to PlayTheBlues4U
PlayTheBlues4U collected $0.62 from pot
PlayTheBlues4U: doesn't show hand 
*** SUMMARY ***
Total pot $0.65 | Rake $0.03 
Board [9c 8c 5d 2h]
Seat 1: 123tiger711a (button) folded before Flop (didn't bet)
Seat 2: SeaofLove (small blind) folded before Flop
Seat 3: PlayTheBlues4U (big blind) collected ($0.62)
Seat 4: bsdnj folded on the Turn
Seat 5: Klytu folded before Flop (didn't bet)
Seat 6: EddieMoney9 folded before Flop (didn't bet)



PokerStars Hand #204848298531:  Hold'em No Limit ($0.05/$0.10 USD) - 2019/10/21 21:30:12 ET
Table 'Draco' 6-max Seat #2 is the button
Seat 1: 123tiger711a ($14.15 in chips) 
Seat 2: SeaofLove ($18.96 in chips) 
Seat 3: PlayTheBlues4U ($10.77 in chips) 
Seat 4: bsdnj ($7.65 in chips) 
Seat 5: Klytu ($13.62 in chips) 
Seat 6: EddieMoney9 ($11.15 in chips) 
PlayTheBlues4U: posts small blind $0.05
bsdnj: posts big blind $0.10
*** HOLE CARDS ***
Dealt to PlayTheBlues4U [4s Ts]
Klytu: folds 
EddieMoney9: folds 
123tiger711a: folds 
SeaofLove: raises $0.15 to $0.25
PlayTheBlues4U: folds 
bsdnj: raises $0.75 to $1
SeaofLove: folds 
Uncalled bet ($0.75) returned to bsdnj
bsdnj collected $0.55 from pot
bsdnj: doesn't show hand 
*** SUMMARY ***
Total pot $0.55 | Rake $0 
Seat 1: 123tiger711a folded before Flop (didn't bet)
Seat 2: SeaofLove (button) folded before Flop
Seat 3: PlayTheBlues4U (small blind) folded before Flop
Seat 4: bsdnj (big blind) collected ($0.55)
Seat 5: Klytu folded before Flop (didn't bet)
Seat 6: EddieMoney9 folded before Flop (didn't bet)



PokerStars Hand #204848298617:  Hold'em No Limit ($0.05/$0.10 USD) - 2019/10/21 21:30:31 ET
Table 'Draco' 6-max Seat #3 is the button
Seat 1: 123tiger711a ($14.15 in chips) 
Seat 2: SeaofLove ($18.71 in chips) 
Seat 3: PlayTheBlues4U ($10.72 in chips) 
Seat 4: bsdnj ($7.95 in chips) 
Seat 5: Klytu ($13.62 in chips) 
Seat 6: EddieMoney9 ($11.15 in chips) 
bsdnj: posts small blind $0.05
Klytu: posts big blind $0.10
*** HOLE CARDS ***
Dealt to PlayTheBlues4U [6d Ah]
EddieMoney9: folds 
123tiger711a: folds 
SeaofLove: raises $0.15 to $0.25
PlayTheBlues4U: folds 
bsdnj: calls $0.20
Klytu: folds 
*** FLOP *** [Ac Jc 2s]
bsdnj: checks 
SeaofLove: checks 
*** TURN *** [Ac Jc 2s] [7d]
bsdnj: bets $0.30
SeaofLove: folds 
Uncalled bet ($0.30) returned to bsdnj
bsdnj collected $0.57 from pot
bsdnj: doesn't show hand 
*** SUMMARY ***
Total pot $0.60 | Rake $0.03 
Board [Ac Jc 2s 7d]
Seat 1: 123tiger711a folded before Flop (didn't bet)
Seat 2: SeaofLove folded on the Turn
Seat 3: PlayTheBlues4U (button) folded before Flop (didn't bet)
Seat 4: bsdnj (small blind) collected ($0.57)
Seat 5: Klytu (big blind) folded before Flop
Seat 6: EddieMoney9 folded before Flop (didn't bet)



PokerStars Hand #204848298744:  Hold'em No Limit ($0.05/$0.10 USD) - 2019/10/21 21:31:02 ET
Table 'Draco' 6-max Seat #4 is the button
Seat 1: 123tiger711a ($14.15 in chips) 
Seat 2: SeaofLove ($18.46 in chips) 
Seat 3: PlayTheBlues4U ($10.72 in chips) 
Seat 4: bsdnj ($8.27 in chips) 
Seat 5: Klytu ($13.52 in chips) 
Seat 6: EddieMoney9 ($11.15 in chips) 
Klytu: posts small blind $0.05
EddieMoney9: posts big blind $0.10
*** HOLE CARDS ***
Dealt to PlayTheBlues4U [Jh Kd]
123tiger711a: folds 
SeaofLove: folds 
PlayTheBlues4U: raises $0.20 to $0.30
bsdnj: calls $0.30
Klytu: folds 
EddieMoney9: folds 
*** FLOP *** [4h 6d 9d]
PlayTheBlues4U: bets $0.40
bsdnj: folds 
Uncalled bet ($0.40) returned to PlayTheBlues4U
PlayTheBlues4U collected $0.71 from pot
PlayTheBlues4U: doesn't show hand 
*** SUMMARY ***
Total pot $0.75 | Rake $0.04 
Board [4h 6d 9d]
Seat 1: 123tiger711a folded before Flop (didn't bet)
Seat 2: SeaofLove folded before Flop (didn't bet)
Seat 3: PlayTheBlues4U collected ($0.71)
Seat 4: bsdnj (button) folded on the Flop
Seat 5: Klytu (small blind) folded before Flop
Seat 6: EddieMoney9 (big blind) folded before Flop



PokerStars Hand #204848298873:  Hold'em No Limit ($0.05/$0.10 USD) - 2019/10/21 21:31:30 ET
Table 'Draco' 6-max Seat #5 is the button
Seat 1: 123tiger711a ($14.15 in chips) 
Seat 2: SeaofLove ($18.46 in chips) 
Seat 3: PlayTheBlues4U ($11.13 in chips) 
Seat 4: bsdnj ($7.97 in chips) 
Seat 5: Klytu ($13.47 in chips) 
Seat 6: EddieMoney9 ($11.05 in chips) 
EddieMoney9: posts small blind $0.05
123tiger711a: posts big blind $0.10
*** HOLE CARDS ***
Dealt to PlayTheBlues4U [Kc Td]
SeaofLove: raises $0.15 to $0.25
PlayTheBlues4U: folds 
bsdnj: folds 
Klytu: folds 
EddieMoney9: folds 
123tiger711a: folds 
Uncalled bet ($0.15) returned to SeaofLove
SeaofLove collected $0.25 from pot
SeaofLove: doesn't show hand 
*** SUMMARY ***
Total pot $0.25 | Rake $0 
Seat 1: 123tiger711a (big blind) folded before Flop
Seat 2: SeaofLove collected ($0.25)
Seat 3: PlayTheBlues4U folded before Flop (didn't bet)
Seat 4: bsdnj folded before Flop (didn't bet)
Seat 5: Klytu (button) folded before Flop (didn't bet)
Seat 6: EddieMoney9 (small blind) folded before Flop



PokerStars Hand #204848298934:  Hold'em No Limit ($0.05/$0.10 USD) - 2019/10/21 21:31:41 ET
Table 'Draco' 6-max Seat #6 is the button
Seat 1: 123tiger711a ($14.05 in chips) 
Seat 2: SeaofLove ($18.61 in chips) 
Seat 3: PlayTheBlues4U ($11.13 in chips) 
Seat 4: bsdnj ($7.97 in chips) 
Seat 5: Klytu ($13.47 in chips) 
Seat 6: EddieMoney9 ($11 in chips) 
123tiger711a: posts small blind $0.05
SeaofLove: posts big blind $0.10
*** HOLE CARDS ***
Dealt to PlayTheBlues4U [5h 4c]
PlayTheBlues4U: folds 
bsdnj: folds 
Klytu: folds 
EddieMoney9: raises $0.20 to $0.30
123tiger711a: folds 
SeaofLove: calls $0.20
*** FLOP *** [Td Ac As]
SeaofLove: checks 
EddieMoney9: bets $0.40
SeaofLove: folds 
Uncalled bet ($0.40) returned to EddieMoney9
EddieMoney9 collected $0.62 from pot
EddieMoney9: doesn't show hand 
*** SUMMARY ***
Total pot $0.65 | Rake $0.03 
Board [Td Ac As]
Seat 1: 123tiger711a (small blind) folded before Flop
Seat 2: SeaofLove (big blind) folded on the Flop
Seat 3: PlayTheBlues4U folded before Flop (didn't bet)
Seat 4: bsdnj folded before Flop (didn't bet)
Seat 5: Klytu folded before Flop (didn't bet)
Seat 6: EddieMoney9 (button) collected ($0.62)



PokerStars Hand #204848299052:  Hold'em No Limit ($0.05/$0.10 USD) - 2019/10/21 21:32:08 ET
Table 'Draco' 6-max Seat #1 is the button
Seat 1: 123tiger711a ($14 in chips) 
Seat 2: SeaofLove ($18.31 in chips) 
Seat 3: PlayTheBlues4U ($11.13 in chips) 
Seat 4: bsdnj ($7.97 in chips) 
Seat 5: Klytu ($13.47 in chips) 
Seat 6: EddieMoney9 ($11.32 in chips) 
SeaofLove: posts small blind $0.05
PlayTheBlues4U: posts big blind $0.10
*** HOLE CARDS ***
Dealt to PlayTheBlues4U [Kd 6d]
bsdnj: raises $0.30 to $0.40
Klytu: folds 
EddieMoney9: folds 
123tiger711a: calls $0.40
SeaofLove: folds 
PlayTheBlues4U: folds 
*** FLOP *** [Ks 5d Qs]
bsdnj: bets $0.40
123tiger711a: calls $0.40
*** TURN *** [Ks 5d Qs] [Qh]
bsdnj: checks 
123tiger711a: checks 
*** RIVER *** [Ks 5d Qs Qh] [5s]
bsdnj: checks 
123tiger711a: checks 
*** SHOW DOWN ***
bsdnj: shows [Td Ts] (two pair, Queens and Tens)
123tiger711a: mucks hand 
bsdnj collected $1.66 from pot
*** SUMMARY ***
Total pot $1.75 | Rake $0.09 
Board [Ks 5d Qs Qh 5s]
Seat 1: 123tiger711a (button) mucked [8d 8c]
Seat 2: SeaofLove (small blind) folded before Flop
Seat 3: PlayTheBlues4U (big blind) folded before Flop
Seat 4: bsdnj showed [Td Ts] and won ($1.66) with two pair, Queens and Tens
Seat 5: Klytu folded before Flop (didn't bet)
Seat 6: EddieMoney9 folded before Flop (didn't bet)



PokerStars Hand #204848299230:  Hold'em No Limit ($0.05/$0.10 USD) - 2019/10/21 21:32:46 ET
Table 'Draco' 6-max Seat #2 is the button
Seat 1: 123tiger711a ($13.20 in chips) 
Seat 2: SeaofLove ($18.26 in chips) 
Seat 3: PlayTheBlues4U ($11.03 in chips) 
Seat 4: bsdnj ($8.83 in chips) 
Seat 5: Klytu ($13.47 in chips) 
Seat 6: EddieMoney9 ($11.32 in chips) 
PlayTheBlues4U: posts small blind $0.05
bsdnj: posts big blind $0.10
*** HOLE CARDS ***
Dealt to PlayTheBlues4U [Kd As]
Klytu: folds 
EddieMoney9: folds 
123tiger711a: folds 
SeaofLove: folds 
PlayTheBlues4U: raises $0.20 to $0.30
bsdnj: folds 
Uncalled bet ($0.20) returned to PlayTheBlues4U
PlayTheBlues4U collected $0.20 from pot
PlayTheBlues4U: doesn't show hand 
*** SUMMARY ***
Total pot $0.20 | Rake $0 
Seat 1: 123tiger711a folded before Flop (didn't bet)
Seat 2: SeaofLove (button) folded before Flop (didn't bet)
Seat 3: PlayTheBlues4U (small blind) collected ($0.20)
Seat 4: bsdnj (big blind) folded before Flop
Seat 5: Klytu folded before Flop (didn't bet)
Seat 6: EddieMoney9 folded before Flop (didn't bet)



PokerStars Hand #204848299370:  Hold'em No Limit ($0.05/$0.10 USD) - 2019/10/21 21:33:15 ET
Table 'Draco' 6-max Seat #3 is the button
Seat 1: 123tiger711a ($13.20 in chips) 
Seat 2: SeaofLove ($18.26 in chips) 
Seat 3: PlayTheBlues4U ($11.13 in chips) 
Seat 4: bsdnj ($8.73 in chips) 
Seat 5: Klytu ($13.47 in chips) 
Seat 6: EddieMoney9 ($11.32 in chips) 
bsdnj: posts small blind $0.05
Klytu: posts big blind $0.10
*** HOLE CARDS ***
Dealt to PlayTheBlues4U [6s Jc]
EddieMoney9: folds 
123tiger711a: folds 
SeaofLove: raises $0.15 to $0.25
PlayTheBlues4U: folds 
bsdnj: calls $0.20
Klytu: calls $0.15
*** FLOP *** [Kh Ac 2h]
bsdnj: checks 
Klytu: checks 
SeaofLove: checks 
*** TURN *** [Kh Ac 2h] [8d]
bsdnj: bets $0.40
Klytu: folds 
SeaofLove: folds 
Uncalled bet ($0.40) returned to bsdnj
bsdnj collected $0.71 from pot
bsdnj: doesn't show hand 
*** SUMMARY ***
Total pot $0.75 | Rake $0.04 
Board [Kh Ac 2h 8d]
Seat 1: 123tiger711a folded before Flop (didn't bet)
Seat 2: SeaofLove folded on the Turn
Seat 3: PlayTheBlues4U (button) folded before Flop (didn't bet)
Seat 4: bsdnj (small blind) collected ($0.71)
Seat 5: Klytu (big blind) folded on the Turn
Seat 6: EddieMoney9 folded before Flop (didn't bet)



PokerStars Hand #204848299462:  Hold'em No Limit ($0.05/$0.10 USD) - 2019/10/21 21:33:38 ET
Table 'Draco' 6-max Seat #4 is the button
Seat 1: 123tiger711a ($13.20 in chips) 
Seat 2: SeaofLove ($18.01 in chips) 
Seat 3: PlayTheBlues4U ($11.13 in chips) 
Seat 4: bsdnj ($9.19 in chips) 
Seat 5: Klytu ($13.22 in chips) 
Seat 6: EddieMoney9 ($11.32 in chips) 
Klytu: posts small blind $0.05
EddieMoney9: posts big blind $0.10
*** HOLE CARDS ***
Dealt to PlayTheBlues4U [As 5d]
123tiger711a: folds 
SeaofLove: folds 
PlayTheBlues4U: raises $0.16 to $0.26
bsdnj: calls $0.26
Klytu: folds 
EddieMoney9: folds 
*** FLOP *** [Kh 7c 6s]
PlayTheBlues4U: bets $0.40
bsdnj: calls $0.40
*** TURN *** [Kh 7c 6s] [9s]
PlayTheBlues4U: checks 
bsdnj: bets $0.70
PlayTheBlues4U: folds 
Uncalled bet ($0.70) returned to bsdnj
bsdnj collected $1.40 from pot
bsdnj: doesn't show hand 
*** SUMMARY ***
Total pot $1.47 | Rake $0.07 
Board [Kh 7c 6s 9s]
Seat 1: 123tiger711a folded before Flop (didn't bet)
Seat 2: SeaofLove folded before Flop (didn't bet)
Seat 3: PlayTheBlues4U folded on the Turn
Seat 4: bsdnj (button) collected ($1.40)
Seat 5: Klytu (small blind) folded before Flop
Seat 6: EddieMoney9 (big blind) folded before Flop



PokerStars Hand #204848299643:  Hold'em No Limit ($0.05/$0.10 USD) - 2019/10/21 21:34:17 ET
Table 'Draco' 6-max Seat #5 is the button
Seat 1: 123tiger711a ($13.20 in chips) 
Seat 2: SeaofLove ($18.01 in chips) 
Seat 3: PlayTheBlues4U ($10.47 in chips) 
Seat 4: bsdnj ($9.93 in chips) 
Seat 5: Klytu ($13.17 in chips) 
Seat 6: EddieMoney9 ($11.22 in chips) 
EddieMoney9: posts small blind $0.05
123tiger711a: posts big blind $0.10
*** HOLE CARDS ***
Dealt to PlayTheBlues4U [3s 6c]
SeaofLove: folds 
PlayTheBlues4U: folds 
bsdnj: folds 
SeaofLove leaves the table
Klytu: folds 
LanskyBanksy joins the table at seat #2 
EddieMoney9: calls $0.05
123tiger711a: raises $0.50 to $0.60
EddieMoney9: folds 
Uncalled bet ($0.50) returned to 123tiger711a
123tiger711a collected $0.20 from pot
*** SUMMARY ***
Total pot $0.20 | Rake $0 
Seat 1: 123tiger711a (big blind) collected ($0.20)
Seat 2: SeaofLove folded before Flop (didn't bet)
Seat 3: PlayTheBlues4U folded before Flop (didn't bet)
Seat 4: bsdnj folded before Flop (didn't bet)
Seat 5: Klytu (button) folded before Flop (didn't bet)
Seat 6: EddieMoney9 (small blind) folded before Flop



PokerStars Hand #204848299767:  Hold'em No Limit ($0.05/$0.10 USD) - 2019/10/21 21:34:44 ET
Table 'Draco' 6-max Seat #6 is the button
Seat 1: 123tiger711a ($13.30 in chips) 
Seat 2: LanskyBanksy ($10 in chips) 
Seat 3: PlayTheBlues4U ($10.47 in chips) 
Seat 4: bsdnj ($9.93 in chips) 
Seat 5: Klytu ($13.17 in chips) 
Seat 6: EddieMoney9 ($11.12 in chips) 
123tiger711a: posts small blind $0.05
LanskyBanksy: posts big blind $0.10
*** HOLE CARDS ***
Dealt to PlayTheBlues4U [6d Ad]
PlayTheBlues4U: folds 
bsdnj: calls $0.10
Klytu: raises $0.25 to $0.35
EddieMoney9: calls $0.35
123tiger711a: folds 
LanskyBanksy: folds 
bsdnj: calls $0.25
*** FLOP *** [8d 4h 3d]
bsdnj: bets $0.50
Klytu: calls $0.50
EddieMoney9: calls $0.50
*** TURN *** [8d 4h 3d] [Jc]
bsdnj: checks 
Klytu: bets $1.30
EddieMoney9: calls $1.30
bsdnj: folds 
*** RIVER *** [8d 4h 3d Jc] [As]
Klytu: checks 
EddieMoney9: checks 
*** SHOW DOWN ***
Klytu: shows [7d 9d] (high card Ace)
EddieMoney9: shows [Jd Qd] (a pair of Jacks)
EddieMoney9 collected $5.04 from pot
*** SUMMARY ***
Total pot $5.30 | Rake $0.26 
Board [8d 4h 3d Jc As]
Seat 1: 123tiger711a (small blind) folded before Flop
Seat 2: LanskyBanksy (big blind) folded before Flop
Seat 3: PlayTheBlues4U folded before Flop (didn't bet)
Seat 4: bsdnj folded on the Turn
Seat 5: Klytu showed [7d 9d] and lost with high card Ace
Seat 6: EddieMoney9 (button) showed [Jd Qd] and won ($5.04) with a pair of Jacks



PokerStars Hand #204850108452:  Hold'em No Limit ($0.05/$0.10 USD) - 2019/10/21 21:36:08 ET
Table 'Draco' 6-max Seat #1 is the button
Seat 1: 123tiger711a ($13.25 in chips) 
Seat 2: LanskyBanksy ($9.90 in chips) 
Seat 3: PlayTheBlues4U ($10.47 in chips) 
Seat 4: bsdnj ($9.08 in chips) 
Seat 5: Klytu ($11.02 in chips) 
Seat 6: EddieMoney9 ($14.01 in chips) 
LanskyBanksy: posts small blind $0.05
PlayTheBlues4U: posts big blind $0.10
*** HOLE CARDS ***
Dealt to PlayTheBlues4U [5s 8d]
bsdnj: folds 
Klytu: folds 
EddieMoney9: folds 
123tiger711a: folds 
LanskyBanksy: calls $0.05
PlayTheBlues4U: checks 
*** FLOP *** [9c 3c Js]
LanskyBanksy: checks 
PlayTheBlues4U: checks 
*** TURN *** [9c 3c Js] [Th]
LanskyBanksy: checks 
PlayTheBlues4U: checks 
*** RIVER *** [9c 3c Js Th] [9d]
LanskyBanksy: checks 
PlayTheBlues4U: checks 
*** SHOW DOWN ***
LanskyBanksy: shows [5d 7c] (a pair of Nines)
PlayTheBlues4U: shows [5s 8d] (a pair of Nines - Jack+Ten+Eight kicker)
PlayTheBlues4U collected $0.19 from pot
*** SUMMARY ***
Total pot $0.20 | Rake $0.01 
Board [9c 3c Js Th 9d]
Seat 1: 123tiger711a (button) folded before Flop (didn't bet)
Seat 2: LanskyBanksy (small blind) showed [5d 7c] and lost with a pair of Nines
Seat 3: PlayTheBlues4U (big blind) showed [5s 8d] and won ($0.19) with a pair of Nines
Seat 4: bsdnj folded before Flop (didn't bet)
Seat 5: Klytu folded before Flop (didn't bet)
Seat 6: EddieMoney9 folded before Flop (didn't bet)



PokerStars Hand #204850108728:  Hold'em No Limit ($0.05/$0.10 USD) - 2019/10/21 21:37:05 ET
Table 'Draco' 6-max Seat #2 is the button
Seat 1: 123tiger711a ($13.25 in chips) 
Seat 2: LanskyBanksy ($9.80 in chips) 
Seat 3: PlayTheBlues4U ($10.56 in chips) 
Seat 4: bsdnj ($9.08 in chips) 
Seat 5: Klytu ($11.02 in chips) 
Seat 6: EddieMoney9 ($14.01 in chips) 
PlayTheBlues4U: posts small blind $0.05
bsdnj: posts big blind $0.10
*** HOLE CARDS ***
Dealt to PlayTheBlues4U [8c Qd]
Klytu: raises $0.25 to $0.35
EddieMoney9: calls $0.35
123tiger711a: folds 
LanskyBanksy: folds 
PlayTheBlues4U: folds 
bsdnj: folds 
*** FLOP *** [7c Kc Jd]
Klytu: bets $0.45
EddieMoney9: calls $0.45
*** TURN *** [7c Kc Jd] [Th]
Klytu: checks 
EddieMoney9: bets $0.70
Klytu: folds 
Uncalled bet ($0.70) returned to EddieMoney9
EddieMoney9 collected $1.66 from pot
EddieMoney9: doesn't show hand 
*** SUMMARY ***
Total pot $1.75 | Rake $0.09 
Board [7c Kc Jd Th]
Seat 1: 123tiger711a folded before Flop (didn't bet)
Seat 2: LanskyBanksy (button) folded before Flop (didn't bet)
Seat 3: PlayTheBlues4U (small blind) folded before Flop
Seat 4: bsdnj (big blind) folded before Flop
Seat 5: Klytu folded on the Turn
Seat 6: EddieMoney9 collected ($1.66)



PokerStars Hand #204850108884:  Hold'em No Limit ($0.05/$0.10 USD) - 2019/10/21 21:37:39 ET
Table 'Draco' 6-max Seat #3 is the button
Seat 1: 123tiger711a ($13.25 in chips) 
Seat 2: LanskyBanksy ($9.80 in chips) 
Seat 3: PlayTheBlues4U ($10.51 in chips) 
Seat 4: bsdnj ($8.98 in chips) 
Seat 5: Klytu ($10.22 in chips) 
Seat 6: EddieMoney9 ($14.87 in chips) 
bsdnj: posts small blind $0.05
Klytu: posts big blind $0.10
*** HOLE CARDS ***
Dealt to PlayTheBlues4U [4d 6s]
EddieMoney9: folds 
123tiger711a: folds 
LanskyBanksy: folds 
PlayTheBlues4U: folds 
bsdnj: folds 
Uncalled bet ($0.05) returned to Klytu
Klytu collected $0.10 from pot
Klytu: doesn't show hand 
*** SUMMARY ***
Total pot $0.10 | Rake $0 
Seat 1: 123tiger711a folded before Flop (didn't bet)
Seat 2: LanskyBanksy folded before Flop (didn't bet)
Seat 3: PlayTheBlues4U (button) folded before Flop (didn't bet)
Seat 4: bsdnj (small blind) folded before Flop
Seat 5: Klytu (big blind) collected ($0.10)
Seat 6: EddieMoney9 folded before Flop (didn't bet)



PokerStars Hand #204850108935:  Hold'em No Limit ($0.05/$0.10 USD) - 2019/10/21 21:37:50 ET
Table 'Draco' 6-max Seat #4 is the button
Seat 1: 123tiger711a ($13.25 in chips) 
Seat 2: LanskyBanksy ($9.80 in chips) 
Seat 3: PlayTheBlues4U ($10.51 in chips) 
Seat 4: bsdnj ($8.93 in chips) 
Seat 5: Klytu ($10.27 in chips) 
Seat 6: EddieMoney9 ($14.87 in chips) 
Klytu: posts small blind $0.05
EddieMoney9: posts big blind $0.10
*** HOLE CARDS ***
Dealt to PlayTheBlues4U [Ks 7h]
123tiger711a: folds 
LanskyBanksy: folds 
PlayTheBlues4U: folds 
bsdnj: raises $0.20 to $0.30
Klytu: folds 
EddieMoney9: folds 
Uncalled bet ($0.20) returned to bsdnj
bsdnj collected $0.25 from pot
bsdnj: doesn't show hand 
*** SUMMARY ***
Total pot $0.25 | Rake $0 
Seat 1: 123tiger711a folded before Flop (didn't bet)
Seat 2: LanskyBanksy folded before Flop (didn't bet)
Seat 3: PlayTheBlues4U folded before Flop (didn't bet)
Seat 4: bsdnj (button) collected ($0.25)
Seat 5: Klytu (small blind) folded before Flop
Seat 6: EddieMoney9 (big blind) folded before Flop



PokerStars Hand #204850108996:  Hold'em No Limit ($0.05/$0.10 USD) - 2019/10/21 21:38:02 ET
Table 'Draco' 6-max Seat #5 is the button
Seat 1: 123tiger711a ($13.25 in chips) 
Seat 2: LanskyBanksy ($9.80 in chips) 
Seat 3: PlayTheBlues4U ($10.51 in chips) 
Seat 4: bsdnj ($9.08 in chips) 
Seat 5: Klytu ($10.22 in chips) 
Seat 6: EddieMoney9 ($14.77 in chips) 
EddieMoney9: posts small blind $0.05
123tiger711a: posts big blind $0.10
*** HOLE CARDS ***
Dealt to PlayTheBlues4U [Ts Qd]
LanskyBanksy: folds 
PlayTheBlues4U: folds 
bsdnj: calls $0.10
Klytu: calls $0.10
EddieMoney9: calls $0.05
123tiger711a: checks 
*** FLOP *** [Kd 9d 3h]
EddieMoney9: checks 
123tiger711a: checks 
bsdnj: checks 
Klytu: checks 
*** TURN *** [Kd 9d 3h] [Th]
EddieMoney9: checks 
123tiger711a: checks 
bsdnj: checks 
Klytu: checks 
*** RIVER *** [Kd 9d 3h Th] [9s]
EddieMoney9: bets $0.30
123tiger711a: folds 
bsdnj: folds 
Klytu: folds 
Uncalled bet ($0.30) returned to EddieMoney9
EddieMoney9 collected $0.38 from pot
EddieMoney9: doesn't show hand 
*** SUMMARY ***
Total pot $0.40 | Rake $0.02 
Board [Kd 9d 3h Th 9s]
Seat 1: 123tiger711a (big blind) folded on the River
Seat 2: LanskyBanksy folded before Flop (didn't bet)
Seat 3: PlayTheBlues4U folded before Flop (didn't bet)
Seat 4: bsdnj folded on the River
Seat 5: Klytu (button) folded on the River
Seat 6: EddieMoney9 (small blind) collected ($0.38)



PokerStars Hand #204850109242:  Hold'em No Limit ($0.05/$0.10 USD) - 2019/10/21 21:38:54 ET
Table 'Draco' 6-max Seat #6 is the button
Seat 1: 123tiger711a ($13.15 in chips) 
Seat 2: LanskyBanksy ($9.80 in chips) 
Seat 3: PlayTheBlues4U ($10.51 in chips) 
Seat 4: bsdnj ($8.98 in chips) 
Seat 5: Klytu ($10.12 in chips) 
Seat 6: EddieMoney9 ($15.05 in chips) 
123tiger711a: posts small blind $0.05
LanskyBanksy: posts big blind $0.10
*** HOLE CARDS ***
Dealt to PlayTheBlues4U [8s 2d]
PlayTheBlues4U: folds 
bsdnj: calls $0.10
Klytu: folds 
EddieMoney9: raises $0.20 to $0.30
123tiger711a: calls $0.25
LanskyBanksy: calls $0.20
bsdnj: calls $0.20
*** FLOP *** [Td 6d 2h]
123tiger711a: checks 
LanskyBanksy: checks 
bsdnj: checks 
EddieMoney9: checks 
*** TURN *** [Td 6d 2h] [5s]
123tiger711a: checks 
LanskyBanksy: checks 
bsdnj: checks 
EddieMoney9: bets $0.80
123tiger711a: folds 
LanskyBanksy: folds 
bsdnj: folds 
Uncalled bet ($0.80) returned to EddieMoney9
EddieMoney9 collected $1.14 from pot
EddieMoney9: doesn't show hand 
*** SUMMARY ***
Total pot $1.20 | Rake $0.06 
Board [Td 6d 2h 5s]
Seat 1: 123tiger711a (small blind) folded on the Turn
Seat 2: LanskyBanksy (big blind) folded on the Turn
Seat 3: PlayTheBlues4U folded before Flop (didn't bet)
Seat 4: bsdnj folded on the Turn
Seat 5: Klytu folded before Flop (didn't bet)
Seat 6: EddieMoney9 (button) collected ($1.14)



PokerStars Hand #204850109584:  Hold'em No Limit ($0.05/$0.10 USD) - 2019/10/21 21:40:13 ET
Table 'Draco' 6-max Seat #1 is the button
Seat 1: 123tiger711a ($12.85 in chips) 
Seat 2: LanskyBanksy ($9.50 in chips) 
Seat 3: PlayTheBlues4U ($10.51 in chips) 
Seat 4: bsdnj ($8.68 in chips) 
Seat 5: Klytu ($10.12 in chips) 
Seat 6: EddieMoney9 ($15.89 in chips) 
LanskyBanksy: posts small blind $0.05
PlayTheBlues4U: posts big blind $0.10
*** HOLE CARDS ***
Dealt to PlayTheBlues4U [3s 5c]
bsdnj: folds 
Klytu: folds 
EddieMoney9: folds 
123tiger711a: folds 
LanskyBanksy: calls $0.05
PlayTheBlues4U: checks 
*** FLOP *** [7d 4s Th]
LanskyBanksy: checks 
PlayTheBlues4U: checks 
*** TURN *** [7d 4s Th] [Kc]
LanskyBanksy: checks 
PlayTheBlues4U: checks 
*** RIVER *** [7d 4s Th Kc] [2c]
LanskyBanksy: checks 
PlayTheBlues4U: checks 
*** SHOW DOWN ***
LanskyBanksy: shows [5s 6s] (high card King)
PlayTheBlues4U: mucks hand 
LanskyBanksy collected $0.19 from pot
*** SUMMARY ***
Total pot $0.20 | Rake $0.01 
Board [7d 4s Th Kc 2c]
Seat 1: 123tiger711a (button) folded before Flop (didn't bet)
Seat 2: LanskyBanksy (small blind) showed [5s 6s] and won ($0.19) with high card King
Seat 3: PlayTheBlues4U (big blind) mucked [3s 5c]
Seat 4: bsdnj folded before Flop (didn't bet)
Seat 5: Klytu folded before Flop (didn't bet)
Seat 6: EddieMoney9 folded before Flop (didn't bet)



PokerStars Hand #204850109987:  Hold'em No Limit ($0.05/$0.10 USD) - 2019/10/21 21:41:39 ET
Table 'Draco' 6-max Seat #2 is the button
Seat 1: 123tiger711a ($12.85 in chips) 
Seat 2: LanskyBanksy ($9.59 in chips) 
Seat 3: PlayTheBlues4U ($10.41 in chips) 
Seat 4: bsdnj ($8.68 in chips) 
Seat 5: Klytu ($10.12 in chips) 
Seat 6: EddieMoney9 ($15.89 in chips) 
PlayTheBlues4U: posts small blind $0.05
bsdnj: posts big blind $0.10
*** HOLE CARDS ***
Dealt to PlayTheBlues4U [3d Jh]
Klytu: raises $0.25 to $0.35
EddieMoney9: folds 
123tiger711a: calls $0.35
LanskyBanksy: folds 
PlayTheBlues4U: folds 
bsdnj: calls $0.25
*** FLOP *** [7d 9h 4c]
bsdnj: bets $0.40
Klytu: calls $0.40
123tiger711a: folds 
*** TURN *** [7d 9h 4c] [6h]
bsdnj: bets $0.50
Klytu: raises $1.35 to $1.85
bsdnj: folds 
Uncalled bet ($1.35) returned to Klytu
Klytu collected $2.76 from pot
Klytu: doesn't show hand 
*** SUMMARY ***
Total pot $2.90 | Rake $0.14 
Board [7d 9h 4c 6h]
Seat 1: 123tiger711a folded on the Flop
Seat 2: LanskyBanksy (button) folded before Flop (didn't bet)
Seat 3: PlayTheBlues4U (small blind) folded before Flop
Seat 4: bsdnj (big blind) folded on the Turn
Seat 5: Klytu collected ($2.76)
Seat 6: EddieMoney9 folded before Flop (didn't bet)



PokerStars Hand #204850617976:  Hold'em No Limit ($0.05/$0.10 USD) - 2019/10/21 21:42:21 ET
Table 'Draco' 6-max Seat #3 is the button
Seat 1: 123tiger711a ($12.50 in chips) 
Seat 2: LanskyBanksy ($9.59 in chips) 
Seat 3: PlayTheBlues4U ($10.36 in chips) 
Seat 4: bsdnj ($7.43 in chips) 
Seat 5: Klytu ($11.63 in chips) 
Seat 6: EddieMoney9 ($15.89 in chips) 
bsdnj: posts small blind $0.05
Klytu: posts big blind $0.10
*** HOLE CARDS ***
Dealt to PlayTheBlues4U [5d Kc]
EddieMoney9: folds 
123tiger711a: calls $0.10
LanskyBanksy: calls $0.10
PlayTheBlues4U: folds 
bsdnj: folds 
Klytu: checks 
*** FLOP *** [8c Ts 4d]
Klytu: checks 
123tiger711a: checks 
LanskyBanksy: bets $0.20
Klytu: folds 
123tiger711a: calls $0.20
*** TURN *** [8c Ts 4d] [7s]
123tiger711a: checks 
LanskyBanksy: checks 
*** RIVER *** [8c Ts 4d 7s] [As]
123tiger711a: checks 
LanskyBanksy: bets $0.71
123tiger711a: folds 
Uncalled bet ($0.71) returned to LanskyBanksy
LanskyBanksy collected $0.71 from pot
LanskyBanksy: doesn't show hand 
*** SUMMARY ***
Total pot $0.75 | Rake $0.04 
Board [8c Ts 4d 7s As]
Seat 1: 123tiger711a folded on the River
Seat 2: LanskyBanksy collected ($0.71)
Seat 3: PlayTheBlues4U (button) folded before Flop (didn't bet)
Seat 4: bsdnj (small blind) folded before Flop
Seat 5: Klytu (big blind) folded on the Flop
Seat 6: EddieMoney9 folded before Flop (didn't bet)



PokerStars Hand #204850618232:  Hold'em No Limit ($0.05/$0.10 USD) - 2019/10/21 21:43:16 ET
Table 'Draco' 6-max Seat #4 is the button
Seat 1: 123tiger711a ($12.20 in chips) 
Seat 2: LanskyBanksy ($10 in chips) 
Seat 3: PlayTheBlues4U ($10.36 in chips) 
Seat 4: bsdnj ($7.38 in chips) 
Seat 5: Klytu ($11.53 in chips) 
Seat 6: EddieMoney9 ($15.89 in chips) 
Klytu: posts small blind $0.05
EddieMoney9: posts big blind $0.10
*** HOLE CARDS ***
Dealt to PlayTheBlues4U [Qc 4d]
123tiger711a: folds 
LanskyBanksy: calls $0.10
PlayTheBlues4U: folds 
bsdnj: folds 
Klytu: calls $0.05
EddieMoney9: checks 
*** FLOP *** [Kd 6d 7s]
Klytu: checks 
EddieMoney9: checks 
LanskyBanksy: bets $0.20
Klytu: folds 
EddieMoney9: folds 
Uncalled bet ($0.20) returned to LanskyBanksy
LanskyBanksy collected $0.28 from pot
LanskyBanksy: doesn't show hand 
*** SUMMARY ***
Total pot $0.30 | Rake $0.02 
Board [Kd 6d 7s]
Seat 1: 123tiger711a folded before Flop (didn't bet)
Seat 2: LanskyBanksy collected ($0.28)
Seat 3: PlayTheBlues4U folded before Flop (didn't bet)
Seat 4: bsdnj (button) folded before Flop (didn't bet)
Seat 5: Klytu (small blind) folded on the Flop
Seat 6: EddieMoney9 (big blind) folded on the Flop



PokerStars Hand #204850618429:  Hold'em No Limit ($0.05/$0.10 USD) - 2019/10/21 21:44:00 ET
Table 'Draco' 6-max Seat #5 is the button
Seat 1: 123tiger711a ($12.20 in chips) 
Seat 2: LanskyBanksy ($10.18 in chips) 
Seat 3: PlayTheBlues4U ($10.36 in chips) 
Seat 4: bsdnj ($7.38 in chips) 
Seat 5: Klytu ($11.43 in chips) 
Seat 6: EddieMoney9 ($15.79 in chips) 
EddieMoney9: posts small blind $0.05
123tiger711a: posts big blind $0.10
*** HOLE CARDS ***
Dealt to PlayTheBlues4U [3h 4h]
LanskyBanksy: folds 
PlayTheBlues4U: raises $0.20 to $0.30
bsdnj: folds 
Klytu: calls $0.30
EddieMoney9: folds 
123tiger711a: folds 
*** FLOP *** [6h As Ts]
PlayTheBlues4U: bets $0.40
Klytu: calls $0.40
*** TURN *** [6h As Ts] [6d]
PlayTheBlues4U: bets $0.90
Klytu: folds 
Uncalled bet ($0.90) returned to PlayTheBlues4U
PlayTheBlues4U collected $1.47 from pot
PlayTheBlues4U: doesn't show hand 
*** SUMMARY ***
Total pot $1.55 | Rake $0.08 
Board [6h As Ts 6d]
Seat 1: 123tiger711a (big blind) folded before Flop
Seat 2: LanskyBanksy folded before Flop (didn't bet)
Seat 3: PlayTheBlues4U collected ($1.47)
Seat 4: bsdnj folded before Flop (didn't bet)
Seat 5: Klytu (button) folded on the Turn
Seat 6: EddieMoney9 (small blind) folded before Flop



PokerStars Hand #204850618685:  Hold'em No Limit ($0.05/$0.10 USD) - 2019/10/21 21:44:54 ET
Table 'Draco' 6-max Seat #6 is the button
Seat 1: 123tiger711a ($12.10 in chips) 
Seat 2: LanskyBanksy ($10.18 in chips) 
Seat 3: PlayTheBlues4U ($11.13 in chips) 
Seat 4: bsdnj ($7.38 in chips) 
Seat 5: Klytu ($10.73 in chips) 
Seat 6: EddieMoney9 ($15.74 in chips) 
123tiger711a: posts small blind $0.05
LanskyBanksy: posts big blind $0.10
*** HOLE CARDS ***
Dealt to PlayTheBlues4U [Kd 6s]
PlayTheBlues4U: folds 
bsdnj: folds 
Klytu: folds 
EddieMoney9: raises $0.20 to $0.30
123tiger711a: calls $0.25
LanskyBanksy: folds 
*** FLOP *** [9c 6c Th]
123tiger711a: checks 
EddieMoney9: bets $0.46
123tiger711a: calls $0.46
*** TURN *** [9c 6c Th] [7d]
123tiger711a: checks 
EddieMoney9: bets $1.08
123tiger711a: folds 
Uncalled bet ($1.08) returned to EddieMoney9
EddieMoney9 collected $1.54 from pot
EddieMoney9: doesn't show hand 
*** SUMMARY ***
Total pot $1.62 | Rake $0.08 
Board [9c 6c Th 7d]
Seat 1: 123tiger711a (small blind) folded on the Turn
Seat 2: LanskyBanksy (big blind) folded before Flop
Seat 3: PlayTheBlues4U folded before Flop (didn't bet)
Seat 4: bsdnj folded before Flop (didn't bet)
Seat 5: Klytu folded before Flop (didn't bet)
Seat 6: EddieMoney9 (button) collected ($1.54)



PokerStars Hand #204850618829:  Hold'em No Limit ($0.05/$0.10 USD) - 2019/10/21 21:45:24 ET
Table 'Draco' 6-max Seat #1 is the button
Seat 1: 123tiger711a ($11.34 in chips) 
Seat 2: LanskyBanksy ($10.08 in chips) 
Seat 3: PlayTheBlues4U ($11.13 in chips) 
Seat 4: bsdnj ($7.38 in chips) 
Seat 5: Klytu ($10.73 in chips) 
Seat 6: EddieMoney9 ($16.52 in chips) 
LanskyBanksy: posts small blind $0.05
PlayTheBlues4U: posts big blind $0.10
*** HOLE CARDS ***
Dealt to PlayTheBlues4U [7c 3h]
bsdnj: folds 
Klytu: folds 
EddieMoney9: folds 
123tiger711a: folds 
LanskyBanksy: raises $0.20 to $0.30
PlayTheBlues4U: folds 
Uncalled bet ($0.20) returned to LanskyBanksy
LanskyBanksy collected $0.20 from pot
LanskyBanksy: doesn't show hand 
*** SUMMARY ***
Total pot $0.20 | Rake $0 
Seat 1: 123tiger711a (button) folded before Flop (didn't bet)
Seat 2: LanskyBanksy (small blind) collected ($0.20)
Seat 3: PlayTheBlues4U (big blind) folded before Flop
Seat 4: bsdnj folded before Flop (didn't bet)
Seat 5: Klytu folded before Flop (didn't bet)
Seat 6: EddieMoney9 folded before Flop (didn't bet)



PokerStars Hand #204850618928:  Hold'em No Limit ($0.05/$0.10 USD) - 2019/10/21 21:45:45 ET
Table 'Draco' 6-max Seat #2 is the button
Seat 1: 123tiger711a ($11.34 in chips) 
Seat 2: LanskyBanksy ($10.18 in chips) 
Seat 3: PlayTheBlues4U ($11.03 in chips) 
Seat 4: bsdnj ($7.38 in chips) 
Seat 5: Klytu ($10.73 in chips) 
Seat 6: EddieMoney9 ($16.52 in chips) 
PlayTheBlues4U: posts small blind $0.05
bsdnj: posts big blind $0.10
*** HOLE CARDS ***
Dealt to PlayTheBlues4U [8d 7s]
Klytu: folds 
EddieMoney9: folds 
123tiger711a: calls $0.10
LanskyBanksy: calls $0.10
PlayTheBlues4U: folds 
bsdnj: checks 
*** FLOP *** [Jc 7h 8h]
bsdnj: checks 
123tiger711a: bets $0.17
LanskyBanksy: raises $0.17 to $0.34
bsdnj: calls $0.34
123tiger711a: calls $0.17
*** TURN *** [Jc 7h 8h] [Kh]
bsdnj: checks 
123tiger711a: checks 
LanskyBanksy: bets $0.80
bsdnj: calls $0.80
123tiger711a: folds 
*** RIVER *** [Jc 7h 8h Kh] [As]
bsdnj: bets $1.60
LanskyBanksy: raises $2.40 to $4
bsdnj: calls $2.40
*** SHOW DOWN ***
LanskyBanksy: shows [5h 6h] (a flush, King high)
bsdnj: mucks hand 
LanskyBanksy collected $10.42 from pot
*** SUMMARY ***
Total pot $10.97 | Rake $0.55 
Board [Jc 7h 8h Kh As]
Seat 1: 123tiger711a folded on the Turn
Seat 2: LanskyBanksy (button) showed [5h 6h] and won ($10.42) with a flush, King high
Seat 3: PlayTheBlues4U (small blind) folded before Flop
Seat 4: bsdnj (big blind) mucked [Ts Qs]
Seat 5: Klytu folded before Flop (didn't bet)
Seat 6: EddieMoney9 folded before Flop (didn't bet)



PokerStars Hand #204850619248:  Hold'em No Limit ($0.05/$0.10 USD) - 2019/10/21 21:46:55 ET
Table 'Draco' 6-max Seat #3 is the button
Seat 1: 123tiger711a ($10.90 in chips) 
Seat 2: LanskyBanksy ($15.36 in chips) 
Seat 3: PlayTheBlues4U ($10.98 in chips) 
Seat 4: bsdnj ($2.14 in chips) 
Seat 5: Klytu ($10.73 in chips) 
Seat 6: EddieMoney9 ($16.52 in chips) 
bsdnj: posts small blind $0.05
Klytu: posts big blind $0.10
*** HOLE CARDS ***
Dealt to PlayTheBlues4U [Kd 5s]
EddieMoney9: folds 
123tiger711a: folds 
LanskyBanksy: folds 
PlayTheBlues4U: folds 
bsdnj: folds 
Uncalled bet ($0.05) returned to Klytu
Klytu collected $0.10 from pot
Klytu: doesn't show hand 
*** SUMMARY ***
Total pot $0.10 | Rake $0 
Seat 1: 123tiger711a folded before Flop (didn't bet)
Seat 2: LanskyBanksy folded before Flop (didn't bet)
Seat 3: PlayTheBlues4U (button) folded before Flop (didn't bet)
Seat 4: bsdnj (small blind) folded before Flop
Seat 5: Klytu (big blind) collected ($0.10)
Seat 6: EddieMoney9 folded before Flop (didn't bet)



PokerStars Hand #204850619348:  Hold'em No Limit ($0.05/$0.10 USD) - 2019/10/21 21:47:16 ET
Table 'Draco' 6-max Seat #4 is the button
Seat 1: 123tiger711a ($10.90 in chips) 
Seat 2: LanskyBanksy ($15.36 in chips) 
Seat 3: PlayTheBlues4U ($10.98 in chips) 
Seat 4: bsdnj ($6.53 in chips) 
Seat 5: Klytu ($10.78 in chips) 
Seat 6: EddieMoney9 ($16.52 in chips) 
Klytu: posts small blind $0.05
EddieMoney9: posts big blind $0.10
*** HOLE CARDS ***
Dealt to PlayTheBlues4U [7c 8d]
123tiger711a: folds 
LanskyBanksy: calls $0.10
PlayTheBlues4U: folds 
bsdnj: folds 
Klytu: calls $0.05
EddieMoney9: checks 
*** FLOP *** [6h 2h 4h]
Klytu: checks 
EddieMoney9: checks 
LanskyBanksy: bets $0.28
Klytu: folds 
EddieMoney9: folds 
Uncalled bet ($0.28) returned to LanskyBanksy
LanskyBanksy collected $0.28 from pot
LanskyBanksy: doesn't show hand 
*** SUMMARY ***
Total pot $0.30 | Rake $0.02 
Board [6h 2h 4h]
Seat 1: 123tiger711a folded before Flop (didn't bet)
Seat 2: LanskyBanksy collected ($0.28)
Seat 3: PlayTheBlues4U folded before Flop (didn't bet)
Seat 4: bsdnj (button) folded before Flop (didn't bet)
Seat 5: Klytu (small blind) folded on the Flop
Seat 6: EddieMoney9 (big blind) folded on the Flop



PokerStars Hand #204846334877:  Hold'em No Limit ($0.05/$0.10 USD) - 2019/10/21 20:52:17 ET
Table 'Hesperia' 6-max Seat #2 is the button
Seat 1: SeaofLove ($12.46 in chips) 
Seat 2: csxwe ($12.17 in chips) 
Seat 3: Varginho13 ($9.94 in chips) 
Seat 4: PlayTheBlues4U ($10 in chips) 
Seat 6: 123tiger711a ($12.93 in chips) 
Varginho13: posts small blind $0.05
PlayTheBlues4U: posts big blind $0.10
Klytu: sits out 
*** HOLE CARDS ***
Dealt to PlayTheBlues4U [Qs 7c]
123tiger711a: folds 
SeaofLove: folds 
csxwe: calls $0.10
Varginho13: calls $0.05
PlayTheBlues4U: checks 
*** FLOP *** [9c As Td]
Varginho13: checks 
PlayTheBlues4U: checks 
csxwe: checks 
*** TURN *** [9c As Td] [6h]
Varginho13: checks 
PlayTheBlues4U: checks 
csxwe: checks 
*** RIVER *** [9c As Td 6h] [Jd]
Varginho13: checks 
PlayTheBlues4U: checks 
csxwe: checks 
*** SHOW DOWN ***
Varginho13: shows [7d Qc] (high card Ace)
PlayTheBlues4U: shows [Qs 7c] (high card Ace)
csxwe: shows [6d 5s] (a pair of Sixes)
csxwe collected $0.28 from pot
*** SUMMARY ***
Total pot $0.30 | Rake $0.02 
Board [9c As Td 6h Jd]
Seat 1: SeaofLove folded before Flop (didn't bet)
Seat 2: csxwe (button) showed [6d 5s] and won ($0.28) with a pair of Sixes
Seat 3: Varginho13 (small blind) showed [7d Qc] and lost with high card Ace
Seat 4: PlayTheBlues4U (big blind) showed [Qs 7c] and lost with high card Ace
Seat 6: 123tiger711a folded before Flop (didn't bet)



PokerStars Hand #204846335028:  Hold'em No Limit ($0.05/$0.10 USD) - 2019/10/21 20:52:52 ET
Table 'Hesperia' 6-max Seat #3 is the button
Seat 1: SeaofLove ($12.46 in chips) 
Seat 2: csxwe ($12.35 in chips) 
Seat 3: Varginho13 ($9.84 in chips) 
Seat 4: PlayTheBlues4U ($9.90 in chips) 
Seat 5: Klytu ($10 in chips) 
Seat 6: 123tiger711a ($12.93 in chips) 
PlayTheBlues4U: posts small blind $0.05
Klytu: posts big blind $0.10
*** HOLE CARDS ***
Dealt to PlayTheBlues4U [Qd Ah]
123tiger711a: calls $0.10
SeaofLove: folds 
csxwe: folds 
Varginho13: raises $0.40 to $0.50
PlayTheBlues4U: calls $0.45
Klytu: folds 
123tiger711a: folds 
*** FLOP *** [5c Kd 3h]
PlayTheBlues4U: checks 
Varginho13: checks 
*** TURN *** [5c Kd 3h] [3s]
PlayTheBlues4U: checks 
Varginho13: bets $0.86
PlayTheBlues4U: calls $0.86
*** RIVER *** [5c Kd 3h 3s] [5d]
PlayTheBlues4U: checks 
Varginho13: bets $1.39
PlayTheBlues4U: folds 
Uncalled bet ($1.39) returned to Varginho13
Varginho13 collected $2.77 from pot
*** SUMMARY ***
Total pot $2.92 | Rake $0.15 
Board [5c Kd 3h 3s 5d]
Seat 1: SeaofLove folded before Flop (didn't bet)
Seat 2: csxwe folded before Flop (didn't bet)
Seat 3: Varginho13 (button) collected ($2.77)
Seat 4: PlayTheBlues4U (small blind) folded on the River
Seat 5: Klytu (big blind) folded before Flop
Seat 6: 123tiger711a folded before Flop



PokerStars Hand #204846335329:  Hold'em No Limit ($0.05/$0.10 USD) - 2019/10/21 20:53:59 ET
Table 'Hesperia' 6-max Seat #4 is the button
Seat 1: SeaofLove ($12.46 in chips) 
Seat 2: csxwe ($12.35 in chips) 
Seat 3: Varginho13 ($11.25 in chips) 
Seat 4: PlayTheBlues4U ($8.54 in chips) 
Seat 5: Klytu ($9.90 in chips) 
Seat 6: 123tiger711a ($12.83 in chips) 
Klytu: posts small blind $0.05
123tiger711a: posts big blind $0.10
*** HOLE CARDS ***
Dealt to PlayTheBlues4U [8d Jh]
SeaofLove: folds 
csxwe: folds 
Varginho13: folds 
PlayTheBlues4U: folds 
Klytu: folds 
Uncalled bet ($0.05) returned to 123tiger711a
123tiger711a collected $0.10 from pot
*** SUMMARY ***
Total pot $0.10 | Rake $0 
Seat 1: SeaofLove folded before Flop (didn't bet)
Seat 2: csxwe folded before Flop (didn't bet)
Seat 3: Varginho13 folded before Flop (didn't bet)
Seat 4: PlayTheBlues4U (button) folded before Flop (didn't bet)
Seat 5: Klytu (small blind) folded before Flop
Seat 6: 123tiger711a (big blind) collected ($0.10)



PokerStars Hand #204846335428:  Hold'em No Limit ($0.05/$0.10 USD) - 2019/10/21 20:54:21 ET
Table 'Hesperia' 6-max Seat #5 is the button
Seat 1: SeaofLove ($12.46 in chips) 
Seat 2: csxwe ($12.35 in chips) 
Seat 3: Varginho13 ($11.25 in chips) 
Seat 4: PlayTheBlues4U ($8.54 in chips) 
Seat 5: Klytu ($9.85 in chips) 
Seat 6: 123tiger711a ($12.88 in chips) 
123tiger711a: posts small blind $0.05
SeaofLove: posts big blind $0.10
*** HOLE CARDS ***
Dealt to PlayTheBlues4U [2c 9c]
csxwe: folds 
Varginho13: folds 
PlayTheBlues4U: folds 
Klytu: raises $0.15 to $0.25
123tiger711a: calls $0.20
SeaofLove: calls $0.15
*** FLOP *** [Ts 9s As]
123tiger711a: checks 
SeaofLove: checks 
Klytu: bets $0.45
123tiger711a: calls $0.45
SeaofLove: folds 
*** TURN *** [Ts 9s As] [5d]
123tiger711a: checks 
Klytu: bets $1
123tiger711a: folds 
Uncalled bet ($1) returned to Klytu
Klytu collected $1.57 from pot
Klytu: doesn't show hand 
*** SUMMARY ***
Total pot $1.65 | Rake $0.08 
Board [Ts 9s As 5d]
Seat 1: SeaofLove (big blind) folded on the Flop
Seat 2: csxwe folded before Flop (didn't bet)
Seat 3: Varginho13 folded before Flop (didn't bet)
Seat 4: PlayTheBlues4U folded before Flop (didn't bet)
Seat 5: Klytu (button) collected ($1.57)
Seat 6: 123tiger711a (small blind) folded on the Turn



PokerStars Hand #204846335577:  Hold'em No Limit ($0.05/$0.10 USD) - 2019/10/21 20:54:55 ET
Table 'Hesperia' 6-max Seat #6 is the button
Seat 1: SeaofLove ($12.21 in chips) 
Seat 2: csxwe ($12.35 in chips) 
Seat 3: Varginho13 ($11.25 in chips) 
Seat 4: PlayTheBlues4U ($8.54 in chips) 
Seat 5: Klytu ($10.72 in chips) 
Seat 6: 123tiger711a ($12.18 in chips) 
SeaofLove: posts small blind $0.05
csxwe: posts big blind $0.10
*** HOLE CARDS ***
Dealt to PlayTheBlues4U [Kd 3s]
Varginho13: folds 
PlayTheBlues4U: folds 
Klytu: calls $0.10
123tiger711a: raises $0.50 to $0.60
SeaofLove: folds 
csxwe: calls $0.50
Klytu: folds 
*** FLOP *** [Qh 4d 2c]
csxwe: checks 
123tiger711a: bets $0.64
csxwe: calls $0.64
*** TURN *** [Qh 4d 2c] [Td]
csxwe: checks 
123tiger711a: bets $1.25
csxwe: raises $4.95 to $6.20
123tiger711a: folds 
Uncalled bet ($4.95) returned to csxwe
csxwe collected $4.87 from pot
csxwe: doesn't show hand 
*** SUMMARY ***
Total pot $5.13 | Rake $0.26 
Board [Qh 4d 2c Td]
Seat 1: SeaofLove (small blind) folded before Flop
Seat 2: csxwe (big blind) collected ($4.87)
Seat 3: Varginho13 folded before Flop (didn't bet)
Seat 4: PlayTheBlues4U folded before Flop (didn't bet)
Seat 5: Klytu folded before Flop
Seat 6: 123tiger711a (button) folded on the Turn



PokerStars Hand #204846335709:  Hold'em No Limit ($0.05/$0.10 USD) - 2019/10/21 20:55:31 ET
Table 'Hesperia' 6-max Seat #1 is the button
Seat 1: SeaofLove ($12.16 in chips) 
Seat 2: csxwe ($14.73 in chips) 
Seat 3: Varginho13 ($11.25 in chips) 
Seat 4: PlayTheBlues4U ($8.54 in chips) 
Seat 5: Klytu ($10.62 in chips) 
Seat 6: 123tiger711a ($10 in chips) 
csxwe: posts small blind $0.05
Varginho13: posts big blind $0.10
*** HOLE CARDS ***
Dealt to PlayTheBlues4U [Tc 3h]
PlayTheBlues4U: folds 
Klytu: folds 
123tiger711a: folds 
SeaofLove: folds 
csxwe: raises $0.10 to $0.20
Varginho13: calls $0.10
*** FLOP *** [Jh 2s 4h]
csxwe: checks 
Varginho13: bets $0.38
csxwe: raises $0.38 to $0.76
Varginho13: calls $0.38
*** TURN *** [Jh 2s 4h] [2d]
csxwe: checks 
Varginho13: bets $0.91
csxwe: calls $0.91
*** RIVER *** [Jh 2s 4h 2d] [8h]
csxwe: bets $1.80
Varginho13: calls $1.80
*** SHOW DOWN ***
csxwe: shows [Ts Jd] (two pair, Jacks and Deuces)
Varginho13: shows [Kh Jc] (two pair, Jacks and Deuces - King kicker)
Varginho13 collected $6.97 from pot
*** SUMMARY ***
Total pot $7.34 | Rake $0.37 
Board [Jh 2s 4h 2d 8h]
Seat 1: SeaofLove (button) folded before Flop (didn't bet)
Seat 2: csxwe (small blind) showed [Ts Jd] and lost with two pair, Jacks and Deuces
Seat 3: Varginho13 (big blind) showed [Kh Jc] and won ($6.97) with two pair, Jacks and Deuces
Seat 4: PlayTheBlues4U folded before Flop (didn't bet)
Seat 5: Klytu folded before Flop (didn't bet)
Seat 6: 123tiger711a folded before Flop (didn't bet)



PokerStars Hand #204846335845:  Hold'em No Limit ($0.05/$0.10 USD) - 2019/10/21 20:56:09 ET
Table 'Hesperia' 6-max Seat #2 is the button
Seat 1: SeaofLove ($12.16 in chips) 
Seat 2: csxwe ($11.06 in chips) 
Seat 3: Varginho13 ($14.55 in chips) 
Seat 4: PlayTheBlues4U ($8.54 in chips) 
Seat 5: Klytu ($10.62 in chips) 
Seat 6: 123tiger711a ($10 in chips) 
Varginho13: posts small blind $0.05
PlayTheBlues4U: posts big blind $0.10
*** HOLE CARDS ***
Dealt to PlayTheBlues4U [3d 9s]
Klytu: folds 
123tiger711a: folds 
SeaofLove: folds 
csxwe: folds 
Varginho13: raises $0.20 to $0.30
PlayTheBlues4U: folds 
Uncalled bet ($0.20) returned to Varginho13
Varginho13 collected $0.20 from pot
*** SUMMARY ***
Total pot $0.20 | Rake $0 
Seat 1: SeaofLove folded before Flop (didn't bet)
Seat 2: csxwe (button) folded before Flop (didn't bet)
Seat 3: Varginho13 (small blind) collected ($0.20)
Seat 4: PlayTheBlues4U (big blind) folded before Flop
Seat 5: Klytu folded before Flop (didn't bet)
Seat 6: 123tiger711a folded before Flop (didn't bet)



PokerStars Hand #204846335896:  Hold'em No Limit ($0.05/$0.10 USD) - 2019/10/21 20:56:25 ET
Table 'Hesperia' 6-max Seat #3 is the button
Seat 1: SeaofLove ($12.16 in chips) 
Seat 2: csxwe ($11.06 in chips) 
Seat 3: Varginho13 ($14.65 in chips) 
Seat 4: PlayTheBlues4U ($8.44 in chips) 
Seat 5: Klytu ($10.62 in chips) 
Seat 6: 123tiger711a ($10 in chips) 
PlayTheBlues4U: posts small blind $0.05
Klytu: posts big blind $0.10
*** HOLE CARDS ***
Dealt to PlayTheBlues4U [8s 2c]
123tiger711a: folds 
SeaofLove: folds 
csxwe: folds 
Varginho13: raises $0.20 to $0.30
PlayTheBlues4U: folds 
Klytu: folds 
Uncalled bet ($0.20) returned to Varginho13
Varginho13 collected $0.25 from pot
*** SUMMARY ***
Total pot $0.25 | Rake $0 
Seat 1: SeaofLove folded before Flop (didn't bet)
Seat 2: csxwe folded before Flop (didn't bet)
Seat 3: Varginho13 (button) collected ($0.25)
Seat 4: PlayTheBlues4U (small blind) folded before Flop
Seat 5: Klytu (big blind) folded before Flop
Seat 6: 123tiger711a folded before Flop (didn't bet)



PokerStars Hand #204846335962:  Hold'em No Limit ($0.05/$0.10 USD) - 2019/10/21 20:56:46 ET
Table 'Hesperia' 6-max Seat #4 is the button
Seat 1: SeaofLove ($12.16 in chips) 
Seat 2: csxwe ($11.06 in chips) 
Seat 3: Varginho13 ($14.80 in chips) 
Seat 4: PlayTheBlues4U ($8.39 in chips) 
Seat 5: Klytu ($10.52 in chips) 
Seat 6: 123tiger711a ($10 in chips) 
Klytu: posts small blind $0.05
123tiger711a: posts big blind $0.10
*** HOLE CARDS ***
Dealt to PlayTheBlues4U [3d 5d]
SeaofLove: raises $0.15 to $0.25
csxwe: folds 
Varginho13: calls $0.25
PlayTheBlues4U: folds 
Klytu: folds 
123tiger711a: calls $0.15
*** FLOP *** [Tc 6c 6h]
123tiger711a: checks 
SeaofLove: checks 
Varginho13: checks 
*** TURN *** [Tc 6c 6h] [Ah]
123tiger711a: checks 
SeaofLove: checks 
Varginho13: bets $0.75
123tiger711a: folds 
SeaofLove: folds 
Uncalled bet ($0.75) returned to Varginho13
Varginho13 collected $0.76 from pot
*** SUMMARY ***
Total pot $0.80 | Rake $0.04 
Board [Tc 6c 6h Ah]
Seat 1: SeaofLove folded on the Turn
Seat 2: csxwe folded before Flop (didn't bet)
Seat 3: Varginho13 collected ($0.76)
Seat 4: PlayTheBlues4U (button) folded before Flop (didn't bet)
Seat 5: Klytu (small blind) folded before Flop
Seat 6: 123tiger711a (big blind) folded on the Turn



PokerStars Hand #204846336085:  Hold'em No Limit ($0.05/$0.10 USD) - 2019/10/21 20:57:22 ET
Table 'Hesperia' 6-max Seat #5 is the button
Seat 1: SeaofLove ($11.91 in chips) 
Seat 2: csxwe ($11.06 in chips) 
Seat 3: Varginho13 ($15.31 in chips) 
Seat 4: PlayTheBlues4U ($8.39 in chips) 
Seat 5: Klytu ($10.47 in chips) 
Seat 6: 123tiger711a ($10 in chips) 
123tiger711a: posts small blind $0.05
SeaofLove: posts big blind $0.10
*** HOLE CARDS ***
Dealt to PlayTheBlues4U [Qc 6d]
csxwe: folds 
Varginho13: folds 
PlayTheBlues4U: folds 
Klytu: folds 
123tiger711a: calls $0.05
SeaofLove: raises $0.20 to $0.30
123tiger711a: folds 
Uncalled bet ($0.20) returned to SeaofLove
SeaofLove collected $0.20 from pot
SeaofLove: doesn't show hand 
*** SUMMARY ***
Total pot $0.20 | Rake $0 
Seat 1: SeaofLove (big blind) collected ($0.20)
Seat 2: csxwe folded before Flop (didn't bet)
Seat 3: Varginho13 folded before Flop (didn't bet)
Seat 4: PlayTheBlues4U folded before Flop (didn't bet)
Seat 5: Klytu (button) folded before Flop (didn't bet)
Seat 6: 123tiger711a (small blind) folded before Flop



PokerStars Hand #204846336152:  Hold'em No Limit ($0.05/$0.10 USD) - 2019/10/21 20:57:41 ET
Table 'Hesperia' 6-max Seat #6 is the button
Seat 1: SeaofLove ($12.01 in chips) 
Seat 2: csxwe ($11.06 in chips) 
Seat 3: Varginho13 ($15.31 in chips) 
Seat 4: PlayTheBlues4U ($8.39 in chips) 
Seat 5: Klytu ($10.47 in chips) 
Seat 6: 123tiger711a ($10 in chips) 
SeaofLove: posts small blind $0.05
csxwe: posts big blind $0.10
*** HOLE CARDS ***
Dealt to PlayTheBlues4U [Qc Js]
Varginho13: raises $0.20 to $0.30
PlayTheBlues4U: folds 
Klytu: folds 
123tiger711a: folds 
SeaofLove: folds 
csxwe: folds 
Uncalled bet ($0.20) returned to Varginho13
Varginho13 collected $0.25 from pot
*** SUMMARY ***
Total pot $0.25 | Rake $0 
Seat 1: SeaofLove (small blind) folded before Flop
Seat 2: csxwe (big blind) folded before Flop
Seat 3: Varginho13 collected ($0.25)
Seat 4: PlayTheBlues4U folded before Flop (didn't bet)
Seat 5: Klytu folded before Flop (didn't bet)
Seat 6: 123tiger711a (button) folded before Flop (didn't bet)



PokerStars Hand #204846336206:  Hold'em No Limit ($0.05/$0.10 USD) - 2019/10/21 20:57:58 ET
Table 'Hesperia' 6-max Seat #1 is the button
Seat 1: SeaofLove ($11.96 in chips) 
Seat 2: csxwe ($10.96 in chips) 
Seat 3: Varginho13 ($15.46 in chips) 
Seat 4: PlayTheBlues4U ($8.39 in chips) 
Seat 5: Klytu ($10.47 in chips) 
Seat 6: 123tiger711a ($10 in chips) 
csxwe: posts small blind $0.05
Varginho13: posts big blind $0.10
*** HOLE CARDS ***
Dealt to PlayTheBlues4U [7d 2s]
PlayTheBlues4U: folds 
Klytu: raises $0.20 to $0.30
123tiger711a: calls $0.30
SeaofLove: folds 
csxwe: folds 
Varginho13: folds 
*** FLOP *** [Jc 3c 7h]
Klytu: bets $0.30
123tiger711a: calls $0.30
*** TURN *** [Jc 3c 7h] [6d]
Klytu: bets $0.65
123tiger711a: calls $0.65
*** RIVER *** [Jc 3c 7h 6d] [Ah]
Klytu: checks 
123tiger711a: checks 
*** SHOW DOWN ***
Klytu: shows [Jd Ks] (a pair of Jacks)
123tiger711a: mucks hand 
Klytu collected $2.52 from pot
*** SUMMARY ***
Total pot $2.65 | Rake $0.13 
Board [Jc 3c 7h 6d Ah]
Seat 1: SeaofLove (button) folded before Flop (didn't bet)
Seat 2: csxwe (small blind) folded before Flop
Seat 3: Varginho13 (big blind) folded before Flop
Seat 4: PlayTheBlues4U folded before Flop (didn't bet)
Seat 5: Klytu showed [Jd Ks] and won ($2.52) with a pair of Jacks
Seat 6: 123tiger711a mucked [9h 9d]



PokerStars Hand #204846336354:  Hold'em No Limit ($0.05/$0.10 USD) - 2019/10/21 20:58:44 ET
Table 'Hesperia' 6-max Seat #2 is the button
Seat 1: SeaofLove ($11.96 in chips) 
Seat 2: csxwe ($10.91 in chips) 
Seat 3: Varginho13 ($15.36 in chips) 
Seat 4: PlayTheBlues4U ($8.39 in chips) 
Seat 5: Klytu ($11.74 in chips) 
Seat 6: 123tiger711a ($10 in chips) 
Varginho13: posts small blind $0.05
PlayTheBlues4U: posts big blind $0.10
*** HOLE CARDS ***
Dealt to PlayTheBlues4U [3c 3s]
Klytu: folds 
123tiger711a: calls $0.10
SeaofLove: raises $0.35 to $0.45
csxwe: folds 
Varginho13: folds 
PlayTheBlues4U: calls $0.35
123tiger711a: folds 
*** FLOP *** [9c 7d Js]
PlayTheBlues4U: checks 
SeaofLove: bets $0.70
PlayTheBlues4U: folds 
Uncalled bet ($0.70) returned to SeaofLove
SeaofLove collected $1 from pot
SeaofLove: doesn't show hand 
*** SUMMARY ***
Total pot $1.05 | Rake $0.05 
Board [9c 7d Js]
Seat 1: SeaofLove collected ($1)
Seat 2: csxwe (button) folded before Flop (didn't bet)
Seat 3: Varginho13 (small blind) folded before Flop
Seat 4: PlayTheBlues4U (big blind) folded on the Flop
Seat 5: Klytu folded before Flop (didn't bet)
Seat 6: 123tiger711a folded before Flop



PokerStars Hand #204846336445:  Hold'em No Limit ($0.05/$0.10 USD) - 2019/10/21 20:59:13 ET
Table 'Hesperia' 6-max Seat #3 is the button
Seat 1: SeaofLove ($12.51 in chips) 
Seat 2: csxwe ($10.91 in chips) 
Seat 3: Varginho13 ($15.31 in chips) 
Seat 4: PlayTheBlues4U ($7.94 in chips) 
Seat 5: Klytu ($11.74 in chips) 
Seat 6: 123tiger711a ($10 in chips) 
PlayTheBlues4U: posts small blind $0.05
Klytu: posts big blind $0.10
*** HOLE CARDS ***
Dealt to PlayTheBlues4U [Qd Td]
123tiger711a: folds 
SeaofLove: folds 
csxwe: folds 
Varginho13: folds 
PlayTheBlues4U: raises $0.15 to $0.25
Klytu: calls $0.15
*** FLOP *** [Qc 3s 2d]
PlayTheBlues4U: bets $0.30
Klytu: calls $0.30
*** TURN *** [Qc 3s 2d] [Js]
PlayTheBlues4U: checks 
Klytu: checks 
*** RIVER *** [Qc 3s 2d Js] [5h]
PlayTheBlues4U: bets $0.70
Klytu: calls $0.70
*** SHOW DOWN ***
PlayTheBlues4U: shows [Qd Td] (a pair of Queens)
Klytu: mucks hand 
PlayTheBlues4U collected $2.38 from pot
*** SUMMARY ***
Total pot $2.50 | Rake $0.12 
Board [Qc 3s 2d Js 5h]
Seat 1: SeaofLove folded before Flop (didn't bet)
Seat 2: csxwe folded before Flop (didn't bet)
Seat 3: Varginho13 (button) folded before Flop (didn't bet)
Seat 4: PlayTheBlues4U (small blind) showed [Qd Td] and won ($2.38) with a pair of Queens
Seat 5: Klytu (big blind) mucked [Kh 2c]
Seat 6: 123tiger711a folded before Flop (didn't bet)



PokerStars Hand #204846336600:  Hold'em No Limit ($0.05/$0.10 USD) - 2019/10/21 20:59:57 ET
Table 'Hesperia' 6-max Seat #4 is the button
Seat 1: SeaofLove ($12.51 in chips) 
Seat 2: csxwe ($10.91 in chips) 
Seat 3: Varginho13 ($15.31 in chips) 
Seat 4: PlayTheBlues4U ($9.07 in chips) 
Seat 5: Klytu ($10.49 in chips) 
Seat 6: 123tiger711a ($10 in chips) 
Klytu: posts small blind $0.05
123tiger711a: posts big blind $0.10
*** HOLE CARDS ***
Dealt to PlayTheBlues4U [3d Kc]
SeaofLove: folds 
csxwe: folds 
Varginho13: folds 
PlayTheBlues4U: folds 
Klytu: raises $0.20 to $0.30
123tiger711a: folds 
Uncalled bet ($0.20) returned to Klytu
Klytu collected $0.20 from pot
Klytu: doesn't show hand 
*** SUMMARY ***
Total pot $0.20 | Rake $0 
Seat 1: SeaofLove folded before Flop (didn't bet)
Seat 2: csxwe folded before Flop (didn't bet)
Seat 3: Varginho13 folded before Flop (didn't bet)
Seat 4: PlayTheBlues4U (button) folded before Flop (didn't bet)
Seat 5: Klytu (small blind) collected ($0.20)
Seat 6: 123tiger711a (big blind) folded before Flop



PokerStars Hand #204846336648:  Hold'em No Limit ($0.05/$0.10 USD) - 2019/10/21 21:00:10 ET
Table 'Hesperia' 6-max Seat #5 is the button
Seat 1: SeaofLove ($12.51 in chips) 
Seat 2: csxwe ($10.91 in chips) 
Seat 3: Varginho13 ($15.31 in chips) 
Seat 4: PlayTheBlues4U ($9.07 in chips) 
Seat 5: Klytu ($10.59 in chips) 
Seat 6: 123tiger711a ($10 in chips) 
123tiger711a: posts small blind $0.05
SeaofLove: posts big blind $0.10
*** HOLE CARDS ***
Dealt to PlayTheBlues4U [8s 6c]
csxwe: calls $0.10
Varginho13: folds 
PlayTheBlues4U: folds 
Klytu: folds 
123tiger711a: calls $0.05
SeaofLove: checks 
*** FLOP *** [3d 6d Jc]
123tiger711a: checks 
SeaofLove: checks 
csxwe: checks 
*** TURN *** [3d 6d Jc] [Jd]
123tiger711a: checks 
SeaofLove: checks 
csxwe: checks 
*** RIVER *** [3d 6d Jc Jd] [7d]
123tiger711a: checks 
SeaofLove: checks 
csxwe: checks 
*** SHOW DOWN ***
123tiger711a: shows [7h 8h] (two pair, Jacks and Sevens)
SeaofLove: mucks hand 
csxwe: mucks hand 
123tiger711a collected $0.28 from pot
*** SUMMARY ***
Total pot $0.30 | Rake $0.02 
Board [3d 6d Jc Jd 7d]
Seat 1: SeaofLove (big blind) mucked [Ts 3h]
Seat 2: csxwe mucked [4s Qs]
Seat 3: Varginho13 folded before Flop (didn't bet)
Seat 4: PlayTheBlues4U folded before Flop (didn't bet)
Seat 5: Klytu (button) folded before Flop (didn't bet)
Seat 6: 123tiger711a (small blind) showed [7h 8h] and won ($0.28) with two pair, Jacks and Sevens



PokerStars Hand #204846336768:  Hold'em No Limit ($0.05/$0.10 USD) - 2019/10/21 21:00:38 ET
Table 'Hesperia' 6-max Seat #6 is the button
Seat 1: SeaofLove ($12.41 in chips) 
Seat 2: csxwe ($10.81 in chips) 
Seat 3: Varginho13 ($15.31 in chips) 
Seat 4: PlayTheBlues4U ($9.07 in chips) 
Seat 5: Klytu ($10.59 in chips) 
Seat 6: 123tiger711a ($10.18 in chips) 
SeaofLove: posts small blind $0.05
csxwe: posts big blind $0.10
*** HOLE CARDS ***
Dealt to PlayTheBlues4U [8s Kc]
Varginho13: folds 
PlayTheBlues4U: folds 
Klytu: folds 
123tiger711a: calls $0.10
SeaofLove: folds 
csxwe: checks 
*** FLOP *** [Kh 6c Qh]
csxwe: checks 
123tiger711a: bets $0.10
csxwe: folds 
Uncalled bet ($0.10) returned to 123tiger711a
123tiger711a collected $0.24 from pot
*** SUMMARY ***
Total pot $0.25 | Rake $0.01 
Board [Kh 6c Qh]
Seat 1: SeaofLove (small blind) folded before Flop
Seat 2: csxwe (big blind) folded on the Flop
Seat 3: Varginho13 folded before Flop (didn't bet)
Seat 4: PlayTheBlues4U folded before Flop (didn't bet)
Seat 5: Klytu folded before Flop (didn't bet)
Seat 6: 123tiger711a (button) collected ($0.24)



PokerStars Hand #204846336899:  Hold'em No Limit ($0.05/$0.10 USD) - 2019/10/21 21:01:07 ET
Table 'Hesperia' 6-max Seat #1 is the button
Seat 1: SeaofLove ($12.36 in chips) 
Seat 2: csxwe ($10.71 in chips) 
Seat 3: Varginho13 ($15.31 in chips) 
Seat 4: PlayTheBlues4U ($9.07 in chips) 
Seat 5: Klytu ($10.59 in chips) 
Seat 6: 123tiger711a ($10.32 in chips) 
csxwe: posts small blind $0.05
Varginho13: posts big blind $0.10
*** HOLE CARDS ***
Dealt to PlayTheBlues4U [Ah 4c]
PlayTheBlues4U: folds 
Klytu: folds 
123tiger711a: folds 
SeaofLove: raises $0.20 to $0.30
csxwe: folds 
Varginho13: folds 
Uncalled bet ($0.20) returned to SeaofLove
SeaofLove collected $0.25 from pot
SeaofLove: doesn't show hand 
*** SUMMARY ***
Total pot $0.25 | Rake $0 
Seat 1: SeaofLove (button) collected ($0.25)
Seat 2: csxwe (small blind) folded before Flop
Seat 3: Varginho13 (big blind) folded before Flop
Seat 4: PlayTheBlues4U folded before Flop (didn't bet)
Seat 5: Klytu folded before Flop (didn't bet)
Seat 6: 123tiger711a folded before Flop (didn't bet)



PokerStars Hand #204846336968:  Hold'em No Limit ($0.05/$0.10 USD) - 2019/10/21 21:01:23 ET
Table 'Hesperia' 6-max Seat #2 is the button
Seat 1: SeaofLove ($12.51 in chips) 
Seat 2: csxwe ($10.66 in chips) 
Seat 3: Varginho13 ($15.21 in chips) 
Seat 4: PlayTheBlues4U ($9.07 in chips) 
Seat 5: Klytu ($10.59 in chips) 
Seat 6: 123tiger711a ($10.32 in chips) 
Varginho13: posts small blind $0.05
PlayTheBlues4U: posts big blind $0.10
*** HOLE CARDS ***
Dealt to PlayTheBlues4U [6h 4c]
Klytu: folds 
123tiger711a: folds 
SeaofLove: raises $0.15 to $0.25
csxwe: folds 
Varginho13: folds 
PlayTheBlues4U: folds 
Uncalled bet ($0.15) returned to SeaofLove
SeaofLove collected $0.25 from pot
SeaofLove: doesn't show hand 
*** SUMMARY ***
Total pot $0.25 | Rake $0 
Seat 1: SeaofLove collected ($0.25)
Seat 2: csxwe (button) folded before Flop (didn't bet)
Seat 3: Varginho13 (small blind) folded before Flop
Seat 4: PlayTheBlues4U (big blind) folded before Flop
Seat 5: Klytu folded before Flop (didn't bet)
Seat 6: 123tiger711a folded before Flop (didn't bet)



PokerStars Hand #204846337047:  Hold'em No Limit ($0.05/$0.10 USD) - 2019/10/21 21:01:44 ET
Table 'Hesperia' 6-max Seat #3 is the button
Seat 1: SeaofLove ($12.66 in chips) 
Seat 2: csxwe ($10.66 in chips) 
Seat 3: Varginho13 ($15.16 in chips) 
Seat 4: PlayTheBlues4U ($8.97 in chips) 
Seat 5: Klytu ($10.59 in chips) 
Seat 6: 123tiger711a ($10.32 in chips) 
PlayTheBlues4U: posts small blind $0.05
Klytu: posts big blind $0.10
*** HOLE CARDS ***
Dealt to PlayTheBlues4U [4s 8c]
123tiger711a: folds 
SeaofLove: folds 
csxwe: folds 
Varginho13: raises $0.20 to $0.30
PlayTheBlues4U: folds 
Klytu: raises $0.70 to $1
Varginho13: folds 
Uncalled bet ($0.70) returned to Klytu
Klytu collected $0.65 from pot
Klytu: doesn't show hand 
*** SUMMARY ***
Total pot $0.65 | Rake $0 
Seat 1: SeaofLove folded before Flop (didn't bet)
Seat 2: csxwe folded before Flop (didn't bet)
Seat 3: Varginho13 (button) folded before Flop
Seat 4: PlayTheBlues4U (small blind) folded before Flop
Seat 5: Klytu (big blind) collected ($0.65)
Seat 6: 123tiger711a folded before Flop (didn't bet)



PokerStars Hand #204846337173:  Hold'em No Limit ($0.05/$0.10 USD) - 2019/10/21 21:02:10 ET
Table 'Hesperia' 6-max Seat #4 is the button
Seat 1: SeaofLove ($12.66 in chips) 
Seat 2: csxwe ($10.66 in chips) 
Seat 3: Varginho13 ($14.86 in chips) 
Seat 4: PlayTheBlues4U ($8.92 in chips) 
Seat 5: Klytu ($10.94 in chips) 
Seat 6: 123tiger711a ($10.32 in chips) 
Klytu: posts small blind $0.05
123tiger711a: posts big blind $0.10
*** HOLE CARDS ***
Dealt to PlayTheBlues4U [5d Tc]
SeaofLove: folds 
csxwe: folds 
Varginho13: folds 
PlayTheBlues4U: folds 
Klytu: raises $0.20 to $0.30
123tiger711a: folds 
Uncalled bet ($0.20) returned to Klytu
Klytu collected $0.20 from pot
Klytu: doesn't show hand 
*** SUMMARY ***
Total pot $0.20 | Rake $0 
Seat 1: SeaofLove folded before Flop (didn't bet)
Seat 2: csxwe folded before Flop (didn't bet)
Seat 3: Varginho13 folded before Flop (didn't bet)
Seat 4: PlayTheBlues4U (button) folded before Flop (didn't bet)
Seat 5: Klytu (small blind) collected ($0.20)
Seat 6: 123tiger711a (big blind) folded before Flop



PokerStars Hand #204846337242:  Hold'em No Limit ($0.05/$0.10 USD) - 2019/10/21 21:02:25 ET
Table 'Hesperia' 6-max Seat #5 is the button
Seat 1: SeaofLove ($12.66 in chips) 
Seat 2: csxwe ($10.66 in chips) 
Seat 3: Varginho13 ($14.86 in chips) 
Seat 4: PlayTheBlues4U ($10 in chips) 
Seat 5: Klytu ($11.04 in chips) 
Seat 6: 123tiger711a ($10.22 in chips) 
123tiger711a: posts small blind $0.05
SeaofLove: posts big blind $0.10
*** HOLE CARDS ***
Dealt to PlayTheBlues4U [7h 5d]
csxwe: folds 
Varginho13: folds 
PlayTheBlues4U: folds 
Klytu: raises $0.15 to $0.25
123tiger711a: calls $0.20
SeaofLove: calls $0.15
*** FLOP *** [7d 3h 8h]
123tiger711a: bets $0.36
SeaofLove: folds 
Klytu: calls $0.36
*** TURN *** [7d 3h 8h] [9s]
123tiger711a: bets $1.40
Klytu: folds 
Uncalled bet ($1.40) returned to 123tiger711a
123tiger711a collected $1.40 from pot
*** SUMMARY ***
Total pot $1.47 | Rake $0.07 
Board [7d 3h 8h 9s]
Seat 1: SeaofLove (big blind) folded on the Flop
Seat 2: csxwe folded before Flop (didn't bet)
Seat 3: Varginho13 folded before Flop (didn't bet)
Seat 4: PlayTheBlues4U folded before Flop (didn't bet)
Seat 5: Klytu (button) folded on the Turn
Seat 6: 123tiger711a (small blind) collected ($1.40)



PokerStars Hand #204846337378:  Hold'em No Limit ($0.05/$0.10 USD) - 2019/10/21 21:02:56 ET
Table 'Hesperia' 6-max Seat #6 is the button
Seat 1: SeaofLove ($12.41 in chips) 
Seat 2: csxwe ($10.66 in chips) 
Seat 3: Varginho13 ($14.86 in chips) 
Seat 4: PlayTheBlues4U ($10 in chips) 
Seat 5: Klytu ($10.43 in chips) 
Seat 6: 123tiger711a ($11.01 in chips) 
SeaofLove: posts small blind $0.05
csxwe: posts big blind $0.10
*** HOLE CARDS ***
Dealt to PlayTheBlues4U [6c Ks]
Varginho13: folds 
PlayTheBlues4U: folds 
Klytu: folds 
123tiger711a: calls $0.10
SeaofLove: folds 
csxwe: checks 
*** FLOP *** [Ad Kh 7c]
csxwe: checks 
123tiger711a: bets $0.12
csxwe: folds 
Uncalled bet ($0.12) returned to 123tiger711a
123tiger711a collected $0.24 from pot
*** SUMMARY ***
Total pot $0.25 | Rake $0.01 
Board [Ad Kh 7c]
Seat 1: SeaofLove (small blind) folded before Flop
Seat 2: csxwe (big blind) folded on the Flop
Seat 3: Varginho13 folded before Flop (didn't bet)
Seat 4: PlayTheBlues4U folded before Flop (didn't bet)
Seat 5: Klytu folded before Flop (didn't bet)
Seat 6: 123tiger711a (button) collected ($0.24)



PokerStars Hand #204846337477:  Hold'em No Limit ($0.05/$0.10 USD) - 2019/10/21 21:03:17 ET
Table 'Hesperia' 6-max Seat #1 is the button
Seat 1: SeaofLove ($12.36 in chips) 
Seat 2: csxwe ($10.56 in chips) 
Seat 3: Varginho13 ($14.86 in chips) 
Seat 4: PlayTheBlues4U ($10 in chips) 
Seat 5: Klytu ($10.43 in chips) 
Seat 6: 123tiger711a ($11.15 in chips) 
csxwe: posts small blind $0.05
Varginho13: posts big blind $0.10
*** HOLE CARDS ***
Dealt to PlayTheBlues4U [4d 5s]
PlayTheBlues4U: folds 
Klytu: folds 
123tiger711a: folds 
SeaofLove: folds 
csxwe: raises $0.10 to $0.20
Varginho13: calls $0.10
*** FLOP *** [Kc 8c Qs]
csxwe: checks 
Varginho13: bets $0.29
csxwe: calls $0.29
*** TURN *** [Kc 8c Qs] [4s]
csxwe: checks 
Varginho13: bets $0.70
csxwe: calls $0.70
*** RIVER *** [Kc 8c Qs 4s] [2d]
csxwe: bets $2.30
Varginho13: folds 
Uncalled bet ($2.30) returned to csxwe
csxwe collected $2.26 from pot
csxwe: doesn't show hand 
*** SUMMARY ***
Total pot $2.38 | Rake $0.12 
Board [Kc 8c Qs 4s 2d]
Seat 1: SeaofLove (button) folded before Flop (didn't bet)
Seat 2: csxwe (small blind) collected ($2.26)
Seat 3: Varginho13 (big blind) folded on the River
Seat 4: PlayTheBlues4U folded before Flop (didn't bet)
Seat 5: Klytu folded before Flop (didn't bet)
Seat 6: 123tiger711a folded before Flop (didn't bet)



PokerStars Hand #204846337608:  Hold'em No Limit ($0.05/$0.10 USD) - 2019/10/21 21:03:46 ET
Table 'Hesperia' 6-max Seat #2 is the button
Seat 1: SeaofLove ($12.36 in chips) 
Seat 2: csxwe ($11.63 in chips) 
Seat 3: Varginho13 ($13.67 in chips) 
Seat 4: PlayTheBlues4U ($10 in chips) 
Seat 5: Klytu ($10.43 in chips) 
Seat 6: 123tiger711a ($11.15 in chips) 
Varginho13: posts small blind $0.05
PlayTheBlues4U: posts big blind $0.10
*** HOLE CARDS ***
Dealt to PlayTheBlues4U [3c Qd]
Klytu: raises $0.15 to $0.25
123tiger711a: calls $0.25
SeaofLove: calls $0.25
csxwe: folds 
Varginho13: calls $0.20
PlayTheBlues4U: folds 
*** FLOP *** [Qs Ah As]
Varginho13 said, "oh yeah"
Varginho13: checks 
Klytu: bets $0.45
123tiger711a: raises $0.45 to $0.90
SeaofLove: folds 
Varginho13: calls $0.90
Klytu: folds 
*** TURN *** [Qs Ah As] [9s]
Varginho13: checks 
123tiger711a: checks 
*** RIVER *** [Qs Ah As 9s] [Kh]
Varginho13: bets $2.39
123tiger711a: folds 
Uncalled bet ($2.39) returned to Varginho13
Varginho13 collected $3.18 from pot
*** SUMMARY ***
Total pot $3.35 | Rake $0.17 
Board [Qs Ah As 9s Kh]
Seat 1: SeaofLove folded on the Flop
Seat 2: csxwe (button) folded before Flop (didn't bet)
Seat 3: Varginho13 (small blind) collected ($3.18)
Seat 4: PlayTheBlues4U (big blind) folded before Flop
Seat 5: Klytu folded on the Flop
Seat 6: 123tiger711a folded on the River



PokerStars Hand #204846337877:  Hold'em No Limit ($0.05/$0.10 USD) - 2019/10/21 21:04:43 ET
Table 'Hesperia' 6-max Seat #3 is the button
Seat 1: SeaofLove ($12.11 in chips) 
Seat 2: csxwe ($11.63 in chips) 
Seat 3: Varginho13 ($15.70 in chips) 
Seat 4: PlayTheBlues4U ($9.90 in chips) 
Seat 5: Klytu ($10 in chips) 
Seat 6: 123tiger711a ($10 in chips) 
PlayTheBlues4U: posts small blind $0.05
Klytu: posts big blind $0.10
*** HOLE CARDS ***
Dealt to PlayTheBlues4U [5d Ac]
123tiger711a: calls $0.10
SeaofLove: folds 
csxwe: calls $0.10
Varginho13: folds 
PlayTheBlues4U: calls $0.05
Klytu: checks 
*** FLOP *** [4s Th 3c]
PlayTheBlues4U: bets $0.20
Klytu: folds 
123tiger711a: folds 
csxwe: calls $0.20
*** TURN *** [4s Th 3c] [Td]
PlayTheBlues4U: checks 
csxwe: checks 
*** RIVER *** [4s Th 3c Td] [Qd]
PlayTheBlues4U: checks 
csxwe: checks 
*** SHOW DOWN ***
PlayTheBlues4U: shows [5d Ac] (a pair of Tens)
csxwe: shows [6s 6c] (two pair, Tens and Sixes)
csxwe collected $0.76 from pot
*** SUMMARY ***
Total pot $0.80 | Rake $0.04 
Board [4s Th 3c Td Qd]
Seat 1: SeaofLove folded before Flop (didn't bet)
Seat 2: csxwe showed [6s 6c] and won ($0.76) with two pair, Tens and Sixes
Seat 3: Varginho13 (button) folded before Flop (didn't bet)
Seat 4: PlayTheBlues4U (small blind) showed [5d Ac] and lost with a pair of Tens
Seat 5: Klytu (big blind) folded on the Flop
Seat 6: 123tiger711a folded on the Flop



PokerStars Hand #204846338099:  Hold'em No Limit ($0.05/$0.10 USD) - 2019/10/21 21:05:30 ET
Table 'Hesperia' 6-max Seat #4 is the button
Seat 1: SeaofLove ($12.11 in chips) 
Seat 2: csxwe ($12.09 in chips) 
Seat 3: Varginho13 ($15.70 in chips) 
Seat 4: PlayTheBlues4U ($9.60 in chips) 
Seat 5: Klytu ($9.90 in chips) 
Seat 6: 123tiger711a ($10 in chips) 
Klytu: posts small blind $0.05
123tiger711a: posts big blind $0.10
*** HOLE CARDS ***
Dealt to PlayTheBlues4U [4d Jh]
SeaofLove: folds 
csxwe: folds 
Varginho13: folds 
PlayTheBlues4U: folds 
Klytu: raises $0.20 to $0.30
123tiger711a: folds 
Uncalled bet ($0.20) returned to Klytu
Klytu collected $0.20 from pot
Klytu: doesn't show hand 
*** SUMMARY ***
Total pot $0.20 | Rake $0 
Seat 1: SeaofLove folded before Flop (didn't bet)
Seat 2: csxwe folded before Flop (didn't bet)
Seat 3: Varginho13 folded before Flop (didn't bet)
Seat 4: PlayTheBlues4U (button) folded before Flop (didn't bet)
Seat 5: Klytu (small blind) collected ($0.20)
Seat 6: 123tiger711a (big blind) folded before Flop



PokerStars Hand #204846338161:  Hold'em No Limit ($0.05/$0.10 USD) - 2019/10/21 21:05:41 ET
Table 'Hesperia' 6-max Seat #5 is the button
Seat 1: SeaofLove ($12.11 in chips) 
Seat 2: csxwe ($12.09 in chips) 
Seat 3: Varginho13 ($15.70 in chips) 
Seat 4: PlayTheBlues4U ($9.60 in chips) 
Seat 5: Klytu ($10 in chips) 
Seat 6: 123tiger711a ($10 in chips) 
123tiger711a: posts small blind $0.05
SeaofLove: posts big blind $0.10
*** HOLE CARDS ***
Dealt to PlayTheBlues4U [4d Jc]
csxwe: folds 
Varginho13: folds 
PlayTheBlues4U: folds 
Klytu: folds 
123tiger711a: calls $0.05
SeaofLove: checks 
*** FLOP *** [Ac 3d 6d]
123tiger711a: checks 
SeaofLove: checks 
*** TURN *** [Ac 3d 6d] [8h]
123tiger711a: checks 
SeaofLove: checks 
*** RIVER *** [Ac 3d 6d 8h] [5d]
123tiger711a: checks 
SeaofLove: checks 
*** SHOW DOWN ***
123tiger711a: shows [4h 2c] (a straight, Deuce to Six)
SeaofLove: mucks hand 
123tiger711a collected $0.19 from pot
*** SUMMARY ***
Total pot $0.20 | Rake $0.01 
Board [Ac 3d 6d 8h 5d]
Seat 1: SeaofLove (big blind) mucked [9d 5c]
Seat 2: csxwe folded before Flop (didn't bet)
Seat 3: Varginho13 folded before Flop (didn't bet)
Seat 4: PlayTheBlues4U folded before Flop (didn't bet)
Seat 5: Klytu (button) folded before Flop (didn't bet)
Seat 6: 123tiger711a (small blind) showed [4h 2c] and won ($0.19) with a straight, Deuce to Six



PokerStars Hand #204846338311:  Hold'em No Limit ($0.05/$0.10 USD) - 2019/10/21 21:06:14 ET
Table 'Hesperia' 6-max Seat #6 is the button
Seat 1: SeaofLove ($12.01 in chips) 
Seat 2: csxwe ($12.09 in chips) 
Seat 3: Varginho13 ($15.70 in chips) 
Seat 4: PlayTheBlues4U ($9.60 in chips) 
Seat 5: Klytu ($10 in chips) 
Seat 6: 123tiger711a ($10.09 in chips) 
SeaofLove: posts small blind $0.05
csxwe: posts big blind $0.10
*** HOLE CARDS ***
Dealt to PlayTheBlues4U [Ts 3d]
Varginho13: folds 
PlayTheBlues4U: folds 
Klytu: folds 
123tiger711a: folds 
SeaofLove: raises $0.20 to $0.30
csxwe: folds 
Uncalled bet ($0.20) returned to SeaofLove
SeaofLove collected $0.20 from pot
SeaofLove: doesn't show hand 
*** SUMMARY ***
Total pot $0.20 | Rake $0 
Seat 1: SeaofLove (small blind) collected ($0.20)
Seat 2: csxwe (big blind) folded before Flop
Seat 3: Varginho13 folded before Flop (didn't bet)
Seat 4: PlayTheBlues4U folded before Flop (didn't bet)
Seat 5: Klytu folded before Flop (didn't bet)
Seat 6: 123tiger711a (button) folded before Flop (didn't bet)



PokerStars Hand #204846338373:  Hold'em No Limit ($0.05/$0.10 USD) - 2019/10/21 21:06:26 ET
Table 'Hesperia' 6-max Seat #1 is the button
Seat 1: SeaofLove ($12.11 in chips) 
Seat 2: csxwe ($11.99 in chips) 
Seat 3: Varginho13 ($15.70 in chips) 
Seat 4: PlayTheBlues4U ($9.60 in chips) 
Seat 5: Klytu ($10 in chips) 
Seat 6: 123tiger711a ($10.09 in chips) 
csxwe: posts small blind $0.05
Varginho13: posts big blind $0.10
*** HOLE CARDS ***
Dealt to PlayTheBlues4U [2h 7h]
PlayTheBlues4U: folds 
Klytu: folds 
123tiger711a: folds 
SeaofLove: raises $0.20 to $0.30
csxwe: folds 
Varginho13: folds 
Uncalled bet ($0.20) returned to SeaofLove
SeaofLove collected $0.25 from pot
SeaofLove: doesn't show hand 
*** SUMMARY ***
Total pot $0.25 | Rake $0 
Seat 1: SeaofLove (button) collected ($0.25)
Seat 2: csxwe (small blind) folded before Flop
Seat 3: Varginho13 (big blind) folded before Flop
Seat 4: PlayTheBlues4U folded before Flop (didn't bet)
Seat 5: Klytu folded before Flop (didn't bet)
Seat 6: 123tiger711a folded before Flop (didn't bet)



PokerStars Hand #204846338517:  Hold'em No Limit ($0.05/$0.10 USD) - 2019/10/21 21:06:53 ET
Table 'Hesperia' 6-max Seat #2 is the button
Seat 1: SeaofLove ($12.26 in chips) 
Seat 2: csxwe ($11.94 in chips) 
Seat 3: Varginho13 ($15.60 in chips) 
Seat 4: PlayTheBlues4U ($9.60 in chips) 
Seat 5: Klytu ($10 in chips) 
Seat 6: 123tiger711a ($10.09 in chips) 
Varginho13: posts small blind $0.05
PlayTheBlues4U: posts big blind $0.10
*** HOLE CARDS ***
Dealt to PlayTheBlues4U [5s 3s]
Klytu: folds 
123tiger711a: calls $0.10
SeaofLove: folds 
csxwe: folds 
Varginho13: folds 
PlayTheBlues4U: checks 
*** FLOP *** [Jh 6h 6c]
PlayTheBlues4U: checks 
123tiger711a: bets $0.10
PlayTheBlues4U: folds 
Uncalled bet ($0.10) returned to 123tiger711a
123tiger711a collected $0.24 from pot
*** SUMMARY ***
Total pot $0.25 | Rake $0.01 
Board [Jh 6h 6c]
Seat 1: SeaofLove folded before Flop (didn't bet)
Seat 2: csxwe (button) folded before Flop (didn't bet)
Seat 3: Varginho13 (small blind) folded before Flop
Seat 4: PlayTheBlues4U (big blind) folded on the Flop
Seat 5: Klytu folded before Flop (didn't bet)
Seat 6: 123tiger711a collected ($0.24)



PokerStars Hand #204846338615:  Hold'em No Limit ($0.05/$0.10 USD) - 2019/10/21 21:07:16 ET
Table 'Hesperia' 6-max Seat #3 is the button
Seat 1: SeaofLove ($12.26 in chips) 
Seat 2: csxwe ($11.94 in chips) 
Seat 3: Varginho13 ($15.55 in chips) 
Seat 4: PlayTheBlues4U ($9.50 in chips) 
Seat 5: Klytu ($10 in chips) 
Seat 6: 123tiger711a ($10.23 in chips) 
PlayTheBlues4U: posts small blind $0.05
Klytu: posts big blind $0.10
*** HOLE CARDS ***
Dealt to PlayTheBlues4U [4c Ks]
123tiger711a: folds 
SeaofLove: folds 
csxwe: folds 
Varginho13 has timed out
Varginho13: folds 
PlayTheBlues4U: folds 
Uncalled bet ($0.05) returned to Klytu
Klytu collected $0.10 from pot
Klytu: doesn't show hand 
*** SUMMARY ***
Total pot $0.10 | Rake $0 
Seat 1: SeaofLove folded before Flop (didn't bet)
Seat 2: csxwe folded before Flop (didn't bet)
Seat 3: Varginho13 (button) folded before Flop (didn't bet)
Seat 4: PlayTheBlues4U (small blind) folded before Flop
Seat 5: Klytu (big blind) collected ($0.10)
Seat 6: 123tiger711a folded before Flop (didn't bet)



PokerStars Hand #204846338734:  Hold'em No Limit ($0.05/$0.10 USD) - 2019/10/21 21:07:41 ET
Table 'Hesperia' 6-max Seat #4 is the button
Seat 1: SeaofLove ($12.26 in chips) 
Seat 2: csxwe ($11.94 in chips) 
Seat 4: PlayTheBlues4U ($9.45 in chips) 
Seat 5: Klytu ($10.05 in chips) 
Seat 6: 123tiger711a ($10.23 in chips) 
Klytu: posts small blind $0.05
123tiger711a: posts big blind $0.10
*** HOLE CARDS ***
Dealt to PlayTheBlues4U [2c 6s]
SeaofLove: folds 
csxwe: folds 
PlayTheBlues4U: folds 
Klytu: folds 
Uncalled bet ($0.05) returned to 123tiger711a
123tiger711a collected $0.10 from pot
*** SUMMARY ***
Total pot $0.10 | Rake $0 
Seat 1: SeaofLove folded before Flop (didn't bet)
Seat 2: csxwe folded before Flop (didn't bet)
Seat 4: PlayTheBlues4U (button) folded before Flop (didn't bet)
Seat 5: Klytu (small blind) folded before Flop
Seat 6: 123tiger711a (big blind) collected ($0.10)



PokerStars Hand #204846338784:  Hold'em No Limit ($0.05/$0.10 USD) - 2019/10/21 21:07:52 ET
Table 'Hesperia' 6-max Seat #5 is the button
Seat 1: SeaofLove ($12.26 in chips) 
Seat 2: csxwe ($11.94 in chips) 
Seat 3: Varginho13 ($15.55 in chips) 
Seat 4: PlayTheBlues4U ($9.45 in chips) 
Seat 5: Klytu ($10 in chips) 
Seat 6: 123tiger711a ($10.28 in chips) 
123tiger711a: posts small blind $0.05
SeaofLove: posts big blind $0.10
*** HOLE CARDS ***
Dealt to PlayTheBlues4U [Qs Kc]
csxwe: calls $0.10
Varginho13: folds 
PlayTheBlues4U: folds 
Klytu: calls $0.10
123tiger711a: calls $0.05
SeaofLove: checks 
*** FLOP *** [9s Ad 5d]
123tiger711a: checks 
SeaofLove: checks 
csxwe: bets $0.10
Klytu: folds 
123tiger711a: calls $0.10
SeaofLove: folds 
*** TURN *** [9s Ad 5d] [2h]
123tiger711a: checks 
csxwe: checks 
*** RIVER *** [9s Ad 5d 2h] [2c]
123tiger711a: checks 
csxwe: bets $0.30
123tiger711a: folds 
Uncalled bet ($0.30) returned to csxwe
csxwe collected $0.57 from pot
csxwe: doesn't show hand 
*** SUMMARY ***
Total pot $0.60 | Rake $0.03 
Board [9s Ad 5d 2h 2c]
Seat 1: SeaofLove (big blind) folded on the Flop
Seat 2: csxwe collected ($0.57)
Seat 3: Varginho13 folded before Flop (didn't bet)
Seat 4: PlayTheBlues4U folded before Flop (didn't bet)
Seat 5: Klytu (button) folded on the Flop
Seat 6: 123tiger711a (small blind) folded on the River



PokerStars Hand #204846338974:  Hold'em No Limit ($0.05/$0.10 USD) - 2019/10/21 21:08:31 ET
Table 'Hesperia' 6-max Seat #6 is the button
Seat 1: SeaofLove ($12.16 in chips) 
Seat 2: csxwe ($12.31 in chips) 
Seat 3: Varginho13 ($15.55 in chips) 
Seat 4: PlayTheBlues4U ($9.45 in chips) 
Seat 5: Klytu ($10 in chips) 
Seat 6: 123tiger711a ($10.08 in chips) 
SeaofLove: posts small blind $0.05
csxwe: posts big blind $0.10
*** HOLE CARDS ***
Dealt to PlayTheBlues4U [6h Kd]
Varginho13: folds 
PlayTheBlues4U: folds 
Klytu: raises $0.20 to $0.30
123tiger711a: folds 
SeaofLove: folds 
csxwe: folds 
Uncalled bet ($0.20) returned to Klytu
Klytu collected $0.25 from pot
Klytu: doesn't show hand 
*** SUMMARY ***
Total pot $0.25 | Rake $0 
Seat 1: SeaofLove (small blind) folded before Flop
Seat 2: csxwe (big blind) folded before Flop
Seat 3: Varginho13 folded before Flop (didn't bet)
Seat 4: PlayTheBlues4U folded before Flop (didn't bet)
Seat 5: Klytu collected ($0.25)
Seat 6: 123tiger711a (button) folded before Flop (didn't bet)



PokerStars Hand #204846339040:  Hold'em No Limit ($0.05/$0.10 USD) - 2019/10/21 21:08:46 ET
Table 'Hesperia' 6-max Seat #1 is the button
Seat 1: SeaofLove ($12.11 in chips) 
Seat 2: csxwe ($12.21 in chips) 
Seat 3: Varginho13 ($15.55 in chips) 
Seat 4: PlayTheBlues4U ($9.45 in chips) 
Seat 5: Klytu ($10.15 in chips) 
Seat 6: 123tiger711a ($10.08 in chips) 
csxwe: posts small blind $0.05
Varginho13: posts big blind $0.10
*** HOLE CARDS ***
Dealt to PlayTheBlues4U [8d 6c]
PlayTheBlues4U: folds 
Klytu: folds 
123tiger711a: folds 
SeaofLove: folds 
csxwe: folds 
Uncalled bet ($0.05) returned to Varginho13
Varginho13 collected $0.10 from pot
*** SUMMARY ***
Total pot $0.10 | Rake $0 
Seat 1: SeaofLove (button) folded before Flop (didn't bet)
Seat 2: csxwe (small blind) folded before Flop
Seat 3: Varginho13 (big blind) collected ($0.10)
Seat 4: PlayTheBlues4U folded before Flop (didn't bet)
Seat 5: Klytu folded before Flop (didn't bet)
Seat 6: 123tiger711a folded before Flop (didn't bet)



PokerStars Hand #204846339118:  Hold'em No Limit ($0.05/$0.10 USD) - 2019/10/21 21:09:02 ET
Table 'Hesperia' 6-max Seat #2 is the button
Seat 1: SeaofLove ($12.11 in chips) 
Seat 2: csxwe ($12.16 in chips) 
Seat 3: Varginho13 ($15.60 in chips) 
Seat 4: PlayTheBlues4U ($9.45 in chips) 
Seat 5: Klytu ($10.15 in chips) 
Seat 6: 123tiger711a ($10.08 in chips) 
Varginho13: posts small blind $0.05
PlayTheBlues4U: posts big blind $0.10
*** HOLE CARDS ***
Dealt to PlayTheBlues4U [Js 2d]
Klytu: raises $0.25 to $0.35
123tiger711a: calls $0.35
SeaofLove: folds 
csxwe: folds 
Varginho13: folds 
PlayTheBlues4U: folds 
*** FLOP *** [3h 9d 7h]
Klytu: bets $0.50
123tiger711a: folds 
Uncalled bet ($0.50) returned to Klytu
Klytu collected $0.81 from pot
Klytu: doesn't show hand 
*** SUMMARY ***
Total pot $0.85 | Rake $0.04 
Board [3h 9d 7h]
Seat 1: SeaofLove folded before Flop (didn't bet)
Seat 2: csxwe (button) folded before Flop (didn't bet)
Seat 3: Varginho13 (small blind) folded before Flop
Seat 4: PlayTheBlues4U (big blind) folded before Flop
Seat 5: Klytu collected ($0.81)
Seat 6: 123tiger711a folded on the Flop



PokerStars Hand #204846339221:  Hold'em No Limit ($0.05/$0.10 USD) - 2019/10/21 21:09:24 ET
Table 'Hesperia' 6-max Seat #3 is the button
Seat 1: SeaofLove ($12.11 in chips) 
Seat 2: csxwe ($12.16 in chips) 
Seat 3: Varginho13 ($15.55 in chips) 
Seat 4: PlayTheBlues4U ($9.35 in chips) 
Seat 5: Klytu ($10.61 in chips) 
Seat 6: 123tiger711a ($10 in chips) 
PlayTheBlues4U: posts small blind $0.05
Klytu: posts big blind $0.10
*** HOLE CARDS ***
Dealt to PlayTheBlues4U [3d 4d]
123tiger711a: calls $0.10
SeaofLove: folds 
csxwe: folds 
Varginho13: folds 
PlayTheBlues4U: calls $0.05
Klytu: raises $0.35 to $0.45
123tiger711a: calls $0.35
PlayTheBlues4U: calls $0.35
*** FLOP *** [2h Ah Jd]
PlayTheBlues4U: checks 
Klytu: bets $0.80
123tiger711a: calls $0.80
PlayTheBlues4U: folds 
*** TURN *** [2h Ah Jd] [7h]
Klytu: checks 
123tiger711a: bets $1.40
Klytu: calls $1.40
*** RIVER *** [2h Ah Jd 7h] [9d]
Klytu: checks 
123tiger711a: checks 
*** SHOW DOWN ***
Klytu: shows [Ac Kc] (a pair of Aces)
123tiger711a: mucks hand 
Klytu collected $5.46 from pot
*** SUMMARY ***
Total pot $5.75 | Rake $0.29 
Board [2h Ah Jd 7h 9d]
Seat 1: SeaofLove folded before Flop (didn't bet)
Seat 2: csxwe folded before Flop (didn't bet)
Seat 3: Varginho13 (button) folded before Flop (didn't bet)
Seat 4: PlayTheBlues4U (small blind) folded on the Flop
Seat 5: Klytu (big blind) showed [Ac Kc] and won ($5.46) with a pair of Aces
Seat 6: 123tiger711a mucked [Ad Th]



PokerStars Hand #204846339448:  Hold'em No Limit ($0.05/$0.10 USD) - 2019/10/21 21:10:13 ET
Table 'Hesperia' 6-max Seat #4 is the button
Seat 1: SeaofLove ($12.11 in chips) 
Seat 2: csxwe ($12.16 in chips) 
Seat 3: Varginho13 ($15.55 in chips) 
Seat 4: PlayTheBlues4U ($8.90 in chips) 
Seat 5: Klytu ($13.42 in chips) 
Seat 6: 123tiger711a ($10 in chips) 
Klytu: posts small blind $0.05
123tiger711a: posts big blind $0.10
*** HOLE CARDS ***
Dealt to PlayTheBlues4U [7c Tc]
SeaofLove: folds 
csxwe: folds 
Varginho13: raises $0.20 to $0.30
PlayTheBlues4U: calls $0.30
Klytu: folds 
123tiger711a: calls $0.20
*** FLOP *** [4d Qh Qs]
123tiger711a: checks 
Varginho13: bets $0.45
PlayTheBlues4U: calls $0.45
123tiger711a: folds 
*** TURN *** [4d Qh Qs] [3d]
Varginho13: checks 
PlayTheBlues4U: bets $1.10
Varginho13: folds 
Uncalled bet ($1.10) returned to PlayTheBlues4U
PlayTheBlues4U collected $1.76 from pot
PlayTheBlues4U: doesn't show hand 
*** SUMMARY ***
Total pot $1.85 | Rake $0.09 
Board [4d Qh Qs 3d]
Seat 1: SeaofLove folded before Flop (didn't bet)
Seat 2: csxwe folded before Flop (didn't bet)
Seat 3: Varginho13 folded on the Turn
Seat 4: PlayTheBlues4U (button) collected ($1.76)
Seat 5: Klytu (small blind) folded before Flop
Seat 6: 123tiger711a (big blind) folded on the Flop



PokerStars Hand #204846339681:  Hold'em No Limit ($0.05/$0.10 USD) - 2019/10/21 21:11:06 ET
Table 'Hesperia' 6-max Seat #5 is the button
Seat 1: SeaofLove ($12.11 in chips) 
Seat 2: csxwe ($12.16 in chips) 
Seat 3: Varginho13 ($14.80 in chips) 
Seat 4: PlayTheBlues4U ($9.91 in chips) 
Seat 5: Klytu ($13.37 in chips) 
Seat 6: 123tiger711a ($10 in chips) 
123tiger711a: posts small blind $0.05
SeaofLove: posts big blind $0.10
*** HOLE CARDS ***
Dealt to PlayTheBlues4U [3s 5d]
csxwe: calls $0.10
Varginho13: folds 
PlayTheBlues4U: folds 
Klytu: folds 
123tiger711a: calls $0.05
SeaofLove: checks 
*** FLOP *** [Jd 7c Kd]
123tiger711a: checks 
SeaofLove: bets $0.14
csxwe: calls $0.14
123tiger711a: folds 
*** TURN *** [Jd 7c Kd] [Kc]
SeaofLove: bets $0.28
csxwe: calls $0.28
*** RIVER *** [Jd 7c Kd Kc] [7d]
SeaofLove: bets $0.54
csxwe: folds 
Uncalled bet ($0.54) returned to SeaofLove
SeaofLove collected $1.08 from pot
SeaofLove: doesn't show hand 
*** SUMMARY ***
Total pot $1.14 | Rake $0.06 
Board [Jd 7c Kd Kc 7d]
Seat 1: SeaofLove (big blind) collected ($1.08)
Seat 2: csxwe folded on the River
Seat 3: Varginho13 folded before Flop (didn't bet)
Seat 4: PlayTheBlues4U folded before Flop (didn't bet)
Seat 5: Klytu (button) folded before Flop (didn't bet)
Seat 6: 123tiger711a (small blind) folded on the Flop



PokerStars Hand #204846339791:  Hold'em No Limit ($0.05/$0.10 USD) - 2019/10/21 21:11:30 ET
Table 'Hesperia' 6-max Seat #6 is the button
Seat 1: SeaofLove ($12.67 in chips) 
Seat 2: csxwe ($11.64 in chips) 
Seat 3: Varginho13 ($14.80 in chips) 
Seat 4: PlayTheBlues4U ($9.91 in chips) 
Seat 5: Klytu ($13.37 in chips) 
Seat 6: 123tiger711a ($10 in chips) 
SeaofLove: posts small blind $0.05
csxwe: posts big blind $0.10
*** HOLE CARDS ***
Dealt to PlayTheBlues4U [8s Jd]
Varginho13: folds 
PlayTheBlues4U: folds 
Klytu: raises $0.15 to $0.25
123tiger711a: folds 
SeaofLove: calls $0.20
csxwe: folds 
*** FLOP *** [6d Kh Kc]
SeaofLove: checks 
Klytu: checks 
*** TURN *** [6d Kh Kc] [Qh]
SeaofLove: checks 
Klytu: bets $0.30
SeaofLove: folds 
Uncalled bet ($0.30) returned to Klytu
Klytu collected $0.57 from pot
Klytu: doesn't show hand 
*** SUMMARY ***
Total pot $0.60 | Rake $0.03 
Board [6d Kh Kc Qh]
Seat 1: SeaofLove (small blind) folded on the Turn
Seat 2: csxwe (big blind) folded before Flop
Seat 3: Varginho13 folded before Flop (didn't bet)
Seat 4: PlayTheBlues4U folded before Flop (didn't bet)
Seat 5: Klytu collected ($0.57)
Seat 6: 123tiger711a (button) folded before Flop (didn't bet)



PokerStars Hand #204846339870:  Hold'em No Limit ($0.05/$0.10 USD) - 2019/10/21 21:11:49 ET
Table 'Hesperia' 6-max Seat #1 is the button
Seat 1: SeaofLove ($12.42 in chips) 
Seat 2: csxwe ($11.54 in chips) 
Seat 3: Varginho13 ($14.80 in chips) 
Seat 4: PlayTheBlues4U ($9.91 in chips) 
Seat 5: Klytu ($13.69 in chips) 
Seat 6: 123tiger711a ($10 in chips) 
csxwe: posts small blind $0.05
Varginho13: posts big blind $0.10
*** HOLE CARDS ***
Dealt to PlayTheBlues4U [Kd 2c]
PlayTheBlues4U: folds 
Klytu: folds 
123tiger711a: calls $0.10
SeaofLove: folds 
csxwe: calls $0.05
Varginho13: checks 
*** FLOP *** [4h Js 9d]
csxwe: checks 
Varginho13: checks 
123tiger711a: checks 
*** TURN *** [4h Js 9d] [Th]
csxwe: bets $0.10
Varginho13: calls $0.10
123tiger711a: folds 
*** RIVER *** [4h Js 9d Th] [5s]
csxwe: bets $0.50
Varginho13: folds 
Uncalled bet ($0.50) returned to csxwe
csxwe collected $0.48 from pot
csxwe: doesn't show hand 
*** SUMMARY ***
Total pot $0.50 | Rake $0.02 
Board [4h Js 9d Th 5s]
Seat 1: SeaofLove (button) folded before Flop (didn't bet)
Seat 2: csxwe (small blind) collected ($0.48)
Seat 3: Varginho13 (big blind) folded on the River
Seat 4: PlayTheBlues4U folded before Flop (didn't bet)
Seat 5: Klytu folded before Flop (didn't bet)
Seat 6: 123tiger711a folded on the Turn



PokerStars Hand #204848294042:  Hold'em No Limit ($0.05/$0.10 USD) - 2019/10/21 21:12:26 ET
Table 'Hesperia' 6-max Seat #2 is the button
Seat 1: SeaofLove ($12.42 in chips) 
Seat 2: csxwe ($11.82 in chips) 
Seat 3: Varginho13 ($14.60 in chips) 
Seat 4: PlayTheBlues4U ($9.91 in chips) 
Seat 5: Klytu ($13.69 in chips) 
Seat 6: 123tiger711a ($10 in chips) 
Varginho13: posts small blind $0.05
PlayTheBlues4U: posts big blind $0.10
*** HOLE CARDS ***
Dealt to PlayTheBlues4U [2c 3s]
Klytu: folds 
123tiger711a: folds 
SeaofLove: folds 
csxwe: calls $0.10
Varginho13: raises $0.30 to $0.40
PlayTheBlues4U: folds 
csxwe: calls $0.30
*** FLOP *** [4d 7h Kc]
Varginho13: bets $0.43
csxwe: folds 
Uncalled bet ($0.43) returned to Varginho13
Varginho13 collected $0.86 from pot
*** SUMMARY ***
Total pot $0.90 | Rake $0.04 
Board [4d 7h Kc]
Seat 1: SeaofLove folded before Flop (didn't bet)
Seat 2: csxwe (button) folded on the Flop
Seat 3: Varginho13 (small blind) collected ($0.86)
Seat 4: PlayTheBlues4U (big blind) folded before Flop
Seat 5: Klytu folded before Flop (didn't bet)
Seat 6: 123tiger711a folded before Flop (didn't bet)



PokerStars Hand #204848294179:  Hold'em No Limit ($0.05/$0.10 USD) - 2019/10/21 21:12:59 ET
Table 'Hesperia' 6-max Seat #3 is the button
Seat 1: SeaofLove ($12.42 in chips) 
Seat 2: csxwe ($11.42 in chips) 
Seat 3: Varginho13 ($15.06 in chips) 
Seat 4: PlayTheBlues4U ($9.81 in chips) 
Seat 5: Klytu ($13.69 in chips) 
Seat 6: 123tiger711a ($10 in chips) 
PlayTheBlues4U: posts small blind $0.05
Klytu: posts big blind $0.10
*** HOLE CARDS ***
Dealt to PlayTheBlues4U [9s Ts]
123tiger711a: folds 
SeaofLove: folds 
csxwe: folds 
Varginho13: folds 
PlayTheBlues4U: raises $0.20 to $0.30
Klytu: folds 
Uncalled bet ($0.20) returned to PlayTheBlues4U
PlayTheBlues4U collected $0.20 from pot
PlayTheBlues4U: doesn't show hand 
*** SUMMARY ***
Total pot $0.20 | Rake $0 
Seat 1: SeaofLove folded before Flop (didn't bet)
Seat 2: csxwe folded before Flop (didn't bet)
Seat 3: Varginho13 (button) folded before Flop (didn't bet)
Seat 4: PlayTheBlues4U (small blind) collected ($0.20)
Seat 5: Klytu (big blind) folded before Flop
Seat 6: 123tiger711a folded before Flop (didn't bet)



PokerStars Hand #204848294235:  Hold'em No Limit ($0.05/$0.10 USD) - 2019/10/21 21:13:13 ET
Table 'Hesperia' 6-max Seat #4 is the button
Seat 1: SeaofLove ($12.42 in chips) 
Seat 2: csxwe ($11.42 in chips) 
Seat 3: Varginho13 ($15.06 in chips) 
Seat 4: PlayTheBlues4U ($9.91 in chips) 
Seat 5: Klytu ($13.59 in chips) 
Seat 6: 123tiger711a ($10 in chips) 
Klytu: posts small blind $0.05
123tiger711a: posts big blind $0.10
*** HOLE CARDS ***
Dealt to PlayTheBlues4U [8c 8h]
SeaofLove: raises $0.15 to $0.25
csxwe: folds 
Varginho13: folds 
PlayTheBlues4U: calls $0.25
Klytu: folds 
123tiger711a: folds 
*** FLOP *** [Js 9h Jh]
SeaofLove: checks 
PlayTheBlues4U: bets $0.40
SeaofLove: calls $0.40
*** TURN *** [Js 9h Jh] [4s]
SeaofLove: checks 
PlayTheBlues4U: checks 
*** RIVER *** [Js 9h Jh 4s] [Kd]
SeaofLove: checks 
PlayTheBlues4U: checks 
*** SHOW DOWN ***
SeaofLove: shows [2c 2h] (two pair, Jacks and Deuces)
PlayTheBlues4U: shows [8c 8h] (two pair, Jacks and Eights)
PlayTheBlues4U collected $1.38 from pot
*** SUMMARY ***
Total pot $1.45 | Rake $0.07 
Board [Js 9h Jh 4s Kd]
Seat 1: SeaofLove showed [2c 2h] and lost with two pair, Jacks and Deuces
Seat 2: csxwe folded before Flop (didn't bet)
Seat 3: Varginho13 folded before Flop (didn't bet)
Seat 4: PlayTheBlues4U (button) showed [8c 8h] and won ($1.38) with two pair, Jacks and Eights
Seat 5: Klytu (small blind) folded before Flop
Seat 6: 123tiger711a (big blind) folded before Flop



PokerStars Hand #204848294385:  Hold'em No Limit ($0.05/$0.10 USD) - 2019/10/21 21:13:45 ET
Table 'Hesperia' 6-max Seat #5 is the button
Seat 1: SeaofLove ($11.77 in chips) 
Seat 2: csxwe ($11.42 in chips) 
Seat 3: Varginho13 ($15.06 in chips) 
Seat 4: PlayTheBlues4U ($10.64 in chips) 
Seat 5: Klytu ($13.54 in chips) 
Seat 6: 123tiger711a ($10 in chips) 
123tiger711a: posts small blind $0.05
SeaofLove: posts big blind $0.10
*** HOLE CARDS ***
Dealt to PlayTheBlues4U [Kc Jc]
csxwe: folds 
Varginho13: folds 
PlayTheBlues4U: raises $0.20 to $0.30
Klytu: calls $0.30
123tiger711a: folds 
SeaofLove: folds 
*** FLOP *** [5s 6c 7s]
PlayTheBlues4U: checks 
Klytu: checks 
*** TURN *** [5s 6c 7s] [Qd]
PlayTheBlues4U: bets $0.40
Klytu: calls $0.40
*** RIVER *** [5s 6c 7s Qd] [8c]
PlayTheBlues4U: checks 
Klytu: checks 
*** SHOW DOWN ***
PlayTheBlues4U: shows [Kc Jc] (high card King)
Klytu: shows [Js Qh] (a pair of Queens)
Klytu collected $1.47 from pot
*** SUMMARY ***
Total pot $1.55 | Rake $0.08 
Board [5s 6c 7s Qd 8c]
Seat 1: SeaofLove (big blind) folded before Flop
Seat 2: csxwe folded before Flop (didn't bet)
Seat 3: Varginho13 folded before Flop (didn't bet)
Seat 4: PlayTheBlues4U showed [Kc Jc] and lost with high card King
Seat 5: Klytu (button) showed [Js Qh] and won ($1.47) with a pair of Queens
Seat 6: 123tiger711a (small blind) folded before Flop



PokerStars Hand #204848294559:  Hold'em No Limit ($0.05/$0.10 USD) - 2019/10/21 21:14:24 ET
Table 'Hesperia' 6-max Seat #6 is the button
Seat 1: SeaofLove ($11.67 in chips) 
Seat 2: csxwe ($11.42 in chips) 
Seat 3: Varginho13 ($15.06 in chips) 
Seat 4: PlayTheBlues4U ($9.94 in chips) 
Seat 5: Klytu ($14.31 in chips) 
Seat 6: 123tiger711a ($10 in chips) 
SeaofLove: posts small blind $0.05
csxwe: posts big blind $0.10
*** HOLE CARDS ***
Dealt to PlayTheBlues4U [3s Ah]
Varginho13: folds 
PlayTheBlues4U: folds 
Klytu: raises $0.20 to $0.30
123tiger711a: folds 
SeaofLove: folds 
csxwe: calls $0.20
*** FLOP *** [2c 8d 2d]
csxwe: checks 
Klytu: checks 
*** TURN *** [2c 8d 2d] [Qh]
csxwe: checks 
Klytu: checks 
*** RIVER *** [2c 8d 2d Qh] [Qc]
csxwe: bets $0.30
Klytu: calls $0.30
*** SHOW DOWN ***
csxwe: shows [7h 5h] (two pair, Queens and Deuces)
Klytu: shows [Th Ad] (two pair, Queens and Deuces - Ace kicker)
Klytu collected $1.19 from pot
*** SUMMARY ***
Total pot $1.25 | Rake $0.06 
Board [2c 8d 2d Qh Qc]
Seat 1: SeaofLove (small blind) folded before Flop
Seat 2: csxwe (big blind) showed [7h 5h] and lost with two pair, Queens and Deuces
Seat 3: Varginho13 folded before Flop (didn't bet)
Seat 4: PlayTheBlues4U folded before Flop (didn't bet)
Seat 5: Klytu showed [Th Ad] and won ($1.19) with two pair, Queens and Deuces
Seat 6: 123tiger711a (button) folded before Flop (didn't bet)



PokerStars Hand #204848294675:  Hold'em No Limit ($0.05/$0.10 USD) - 2019/10/21 21:14:48 ET
Table 'Hesperia' 6-max Seat #1 is the button
Seat 1: SeaofLove ($11.62 in chips) 
Seat 2: csxwe ($10.82 in chips) 
Seat 3: Varginho13 ($15.06 in chips) 
Seat 4: PlayTheBlues4U ($9.94 in chips) 
Seat 5: Klytu ($14.90 in chips) 
Seat 6: 123tiger711a ($10 in chips) 
csxwe: posts small blind $0.05
Varginho13: posts big blind $0.10
*** HOLE CARDS ***
Dealt to PlayTheBlues4U [3h 7h]
PlayTheBlues4U: folds 
Klytu: raises $0.20 to $0.30
123tiger711a: folds 
SeaofLove: folds 
csxwe: calls $0.25
Varginho13: folds 
*** FLOP *** [2h 5s 2c]
csxwe: checks 
Klytu: checks 
*** TURN *** [2h 5s 2c] [4c]
csxwe: checks 
Klytu: bets $0.35
csxwe: folds 
Uncalled bet ($0.35) returned to Klytu
Klytu collected $0.66 from pot
Klytu: doesn't show hand 
*** SUMMARY ***
Total pot $0.70 | Rake $0.04 
Board [2h 5s 2c 4c]
Seat 1: SeaofLove (button) folded before Flop (didn't bet)
Seat 2: csxwe (small blind) folded on the Turn
Seat 3: Varginho13 (big blind) folded before Flop
Seat 4: PlayTheBlues4U folded before Flop (didn't bet)
Seat 5: Klytu collected ($0.66)
Seat 6: 123tiger711a folded before Flop (didn't bet)



PokerStars Hand #204848294753:  Hold'em No Limit ($0.05/$0.10 USD) - 2019/10/21 21:15:08 ET
Table 'Hesperia' 6-max Seat #2 is the button
Seat 1: SeaofLove ($11.62 in chips) 
Seat 2: csxwe ($10.52 in chips) 
Seat 3: Varginho13 ($14.96 in chips) 
Seat 4: PlayTheBlues4U ($9.94 in chips) 
Seat 5: Klytu ($15.26 in chips) 
Seat 6: 123tiger711a ($10 in chips) 
Varginho13: posts small blind $0.05
PlayTheBlues4U: posts big blind $0.10
*** HOLE CARDS ***
Dealt to PlayTheBlues4U [4h 2h]
Klytu: folds 
123tiger711a: calls $0.10
SeaofLove: folds 
csxwe: calls $0.10
Varginho13: calls $0.05
PlayTheBlues4U: checks 
*** FLOP *** [Ad Kd Qh]
Varginho13: checks 
PlayTheBlues4U: checks 
123tiger711a: bets $0.38
csxwe: folds 
Varginho13: folds 
PlayTheBlues4U: folds 
Uncalled bet ($0.38) returned to 123tiger711a
123tiger711a collected $0.38 from pot
*** SUMMARY ***
Total pot $0.40 | Rake $0.02 
Board [Ad Kd Qh]
Seat 1: SeaofLove folded before Flop (didn't bet)
Seat 2: csxwe (button) folded on the Flop
Seat 3: Varginho13 (small blind) folded on the Flop
Seat 4: PlayTheBlues4U (big blind) folded on the Flop
Seat 5: Klytu folded before Flop (didn't bet)
Seat 6: 123tiger711a collected ($0.38)



PokerStars Hand #204848294921:  Hold'em No Limit ($0.05/$0.10 USD) - 2019/10/21 21:15:45 ET
Table 'Hesperia' 6-max Seat #3 is the button
Seat 1: SeaofLove ($11.62 in chips) 
Seat 2: csxwe ($10.42 in chips) 
Seat 3: Varginho13 ($14.86 in chips) 
Seat 4: PlayTheBlues4U ($9.84 in chips) 
Seat 5: Klytu ($15.26 in chips) 
Seat 6: 123tiger711a ($10.28 in chips) 
PlayTheBlues4U: posts small blind $0.05
Klytu: posts big blind $0.10
*** HOLE CARDS ***
Dealt to PlayTheBlues4U [4s 3c]
123tiger711a: folds 
SeaofLove: raises $0.15 to $0.25
csxwe: calls $0.25
Varginho13: folds 
PlayTheBlues4U: folds 
Klytu: folds 
*** FLOP *** [3h 4d 7h]
SeaofLove: bets $0.41
csxwe: calls $0.41
*** TURN *** [3h 4d 7h] [2c]
SeaofLove: bets $0.93
csxwe: calls $0.93
*** RIVER *** [3h 4d 7h 2c] [6h]
SeaofLove: bets $10.03 and is all-in
csxwe: folds 
Uncalled bet ($10.03) returned to SeaofLove
SeaofLove collected $3.16 from pot
SeaofLove: doesn't show hand 
*** SUMMARY ***
Total pot $3.33 | Rake $0.17 
Board [3h 4d 7h 2c 6h]
Seat 1: SeaofLove collected ($3.16)
Seat 2: csxwe folded on the River
Seat 3: Varginho13 (button) folded before Flop (didn't bet)
Seat 4: PlayTheBlues4U (small blind) folded before Flop
Seat 5: Klytu (big blind) folded before Flop
Seat 6: 123tiger711a folded before Flop (didn't bet)



PokerStars Hand #204848295174:  Hold'em No Limit ($0.05/$0.10 USD) - 2019/10/21 21:16:47 ET
Table 'Hesperia' 6-max Seat #4 is the button
Seat 1: SeaofLove ($13.19 in chips) 
Seat 2: csxwe ($8.83 in chips) 
Seat 3: Varginho13 ($14.86 in chips) 
Seat 4: PlayTheBlues4U ($9.79 in chips) 
Seat 5: Klytu ($15.16 in chips) 
Seat 6: 123tiger711a ($10.28 in chips) 
Klytu: posts small blind $0.05
123tiger711a: posts big blind $0.10
*** HOLE CARDS ***
Dealt to PlayTheBlues4U [8h 9s]
SeaofLove: folds 
csxwe: raises $0.20 to $0.30
Varginho13: calls $0.30
PlayTheBlues4U: folds 
Klytu: calls $0.25
123tiger711a: calls $0.20
*** FLOP *** [Ks 9c 4s]
Klytu: checks 
123tiger711a: checks 
csxwe: bets $1.10
Varginho13: folds 
Klytu: calls $1.10
123tiger711a: folds 
*** TURN *** [Ks 9c 4s] [5c]
Klytu: checks 
csxwe: checks 
*** RIVER *** [Ks 9c 4s 5c] [6h]
Klytu: bets $1.65
csxwe: calls $1.65
*** SHOW DOWN ***
Klytu: shows [Ac Kd] (a pair of Kings)
csxwe: mucks hand 
Klytu collected $6.36 from pot
*** SUMMARY ***
Total pot $6.70 | Rake $0.34 
Board [Ks 9c 4s 5c 6h]
Seat 1: SeaofLove folded before Flop (didn't bet)
Seat 2: csxwe mucked [Kh Td]
Seat 3: Varginho13 folded on the Flop
Seat 4: PlayTheBlues4U (button) folded before Flop (didn't bet)
Seat 5: Klytu (small blind) showed [Ac Kd] and won ($6.36) with a pair of Kings
Seat 6: 123tiger711a (big blind) folded on the Flop



PokerStars Hand #204848295327:  Hold'em No Limit ($0.05/$0.10 USD) - 2019/10/21 21:17:21 ET
Table 'Hesperia' 6-max Seat #5 is the button
Seat 1: SeaofLove ($13.19 in chips) 
Seat 2: csxwe ($5.78 in chips) 
Seat 3: Varginho13 ($14.56 in chips) 
Seat 4: PlayTheBlues4U ($9.79 in chips) 
Seat 5: Klytu ($18.47 in chips) 
Seat 6: 123tiger711a ($10 in chips) 
123tiger711a: posts small blind $0.05
SeaofLove: posts big blind $0.10
*** HOLE CARDS ***
Dealt to PlayTheBlues4U [9c Jh]
csxwe: folds 
csxwe leaves the table
Varginho13: folds 
PlayTheBlues4U: folds 
Klytu: folds 
123tiger711a: calls $0.05
SeaofLove: checks 
*** FLOP *** [Jc Qc Qs]
123tiger711a: checks 
SeaofLove: checks 
*** TURN *** [Jc Qc Qs] [8h]
123tiger711a: checks 
SeaofLove: checks 
*** RIVER *** [Jc Qc Qs 8h] [Ac]
123tiger711a: checks 
SeaofLove: checks 
*** SHOW DOWN ***
123tiger711a: shows [As 3s] (two pair, Aces and Queens)
SeaofLove: mucks hand 
123tiger711a collected $0.19 from pot
*** SUMMARY ***
Total pot $0.20 | Rake $0.01 
Board [Jc Qc Qs 8h Ac]
Seat 1: SeaofLove (big blind) mucked [7h 6d]
Seat 2: csxwe folded before Flop (didn't bet)
Seat 3: Varginho13 folded before Flop (didn't bet)
Seat 4: PlayTheBlues4U folded before Flop (didn't bet)
Seat 5: Klytu (button) folded before Flop (didn't bet)
Seat 6: 123tiger711a (small blind) showed [As 3s] and won ($0.19) with two pair, Aces and Queens



PokerStars Hand #204848295447:  Hold'em No Limit ($0.05/$0.10 USD) - 2019/10/21 21:17:48 ET
Table 'Hesperia' 6-max Seat #6 is the button
Seat 1: SeaofLove ($13.09 in chips) 
Seat 3: Varginho13 ($14.56 in chips) 
Seat 4: PlayTheBlues4U ($9.79 in chips) 
Seat 5: Klytu ($18.47 in chips) 
Seat 6: 123tiger711a ($10.09 in chips) 
SeaofLove: posts small blind $0.05
Varginho13: posts big blind $0.10
*** HOLE CARDS ***
Dealt to PlayTheBlues4U [8h 5h]
PlayTheBlues4U: folds 
Klytu: folds 
123tiger711a: folds 
SeaofLove: folds 
Uncalled bet ($0.05) returned to Varginho13
Varginho13 collected $0.10 from pot
*** SUMMARY ***
Total pot $0.10 | Rake $0 
Seat 1: SeaofLove (small blind) folded before Flop
Seat 3: Varginho13 (big blind) collected ($0.10)
Seat 4: PlayTheBlues4U folded before Flop (didn't bet)
Seat 5: Klytu folded before Flop (didn't bet)
Seat 6: 123tiger711a (button) folded before Flop (didn't bet)



PokerStars Hand #204848295475:  Hold'em No Limit ($0.05/$0.10 USD) - 2019/10/21 21:17:55 ET
Table 'Hesperia' 6-max Seat #1 is the button
Seat 1: SeaofLove ($13.04 in chips) 
Seat 3: Varginho13 ($14.61 in chips) 
Seat 4: PlayTheBlues4U ($9.79 in chips) 
Seat 5: Klytu ($18.47 in chips) 
Seat 6: 123tiger711a ($10.09 in chips) 
Varginho13: posts small blind $0.05
PlayTheBlues4U: posts big blind $0.10
*** HOLE CARDS ***
Dealt to PlayTheBlues4U [Jd Th]
Klytu: raises $0.20 to $0.30
123tiger711a: folds 
SeaofLove: folds 
Varginho13: folds 
LanskyBanksy joins the table at seat #2 
PlayTheBlues4U: folds 
Uncalled bet ($0.20) returned to Klytu
Klytu collected $0.25 from pot
Klytu: doesn't show hand 
*** SUMMARY ***
Total pot $0.25 | Rake $0 
Seat 1: SeaofLove (button) folded before Flop (didn't bet)
Seat 3: Varginho13 (small blind) folded before Flop
Seat 4: PlayTheBlues4U (big blind) folded before Flop
Seat 5: Klytu collected ($0.25)
Seat 6: 123tiger711a folded before Flop (didn't bet)



PokerStars Hand #204848295543:  Hold'em No Limit ($0.05/$0.10 USD) - 2019/10/21 21:18:11 ET
Table 'Hesperia' 6-max Seat #3 is the button
Seat 1: SeaofLove ($13.04 in chips) 
Seat 2: LanskyBanksy ($10 in chips) 
Seat 3: Varginho13 ($14.56 in chips) 
Seat 4: PlayTheBlues4U ($9.69 in chips) 
Seat 5: Klytu ($18.62 in chips) 
Seat 6: 123tiger711a ($10.09 in chips) 
PlayTheBlues4U: posts small blind $0.05
Klytu: posts big blind $0.10
LanskyBanksy: posts big blind $0.10
*** HOLE CARDS ***
Dealt to PlayTheBlues4U [Kc 8c]
123tiger711a: folds 
SeaofLove: folds 
LanskyBanksy: checks 
Varginho13: folds 
PlayTheBlues4U: calls $0.05
Klytu: checks 
*** FLOP *** [5h 9h 3s]
PlayTheBlues4U: checks 
Klytu: checks 
LanskyBanksy: checks 
*** TURN *** [5h 9h 3s] [Kh]
PlayTheBlues4U: bets $0.20
Klytu: folds 
LanskyBanksy: folds 
Uncalled bet ($0.20) returned to PlayTheBlues4U
PlayTheBlues4U collected $0.28 from pot
PlayTheBlues4U: doesn't show hand 
*** SUMMARY ***
Total pot $0.30 | Rake $0.02 
Board [5h 9h 3s Kh]
Seat 1: SeaofLove folded before Flop (didn't bet)
Seat 2: LanskyBanksy folded on the Turn (didn't bet)
Seat 3: Varginho13 (button) folded before Flop (didn't bet)
Seat 4: PlayTheBlues4U (small blind) collected ($0.28)
Seat 5: Klytu (big blind) folded on the Turn
Seat 6: 123tiger711a folded before Flop (didn't bet)



PokerStars Hand #204848295681:  Hold'em No Limit ($0.05/$0.10 USD) - 2019/10/21 21:18:47 ET
Table 'Hesperia' 6-max Seat #4 is the button
Seat 1: SeaofLove ($13.04 in chips) 
Seat 2: LanskyBanksy ($9.90 in chips) 
Seat 3: Varginho13 ($14.56 in chips) 
Seat 4: PlayTheBlues4U ($9.87 in chips) 
Seat 5: Klytu ($18.52 in chips) 
Seat 6: 123tiger711a ($10.09 in chips) 
Klytu: posts small blind $0.05
123tiger711a: posts big blind $0.10
*** HOLE CARDS ***
Dealt to PlayTheBlues4U [Ts Qs]
SeaofLove: folds 
LanskyBanksy: folds 
Varginho13: raises $0.20 to $0.30
PlayTheBlues4U: calls $0.30
Klytu: folds 
123tiger711a: calls $0.20
*** FLOP *** [3c 8h Ah]
123tiger711a: checks 
Varginho13: checks 
PlayTheBlues4U: bets $0.50
123tiger711a: folds 
Varginho13: folds 
Uncalled bet ($0.50) returned to PlayTheBlues4U
PlayTheBlues4U collected $0.90 from pot
PlayTheBlues4U: doesn't show hand 
*** SUMMARY ***
Total pot $0.95 | Rake $0.05 
Board [3c 8h Ah]
Seat 1: SeaofLove folded before Flop (didn't bet)
Seat 2: LanskyBanksy folded before Flop (didn't bet)
Seat 3: Varginho13 folded on the Flop
Seat 4: PlayTheBlues4U (button) collected ($0.90)
Seat 5: Klytu (small blind) folded before Flop
Seat 6: 123tiger711a (big blind) folded on the Flop



PokerStars Hand #204848295966:  Hold'em No Limit ($0.05/$0.10 USD) - 2019/10/21 21:19:58 ET
Table 'Hesperia' 6-max Seat #5 is the button
Seat 1: SeaofLove ($13.04 in chips) 
Seat 2: LanskyBanksy ($9.90 in chips) 
Seat 3: Varginho13 ($14.26 in chips) 
Seat 4: PlayTheBlues4U ($10.47 in chips) 
Seat 5: Klytu ($18.47 in chips) 
Seat 6: 123tiger711a ($10 in chips) 
123tiger711a: posts small blind $0.05
SeaofLove: posts big blind $0.10
*** HOLE CARDS ***
Dealt to PlayTheBlues4U [2d 6c]
LanskyBanksy: folds 
Varginho13: folds 
PlayTheBlues4U: folds 
Klytu: folds 
123tiger711a: calls $0.05
SeaofLove: checks 
*** FLOP *** [Qs 3c 7d]
123tiger711a: checks 
SeaofLove: checks 
*** TURN *** [Qs 3c 7d] [5d]
123tiger711a: checks 
SeaofLove: checks 
*** RIVER *** [Qs 3c 7d 5d] [7c]
123tiger711a: checks 
SeaofLove: checks 
*** SHOW DOWN ***
123tiger711a: shows [Jc Th] (a pair of Sevens)
SeaofLove: shows [Kd 5c] (two pair, Sevens and Fives)
SeaofLove collected $0.19 from pot
*** SUMMARY ***
Total pot $0.20 | Rake $0.01 
Board [Qs 3c 7d 5d 7c]
Seat 1: SeaofLove (big blind) showed [Kd 5c] and won ($0.19) with two pair, Sevens and Fives
Seat 2: LanskyBanksy folded before Flop (didn't bet)
Seat 3: Varginho13 folded before Flop (didn't bet)
Seat 4: PlayTheBlues4U folded before Flop (didn't bet)
Seat 5: Klytu (button) folded before Flop (didn't bet)
Seat 6: 123tiger711a (small blind) showed [Jc Th] and lost with a pair of Sevens



PokerStars Hand #204848296047:  Hold'em No Limit ($0.05/$0.10 USD) - 2019/10/21 21:20:15 ET
Table 'Hesperia' 6-max Seat #6 is the button
Seat 1: SeaofLove ($13.13 in chips) 
Seat 2: LanskyBanksy ($9.90 in chips) 
Seat 3: Varginho13 ($14.26 in chips) 
Seat 4: PlayTheBlues4U ($10.47 in chips) 
Seat 5: Klytu ($18.47 in chips) 
Seat 6: 123tiger711a ($10 in chips) 
SeaofLove: posts small blind $0.05
LanskyBanksy: posts big blind $0.10
*** HOLE CARDS ***
Dealt to PlayTheBlues4U [4c 9d]
Varginho13: folds 
PlayTheBlues4U: folds 
Klytu: folds 
123tiger711a: folds 
SeaofLove: raises $0.20 to $0.30
LanskyBanksy: folds 
Uncalled bet ($0.20) returned to SeaofLove
SeaofLove collected $0.20 from pot
SeaofLove: doesn't show hand 
*** SUMMARY ***
Total pot $0.20 | Rake $0 
Seat 1: SeaofLove (small blind) collected ($0.20)
Seat 2: LanskyBanksy (big blind) folded before Flop
Seat 3: Varginho13 folded before Flop (didn't bet)
Seat 4: PlayTheBlues4U folded before Flop (didn't bet)
Seat 5: Klytu folded before Flop (didn't bet)
Seat 6: 123tiger711a (button) folded before Flop (didn't bet)



PokerStars Hand #204848296091:  Hold'em No Limit ($0.05/$0.10 USD) - 2019/10/21 21:20:27 ET
Table 'Hesperia' 6-max Seat #1 is the button
Seat 1: SeaofLove ($13.23 in chips) 
Seat 2: LanskyBanksy ($9.80 in chips) 
Seat 3: Varginho13 ($14.26 in chips) 
Seat 4: PlayTheBlues4U ($10.47 in chips) 
Seat 5: Klytu ($18.47 in chips) 
Seat 6: 123tiger711a ($10 in chips) 
LanskyBanksy: posts small blind $0.05
Varginho13: posts big blind $0.10
*** HOLE CARDS ***
Dealt to PlayTheBlues4U [Qs 7d]
PlayTheBlues4U: folds 
Klytu: folds 
123tiger711a: folds 
SeaofLove: raises $0.15 to $0.25
LanskyBanksy: folds 
Varginho13: calls $0.15
*** FLOP *** [2s Jc Ks]
Varginho13: checks 
SeaofLove: checks 
*** TURN *** [2s Jc Ks] [3h]
Varginho13: checks 
SeaofLove: checks 
*** RIVER *** [2s Jc Ks 3h] [5s]
Varginho13: checks 
SeaofLove: bets $0.35
Varginho13: folds 
Uncalled bet ($0.35) returned to SeaofLove
SeaofLove collected $0.52 from pot
SeaofLove: doesn't show hand 
*** SUMMARY ***
Total pot $0.55 | Rake $0.03 
Board [2s Jc Ks 3h 5s]
Seat 1: SeaofLove (button) collected ($0.52)
Seat 2: LanskyBanksy (small blind) folded before Flop
Seat 3: Varginho13 (big blind) folded on the River
Seat 4: PlayTheBlues4U folded before Flop (didn't bet)
Seat 5: Klytu folded before Flop (didn't bet)
Seat 6: 123tiger711a folded before Flop (didn't bet)



PokerStars Hand #204848296328:  Hold'em No Limit ($0.05/$0.10 USD) - 2019/10/21 21:21:24 ET
Table 'Hesperia' 6-max Seat #2 is the button
Seat 1: SeaofLove ($13.50 in chips) 
Seat 2: LanskyBanksy ($9.75 in chips) 
Seat 3: Varginho13 ($14.01 in chips) 
Seat 4: PlayTheBlues4U ($10.47 in chips) 
Seat 5: Klytu ($18.47 in chips) 
Seat 6: 123tiger711a ($10 in chips) 
Varginho13: posts small blind $0.05
PlayTheBlues4U: posts big blind $0.10
*** HOLE CARDS ***
Dealt to PlayTheBlues4U [3s 9h]
Klytu: raises $0.25 to $0.35
123tiger711a: folds 
SeaofLove: folds 
LanskyBanksy: calls $0.35
Varginho13: folds 
PlayTheBlues4U: folds 
*** FLOP *** [5d 8d 9c]
Klytu: bets $0.50
LanskyBanksy: folds 
Uncalled bet ($0.50) returned to Klytu
Klytu collected $0.81 from pot
Klytu: doesn't show hand 
*** SUMMARY ***
Total pot $0.85 | Rake $0.04 
Board [5d 8d 9c]
Seat 1: SeaofLove folded before Flop (didn't bet)
Seat 2: LanskyBanksy (button) folded on the Flop
Seat 3: Varginho13 (small blind) folded before Flop
Seat 4: PlayTheBlues4U (big blind) folded before Flop
Seat 5: Klytu collected ($0.81)
Seat 6: 123tiger711a folded before Flop (didn't bet)



PokerStars Hand #204848296446:  Hold'em No Limit ($0.05/$0.10 USD) - 2019/10/21 21:21:54 ET
Table 'Hesperia' 6-max Seat #3 is the button
Seat 1: SeaofLove ($13.50 in chips) 
Seat 2: LanskyBanksy ($9.40 in chips) 
Seat 3: Varginho13 ($13.96 in chips) 
Seat 4: PlayTheBlues4U ($10.37 in chips) 
Seat 5: Klytu ($18.93 in chips) 
Seat 6: 123tiger711a ($10 in chips) 
PlayTheBlues4U: posts small blind $0.05
Klytu: posts big blind $0.10
*** HOLE CARDS ***
Dealt to PlayTheBlues4U [Qd 8s]
123tiger711a: folds 
SeaofLove: folds 
LanskyBanksy: raises $0.20 to $0.30
Varginho13: calls $0.30
PlayTheBlues4U: folds 
Klytu: folds 
*** FLOP *** [6c Ah Kh]
LanskyBanksy: checks 
Varginho13: checks 
*** TURN *** [6c Ah Kh] [2h]
LanskyBanksy: bets $0.36
Varginho13: calls $0.36
*** RIVER *** [6c Ah Kh 2h] [5d]
LanskyBanksy: checks 
Varginho13: bets $1.05
LanskyBanksy: folds 
Uncalled bet ($1.05) returned to Varginho13
Varginho13 collected $1.40 from pot
*** SUMMARY ***
Total pot $1.47 | Rake $0.07 
Board [6c Ah Kh 2h 5d]
Seat 1: SeaofLove folded before Flop (didn't bet)
Seat 2: LanskyBanksy folded on the River
Seat 3: Varginho13 (button) collected ($1.40)
Seat 4: PlayTheBlues4U (small blind) folded before Flop
Seat 5: Klytu (big blind) folded before Flop
Seat 6: 123tiger711a folded before Flop (didn't bet)



PokerStars Hand #204848296776:  Hold'em No Limit ($0.05/$0.10 USD) - 2019/10/21 21:23:18 ET
Table 'Hesperia' 6-max Seat #4 is the button
Seat 1: SeaofLove ($13.50 in chips) 
Seat 2: LanskyBanksy ($8.74 in chips) 
Seat 3: Varginho13 ($14.70 in chips) 
Seat 4: PlayTheBlues4U ($10.32 in chips) 
Seat 5: Klytu ($18.83 in chips) 
Seat 6: 123tiger711a ($10 in chips) 
Klytu: posts small blind $0.05
123tiger711a: posts big blind $0.10
*** HOLE CARDS ***
Dealt to PlayTheBlues4U [2c 4s]
SeaofLove: folds 
LanskyBanksy: folds 
Varginho13: raises $0.20 to $0.30
PlayTheBlues4U: folds 
Klytu: folds 
123tiger711a: folds 
Uncalled bet ($0.20) returned to Varginho13
Varginho13 collected $0.25 from pot
*** SUMMARY ***
Total pot $0.25 | Rake $0 
Seat 1: SeaofLove folded before Flop (didn't bet)
Seat 2: LanskyBanksy folded before Flop (didn't bet)
Seat 3: Varginho13 collected ($0.25)
Seat 4: PlayTheBlues4U (button) folded before Flop (didn't bet)
Seat 5: Klytu (small blind) folded before Flop
Seat 6: 123tiger711a (big blind) folded before Flop



PokerStars Hand #204848296880:  Hold'em No Limit ($0.05/$0.10 USD) - 2019/10/21 21:23:44 ET
Table 'Hesperia' 6-max Seat #5 is the button
Seat 1: SeaofLove ($13.50 in chips) 
Seat 2: LanskyBanksy ($8.74 in chips) 
Seat 3: Varginho13 ($14.85 in chips) 
Seat 4: PlayTheBlues4U ($10.32 in chips) 
Seat 5: Klytu ($18.78 in chips) 
Seat 6: 123tiger711a ($10 in chips) 
123tiger711a: posts small blind $0.05
SeaofLove: posts big blind $0.10
*** HOLE CARDS ***
Dealt to PlayTheBlues4U [4c Jd]
LanskyBanksy: raises $0.20 to $0.30
Varginho13: folds 
PlayTheBlues4U: folds 
Klytu: folds 
123tiger711a: calls $0.25
SeaofLove: folds 
*** FLOP *** [8c 2d 7d]
123tiger711a: checks 
LanskyBanksy: bets $0.33
123tiger711a: folds 
Uncalled bet ($0.33) returned to LanskyBanksy
LanskyBanksy collected $0.66 from pot
LanskyBanksy: doesn't show hand 
*** SUMMARY ***
Total pot $0.70 | Rake $0.04 
Board [8c 2d 7d]
Seat 1: SeaofLove (big blind) folded before Flop
Seat 2: LanskyBanksy collected ($0.66)
Seat 3: Varginho13 folded before Flop (didn't bet)
Seat 4: PlayTheBlues4U folded before Flop (didn't bet)
Seat 5: Klytu (button) folded before Flop (didn't bet)
Seat 6: 123tiger711a (small blind) folded on the Flop



PokerStars Hand #204848296991:  Hold'em No Limit ($0.05/$0.10 USD) - 2019/10/21 21:24:11 ET
Table 'Hesperia' 6-max Seat #6 is the button
Seat 1: SeaofLove ($13.40 in chips) 
Seat 2: LanskyBanksy ($9.10 in chips) 
Seat 3: Varginho13 ($14.85 in chips) 
Seat 4: PlayTheBlues4U ($10.32 in chips) 
Seat 5: Klytu ($18.78 in chips) 
Seat 6: 123tiger711a ($10 in chips) 
SeaofLove: posts small blind $0.05
LanskyBanksy: posts big blind $0.10
*** HOLE CARDS ***
Dealt to PlayTheBlues4U [7d 5c]
Varginho13: folds 
PlayTheBlues4U: folds 
Klytu: folds 
123tiger711a: folds 
SeaofLove: folds 
Uncalled bet ($0.05) returned to LanskyBanksy
LanskyBanksy collected $0.10 from pot
LanskyBanksy: doesn't show hand 
*** SUMMARY ***
Total pot $0.10 | Rake $0 
Seat 1: SeaofLove (small blind) folded before Flop
Seat 2: LanskyBanksy (big blind) collected ($0.10)
Seat 3: Varginho13 folded before Flop (didn't bet)
Seat 4: PlayTheBlues4U folded before Flop (didn't bet)
Seat 5: Klytu folded before Flop (didn't bet)
Seat 6: 123tiger711a (button) folded before Flop (didn't bet)



PokerStars Hand #204848297032:  Hold'em No Limit ($0.05/$0.10 USD) - 2019/10/21 21:24:21 ET
Table 'Hesperia' 6-max Seat #1 is the button
Seat 1: SeaofLove ($13.35 in chips) 
Seat 2: LanskyBanksy ($9.15 in chips) 
Seat 3: Varginho13 ($14.85 in chips) 
Seat 4: PlayTheBlues4U ($10.32 in chips) 
Seat 5: Klytu ($18.78 in chips) 
Seat 6: 123tiger711a ($10 in chips) 
LanskyBanksy: posts small blind $0.05
Varginho13: posts big blind $0.10
*** HOLE CARDS ***
Dealt to PlayTheBlues4U [3c 9d]
PlayTheBlues4U: folds 
Klytu: folds 
123tiger711a: calls $0.10
SeaofLove: folds 
LanskyBanksy: calls $0.05
Varginho13: checks 
*** FLOP *** [Qd 2c As]
LanskyBanksy: checks 
Varginho13: checks 
123tiger711a: bets $0.14
LanskyBanksy: folds 
Varginho13: folds 
Uncalled bet ($0.14) returned to 123tiger711a
123tiger711a collected $0.28 from pot
*** SUMMARY ***
Total pot $0.30 | Rake $0.02 
Board [Qd 2c As]
Seat 1: SeaofLove (button) folded before Flop (didn't bet)
Seat 2: LanskyBanksy (small blind) folded on the Flop
Seat 3: Varginho13 (big blind) folded on the Flop
Seat 4: PlayTheBlues4U folded before Flop (didn't bet)
Seat 5: Klytu folded before Flop (didn't bet)
Seat 6: 123tiger711a collected ($0.28)



PokerStars Hand #204848297205:  Hold'em No Limit ($0.05/$0.10 USD) - 2019/10/21 21:25:04 ET
Table 'Hesperia' 6-max Seat #2 is the button
Seat 1: SeaofLove ($13.35 in chips) 
Seat 2: LanskyBanksy ($9.05 in chips) 
Seat 3: Varginho13 ($14.75 in chips) 
Seat 4: PlayTheBlues4U ($10.32 in chips) 
Seat 5: Klytu ($18.78 in chips) 
Seat 6: 123tiger711a ($10.18 in chips) 
Varginho13: posts small blind $0.05
PlayTheBlues4U: posts big blind $0.10
*** HOLE CARDS ***
Dealt to PlayTheBlues4U [Jh Tc]
Klytu: folds 
123tiger711a: folds 
SeaofLove: folds 
LanskyBanksy: raises $0.20 to $0.30
Varginho13: folds 
PlayTheBlues4U: calls $0.20
*** FLOP *** [Td As Jc]
PlayTheBlues4U: checks 
LanskyBanksy: bets $0.31
PlayTheBlues4U: calls $0.31
*** TURN *** [Td As Jc] [Ad]
PlayTheBlues4U: checks 
LanskyBanksy: bets $0.80
PlayTheBlues4U: calls $0.80
*** RIVER *** [Td As Jc Ad] [Ah]
PlayTheBlues4U: checks 
LanskyBanksy: bets $2
PlayTheBlues4U: calls $2
*** SHOW DOWN ***
LanskyBanksy: shows [Ac Ks] (four of a kind, Aces)
PlayTheBlues4U: mucks hand 
LanskyBanksy collected $6.53 from pot
*** SUMMARY ***
Total pot $6.87 | Rake $0.34 
Board [Td As Jc Ad Ah]
Seat 1: SeaofLove folded before Flop (didn't bet)
Seat 2: LanskyBanksy (button) showed [Ac Ks] and won ($6.53) with four of a kind, Aces
Seat 3: Varginho13 (small blind) folded before Flop
Seat 4: PlayTheBlues4U (big blind) mucked [Jh Tc]
Seat 5: Klytu folded before Flop (didn't bet)
Seat 6: 123tiger711a folded before Flop (didn't bet)



PokerStars Hand #204848297438:  Hold'em No Limit ($0.05/$0.10 USD) - 2019/10/21 21:25:58 ET
Table 'Hesperia' 6-max Seat #3 is the button
Seat 1: SeaofLove ($13.35 in chips) 
Seat 2: LanskyBanksy ($12.17 in chips) 
Seat 3: Varginho13 ($14.70 in chips) 
Seat 4: PlayTheBlues4U ($6.91 in chips) 
Seat 5: Klytu ($18.78 in chips) 
Seat 6: 123tiger711a ($10.18 in chips) 
PlayTheBlues4U: posts small blind $0.05
Klytu: posts big blind $0.10
*** HOLE CARDS ***
Dealt to PlayTheBlues4U [8c 4h]
123tiger711a: calls $0.10
PlayTheBlues4U said, "you really have the quads lol"
SeaofLove: raises $0.35 to $0.45
LanskyBanksy: folds 
Varginho13: folds 
PlayTheBlues4U: folds 
Klytu: folds 
123tiger711a: folds 
Uncalled bet ($0.35) returned to SeaofLove
SeaofLove collected $0.35 from pot
SeaofLove: doesn't show hand 
*** SUMMARY ***
Total pot $0.35 | Rake $0 
Seat 1: SeaofLove collected ($0.35)
Seat 2: LanskyBanksy folded before Flop (didn't bet)
Seat 3: Varginho13 (button) folded before Flop (didn't bet)
Seat 4: PlayTheBlues4U (small blind) folded before Flop
Seat 5: Klytu (big blind) folded before Flop
Seat 6: 123tiger711a folded before Flop



PokerStars Hand #204848297538:  Hold'em No Limit ($0.05/$0.10 USD) - 2019/10/21 21:26:21 ET
Table 'Hesperia' 6-max Seat #4 is the button
Seat 1: SeaofLove ($13.60 in chips) 
Seat 2: LanskyBanksy ($12.17 in chips) 
Seat 3: Varginho13 ($14.70 in chips) 
Seat 4: PlayTheBlues4U ($10 in chips) 
Seat 5: Klytu ($18.68 in chips) 
Seat 6: 123tiger711a ($10.08 in chips) 
Klytu: posts small blind $0.05
123tiger711a: posts big blind $0.10
*** HOLE CARDS ***
Dealt to PlayTheBlues4U [4d Td]
SeaofLove: raises $0.15 to $0.25
LanskyBanksy: folds 
Varginho13: folds 
PlayTheBlues4U: folds 
Klytu: folds 
123tiger711a: calls $0.15
*** FLOP *** [9c Kh Ac]
123tiger711a: checks 
LanskyBanksy said, "yup"
SeaofLove: bets $0.35
123tiger711a: calls $0.35
*** TURN *** [9c Kh Ac] [3h]
123tiger711a: checks 
SeaofLove: checks 
*** RIVER *** [9c Kh Ac 3h] [Jc]
123tiger711a: checks 
SeaofLove: checks 
*** SHOW DOWN ***
123tiger711a: shows [Jh Ts] (a pair of Jacks)
SeaofLove: shows [As 5s] (a pair of Aces)
SeaofLove collected $1.19 from pot
*** SUMMARY ***
Total pot $1.25 | Rake $0.06 
Board [9c Kh Ac 3h Jc]
Seat 1: SeaofLove showed [As 5s] and won ($1.19) with a pair of Aces
Seat 2: LanskyBanksy folded before Flop (didn't bet)
Seat 3: Varginho13 folded before Flop (didn't bet)
Seat 4: PlayTheBlues4U (button) folded before Flop (didn't bet)
Seat 5: Klytu (small blind) folded before Flop
Seat 6: 123tiger711a (big blind) showed [Jh Ts] and lost with a pair of Jacks



PokerStars Hand #204848297640:  Hold'em No Limit ($0.05/$0.10 USD) - 2019/10/21 21:26:44 ET
Table 'Hesperia' 6-max Seat #5 is the button
Seat 1: SeaofLove ($14.19 in chips) 
Seat 2: LanskyBanksy ($12.17 in chips) 
Seat 3: Varginho13 ($14.70 in chips) 
Seat 4: PlayTheBlues4U ($10 in chips) 
Seat 5: Klytu ($18.63 in chips) 
Seat 6: 123tiger711a ($10 in chips) 
123tiger711a: posts small blind $0.05
SeaofLove: posts big blind $0.10
*** HOLE CARDS ***
Dealt to PlayTheBlues4U [Jc 3d]
LanskyBanksy: folds 
Varginho13: raises $0.20 to $0.30
PlayTheBlues4U: folds 
Klytu: folds 
123tiger711a: folds 
SeaofLove: calls $0.20
*** FLOP *** [Qs 6d 2d]
SeaofLove: checks 
Varginho13: bets $0.50
SeaofLove: folds 
Uncalled bet ($0.50) returned to Varginho13
Varginho13 collected $0.62 from pot
*** SUMMARY ***
Total pot $0.65 | Rake $0.03 
Board [Qs 6d 2d]
Seat 1: SeaofLove (big blind) folded on the Flop
Seat 2: LanskyBanksy folded before Flop (didn't bet)
Seat 3: Varginho13 collected ($0.62)
Seat 4: PlayTheBlues4U folded before Flop (didn't bet)
Seat 5: Klytu (button) folded before Flop (didn't bet)
Seat 6: 123tiger711a (small blind) folded before Flop



PokerStars Hand #204848297816:  Hold'em No Limit ($0.05/$0.10 USD) - 2019/10/21 21:27:24 ET
Table 'Hesperia' 6-max Seat #6 is the button
Seat 1: SeaofLove ($13.89 in chips) 
Seat 2: LanskyBanksy ($12.17 in chips) 
Seat 3: Varginho13 ($15.02 in chips) 
Seat 4: PlayTheBlues4U ($10 in chips) 
Seat 5: Klytu ($18.63 in chips) 
Seat 6: 123tiger711a ($10 in chips) 
SeaofLove: posts small blind $0.05
LanskyBanksy: posts big blind $0.10
*** HOLE CARDS ***
Dealt to PlayTheBlues4U [Qs 6c]
Varginho13: raises $0.20 to $0.30
PlayTheBlues4U: folds 
Klytu: folds 
123tiger711a: folds 
SeaofLove: folds 
LanskyBanksy: folds 
Uncalled bet ($0.20) returned to Varginho13
Varginho13 collected $0.25 from pot
*** SUMMARY ***
Total pot $0.25 | Rake $0 
Seat 1: SeaofLove (small blind) folded before Flop
Seat 2: LanskyBanksy (big blind) folded before Flop
Seat 3: Varginho13 collected ($0.25)
Seat 4: PlayTheBlues4U folded before Flop (didn't bet)
Seat 5: Klytu folded before Flop (didn't bet)
Seat 6: 123tiger711a (button) folded before Flop (didn't bet)



PokerStars Hand #204848297923:  Hold'em No Limit ($0.05/$0.10 USD) - 2019/10/21 21:27:50 ET
Table 'Hesperia' 6-max Seat #1 is the button
Seat 1: SeaofLove ($13.84 in chips) 
Seat 2: LanskyBanksy ($12.07 in chips) 
Seat 3: Varginho13 ($15.17 in chips) 
Seat 4: PlayTheBlues4U ($10 in chips) 
Seat 5: Klytu ($18.63 in chips) 
Seat 6: 123tiger711a ($10 in chips) 
LanskyBanksy: posts small blind $0.05
Varginho13: posts big blind $0.10
*** HOLE CARDS ***
Dealt to PlayTheBlues4U [6s Jh]
PlayTheBlues4U: folds 
Klytu: folds 
123tiger711a: calls $0.10
SeaofLove: raises $0.35 to $0.45
LanskyBanksy: folds 
Varginho13: folds 
123tiger711a: calls $0.35
*** FLOP *** [8c Qs Kd]
123tiger711a: checks 
SeaofLove: bets $0.67
123tiger711a: calls $0.67
*** TURN *** [8c Qs Kd] [2d]
123tiger711a: checks 
SeaofLove: bets $1.51
123tiger711a: calls $1.51
*** RIVER *** [8c Qs Kd 2d] [Kh]
123tiger711a: checks 
SeaofLove: bets $2.57
123tiger711a: calls $2.57
*** SHOW DOWN ***
SeaofLove: shows [Ad Ac] (two pair, Aces and Kings)
123tiger711a: mucks hand 
SeaofLove collected $10.02 from pot
*** SUMMARY ***
Total pot $10.55 | Rake $0.53 
Board [8c Qs Kd 2d Kh]
Seat 1: SeaofLove (button) showed [Ad Ac] and won ($10.02) with two pair, Aces and Kings
Seat 2: LanskyBanksy (small blind) folded before Flop
Seat 3: Varginho13 (big blind) folded before Flop
Seat 4: PlayTheBlues4U folded before Flop (didn't bet)
Seat 5: Klytu folded before Flop (didn't bet)
Seat 6: 123tiger711a mucked [9h Qc]



PokerStars Hand #204848298050:  Hold'em No Limit ($0.05/$0.10 USD) - 2019/10/21 21:28:19 ET
Table 'Hesperia' 6-max Seat #2 is the button
Seat 1: SeaofLove ($18.66 in chips) 
Seat 2: LanskyBanksy ($12.02 in chips) 
Seat 3: Varginho13 ($15.07 in chips) 
Seat 4: PlayTheBlues4U ($10 in chips) 
Seat 5: Klytu ($18.63 in chips) 
Seat 6: 123tiger711a ($10 in chips) 
Varginho13: posts small blind $0.05
PlayTheBlues4U: posts big blind $0.10
*** HOLE CARDS ***
Dealt to PlayTheBlues4U [4c Th]
Klytu: folds 
123tiger711a: folds 
SeaofLove: folds 
LanskyBanksy: folds 
Varginho13: calls $0.05
PlayTheBlues4U: checks 
*** FLOP *** [4s Qs 6h]
Varginho13: checks 
PlayTheBlues4U: checks 
*** TURN *** [4s Qs 6h] [Qd]
Varginho13: checks 
PlayTheBlues4U: checks 
*** RIVER *** [4s Qs 6h Qd] [2c]
Varginho13: checks 
PlayTheBlues4U: bets $0.10
Varginho13: folds 
Uncalled bet ($0.10) returned to PlayTheBlues4U
PlayTheBlues4U collected $0.19 from pot
PlayTheBlues4U: doesn't show hand 
*** SUMMARY ***
Total pot $0.20 | Rake $0.01 
Board [4s Qs 6h Qd 2c]
Seat 1: SeaofLove folded before Flop (didn't bet)
Seat 2: LanskyBanksy (button) folded before Flop (didn't bet)
Seat 3: Varginho13 (small blind) folded on the River
Seat 4: PlayTheBlues4U (big blind) collected ($0.19)
Seat 5: Klytu folded before Flop (didn't bet)
Seat 6: 123tiger711a folded before Flop (didn't bet)



PokerStars Hand #204848298269:  Hold'em No Limit ($0.05/$0.10 USD) - 2019/10/21 21:29:11 ET
Table 'Hesperia' 6-max Seat #3 is the button
Seat 1: SeaofLove ($18.66 in chips) 
Seat 2: LanskyBanksy ($12.02 in chips) 
Seat 3: Varginho13 ($14.97 in chips) 
Seat 4: PlayTheBlues4U ($10.09 in chips) 
Seat 5: Klytu ($18.63 in chips) 
Seat 6: 123tiger711a ($10 in chips) 
PlayTheBlues4U: posts small blind $0.05
Klytu: posts big blind $0.10
*** HOLE CARDS ***
Dealt to PlayTheBlues4U [Ah 2s]
123tiger711a: calls $0.10
SeaofLove: folds 
LanskyBanksy: folds 
Varginho13: calls $0.10
PlayTheBlues4U: calls $0.05
Klytu: raises $0.45 to $0.55
123tiger711a: folds 
Varginho13: folds 
PlayTheBlues4U: folds 
Uncalled bet ($0.45) returned to Klytu
Klytu collected $0.40 from pot
Klytu: doesn't show hand 
*** SUMMARY ***
Total pot $0.40 | Rake $0 
Seat 1: SeaofLove folded before Flop (didn't bet)
Seat 2: LanskyBanksy folded before Flop (didn't bet)
Seat 3: Varginho13 (button) folded before Flop
Seat 4: PlayTheBlues4U (small blind) folded before Flop
Seat 5: Klytu (big blind) collected ($0.40)
Seat 6: 123tiger711a folded before Flop



PokerStars Hand #204848298381:  Hold'em No Limit ($0.05/$0.10 USD) - 2019/10/21 21:29:37 ET
Table 'Hesperia' 6-max Seat #4 is the button
Seat 1: SeaofLove ($18.66 in chips) 
Seat 2: LanskyBanksy ($12.02 in chips) 
Seat 3: Varginho13 ($14.87 in chips) 
Seat 4: PlayTheBlues4U ($9.99 in chips) 
Seat 5: Klytu ($18.93 in chips) 
Seat 6: 123tiger711a ($10 in chips) 
Klytu: posts small blind $0.05
123tiger711a: posts big blind $0.10
*** HOLE CARDS ***
Dealt to PlayTheBlues4U [2h 5s]
SeaofLove: folds 
LanskyBanksy: raises $0.20 to $0.30
Varginho13: calls $0.30
PlayTheBlues4U: folds 
Klytu: folds 
123tiger711a: calls $0.20
*** FLOP *** [Kh 8c 4h]
123tiger711a: checks 
LanskyBanksy: checks 
Varginho13: bets $0.75
123tiger711a: folds 
LanskyBanksy: folds 
Uncalled bet ($0.75) returned to Varginho13
Varginho13 collected $0.90 from pot
*** SUMMARY ***
Total pot $0.95 | Rake $0.05 
Board [Kh 8c 4h]
Seat 1: SeaofLove folded before Flop (didn't bet)
Seat 2: LanskyBanksy folded on the Flop
Seat 3: Varginho13 collected ($0.90)
Seat 4: PlayTheBlues4U (button) folded before Flop (didn't bet)
Seat 5: Klytu (small blind) folded before Flop
Seat 6: 123tiger711a (big blind) folded on the Flop



PokerStars Hand #204848298564:  Hold'em No Limit ($0.05/$0.10 USD) - 2019/10/21 21:30:19 ET
Table 'Hesperia' 6-max Seat #5 is the button
Seat 1: SeaofLove ($18.66 in chips) 
Seat 2: LanskyBanksy ($11.72 in chips) 
Seat 3: Varginho13 ($15.47 in chips) 
Seat 4: PlayTheBlues4U ($9.99 in chips) 
Seat 5: Klytu ($18.88 in chips) 
Seat 6: 123tiger711a ($10 in chips) 
123tiger711a: posts small blind $0.05
SeaofLove: posts big blind $0.10
*** HOLE CARDS ***
Dealt to PlayTheBlues4U [Ks 9c]
LanskyBanksy: folds 
Varginho13: raises $0.20 to $0.30
PlayTheBlues4U: folds 
Klytu: calls $0.30
123tiger711a: folds 
SeaofLove: folds 
*** FLOP *** [5s 8h Td]
Varginho13: checks 
Klytu: checks 
*** TURN *** [5s 8h Td] [6h]
Varginho13: checks 
Klytu: bets $0.45
Varginho13: folds 
Uncalled bet ($0.45) returned to Klytu
Klytu collected $0.71 from pot
Klytu: doesn't show hand 
*** SUMMARY ***
Total pot $0.75 | Rake $0.04 
Board [5s 8h Td 6h]
Seat 1: SeaofLove (big blind) folded before Flop
Seat 2: LanskyBanksy folded before Flop (didn't bet)
Seat 3: Varginho13 folded on the Turn
Seat 4: PlayTheBlues4U folded before Flop (didn't bet)
Seat 5: Klytu (button) collected ($0.71)
Seat 6: 123tiger711a (small blind) folded before Flop



PokerStars Hand #204848298789:  Hold'em No Limit ($0.05/$0.10 USD) - 2019/10/21 21:31:12 ET
Table 'Hesperia' 6-max Seat #6 is the button
Seat 1: SeaofLove ($18.56 in chips) 
Seat 2: LanskyBanksy ($11.72 in chips) 
Seat 3: Varginho13 ($15.17 in chips) 
Seat 4: PlayTheBlues4U ($9.99 in chips) 
Seat 5: Klytu ($19.29 in chips) 
Seat 6: 123tiger711a ($10 in chips) 
SeaofLove: posts small blind $0.05
LanskyBanksy: posts big blind $0.10
*** HOLE CARDS ***
Dealt to PlayTheBlues4U [3s 4d]
Varginho13: folds 
PlayTheBlues4U: folds 
Klytu: folds 
123tiger711a: folds 
SeaofLove: folds 
Uncalled bet ($0.05) returned to LanskyBanksy
LanskyBanksy collected $0.10 from pot
LanskyBanksy: doesn't show hand 
*** SUMMARY ***
Total pot $0.10 | Rake $0 
Seat 1: SeaofLove (small blind) folded before Flop
Seat 2: LanskyBanksy (big blind) collected ($0.10)
Seat 3: Varginho13 folded before Flop (didn't bet)
Seat 4: PlayTheBlues4U folded before Flop (didn't bet)
Seat 5: Klytu folded before Flop (didn't bet)
Seat 6: 123tiger711a (button) folded before Flop (didn't bet)



PokerStars Hand #204848298825:  Hold'em No Limit ($0.05/$0.10 USD) - 2019/10/21 21:31:19 ET
Table 'Hesperia' 6-max Seat #1 is the button
Seat 1: SeaofLove ($18.51 in chips) 
Seat 2: LanskyBanksy ($11.77 in chips) 
Seat 3: Varginho13 ($15.17 in chips) 
Seat 4: PlayTheBlues4U ($9.99 in chips) 
Seat 5: Klytu ($19.29 in chips) 
Seat 6: 123tiger711a ($10 in chips) 
LanskyBanksy: posts small blind $0.05
Varginho13: posts big blind $0.10
*** HOLE CARDS ***
Dealt to PlayTheBlues4U [5c 4s]
PlayTheBlues4U: folds 
Klytu: folds 
123tiger711a: calls $0.10
SeaofLove: folds 
LanskyBanksy: calls $0.05
Varginho13: checks 
*** FLOP *** [2c 4d As]
LanskyBanksy: checks 
Varginho13: bets $0.30
123tiger711a: folds 
LanskyBanksy: calls $0.30
*** TURN *** [2c 4d As] [Kh]
LanskyBanksy: checks 
Varginho13: bets $0.45
LanskyBanksy: folds 
Uncalled bet ($0.45) returned to Varginho13
Varginho13 collected $0.86 from pot
*** SUMMARY ***
Total pot $0.90 | Rake $0.04 
Board [2c 4d As Kh]
Seat 1: SeaofLove (button) folded before Flop (didn't bet)
Seat 2: LanskyBanksy (small blind) folded on the Turn
Seat 3: Varginho13 (big blind) collected ($0.86)
Seat 4: PlayTheBlues4U folded before Flop (didn't bet)
Seat 5: Klytu folded before Flop (didn't bet)
Seat 6: 123tiger711a folded on the Flop



PokerStars Hand #204848299140:  Hold'em No Limit ($0.05/$0.10 USD) - 2019/10/21 21:32:26 ET
Table 'Hesperia' 6-max Seat #2 is the button
Seat 1: SeaofLove ($18.51 in chips) 
Seat 2: LanskyBanksy ($11.37 in chips) 
Seat 3: Varginho13 ($15.63 in chips) 
Seat 4: PlayTheBlues4U ($9.99 in chips) 
Seat 5: Klytu ($19.29 in chips) 
Seat 6: 123tiger711a ($10 in chips) 
Varginho13: posts small blind $0.05
PlayTheBlues4U: posts big blind $0.10
*** HOLE CARDS ***
Dealt to PlayTheBlues4U [8h 4h]
Klytu: folds 
123tiger711a: folds 
SeaofLove: folds 
LanskyBanksy: raises $0.20 to $0.30
Varginho13: folds 
PlayTheBlues4U: folds 
Uncalled bet ($0.20) returned to LanskyBanksy
LanskyBanksy collected $0.25 from pot
LanskyBanksy: doesn't show hand 
*** SUMMARY ***
Total pot $0.25 | Rake $0 
Seat 1: SeaofLove folded before Flop (didn't bet)
Seat 2: LanskyBanksy (button) collected ($0.25)
Seat 3: Varginho13 (small blind) folded before Flop
Seat 4: PlayTheBlues4U (big blind) folded before Flop
Seat 5: Klytu folded before Flop (didn't bet)
Seat 6: 123tiger711a folded before Flop (didn't bet)



PokerStars Hand #204848299233:  Hold'em No Limit ($0.05/$0.10 USD) - 2019/10/21 21:32:47 ET
Table 'Hesperia' 6-max Seat #3 is the button
Seat 1: SeaofLove ($18.51 in chips) 
Seat 2: LanskyBanksy ($11.52 in chips) 
Seat 3: Varginho13 ($15.58 in chips) 
Seat 4: PlayTheBlues4U ($9.89 in chips) 
Seat 5: Klytu ($19.29 in chips) 
Seat 6: 123tiger711a ($10 in chips) 
PlayTheBlues4U: posts small blind $0.05
Klytu: posts big blind $0.10
*** HOLE CARDS ***
Dealt to PlayTheBlues4U [6s Th]
123tiger711a: folds 
SeaofLove: raises $0.15 to $0.25
LanskyBanksy: folds 
Varginho13: folds 
PlayTheBlues4U: folds 
Klytu: folds 
Uncalled bet ($0.15) returned to SeaofLove
SeaofLove collected $0.25 from pot
SeaofLove: doesn't show hand 
*** SUMMARY ***
Total pot $0.25 | Rake $0 
Seat 1: SeaofLove collected ($0.25)
Seat 2: LanskyBanksy folded before Flop (didn't bet)
Seat 3: Varginho13 (button) folded before Flop (didn't bet)
Seat 4: PlayTheBlues4U (small blind) folded before Flop
Seat 5: Klytu (big blind) folded before Flop
Seat 6: 123tiger711a folded before Flop (didn't bet)



PokerStars Hand #204848299329:  Hold'em No Limit ($0.05/$0.10 USD) - 2019/10/21 21:33:07 ET
Table 'Hesperia' 6-max Seat #4 is the button
Seat 1: SeaofLove ($18.66 in chips) 
Seat 2: LanskyBanksy ($11.52 in chips) 
Seat 3: Varginho13 ($15.58 in chips) 
Seat 4: PlayTheBlues4U ($9.84 in chips) 
Seat 5: Klytu ($19.19 in chips) 
Seat 6: 123tiger711a ($10 in chips) 
Klytu: posts small blind $0.05
123tiger711a: posts big blind $0.10
*** HOLE CARDS ***
Dealt to PlayTheBlues4U [9d 2d]
SeaofLove: raises $0.15 to $0.25
LanskyBanksy: folds 
Varginho13: folds 
PlayTheBlues4U: folds 
Klytu: folds 
123tiger711a: calls $0.15
*** FLOP *** [6h 9h 2c]
123tiger711a: checks 
SeaofLove: bets $0.35
123tiger711a: folds 
Uncalled bet ($0.35) returned to SeaofLove
SeaofLove collected $0.52 from pot
SeaofLove: doesn't show hand 
*** SUMMARY ***
Total pot $0.55 | Rake $0.03 
Board [6h 9h 2c]
Seat 1: SeaofLove collected ($0.52)
Seat 2: LanskyBanksy folded before Flop (didn't bet)
Seat 3: Varginho13 folded before Flop (didn't bet)
Seat 4: PlayTheBlues4U (button) folded before Flop (didn't bet)
Seat 5: Klytu (small blind) folded before Flop
Seat 6: 123tiger711a (big blind) folded on the Flop



PokerStars Hand #204848299425:  Hold'em No Limit ($0.05/$0.10 USD) - 2019/10/21 21:33:29 ET
Table 'Hesperia' 6-max Seat #5 is the button
Seat 2: LanskyBanksy ($11.52 in chips) 
Seat 3: Varginho13 ($15.58 in chips) 
Seat 4: PlayTheBlues4U ($9.84 in chips) 
Seat 5: Klytu ($19.14 in chips) 
Seat 6: 123tiger711a ($10 in chips) 
123tiger711a: posts small blind $0.05
SeaofLove: is sitting out 
LanskyBanksy: posts big blind $0.10
*** HOLE CARDS ***
Dealt to PlayTheBlues4U [9d 6h]
SeaofLove leaves the table
Varginho13: folds 
PlayTheBlues4U: folds 
Klytu: folds 
123tiger711a: calls $0.05
LanskyBanksy: checks 
*** FLOP *** [3s Ah 4c]
123tiger711a: bets $0.10
LanskyBanksy: calls $0.10
*** TURN *** [3s Ah 4c] [9c]
123tiger711a: bets $0.38
LanskyBanksy: calls $0.38
*** RIVER *** [3s Ah 4c 9c] [Qd]
123tiger711a: checks 
LanskyBanksy: bets $1
123tiger711a: folds 
Uncalled bet ($1) returned to LanskyBanksy
LanskyBanksy collected $1.10 from pot
LanskyBanksy: doesn't show hand 
*** SUMMARY ***
Total pot $1.16 | Rake $0.06 
Board [3s Ah 4c 9c Qd]
Seat 2: LanskyBanksy (big blind) collected ($1.10)
Seat 3: Varginho13 folded before Flop (didn't bet)
Seat 4: PlayTheBlues4U folded before Flop (didn't bet)
Seat 5: Klytu (button) folded before Flop (didn't bet)
Seat 6: 123tiger711a (small blind) folded on the River



PokerStars Hand #204848299614:  Hold'em No Limit ($0.05/$0.10 USD) - 2019/10/21 21:34:11 ET
Table 'Hesperia' 6-max Seat #6 is the button
Seat 2: LanskyBanksy ($12.04 in chips) 
Seat 3: Varginho13 ($15.58 in chips) 
Seat 4: PlayTheBlues4U ($9.84 in chips) 
Seat 5: Klytu ($19.14 in chips) 
Seat 6: 123tiger711a ($10 in chips) 
LanskyBanksy: posts small blind $0.05
Varginho13: posts big blind $0.10
*** HOLE CARDS ***
Dealt to PlayTheBlues4U [8h 4d]
PlayTheBlues4U: folds 
Klytu: raises $0.20 to $0.30
123tiger711a: folds 
LanskyBanksy: folds 
Varginho13: folds 
Uncalled bet ($0.20) returned to Klytu
Klytu collected $0.25 from pot
Klytu: doesn't show hand 
*** SUMMARY ***
Total pot $0.25 | Rake $0 
Seat 2: LanskyBanksy (small blind) folded before Flop
Seat 3: Varginho13 (big blind) folded before Flop
Seat 4: PlayTheBlues4U folded before Flop (didn't bet)
Seat 5: Klytu collected ($0.25)
Seat 6: 123tiger711a (button) folded before Flop (didn't bet)



PokerStars Hand #204848299677:  Hold'em No Limit ($0.05/$0.10 USD) - 2019/10/21 21:34:25 ET
Table 'Hesperia' 6-max Seat #2 is the button
Seat 2: LanskyBanksy ($11.99 in chips) 
Seat 3: Varginho13 ($15.48 in chips) 
Seat 4: PlayTheBlues4U ($9.84 in chips) 
Seat 5: Klytu ($19.29 in chips) 
Seat 6: 123tiger711a ($10 in chips) 
Varginho13: posts small blind $0.05
PlayTheBlues4U: posts big blind $0.10
*** HOLE CARDS ***
Dealt to PlayTheBlues4U [4c Js]
Klytu: folds 
123tiger711a: folds 
LanskyBanksy: raises $0.10 to $0.20
Varginho13: calls $0.15
PlayTheBlues4U: folds 
*** FLOP *** [5d 5s 2h]
Varginho13: checks 
LanskyBanksy: checks 
*** TURN *** [5d 5s 2h] [Ad]
Varginho13: checks 
LanskyBanksy: checks 
*** RIVER *** [5d 5s 2h Ad] [Qc]
Varginho13: bets $1
LanskyBanksy: folds 
Uncalled bet ($1) returned to Varginho13
Varginho13 collected $0.48 from pot
*** SUMMARY ***
Total pot $0.50 | Rake $0.02 
Board [5d 5s 2h Ad Qc]
Seat 2: LanskyBanksy (button) folded on the River
Seat 3: Varginho13 (small blind) collected ($0.48)
Seat 4: PlayTheBlues4U (big blind) folded before Flop
Seat 5: Klytu folded before Flop (didn't bet)
Seat 6: 123tiger711a folded before Flop (didn't bet)



PokerStars Hand #204848299878:  Hold'em No Limit ($0.05/$0.10 USD) - 2019/10/21 21:35:08 ET
Table 'Hesperia' 6-max Seat #3 is the button
Seat 2: LanskyBanksy ($11.79 in chips) 
Seat 3: Varginho13 ($15.76 in chips) 
Seat 4: PlayTheBlues4U ($9.74 in chips) 
Seat 5: Klytu ($19.29 in chips) 
Seat 6: 123tiger711a ($10 in chips) 
PlayTheBlues4U: posts small blind $0.05
Klytu: posts big blind $0.10
*** HOLE CARDS ***
Dealt to PlayTheBlues4U [Jc Jh]
123tiger711a: folds 
LanskyBanksy: folds 
Varginho13: folds 
PlayTheBlues4U: raises $0.20 to $0.30
Klytu: calls $0.20
*** FLOP *** [Ah 9c Qh]
PlayTheBlues4U: bets $0.30
Klytu: calls $0.30
*** TURN *** [Ah 9c Qh] [3h]
PlayTheBlues4U: checks 
Klytu: checks 
*** RIVER *** [Ah 9c Qh 3h] [5d]
PlayTheBlues4U: checks 
Klytu: checks 
*** SHOW DOWN ***
PlayTheBlues4U: shows [Jc Jh] (a pair of Jacks)
Klytu: mucks hand 
PlayTheBlues4U collected $1.14 from pot
*** SUMMARY ***
Total pot $1.20 | Rake $0.06 
Board [Ah 9c Qh 3h 5d]
Seat 2: LanskyBanksy folded before Flop (didn't bet)
Seat 3: Varginho13 (button) folded before Flop (didn't bet)
Seat 4: PlayTheBlues4U (small blind) showed [Jc Jh] and won ($1.14) with a pair of Jacks
Seat 5: Klytu (big blind) mucked [Tc Jd]
Seat 6: 123tiger711a folded before Flop (didn't bet)



PokerStars Hand #204850108385:  Hold'em No Limit ($0.05/$0.10 USD) - 2019/10/21 21:35:57 ET
Table 'Hesperia' 6-max Seat #4 is the button
Seat 2: LanskyBanksy ($11.79 in chips) 
Seat 3: Varginho13 ($15.76 in chips) 
Seat 4: PlayTheBlues4U ($10.28 in chips) 
Seat 5: Klytu ($18.69 in chips) 
Seat 6: 123tiger711a ($10 in chips) 
Klytu: posts small blind $0.05
123tiger711a: posts big blind $0.10
*** HOLE CARDS ***
Dealt to PlayTheBlues4U [Ah 3s]
LanskyBanksy: folds 
Varginho13: raises $0.20 to $0.30
PlayTheBlues4U: calls $0.30
BigBlue joins the table at seat #1 
Klytu: calls $0.25
123tiger711a: folds 
*** FLOP *** [Qs As Qc]
Klytu: checks 
Varginho13: checks 
PlayTheBlues4U: bets $0.50
Klytu: folds 
Varginho13: calls $0.50
*** TURN *** [Qs As Qc] [2c]
Varginho13: checks 
PlayTheBlues4U: checks 
*** RIVER *** [Qs As Qc 2c] [6d]
Varginho13: checks 
PlayTheBlues4U: bets $1
Varginho13: folds 
Uncalled bet ($1) returned to PlayTheBlues4U
PlayTheBlues4U collected $1.90 from pot
PlayTheBlues4U: doesn't show hand 
*** SUMMARY ***
Total pot $2 | Rake $0.10 
Board [Qs As Qc 2c 6d]
Seat 2: LanskyBanksy folded before Flop (didn't bet)
Seat 3: Varginho13 folded on the River
Seat 4: PlayTheBlues4U (button) collected ($1.90)
Seat 5: Klytu (small blind) folded on the Flop
Seat 6: 123tiger711a (big blind) folded before Flop



PokerStars Hand #204850109058:  Hold'em No Limit ($0.05/$0.10 USD) - 2019/10/21 21:38:17 ET
Table 'Hesperia' 6-max Seat #5 is the button
Seat 1: BigBlue ($8 in chips) 
Seat 2: LanskyBanksy ($11.79 in chips) 
Seat 3: Varginho13 ($14.96 in chips) 
Seat 4: PlayTheBlues4U ($11.38 in chips) 
Seat 5: Klytu ($18.39 in chips) 
Seat 6: 123tiger711a ($10 in chips) 
123tiger711a: posts small blind $0.05
BigBlue: posts big blind $0.10
*** HOLE CARDS ***
Dealt to PlayTheBlues4U [Js Ac]
LanskyBanksy: folds 
Varginho13 has timed out
Varginho13: folds 
PlayTheBlues4U: raises $0.20 to $0.30
Klytu: calls $0.30
123tiger711a: folds 
BigBlue: folds 
*** FLOP *** [8s 5s Ks]
PlayTheBlues4U: checks 
Klytu: bets $0.50
PlayTheBlues4U: calls $0.50
*** TURN *** [8s 5s Ks] [Jh]
PlayTheBlues4U: checks 
Klytu: bets $1.20
PlayTheBlues4U: folds 
Uncalled bet ($1.20) returned to Klytu
Klytu collected $1.66 from pot
Klytu: doesn't show hand 
*** SUMMARY ***
Total pot $1.75 | Rake $0.09 
Board [8s 5s Ks Jh]
Seat 1: BigBlue (big blind) folded before Flop
Seat 2: LanskyBanksy folded before Flop (didn't bet)
Seat 3: Varginho13 folded before Flop (didn't bet)
Seat 4: PlayTheBlues4U folded on the Turn
Seat 5: Klytu (button) collected ($1.66)
Seat 6: 123tiger711a (small blind) folded before Flop



PokerStars Hand #204850109407:  Hold'em No Limit ($0.05/$0.10 USD) - 2019/10/21 21:39:32 ET
Table 'Hesperia' 6-max Seat #6 is the button
Seat 1: BigBlue ($7.90 in chips) 
Seat 2: LanskyBanksy ($11.79 in chips) 
Seat 3: Varginho13 ($14.96 in chips) 
Seat 4: PlayTheBlues4U ($10.58 in chips) 
Seat 5: Klytu ($19.25 in chips) 
Seat 6: 123tiger711a ($10 in chips) 
BigBlue: posts small blind $0.05
LanskyBanksy: posts big blind $0.10
*** HOLE CARDS ***
Dealt to PlayTheBlues4U [7s 6s]
Varginho13: folds 
PlayTheBlues4U: folds 
Klytu: raises $0.20 to $0.30
123tiger711a: calls $0.30
BigBlue: folds 
LanskyBanksy: folds 
*** FLOP *** [8h Ks 6c]
Klytu: bets $0.45
123tiger711a: calls $0.45
*** TURN *** [8h Ks 6c] [Qd]
Klytu: checks 
123tiger711a: checks 
*** RIVER *** [8h Ks 6c Qd] [Kd]
Klytu: bets $1.05
123tiger711a: folds 
Uncalled bet ($1.05) returned to Klytu
Klytu collected $1.57 from pot
Klytu: doesn't show hand 
*** SUMMARY ***
Total pot $1.65 | Rake $0.08 
Board [8h Ks 6c Qd Kd]
Seat 1: BigBlue (small blind) folded before Flop
Seat 2: LanskyBanksy (big blind) folded before Flop
Seat 3: Varginho13 folded before Flop (didn't bet)
Seat 4: PlayTheBlues4U folded before Flop (didn't bet)
Seat 5: Klytu collected ($1.57)
Seat 6: 123tiger711a (button) folded on the River



PokerStars Hand #204850109563:  Hold'em No Limit ($0.05/$0.10 USD) - 2019/10/21 21:40:08 ET
Table 'Hesperia' 6-max Seat #1 is the button
Seat 1: BigBlue ($7.85 in chips) 
Seat 2: LanskyBanksy ($11.69 in chips) 
Seat 3: Varginho13 ($14.96 in chips) 
Seat 4: PlayTheBlues4U ($10.58 in chips) 
Seat 5: Klytu ($20.07 in chips) 
Seat 6: 123tiger711a ($10 in chips) 
LanskyBanksy: posts small blind $0.05
Varginho13: posts big blind $0.10
*** HOLE CARDS ***
Dealt to PlayTheBlues4U [Ks 9c]
PlayTheBlues4U: folds 
Klytu: raises $0.20 to $0.30
123tiger711a: folds 
BigBlue: folds 
LanskyBanksy: folds 
Varginho13: folds 
Uncalled bet ($0.20) returned to Klytu
Klytu collected $0.25 from pot
Klytu: doesn't show hand 
*** SUMMARY ***
Total pot $0.25 | Rake $0 
Seat 1: BigBlue (button) folded before Flop (didn't bet)
Seat 2: LanskyBanksy (small blind) folded before Flop
Seat 3: Varginho13 (big blind) folded before Flop
Seat 4: PlayTheBlues4U folded before Flop (didn't bet)
Seat 5: Klytu collected ($0.25)
Seat 6: 123tiger711a folded before Flop (didn't bet)



PokerStars Hand #204850109658:  Hold'em No Limit ($0.05/$0.10 USD) - 2019/10/21 21:40:29 ET
Table 'Hesperia' 6-max Seat #2 is the button
Seat 1: BigBlue ($7.85 in chips) 
Seat 2: LanskyBanksy ($11.64 in chips) 
Seat 3: Varginho13 ($14.86 in chips) 
Seat 4: PlayTheBlues4U ($10.58 in chips) 
Seat 5: Klytu ($20.22 in chips) 
Seat 6: 123tiger711a ($10 in chips) 
Varginho13: posts small blind $0.05
PlayTheBlues4U: posts big blind $0.10
*** HOLE CARDS ***
Dealt to PlayTheBlues4U [Qc 5d]
Klytu: folds 
123tiger711a: folds 
BigBlue: raises $0.15 to $0.25
LanskyBanksy: calls $0.25
Varginho13: folds 
PlayTheBlues4U: folds 
*** FLOP *** [3h Kd 9d]
BigBlue: checks 
LanskyBanksy: checks 
*** TURN *** [3h Kd 9d] [Ts]
BigBlue: bets $0.30
LanskyBanksy: calls $0.30
*** RIVER *** [3h Kd 9d Ts] [Qd]
BigBlue: checks 
LanskyBanksy: bets $0.90
BigBlue: folds 
Uncalled bet ($0.90) returned to LanskyBanksy
LanskyBanksy collected $1.19 from pot
LanskyBanksy: doesn't show hand 
*** SUMMARY ***
Total pot $1.25 | Rake $0.06 
Board [3h Kd 9d Ts Qd]
Seat 1: BigBlue folded on the River
Seat 2: LanskyBanksy (button) collected ($1.19)
Seat 3: Varginho13 (small blind) folded before Flop
Seat 4: PlayTheBlues4U (big blind) folded before Flop
Seat 5: Klytu folded before Flop (didn't bet)
Seat 6: 123tiger711a folded before Flop (didn't bet)



PokerStars Hand #204850109872:  Hold'em No Limit ($0.05/$0.10 USD) - 2019/10/21 21:41:15 ET
Table 'Hesperia' 6-max Seat #3 is the button
Seat 1: BigBlue ($7.30 in chips) 
Seat 2: LanskyBanksy ($12.28 in chips) 
Seat 3: Varginho13 ($14.81 in chips) 
Seat 4: PlayTheBlues4U ($10.48 in chips) 
Seat 5: Klytu ($20.22 in chips) 
Seat 6: 123tiger711a ($10 in chips) 
PlayTheBlues4U: posts small blind $0.05
Klytu: posts big blind $0.10
*** HOLE CARDS ***
Dealt to PlayTheBlues4U [Kc 2h]
123tiger711a: folds 
BigBlue: folds 
LanskyBanksy: folds 
Varginho13: raises $0.20 to $0.30
PlayTheBlues4U: folds 
Klytu: folds 
Uncalled bet ($0.20) returned to Varginho13
Varginho13 collected $0.25 from pot
*** SUMMARY ***
Total pot $0.25 | Rake $0 
Seat 1: BigBlue folded before Flop (didn't bet)
Seat 2: LanskyBanksy folded before Flop (didn't bet)
Seat 3: Varginho13 (button) collected ($0.25)
Seat 4: PlayTheBlues4U (small blind) folded before Flop
Seat 5: Klytu (big blind) folded before Flop
Seat 6: 123tiger711a folded before Flop (didn't bet)



PokerStars Hand #204850617804:  Hold'em No Limit ($0.05/$0.10 USD) - 2019/10/21 21:41:43 ET
Table 'Hesperia' 6-max Seat #4 is the button
Seat 1: BigBlue ($7.30 in chips) 
Seat 2: LanskyBanksy ($12.28 in chips) 
Seat 3: Varginho13 ($14.96 in chips) 
Seat 4: PlayTheBlues4U ($10.43 in chips) 
Seat 5: Klytu ($20.12 in chips) 
Seat 6: 123tiger711a ($10 in chips) 
Klytu: posts small blind $0.05
123tiger711a: posts big blind $0.10
*** HOLE CARDS ***
Dealt to PlayTheBlues4U [Jd Td]
BigBlue: folds 
LanskyBanksy: calls $0.10
Varginho13: folds 
PlayTheBlues4U: raises $0.20 to $0.30
Klytu: folds 
123tiger711a: calls $0.20
LanskyBanksy: calls $0.20
*** FLOP *** [5s 6s 9h]
123tiger711a: checks 
LanskyBanksy: bets $0.50
PlayTheBlues4U: folds 
123tiger711a: folds 
Uncalled bet ($0.50) returned to LanskyBanksy
LanskyBanksy collected $0.90 from pot
LanskyBanksy: doesn't show hand 
*** SUMMARY ***
Total pot $0.95 | Rake $0.05 
Board [5s 6s 9h]
Seat 1: BigBlue folded before Flop (didn't bet)
Seat 2: LanskyBanksy collected ($0.90)
Seat 3: Varginho13 folded before Flop (didn't bet)
Seat 4: PlayTheBlues4U (button) folded on the Flop
Seat 5: Klytu (small blind) folded before Flop
Seat 6: 123tiger711a (big blind) folded on the Flop



PokerStars Hand #204850618051:  Hold'em No Limit ($0.05/$0.10 USD) - 2019/10/21 21:42:36 ET
Table 'Hesperia' 6-max Seat #5 is the button
Seat 1: BigBlue ($7.30 in chips) 
Seat 2: LanskyBanksy ($12.88 in chips) 
Seat 3: Varginho13 ($14.96 in chips) 
Seat 4: PlayTheBlues4U ($10.13 in chips) 
Seat 5: Klytu ($20.07 in chips) 
Seat 6: 123tiger711a ($10 in chips) 
123tiger711a: posts small blind $0.05
BigBlue: posts big blind $0.10
*** HOLE CARDS ***
Dealt to PlayTheBlues4U [Js 4c]
LanskyBanksy: folds 
Varginho13: folds 
PlayTheBlues4U: folds 
Klytu: raises $0.15 to $0.25
123tiger711a: calls $0.20
BigBlue: calls $0.15
*** FLOP *** [3d 3h Ah]
123tiger711a: checks 
BigBlue: checks 
Klytu: bets $0.35
123tiger711a: folds 
BigBlue: folds 
Uncalled bet ($0.35) returned to Klytu
Klytu collected $0.71 from pot
Klytu: doesn't show hand 
*** SUMMARY ***
Total pot $0.75 | Rake $0.04 
Board [3d 3h Ah]
Seat 1: BigBlue (big blind) folded on the Flop
Seat 2: LanskyBanksy folded before Flop (didn't bet)
Seat 3: Varginho13 folded before Flop (didn't bet)
Seat 4: PlayTheBlues4U folded before Flop (didn't bet)
Seat 5: Klytu (button) collected ($0.71)
Seat 6: 123tiger711a (small blind) folded on the Flop



PokerStars Hand #204850618192:  Hold'em No Limit ($0.05/$0.10 USD) - 2019/10/21 21:43:06 ET
Table 'Hesperia' 6-max Seat #6 is the button
Seat 1: BigBlue ($7.05 in chips) 
Seat 2: LanskyBanksy ($12.88 in chips) 
Seat 3: Varginho13 ($14.96 in chips) 
Seat 4: PlayTheBlues4U ($10.13 in chips) 
Seat 5: Klytu ($20.53 in chips) 
Seat 6: 123tiger711a ($10 in chips) 
BigBlue: posts small blind $0.05
LanskyBanksy: posts big blind $0.10
*** HOLE CARDS ***
Dealt to PlayTheBlues4U [9c As]
Varginho13: folds 
PlayTheBlues4U: folds 
Klytu: raises $0.15 to $0.25
123tiger711a: calls $0.25
BigBlue: calls $0.20
LanskyBanksy: folds 
*** FLOP *** [Td 9s 5c]
BigBlue: checks 
Klytu: bets $0.40
123tiger711a: raises $0.40 to $0.80
BigBlue: folds 
Klytu: calls $0.40
*** TURN *** [Td 9s 5c] [9h]
Klytu: checks 
123tiger711a: bets $2.33
Klytu: folds 
Uncalled bet ($2.33) returned to 123tiger711a
123tiger711a collected $2.33 from pot
*** SUMMARY ***
Total pot $2.45 | Rake $0.12 
Board [Td 9s 5c 9h]
Seat 1: BigBlue (small blind) folded on the Flop
Seat 2: LanskyBanksy (big blind) folded before Flop
Seat 3: Varginho13 folded before Flop (didn't bet)
Seat 4: PlayTheBlues4U folded before Flop (didn't bet)
Seat 5: Klytu folded on the Turn
Seat 6: 123tiger711a (button) collected ($2.33)



PokerStars Hand #204850618342:  Hold'em No Limit ($0.05/$0.10 USD) - 2019/10/21 21:43:40 ET
Table 'Hesperia' 6-max Seat #1 is the button
Seat 1: BigBlue ($6.80 in chips) 
Seat 2: LanskyBanksy ($12.78 in chips) 
Seat 3: Varginho13 ($14.96 in chips) 
Seat 4: PlayTheBlues4U ($10.13 in chips) 
Seat 5: Klytu ($19.48 in chips) 
Seat 6: 123tiger711a ($11.28 in chips) 
LanskyBanksy: posts small blind $0.05
Varginho13: posts big blind $0.10
*** HOLE CARDS ***
Dealt to PlayTheBlues4U [5c Qs]
PlayTheBlues4U: folds 
Klytu: folds 
123tiger711a: folds 
BigBlue: raises $0.15 to $0.25
LanskyBanksy: folds 
Varginho13: folds 
Uncalled bet ($0.15) returned to BigBlue
BigBlue collected $0.25 from pot
BigBlue: doesn't show hand 
*** SUMMARY ***
Total pot $0.25 | Rake $0 
Seat 1: BigBlue (button) collected ($0.25)
Seat 2: LanskyBanksy (small blind) folded before Flop
Seat 3: Varginho13 (big blind) folded before Flop
Seat 4: PlayTheBlues4U folded before Flop (didn't bet)
Seat 5: Klytu folded before Flop (didn't bet)
Seat 6: 123tiger711a folded before Flop (didn't bet)



PokerStars Hand #204850618420:  Hold'em No Limit ($0.05/$0.10 USD) - 2019/10/21 21:43:59 ET
Table 'Hesperia' 6-max Seat #2 is the button
Seat 1: BigBlue ($6.95 in chips) 
Seat 2: LanskyBanksy ($12.73 in chips) 
Seat 3: Varginho13 ($14.86 in chips) 
Seat 4: PlayTheBlues4U ($10.13 in chips) 
Seat 5: Klytu ($19.48 in chips) 
Seat 6: 123tiger711a ($11.28 in chips) 
Varginho13: posts small blind $0.05
PlayTheBlues4U: posts big blind $0.10
*** HOLE CARDS ***
Dealt to PlayTheBlues4U [3c 9d]
Klytu: folds 
123tiger711a: folds 
BigBlue: folds 
LanskyBanksy: raises $0.20 to $0.30
Varginho13: folds 
PlayTheBlues4U: folds 
Uncalled bet ($0.20) returned to LanskyBanksy
LanskyBanksy collected $0.25 from pot
LanskyBanksy: doesn't show hand 
*** SUMMARY ***
Total pot $0.25 | Rake $0 
Seat 1: BigBlue folded before Flop (didn't bet)
Seat 2: LanskyBanksy (button) collected ($0.25)
Seat 3: Varginho13 (small blind) folded before Flop
Seat 4: PlayTheBlues4U (big blind) folded before Flop
Seat 5: Klytu folded before Flop (didn't bet)
Seat 6: 123tiger711a folded before Flop (didn't bet)



PokerStars Hand #204850618531:  Hold'em No Limit ($0.05/$0.10 USD) - 2019/10/21 21:44:21 ET
Table 'Hesperia' 6-max Seat #4 is the button
Seat 1: BigBlue ($6.95 in chips) 
Seat 2: LanskyBanksy ($12.88 in chips) 
Seat 4: PlayTheBlues4U ($10.03 in chips) 
Seat 5: Klytu ($19.48 in chips) 
Seat 6: 123tiger711a ($11.28 in chips) 
Klytu: posts small blind $0.05
123tiger711a: posts big blind $0.10
*** HOLE CARDS ***
Dealt to PlayTheBlues4U [3d 9d]
BigBlue: folds 
LanskyBanksy: folds 
PlayTheBlues4U: folds 
Klytu: raises $0.20 to $0.30
123tiger711a: calls $0.20
*** FLOP *** [6c 9c 2h]
Klytu: bets $0.30
123tiger711a: calls $0.30
*** TURN *** [6c 9c 2h] [3c]
Klytu: checks 
123tiger711a: checks 
*** RIVER *** [6c 9c 2h 3c] [6d]
Klytu: checks 
123tiger711a: checks 
*** SHOW DOWN ***
Klytu: shows [4d Ad] (a pair of Sixes)
123tiger711a: mucks hand 
Klytu collected $1.14 from pot
*** SUMMARY ***
Total pot $1.20 | Rake $0.06 
Board [6c 9c 2h 3c 6d]
Seat 1: BigBlue folded before Flop (didn't bet)
Seat 2: LanskyBanksy folded before Flop (didn't bet)
Seat 4: PlayTheBlues4U (button) folded before Flop (didn't bet)
Seat 5: Klytu (small blind) showed [4d Ad] and won ($1.14) with a pair of Sixes
Seat 6: 123tiger711a (big blind) mucked [Ks Js]



PokerStars Hand #204850618656:  Hold'em No Limit ($0.05/$0.10 USD) - 2019/10/21 21:44:48 ET
Table 'Hesperia' 6-max Seat #5 is the button
Seat 1: BigBlue ($6.95 in chips) 
Seat 2: LanskyBanksy ($12.88 in chips) 
Seat 4: PlayTheBlues4U ($10.03 in chips) 
Seat 5: Klytu ($20.02 in chips) 
Seat 6: 123tiger711a ($10.68 in chips) 
123tiger711a: posts small blind $0.05
BigBlue: posts big blind $0.10
*** HOLE CARDS ***
Dealt to PlayTheBlues4U [Ks Th]
LanskyBanksy: raises $0.20 to $0.30
PlayTheBlues4U: folds 
Klytu: folds 
123tiger711a: folds 
BigBlue: folds 
Uncalled bet ($0.20) returned to LanskyBanksy
LanskyBanksy collected $0.25 from pot
LanskyBanksy: doesn't show hand 
*** SUMMARY ***
Total pot $0.25 | Rake $0 
Seat 1: BigBlue (big blind) folded before Flop
Seat 2: LanskyBanksy collected ($0.25)
Seat 4: PlayTheBlues4U folded before Flop (didn't bet)
Seat 5: Klytu (button) folded before Flop (didn't bet)
Seat 6: 123tiger711a (small blind) folded before Flop



PokerStars Hand #204850618715:  Hold'em No Limit ($0.05/$0.10 USD) - 2019/10/21 21:45:00 ET
Table 'Hesperia' 6-max Seat #6 is the button
Seat 1: BigBlue ($6.85 in chips) 
Seat 2: LanskyBanksy ($13.03 in chips) 
Seat 4: PlayTheBlues4U ($10.03 in chips) 
Seat 5: Klytu ($20.02 in chips) 
Seat 6: 123tiger711a ($10.63 in chips) 
BigBlue: posts small blind $0.05
LanskyBanksy: posts big blind $0.10
*** HOLE CARDS ***
Dealt to PlayTheBlues4U [Ad Ts]
PlayTheBlues4U: raises $0.20 to $0.30
Klytu: calls $0.30
123tiger711a: folds 
BigBlue: folds 
LanskyBanksy: calls $0.20
*** FLOP *** [8h Js Kc]
LanskyBanksy: checks 
PlayTheBlues4U: checks 
Klytu: checks 
*** TURN *** [8h Js Kc] [2c]
LanskyBanksy: checks 
PlayTheBlues4U: checks 
Klytu: bets $0.45
LanskyBanksy: folds 
PlayTheBlues4U: calls $0.45
*** RIVER *** [8h Js Kc 2c] [6s]
PlayTheBlues4U: checks 
Klytu: checks 
*** SHOW DOWN ***
PlayTheBlues4U: shows [Ad Ts] (high card Ace)
Klytu: mucks hand 
PlayTheBlues4U collected $1.76 from pot
*** SUMMARY ***
Total pot $1.85 | Rake $0.09 
Board [8h Js Kc 2c 6s]
Seat 1: BigBlue (small blind) folded before Flop
Seat 2: LanskyBanksy (big blind) folded on the Turn
Seat 4: PlayTheBlues4U showed [Ad Ts] and won ($1.76) with high card Ace
Seat 5: Klytu mucked [Qc 9c]
Seat 6: 123tiger711a (button) folded before Flop (didn't bet)



PokerStars Hand #204850619012:  Hold'em No Limit ($0.05/$0.10 USD) - 2019/10/21 21:46:02 ET
Table 'Hesperia' 6-max Seat #1 is the button
Seat 1: BigBlue ($6.80 in chips) 
Seat 2: LanskyBanksy ($12.73 in chips) 
Seat 4: PlayTheBlues4U ($11.04 in chips) 
Seat 5: Klytu ($19.27 in chips) 
Seat 6: 123tiger711a ($10.63 in chips) 
LanskyBanksy: posts small blind $0.05
PlayTheBlues4U: posts big blind $0.10
*** HOLE CARDS ***
Dealt to PlayTheBlues4U [3h Tc]
Klytu: folds 
123tiger711a: folds 
BigBlue: raises $0.15 to $0.25
LanskyBanksy: folds 
PlayTheBlues4U: folds 
Uncalled bet ($0.15) returned to BigBlue
BigBlue collected $0.25 from pot
BigBlue: doesn't show hand 
*** SUMMARY ***
Total pot $0.25 | Rake $0 
Seat 1: BigBlue (button) collected ($0.25)
Seat 2: LanskyBanksy (small blind) folded before Flop
Seat 4: PlayTheBlues4U (big blind) folded before Flop
Seat 5: Klytu folded before Flop (didn't bet)
Seat 6: 123tiger711a folded before Flop (didn't bet)



PokerStars Hand #204850619088:  Hold'em No Limit ($0.05/$0.10 USD) - 2019/10/21 21:46:17 ET
Table 'Hesperia' 6-max Seat #2 is the button
Seat 1: BigBlue ($6.95 in chips) 
Seat 2: LanskyBanksy ($12.68 in chips) 
Seat 4: PlayTheBlues4U ($10.94 in chips) 
Seat 5: Klytu ($19.27 in chips) 
Seat 6: 123tiger711a ($10.63 in chips) 
PlayTheBlues4U: posts small blind $0.05
Klytu: posts big blind $0.10
*** HOLE CARDS ***
Dealt to PlayTheBlues4U [4s 5s]
123tiger711a: folds 
BigBlue: folds 
LanskyBanksy: folds 
PlayTheBlues4U: raises $0.15 to $0.25
Klytu: folds 
Uncalled bet ($0.15) returned to PlayTheBlues4U
PlayTheBlues4U collected $0.20 from pot
PlayTheBlues4U: doesn't show hand 
*** SUMMARY ***
Total pot $0.20 | Rake $0 
Seat 1: BigBlue folded before Flop (didn't bet)
Seat 2: LanskyBanksy (button) folded before Flop (didn't bet)
Seat 4: PlayTheBlues4U (small blind) collected ($0.20)
Seat 5: Klytu (big blind) folded before Flop
Seat 6: 123tiger711a folded before Flop (didn't bet)



PokerStars Hand #204850619177:  Hold'em No Limit ($0.05/$0.10 USD) - 2019/10/21 21:46:38 ET
Table 'Hesperia' 6-max Seat #4 is the button
Seat 1: BigBlue ($6.95 in chips) 
Seat 2: LanskyBanksy ($12.68 in chips) 
Seat 4: PlayTheBlues4U ($11.04 in chips) 
Seat 5: Klytu ($19.17 in chips) 
Seat 6: 123tiger711a ($10.63 in chips) 
Klytu: posts small blind $0.05
123tiger711a: posts big blind $0.10
*** HOLE CARDS ***
Dealt to PlayTheBlues4U [2d 9h]
BigBlue: folds 
LanskyBanksy: folds 
PlayTheBlues4U: folds 
Klytu: folds 
Uncalled bet ($0.05) returned to 123tiger711a
123tiger711a collected $0.10 from pot
*** SUMMARY ***
Total pot $0.10 | Rake $0 
Seat 1: BigBlue folded before Flop (didn't bet)
Seat 2: LanskyBanksy folded before Flop (didn't bet)
Seat 4: PlayTheBlues4U (button) folded before Flop (didn't bet)
Seat 5: Klytu (small blind) folded before Flop
Seat 6: 123tiger711a (big blind) collected ($0.10)



PokerStars Hand #204850619218:  Hold'em No Limit ($0.05/$0.10 USD) - 2019/10/21 21:46:49 ET
Table 'Hesperia' 6-max Seat #5 is the button
Seat 1: BigBlue ($6.95 in chips) 
Seat 2: LanskyBanksy ($12.68 in chips) 
Seat 4: PlayTheBlues4U ($11.04 in chips) 
Seat 5: Klytu ($19.12 in chips) 
Seat 6: 123tiger711a ($10.68 in chips) 
123tiger711a: posts small blind $0.05
BigBlue: posts big blind $0.10
*** HOLE CARDS ***
Dealt to PlayTheBlues4U [2d Js]
LanskyBanksy: raises $0.20 to $0.30
PlayTheBlues4U: folds 
Klytu: folds 
123tiger711a: calls $0.25
BigBlue: folds 
*** FLOP *** [Qs Kh 6s]
123tiger711a: checks 
LanskyBanksy: checks 
*** TURN *** [Qs Kh 6s] [9c]
123tiger711a: checks 
LanskyBanksy: checks 
*** RIVER *** [Qs Kh 6s 9c] [4d]
123tiger711a: checks 
LanskyBanksy: checks 
*** SHOW DOWN ***
123tiger711a: shows [6d Ad] (a pair of Sixes)
LanskyBanksy: mucks hand 
123tiger711a collected $0.66 from pot
*** SUMMARY ***
Total pot $0.70 | Rake $0.04 
Board [Qs Kh 6s 9c 4d]
Seat 1: BigBlue (big blind) folded before Flop
Seat 2: LanskyBanksy mucked [Jh Ah]
Seat 4: PlayTheBlues4U folded before Flop (didn't bet)
Seat 5: Klytu (button) folded before Flop (didn't bet)
Seat 6: 123tiger711a (small blind) showed [6d Ad] and won ($0.66) with a pair of Sixes



PokerStars Hand #205379006821:  Hold'em No Limit ($0.05/$0.10 USD) - 2019/11/02 22:52:32 ET
Table 'Hekate' 6-max Seat #3 is the button
Seat 3: PlayTheBlues4U ($44.07 in chips)
Seat 4: SeaofLove ($13.10 in chips)
Seat 6: Ty1erDurrden ($17.10 in chips)
SeaofLove: posts small blind $0.05
Ty1erDurrden: posts big blind $0.10
*** HOLE CARDS ***
Dealt to PlayTheBlues4U [Ts 8s]
PlayTheBlues4U: raises $0.20 to $0.30
SeaofLove: folds
Ty1erDurrden: calls $0.20
*** FLOP *** [8d Qh 2s]
Ty1erDurrden: checks
PlayTheBlues4U: bets $0.40
Ty1erDurrden: calls $0.40
*** TURN *** [8d Qh 2s] [9d]
Ty1erDurrden: checks
PlayTheBlues4U: checks
*** RIVER *** [8d Qh 2s 9d] [4c]
Ty1erDurrden: checks
PlayTheBlues4U: checks
*** SHOW DOWN ***
Ty1erDurrden: shows [8c Jh] (a pair of Eights)
PlayTheBlues4U: mucks hand
Ty1erDurrden collected $1.38 from pot
*** SUMMARY ***
Total pot $1.45 | Rake $0.07
Board [8d Qh 2s 9d 4c]
Seat 3: PlayTheBlues4U (button) mucked [Ts 8s]
Seat 4: SeaofLove (small blind) folded before Flop
Seat 6: Ty1erDurrden (big blind) showed [8c Jh] and won ($1.38) with a pair of Eights


PokerStars Hand #205379006773:  Hold'em No Limit ($0.05/$0.10 USD) - 2019/11/02 22:52:19 ET
Table 'Hekate' 6-max Seat #6 is the button
Seat 3: PlayTheBlues4U ($44.12 in chips)
Seat 4: SeaofLove ($13.05 in chips)
Seat 6: Ty1erDurrden ($17.10 in chips)
PlayTheBlues4U: posts small blind $0.05
SeaofLove: posts big blind $0.10
*** HOLE CARDS ***
Dealt to PlayTheBlues4U [Td 8c]
SourShoes9 leaves the table
Ty1erDurrden: folds
PlayTheBlues4U: folds
Uncalled bet ($0.05) returned to SeaofLove
SeaofLove collected $0.10 from pot
SeaofLove: doesn't show hand
*** SUMMARY ***
Total pot $0.10 | Rake $0
Seat 3: PlayTheBlues4U (small blind) folded before Flop
Seat 4: SeaofLove (big blind) collected ($0.10)
Seat 6: Ty1erDurrden (button) folded before Flop (didn't bet)


PokerStars Hand #205379006712:  Hold'em No Limit ($0.05/$0.10 USD) - 2019/11/02 22:52:06 ET
Table 'Hekate' 6-max Seat #4 is the button
Seat 1: SourShoes9 ($14.18 in chips)
Seat 3: PlayTheBlues4U ($44.12 in chips)
Seat 4: SeaofLove ($12.90 in chips)
Seat 6: Ty1erDurrden ($17.15 in chips)
Ty1erDurrden: posts small blind $0.05
SourShoes9: posts big blind $0.10
*** HOLE CARDS ***
Dealt to PlayTheBlues4U [9d 4d]
PlayTheBlues4U: folds
SeaofLove: raises $0.15 to $0.25
Ty1erDurrden: folds
SourShoes9: folds
Uncalled bet ($0.15) returned to SeaofLove
SeaofLove collected $0.25 from pot
SeaofLove: doesn't show hand
*** SUMMARY ***
Total pot $0.25 | Rake $0
Seat 1: SourShoes9 (big blind) folded before Flop
Seat 3: PlayTheBlues4U folded before Flop (didn't bet)
Seat 4: SeaofLove (button) collected ($0.25)
Seat 6: Ty1erDurrden (small blind) folded before Flop


PokerStars Hand #205379006507:  Hold'em No Limit ($0.05/$0.10 USD) - 2019/11/02 22:51:08 ET
Table 'Hekate' 6-max Seat #3 is the button
Seat 1: SourShoes9 ($9.32 in chips)
Seat 3: PlayTheBlues4U ($46.72 in chips)
Seat 4: SeaofLove ($12.95 in chips)
Seat 6: Ty1erDurrden ($19.75 in chips)
SeaofLove: posts small blind $0.05
Ty1erDurrden: posts big blind $0.10
*** HOLE CARDS ***
Dealt to PlayTheBlues4U [9c Tc]
SourShoes9: calls $0.10
PlayTheBlues4U: raises $0.20 to $0.30
SeaofLove: folds
Ty1erDurrden: calls $0.20
SourShoes9: calls $0.20
*** FLOP *** [Jc 7h 7c]
Ty1erDurrden: checks
SourShoes9: checks
PlayTheBlues4U: bets $0.50
Ty1erDurrden: calls $0.50
SourShoes9: calls $0.50
*** TURN *** [Jc 7h 7c] [5c]
Ty1erDurrden: checks
SourShoes9: checks
PlayTheBlues4U: bets $1.80
Ty1erDurrden: calls $1.80
SourShoes9: calls $1.80
*** RIVER *** [Jc 7h 7c 5c] [4c]
Ty1erDurrden: checks
SourShoes9: checks
PlayTheBlues4U: checks
*** SHOW DOWN ***
Ty1erDurrden: shows [7s As] (three of a kind, Sevens)
SourShoes9: shows [Ts Kc] (a flush, King high)
PlayTheBlues4U: mucks hand
SourShoes9 collected $7.46 from pot
*** SUMMARY ***
Total pot $7.85 | Rake $0.39
Board [Jc 7h 7c 5c 4c]
Seat 1: SourShoes9 showed [Ts Kc] and won ($7.46) with a flush, King high
Seat 3: PlayTheBlues4U (button) mucked [9c Tc]
Seat 4: SeaofLove (small blind) folded before Flop
Seat 6: Ty1erDurrden (big blind) showed [7s As] and lost with three of a kind, Sevens


PokerStars Hand #205379006436:  Hold'em No Limit ($0.05/$0.10 USD) - 2019/11/02 22:50:52 ET
Table 'Hekate' 6-max Seat #1 is the button
Seat 1: SourShoes9 ($9.32 in chips)
Seat 3: PlayTheBlues4U ($46.82 in chips)
Seat 4: SeaofLove ($12.85 in chips)
Seat 6: Ty1erDurrden ($19.75 in chips)
PlayTheBlues4U: posts small blind $0.05
SeaofLove: posts big blind $0.10
*** HOLE CARDS ***
Dealt to PlayTheBlues4U [Ks 9s]
Ty1erDurrden: folds
SourShoes9: folds
PlayTheBlues4U: calls $0.05
SeaofLove: raises $0.20 to $0.30
PlayTheBlues4U: folds
Uncalled bet ($0.20) returned to SeaofLove
SeaofLove collected $0.20 from pot
SeaofLove: doesn't show hand
*** SUMMARY ***
Total pot $0.20 | Rake $0
Seat 1: SourShoes9 (button) folded before Flop (didn't bet)
Seat 3: PlayTheBlues4U (small blind) folded before Flop
Seat 4: SeaofLove (big blind) collected ($0.20)
Seat 6: Ty1erDurrden folded before Flop (didn't bet)


PokerStars Hand #205379006362:  Hold'em No Limit ($0.05/$0.10 USD) - 2019/11/02 22:50:31 ET
Table 'Antares' 6-max Seat #5 is the button
Seat 1: SeaofLove ($10.57 in chips)
Seat 2: PlayTheBlues4U ($15.34 in chips)
Seat 3: StickyChipss ($16.51 in chips)
Seat 4: tempusfugit3737 ($10.97 in chips)
Seat 5: skoalguy33 ($13.28 in chips)
Seat 6: hanklocic ($7.90 in chips)
hanklocic: posts small blind $0.05
SeaofLove: posts big blind $0.10
*** HOLE CARDS ***
Dealt to PlayTheBlues4U [2d Tc]
PlayTheBlues4U: folds
StickyChipss: folds
tempusfugit3737: raises $0.20 to $0.30
skoalguy33: calls $0.30
hanklocic: calls $0.25
SeaofLove: folds
*** FLOP *** [Ks Ad Kh]
hanklocic: checks
tempusfugit3737: checks
skoalguy33: bets $0.48
hanklocic: folds
tempusfugit3737: calls $0.48
*** TURN *** [Ks Ad Kh] [9d]
tempusfugit3737: checks
skoalguy33: bets $0.93
tempusfugit3737: folds
Uncalled bet ($0.93) returned to skoalguy33
skoalguy33 collected $1.86 from pot
skoalguy33: doesn't show hand
*** SUMMARY ***
Total pot $1.96 | Rake $0.10
Board [Ks Ad Kh 9d]
Seat 1: SeaofLove (big blind) folded before Flop
Seat 2: PlayTheBlues4U folded before Flop (didn't bet)
Seat 3: StickyChipss folded before Flop (didn't bet)
Seat 4: tempusfugit3737 folded on the Turn
Seat 5: skoalguy33 (button) collected ($1.86)
Seat 6: hanklocic (small blind) folded on the Flop


PokerStars Hand #205379006337:  Hold'em No Limit ($0.05/$0.10 USD) - 2019/11/02 22:50:27 ET
Table 'Hekate' 6-max Seat #6 is the button
Seat 1: SourShoes9 ($8.50 in chips)
Seat 3: PlayTheBlues4U ($46.92 in chips)
Seat 4: SeaofLove ($12.85 in chips)
Seat 6: Ty1erDurrden ($20.55 in chips)
SourShoes9: posts small blind $0.05
PlayTheBlues4U: posts big blind $0.10
*** HOLE CARDS ***
Dealt to PlayTheBlues4U [4d 7c]
SeaofLove: folds
Ty1erDurrden: raises $0.15 to $0.25
SourShoes9: raises $0.15 to $0.40
PlayTheBlues4U: folds
Ty1erDurrden: calls $0.15
*** FLOP *** [Qc Kh Ac]
SourShoes9: bets $0.40
Ty1erDurrden: calls $0.40
*** TURN *** [Qc Kh Ac] [5d]
SourShoes9: bets $0.80
Ty1erDurrden: folds
Uncalled bet ($0.80) returned to SourShoes9
SourShoes9 collected $1.62 from pot
SourShoes9: doesn't show hand
*** SUMMARY ***
Total pot $1.70 | Rake $0.08
Board [Qc Kh Ac 5d]
Seat 1: SourShoes9 (small blind) collected ($1.62)
Seat 3: PlayTheBlues4U (big blind) folded before Flop
Seat 4: SeaofLove folded before Flop (didn't bet)
Seat 6: Ty1erDurrden (button) folded on the Turn


PokerStars Hand #205379006276:  Hold'em No Limit ($0.05/$0.10 USD) - 2019/11/02 22:50:11 ET
Table 'Antares' 6-max Seat #4 is the button
Seat 1: SeaofLove ($10.57 in chips)
Seat 2: PlayTheBlues4U ($15.34 in chips)
Seat 3: StickyChipss ($16.51 in chips)
Seat 4: tempusfugit3737 ($10.82 in chips)
Seat 5: skoalguy33 ($13.33 in chips)
Seat 6: hanklocic ($8 in chips)
skoalguy33: posts small blind $0.05
hanklocic: posts big blind $0.10
*** HOLE CARDS ***
Dealt to PlayTheBlues4U [6s 8c]
SeaofLove: folds
PlayTheBlues4U: folds
StickyChipss: folds
tempusfugit3737: raises $0.20 to $0.30
skoalguy33: folds
hanklocic: folds
Uncalled bet ($0.20) returned to tempusfugit3737
tempusfugit3737 collected $0.25 from pot
tempusfugit3737: doesn't show hand
*** SUMMARY ***
Total pot $0.25 | Rake $0
Seat 1: SeaofLove folded before Flop (didn't bet)
Seat 2: PlayTheBlues4U folded before Flop (didn't bet)
Seat 3: StickyChipss folded before Flop (didn't bet)
Seat 4: tempusfugit3737 (button) collected ($0.25)
Seat 5: skoalguy33 (small blind) folded before Flop
Seat 6: hanklocic (big blind) folded before Flop


PokerStars Hand #205379006106:  Hold'em No Limit ($0.05/$0.10 USD) - 2019/11/02 22:49:28 ET
Table 'Antares' 6-max Seat #3 is the button
Seat 1: SeaofLove ($10.57 in chips)
Seat 2: PlayTheBlues4U ($15.34 in chips)
Seat 3: StickyChipss ($16.51 in chips)
Seat 4: tempusfugit3737 ($11.92 in chips)
Seat 5: skoalguy33 ($12.34 in chips)
tempusfugit3737: posts small blind $0.05
skoalguy33: posts big blind $0.10
hanklocic: sits out
*** HOLE CARDS ***
Dealt to PlayTheBlues4U [Ts Jc]
SeaofLove: folds
PlayTheBlues4U: folds
StickyChipss: folds
tempusfugit3737: raises $0.20 to $0.30
skoalguy33: raises $0.80 to $1.10
tempusfugit3737: calls $0.80
*** FLOP *** [2d 5h Th]
tempusfugit3737: checks
skoalguy33: bets $1.05
tempusfugit3737: folds
Uncalled bet ($1.05) returned to skoalguy33
skoalguy33 collected $2.09 from pot
skoalguy33: doesn't show hand
*** SUMMARY ***
Total pot $2.20 | Rake $0.11
Board [2d 5h Th]
Seat 1: SeaofLove folded before Flop (didn't bet)
Seat 2: PlayTheBlues4U folded before Flop (didn't bet)
Seat 3: StickyChipss (button) folded before Flop (didn't bet)
Seat 4: tempusfugit3737 (small blind) folded on the Flop
Seat 5: skoalguy33 (big blind) collected ($2.09)


PokerStars Hand #205379006104:  Hold'em No Limit ($0.05/$0.10 USD) - 2019/11/02 22:49:28 ET
Table 'Hekate' 6-max Seat #4 is the button
Seat 1: SourShoes9 ($9.70 in chips)
Seat 3: PlayTheBlues4U ($48.12 in chips)
Seat 4: SeaofLove ($12.85 in chips)
Seat 6: Ty1erDurrden ($18.33 in chips)
Ty1erDurrden: posts small blind $0.05
SourShoes9: posts big blind $0.10
*** HOLE CARDS ***
Dealt to PlayTheBlues4U [3c Ac]
PlayTheBlues4U: raises $0.20 to $0.30
SeaofLove: folds
Ty1erDurrden: raises $0.90 to $1.20
SourShoes9: calls $1.10
PlayTheBlues4U: calls $0.90
*** FLOP *** [6s 4h Js]
Ty1erDurrden: bets $1.50
SourShoes9: folds
PlayTheBlues4U: folds
Uncalled bet ($1.50) returned to Ty1erDurrden
Ty1erDurrden collected $3.42 from pot
Ty1erDurrden: doesn't show hand
*** SUMMARY ***
Total pot $3.60 | Rake $0.18
Board [6s 4h Js]
Seat 1: SourShoes9 (big blind) folded on the Flop
Seat 3: PlayTheBlues4U folded on the Flop
Seat 4: SeaofLove (button) folded before Flop (didn't bet)
Seat 6: Ty1erDurrden (small blind) collected ($3.42)


PokerStars Hand #205379006079:  Hold'em No Limit ($0.05/$0.10 USD) - 2019/11/02 22:49:21 ET
Table 'Hekate' 6-max Seat #3 is the button
Seat 1: SourShoes9 ($9.70 in chips)
Seat 3: PlayTheBlues4U ($48.12 in chips)
Seat 4: SeaofLove ($12.90 in chips)
Seat 6: Ty1erDurrden ($18.28 in chips)
SeaofLove: posts small blind $0.05
Ty1erDurrden: posts big blind $0.10
*** HOLE CARDS ***
Dealt to PlayTheBlues4U [Kh 6c]
SourShoes9: folds
PlayTheBlues4U: folds
SeaofLove: folds
Uncalled bet ($0.05) returned to Ty1erDurrden
Ty1erDurrden collected $0.10 from pot
Ty1erDurrden: doesn't show hand
*** SUMMARY ***
Total pot $0.10 | Rake $0
Seat 1: SourShoes9 folded before Flop (didn't bet)
Seat 3: PlayTheBlues4U (button) folded before Flop (didn't bet)
Seat 4: SeaofLove (small blind) folded before Flop
Seat 6: Ty1erDurrden (big blind) collected ($0.10)


PokerStars Hand #205379006038:  Hold'em No Limit ($0.05/$0.10 USD) - 2019/11/02 22:49:11 ET
Table 'Antares' 6-max Seat #2 is the button
Seat 1: SeaofLove ($10.42 in chips)
Seat 2: PlayTheBlues4U ($15.34 in chips)
Seat 3: StickyChipss ($16.56 in chips)
Seat 4: tempusfugit3737 ($12.02 in chips)
Seat 5: skoalguy33 ($12.34 in chips)
StickyChipss: posts small blind $0.05
tempusfugit3737: posts big blind $0.10
hanklocic: sits out
*** HOLE CARDS ***
Dealt to PlayTheBlues4U [6c 2c]
skoalguy33: folds
SeaofLove: raises $0.20 to $0.30
PlayTheBlues4U: folds
StickyChipss: folds
tempusfugit3737: folds
Uncalled bet ($0.20) returned to SeaofLove
SeaofLove collected $0.25 from pot
SeaofLove: doesn't show hand
*** SUMMARY ***
Total pot $0.25 | Rake $0
Seat 1: SeaofLove collected ($0.25)
Seat 2: PlayTheBlues4U (button) folded before Flop (didn't bet)
Seat 3: StickyChipss (small blind) folded before Flop
Seat 4: tempusfugit3737 (big blind) folded before Flop
Seat 5: skoalguy33 folded before Flop (didn't bet)


PokerStars Hand #205379005978:  Hold'em No Limit ($0.05/$0.10 USD) - 2019/11/02 22:48:55 ET
Table 'Antares' 6-max Seat #1 is the button
Seat 1: SeaofLove ($10.42 in chips)
Seat 2: PlayTheBlues4U ($15.39 in chips)
Seat 3: StickyChipss ($16.51 in chips)
Seat 4: tempusfugit3737 ($12.02 in chips)
Seat 5: skoalguy33 ($12.34 in chips)
PlayTheBlues4U: posts small blind $0.05
StickyChipss: posts big blind $0.10
*** HOLE CARDS ***
Dealt to PlayTheBlues4U [Kh 6c]
hanklocic joins the table at seat #6
tempusfugit3737: folds
skoalguy33: folds
SeaofLove: folds
PlayTheBlues4U: folds
Uncalled bet ($0.05) returned to StickyChipss
StickyChipss collected $0.10 from pot
*** SUMMARY ***
Total pot $0.10 | Rake $0
Seat 1: SeaofLove (button) folded before Flop (didn't bet)
Seat 2: PlayTheBlues4U (small blind) folded before Flop
Seat 3: StickyChipss (big blind) collected ($0.10)
Seat 4: tempusfugit3737 folded before Flop (didn't bet)
Seat 5: skoalguy33 folded before Flop (didn't bet)


PokerStars Hand #205379005940:  Hold'em No Limit ($0.05/$0.10 USD) - 2019/11/02 22:48:45 ET
Table 'Antares' 6-max Seat #5 is the button
Seat 1: SeaofLove ($10.32 in chips)
Seat 2: PlayTheBlues4U ($15.49 in chips)
Seat 3: StickyChipss ($16.51 in chips)
Seat 4: tempusfugit3737 ($12.02 in chips)
Seat 5: skoalguy33 ($12.34 in chips)
SeaofLove: posts small blind $0.05
PlayTheBlues4U: posts big blind $0.10
*** HOLE CARDS ***
Dealt to PlayTheBlues4U [3h 8h]
StickyChipss: folds
tempusfugit3737: folds
skoalguy33: folds
SeaofLove: raises $0.20 to $0.30
PlayTheBlues4U: folds
Uncalled bet ($0.20) returned to SeaofLove
SeaofLove collected $0.20 from pot
SeaofLove: doesn't show hand
*** SUMMARY ***
Total pot $0.20 | Rake $0
Seat 1: SeaofLove (small blind) collected ($0.20)
Seat 2: PlayTheBlues4U (big blind) folded before Flop
Seat 3: StickyChipss folded before Flop (didn't bet)
Seat 4: tempusfugit3737 folded before Flop (didn't bet)
Seat 5: skoalguy33 (button) folded before Flop (didn't bet)


PokerStars Hand #205379005914:  Hold'em No Limit ($0.05/$0.10 USD) - 2019/11/02 22:48:40 ET
Table 'Hekate' 6-max Seat #1 is the button
Seat 1: SourShoes9 ($10.95 in chips)
Seat 3: PlayTheBlues4U ($48.37 in chips)
Seat 4: SeaofLove ($11.30 in chips)
Seat 6: Ty1erDurrden ($18.53 in chips)
PlayTheBlues4U: posts small blind $0.05
SeaofLove: posts big blind $0.10
*** HOLE CARDS ***
Dealt to PlayTheBlues4U [Js Ac]
Ty1erDurrden: raises $0.15 to $0.25
SourShoes9: calls $0.25
PlayTheBlues4U: calls $0.20
SeaofLove: raises $1 to $1.25
Ty1erDurrden: folds
SourShoes9: calls $1
PlayTheBlues4U: folds
*** FLOP *** [9d Qd 2h]
SeaofLove: bets $1.50
SourShoes9: folds
Uncalled bet ($1.50) returned to SeaofLove
SeaofLove collected $2.85 from pot
SeaofLove: doesn't show hand
*** SUMMARY ***
Total pot $3 | Rake $0.15
Board [9d Qd 2h]
Seat 1: SourShoes9 (button) folded on the Flop
Seat 3: PlayTheBlues4U (small blind) folded before Flop
Seat 4: SeaofLove (big blind) collected ($2.85)
Seat 6: Ty1erDurrden folded before Flop


PokerStars Hand #205379005899:  Hold'em No Limit ($0.05/$0.10 USD) - 2019/11/02 22:48:36 ET
Table 'Antares' 6-max Seat #4 is the button
Seat 1: SeaofLove ($10.27 in chips)
Seat 2: PlayTheBlues4U ($15.49 in chips)
Seat 3: StickyChipss ($16.51 in chips)
Seat 4: tempusfugit3737 ($12.02 in chips)
Seat 5: skoalguy33 ($12.39 in chips)
skoalguy33: posts small blind $0.05
SeaofLove: posts big blind $0.10
*** HOLE CARDS ***
Dealt to PlayTheBlues4U [6d 4c]
PlayTheBlues4U: folds
StickyChipss: folds
tempusfugit3737: folds
skoalguy33: folds
Uncalled bet ($0.05) returned to SeaofLove
SeaofLove collected $0.10 from pot
SeaofLove: doesn't show hand
*** SUMMARY ***
Total pot $0.10 | Rake $0
Seat 1: SeaofLove (big blind) collected ($0.10)
Seat 2: PlayTheBlues4U folded before Flop (didn't bet)
Seat 3: StickyChipss folded before Flop (didn't bet)
Seat 4: tempusfugit3737 (button) folded before Flop (didn't bet)
Seat 5: skoalguy33 (small blind) folded before Flop


PokerStars Hand #205379005864:  Hold'em No Limit ($0.05/$0.10 USD) - 2019/11/02 22:48:25 ET
Table 'Antares' 6-max Seat #3 is the button
Seat 1: SeaofLove ($10.27 in chips)
Seat 2: PlayTheBlues4U ($15.49 in chips)
Seat 3: StickyChipss ($16.51 in chips)
Seat 4: tempusfugit3737 ($12.07 in chips)
Seat 5: skoalguy33 ($12.34 in chips)
tempusfugit3737: posts small blind $0.05
skoalguy33: posts big blind $0.10
*** HOLE CARDS ***
Dealt to PlayTheBlues4U [Ad 3s]
SeaofLove: folds
PlayTheBlues4U: folds
StickyChipss: folds
tempusfugit3737: folds
Uncalled bet ($0.05) returned to skoalguy33
skoalguy33 collected $0.10 from pot
skoalguy33: doesn't show hand
*** SUMMARY ***
Total pot $0.10 | Rake $0
Seat 1: SeaofLove folded before Flop (didn't bet)
Seat 2: PlayTheBlues4U folded before Flop (didn't bet)
Seat 3: StickyChipss (button) folded before Flop (didn't bet)
Seat 4: tempusfugit3737 (small blind) folded before Flop
Seat 5: skoalguy33 (big blind) collected ($0.10)


PokerStars Hand #205379005830:  Hold'em No Limit ($0.05/$0.10 USD) - 2019/11/02 22:48:16 ET
Table 'Antares' 6-max Seat #2 is the button
Seat 1: SeaofLove ($10.27 in chips)
Seat 2: PlayTheBlues4U ($15.49 in chips)
Seat 3: StickyChipss ($16.56 in chips)
Seat 4: tempusfugit3737 ($12.02 in chips)
Seat 5: skoalguy33 ($12.34 in chips)
StickyChipss: posts small blind $0.05
tempusfugit3737: posts big blind $0.10
*** HOLE CARDS ***
Dealt to PlayTheBlues4U [Jh 6d]
skoalguy33: folds
SeaofLove: folds
PlayTheBlues4U: folds
StickyChipss: folds
Uncalled bet ($0.05) returned to tempusfugit3737
tempusfugit3737 collected $0.10 from pot
tempusfugit3737: doesn't show hand
*** SUMMARY ***
Total pot $0.10 | Rake $0
Seat 1: SeaofLove folded before Flop (didn't bet)
Seat 2: PlayTheBlues4U (button) folded before Flop (didn't bet)
Seat 3: StickyChipss (small blind) folded before Flop
Seat 4: tempusfugit3737 (big blind) collected ($0.10)
Seat 5: skoalguy33 folded before Flop (didn't bet)


PokerStars Hand #205379005736:  Hold'em No Limit ($0.05/$0.10 USD) - 2019/11/02 22:47:53 ET
Table 'Hekate' 6-max Seat #6 is the button
Seat 1: SourShoes9 ($11 in chips)
Seat 3: PlayTheBlues4U ($48.47 in chips)
Seat 4: SeaofLove ($10.08 in chips)
Seat 6: Ty1erDurrden ($19.73 in chips)
SourShoes9: posts small blind $0.05
PlayTheBlues4U: posts big blind $0.10
*** HOLE CARDS ***
Dealt to PlayTheBlues4U [5s 9s]
SeaofLove: raises $0.15 to $0.25
Ty1erDurrden: raises $0.95 to $1.20
SourShoes9: folds
PlayTheBlues4U: folds
SeaofLove: calls $0.95
*** FLOP *** [2s Ts 4d]
SeaofLove: checks
Ty1erDurrden: checks
*** TURN *** [2s Ts 4d] [Js]
SeaofLove: bets $1.61
Ty1erDurrden: folds
Uncalled bet ($1.61) returned to SeaofLove
SeaofLove collected $2.42 from pot
SeaofLove: doesn't show hand
*** SUMMARY ***
Total pot $2.55 | Rake $0.13
Board [2s Ts 4d Js]
Seat 1: SourShoes9 (small blind) folded before Flop
Seat 3: PlayTheBlues4U (big blind) folded before Flop
Seat 4: SeaofLove collected ($2.42)
Seat 6: Ty1erDurrden (button) folded on the Turn


PokerStars Hand #205379005723:  Hold'em No Limit ($0.05/$0.10 USD) - 2019/11/02 22:47:50 ET
Table 'Antares' 6-max Seat #1 is the button
Seat 1: SeaofLove ($10.27 in chips)
Seat 2: PlayTheBlues4U ($15.54 in chips)
Seat 3: StickyChipss ($16.66 in chips)
Seat 4: tempusfugit3737 ($11.61 in chips)
Seat 5: skoalguy33 ($12.64 in chips)
PlayTheBlues4U: posts small blind $0.05
StickyChipss: posts big blind $0.10
*** HOLE CARDS ***
Dealt to PlayTheBlues4U [9c Qc]
tempusfugit3737: raises $0.20 to $0.30
skoalguy33: calls $0.30
SeaofLove: folds
PlayTheBlues4U: folds
StickyChipss: folds
*** FLOP *** [Th 6d 6c]
tempusfugit3737: checks
skoalguy33: checks
*** TURN *** [Th 6d 6c] [Jh]
tempusfugit3737: bets $0.40
skoalguy33: folds
Uncalled bet ($0.40) returned to tempusfugit3737
tempusfugit3737 collected $0.71 from pot
tempusfugit3737: doesn't show hand
*** SUMMARY ***
Total pot $0.75 | Rake $0.04
Board [Th 6d 6c Jh]
Seat 1: SeaofLove (button) folded before Flop (didn't bet)
Seat 2: PlayTheBlues4U (small blind) folded before Flop
Seat 3: StickyChipss (big blind) folded before Flop
Seat 4: tempusfugit3737 collected ($0.71)
Seat 5: skoalguy33 folded on the Turn


PokerStars Hand #205379005648:  Hold'em No Limit ($0.05/$0.10 USD) - 2019/11/02 22:47:29 ET
Table 'Hekate' 6-max Seat #4 is the button
Seat 1: SourShoes9 ($11.30 in chips)
Seat 3: PlayTheBlues4U ($48.47 in chips)
Seat 4: SeaofLove ($10.08 in chips)
Seat 6: Ty1erDurrden ($19.46 in chips)
Ty1erDurrden: posts small blind $0.05
SourShoes9: posts big blind $0.10
*** HOLE CARDS ***
Dealt to PlayTheBlues4U [8c 9h]
PlayTheBlues4U: folds
SeaofLove: folds
Ty1erDurrden: raises $0.20 to $0.30
SourShoes9: calls $0.20
*** FLOP *** [Qd 8d Ac]
Ty1erDurrden: bets $0.30
SourShoes9: folds
Uncalled bet ($0.30) returned to Ty1erDurrden
Ty1erDurrden collected $0.57 from pot
Ty1erDurrden: doesn't show hand
*** SUMMARY ***
Total pot $0.60 | Rake $0.03
Board [Qd 8d Ac]
Seat 1: SourShoes9 (big blind) folded on the Flop
Seat 3: PlayTheBlues4U folded before Flop (didn't bet)
Seat 4: SeaofLove (button) folded before Flop (didn't bet)
Seat 6: Ty1erDurrden (small blind) collected ($0.57)


PokerStars Hand #205379005593:  Hold'em No Limit ($0.05/$0.10 USD) - 2019/11/02 22:47:15 ET
Table 'Antares' 6-max Seat #5 is the button
Seat 1: SeaofLove ($10 in chips)
Seat 2: PlayTheBlues4U ($15.84 in chips)
Seat 3: StickyChipss ($16.66 in chips)
Seat 4: tempusfugit3737 ($11.61 in chips)
Seat 5: skoalguy33 ($12.64 in chips)
SeaofLove: posts small blind $0.05
PlayTheBlues4U: posts big blind $0.10
*** HOLE CARDS ***
Dealt to PlayTheBlues4U [Qc Td]
StickyChipss: folds
tempusfugit3737: folds
skoalguy33: folds
SeaofLove: raises $0.20 to $0.30
PlayTheBlues4U: calls $0.20
*** FLOP *** [6s 5h Ah]
SeaofLove: bets $0.38
PlayTheBlues4U: folds
Uncalled bet ($0.38) returned to SeaofLove
SeaofLove collected $0.57 from pot
SeaofLove: doesn't show hand
*** SUMMARY ***
Total pot $0.60 | Rake $0.03
Board [6s 5h Ah]
Seat 1: SeaofLove (small blind) collected ($0.57)
Seat 2: PlayTheBlues4U (big blind) folded on the Flop
Seat 3: StickyChipss folded before Flop (didn't bet)
Seat 4: tempusfugit3737 folded before Flop (didn't bet)
Seat 5: skoalguy33 (button) folded before Flop (didn't bet)


PokerStars Hand #205379005569:  Hold'em No Limit ($0.05/$0.10 USD) - 2019/11/02 22:47:09 ET
Table 'Hekate' 6-max Seat #3 is the button
Seat 1: SourShoes9 ($11.16 in chips)
Seat 3: PlayTheBlues4U ($48.47 in chips)
Seat 4: SeaofLove ($10.13 in chips)
Seat 6: Ty1erDurrden ($19.56 in chips)
SeaofLove: posts small blind $0.05
Ty1erDurrden: posts big blind $0.10
*** HOLE CARDS ***
Dealt to PlayTheBlues4U [8d Kc]
SourShoes9: calls $0.10
PlayTheBlues4U: folds
SeaofLove: folds
mankar.am leaves the table
Ty1erDurrden: checks
*** FLOP *** [Jc Ts 2h]
Ty1erDurrden: checks
SourShoes9: bets $0.10
Ty1erDurrden: folds
Uncalled bet ($0.10) returned to SourShoes9
SourShoes9 collected $0.24 from pot
SourShoes9: doesn't show hand
*** SUMMARY ***
Total pot $0.25 | Rake $0.01
Board [Jc Ts 2h]
Seat 1: SourShoes9 collected ($0.24)
Seat 3: PlayTheBlues4U (button) folded before Flop (didn't bet)
Seat 4: SeaofLove (small blind) folded before Flop
Seat 6: Ty1erDurrden (big blind) folded on the Flop


PokerStars Hand #205379005462:  Hold'em No Limit ($0.05/$0.10 USD) - 2019/11/02 22:46:39 ET
Table 'Antares' 6-max Seat #4 is the button
Seat 1: SeaofLove ($10 in chips)
Seat 2: PlayTheBlues4U ($15.84 in chips)
Seat 3: StickyChipss ($13.81 in chips)
Seat 4: tempusfugit3737 ($11.61 in chips)
Seat 5: skoalguy33 ($13.44 in chips)
skoalguy33: posts small blind $0.05
SeaofLove: posts big blind $0.10
*** HOLE CARDS ***
Dealt to PlayTheBlues4U [3s 4c]
PlayTheBlues4U: folds
StickyChipss: raises $0.20 to $0.30
tempusfugit3737: folds
skoalguy33: calls $0.25
SeaofLove: calls $0.20
*** FLOP *** [Th 6h 7c]
skoalguy33: checks
SeaofLove: bets $0.50
StickyChipss: calls $0.50
skoalguy33: calls $0.50
*** TURN *** [Th 6h 7c] [Qd]
skoalguy33: checks
SeaofLove: bets $1.52
StickyChipss: calls $1.52
skoalguy33: folds
*** RIVER *** [Th 6h 7c Qd] [4d]
SeaofLove: checks
StickyChipss: bets $5.17
SeaofLove: folds
Uncalled bet ($5.17) returned to StickyChipss
StickyChipss collected $5.17 from pot
*** SUMMARY ***
Total pot $5.44 | Rake $0.27
Board [Th 6h 7c Qd 4d]
Seat 1: SeaofLove (big blind) folded on the River
Seat 2: PlayTheBlues4U folded before Flop (didn't bet)
Seat 3: StickyChipss collected ($5.17)
Seat 4: tempusfugit3737 (button) folded before Flop (didn't bet)
Seat 5: skoalguy33 (small blind) folded on the Turn


PokerStars Hand #205379005429:  Hold'em No Limit ($0.05/$0.10 USD) - 2019/11/02 22:46:31 ET
Table 'Antares' 6-max Seat #3 is the button
Seat 1: SeaofLove ($10 in chips)
Seat 2: PlayTheBlues4U ($15.69 in chips)
Seat 3: StickyChipss ($13.81 in chips)
Seat 4: tempusfugit3737 ($11.66 in chips)
Seat 5: skoalguy33 ($13.54 in chips)
tempusfugit3737: posts small blind $0.05
skoalguy33: posts big blind $0.10
*** HOLE CARDS ***
Dealt to PlayTheBlues4U [As Qc]
SeaofLove: folds
PlayTheBlues4U: raises $0.20 to $0.30
StickyChipss: folds
tempusfugit3737: folds
skoalguy33: folds
Uncalled bet ($0.20) returned to PlayTheBlues4U
PlayTheBlues4U collected $0.25 from pot
PlayTheBlues4U: doesn't show hand
*** SUMMARY ***
Total pot $0.25 | Rake $0
Seat 1: SeaofLove folded before Flop (didn't bet)
Seat 2: PlayTheBlues4U collected ($0.25)
Seat 3: StickyChipss (button) folded before Flop (didn't bet)
Seat 4: tempusfugit3737 (small blind) folded before Flop
Seat 5: skoalguy33 (big blind) folded before Flop


PokerStars Hand #205379005384:  Hold'em No Limit ($0.05/$0.10 USD) - 2019/11/02 22:46:20 ET
Table 'Hekate' 6-max Seat #1 is the button
Seat 1: SourShoes9 ($6.79 in chips)
Seat 2: mankar.am ($4.75 in chips)
Seat 3: PlayTheBlues4U ($48.57 in chips)
Seat 4: SeaofLove ($10.13 in chips)
Seat 6: Ty1erDurrden ($19.56 in chips)
mankar.am: posts small blind $0.05
PlayTheBlues4U: posts big blind $0.10
*** HOLE CARDS ***
Dealt to PlayTheBlues4U [4s Kd]
SeaofLove: folds
Ty1erDurrden: folds
SourShoes9: raises $0.20 to $0.30
mankar.am: calls $0.25
PlayTheBlues4U: folds
*** FLOP *** [Jc 2s 3h]
mankar.am: checks
SourShoes9: bets $0.70
mankar.am: calls $0.70
*** TURN *** [Jc 2s 3h] [Qs]
mankar.am: checks
SourShoes9: bets $2.70
mankar.am: calls $2.70
*** RIVER *** [Jc 2s 3h Qs] [6c]
mankar.am: bets $1.05 and is all-in
SourShoes9: calls $1.05
*** SHOW DOWN ***
mankar.am: shows [Kc Th] (high card King)
SourShoes9: shows [Js 9c] (a pair of Jacks)
SourShoes9 collected $9.12 from pot
*** SUMMARY ***
Total pot $9.60 | Rake $0.48
Board [Jc 2s 3h Qs 6c]
Seat 1: SourShoes9 (button) showed [Js 9c] and won ($9.12) with a pair of Jacks
Seat 2: mankar.am (small blind) showed [Kc Th] and lost with high card King
Seat 3: PlayTheBlues4U (big blind) folded before Flop
Seat 4: SeaofLove folded before Flop (didn't bet)
Seat 6: Ty1erDurrden folded before Flop (didn't bet)


PokerStars Hand #205379005272:  Hold'em No Limit ($0.05/$0.10 USD) - 2019/11/02 22:45:51 ET
Table 'Antares' 6-max Seat #2 is the button
Seat 1: SeaofLove ($10 in chips)
Seat 2: PlayTheBlues4U ($15.18 in chips)
Seat 3: StickyChipss ($13.86 in chips)
Seat 4: tempusfugit3737 ($11.91 in chips)
Seat 5: skoalguy33 ($13.54 in chips)
StickyChipss: posts small blind $0.05
tempusfugit3737: posts big blind $0.10
*** HOLE CARDS ***
Dealt to PlayTheBlues4U [7c 7s]
skoalguy33: folds
SeaofLove: raises $0.15 to $0.25
PlayTheBlues4U: calls $0.25
StickyChipss: folds
tempusfugit3737: calls $0.15
*** FLOP *** [7h 8c 8h]
tempusfugit3737: checks
SeaofLove: checks
PlayTheBlues4U: bets $0.60
tempusfugit3737: folds
SeaofLove: folds
Uncalled bet ($0.60) returned to PlayTheBlues4U
PlayTheBlues4U collected $0.76 from pot
PlayTheBlues4U: doesn't show hand
*** SUMMARY ***
Total pot $0.80 | Rake $0.04
Board [7h 8c 8h]
Seat 1: SeaofLove folded on the Flop
Seat 2: PlayTheBlues4U (button) collected ($0.76)
Seat 3: StickyChipss (small blind) folded before Flop
Seat 4: tempusfugit3737 (big blind) folded on the Flop
Seat 5: skoalguy33 folded before Flop (didn't bet)


PokerStars Hand #205379005243:  Hold'em No Limit ($0.05/$0.10 USD) - 2019/11/02 22:45:45 ET
Table 'Hekate' 6-max Seat #6 is the button
Seat 1: SourShoes9 ($6.84 in chips)
Seat 2: mankar.am ($4.85 in chips)
Seat 3: PlayTheBlues4U ($48.57 in chips)
Seat 4: SeaofLove ($16.09 in chips)
Seat 6: Ty1erDurrden ($14.05 in chips)
SourShoes9: posts small blind $0.05
mankar.am: posts big blind $0.10
*** HOLE CARDS ***
Dealt to PlayTheBlues4U [8d Jd]
PlayTheBlues4U: folds
SeaofLove: raises $0.15 to $0.25
Ty1erDurrden: raises $0.95 to $1.20
SourShoes9: folds
mankar.am: folds
SeaofLove: calls $0.95
*** FLOP *** [2c Ts 7c]
SeaofLove: checks
Ty1erDurrden: bets $1.82
SeaofLove: calls $1.82
*** TURN *** [2c Ts 7c] [8s]
SeaofLove: checks
Ty1erDurrden: checks
*** RIVER *** [2c Ts 7c 8s] [Th]
SeaofLove: bets $2.94
Ty1erDurrden: calls $2.94
*** SHOW DOWN ***
SeaofLove: shows [9c 9s] (two pair, Tens and Nines)
Ty1erDurrden: shows [Ks Kd] (two pair, Kings and Tens)
Ty1erDurrden collected $11.47 from pot
*** SUMMARY ***
Total pot $12.07 | Rake $0.60
Board [2c Ts 7c 8s Th]
Seat 1: SourShoes9 (small blind) folded before Flop
Seat 2: mankar.am (big blind) folded before Flop
Seat 3: PlayTheBlues4U folded before Flop (didn't bet)
Seat 4: SeaofLove showed [9c 9s] and lost with two pair, Tens and Nines
Seat 6: Ty1erDurrden (button) showed [Ks Kd] and won ($11.47) with two pair, Kings and Tens


PokerStars Hand #205379005070:  Hold'em No Limit ($0.05/$0.10 USD) - 2019/11/02 22:45:03 ET
Table 'Antares' 6-max Seat #1 is the button
Seat 1: SeaofLove ($10 in chips)
Seat 2: PlayTheBlues4U ($15.95 in chips)
Seat 3: StickyChipss ($13.17 in chips)
Seat 4: tempusfugit3737 ($11.91 in chips)
Seat 5: skoalguy33 ($13.54 in chips)
PlayTheBlues4U: posts small blind $0.05
StickyChipss: posts big blind $0.10
*** HOLE CARDS ***
Dealt to PlayTheBlues4U [6h 6s]
tempusfugit3737: folds
skoalguy33: folds
SeaofLove: folds
PlayTheBlues4U: calls $0.05
StickyChipss: raises $0.67 to $0.77
PlayTheBlues4U: calls $0.67
*** FLOP *** [2c 7d Ac]
PlayTheBlues4U: checks
StickyChipss: bets $1
PlayTheBlues4U: folds
Uncalled bet ($1) returned to StickyChipss
StickyChipss collected $1.46 from pot
*** SUMMARY ***
Total pot $1.54 | Rake $0.08
Board [2c 7d Ac]
Seat 1: SeaofLove (button) folded before Flop (didn't bet)
Seat 2: PlayTheBlues4U (small blind) folded on the Flop
Seat 3: StickyChipss (big blind) collected ($1.46)
Seat 4: tempusfugit3737 folded before Flop (didn't bet)
Seat 5: skoalguy33 folded before Flop (didn't bet)


PokerStars Hand #205379005006:  Hold'em No Limit ($0.05/$0.10 USD) - 2019/11/02 22:44:47 ET
Table 'Hekate' 6-max Seat #4 is the button
Seat 1: SourShoes9 ($10.49 in chips)
Seat 2: mankar.am ($5.30 in chips)
Seat 3: PlayTheBlues4U ($48.57 in chips)
Seat 4: SeaofLove ($12.33 in chips)
Seat 6: Ty1erDurrden ($14.10 in chips)
Ty1erDurrden: posts small blind $0.05
SourShoes9: posts big blind $0.10
*** HOLE CARDS ***
Dealt to PlayTheBlues4U [Ah 7s]
mankar.am: calls $0.10
PlayTheBlues4U: folds
SeaofLove: raises $0.35 to $0.45
Ty1erDurrden: folds
SourShoes9: calls $0.35
mankar.am: calls $0.35
*** FLOP *** [Jd Kh 5h]
SourShoes9: checks
mankar.am: checks
SeaofLove: checks
*** TURN *** [Jd Kh 5h] [4d]
SourShoes9: bets $1.30
mankar.am: folds
SeaofLove: calls $1.30
*** RIVER *** [Jd Kh 5h 4d] [Ad]
SourShoes9: bets $1.90
SeaofLove: raises $7.60 to $9.50
SourShoes9: folds
Uncalled bet ($7.60) returned to SeaofLove
SeaofLove collected $7.41 from pot
SeaofLove: doesn't show hand
*** SUMMARY ***
Total pot $7.80 | Rake $0.39
Board [Jd Kh 5h 4d Ad]
Seat 1: SourShoes9 (big blind) folded on the River
Seat 2: mankar.am folded on the Turn
Seat 3: PlayTheBlues4U folded before Flop (didn't bet)
Seat 4: SeaofLove (button) collected ($7.41)
Seat 6: Ty1erDurrden (small blind) folded before Flop


PokerStars Hand #205379004990:  Hold'em No Limit ($0.05/$0.10 USD) - 2019/11/02 22:44:45 ET
Table 'Antares' 6-max Seat #5 is the button
Seat 1: SeaofLove ($10 in chips)
Seat 2: PlayTheBlues4U ($16.05 in chips)
Seat 3: StickyChipss ($13.17 in chips)
Seat 4: tempusfugit3737 ($11.91 in chips)
Seat 5: skoalguy33 ($13.39 in chips)
SeaofLove: posts small blind $0.05
PlayTheBlues4U: posts big blind $0.10
*** HOLE CARDS ***
Dealt to PlayTheBlues4U [Th Jd]
StickyChipss: folds
tempusfugit3737: folds
skoalguy33: raises $0.20 to $0.30
SeaofLove: folds
PlayTheBlues4U: folds
Uncalled bet ($0.20) returned to skoalguy33
skoalguy33 collected $0.25 from pot
skoalguy33: doesn't show hand
*** SUMMARY ***
Total pot $0.25 | Rake $0
Seat 1: SeaofLove (small blind) folded before Flop
Seat 2: PlayTheBlues4U (big blind) folded before Flop
Seat 3: StickyChipss folded before Flop (didn't bet)
Seat 4: tempusfugit3737 folded before Flop (didn't bet)
Seat 5: skoalguy33 (button) collected ($0.25)


PokerStars Hand #205379004868:  Hold'em No Limit ($0.05/$0.10 USD) - 2019/11/02 22:44:11 ET
Table 'Antares' 6-max Seat #4 is the button
Seat 1: SeaofLove ($10 in chips)
Seat 2: PlayTheBlues4U ($14.35 in chips)
Seat 3: StickyChipss ($13.17 in chips)
Seat 4: tempusfugit3737 ($12.21 in chips)
Seat 5: skoalguy33 ($14.69 in chips)
skoalguy33: posts small blind $0.05
SeaofLove: posts big blind $0.10
*** HOLE CARDS ***
Dealt to PlayTheBlues4U [Kc Ks]
PlayTheBlues4U: raises $0.20 to $0.30
StickyChipss: folds
tempusfugit3737: calls $0.30
skoalguy33: raises $1 to $1.30
SeaofLove: folds
PlayTheBlues4U: raises $2.20 to $3.50
tempusfugit3737: folds
skoalguy33: folds
Uncalled bet ($2.20) returned to PlayTheBlues4U
PlayTheBlues4U collected $3 from pot
PlayTheBlues4U: doesn't show hand
*** SUMMARY ***
Total pot $3 | Rake $0
Seat 1: SeaofLove (big blind) folded before Flop
Seat 2: PlayTheBlues4U collected ($3)
Seat 3: StickyChipss folded before Flop (didn't bet)
Seat 4: tempusfugit3737 (button) folded before Flop
Seat 5: skoalguy33 (small blind) folded before Flop


PokerStars Hand #205379004821:  Hold'em No Limit ($0.05/$0.10 USD) - 2019/11/02 22:44:00 ET
Table 'Hekate' 6-max Seat #3 is the button
Seat 1: SourShoes9 ($10.49 in chips)
Seat 2: mankar.am ($7.04 in chips)
Seat 3: PlayTheBlues4U ($48.57 in chips)
Seat 4: SeaofLove ($12.38 in chips)
Seat 6: Ty1erDurrden ($12.49 in chips)
SeaofLove: posts small blind $0.05
Ty1erDurrden: posts big blind $0.10
*** HOLE CARDS ***
Dealt to PlayTheBlues4U [As 4c]
SourShoes9: folds
mankar.am: calls $0.10
PlayTheBlues4U: folds
SeaofLove: folds
Ty1erDurrden: raises $0.60 to $0.70
mankar.am: calls $0.60
*** FLOP *** [Qh 5s 8s]
Ty1erDurrden: bets $1.04
mankar.am: calls $1.04
*** TURN *** [Qh 5s 8s] [Jh]
Ty1erDurrden: bets $6.78
mankar.am: folds
Uncalled bet ($6.78) returned to Ty1erDurrden
Ty1erDurrden collected $3.35 from pot
Ty1erDurrden: doesn't show hand
*** SUMMARY ***
Total pot $3.53 | Rake $0.18
Board [Qh 5s 8s Jh]
Seat 1: SourShoes9 folded before Flop (didn't bet)
Seat 2: mankar.am folded on the Turn
Seat 3: PlayTheBlues4U (button) folded before Flop (didn't bet)
Seat 4: SeaofLove (small blind) folded before Flop
Seat 6: Ty1erDurrden (big blind) collected ($3.35)


PokerStars Hand #205379004804:  Hold'em No Limit ($0.05/$0.10 USD) - 2019/11/02 22:43:56 ET
Table 'Antares' 6-max Seat #3 is the button
Seat 1: SeaofLove ($10 in chips)
Seat 2: PlayTheBlues4U ($14.20 in chips)
Seat 3: StickyChipss ($13.17 in chips)
Seat 4: tempusfugit3737 ($12.26 in chips)
Seat 5: skoalguy33 ($14.79 in chips)
tempusfugit3737: posts small blind $0.05
skoalguy33: posts big blind $0.10
*** HOLE CARDS ***
Dealt to PlayTheBlues4U [6h Ah]
SeaofLove: folds
PlayTheBlues4U: raises $0.20 to $0.30
StickyChipss: folds
tempusfugit3737: folds
skoalguy33: folds
Uncalled bet ($0.20) returned to PlayTheBlues4U
PlayTheBlues4U collected $0.25 from pot
PlayTheBlues4U: doesn't show hand
*** SUMMARY ***
Total pot $0.25 | Rake $0
Seat 1: SeaofLove folded before Flop (didn't bet)
Seat 2: PlayTheBlues4U collected ($0.25)
Seat 3: StickyChipss (button) folded before Flop (didn't bet)
Seat 4: tempusfugit3737 (small blind) folded before Flop
Seat 5: skoalguy33 (big blind) folded before Flop


PokerStars Hand #205379004767:  Hold'em No Limit ($0.05/$0.10 USD) - 2019/11/02 22:43:47 ET
Table 'Antares' 6-max Seat #2 is the button
Seat 1: SeaofLove ($10 in chips)
Seat 2: PlayTheBlues4U ($14.20 in chips)
Seat 3: StickyChipss ($13.22 in chips)
Seat 4: tempusfugit3737 ($12.21 in chips)
Seat 5: skoalguy33 ($14.79 in chips)
StickyChipss: posts small blind $0.05
tempusfugit3737: posts big blind $0.10
*** HOLE CARDS ***
Dealt to PlayTheBlues4U [9h Kc]
skoalguy33: folds
SeaofLove: folds
PlayTheBlues4U: folds
StickyChipss: folds
Uncalled bet ($0.05) returned to tempusfugit3737
tempusfugit3737 collected $0.10 from pot
tempusfugit3737: doesn't show hand
*** SUMMARY ***
Total pot $0.10 | Rake $0
Seat 1: SeaofLove folded before Flop (didn't bet)
Seat 2: PlayTheBlues4U (button) folded before Flop (didn't bet)
Seat 3: StickyChipss (small blind) folded before Flop
Seat 4: tempusfugit3737 (big blind) collected ($0.10)
Seat 5: skoalguy33 folded before Flop (didn't bet)


PokerStars Hand #205379004672:  Hold'em No Limit ($0.05/$0.10 USD) - 2019/11/02 22:43:23 ET
Table 'Hekate' 6-max Seat #2 is the button
Seat 1: SourShoes9 ($11.64 in chips)
Seat 2: mankar.am ($5.86 in chips)
Seat 3: PlayTheBlues4U ($48.62 in chips)
Seat 4: SeaofLove ($12.48 in chips)
Seat 6: Ty1erDurrden ($12.49 in chips)
PlayTheBlues4U: posts small blind $0.05
SeaofLove: posts big blind $0.10
*** HOLE CARDS ***
Dealt to PlayTheBlues4U [Ks 9h]
Ty1erDurrden: folds
SourShoes9: raises $0.25 to $0.35
mankar.am: calls $0.35
PlayTheBlues4U: folds
SeaofLove: folds
*** FLOP *** [Js Ac Qc]
SourShoes9: bets $0.40
mankar.am: raises $0.40 to $0.80
SourShoes9: calls $0.40
*** TURN *** [Js Ac Qc] [4d]
SourShoes9: checks
mankar.am: bets $1.20
SourShoes9: folds
Uncalled bet ($1.20) returned to mankar.am
mankar.am collected $2.33 from pot
mankar.am: doesn't show hand
*** SUMMARY ***
Total pot $2.45 | Rake $0.12
Board [Js Ac Qc 4d]
Seat 1: SourShoes9 folded on the Turn
Seat 2: mankar.am (button) collected ($2.33)
Seat 3: PlayTheBlues4U (small blind) folded before Flop
Seat 4: SeaofLove (big blind) folded before Flop
Seat 6: Ty1erDurrden folded before Flop (didn't bet)


PokerStars Hand #205379004632:  Hold'em No Limit ($0.05/$0.10 USD) - 2019/11/02 22:43:14 ET
Table 'Antares' 6-max Seat #1 is the button
Seat 1: SeaofLove ($10.66 in chips)
Seat 2: PlayTheBlues4U ($14.25 in chips)
Seat 3: StickyChipss ($13.32 in chips)
Seat 4: tempusfugit3737 ($11.12 in chips)
Seat 5: skoalguy33 ($14.79 in chips)
PlayTheBlues4U: posts small blind $0.05
StickyChipss: posts big blind $0.10
*** HOLE CARDS ***
Dealt to PlayTheBlues4U [8h Ks]
tempusfugit3737: raises $0.20 to $0.30
skoalguy33: folds
SeaofLove: raises $0.75 to $1.05
PlayTheBlues4U: folds
StickyChipss: folds
tempusfugit3737: calls $0.75
*** FLOP *** [7s 2s 3s]
tempusfugit3737: bets $1.20
SeaofLove: folds
Uncalled bet ($1.20) returned to tempusfugit3737
tempusfugit3737 collected $2.14 from pot
tempusfugit3737: doesn't show hand
*** SUMMARY ***
Total pot $2.25 | Rake $0.11
Board [7s 2s 3s]
Seat 1: SeaofLove (button) folded on the Flop
Seat 2: PlayTheBlues4U (small blind) folded before Flop
Seat 3: StickyChipss (big blind) folded before Flop
Seat 4: tempusfugit3737 collected ($2.14)
Seat 5: skoalguy33 folded before Flop (didn't bet)


PokerStars Hand #205379004582:  Hold'em No Limit ($0.05/$0.10 USD) - 2019/11/02 22:43:02 ET
Table 'Antares' 6-max Seat #5 is the button
Seat 1: SeaofLove ($10.56 in chips)
Seat 2: PlayTheBlues4U ($14.35 in chips)
Seat 3: StickyChipss ($13.32 in chips)
Seat 4: tempusfugit3737 ($11.12 in chips)
Seat 5: skoalguy33 ($14.79 in chips)
SeaofLove: posts small blind $0.05
PlayTheBlues4U: posts big blind $0.10
*** HOLE CARDS ***
Dealt to PlayTheBlues4U [9d 3d]
StickyChipss: folds
tempusfugit3737: folds
skoalguy33: folds
SeaofLove: raises $0.20 to $0.30
PlayTheBlues4U: folds
Uncalled bet ($0.20) returned to SeaofLove
SeaofLove collected $0.20 from pot
SeaofLove: doesn't show hand
*** SUMMARY ***
Total pot $0.20 | Rake $0
Seat 1: SeaofLove (small blind) collected ($0.20)
Seat 2: PlayTheBlues4U (big blind) folded before Flop
Seat 3: StickyChipss folded before Flop (didn't bet)
Seat 4: tempusfugit3737 folded before Flop (didn't bet)
Seat 5: skoalguy33 (button) folded before Flop (didn't bet)


PokerStars Hand #205379004557:  Hold'em No Limit ($0.05/$0.10 USD) - 2019/11/02 22:42:56 ET
Table 'Hekate' 6-max Seat #1 is the button
Seat 1: SourShoes9 ($11.64 in chips)
Seat 2: mankar.am ($5.91 in chips)
Seat 3: PlayTheBlues4U ($48.72 in chips)
Seat 4: SeaofLove ($13.68 in chips)
Seat 6: Ty1erDurrden ($11.27 in chips)
mankar.am: posts small blind $0.05
PlayTheBlues4U: posts big blind $0.10
*** HOLE CARDS ***
Dealt to PlayTheBlues4U [7d Qc]
SeaofLove: raises $0.15 to $0.25
Ty1erDurrden: raises $0.95 to $1.20
SourShoes9: folds
mankar.am: folds
PlayTheBlues4U: folds
SeaofLove: calls $0.95
*** FLOP *** [Jc Tc As]
SeaofLove: checks
Ty1erDurrden: bets $1.82
SeaofLove: folds
Uncalled bet ($1.82) returned to Ty1erDurrden
Ty1erDurrden collected $2.42 from pot
Ty1erDurrden: doesn't show hand
*** SUMMARY ***
Total pot $2.55 | Rake $0.13
Board [Jc Tc As]
Seat 1: SourShoes9 (button) folded before Flop (didn't bet)
Seat 2: mankar.am (small blind) folded before Flop
Seat 3: PlayTheBlues4U (big blind) folded before Flop
Seat 4: SeaofLove folded on the Flop
Seat 6: Ty1erDurrden collected ($2.42)


PokerStars Hand #205379004510:  Hold'em No Limit ($0.05/$0.10 USD) - 2019/11/02 22:42:44 ET
Table 'Antares' 6-max Seat #4 is the button
Seat 1: SeaofLove ($10.66 in chips)
Seat 2: PlayTheBlues4U ($14.35 in chips)
Seat 3: StickyChipss ($13.32 in chips)
Seat 4: tempusfugit3737 ($10.97 in chips)
Seat 5: skoalguy33 ($14.84 in chips)
skoalguy33: posts small blind $0.05
SeaofLove: posts big blind $0.10
*** HOLE CARDS ***
Dealt to PlayTheBlues4U [4s 2h]
PlayTheBlues4U: folds
StickyChipss: folds
tempusfugit3737: raises $0.20 to $0.30
skoalguy33: folds
SeaofLove: folds
Uncalled bet ($0.20) returned to tempusfugit3737
tempusfugit3737 collected $0.25 from pot
tempusfugit3737: doesn't show hand
*** SUMMARY ***
Total pot $0.25 | Rake $0
Seat 1: SeaofLove (big blind) folded before Flop
Seat 2: PlayTheBlues4U folded before Flop (didn't bet)
Seat 3: StickyChipss folded before Flop (didn't bet)
Seat 4: tempusfugit3737 (button) collected ($0.25)
Seat 5: skoalguy33 (small blind) folded before Flop


PokerStars Hand #205379004393:  Hold'em No Limit ($0.05/$0.10 USD) - 2019/11/02 22:42:13 ET
Table 'Antares' 6-max Seat #3 is the button
Seat 1: SeaofLove ($10.66 in chips)
Seat 2: PlayTheBlues4U ($14.35 in chips)
Seat 3: StickyChipss ($13.32 in chips)
Seat 4: tempusfugit3737 ($10.88 in chips)
Seat 5: skoalguy33 ($14.94 in chips)
Seat 6: StarManNJ ($8.05 in chips)
tempusfugit3737: posts small blind $0.05
skoalguy33: posts big blind $0.10
*** HOLE CARDS ***
Dealt to PlayTheBlues4U [4s 9d]
StarManNJ: folds
SeaofLove: folds
StarManNJ leaves the table
PlayTheBlues4U: folds
StickyChipss: folds
tempusfugit3737: calls $0.05
skoalguy33: checks
*** FLOP *** [4h Qs 7d]
tempusfugit3737: checks
skoalguy33: checks
*** TURN *** [4h Qs 7d] [Td]
tempusfugit3737: bets $0.20
skoalguy33: folds
Uncalled bet ($0.20) returned to tempusfugit3737
tempusfugit3737 collected $0.19 from pot
tempusfugit3737: doesn't show hand
*** SUMMARY ***
Total pot $0.20 | Rake $0.01
Board [4h Qs 7d Td]
Seat 1: SeaofLove folded before Flop (didn't bet)
Seat 2: PlayTheBlues4U folded before Flop (didn't bet)
Seat 3: StickyChipss (button) folded before Flop (didn't bet)
Seat 4: tempusfugit3737 (small blind) collected ($0.19)
Seat 5: skoalguy33 (big blind) folded on the Turn
Seat 6: StarManNJ folded before Flop (didn't bet)


PokerStars Hand #205379004321:  Hold'em No Limit ($0.05/$0.10 USD) - 2019/11/02 22:41:55 ET
Table 'Antares' 6-max Seat #2 is the button
Seat 1: SeaofLove ($10.66 in chips)
Seat 2: PlayTheBlues4U ($14.35 in chips)
Seat 3: StickyChipss ($13.37 in chips)
Seat 4: tempusfugit3737 ($10.98 in chips)
Seat 5: skoalguy33 ($14.94 in chips)
Seat 6: StarManNJ ($7.90 in chips)
StickyChipss: posts small blind $0.05
tempusfugit3737: posts big blind $0.10
*** HOLE CARDS ***
Dealt to PlayTheBlues4U [4c 2h]
skoalguy33: folds
StarManNJ: raises $0.20 to $0.30
SeaofLove: folds
PlayTheBlues4U: folds
StickyChipss: folds
tempusfugit3737: folds
Uncalled bet ($0.20) returned to StarManNJ
StarManNJ collected $0.25 from pot
StarManNJ: doesn't show hand
*** SUMMARY ***
Total pot $0.25 | Rake $0
Seat 1: SeaofLove folded before Flop (didn't bet)
Seat 2: PlayTheBlues4U (button) folded before Flop (didn't bet)
Seat 3: StickyChipss (small blind) folded before Flop
Seat 4: tempusfugit3737 (big blind) folded before Flop
Seat 5: skoalguy33 folded before Flop (didn't bet)
Seat 6: StarManNJ collected ($0.25)


PokerStars Hand #205379004293:  Hold'em No Limit ($0.05/$0.10 USD) - 2019/11/02 22:41:48 ET
Table 'Hekate' 6-max Seat #6 is the button
Seat 1: SourShoes9 ($11.69 in chips)
Seat 2: mankar.am ($3.65 in chips)
Seat 3: PlayTheBlues4U ($48.72 in chips)
Seat 4: SeaofLove ($13.68 in chips)
Seat 5: StarManNJ ($7.60 in chips)
Seat 6: Ty1erDurrden ($12.84 in chips)
SourShoes9: posts small blind $0.05
mankar.am: posts big blind $0.10
*** HOLE CARDS ***
Dealt to PlayTheBlues4U [4d Tc]
PlayTheBlues4U: folds
SeaofLove: folds
StarManNJ: raises $0.10 to $0.20
Ty1erDurrden: raises $0.64 to $0.84
SourShoes9: folds
mankar.am: calls $0.74
StarManNJ: calls $0.64
*** FLOP *** [As Js 4s]
mankar.am: checks
StarManNJ: checks
Ty1erDurrden: bets $0.73
mankar.am: calls $0.73
StarManNJ: folds
*** TURN *** [As Js 4s] [4c]
StarManNJ leaves the table
mankar.am: checks
Ty1erDurrden: checks
*** RIVER *** [As Js 4s 4c] [3h]
mankar.am: checks
Ty1erDurrden: checks
*** SHOW DOWN ***
mankar.am: shows [Qs Jc] (two pair, Jacks and Fours)
Ty1erDurrden: mucks hand
mankar.am collected $3.83 from pot
*** SUMMARY ***
Total pot $4.03 | Rake $0.20
Board [As Js 4s 4c 3h]
Seat 1: SourShoes9 (small blind) folded before Flop
Seat 2: mankar.am (big blind) showed [Qs Jc] and won ($3.83) with two pair, Jacks and Fours
Seat 3: PlayTheBlues4U folded before Flop (didn't bet)
Seat 4: SeaofLove folded before Flop (didn't bet)
Seat 5: StarManNJ folded on the Flop
Seat 6: Ty1erDurrden (button) mucked [8d 7d]


PokerStars Hand #205379004275:  Hold'em No Limit ($0.05/$0.10 USD) - 2019/11/02 22:41:42 ET
Table 'Antares' 6-max Seat #1 is the button
Seat 1: SeaofLove ($10.66 in chips)
Seat 2: PlayTheBlues4U ($14.40 in chips)
Seat 3: StickyChipss ($13.47 in chips)
Seat 4: tempusfugit3737 ($10.73 in chips)
Seat 5: skoalguy33 ($14.94 in chips)
Seat 6: StarManNJ ($8 in chips)
PlayTheBlues4U: posts small blind $0.05
StickyChipss: posts big blind $0.10
StarManNJ: posts big blind $0.10
*** HOLE CARDS ***
Dealt to PlayTheBlues4U [8s Jd]
tempusfugit3737: raises $0.20 to $0.30
skoalguy33: folds
StarManNJ: folds
SeaofLove: folds
PlayTheBlues4U: folds
StickyChipss: folds
Uncalled bet ($0.20) returned to tempusfugit3737
tempusfugit3737 collected $0.35 from pot
tempusfugit3737: doesn't show hand
*** SUMMARY ***
Total pot $0.35 | Rake $0
Seat 1: SeaofLove (button) folded before Flop (didn't bet)
Seat 2: PlayTheBlues4U (small blind) folded before Flop
Seat 3: StickyChipss (big blind) folded before Flop
Seat 4: tempusfugit3737 collected ($0.35)
Seat 5: skoalguy33 folded before Flop (didn't bet)
Seat 6: StarManNJ folded before Flop (didn't bet)


PokerStars Hand #205379004179:  Hold'em No Limit ($0.05/$0.10 USD) - 2019/11/02 22:41:17 ET
Table 'Antares' 6-max Seat #5 is the button
Seat 1: SeaofLove ($10.71 in chips)
Seat 2: PlayTheBlues4U ($14.50 in chips)
Seat 3: StickyChipss ($13.77 in chips)
Seat 4: tempusfugit3737 ($10.28 in chips)
Seat 5: skoalguy33 ($14.94 in chips)
StarManNJ will be allowed to play after the button
SeaofLove: posts small blind $0.05
PlayTheBlues4U: posts big blind $0.10
*** HOLE CARDS ***
Dealt to PlayTheBlues4U [Ah Kd]
StickyChipss: raises $0.20 to $0.30
tempusfugit3737: raises $0.70 to $1
skoalguy33: folds
SeaofLove: folds
PlayTheBlues4U: folds
StickyChipss: folds
Uncalled bet ($0.70) returned to tempusfugit3737
tempusfugit3737 collected $0.75 from pot
tempusfugit3737: doesn't show hand
*** SUMMARY ***
Total pot $0.75 | Rake $0
Seat 1: SeaofLove (small blind) folded before Flop
Seat 2: PlayTheBlues4U (big blind) folded before Flop
Seat 3: StickyChipss folded before Flop
Seat 4: tempusfugit3737 collected ($0.75)
Seat 5: skoalguy33 (button) folded before Flop (didn't bet)


PokerStars Hand #205379004167:  Hold'em No Limit ($0.05/$0.10 USD) - 2019/11/02 22:41:14 ET
Table 'Hekate' 6-max Seat #5 is the button
Seat 1: SourShoes9 ($11.10 in chips)
Seat 2: mankar.am ($3.65 in chips)
Seat 3: PlayTheBlues4U ($48.72 in chips)
Seat 4: SeaofLove ($14.28 in chips)
Seat 5: StarManNJ ($7.60 in chips)
Seat 6: Ty1erDurrden ($12.89 in chips)
Ty1erDurrden: posts small blind $0.05
SourShoes9: posts big blind $0.10
*** HOLE CARDS ***
Dealt to PlayTheBlues4U [Kh 4c]
mankar.am: folds
PlayTheBlues4U: folds
SeaofLove: raises $0.15 to $0.25
StarManNJ: folds
Ty1erDurrden: folds
SourShoes9: calls $0.15
*** FLOP *** [5h Th 4s]
SourShoes9: checks
SeaofLove: checks
*** TURN *** [5h Th 4s] [8d]
SourShoes9: checks
SeaofLove: bets $0.35
SourShoes9: calls $0.35
*** RIVER *** [5h Th 4s 8d] [Qd]
SourShoes9: checks
SeaofLove: checks
*** SHOW DOWN ***
SourShoes9: shows [9h Qs] (a pair of Queens)
SeaofLove: mucks hand
SourShoes9 collected $1.19 from pot
*** SUMMARY ***
Total pot $1.25 | Rake $0.06
Board [5h Th 4s 8d Qd]
Seat 1: SourShoes9 (big blind) showed [9h Qs] and won ($1.19) with a pair of Queens
Seat 2: mankar.am folded before Flop (didn't bet)
Seat 3: PlayTheBlues4U folded before Flop (didn't bet)
Seat 4: SeaofLove mucked [Tc 9s]
Seat 5: StarManNJ (button) folded before Flop (didn't bet)
Seat 6: Ty1erDurrden (small blind) folded before Flop


PokerStars Hand #205379004001:  Hold'em No Limit ($0.05/$0.10 USD) - 2019/11/02 22:40:29 ET
Table 'Antares' 6-max Seat #4 is the button
Seat 1: SeaofLove ($10.15 in chips)
Seat 2: PlayTheBlues4U ($14.50 in chips)
Seat 3: StickyChipss ($13.77 in chips)
Seat 4: tempusfugit3737 ($10.58 in chips)
Seat 5: skoalguy33 ($15.24 in chips)
skoalguy33: posts small blind $0.05
SeaofLove: posts big blind $0.10
*** HOLE CARDS ***
Dealt to PlayTheBlues4U [2h Jd]
PlayTheBlues4U: folds
StickyChipss: folds
tempusfugit3737: raises $0.20 to $0.30
skoalguy33: calls $0.25
SeaofLove: calls $0.20
*** FLOP *** [6s Jc 4d]
StarManNJ joins the table at seat #6
skoalguy33: checks
SeaofLove: checks
tempusfugit3737: checks
*** TURN *** [6s Jc 4d] [Ts]
skoalguy33: checks
SeaofLove: bets $0.57
tempusfugit3737: folds
skoalguy33: folds
Uncalled bet ($0.57) returned to SeaofLove
SeaofLove collected $0.86 from pot
SeaofLove: doesn't show hand
*** SUMMARY ***
Total pot $0.90 | Rake $0.04
Board [6s Jc 4d Ts]
Seat 1: SeaofLove (big blind) collected ($0.86)
Seat 2: PlayTheBlues4U folded before Flop (didn't bet)
Seat 3: StickyChipss folded before Flop (didn't bet)
Seat 4: tempusfugit3737 (button) folded on the Turn
Seat 5: skoalguy33 (small blind) folded on the Turn


PokerStars Hand #205379003938:  Hold'em No Limit ($0.05/$0.10 USD) - 2019/11/02 22:40:16 ET
Table 'Hekate' 6-max Seat #4 is the button
Seat 1: SourShoes9 ($10 in chips)
Seat 2: mankar.am ($4.45 in chips)
Seat 3: PlayTheBlues4U ($48.72 in chips)
Seat 4: SeaofLove ($14.28 in chips)
Seat 5: StarManNJ ($7.70 in chips)
Seat 6: Ty1erDurrden ($13.19 in chips)
StarManNJ: posts small blind $0.05
Ty1erDurrden: posts big blind $0.10
*** HOLE CARDS ***
Dealt to PlayTheBlues4U [Td Kh]
SourShoes9: calls $0.10
mankar.am: calls $0.10
PlayTheBlues4U: folds
SeaofLove: folds
StarManNJ: calls $0.05
Ty1erDurrden: checks
*** FLOP *** [Ac 3d 2c]
StarManNJ: checks
Ty1erDurrden: checks
SourShoes9: bets $0.20
mankar.am: calls $0.20
StarManNJ: folds
Ty1erDurrden: calls $0.20
*** TURN *** [Ac 3d 2c] [Ts]
Ty1erDurrden: checks
SourShoes9: bets $0.50
mankar.am: calls $0.50
Ty1erDurrden: folds
*** RIVER *** [Ac 3d 2c Ts] [9d]
SourShoes9: bets $1.80
mankar.am: folds
Uncalled bet ($1.80) returned to SourShoes9
SourShoes9 collected $1.90 from pot
SourShoes9: doesn't show hand
*** SUMMARY ***
Total pot $2 | Rake $0.10
Board [Ac 3d 2c Ts 9d]
Seat 1: SourShoes9 collected ($1.90)
Seat 2: mankar.am folded on the River
Seat 3: PlayTheBlues4U folded before Flop (didn't bet)
Seat 4: SeaofLove (button) folded before Flop (didn't bet)
Seat 5: StarManNJ (small blind) folded on the Flop
Seat 6: Ty1erDurrden (big blind) folded on the Turn


PokerStars Hand #205379003935:  Hold'em No Limit ($0.05/$0.10 USD) - 2019/11/02 22:40:15 ET
Table 'Antares' 6-max Seat #3 is the button
Seat 1: SeaofLove ($10.15 in chips)
Seat 2: PlayTheBlues4U ($14.50 in chips)
Seat 3: StickyChipss ($13.77 in chips)
Seat 4: tempusfugit3737 ($10.63 in chips)
Seat 5: skoalguy33 ($15.19 in chips)
tempusfugit3737: posts small blind $0.05
skoalguy33: posts big blind $0.10
*** HOLE CARDS ***
Dealt to PlayTheBlues4U [8d 6s]
SeaofLove: folds
PlayTheBlues4U: folds
StickyChipss: folds
tempusfugit3737: folds
Uncalled bet ($0.05) returned to skoalguy33
skoalguy33 collected $0.10 from pot
skoalguy33: doesn't show hand
*** SUMMARY ***
Total pot $0.10 | Rake $0
Seat 1: SeaofLove folded before Flop (didn't bet)
Seat 2: PlayTheBlues4U folded before Flop (didn't bet)
Seat 3: StickyChipss (button) folded before Flop (didn't bet)
Seat 4: tempusfugit3737 (small blind) folded before Flop
Seat 5: skoalguy33 (big blind) collected ($0.10)


PokerStars Hand #205379003855:  Hold'em No Limit ($0.05/$0.10 USD) - 2019/11/02 22:39:54 ET
Table 'Antares' 6-max Seat #2 is the button
Seat 1: SeaofLove ($10 in chips)
Seat 2: PlayTheBlues4U ($14.50 in chips)
Seat 3: StickyChipss ($13.82 in chips)
Seat 4: tempusfugit3737 ($10.73 in chips)
Seat 5: skoalguy33 ($15.19 in chips)
StickyChipss: posts small blind $0.05
tempusfugit3737: posts big blind $0.10
*** HOLE CARDS ***
Dealt to PlayTheBlues4U [9s Qd]
skoalguy33: folds
SeaofLove: raises $0.15 to $0.25
PlayTheBlues4U: folds
StickyChipss: folds
tempusfugit3737: folds
Uncalled bet ($0.15) returned to SeaofLove
SeaofLove collected $0.25 from pot
SeaofLove: doesn't show hand
*** SUMMARY ***
Total pot $0.25 | Rake $0
Seat 1: SeaofLove collected ($0.25)
Seat 2: PlayTheBlues4U (button) folded before Flop (didn't bet)
Seat 3: StickyChipss (small blind) folded before Flop
Seat 4: tempusfugit3737 (big blind) folded before Flop
Seat 5: skoalguy33 folded before Flop (didn't bet)


PokerStars Hand #205379003821:  Hold'em No Limit ($0.05/$0.10 USD) - 2019/11/02 22:39:49 ET
Table 'Hekate' 6-max Seat #3 is the button
Seat 1: SourShoes9 ($10 in chips)
Seat 2: mankar.am ($4.80 in chips)
Seat 3: PlayTheBlues4U ($48.72 in chips)
Seat 4: SeaofLove ($14.33 in chips)
Seat 5: StarManNJ ($7.80 in chips)
Seat 6: Ty1erDurrden ($12.73 in chips)
SeaofLove: posts small blind $0.05
StarManNJ: posts big blind $0.10
*** HOLE CARDS ***
Dealt to PlayTheBlues4U [Jh 6h]
Ty1erDurrden: raises $0.15 to $0.25
SourShoes9: folds
mankar.am: calls $0.25
PlayTheBlues4U: folds
SeaofLove: folds
StarManNJ: folds
*** FLOP *** [Ks 4d 5h]
Ty1erDurrden: bets $0.10
mankar.am: calls $0.10
*** TURN *** [Ks 4d 5h] [As]
Ty1erDurrden: bets $0.53
mankar.am: folds
Uncalled bet ($0.53) returned to Ty1erDurrden
Ty1erDurrden collected $0.81 from pot
Ty1erDurrden: doesn't show hand
*** SUMMARY ***
Total pot $0.85 | Rake $0.04
Board [Ks 4d 5h As]
Seat 1: SourShoes9 folded before Flop (didn't bet)
Seat 2: mankar.am folded on the Turn
Seat 3: PlayTheBlues4U (button) folded before Flop (didn't bet)
Seat 4: SeaofLove (small blind) folded before Flop
Seat 5: StarManNJ (big blind) folded before Flop
Seat 6: Ty1erDurrden collected ($0.81)


PokerStars Hand #205379003765:  Hold'em No Limit ($0.05/$0.10 USD) - 2019/11/02 22:39:36 ET
Table 'Hekate' 6-max Seat #2 is the button
Seat 2: mankar.am ($4.80 in chips)
Seat 3: PlayTheBlues4U ($48.77 in chips)
Seat 4: SeaofLove ($14.43 in chips)
Seat 5: StarManNJ ($8 in chips)
Seat 6: Ty1erDurrden ($12.38 in chips)
PlayTheBlues4U: posts small blind $0.05
SeaofLove: posts big blind $0.10
StarManNJ: posts big blind $0.10
*** HOLE CARDS ***
Dealt to PlayTheBlues4U [2h 3c]
StarManNJ: raises $0.10 to $0.20
Ty1erDurrden: raises $0.64 to $0.84
mankar.am: folds
PlayTheBlues4U: folds
SeaofLove: folds
StarManNJ: folds
Uncalled bet ($0.64) returned to Ty1erDurrden
Ty1erDurrden collected $0.55 from pot
Ty1erDurrden: doesn't show hand
*** SUMMARY ***
Total pot $0.55 | Rake $0
Seat 2: mankar.am (button) folded before Flop (didn't bet)
Seat 3: PlayTheBlues4U (small blind) folded before Flop
Seat 4: SeaofLove (big blind) folded before Flop
Seat 5: StarManNJ folded before Flop
Seat 6: Ty1erDurrden collected ($0.55)


PokerStars Hand #205379003732:  Hold'em No Limit ($0.05/$0.10 USD) - 2019/11/02 22:39:28 ET
Table 'Antares' 6-max Seat #1 is the button
Seat 1: SeaofLove ($10 in chips)
Seat 2: PlayTheBlues4U ($14.55 in chips)
Seat 3: StickyChipss ($13.92 in chips)
Seat 4: tempusfugit3737 ($10.32 in chips)
Seat 5: skoalguy33 ($15.49 in chips)
PlayTheBlues4U: posts small blind $0.05
StickyChipss: posts big blind $0.10
*** HOLE CARDS ***
Dealt to PlayTheBlues4U [Ad 5s]
tempusfugit3737: raises $0.20 to $0.30
skoalguy33: calls $0.30
SeaofLove: folds
PlayTheBlues4U: folds
StickyChipss: folds
*** FLOP *** [6d 5h 6s]
tempusfugit3737: checks
skoalguy33: checks
*** TURN *** [6d 5h 6s] [9s]
tempusfugit3737: bets $0.30
skoalguy33: folds
Uncalled bet ($0.30) returned to tempusfugit3737
tempusfugit3737 collected $0.71 from pot
tempusfugit3737: doesn't show hand
*** SUMMARY ***
Total pot $0.75 | Rake $0.04
Board [6d 5h 6s 9s]
Seat 1: SeaofLove (button) folded before Flop (didn't bet)
Seat 2: PlayTheBlues4U (small blind) folded before Flop
Seat 3: StickyChipss (big blind) folded before Flop
Seat 4: tempusfugit3737 collected ($0.71)
Seat 5: skoalguy33 folded on the Turn


PokerStars Hand #205379003670:  Hold'em No Limit ($0.05/$0.10 USD) - 2019/11/02 22:39:15 ET
Table 'Antares' 6-max Seat #5 is the button
Seat 1: SeaofLove ($10 in chips)
Seat 2: PlayTheBlues4U ($14.50 in chips)
Seat 3: StickyChipss ($13.92 in chips)
Seat 4: tempusfugit3737 ($10.32 in chips)
Seat 5: skoalguy33 ($15.49 in chips)
SeaofLove: posts small blind $0.05
PlayTheBlues4U: posts big blind $0.10
*** HOLE CARDS ***
Dealt to PlayTheBlues4U [4c Qh]
StickyChipss: folds
StickyChipss said, "get out of here with dat"
tempusfugit3737: folds
skoalguy33: folds
SeaofLove: folds
Uncalled bet ($0.05) returned to PlayTheBlues4U
PlayTheBlues4U collected $0.10 from pot
PlayTheBlues4U: doesn't show hand
*** SUMMARY ***
Total pot $0.10 | Rake $0
Seat 1: SeaofLove (small blind) folded before Flop
Seat 2: PlayTheBlues4U (big blind) collected ($0.10)
Seat 3: StickyChipss folded before Flop (didn't bet)
Seat 4: tempusfugit3737 folded before Flop (didn't bet)
Seat 5: skoalguy33 (button) folded before Flop (didn't bet)


PokerStars Hand #205379003625:  Hold'em No Limit ($0.05/$0.10 USD) - 2019/11/02 22:39:06 ET
Table 'Hekate' 6-max Seat #1 is the button
Seat 1: SourShoes9 ($6.60 in chips)
Seat 2: mankar.am ($4.85 in chips)
Seat 3: PlayTheBlues4U ($42.78 in chips)
Seat 4: SeaofLove ($14.43 in chips)
Seat 6: Ty1erDurrden ($12.38 in chips)
mankar.am: posts small blind $0.05
PlayTheBlues4U: posts big blind $0.10
*** HOLE CARDS ***
Dealt to PlayTheBlues4U [Ts Tc]
SeaofLove: folds
Ty1erDurrden: folds
SourShoes9: calls $0.10
mankar.am: folds
PlayTheBlues4U: raises $0.20 to $0.30
SourShoes9: raises $6.30 to $6.60 and is all-in
StarManNJ joins the table at seat #5
PlayTheBlues4U: calls $6.30
*** FLOP *** [5d 9c 2d]
*** TURN *** [5d 9c 2d] [5h]
*** RIVER *** [5d 9c 2d 5h] [4h]
*** SHOW DOWN ***
PlayTheBlues4U: shows [Ts Tc] (two pair, Tens and Fives)
SourShoes9: shows [7h 7d] (two pair, Sevens and Fives)
PlayTheBlues4U collected $12.59 from pot
*** SUMMARY ***
Total pot $13.25 | Rake $0.66
Board [5d 9c 2d 5h 4h]
Seat 1: SourShoes9 (button) showed [7h 7d] and lost with two pair, Sevens and Fives
Seat 2: mankar.am (small blind) folded before Flop
Seat 3: PlayTheBlues4U (big blind) showed [Ts Tc] and won ($12.59) with two pair, Tens and Fives
Seat 4: SeaofLove folded before Flop (didn't bet)
Seat 6: Ty1erDurrden folded before Flop (didn't bet)


PokerStars Hand #205379003542:  Hold'em No Limit ($0.05/$0.10 USD) - 2019/11/02 22:38:44 ET
Table 'Antares' 6-max Seat #4 is the button
Seat 1: SeaofLove ($10 in chips)
Seat 2: PlayTheBlues4U ($14.50 in chips)
Seat 3: StickyChipss ($13.92 in chips)
Seat 4: tempusfugit3737 ($10 in chips)
Seat 5: skoalguy33 ($15.54 in chips)
skoalguy33: posts small blind $0.05
SeaofLove: posts big blind $0.10
*** HOLE CARDS ***
Dealt to PlayTheBlues4U [3s 4s]
PlayTheBlues4U: folds
StickyChipss: folds
tempusfugit3737: raises $0.20 to $0.30
skoalguy33: folds
SeaofLove: calls $0.20
*** FLOP *** [3h 4h 9d]
StickyChipss said, "Whats that little blocker bet for? lol"
SeaofLove: checks
tempusfugit3737: bets $0.40
SeaofLove: folds
Uncalled bet ($0.40) returned to tempusfugit3737
tempusfugit3737 collected $0.62 from pot
boxerpupp727 was removed from the table for failing to post
boxerpupp727 leaves the table
tempusfugit3737: doesn't show hand
*** SUMMARY ***
Total pot $0.65 | Rake $0.03
Board [3h 4h 9d]
Seat 1: SeaofLove (big blind) folded on the Flop
Seat 2: PlayTheBlues4U folded before Flop (didn't bet)
Seat 3: StickyChipss folded before Flop (didn't bet)
Seat 4: tempusfugit3737 (button) collected ($0.62)
Seat 5: skoalguy33 (small blind) folded before Flop


PokerStars Hand #205379003487:  Hold'em No Limit ($0.05/$0.10 USD) - 2019/11/02 22:38:29 ET
Table 'Hekate' 6-max Seat #6 is the button
Seat 1: SourShoes9 ($6.65 in chips)
Seat 2: mankar.am ($5.90 in chips)
Seat 3: PlayTheBlues4U ($42.78 in chips)
Seat 4: SeaofLove ($14.43 in chips)
Seat 6: Ty1erDurrden ($11.39 in chips)
SourShoes9: posts small blind $0.05
mankar.am: posts big blind $0.10
*** HOLE CARDS ***
Dealt to PlayTheBlues4U [Jh 5h]
PlayTheBlues4U: folds
SeaofLove: folds
Ty1erDurrden: raises $0.15 to $0.25
SourShoes9: folds
mankar.am: calls $0.15
*** FLOP *** [Js Ad 5c]
mankar.am: checks
Ty1erDurrden: checks
*** TURN *** [Js Ad 5c] [3s]
mankar.am: bets $0.30
Ty1erDurrden: calls $0.30
*** RIVER *** [Js Ad 5c 3s] [Ks]
mankar.am: bets $0.50
Ty1erDurrden: calls $0.50
*** SHOW DOWN ***
mankar.am: shows [7c Ts] (high card Ace)
Ty1erDurrden: shows [Kd Kh] (three of a kind, Kings)
Ty1erDurrden collected $2.04 from pot
*** SUMMARY ***
Total pot $2.15 | Rake $0.11
Board [Js Ad 5c 3s Ks]
Seat 1: SourShoes9 (small blind) folded before Flop
Seat 2: mankar.am (big blind) showed [7c Ts] and lost with high card Ace
Seat 3: PlayTheBlues4U folded before Flop (didn't bet)
Seat 4: SeaofLove folded before Flop (didn't bet)
Seat 6: Ty1erDurrden (button) showed [Kd Kh] and won ($2.04) with three of a kind, Kings


PokerStars Hand #205379003406:  Hold'em No Limit ($0.05/$0.10 USD) - 2019/11/02 22:38:07 ET
Table 'Hekate' 6-max Seat #4 is the button
Seat 1: SourShoes9 ($7.10 in chips)
Seat 2: mankar.am ($6.35 in chips)
Seat 3: PlayTheBlues4U ($42.78 in chips)
Seat 4: SeaofLove ($14.43 in chips)
Seat 6: Ty1erDurrden ($10.56 in chips)
Ty1erDurrden: posts small blind $0.05
SourShoes9: posts big blind $0.10
*** HOLE CARDS ***
Dealt to PlayTheBlues4U [3h 4d]
mankar.am: calls $0.10
PlayTheBlues4U: folds
SeaofLove: folds
Ty1erDurrden: raises $0.35 to $0.45
SourShoes9: calls $0.35
mankar.am: calls $0.35
*** FLOP *** [5s 3s Kd]
Ty1erDurrden: checks
SourShoes9: checks
mankar.am: checks
*** TURN *** [5s 3s Kd] [8h]
Ty1erDurrden: bets $0.90
SourShoes9: folds
mankar.am: folds
Uncalled bet ($0.90) returned to Ty1erDurrden
Ty1erDurrden collected $1.28 from pot
Ty1erDurrden: doesn't show hand
*** SUMMARY ***
Total pot $1.35 | Rake $0.07
Board [5s 3s Kd 8h]
Seat 1: SourShoes9 (big blind) folded on the Turn
Seat 2: mankar.am folded on the Turn
Seat 3: PlayTheBlues4U folded before Flop (didn't bet)
Seat 4: SeaofLove (button) folded before Flop (didn't bet)
Seat 6: Ty1erDurrden (small blind) collected ($1.28)


PokerStars Hand #205379003283:  Hold'em No Limit ($0.05/$0.10 USD) - 2019/11/02 22:37:37 ET
Table 'Hekate' 6-max Seat #3 is the button
Seat 1: SourShoes9 ($7.10 in chips)
Seat 2: mankar.am ($10.85 in chips)
Seat 3: PlayTheBlues4U ($42.78 in chips)
Seat 4: SeaofLove ($10.29 in chips)
Seat 5: doodooeater ($10.64 in chips)
Seat 6: Ty1erDurrden ($10.56 in chips)
SeaofLove: posts small blind $0.05
doodooeater: posts big blind $0.10
*** HOLE CARDS ***
Dealt to PlayTheBlues4U [Kh 5s]
Ty1erDurrden: folds
SourShoes9: folds
mankar.am: raises $0.10 to $0.20
PlayTheBlues4U: folds
SeaofLove: raises $0.50 to $0.70
doodooeater: folds
mankar.am: calls $0.50
*** FLOP *** [As 3c 4c]
SeaofLove: bets $0.80
mankar.am: raises $0.80 to $1.60
SeaofLove: calls $0.80
*** TURN *** [As 3c 4c] [2s]
doodooeater leaves the table
SeaofLove: checks
mankar.am: bets $2.20
SeaofLove: calls $2.20
*** RIVER *** [As 3c 4c 2s] [9c]
SeaofLove: checks
mankar.am: checks
*** SHOW DOWN ***
SeaofLove: shows [Ah Qh] (a pair of Aces)
mankar.am: mucks hand
SeaofLove collected $8.64 from pot
*** SUMMARY ***
Total pot $9.10 | Rake $0.46
Board [As 3c 4c 2s 9c]
Seat 1: SourShoes9 folded before Flop (didn't bet)
Seat 2: mankar.am mucked [Qs Jd]
Seat 3: PlayTheBlues4U (button) folded before Flop (didn't bet)
Seat 4: SeaofLove (small blind) showed [Ah Qh] and won ($8.64) with a pair of Aces
Seat 5: doodooeater (big blind) folded before Flop
Seat 6: Ty1erDurrden folded before Flop (didn't bet)


PokerStars Hand #205379003221:  Hold'em No Limit ($0.05/$0.10 USD) - 2019/11/02 22:37:22 ET
Table 'Antares' 6-max Seat #3 is the button
Seat 1: SeaofLove ($10 in chips)
Seat 2: PlayTheBlues4U ($14.50 in chips)
Seat 3: StickyChipss ($11.32 in chips)
Seat 4: tempusfugit3737 ($10.35 in chips)
Seat 5: skoalguy33 ($15.64 in chips)
tempusfugit3737: posts small blind $0.05
skoalguy33: posts big blind $0.10
*** HOLE CARDS ***
Dealt to PlayTheBlues4U [6h 5d]
SeaofLove: folds
PlayTheBlues4U: folds
StickyChipss: raises $0.20 to $0.30
tempusfugit3737: calls $0.25
skoalguy33: folds
*** FLOP *** [4s Js 7c]
tempusfugit3737: checks
StickyChipss: bets $0.44
tempusfugit3737: raises $0.54 to $0.98
StickyChipss: calls $0.54
*** TURN *** [4s Js 7c] [Tc]
tempusfugit3737: bets $1.50
StickyChipss: raises $8.54 to $10.04 and is all-in
tempusfugit3737: folds
Uncalled bet ($8.54) returned to StickyChipss
StickyChipss collected $5.38 from pot
*** SUMMARY ***
Total pot $5.66 | Rake $0.28
Board [4s Js 7c Tc]
Seat 1: SeaofLove folded before Flop (didn't bet)
Seat 2: PlayTheBlues4U folded before Flop (didn't bet)
Seat 3: StickyChipss (button) collected ($5.38)
Seat 4: tempusfugit3737 (small blind) folded on the Turn
Seat 5: skoalguy33 (big blind) folded before Flop


PokerStars Hand #205379003143:  Hold'em No Limit ($0.05/$0.10 USD) - 2019/11/02 22:37:04 ET
Table 'Antares' 6-max Seat #2 is the button
Seat 1: SeaofLove ($10 in chips)
Seat 2: PlayTheBlues4U ($14.50 in chips)
Seat 3: StickyChipss ($11.37 in chips)
Seat 4: tempusfugit3737 ($10.30 in chips)
Seat 5: skoalguy33 ($15.64 in chips)
StickyChipss: posts small blind $0.05
tempusfugit3737: posts big blind $0.10
*** HOLE CARDS ***
Dealt to PlayTheBlues4U [Jd 4c]
skoalguy33: folds
SeaofLove: folds
PlayTheBlues4U: folds
StickyChipss: folds
Uncalled bet ($0.05) returned to tempusfugit3737
tempusfugit3737 collected $0.10 from pot
tempusfugit3737: doesn't show hand
*** SUMMARY ***
Total pot $0.10 | Rake $0
Seat 1: SeaofLove folded before Flop (didn't bet)
Seat 2: PlayTheBlues4U (button) folded before Flop (didn't bet)
Seat 3: StickyChipss (small blind) folded before Flop
Seat 4: tempusfugit3737 (big blind) collected ($0.10)
Seat 5: skoalguy33 folded before Flop (didn't bet)


PokerStars Hand #205379003135:  Hold'em No Limit ($0.05/$0.10 USD) - 2019/11/02 22:37:02 ET
Table 'Hekate' 6-max Seat #2 is the button
Seat 1: SourShoes9 ($7.35 in chips)
Seat 2: mankar.am ($10.79 in chips)
Seat 3: PlayTheBlues4U ($42.83 in chips)
Seat 4: SeaofLove ($10.39 in chips)
Seat 5: doodooeater ($10.64 in chips)
Seat 6: Ty1erDurrden ($10.50 in chips)
PlayTheBlues4U: posts small blind $0.05
SeaofLove: posts big blind $0.10
*** HOLE CARDS ***
Dealt to PlayTheBlues4U [9h 3c]
doodooeater: folds
Ty1erDurrden: raises $0.15 to $0.25
SourShoes9: calls $0.25
mankar.am: calls $0.25
PlayTheBlues4U: folds
SeaofLove: folds
*** FLOP *** [2h As 7c]
Ty1erDurrden: checks
SourShoes9: checks
mankar.am: checks
*** TURN *** [2h As 7c] [Kc]
Ty1erDurrden: bets $0.50
SourShoes9: folds
mankar.am: raises $0.50 to $1
Ty1erDurrden: calls $0.50
*** RIVER *** [2h As 7c Kc] [7s]
Ty1erDurrden: checks
mankar.am: bets $1.40
Ty1erDurrden: calls $1.40
*** SHOW DOWN ***
mankar.am: shows [2c Ad] (two pair, Aces and Sevens)
Ty1erDurrden: shows [Ah Ts] (two pair, Aces and Sevens)
Ty1erDurrden collected $2.71 from pot
mankar.am collected $2.71 from pot
*** SUMMARY ***
Total pot $5.70 | Rake $0.28
Board [2h As 7c Kc 7s]
Seat 1: SourShoes9 folded on the Turn
Seat 2: mankar.am (button) showed [2c Ad] and won ($2.71) with two pair, Aces and Sevens
Seat 3: PlayTheBlues4U (small blind) folded before Flop
Seat 4: SeaofLove (big blind) folded before Flop
Seat 5: doodooeater folded before Flop (didn't bet)
Seat 6: Ty1erDurrden showed [Ah Ts] and won ($2.71) with two pair, Aces and Sevens


PokerStars Hand #205379003096:  Hold'em No Limit ($0.05/$0.10 USD) - 2019/11/02 22:36:52 ET
Table 'Antares' 6-max Seat #1 is the button
Seat 1: SeaofLove ($10 in chips)
Seat 2: PlayTheBlues4U ($14.55 in chips)
Seat 3: StickyChipss ($11.47 in chips)
Seat 4: tempusfugit3737 ($10.15 in chips)
Seat 5: skoalguy33 ($15.64 in chips)
PlayTheBlues4U: posts small blind $0.05
StickyChipss: posts big blind $0.10
*** HOLE CARDS ***
Dealt to PlayTheBlues4U [4c Ad]
tempusfugit3737: raises $0.20 to $0.30
skoalguy33: folds
SeaofLove: folds
PlayTheBlues4U: folds
StickyChipss: folds
Uncalled bet ($0.20) returned to tempusfugit3737
tempusfugit3737 collected $0.25 from pot
tempusfugit3737: doesn't show hand
*** SUMMARY ***
Total pot $0.25 | Rake $0
Seat 1: SeaofLove (button) folded before Flop (didn't bet)
Seat 2: PlayTheBlues4U (small blind) folded before Flop
Seat 3: StickyChipss (big blind) folded before Flop
Seat 4: tempusfugit3737 collected ($0.25)
Seat 5: skoalguy33 folded before Flop (didn't bet)


PokerStars Hand #205379003029:  Hold'em No Limit ($0.05/$0.10 USD) - 2019/11/02 22:36:34 ET
Table 'Antares' 6-max Seat #5 is the button
Seat 1: SeaofLove ($10.05 in chips)
Seat 2: PlayTheBlues4U ($14.65 in chips)
Seat 3: StickyChipss ($11.77 in chips)
Seat 4: tempusfugit3737 ($10.15 in chips)
Seat 5: skoalguy33 ($15.19 in chips)
SeaofLove: posts small blind $0.05
PlayTheBlues4U: posts big blind $0.10
*** HOLE CARDS ***
Dealt to PlayTheBlues4U [Qs 8h]
StickyChipss: raises $0.20 to $0.30
tempusfugit3737: folds
skoalguy33: raises $0.75 to $1.05
SeaofLove: folds
PlayTheBlues4U: folds
StickyChipss: folds
Uncalled bet ($0.75) returned to skoalguy33
skoalguy33 collected $0.75 from pot
skoalguy33: doesn't show hand
*** SUMMARY ***
Total pot $0.75 | Rake $0
Seat 1: SeaofLove (small blind) folded before Flop
Seat 2: PlayTheBlues4U (big blind) folded before Flop
Seat 3: StickyChipss folded before Flop
Seat 4: tempusfugit3737 folded before Flop (didn't bet)
Seat 5: skoalguy33 (button) collected ($0.75)


PokerStars Hand #205379003025:  Hold'em No Limit ($0.05/$0.10 USD) - 2019/11/02 22:36:33 ET
Table 'Hekate' 6-max Seat #1 is the button
Seat 1: SourShoes9 ($7.35 in chips)
Seat 2: mankar.am ($11.39 in chips)
Seat 3: PlayTheBlues4U ($42.93 in chips)
Seat 4: SeaofLove ($10.39 in chips)
Seat 5: doodooeater ($10 in chips)
Seat 6: Ty1erDurrden ($10.50 in chips)
mankar.am: posts small blind $0.05
PlayTheBlues4U: posts big blind $0.10
*** HOLE CARDS ***
Dealt to PlayTheBlues4U [Kc 3h]
SeaofLove: folds
doodooeater: raises $0.20 to $0.30
Ty1erDurrden: folds
SourShoes9: folds
mankar.am: calls $0.25
PlayTheBlues4U: folds
*** FLOP *** [3d Ad 4h]
mankar.am: checks
doodooeater: checks
*** TURN *** [3d Ad 4h] [Qh]
mankar.am: bets $0.30
doodooeater: raises $0.95 to $1.25
mankar.am: folds
Uncalled bet ($0.95) returned to doodooeater
doodooeater collected $1.24 from pot
*** SUMMARY ***
Total pot $1.30 | Rake $0.06
Board [3d Ad 4h Qh]
Seat 1: SourShoes9 (button) folded before Flop (didn't bet)
Seat 2: mankar.am (small blind) folded on the Turn
Seat 3: PlayTheBlues4U (big blind) folded before Flop
Seat 4: SeaofLove folded before Flop (didn't bet)
Seat 5: doodooeater collected ($1.24)
Seat 6: Ty1erDurrden folded before Flop (didn't bet)


PokerStars Hand #205379002947:  Hold'em No Limit ($0.05/$0.10 USD) - 2019/11/02 22:36:16 ET
Table 'Antares' 6-max Seat #4 is the button
Seat 1: SeaofLove ($10.15 in chips)
Seat 2: PlayTheBlues4U ($14.65 in chips)
Seat 3: StickyChipss ($11.77 in chips)
Seat 4: tempusfugit3737 ($10 in chips)
Seat 5: skoalguy33 ($15.24 in chips)
skoalguy33: posts small blind $0.05
SeaofLove: posts big blind $0.10
*** HOLE CARDS ***
Dealt to PlayTheBlues4U [5d Ac]
PlayTheBlues4U: folds
StickyChipss: folds
tempusfugit3737: raises $0.20 to $0.30
skoalguy33: folds
SeaofLove: folds
Uncalled bet ($0.20) returned to tempusfugit3737
tempusfugit3737 collected $0.25 from pot
tempusfugit3737: doesn't show hand
*** SUMMARY ***
Total pot $0.25 | Rake $0
Seat 1: SeaofLove (big blind) folded before Flop
Seat 2: PlayTheBlues4U folded before Flop (didn't bet)
Seat 3: StickyChipss folded before Flop (didn't bet)
Seat 4: tempusfugit3737 (button) collected ($0.25)
Seat 5: skoalguy33 (small blind) folded before Flop


PokerStars Hand #205379002911:  Hold'em No Limit ($0.05/$0.10 USD) - 2019/11/02 22:36:05 ET
Table 'Hekate' 6-max Seat #6 is the button
Seat 1: SourShoes9 ($7.55 in chips)
Seat 2: mankar.am ($11.21 in chips)
Seat 3: PlayTheBlues4U ($42.93 in chips)
Seat 4: SeaofLove ($10.39 in chips)
Seat 5: doodooeater ($10 in chips)
Seat 6: Ty1erDurrden ($10.50 in chips)
SourShoes9: posts small blind $0.05
mankar.am: posts big blind $0.10
*** HOLE CARDS ***
Dealt to PlayTheBlues4U [9d 3c]
PlayTheBlues4U: folds
SeaofLove: folds
doodooeater: folds
Ty1erDurrden: folds
SourShoes9: calls $0.05
mankar.am: raises $0.10 to $0.20
SourShoes9: calls $0.10
*** FLOP *** [8s Js 2h]
SourShoes9: checks
mankar.am: bets $0.20
SourShoes9: folds
Uncalled bet ($0.20) returned to mankar.am
mankar.am collected $0.38 from pot
*** SUMMARY ***
Total pot $0.40 | Rake $0.02
Board [8s Js 2h]
Seat 1: SourShoes9 (small blind) folded on the Flop
Seat 2: mankar.am (big blind) collected ($0.38)
Seat 3: PlayTheBlues4U folded before Flop (didn't bet)
Seat 4: SeaofLove folded before Flop (didn't bet)
Seat 5: doodooeater folded before Flop (didn't bet)
Seat 6: Ty1erDurrden (button) folded before Flop (didn't bet)


PokerStars Hand #205379002893:  Hold'em No Limit ($0.05/$0.10 USD) - 2019/11/02 22:36:00 ET
Table 'Antares' 6-max Seat #3 is the button
Seat 1: SeaofLove ($10 in chips)
Seat 2: PlayTheBlues4U ($14.65 in chips)
Seat 3: StickyChipss ($11.77 in chips)
Seat 4: tempusfugit3737 ($10.05 in chips)
Seat 5: skoalguy33 ($15.34 in chips)
tempusfugit3737: posts small blind $0.05
skoalguy33: posts big blind $0.10
*** HOLE CARDS ***
Dealt to PlayTheBlues4U [4c 9c]
SeaofLove: raises $0.15 to $0.25
PlayTheBlues4U: folds
StickyChipss: folds
tempusfugit3737: folds
skoalguy33: folds
Uncalled bet ($0.15) returned to SeaofLove
SeaofLove collected $0.25 from pot
SeaofLove: doesn't show hand
*** SUMMARY ***
Total pot $0.25 | Rake $0
Seat 1: SeaofLove collected ($0.25)
Seat 2: PlayTheBlues4U folded before Flop (didn't bet)
Seat 3: StickyChipss (button) folded before Flop (didn't bet)
Seat 4: tempusfugit3737 (small blind) folded before Flop
Seat 5: skoalguy33 (big blind) folded before Flop


PokerStars Hand #205379002852:  Hold'em No Limit ($0.05/$0.10 USD) - 2019/11/02 22:35:50 ET
Table 'Antares' 6-max Seat #2 is the button
Seat 1: SeaofLove ($10 in chips)
Seat 2: PlayTheBlues4U ($14.65 in chips)
Seat 3: StickyChipss ($11.82 in chips)
Seat 4: tempusfugit3737 ($10 in chips)
Seat 5: skoalguy33 ($15.34 in chips)
StickyChipss: posts small blind $0.05
tempusfugit3737: posts big blind $0.10
*** HOLE CARDS ***
Dealt to PlayTheBlues4U [4s Ah]
skoalguy33: folds
SeaofLove: folds
PlayTheBlues4U: folds
StickyChipss: folds
Uncalled bet ($0.05) returned to tempusfugit3737
tempusfugit3737 collected $0.10 from pot
tempusfugit3737: doesn't show hand
*** SUMMARY ***
Total pot $0.10 | Rake $0
Seat 1: SeaofLove folded before Flop (didn't bet)
Seat 2: PlayTheBlues4U (button) folded before Flop (didn't bet)
Seat 3: StickyChipss (small blind) folded before Flop
Seat 4: tempusfugit3737 (big blind) collected ($0.10)
Seat 5: skoalguy33 folded before Flop (didn't bet)


PokerStars Hand #205379002762:  Hold'em No Limit ($0.05/$0.10 USD) - 2019/11/02 22:35:26 ET
Table 'Hekate' 6-max Seat #5 is the button
Seat 1: SourShoes9 ($7.85 in chips)
Seat 2: mankar.am ($11.21 in chips)
Seat 3: PlayTheBlues4U ($42.61 in chips)
Seat 4: SeaofLove ($10.39 in chips)
Seat 5: doodooeater ($10 in chips)
Seat 6: Ty1erDurrden ($10.55 in chips)
Ty1erDurrden: posts small blind $0.05
SourShoes9: posts big blind $0.10
*** HOLE CARDS ***
Dealt to PlayTheBlues4U [As Jc]
mankar.am: folds
PlayTheBlues4U: raises $0.20 to $0.30
SeaofLove: folds
doodooeater: folds
Ty1erDurrden: folds
SourShoes9: calls $0.20
*** FLOP *** [3d 7s Ks]
SourShoes9: checks
PlayTheBlues4U: checks
*** TURN *** [3d 7s Ks] [Kc]
SourShoes9: checks
PlayTheBlues4U: checks
*** RIVER *** [3d 7s Ks Kc] [9h]
SourShoes9: checks
PlayTheBlues4U: checks
*** SHOW DOWN ***
SourShoes9: shows [4d 6c] (a pair of Kings)
PlayTheBlues4U: shows [As Jc] (a pair of Kings - Ace kicker)
PlayTheBlues4U collected $0.62 from pot
*** SUMMARY ***
Total pot $0.65 | Rake $0.03
Board [3d 7s Ks Kc 9h]
Seat 1: SourShoes9 (big blind) showed [4d 6c] and lost with a pair of Kings
Seat 2: mankar.am folded before Flop (didn't bet)
Seat 3: PlayTheBlues4U showed [As Jc] and won ($0.62) with a pair of Kings
Seat 4: SeaofLove folded before Flop (didn't bet)
Seat 5: doodooeater (button) folded before Flop (didn't bet)
Seat 6: Ty1erDurrden (small blind) folded before Flop


PokerStars Hand #205379002689:  Hold'em No Limit ($0.05/$0.10 USD) - 2019/11/02 22:35:06 ET
Table 'Hekate' 6-max Seat #4 is the button
Seat 1: SourShoes9 ($8.05 in chips)
Seat 2: mankar.am ($10.89 in chips)
Seat 3: PlayTheBlues4U ($42.61 in chips)
Seat 4: SeaofLove ($10.39 in chips)
Seat 5: doodooeater ($10 in chips)
Seat 6: Ty1erDurrden ($10.65 in chips)
doodooeater: posts small blind $0.05
Ty1erDurrden: posts big blind $0.10
*** HOLE CARDS ***
Dealt to PlayTheBlues4U [6d 9c]
SourShoes9: calls $0.10
mankar.am: raises $0.10 to $0.20
PlayTheBlues4U: folds
SeaofLove: folds
doodooeater: folds
Ty1erDurrden: folds
SourShoes9: calls $0.10
*** FLOP *** [7s 6s Td]
SourShoes9: checks
mankar.am: bets $0.30
SourShoes9: folds
Uncalled bet ($0.30) returned to mankar.am
mankar.am collected $0.52 from pot
*** SUMMARY ***
Total pot $0.55 | Rake $0.03
Board [7s 6s Td]
Seat 1: SourShoes9 folded on the Flop
Seat 2: mankar.am collected ($0.52)
Seat 3: PlayTheBlues4U folded before Flop (didn't bet)
Seat 4: SeaofLove (button) folded before Flop (didn't bet)
Seat 5: doodooeater (small blind) folded before Flop
Seat 6: Ty1erDurrden (big blind) folded before Flop


PokerStars Hand #205379002619:  Hold'em No Limit ($0.05/$0.10 USD) - 2019/11/02 22:34:47 ET
Table 'Antares' 6-max Seat #1 is the button
Seat 1: SeaofLove ($12.53 in chips)
Seat 2: PlayTheBlues4U ($14.70 in chips)
Seat 3: StickyChipss ($11.92 in chips)
Seat 4: tempusfugit3737 ($10 in chips)
Seat 5: skoalguy33 ($8 in chips)
PlayTheBlues4U: posts small blind $0.05
StickyChipss: posts big blind $0.10
*** HOLE CARDS ***
Dealt to PlayTheBlues4U [Ts Tc]
tempusfugit3737 has timed out
tempusfugit3737: folds
skoalguy33: raises $0.20 to $0.30
SeaofLove: raises $0.75 to $1.05
PlayTheBlues4U: folds
StickyChipss: folds
skoalguy33: calls $0.75
*** FLOP *** [Th 9h 6c]
skoalguy33: checks
SeaofLove: bets $1.43
skoalguy33: calls $1.43
*** TURN *** [Th 9h 6c] [4h]
skoalguy33: checks
SeaofLove: bets $3.23
skoalguy33: raises $2.29 to $5.52 and is all-in
SeaofLove: calls $2.29
*** RIVER *** [Th 9h 6c 4h] [As]
*** SHOW DOWN ***
skoalguy33: shows [Qh Kh] (a flush, King high)
SeaofLove: shows [9d 9c] (three of a kind, Nines)
skoalguy33 collected $15.34 from pot
*** SUMMARY ***
Total pot $16.15 | Rake $0.81
Board [Th 9h 6c 4h As]
Seat 1: SeaofLove (button) showed [9d 9c] and lost with three of a kind, Nines
Seat 2: PlayTheBlues4U (small blind) folded before Flop
Seat 3: StickyChipss (big blind) folded before Flop
Seat 4: tempusfugit3737 folded before Flop (didn't bet)
Seat 5: skoalguy33 showed [Qh Kh] and won ($15.34) with a flush, King high


PokerStars Hand #205379002570:  Hold'em No Limit ($0.05/$0.10 USD) - 2019/11/02 22:34:33 ET
Table 'Hekate' 6-max Seat #3 is the button
Seat 1: SourShoes9 ($9.90 in chips)
Seat 2: mankar.am ($8.28 in chips)
Seat 3: PlayTheBlues4U ($42.61 in chips)
Seat 4: SeaofLove ($11.29 in chips)
Seat 5: doodooeater ($10 in chips)
Seat 6: Ty1erDurrden ($10.65 in chips)
SeaofLove: posts small blind $0.05
doodooeater: posts big blind $0.10
*** HOLE CARDS ***
Dealt to PlayTheBlues4U [7s Js]
Ty1erDurrden: folds
SourShoes9: raises $0.25 to $0.35
mankar.am: calls $0.35
PlayTheBlues4U: folds
SeaofLove: calls $0.30
doodooeater: folds
*** FLOP *** [7d 2d 2c]
SeaofLove: bets $0.55
SourShoes9: raises $0.95 to $1.50
mankar.am: raises $0.95 to $2.45
SeaofLove: folds
SourShoes9: folds
Uncalled bet ($0.95) returned to mankar.am
mankar.am collected $4.46 from pot
*** SUMMARY ***
Total pot $4.70 | Rake $0.24
Board [7d 2d 2c]
Seat 1: SourShoes9 folded on the Flop
Seat 2: mankar.am collected ($4.46)
Seat 3: PlayTheBlues4U (button) folded before Flop (didn't bet)
Seat 4: SeaofLove (small blind) folded on the Flop
Seat 5: doodooeater (big blind) folded before Flop
Seat 6: Ty1erDurrden folded before Flop (didn't bet)


PokerStars Hand #205379002548:  Hold'em No Limit ($0.05/$0.10 USD) - 2019/11/02 22:34:28 ET
Table 'Antares' 6-max Seat #5 is the button
Seat 1: SeaofLove ($12.58 in chips)
Seat 2: PlayTheBlues4U ($14.80 in chips)
Seat 3: StickyChipss ($11.92 in chips)
Seat 4: tempusfugit3737 ($9 in chips)
Seat 5: skoalguy33 ($7.85 in chips)
SeaofLove: posts small blind $0.05
PlayTheBlues4U: posts big blind $0.10
*** HOLE CARDS ***
Dealt to PlayTheBlues4U [6c Ad]
StickyChipss: folds
tempusfugit3737: folds
skoalguy33: raises $0.20 to $0.30
SeaofLove: folds
PlayTheBlues4U: folds
Uncalled bet ($0.20) returned to skoalguy33
skoalguy33 collected $0.25 from pot
skoalguy33: doesn't show hand
*** SUMMARY ***
Total pot $0.25 | Rake $0
Seat 1: SeaofLove (small blind) folded before Flop
Seat 2: PlayTheBlues4U (big blind) folded before Flop
Seat 3: StickyChipss folded before Flop (didn't bet)
Seat 4: tempusfugit3737 folded before Flop (didn't bet)
Seat 5: skoalguy33 (button) collected ($0.25)


PokerStars Hand #205379002466:  Hold'em No Limit ($0.05/$0.10 USD) - 2019/11/02 22:34:07 ET
Table 'Hekate' 6-max Seat #2 is the button
Seat 1: SourShoes9 ($10 in chips)
Seat 2: mankar.am ($8.05 in chips)
Seat 3: PlayTheBlues4U ($42.66 in chips)
Seat 4: SeaofLove ($11.39 in chips)
Seat 5: doodooeater ($10 in chips)
Seat 6: Ty1erDurrden ($10.65 in chips)
PlayTheBlues4U: posts small blind $0.05
SeaofLove: posts big blind $0.10
SourShoes9: posts big blind $0.10
*** HOLE CARDS ***
Dealt to PlayTheBlues4U [6s Qh]
doodooeater: folds
Ty1erDurrden: folds
SourShoes9: checks
mankar.am: calls $0.10
PlayTheBlues4U: folds
SeaofLove: checks
*** FLOP *** [9d 5c 8d]
SeaofLove: checks
SourShoes9: checks
mankar.am: bets $0.20
SeaofLove: folds
SourShoes9: folds
Uncalled bet ($0.20) returned to mankar.am
mankar.am collected $0.33 from pot
mankar.am: doesn't show hand
*** SUMMARY ***
Total pot $0.35 | Rake $0.02
Board [9d 5c 8d]
Seat 1: SourShoes9 folded on the Flop (didn't bet)
Seat 2: mankar.am (button) collected ($0.33)
Seat 3: PlayTheBlues4U (small blind) folded before Flop
Seat 4: SeaofLove (big blind) folded on the Flop
Seat 5: doodooeater folded before Flop (didn't bet)
Seat 6: Ty1erDurrden folded before Flop (didn't bet)


PokerStars Hand #205379002413:  Hold'em No Limit ($0.05/$0.10 USD) - 2019/11/02 22:33:51 ET
Table 'Hekate' 6-max Seat #6 is the button
Seat 2: mankar.am ($8.10 in chips)
Seat 3: PlayTheBlues4U ($42.76 in chips)
Seat 4: SeaofLove ($11.39 in chips)
Seat 5: doodooeater ($10 in chips)
Seat 6: Ty1erDurrden ($10.40 in chips)
mankar.am: posts small blind $0.05
PlayTheBlues4U: posts big blind $0.10
doodooeater: posts big blind $0.10
*** HOLE CARDS ***
Dealt to PlayTheBlues4U [9h 2c]
SeaofLove: folds
doodooeater: checks
SourShoes9 joins the table at seat #1
Ty1erDurrden: raises $0.35 to $0.45
mankar.am: folds
PlayTheBlues4U: folds
doodooeater: folds
Uncalled bet ($0.35) returned to Ty1erDurrden
Ty1erDurrden collected $0.35 from pot
Ty1erDurrden: doesn't show hand
*** SUMMARY ***
Total pot $0.35 | Rake $0
Seat 2: mankar.am (small blind) folded before Flop
Seat 3: PlayTheBlues4U (big blind) folded before Flop
Seat 4: SeaofLove folded before Flop (didn't bet)
Seat 5: doodooeater folded before Flop (didn't bet)
Seat 6: Ty1erDurrden (button) collected ($0.35)


PokerStars Hand #205379002352:  Hold'em No Limit ($0.05/$0.10 USD) - 2019/11/02 22:33:33 ET
Table 'Antares' 6-max Seat #4 is the button
Seat 1: SeaofLove ($12.68 in chips)
Seat 2: PlayTheBlues4U ($14.80 in chips)
Seat 3: StickyChipss ($11.01 in chips)
Seat 4: tempusfugit3737 ($9.85 in chips)
Seat 5: skoalguy33 ($7.90 in chips)
skoalguy33: posts small blind $0.05
SeaofLove: posts big blind $0.10
*** HOLE CARDS ***
Dealt to PlayTheBlues4U [3s 4c]
PlayTheBlues4U: folds
StickyChipss: raises $0.20 to $0.30
tempusfugit3737: calls $0.30
skoalguy33: folds
SeaofLove: folds
*** FLOP *** [Td 7d 2c]
StickyChipss: bets $0.55
tempusfugit3737: calls $0.55
*** TURN *** [Td 7d 2c] [8s]
StickyChipss: bets $1.36
tempusfugit3737: folds
Uncalled bet ($1.36) returned to StickyChipss
StickyChipss collected $1.76 from pot
*** SUMMARY ***
Total pot $1.85 | Rake $0.09
Board [Td 7d 2c 8s]
Seat 1: SeaofLove (big blind) folded before Flop
Seat 2: PlayTheBlues4U folded before Flop (didn't bet)
Seat 3: StickyChipss collected ($1.76)
Seat 4: tempusfugit3737 (button) folded on the Turn
Seat 5: skoalguy33 (small blind) folded before Flop


PokerStars Hand #205379002323:  Hold'em No Limit ($0.05/$0.10 USD) - 2019/11/02 22:33:27 ET
Table 'Hekate' 6-max Seat #4 is the button
Seat 2: mankar.am ($8.20 in chips)
Seat 3: PlayTheBlues4U ($43.06 in chips)
Seat 4: SeaofLove ($11.39 in chips)
Seat 6: Ty1erDurrden ($10 in chips)
doodooeater will be allowed to play after the button
Ty1erDurrden: posts small blind $0.05
mankar.am: posts big blind $0.10
*** HOLE CARDS ***
Dealt to PlayTheBlues4U [Ac Td]
PlayTheBlues4U: raises $0.20 to $0.30
SeaofLove: folds
Ty1erDurrden: raises $0.90 to $1.20
mankar.am: folds
PlayTheBlues4U: folds
Uncalled bet ($0.90) returned to Ty1erDurrden
Ty1erDurrden collected $0.70 from pot
Ty1erDurrden: doesn't show hand
*** SUMMARY ***
Total pot $0.70 | Rake $0
Seat 2: mankar.am (big blind) folded before Flop
Seat 3: PlayTheBlues4U folded before Flop
Seat 4: SeaofLove (button) folded before Flop (didn't bet)
Seat 6: Ty1erDurrden (small blind) collected ($0.70)


PokerStars Hand #205379002300:  Hold'em No Limit ($0.05/$0.10 USD) - 2019/11/02 22:33:21 ET
Table 'Antares' 6-max Seat #3 is the button
Seat 1: SeaofLove ($12.68 in chips)
Seat 2: PlayTheBlues4U ($14.80 in chips)
Seat 3: StickyChipss ($11.01 in chips)
Seat 4: tempusfugit3737 ($9.75 in chips)
Seat 5: skoalguy33 ($8 in chips)
tempusfugit3737: posts small blind $0.05
skoalguy33: posts big blind $0.10
*** HOLE CARDS ***
Dealt to PlayTheBlues4U [8s Qh]
SeaofLove: folds
PlayTheBlues4U: folds
StickyChipss: folds
tempusfugit3737: raises $0.20 to $0.30
skoalguy33: folds
Uncalled bet ($0.20) returned to tempusfugit3737
tempusfugit3737 collected $0.20 from pot
tempusfugit3737: doesn't show hand
*** SUMMARY ***
Total pot $0.20 | Rake $0
Seat 1: SeaofLove folded before Flop (didn't bet)
Seat 2: PlayTheBlues4U folded before Flop (didn't bet)
Seat 3: StickyChipss (button) folded before Flop (didn't bet)
Seat 4: tempusfugit3737 (small blind) collected ($0.20)
Seat 5: skoalguy33 (big blind) folded before Flop


PokerStars Hand #205379002200:  Hold'em No Limit ($0.05/$0.10 USD) - 2019/11/02 22:32:53 ET
Table 'Antares' 6-max Seat #2 is the button
Seat 1: SeaofLove ($12.17 in chips)
Seat 2: PlayTheBlues4U ($15.05 in chips)
Seat 3: StickyChipss ($11.06 in chips)
Seat 4: tempusfugit3737 ($10 in chips)
StickyChipss: posts small blind $0.05
tempusfugit3737: posts big blind $0.10
skoalguy33: sits out
*** HOLE CARDS ***
Dealt to PlayTheBlues4U [9d Ah]
SeaofLove: raises $0.15 to $0.25
PlayTheBlues4U: calls $0.25
StickyChipss: folds
tempusfugit3737: calls $0.15
*** FLOP *** [2s Qs Qc]
tempusfugit3737: checks
SeaofLove: bets $0.51
PlayTheBlues4U: folds
tempusfugit3737: folds
Uncalled bet ($0.51) returned to SeaofLove
SeaofLove collected $0.76 from pot
SeaofLove: doesn't show hand
*** SUMMARY ***
Total pot $0.80 | Rake $0.04
Board [2s Qs Qc]
Seat 1: SeaofLove collected ($0.76)
Seat 2: PlayTheBlues4U (button) folded on the Flop
Seat 3: StickyChipss (small blind) folded before Flop
Seat 4: tempusfugit3737 (big blind) folded on the Flop


PokerStars Hand #205379002194:  Hold'em No Limit ($0.05/$0.10 USD) - 2019/11/02 22:32:51 ET
Table 'Hekate' 6-max Seat #3 is the button
Seat 2: mankar.am ($7.79 in chips)
Seat 3: PlayTheBlues4U ($43.36 in chips)
Seat 4: SeaofLove ($11.44 in chips)
Seat 6: Ty1erDurrden ($9.95 in chips)
SeaofLove: posts small blind $0.05
Ty1erDurrden: posts big blind $0.10
*** HOLE CARDS ***
Dealt to PlayTheBlues4U [Th Ah]
mankar.am: raises $0.10 to $0.20
PlayTheBlues4U: calls $0.20
SeaofLove: folds
Ty1erDurrden: folds
*** FLOP *** [9h 5c 3d]
mankar.am: checks
PlayTheBlues4U: checks
*** TURN *** [9h 5c 3d] [Jh]
mankar.am: bets $0.10
PlayTheBlues4U: calls $0.10
*** RIVER *** [9h 5c 3d Jh] [9d]
doodooeater joins the table at seat #5
mankar.am: bets $0.70
PlayTheBlues4U: folds
Uncalled bet ($0.70) returned to mankar.am
mankar.am collected $0.71 from pot
mankar.am: doesn't show hand
*** SUMMARY ***
Total pot $0.75 | Rake $0.04
Board [9h 5c 3d Jh 9d]
Seat 2: mankar.am collected ($0.71)
Seat 3: PlayTheBlues4U (button) folded on the River
Seat 4: SeaofLove (small blind) folded before Flop
Seat 6: Ty1erDurrden (big blind) folded before Flop


PokerStars Hand #205379002035:  Hold'em No Limit ($0.05/$0.10 USD) - 2019/11/02 22:32:08 ET
Table 'Hekate' 6-max Seat #2 is the button
Seat 2: mankar.am ($6.71 in chips)
Seat 3: PlayTheBlues4U ($44.46 in chips)
Seat 4: SeaofLove ($11.54 in chips)
Seat 6: Ty1erDurrden ($9.95 in chips)
PlayTheBlues4U: posts small blind $0.05
SeaofLove: posts big blind $0.10
*** HOLE CARDS ***
Dealt to PlayTheBlues4U [Td 9h]
Ty1erDurrden: folds
mankar.am: raises $0.10 to $0.20
PlayTheBlues4U: calls $0.15
SeaofLove: folds
*** FLOP *** [7d Qs Jd]
PlayTheBlues4U: checks
mankar.am: checks
*** TURN *** [7d Qs Jd] [4s]
PlayTheBlues4U: bets $0.30
mankar.am: calls $0.30
*** RIVER *** [7d Qs Jd 4s] [Qc]
PlayTheBlues4U: bets $0.60
mankar.am: calls $0.60
*** SHOW DOWN ***
PlayTheBlues4U: shows [Td 9h] (a pair of Queens)
mankar.am: shows [Ac Th] (a pair of Queens - Ace kicker)
mankar.am collected $2.18 from pot
*** SUMMARY ***
Total pot $2.30 | Rake $0.12
Board [7d Qs Jd 4s Qc]
Seat 2: mankar.am (button) showed [Ac Th] and won ($2.18) with a pair of Queens
Seat 3: PlayTheBlues4U (small blind) showed [Td 9h] and lost with a pair of Queens
Seat 4: SeaofLove (big blind) folded before Flop
Seat 6: Ty1erDurrden folded before Flop (didn't bet)


PokerStars Hand #205379001966:  Hold'em No Limit ($0.05/$0.10 USD) - 2019/11/02 22:31:50 ET
Table 'Hekate' 6-max Seat #6 is the button
Seat 2: mankar.am ($6.96 in chips)
Seat 3: PlayTheBlues4U ($44.56 in chips)
Seat 4: SeaofLove ($11.22 in chips)
Seat 6: Ty1erDurrden ($9.95 in chips)
mankar.am: posts small blind $0.05
PlayTheBlues4U: posts big blind $0.10
*** HOLE CARDS ***
Dealt to PlayTheBlues4U [2h Td]
SeaofLove: raises $0.15 to $0.25
Ty1erDurrden: folds
mankar.am: calls $0.20
PlayTheBlues4U: folds
*** FLOP *** [6s Kc 8h]
mankar.am: checks
SeaofLove: bets $0.38
mankar.am: folds
Uncalled bet ($0.38) returned to SeaofLove
SeaofLove collected $0.57 from pot
SeaofLove: doesn't show hand
*** SUMMARY ***
Total pot $0.60 | Rake $0.03
Board [6s Kc 8h]
Seat 2: mankar.am (small blind) folded on the Flop
Seat 3: PlayTheBlues4U (big blind) folded before Flop
Seat 4: SeaofLove collected ($0.57)
Seat 6: Ty1erDurrden (button) folded before Flop (didn't bet)


PokerStars Hand #205379001868:  Hold'em No Limit ($0.05/$0.10 USD) - 2019/11/02 22:31:23 ET
Table 'Hekate' 6-max Seat #4 is the button
Seat 2: mankar.am ($8.26 in chips)
Seat 3: PlayTheBlues4U ($44.56 in chips)
Seat 4: SeaofLove ($10 in chips)
Seat 6: Ty1erDurrden ($10 in chips)
Ty1erDurrden: posts small blind $0.05
mankar.am: posts big blind $0.10
*** HOLE CARDS ***
Dealt to PlayTheBlues4U [4c 8d]
PlayTheBlues4U: folds
SeaofLove: raises $0.15 to $0.25
Ty1erDurrden: folds
mankar.am: calls $0.15
*** FLOP *** [5d 4d Th]
mankar.am: bets $0.30
SeaofLove: raises $0.75 to $1.05
mankar.am: calls $0.75
*** TURN *** [5d 4d Th] [5s]
mankar.am: checks
SeaofLove: bets $1.30
mankar.am: folds
Uncalled bet ($1.30) returned to SeaofLove
SeaofLove collected $2.52 from pot
SeaofLove: doesn't show hand
*** SUMMARY ***
Total pot $2.65 | Rake $0.13
Board [5d 4d Th 5s]
Seat 2: mankar.am (big blind) folded on the Turn
Seat 3: PlayTheBlues4U folded before Flop (didn't bet)
Seat 4: SeaofLove (button) collected ($2.52)
Seat 6: Ty1erDurrden (small blind) folded before Flop


PokerStars Hand #205379001854:  Hold'em No Limit ($0.05/$0.10 USD) - 2019/11/02 22:31:19 ET
Table 'Antares' 6-max Seat #1 is the button
Seat 1: SeaofLove ($11.85 in chips)
Seat 2: PlayTheBlues4U ($15.30 in chips)
Seat 3: StickyChipss ($11.16 in chips)
PlayTheBlues4U: posts small blind $0.05
StickyChipss: posts big blind $0.10
*** HOLE CARDS ***
Dealt to PlayTheBlues4U [Tc 7c]
SeaofLove: raises $0.15 to $0.25
PlayTheBlues4U: calls $0.20
skoalguy33 joins the table at seat #5
tempusfugit3737 joins the table at seat #4
StickyChipss: folds
*** FLOP *** [Jd Qd 2h]
PlayTheBlues4U: checks
SeaofLove: checks
*** TURN *** [Jd Qd 2h] [2c]
PlayTheBlues4U: checks
SeaofLove: checks
*** RIVER *** [Jd Qd 2h 2c] [4c]
PlayTheBlues4U: checks
SeaofLove: checks
*** SHOW DOWN ***
PlayTheBlues4U: shows [Tc 7c] (a pair of Deuces)
SeaofLove: shows [Ac 6c] (a pair of Deuces - Ace kicker)
SeaofLove collected $0.57 from pot
*** SUMMARY ***
Total pot $0.60 | Rake $0.03
Board [Jd Qd 2h 2c 4c]
Seat 1: SeaofLove (button) showed [Ac 6c] and won ($0.57) with a pair of Deuces
Seat 2: PlayTheBlues4U (small blind) showed [Tc 7c] and lost with a pair of Deuces
Seat 3: StickyChipss (big blind) folded before Flop


PokerStars Hand #205379001833:  Hold'em No Limit ($0.05/$0.10 USD) - 2019/11/02 22:31:13 ET
Table 'Antares' 6-max Seat #3 is the button
Seat 1: SeaofLove ($11.90 in chips)
Seat 2: PlayTheBlues4U ($15.25 in chips)
Seat 3: StickyChipss ($11.16 in chips)
SeaofLove: posts small blind $0.05
PlayTheBlues4U: posts big blind $0.10
*** HOLE CARDS ***
Dealt to PlayTheBlues4U [9h 7s]
StickyChipss: folds
SeaofLove: folds
Uncalled bet ($0.05) returned to PlayTheBlues4U
PlayTheBlues4U collected $0.10 from pot
PlayTheBlues4U: doesn't show hand
*** SUMMARY ***
Total pot $0.10 | Rake $0
Seat 1: SeaofLove (small blind) folded before Flop
Seat 2: PlayTheBlues4U (big blind) collected ($0.10)
Seat 3: StickyChipss (button) folded before Flop (didn't bet)


PokerStars Hand #205379001803:  Hold'em No Limit ($0.05/$0.10 USD) - 2019/11/02 22:31:05 ET
Table 'Antares' 6-max Seat #2 is the button
Seat 1: SeaofLove ($11.85 in chips)
Seat 2: PlayTheBlues4U ($15.25 in chips)
Seat 3: StickyChipss ($11.21 in chips)
StickyChipss: posts small blind $0.05
SeaofLove: posts big blind $0.10
*** HOLE CARDS ***
Dealt to PlayTheBlues4U [4h Js]
PlayTheBlues4U: folds
StickyChipss: folds
Uncalled bet ($0.05) returned to SeaofLove
SeaofLove collected $0.10 from pot
SeaofLove: doesn't show hand
*** SUMMARY ***
Total pot $0.10 | Rake $0
Seat 1: SeaofLove (big blind) collected ($0.10)
Seat 2: PlayTheBlues4U (button) folded before Flop (didn't bet)
Seat 3: StickyChipss (small blind) folded before Flop


PokerStars Hand #205379001755:  Hold'em No Limit ($0.05/$0.10 USD) - 2019/11/02 22:30:53 ET
Table 'Antares' 6-max Seat #1 is the button
Seat 1: SeaofLove ($11.85 in chips)
Seat 2: PlayTheBlues4U ($15.15 in chips)
Seat 3: StickyChipss ($11.31 in chips)
PlayTheBlues4U: posts small blind $0.05
StickyChipss: posts big blind $0.10
*** HOLE CARDS ***
Dealt to PlayTheBlues4U [As 4s]
SeaofLove: folds
PlayTheBlues4U: raises $0.20 to $0.30
StickyChipss: folds
Uncalled bet ($0.20) returned to PlayTheBlues4U
PlayTheBlues4U collected $0.20 from pot
PlayTheBlues4U: doesn't show hand
*** SUMMARY ***
Total pot $0.20 | Rake $0
Seat 1: SeaofLove (button) folded before Flop (didn't bet)
Seat 2: PlayTheBlues4U (small blind) collected ($0.20)
Seat 3: StickyChipss (big blind) folded before Flop


PokerStars Hand #205379001744:  Hold'em No Limit ($0.05/$0.10 USD) - 2019/11/02 22:30:51 ET
Table 'Hekate' 6-max Seat #3 is the button
Seat 2: mankar.am ($6.84 in chips)
Seat 3: PlayTheBlues4U ($44.56 in chips)
Seat 4: SeaofLove ($10.95 in chips)
Seat 6: Ty1erDurrden ($9.95 in chips)
SeaofLove: posts small blind $0.05
Ty1erDurrden: posts big blind $0.10
*** HOLE CARDS ***
Dealt to PlayTheBlues4U [Qh Jc]
mankar.am: raises $0.10 to $0.20
PlayTheBlues4U: folds
SeaofLove: calls $0.15
Ty1erDurrden: calls $0.10
*** FLOP *** [5h Td 3c]
SeaofLove: bets $0.38
Ty1erDurrden: calls $0.38
mankar.am: raises $0.38 to $0.76
SeaofLove: calls $0.38
Ty1erDurrden: folds
*** TURN *** [5h Td 3c] [3d]
SeaofLove: checks
mankar.am: bets $1.20
SeaofLove: folds
Uncalled bet ($1.20) returned to mankar.am
mankar.am collected $2.38 from pot
mankar.am: doesn't show hand
*** SUMMARY ***
Total pot $2.50 | Rake $0.12
Board [5h Td 3c 3d]
Seat 2: mankar.am collected ($2.38)
Seat 3: PlayTheBlues4U (button) folded before Flop (didn't bet)
Seat 4: SeaofLove (small blind) folded on the Turn
Seat 6: Ty1erDurrden (big blind) folded on the Flop


PokerStars Hand #205379001730:  Hold'em No Limit ($0.05/$0.10 USD) - 2019/11/02 22:30:46 ET
Table 'Antares' 6-max Seat #3 is the button
Seat 1: SeaofLove ($11.90 in chips)
Seat 2: PlayTheBlues4U ($15.10 in chips)
Seat 3: StickyChipss ($11.31 in chips)
SeaofLove: posts small blind $0.05
PlayTheBlues4U: posts big blind $0.10
*** HOLE CARDS ***
Dealt to PlayTheBlues4U [Jc 3s]
StickyChipss: folds
SeaofLove: folds
Uncalled bet ($0.05) returned to PlayTheBlues4U
PlayTheBlues4U collected $0.10 from pot
PlayTheBlues4U: doesn't show hand
*** SUMMARY ***
Total pot $0.10 | Rake $0
Seat 1: SeaofLove (small blind) folded before Flop
Seat 2: PlayTheBlues4U (big blind) collected ($0.10)
Seat 3: StickyChipss (button) folded before Flop (didn't bet)


PokerStars Hand #205379001704:  Hold'em No Limit ($0.05/$0.10 USD) - 2019/11/02 22:30:39 ET
Table 'Hekate' 6-max Seat #2 is the button
Seat 2: mankar.am ($6.69 in chips)
Seat 3: PlayTheBlues4U ($44.61 in chips)
Seat 4: SeaofLove ($11.05 in chips)
Seat 6: Ty1erDurrden ($9.95 in chips)
PlayTheBlues4U: posts small blind $0.05
SeaofLove: posts big blind $0.10
*** HOLE CARDS ***
Dealt to PlayTheBlues4U [Th 7h]
Ty1erDurrden: folds
mankar.am: raises $0.10 to $0.20
linghuchong2 leaves the table
PlayTheBlues4U: folds
SeaofLove: folds
Uncalled bet ($0.10) returned to mankar.am
mankar.am collected $0.25 from pot
*** SUMMARY ***
Total pot $0.25 | Rake $0
Seat 2: mankar.am (button) collected ($0.25)
Seat 3: PlayTheBlues4U (small blind) folded before Flop
Seat 4: SeaofLove (big blind) folded before Flop
Seat 6: Ty1erDurrden folded before Flop (didn't bet)


PokerStars Hand #205379001662:  Hold'em No Limit ($0.05/$0.10 USD) - 2019/11/02 22:30:28 ET
Table 'Antares' 6-max Seat #2 is the button
Seat 1: SeaofLove ($12 in chips)
Seat 2: PlayTheBlues4U ($15.10 in chips)
Seat 3: StickyChipss ($11.21 in chips)
StickyChipss: posts small blind $0.05
SeaofLove: posts big blind $0.10
*** HOLE CARDS ***
Dealt to PlayTheBlues4U [Th 2c]
PlayTheBlues4U: folds
StickyChipss: raises $0.90 to $1
SeaofLove: folds
Uncalled bet ($0.90) returned to StickyChipss
StickyChipss collected $0.20 from pot
*** SUMMARY ***
Total pot $0.20 | Rake $0
Seat 1: SeaofLove (big blind) folded before Flop
Seat 2: PlayTheBlues4U (button) folded before Flop (didn't bet)
Seat 3: StickyChipss (small blind) collected ($0.20)


PokerStars Hand #205379001625:  Hold'em No Limit ($0.05/$0.10 USD) - 2019/11/02 22:30:19 ET
Table 'Antares' 6-max Seat #1 is the button
Seat 1: SeaofLove ($12 in chips)
Seat 2: PlayTheBlues4U ($15.15 in chips)
Seat 3: StickyChipss ($11.16 in chips)
PlayTheBlues4U: posts small blind $0.05
StickyChipss: posts big blind $0.10
*** HOLE CARDS ***
Dealt to PlayTheBlues4U [7d 2c]
SeaofLove: folds
PlayTheBlues4U: folds
Uncalled bet ($0.05) returned to StickyChipss
StickyChipss collected $0.10 from pot
*** SUMMARY ***
Total pot $0.10 | Rake $0
Seat 1: SeaofLove (button) folded before Flop (didn't bet)
Seat 2: PlayTheBlues4U (small blind) folded before Flop
Seat 3: StickyChipss (big blind) collected ($0.10)


PokerStars Hand #205379001594:  Hold'em No Limit ($0.05/$0.10 USD) - 2019/11/02 22:30:12 ET
Table 'Hekate' 6-max Seat #6 is the button
Seat 1: linghuchong2 ($0.44 in chips)
Seat 2: mankar.am ($6.29 in chips)
Seat 3: PlayTheBlues4U ($44.61 in chips)
Seat 4: SeaofLove ($11.05 in chips)
Seat 6: Ty1erDurrden ($9.95 in chips)
linghuchong2: posts small blind $0.05
mankar.am: posts big blind $0.10
*** HOLE CARDS ***
Dealt to PlayTheBlues4U [Js Tc]
PlayTheBlues4U: folds
SeaofLove: folds
Ty1erDurrden: folds
linghuchong2: raises $0.34 to $0.44 and is all-in
mankar.am: calls $0.34
*** FLOP *** [5h 9d 7d]
*** TURN *** [5h 9d 7d] [4c]
*** RIVER *** [5h 9d 7d 4c] [3s]
*** SHOW DOWN ***
linghuchong2: shows [Ad 3c] (a pair of Threes)
mankar.am: shows [4h Qd] (a pair of Fours)
mankar.am collected $0.84 from pot
*** SUMMARY ***
Total pot $0.88 | Rake $0.04
Board [5h 9d 7d 4c 3s]
Seat 1: linghuchong2 (small blind) showed [Ad 3c] and lost with a pair of Threes
Seat 2: mankar.am (big blind) showed [4h Qd] and won ($0.84) with a pair of Fours
Seat 3: PlayTheBlues4U folded before Flop (didn't bet)
Seat 4: SeaofLove folded before Flop (didn't bet)
Seat 6: Ty1erDurrden (button) folded before Flop (didn't bet)


PokerStars Hand #205379001556:  Hold'em No Limit ($0.05/$0.10 USD) - 2019/11/02 22:30:00 ET
Table 'Antares' 6-max Seat #5 is the button
Seat 1: SeaofLove ($12.05 in chips)
Seat 2: PlayTheBlues4U ($15.10 in chips)
Seat 3: StickyChipss ($11.16 in chips)
Seat 5: colinsdad16 ($6.85 in chips)
SeaofLove: posts small blind $0.05
PlayTheBlues4U: posts big blind $0.10
*** HOLE CARDS ***
Dealt to PlayTheBlues4U [Ts 9h]
StickyChipss: folds
boxerpupp727 is disconnected
colinsdad16: folds
SeaofLove: folds
Uncalled bet ($0.05) returned to PlayTheBlues4U
PlayTheBlues4U collected $0.10 from pot
colinsdad16 leaves the table
PlayTheBlues4U: doesn't show hand
*** SUMMARY ***
Total pot $0.10 | Rake $0
Seat 1: SeaofLove (small blind) folded before Flop
Seat 2: PlayTheBlues4U (big blind) collected ($0.10)
Seat 3: StickyChipss folded before Flop (didn't bet)
Seat 5: colinsdad16 (button) folded before Flop (didn't bet)


PokerStars Hand #205379001481:  Hold'em No Limit ($0.05/$0.10 USD) - 2019/11/02 22:29:38 ET
Table 'Hekate' 6-max Seat #4 is the button
Seat 1: linghuchong2 ($2.24 in chips)
Seat 2: mankar.am ($4.62 in chips)
Seat 3: PlayTheBlues4U ($44.61 in chips)
Seat 4: SeaofLove ($11.05 in chips)
Seat 6: Ty1erDurrden ($10 in chips)
Ty1erDurrden: posts small blind $0.05
linghuchong2: posts big blind $0.10
*** HOLE CARDS ***
Dealt to PlayTheBlues4U [5d 9s]
mankar.am: raises $0.10 to $0.20
PlayTheBlues4U: folds
SeaofLove: folds
Ty1erDurrden: folds
linghuchong2: calls $0.10
*** FLOP *** [4s Ac 3c]
linghuchong2: bets $0.40
mankar.am: calls $0.40
*** TURN *** [4s Ac 3c] [Ks]
linghuchong2: checks
mankar.am: checks
*** RIVER *** [4s Ac 3c Ks] [7d]
linghuchong2: checks
mankar.am: bets $1.20
linghuchong2: calls $1.20
*** SHOW DOWN ***
mankar.am: shows [5c 6c] (a straight, Three to Seven)
linghuchong2: mucks hand
mankar.am collected $3.47 from pot
*** SUMMARY ***
Total pot $3.65 | Rake $0.18
Board [4s Ac 3c Ks 7d]
Seat 1: linghuchong2 (big blind) mucked [Jc Ah]
Seat 2: mankar.am showed [5c 6c] and won ($3.47) with a straight, Three to Seven
Seat 3: PlayTheBlues4U folded before Flop (didn't bet)
Seat 4: SeaofLove (button) folded before Flop (didn't bet)
Seat 6: Ty1erDurrden (small blind) folded before Flop


PokerStars Hand #205379001346:  Hold'em No Limit ($0.05/$0.10 USD) - 2019/11/02 22:29:02 ET
Table 'Antares' 6-max Seat #3 is the button
Seat 1: SeaofLove ($12.30 in chips)
Seat 2: PlayTheBlues4U ($12.06 in chips)
Seat 3: StickyChipss ($11.16 in chips)
Seat 5: colinsdad16 ($9.70 in chips)
Seat 6: boxerpupp727 ($12.24 in chips)
colinsdad16: posts small blind $0.05
boxerpupp727: posts big blind $0.10
*** HOLE CARDS ***
Dealt to PlayTheBlues4U [5d 5h]
SeaofLove: raises $0.15 to $0.25
boxerpupp727 said, "75 other day. now 30s"
PlayTheBlues4U: calls $0.25
StickyChipss: folds
colinsdad16: calls $0.20
boxerpupp727: calls $0.15
*** FLOP *** [2h 5s 6s]
colinsdad16: checks
boxerpupp727: checks
SeaofLove: checks
PlayTheBlues4U: bets $0.70
colinsdad16: calls $0.70
boxerpupp727: folds
SeaofLove: folds
*** TURN *** [2h 5s 6s] [2c]
colinsdad16: checks
PlayTheBlues4U: bets $1.90
colinsdad16: calls $1.90
*** RIVER *** [2h 5s 6s 2c] [Kh]
colinsdad16: checks
PlayTheBlues4U: bets $4.80
colinsdad16: folds
Uncalled bet ($4.80) returned to PlayTheBlues4U
PlayTheBlues4U collected $5.89 from pot
PlayTheBlues4U: doesn't show hand
*** SUMMARY ***
Total pot $6.20 | Rake $0.31
Board [2h 5s 6s 2c Kh]
Seat 1: SeaofLove folded on the Flop
Seat 2: PlayTheBlues4U collected ($5.89)
Seat 3: StickyChipss (button) folded before Flop (didn't bet)
Seat 5: colinsdad16 (small blind) folded on the River
Seat 6: boxerpupp727 (big blind) folded on the Flop


PokerStars Hand #205379001252:  Hold'em No Limit ($0.05/$0.10 USD) - 2019/11/02 22:28:36 ET
Table 'Antares' 6-max Seat #2 is the button
Seat 1: SeaofLove ($12.15 in chips)
Seat 2: PlayTheBlues4U ($12.06 in chips)
Seat 3: StickyChipss ($11.21 in chips)
Seat 5: colinsdad16 ($9.80 in chips)
Seat 6: boxerpupp727 ($12.24 in chips)
StickyChipss: posts small blind $0.05
colinsdad16: posts big blind $0.10
*** HOLE CARDS ***
Dealt to PlayTheBlues4U [5d Kc]
boxerpupp727: folds
SeaofLove: raises $0.15 to $0.25
boxerpupp727 said, "damn. winter is here"
PlayTheBlues4U: folds
StickyChipss: folds
colinsdad16: folds
Uncalled bet ($0.15) returned to SeaofLove
SeaofLove collected $0.25 from pot
SeaofLove: doesn't show hand
*** SUMMARY ***
Total pot $0.25 | Rake $0
Seat 1: SeaofLove collected ($0.25)
Seat 2: PlayTheBlues4U (button) folded before Flop (didn't bet)
Seat 3: StickyChipss (small blind) folded before Flop
Seat 5: colinsdad16 (big blind) folded before Flop
Seat 6: boxerpupp727 folded before Flop (didn't bet)


PokerStars Hand #205379001237:  Hold'em No Limit ($0.05/$0.10 USD) - 2019/11/02 22:28:32 ET
Table 'Hekate' 6-max Seat #3 is the button
Seat 1: linghuchong2 ($2.24 in chips)
Seat 2: mankar.am ($5.42 in chips)
Seat 3: PlayTheBlues4U ($42.99 in chips)
Seat 4: SeaofLove ($11.10 in chips)
Seat 5: papabear127 ($15.91 in chips)
Seat 6: Ty1erDurrden ($10 in chips)
SeaofLove: posts small blind $0.05
papabear127: posts big blind $0.10
*** HOLE CARDS ***
Dealt to PlayTheBlues4U [As 2s]
Ty1erDurrden: raises $0.15 to $0.25
linghuchong2: folds
mankar.am: calls $0.25
PlayTheBlues4U: raises $0.55 to $0.80
SeaofLove: folds
papabear127: folds
Ty1erDurrden: calls $0.55
mankar.am: calls $0.55
*** FLOP *** [9d Kc 3d]
Ty1erDurrden: checks
mankar.am: checks
PlayTheBlues4U: bets $1.70
Ty1erDurrden: folds
papabear127 leaves the table
mankar.am: folds
Uncalled bet ($1.70) returned to PlayTheBlues4U
PlayTheBlues4U collected $2.42 from pot
*** SUMMARY ***
Total pot $2.55 | Rake $0.13
Board [9d Kc 3d]
Seat 1: linghuchong2 folded before Flop (didn't bet)
Seat 2: mankar.am folded on the Flop
Seat 3: PlayTheBlues4U (button) collected ($2.42)
Seat 4: SeaofLove (small blind) folded before Flop
Seat 5: papabear127 (big blind) folded before Flop
Seat 6: Ty1erDurrden folded on the Flop


PokerStars Hand #205379001224:  Hold'em No Limit ($0.05/$0.10 USD) - 2019/11/02 22:28:29 ET
Table 'Antares' 6-max Seat #1 is the button
Seat 1: SeaofLove ($12.15 in chips)
Seat 2: PlayTheBlues4U ($12.11 in chips)
Seat 3: StickyChipss ($11.16 in chips)
Seat 5: colinsdad16 ($9.80 in chips)
Seat 6: boxerpupp727 ($12.24 in chips)
PlayTheBlues4U: posts small blind $0.05
StickyChipss: posts big blind $0.10
*** HOLE CARDS ***
Dealt to PlayTheBlues4U [7c Tc]
colinsdad16: folds
boxerpupp727: folds
SeaofLove: folds
PlayTheBlues4U: folds
Uncalled bet ($0.05) returned to StickyChipss
StickyChipss collected $0.10 from pot
*** SUMMARY ***
Total pot $0.10 | Rake $0
Seat 1: SeaofLove (button) folded before Flop (didn't bet)
Seat 2: PlayTheBlues4U (small blind) folded before Flop
Seat 3: StickyChipss (big blind) collected ($0.10)
Seat 5: colinsdad16 folded before Flop (didn't bet)
Seat 6: boxerpupp727 folded before Flop (didn't bet)


PokerStars Hand #205379001177:  Hold'em No Limit ($0.05/$0.10 USD) - 2019/11/02 22:28:15 ET
Table 'Antares' 6-max Seat #6 is the button
Seat 1: SeaofLove ($12.20 in chips)
Seat 2: PlayTheBlues4U ($12.06 in chips)
Seat 3: StickyChipss ($11.16 in chips)
Seat 5: colinsdad16 ($9.80 in chips)
Seat 6: boxerpupp727 ($12.24 in chips)
SeaofLove: posts small blind $0.05
PlayTheBlues4U: posts big blind $0.10
*** HOLE CARDS ***
Dealt to PlayTheBlues4U [5h Kh]
StickyChipss: folds
colinsdad16: folds
boxerpupp727: folds
SeaofLove: folds
Uncalled bet ($0.05) returned to PlayTheBlues4U
PlayTheBlues4U collected $0.10 from pot
PlayTheBlues4U: doesn't show hand
*** SUMMARY ***
Total pot $0.10 | Rake $0
Seat 1: SeaofLove (small blind) folded before Flop
Seat 2: PlayTheBlues4U (big blind) collected ($0.10)
Seat 3: StickyChipss folded before Flop (didn't bet)
Seat 5: colinsdad16 folded before Flop (didn't bet)
Seat 6: boxerpupp727 (button) folded before Flop (didn't bet)


PokerStars Hand #205379001147:  Hold'em No Limit ($0.05/$0.10 USD) - 2019/11/02 22:28:07 ET
Table 'Antares' 6-max Seat #5 is the button
Seat 1: SeaofLove ($12.15 in chips)
Seat 2: PlayTheBlues4U ($12.06 in chips)
Seat 3: StickyChipss ($11.16 in chips)
Seat 5: colinsdad16 ($9.80 in chips)
Seat 6: boxerpupp727 ($12.29 in chips)
boxerpupp727: posts small blind $0.05
SeaofLove: posts big blind $0.10
*** HOLE CARDS ***
Dealt to PlayTheBlues4U [Qd 4d]
PlayTheBlues4U: folds
StickyChipss: folds
colinsdad16: folds
boxerpupp727: folds
Uncalled bet ($0.05) returned to SeaofLove
SeaofLove collected $0.10 from pot
SeaofLove: doesn't show hand
*** SUMMARY ***
Total pot $0.10 | Rake $0
Seat 1: SeaofLove (big blind) collected ($0.10)
Seat 2: PlayTheBlues4U folded before Flop (didn't bet)
Seat 3: StickyChipss folded before Flop (didn't bet)
Seat 5: colinsdad16 (button) folded before Flop (didn't bet)
Seat 6: boxerpupp727 (small blind) folded before Flop


PokerStars Hand #205379001026:  Hold'em No Limit ($0.05/$0.10 USD) - 2019/11/02 22:27:34 ET
Table 'Antares' 6-max Seat #3 is the button
Seat 1: SeaofLove ($12.90 in chips)
Seat 2: PlayTheBlues4U ($12.06 in chips)
Seat 3: StickyChipss ($11.16 in chips)
Seat 5: colinsdad16 ($10.05 in chips)
Seat 6: boxerpupp727 ($11.38 in chips)
colinsdad16: posts small blind $0.05
boxerpupp727: posts big blind $0.10
*** HOLE CARDS ***
Dealt to PlayTheBlues4U [4c 5h]
SeaofLove: raises $0.15 to $0.25
PlayTheBlues4U: folds
StickyChipss: folds
colinsdad16: calls $0.20
boxerpupp727: calls $0.15
*** FLOP *** [7h 6h 9s]
colinsdad16: checks
boxerpupp727: checks
SeaofLove: checks
*** TURN *** [7h 6h 9s] [3c]
colinsdad16: checks
boxerpupp727: bets $0.50
SeaofLove: calls $0.50
colinsdad16: folds
*** RIVER *** [7h 6h 9s 3c] [4s]
boxerpupp727: checks
SeaofLove: checks
*** SHOW DOWN ***
boxerpupp727: shows [Qs Qc] (a pair of Queens)
SeaofLove: mucks hand
boxerpupp727 collected $1.66 from pot
*** SUMMARY ***
Total pot $1.75 | Rake $0.09
Board [7h 6h 9s 3c 4s]
Seat 1: SeaofLove mucked [Qd 9d]
Seat 2: PlayTheBlues4U folded before Flop (didn't bet)
Seat 3: StickyChipss (button) folded before Flop (didn't bet)
Seat 5: colinsdad16 (small blind) folded on the Turn
Seat 6: boxerpupp727 (big blind) showed [Qs Qc] and won ($1.66) with a pair of Queens


PokerStars Hand #205379001002:  Hold'em No Limit ($0.05/$0.10 USD) - 2019/11/02 22:27:28 ET
Table 'Hekate' 6-max Seat #2 is the button
Seat 1: linghuchong2 ($2.24 in chips)
Seat 2: mankar.am ($6.22 in chips)
Seat 3: PlayTheBlues4U ($43.04 in chips)
Seat 4: SeaofLove ($11.20 in chips)
Seat 5: papabear127 ($7.90 in chips)
Seat 6: Ty1erDurrden ($10 in chips)
PlayTheBlues4U: posts small blind $0.05
SeaofLove: posts big blind $0.10
*** HOLE CARDS ***
Dealt to PlayTheBlues4U [4h 4s]
papabear127: calls $0.10
Ty1erDurrden: raises $0.35 to $0.45
linghuchong2: folds
mankar.am: raises $0.35 to $0.80
PlayTheBlues4U: folds
SeaofLove: folds
papabear127: calls $0.70
Ty1erDurrden: calls $0.35
*** FLOP *** [Jc 5d 9h]
papabear127: bets $1.21
Ty1erDurrden: raises $1.45 to $2.66
mankar.am: folds
papabear127: calls $1.45
*** TURN *** [Jc 5d 9h] [Qc]
papabear127: checks
Ty1erDurrden: bets $6.54 and is all-in
papabear127: calls $4.44 and is all-in
Uncalled bet ($2.10) returned to Ty1erDurrden
*** RIVER *** [Jc 5d 9h Qc] [Ks]
*** SHOW DOWN ***
papabear127: shows [Jh Qd] (two pair, Queens and Jacks)
Ty1erDurrden: shows [9s Js] (two pair, Jacks and Nines)
papabear127 collected $15.91 from pot
*** SUMMARY ***
Total pot $16.75 | Rake $0.84
Board [Jc 5d 9h Qc Ks]
Seat 1: linghuchong2 folded before Flop (didn't bet)
Seat 2: mankar.am (button) folded on the Flop
Seat 3: PlayTheBlues4U (small blind) folded before Flop
Seat 4: SeaofLove (big blind) folded before Flop
Seat 5: papabear127 showed [Jh Qd] and won ($15.91) with two pair, Queens and Jacks
Seat 6: Ty1erDurrden showed [9s Js] and lost with two pair, Jacks and Nines


PokerStars Hand #205379000996:  Hold'em No Limit ($0.05/$0.10 USD) - 2019/11/02 22:27:26 ET
Table 'Antares' 6-max Seat #2 is the button
Seat 1: SeaofLove ($12.90 in chips)
Seat 2: PlayTheBlues4U ($12.06 in chips)
Seat 3: StickyChipss ($11.21 in chips)
Seat 5: colinsdad16 ($10 in chips)
Seat 6: boxerpupp727 ($11.38 in chips)
StickyChipss: posts small blind $0.05
colinsdad16: posts big blind $0.10
*** HOLE CARDS ***
Dealt to PlayTheBlues4U [4c Tc]
boxerpupp727: folds
SeaofLove: folds
PlayTheBlues4U: folds
StickyChipss: folds
Uncalled bet ($0.05) returned to colinsdad16
colinsdad16 collected $0.10 from pot
colinsdad16: doesn't show hand
*** SUMMARY ***
Total pot $0.10 | Rake $0
Seat 1: SeaofLove folded before Flop (didn't bet)
Seat 2: PlayTheBlues4U (button) folded before Flop (didn't bet)
Seat 3: StickyChipss (small blind) folded before Flop
Seat 5: colinsdad16 (big blind) collected ($0.10)
Seat 6: boxerpupp727 folded before Flop (didn't bet)


PokerStars Hand #205379000872:  Hold'em No Limit ($0.05/$0.10 USD) - 2019/11/02 22:26:55 ET
Table 'Hekate' 6-max Seat #1 is the button
Seat 1: linghuchong2 ($2.24 in chips)
Seat 2: mankar.am ($5.17 in chips)
Seat 3: PlayTheBlues4U ($43.14 in chips)
Seat 4: SeaofLove ($11.20 in chips)
Seat 5: papabear127 ($8 in chips)
Seat 6: Ty1erDurrden ($10.25 in chips)
mankar.am: posts small blind $0.05
PlayTheBlues4U: posts big blind $0.10
papabear127: posts big blind $0.10
*** HOLE CARDS ***
Dealt to PlayTheBlues4U [Qs 3d]
SeaofLove: folds
papabear127: checks
Ty1erDurrden: raises $0.35 to $0.45
linghuchong2: folds
mankar.am: calls $0.40
PlayTheBlues4U: folds
papabear127: folds
*** FLOP *** [Qh 9c Th]
mankar.am: bets $0.50
Ty1erDurrden: calls $0.50
*** TURN *** [Qh 9c Th] [8h]
mankar.am: bets $1
Ty1erDurrden: folds
Uncalled bet ($1) returned to mankar.am
mankar.am collected $2 from pot
*** SUMMARY ***
Total pot $2.10 | Rake $0.10
Board [Qh 9c Th 8h]
Seat 1: linghuchong2 (button) folded before Flop (didn't bet)
Seat 2: mankar.am (small blind) collected ($2)
Seat 3: PlayTheBlues4U (big blind) folded before Flop
Seat 4: SeaofLove folded before Flop (didn't bet)
Seat 5: papabear127 folded before Flop (didn't bet)
Seat 6: Ty1erDurrden folded on the Turn


PokerStars Hand #205379000853:  Hold'em No Limit ($0.05/$0.10 USD) - 2019/11/02 22:26:51 ET
Table 'Antares' 6-max Seat #1 is the button
Seat 1: SeaofLove ($13.25 in chips)
Seat 2: PlayTheBlues4U ($13.01 in chips)
Seat 3: StickyChipss ($11.31 in chips)
Seat 6: boxerpupp727 ($10.10 in chips)
PlayTheBlues4U: posts small blind $0.05
StickyChipss: posts big blind $0.10
*** HOLE CARDS ***
Dealt to PlayTheBlues4U [Qc Kc]
boxerpupp727: raises $0.25 to $0.35
SeaofLove: calls $0.35
PlayTheBlues4U: calls $0.30
StickyChipss: folds
*** FLOP *** [Ah 7c Ts]
PlayTheBlues4U: checks
boxerpupp727: checks
SeaofLove: checks
*** TURN *** [Ah 7c Ts] [4c]
PlayTheBlues4U: bets $0.60
boxerpupp727: calls $0.60
SeaofLove: folds
*** RIVER *** [Ah 7c Ts 4c] [8d]
PlayTheBlues4U: checks
colinsdad16 joins the table at seat #5
boxerpupp727: checks
*** SHOW DOWN ***
PlayTheBlues4U: shows [Qc Kc] (high card Ace)
boxerpupp727: shows [7d Jd] (a pair of Sevens)
boxerpupp727 collected $2.23 from pot
*** SUMMARY ***
Total pot $2.35 | Rake $0.12
Board [Ah 7c Ts 4c 8d]
Seat 1: SeaofLove (button) folded on the Turn
Seat 2: PlayTheBlues4U (small blind) showed [Qc Kc] and lost with high card Ace
Seat 3: StickyChipss (big blind) folded before Flop
Seat 6: boxerpupp727 showed [7d Jd] and won ($2.23) with a pair of Sevens


PokerStars Hand #205379000813:  Hold'em No Limit ($0.05/$0.10 USD) - 2019/11/02 22:26:39 ET
Table 'Antares' 6-max Seat #6 is the button
Seat 1: SeaofLove ($13.30 in chips)
Seat 2: PlayTheBlues4U ($13.11 in chips)
Seat 3: StickyChipss ($11.31 in chips)
Seat 6: boxerpupp727 ($9.95 in chips)
SeaofLove: posts small blind $0.05
PlayTheBlues4U: posts big blind $0.10
*** HOLE CARDS ***
Dealt to PlayTheBlues4U [2d 6h]
StickyChipss: folds
boxerpupp727: raises $0.25 to $0.35
SeaofLove: folds
PlayTheBlues4U: folds
Uncalled bet ($0.25) returned to boxerpupp727
boxerpupp727 collected $0.25 from pot
*** SUMMARY ***
Total pot $0.25 | Rake $0
Seat 1: SeaofLove (small blind) folded before Flop
Seat 2: PlayTheBlues4U (big blind) folded before Flop
Seat 3: StickyChipss folded before Flop (didn't bet)
Seat 6: boxerpupp727 (button) collected ($0.25)


PokerStars Hand #205379000773:  Hold'em No Limit ($0.05/$0.10 USD) - 2019/11/02 22:26:29 ET
Table 'Antares' 6-max Seat #3 is the button
Seat 1: SeaofLove ($13.25 in chips)
Seat 2: PlayTheBlues4U ($13.11 in chips)
Seat 3: StickyChipss ($11.31 in chips)
Seat 6: boxerpupp727 ($10 in chips)
boxerpupp727: posts small blind $0.05
SeaofLove: posts big blind $0.10
*** HOLE CARDS ***
Dealt to PlayTheBlues4U [2d Ah]
PlayTheBlues4U: folds
StickyChipss: folds
boxerpupp727: folds
Uncalled bet ($0.05) returned to SeaofLove
SeaofLove collected $0.10 from pot
SeaofLove: doesn't show hand
*** SUMMARY ***
Total pot $0.10 | Rake $0
Seat 1: SeaofLove (big blind) collected ($0.10)
Seat 2: PlayTheBlues4U folded before Flop (didn't bet)
Seat 3: StickyChipss (button) folded before Flop (didn't bet)
Seat 6: boxerpupp727 (small blind) folded before Flop


PokerStars Hand #205379000719:  Hold'em No Limit ($0.05/$0.10 USD) - 2019/11/02 22:26:16 ET
Table 'Hekate' 6-max Seat #6 is the button
Seat 1: linghuchong2 ($2.29 in chips)
Seat 2: mankar.am ($4.86 in chips)
Seat 3: PlayTheBlues4U ($44.24 in chips)
Seat 4: SeaofLove ($11.20 in chips)
Seat 6: Ty1erDurrden ($9.95 in chips)
linghuchong2: posts small blind $0.05
mankar.am: posts big blind $0.10
*** HOLE CARDS ***
Dealt to PlayTheBlues4U [Jc Jd]
PlayTheBlues4U: raises $0.20 to $0.30
SeaofLove: folds
Ty1erDurrden: raises $0.80 to $1.10
linghuchong2: folds
mankar.am: calls $1
PlayTheBlues4U: calls $0.80
*** FLOP *** [7d Ad 3h]
mankar.am: bets $3.76 and is all-in
papabear127 joins the table at seat #5
PlayTheBlues4U: folds
Ty1erDurrden: calls $3.76
*** TURN *** [7d Ad 3h] [7c]
*** RIVER *** [7d Ad 3h 7c] [7s]
*** SHOW DOWN ***
mankar.am: shows [9s As] (a full house, Sevens full of Aces)
Ty1erDurrden: shows [Ac Qc] (a full house, Sevens full of Aces)
mankar.am collected $5.17 from pot
Ty1erDurrden collected $5.16 from pot
*** SUMMARY ***
Total pot $10.87 | Rake $0.54
Board [7d Ad 3h 7c 7s]
Seat 1: linghuchong2 (small blind) folded before Flop
Seat 2: mankar.am (big blind) showed [9s As] and won ($5.17) with a full house, Sevens full of Aces
Seat 3: PlayTheBlues4U folded on the Flop
Seat 4: SeaofLove folded before Flop (didn't bet)
Seat 6: Ty1erDurrden (button) showed [Ac Qc] and won ($5.16) with a full house, Sevens full of Aces


PokerStars Hand #205379000714:  Hold'em No Limit ($0.05/$0.10 USD) - 2019/11/02 22:26:15 ET
Table 'Antares' 6-max Seat #2 is the button
Seat 1: SeaofLove ($13.25 in chips)
Seat 2: PlayTheBlues4U ($12.96 in chips)
Seat 3: StickyChipss ($11.36 in chips)
Seat 6: boxerpupp727 ($10.10 in chips)
StickyChipss: posts small blind $0.05
boxerpupp727: posts big blind $0.10
*** HOLE CARDS ***
Dealt to PlayTheBlues4U [9d Th]
SeaofLove: folds
PlayTheBlues4U: raises $0.20 to $0.30
StickyChipss: folds
boxerpupp727: folds
Uncalled bet ($0.20) returned to PlayTheBlues4U
PlayTheBlues4U collected $0.25 from pot
PlayTheBlues4U: doesn't show hand
*** SUMMARY ***
Total pot $0.25 | Rake $0
Seat 1: SeaofLove folded before Flop (didn't bet)
Seat 2: PlayTheBlues4U (button) collected ($0.25)
Seat 3: StickyChipss (small blind) folded before Flop
Seat 6: boxerpupp727 (big blind) folded before Flop


PokerStars Hand #205379000682:  Hold'em No Limit ($0.05/$0.10 USD) - 2019/11/02 22:26:04 ET
Table 'Hekate' 6-max Seat #4 is the button
Seat 1: linghuchong2 ($2.39 in chips)
Seat 2: mankar.am ($4.71 in chips)
Seat 3: PlayTheBlues4U ($44.24 in chips)
Seat 4: SeaofLove ($11.20 in chips)
Seat 6: Ty1erDurrden ($10 in chips)
Ty1erDurrden: posts small blind $0.05
linghuchong2: posts big blind $0.10
*** HOLE CARDS ***
Dealt to PlayTheBlues4U [9s 7d]
mankar.am: raises $0.10 to $0.20
PlayTheBlues4U: folds
SeaofLove: folds
Ty1erDurrden: folds
linghuchong2: folds
Uncalled bet ($0.10) returned to mankar.am
mankar.am collected $0.25 from pot
mankar.am: doesn't show hand
*** SUMMARY ***
Total pot $0.25 | Rake $0
Seat 1: linghuchong2 (big blind) folded before Flop
Seat 2: mankar.am collected ($0.25)
Seat 3: PlayTheBlues4U folded before Flop (didn't bet)
Seat 4: SeaofLove (button) folded before Flop (didn't bet)
Seat 6: Ty1erDurrden (small blind) folded before Flop


PokerStars Hand #205379000650:  Hold'em No Limit ($0.05/$0.10 USD) - 2019/11/02 22:25:56 ET
Table 'Antares' 6-max Seat #1 is the button
Seat 1: SeaofLove ($13.25 in chips)
Seat 2: PlayTheBlues4U ($13.01 in chips)
Seat 3: StickyChipss ($11.46 in chips)
Seat 6: boxerpupp727 ($9.95 in chips)
PlayTheBlues4U: posts small blind $0.05
StickyChipss: posts big blind $0.10
*** HOLE CARDS ***
Dealt to PlayTheBlues4U [7s 4s]
boxerpupp727: raises $0.25 to $0.35
SeaofLove: folds
PlayTheBlues4U: folds
StickyChipss: folds
Uncalled bet ($0.25) returned to boxerpupp727
boxerpupp727 collected $0.25 from pot
boxerpupp727: doesn't show hand
*** SUMMARY ***
Total pot $0.25 | Rake $0
Seat 1: SeaofLove (button) folded before Flop (didn't bet)
Seat 2: PlayTheBlues4U (small blind) folded before Flop
Seat 3: StickyChipss (big blind) folded before Flop
Seat 6: boxerpupp727 collected ($0.25)


PokerStars Hand #205379000619:  Hold'em No Limit ($0.05/$0.10 USD) - 2019/11/02 22:25:46 ET
Table 'Antares' 6-max Seat #6 is the button
Seat 1: SeaofLove ($13.30 in chips)
Seat 2: PlayTheBlues4U ($13.11 in chips)
Seat 3: StickyChipss ($11.46 in chips)
Seat 6: boxerpupp727 ($9.80 in chips)
SeaofLove: posts small blind $0.05
PlayTheBlues4U: posts big blind $0.10
*** HOLE CARDS ***
Dealt to PlayTheBlues4U [3h 4c]
StickyChipss: folds
boxerpupp727: raises $0.25 to $0.35
SeaofLove: folds
PlayTheBlues4U: folds
Uncalled bet ($0.25) returned to boxerpupp727
boxerpupp727 collected $0.25 from pot
boxerpupp727: doesn't show hand
*** SUMMARY ***
Total pot $0.25 | Rake $0
Seat 1: SeaofLove (small blind) folded before Flop
Seat 2: PlayTheBlues4U (big blind) folded before Flop
Seat 3: StickyChipss folded before Flop (didn't bet)
Seat 6: boxerpupp727 (button) collected ($0.25)


PokerStars Hand #205379000557:  Hold'em No Limit ($0.05/$0.10 USD) - 2019/11/02 22:25:31 ET
Table 'Hekate' 6-max Seat #3 is the button
Seat 1: linghuchong2 ($2.07 in chips)
Seat 2: mankar.am ($4.71 in chips)
Seat 3: PlayTheBlues4U ($44.24 in chips)
Seat 4: SeaofLove ($11.25 in chips)
Seat 6: Ty1erDurrden ($10 in chips)
SeaofLove: posts small blind $0.05
Ty1erDurrden: posts big blind $0.10
*** HOLE CARDS ***
Dealt to PlayTheBlues4U [Qs 5d]
linghuchong2: calls $0.10
mankar.am: folds
PlayTheBlues4U: folds
SeaofLove: folds
Ty1erDurrden: checks
*** FLOP *** [8h Kh Jd]
Ty1erDurrden: checks
linghuchong2: checks
*** TURN *** [8h Kh Jd] [Js]
Ty1erDurrden: checks
linghuchong2: bets $0.20
Ty1erDurrden: calls $0.20
*** RIVER *** [8h Kh Jd Js] [8c]
Ty1erDurrden: checks
linghuchong2: bets $0.60
Ty1erDurrden: folds
Uncalled bet ($0.60) returned to linghuchong2
linghuchong2 collected $0.62 from pot
linghuchong2: doesn't show hand
*** SUMMARY ***
Total pot $0.65 | Rake $0.03
Board [8h Kh Jd Js 8c]
Seat 1: linghuchong2 collected ($0.62)
Seat 2: mankar.am folded before Flop (didn't bet)
Seat 3: PlayTheBlues4U (button) folded before Flop (didn't bet)
Seat 4: SeaofLove (small blind) folded before Flop
Seat 6: Ty1erDurrden (big blind) folded on the River


PokerStars Hand #205379000508:  Hold'em No Limit ($0.05/$0.10 USD) - 2019/11/02 22:25:16 ET
Table 'Antares' 6-max Seat #3 is the button
Seat 1: SeaofLove ($13.40 in chips)
Seat 2: PlayTheBlues4U ($12.96 in chips)
Seat 3: StickyChipss ($11.46 in chips)
Seat 6: boxerpupp727 ($9.85 in chips)
boxerpupp727: posts small blind $0.05
SeaofLove: posts big blind $0.10
*** HOLE CARDS ***
Dealt to PlayTheBlues4U [Jc 9c]
PlayTheBlues4U: raises $0.20 to $0.30
boxerpupp727 said, "sorry"
boxerpupp727 said, " busy"
StickyChipss: folds
boxerpupp727: folds
SeaofLove: folds
Uncalled bet ($0.20) returned to PlayTheBlues4U
PlayTheBlues4U collected $0.25 from pot
PlayTheBlues4U: doesn't show hand
*** SUMMARY ***
Total pot $0.25 | Rake $0
Seat 1: SeaofLove (big blind) folded before Flop
Seat 2: PlayTheBlues4U collected ($0.25)
Seat 3: StickyChipss (button) folded before Flop (didn't bet)
Seat 6: boxerpupp727 (small blind) folded before Flop


PokerStars Hand #205379000466:  Hold'em No Limit ($0.05/$0.10 USD) - 2019/11/02 22:25:07 ET
Table 'Hekate' 6-max Seat #2 is the button
Seat 1: linghuchong2 ($1.66 in chips)
Seat 2: mankar.am ($5.01 in chips)
Seat 3: PlayTheBlues4U ($44.29 in chips)
Seat 4: SeaofLove ($11.35 in chips)
Seat 6: Ty1erDurrden ($10 in chips)
PlayTheBlues4U: posts small blind $0.05
SeaofLove: posts big blind $0.10
*** HOLE CARDS ***
Dealt to PlayTheBlues4U [4h 9d]
Ty1erDurrden: folds
linghuchong2: raises $0.20 to $0.30
mankar.am: calls $0.30
PlayTheBlues4U: folds
SeaofLove: folds
*** FLOP *** [Kd 5d Tc]
linghuchong2: bets $0.70
mankar.am: folds
Uncalled bet ($0.70) returned to linghuchong2
linghuchong2 collected $0.71 from pot
linghuchong2: doesn't show hand
*** SUMMARY ***
Total pot $0.75 | Rake $0.04
Board [Kd 5d Tc]
Seat 1: linghuchong2 collected ($0.71)
Seat 2: mankar.am (button) folded on the Flop
Seat 3: PlayTheBlues4U (small blind) folded before Flop
Seat 4: SeaofLove (big blind) folded before Flop
Seat 6: Ty1erDurrden folded before Flop (didn't bet)


PokerStars Hand #205379000420:  Hold'em No Limit ($0.05/$0.10 USD) - 2019/11/02 22:24:52 ET
Table 'Hekate' 6-max Seat #1 is the button
Seat 1: linghuchong2 ($1.66 in chips)
Seat 2: mankar.am ($4.91 in chips)
Seat 3: PlayTheBlues4U ($44.39 in chips)
Seat 4: SeaofLove ($11.35 in chips)
Seat 6: Ty1erDurrden ($10 in chips)
mankar.am: posts small blind $0.05
PlayTheBlues4U: posts big blind $0.10
*** HOLE CARDS ***
Dealt to PlayTheBlues4U [8h 3c]
SeaofLove: folds
Ty1erDurrden: folds
linghuchong2: folds
mankar.am: raises $0.10 to $0.20
PlayTheBlues4U: folds
Uncalled bet ($0.10) returned to mankar.am
mankar.am collected $0.20 from pot
*** SUMMARY ***
Total pot $0.20 | Rake $0
Seat 1: linghuchong2 (button) folded before Flop (didn't bet)
Seat 2: mankar.am (small blind) collected ($0.20)
Seat 3: PlayTheBlues4U (big blind) folded before Flop
Seat 4: SeaofLove folded before Flop (didn't bet)
Seat 6: Ty1erDurrden folded before Flop (didn't bet)


PokerStars Hand #205379000307:  Hold'em No Limit ($0.05/$0.10 USD) - 2019/11/02 22:24:23 ET
Table 'Antares' 6-max Seat #2 is the button
Seat 1: SeaofLove ($13.40 in chips)
Seat 2: PlayTheBlues4U ($12.96 in chips)
Seat 3: StickyChipss ($11.36 in chips)
Seat 6: boxerpupp727 ($9.95 in chips)
StickyChipss: posts small blind $0.05
boxerpupp727: posts big blind $0.10
*** HOLE CARDS ***
Dealt to PlayTheBlues4U [7d 3d]
SeaofLove: folds
boxerpupp727 said, "at work"
PlayTheBlues4U: folds
StickyChipss: raises $0.20 to $0.30
boxerpupp727: folds
Uncalled bet ($0.20) returned to StickyChipss
StickyChipss collected $0.20 from pot
*** SUMMARY ***
Total pot $0.20 | Rake $0
Seat 1: SeaofLove folded before Flop (didn't bet)
Seat 2: PlayTheBlues4U (button) folded before Flop (didn't bet)
Seat 3: StickyChipss (small blind) collected ($0.20)
Seat 6: boxerpupp727 (big blind) folded before Flop


PokerStars Hand #205379000278:  Hold'em No Limit ($0.05/$0.10 USD) - 2019/11/02 22:24:15 ET
Table 'Antares' 6-max Seat #1 is the button
Seat 1: SeaofLove ($13.25 in chips)
Seat 2: PlayTheBlues4U ($13.01 in chips)
Seat 3: StickyChipss ($11.46 in chips)
PlayTheBlues4U: posts small blind $0.05
StickyChipss: posts big blind $0.10
boxerpupp727: sits out
*** HOLE CARDS ***
Dealt to PlayTheBlues4U [4s 5c]
SeaofLove: raises $0.15 to $0.25
PlayTheBlues4U: folds
StickyChipss: folds
Uncalled bet ($0.15) returned to SeaofLove
SeaofLove collected $0.25 from pot
SeaofLove: doesn't show hand
*** SUMMARY ***
Total pot $0.25 | Rake $0
Seat 1: SeaofLove (button) collected ($0.25)
Seat 2: PlayTheBlues4U (small blind) folded before Flop
Seat 3: StickyChipss (big blind) folded before Flop


PokerStars Hand #205379000245:  Hold'em No Limit ($0.05/$0.10 USD) - 2019/11/02 22:24:06 ET
Table 'Hekate' 6-max Seat #6 is the button
Seat 1: linghuchong2 ($1.71 in chips)
Seat 2: mankar.am ($4.32 in chips)
Seat 3: PlayTheBlues4U ($44.99 in chips)
Seat 4: SeaofLove ($11.35 in chips)
Seat 6: Ty1erDurrden ($10 in chips)
linghuchong2: posts small blind $0.05
mankar.am: posts big blind $0.10
*** HOLE CARDS ***
Dealt to PlayTheBlues4U [Kc Ks]
PlayTheBlues4U: raises $0.20 to $0.30
SeaofLove: folds
Ty1erDurrden: folds
linghuchong2: folds
mankar.am: calls $0.20
*** FLOP *** [2d Ad 7h]
mankar.am: checks
PlayTheBlues4U: checks
*** TURN *** [2d Ad 7h] [8s]
mankar.am: bets $0.30
PlayTheBlues4U: calls $0.30
*** RIVER *** [2d Ad 7h 8s] [3c]
mankar.am: bets $1.20
PlayTheBlues4U: folds
Uncalled bet ($1.20) returned to mankar.am
mankar.am collected $1.19 from pot
*** SUMMARY ***
Total pot $1.25 | Rake $0.06
Board [2d Ad 7h 8s 3c]
Seat 1: linghuchong2 (small blind) folded before Flop
Seat 2: mankar.am (big blind) collected ($1.19)
Seat 3: PlayTheBlues4U folded on the River
Seat 4: SeaofLove folded before Flop (didn't bet)
Seat 6: Ty1erDurrden (button) folded before Flop (didn't bet)


PokerStars Hand #205379000241:  Hold'em No Limit ($0.05/$0.10 USD) - 2019/11/02 22:24:05 ET
Table 'Antares' 6-max Seat #3 is the button
Seat 1: SeaofLove ($13.30 in chips)
Seat 2: PlayTheBlues4U ($12.96 in chips)
Seat 3: StickyChipss ($11.46 in chips)
SeaofLove: posts small blind $0.05
PlayTheBlues4U: posts big blind $0.10
*** HOLE CARDS ***
Dealt to PlayTheBlues4U [Qs 7h]
StickyChipss: folds
SeaofLove: folds
Uncalled bet ($0.05) returned to PlayTheBlues4U
PlayTheBlues4U collected $0.10 from pot
PlayTheBlues4U: doesn't show hand
*** SUMMARY ***
Total pot $0.10 | Rake $0
Seat 1: SeaofLove (small blind) folded before Flop
Seat 2: PlayTheBlues4U (big blind) collected ($0.10)
Seat 3: StickyChipss (button) folded before Flop (didn't bet)


PokerStars Hand #205379000207:  Hold'em No Limit ($0.05/$0.10 USD) - 2019/11/02 22:23:53 ET
Table 'Antares' 6-max Seat #2 is the button
Seat 1: SeaofLove ($13.25 in chips)
Seat 2: PlayTheBlues4U ($12.96 in chips)
Seat 3: StickyChipss ($11.51 in chips)
StickyChipss: posts small blind $0.05
SeaofLove: posts big blind $0.10
*** HOLE CARDS ***
Dealt to PlayTheBlues4U [4c Td]
PlayTheBlues4U: folds
StickyChipss: folds
Uncalled bet ($0.05) returned to SeaofLove
SeaofLove collected $0.10 from pot
SeaofLove: doesn't show hand
*** SUMMARY ***
Total pot $0.10 | Rake $0
Seat 1: SeaofLove (big blind) collected ($0.10)
Seat 2: PlayTheBlues4U (button) folded before Flop (didn't bet)
Seat 3: StickyChipss (small blind) folded before Flop


PokerStars Hand #205379000181:  Hold'em No Limit ($0.05/$0.10 USD) - 2019/11/02 22:23:45 ET
Table 'Hekate' 6-max Seat #4 is the button
Seat 1: linghuchong2 ($1.91 in chips)
Seat 2: mankar.am ($4.09 in chips)
Seat 3: PlayTheBlues4U ($44.99 in chips)
Seat 4: SeaofLove ($11.35 in chips)
Seat 6: Ty1erDurrden ($9.90 in chips)
Ty1erDurrden: posts small blind $0.05
linghuchong2: posts big blind $0.10
*** HOLE CARDS ***
Dealt to PlayTheBlues4U [Th 5d]
mankar.am: raises $0.10 to $0.20
PlayTheBlues4U: folds
SeaofLove: folds
Ty1erDurrden: folds
linghuchong2: calls $0.10
*** FLOP *** [Kd Ah 9h]
linghuchong2: checks
mankar.am: bets $0.20
linghuchong2: folds
Uncalled bet ($0.20) returned to mankar.am
mankar.am collected $0.43 from pot
*** SUMMARY ***
Total pot $0.45 | Rake $0.02
Board [Kd Ah 9h]
Seat 1: linghuchong2 (big blind) folded on the Flop
Seat 2: mankar.am collected ($0.43)
Seat 3: PlayTheBlues4U folded before Flop (didn't bet)
Seat 4: SeaofLove (button) folded before Flop (didn't bet)
Seat 6: Ty1erDurrden (small blind) folded before Flop


PokerStars Hand #205379000159:  Hold'em No Limit ($0.05/$0.10 USD) - 2019/11/02 22:23:39 ET
Table 'Antares' 6-max Seat #1 is the button
Seat 1: SeaofLove ($13.25 in chips)
Seat 2: PlayTheBlues4U ($13.01 in chips)
Seat 3: StickyChipss ($11.46 in chips)
PlayTheBlues4U: posts small blind $0.05
StickyChipss: posts big blind $0.10
*** HOLE CARDS ***
Dealt to PlayTheBlues4U [5s Jd]
SeaofLove: folds
PlayTheBlues4U: folds
Uncalled bet ($0.05) returned to StickyChipss
StickyChipss collected $0.10 from pot
*** SUMMARY ***
Total pot $0.10 | Rake $0
Seat 1: SeaofLove (button) folded before Flop (didn't bet)
Seat 2: PlayTheBlues4U (small blind) folded before Flop
Seat 3: StickyChipss (big blind) collected ($0.10)


PokerStars Hand #205377949968:  Hold'em No Limit ($0.05/$0.10 USD) - 2019/11/02 22:23:13 ET
Table 'Antares' 6-max Seat #3 is the button
Seat 1: SeaofLove ($13.35 in chips)
Seat 2: PlayTheBlues4U ($13.01 in chips)
Seat 3: StickyChipss ($11.31 in chips)
Seat 6: boxerpupp727 ($10 in chips)
boxerpupp727: posts small blind $0.05
SeaofLove: posts big blind $0.10
*** HOLE CARDS ***
Dealt to PlayTheBlues4U [4c 3h]
boxerpupp727 said, " nh sticky"
StickyChipss said, "TY"
boxerpupp727 said, "brb"
PlayTheBlues4U: folds
StickyChipss: raises $0.20 to $0.30
boxerpupp727: folds
SeaofLove: folds
Uncalled bet ($0.20) returned to StickyChipss
StickyChipss collected $0.25 from pot
*** SUMMARY ***
Total pot $0.25 | Rake $0
Seat 1: SeaofLove (big blind) folded before Flop
Seat 2: PlayTheBlues4U folded before Flop (didn't bet)
Seat 3: StickyChipss (button) collected ($0.25)
Seat 6: boxerpupp727 (small blind) folded before Flop


PokerStars Hand #205377949864:  Hold'em No Limit ($0.05/$0.10 USD) - 2019/11/02 22:22:50 ET
Table 'Antares' 6-max Seat #2 is the button
Seat 1: SeaofLove ($13.35 in chips)
Seat 2: PlayTheBlues4U ($13.01 in chips)
Seat 3: StickyChipss ($10.64 in chips)
Seat 6: boxerpupp727 ($10 in chips)
StickyChipss: posts small blind $0.05
boxerpupp727: posts big blind $0.10
*** HOLE CARDS ***
Dealt to PlayTheBlues4U [3c 2c]
SeaofLove: folds
PlayTheBlues4U: folds
boxerpupp727 said, "lol ps"
StickyChipss: raises $0.20 to $0.30
boxerpupp727: calls $0.20
*** FLOP *** [4h Js 5h]
StickyChipss: bets $0.44
boxerpupp727: calls $0.44
*** TURN *** [4h Js 5h] [9h]
StickyChipss: checks
boxerpupp727: checks
*** RIVER *** [4h Js 5h 9h] [6h]
StickyChipss: checks
boxerpupp727: checks
*** SHOW DOWN ***
StickyChipss: shows [Jc Jd] (three of a kind, Jacks)
boxerpupp727: mucks hand
StickyChipss collected $1.41 from pot
*** SUMMARY ***
Total pot $1.48 | Rake $0.07
Board [4h Js 5h 9h 6h]
Seat 1: SeaofLove folded before Flop (didn't bet)
Seat 2: PlayTheBlues4U (button) folded before Flop (didn't bet)
Seat 3: StickyChipss (small blind) showed [Jc Jd] and won ($1.41) with three of a kind, Jacks
Seat 6: boxerpupp727 (big blind) mucked [Ad Tc]


PokerStars Hand #205377949841:  Hold'em No Limit ($0.05/$0.10 USD) - 2019/11/02 22:22:42 ET
Table 'Hekate' 6-max Seat #3 is the button
Seat 1: linghuchong2 ($9.21 in chips)
Seat 2: mankar.am ($4.49 in chips)
Seat 3: PlayTheBlues4U ($37.90 in chips)
Seat 4: SeaofLove ($11.40 in chips)
Seat 6: Ty1erDurrden ($10 in chips)
SeaofLove: posts small blind $0.05
Ty1erDurrden: posts big blind $0.10
*** HOLE CARDS ***
Dealt to PlayTheBlues4U [Js Jd]
linghuchong2: calls $0.10
mankar.am: calls $0.10
PlayTheBlues4U: raises $0.30 to $0.40
SeaofLove: folds
Ty1erDurrden: folds
linghuchong2: calls $0.30
mankar.am: calls $0.30
*** FLOP *** [2d 2h 3h]
linghuchong2: checks
mankar.am: checks
PlayTheBlues4U: bets $0.90
linghuchong2: calls $0.90
mankar.am: folds
*** TURN *** [2d 2h 3h] [6d]
linghuchong2: checks
PlayTheBlues4U: bets $2.30
linghuchong2: calls $2.30
*** RIVER *** [2d 2h 3h 6d] [7s]
linghuchong2: bets $3.70
PlayTheBlues4U: calls $3.70
*** SHOW DOWN ***
linghuchong2: shows [3d As] (two pair, Threes and Deuces)
PlayTheBlues4U: shows [Js Jd] (two pair, Jacks and Deuces)
PlayTheBlues4U collected $14.39 from pot
*** SUMMARY ***
Total pot $15.15 | Rake $0.76
Board [2d 2h 3h 6d 7s]
Seat 1: linghuchong2 showed [3d As] and lost with two pair, Threes and Deuces
Seat 2: mankar.am folded on the Flop
Seat 3: PlayTheBlues4U (button) showed [Js Jd] and won ($14.39) with two pair, Jacks and Deuces
Seat 4: SeaofLove (small blind) folded before Flop
Seat 6: Ty1erDurrden (big blind) folded before Flop


PokerStars Hand #205377949838:  Hold'em No Limit ($0.05/$0.10 USD) - 2019/11/02 22:22:41 ET
Table 'Antares' 6-max Seat #1 is the button
Seat 1: SeaofLove ($13.35 in chips)
Seat 2: PlayTheBlues4U ($13.06 in chips)
Seat 3: StickyChipss ($10.59 in chips)
Seat 6: boxerpupp727 ($10 in chips)
PlayTheBlues4U: posts small blind $0.05
StickyChipss: posts big blind $0.10
*** HOLE CARDS ***
Dealt to PlayTheBlues4U [5c Tc]
boxerpupp727: folds
SeaofLove: folds
PlayTheBlues4U: folds
Uncalled bet ($0.05) returned to StickyChipss
boxerpupp727 said, "sick"
StickyChipss collected $0.10 from pot
*** SUMMARY ***
Total pot $0.10 | Rake $0
Seat 1: SeaofLove (button) folded before Flop (didn't bet)
Seat 2: PlayTheBlues4U (small blind) folded before Flop
Seat 3: StickyChipss (big blind) collected ($0.10)
Seat 6: boxerpupp727 folded before Flop (didn't bet)


PokerStars Hand #205377949789:  Hold'em No Limit ($0.05/$0.10 USD) - 2019/11/02 22:22:26 ET
Table 'Hekate' 6-max Seat #2 is the button
Seat 1: linghuchong2 ($9.21 in chips)
Seat 2: mankar.am ($4.49 in chips)
Seat 3: PlayTheBlues4U ($37.95 in chips)
Seat 4: SeaofLove ($11.35 in chips)
Seat 6: Ty1erDurrden ($10 in chips)
PlayTheBlues4U: posts small blind $0.05
SeaofLove: posts big blind $0.10
*** HOLE CARDS ***
Dealt to PlayTheBlues4U [Kc 6c]
Ty1erDurrden: folds
linghuchong2: folds
mankar.am: folds
PlayTheBlues4U: folds
Uncalled bet ($0.05) returned to SeaofLove
SeaofLove collected $0.10 from pot
SeaofLove: doesn't show hand
*** SUMMARY ***
Total pot $0.10 | Rake $0
Seat 1: linghuchong2 folded before Flop (didn't bet)
Seat 2: mankar.am (button) folded before Flop (didn't bet)
Seat 3: PlayTheBlues4U (small blind) folded before Flop
Seat 4: SeaofLove (big blind) collected ($0.10)
Seat 6: Ty1erDurrden folded before Flop (didn't bet)


PokerStars Hand #205377949716:  Hold'em No Limit ($0.05/$0.10 USD) - 2019/11/02 22:22:06 ET
Table 'Antares' 6-max Seat #6 is the button
Seat 1: SeaofLove ($13.40 in chips)
Seat 2: PlayTheBlues4U ($13.16 in chips)
Seat 3: StickyChipss ($10.65 in chips)
Seat 6: boxerpupp727 ($10 in chips)
SeaofLove: posts small blind $0.05
PlayTheBlues4U: posts big blind $0.10
*** HOLE CARDS ***
Dealt to PlayTheBlues4U [Jh 6d]
StickyChipss: raises $0.20 to $0.30
boxerpupp727: folds
SeaofLove: calls $0.25
PlayTheBlues4U: folds
*** FLOP *** [Qd Ad Jd]
SeaofLove: checks
StickyChipss: bets $0.51
SeaofLove: calls $0.51
*** TURN *** [Qd Ad Jd] [Td]
SeaofLove: checks
StickyChipss: bets $1.26
SeaofLove: calls $1.26
*** RIVER *** [Qd Ad Jd Td] [Kd]
SeaofLove: checks
StickyChipss: checks
*** SHOW DOWN ***
SeaofLove: shows [Ac Qh] (a Royal Flush)
StickyChipss: shows [Ks Qs] (a Royal Flush)
SeaofLove collected $2.02 from pot
StickyChipss collected $2.01 from pot
boxerpupp727 said, "wow"
*** SUMMARY ***
Total pot $4.24 | Rake $0.21
Board [Qd Ad Jd Td Kd]
Seat 1: SeaofLove (small blind) showed [Ac Qh] and won ($2.02) with a Royal Flush
Seat 2: PlayTheBlues4U (big blind) folded before Flop
Seat 3: StickyChipss showed [Ks Qs] and won ($2.01) with a Royal Flush
Seat 6: boxerpupp727 (button) folded before Flop (didn't bet)


PokerStars Hand #205377949710:  Hold'em No Limit ($0.05/$0.10 USD) - 2019/11/02 22:22:06 ET
Table 'Hekate' 6-max Seat #1 is the button
Seat 1: linghuchong2 ($9.21 in chips)
Seat 2: mankar.am ($4.74 in chips)
Seat 3: PlayTheBlues4U ($38.05 in chips)
Seat 4: SeaofLove ($11.03 in chips)
Seat 6: Ty1erDurrden ($10 in chips)
mankar.am: posts small blind $0.05
PlayTheBlues4U: posts big blind $0.10
*** HOLE CARDS ***
Dealt to PlayTheBlues4U [5c Jc]
SeaofLove: raises $0.15 to $0.25
Ty1erDurrden: folds
linghuchong2: folds
mankar.am: calls $0.20
PlayTheBlues4U: folds
*** FLOP *** [6d Ac 3d]
mankar.am: checks
SeaofLove: bets $0.38
mankar.am: folds
Uncalled bet ($0.38) returned to SeaofLove
SeaofLove collected $0.57 from pot
SeaofLove: doesn't show hand
*** SUMMARY ***
Total pot $0.60 | Rake $0.03
Board [6d Ac 3d]
Seat 1: linghuchong2 (button) folded before Flop (didn't bet)
Seat 2: mankar.am (small blind) folded on the Flop
Seat 3: PlayTheBlues4U (big blind) folded before Flop
Seat 4: SeaofLove collected ($0.57)
Seat 6: Ty1erDurrden folded before Flop (didn't bet)


PokerStars Hand #205377949674:  Hold'em No Limit ($0.05/$0.10 USD) - 2019/11/02 22:21:57 ET
Table 'Antares' 6-max Seat #3 is the button
Seat 1: SeaofLove ($13.50 in chips)
Seat 2: PlayTheBlues4U ($13.16 in chips)
Seat 3: StickyChipss ($10.50 in chips)
Seat 6: boxerpupp727 ($9.20 in chips)
boxerpupp727: posts small blind $0.05
SeaofLove: posts big blind $0.10
*** HOLE CARDS ***
Dealt to PlayTheBlues4U [3d 8c]
PlayTheBlues4U: folds
StickyChipss: raises $0.20 to $0.30
boxerpupp727: folds
SeaofLove: folds
Uncalled bet ($0.20) returned to StickyChipss
StickyChipss collected $0.25 from pot
*** SUMMARY ***
Total pot $0.25 | Rake $0
Seat 1: SeaofLove (big blind) folded before Flop
Seat 2: PlayTheBlues4U folded before Flop (didn't bet)
Seat 3: StickyChipss (button) collected ($0.25)
Seat 6: boxerpupp727 (small blind) folded before Flop


PokerStars Hand #205377949638:  Hold'em No Limit ($0.05/$0.10 USD) - 2019/11/02 22:21:47 ET
Table 'Hekate' 6-max Seat #6 is the button
Seat 1: linghuchong2 ($9.26 in chips)
Seat 2: mankar.am ($4.84 in chips)
Seat 3: PlayTheBlues4U ($37.90 in chips)
Seat 4: SeaofLove ($11.03 in chips)
Seat 6: Ty1erDurrden ($10 in chips)
linghuchong2: posts small blind $0.05
mankar.am: posts big blind $0.10
*** HOLE CARDS ***
Dealt to PlayTheBlues4U [Kc Ks]
PlayTheBlues4U: raises $0.20 to $0.30
SeaofLove: folds
Ty1erDurrden: folds
linghuchong2: folds
mankar.am: folds
Uncalled bet ($0.20) returned to PlayTheBlues4U
PlayTheBlues4U collected $0.25 from pot
PlayTheBlues4U: doesn't show hand
*** SUMMARY ***
Total pot $0.25 | Rake $0
Seat 1: linghuchong2 (small blind) folded before Flop
Seat 2: mankar.am (big blind) folded before Flop
Seat 3: PlayTheBlues4U collected ($0.25)
Seat 4: SeaofLove folded before Flop (didn't bet)
Seat 6: Ty1erDurrden (button) folded before Flop (didn't bet)


PokerStars Hand #205377949599:  Hold'em No Limit ($0.05/$0.10 USD) - 2019/11/02 22:21:38 ET
Table 'Hekate' 6-max Seat #4 is the button
Seat 1: linghuchong2 ($9.21 in chips)
Seat 2: mankar.am ($4.84 in chips)
Seat 3: PlayTheBlues4U ($37.90 in chips)
Seat 4: SeaofLove ($11.03 in chips)
Seat 6: Ty1erDurrden ($9.90 in chips)
Ty1erDurrden: posts small blind $0.05
linghuchong2: posts big blind $0.10
*** HOLE CARDS ***
Dealt to PlayTheBlues4U [9h Ts]
mankar.am: folds
PlayTheBlues4U: folds
SeaofLove: folds
Ty1erDurrden: folds
Uncalled bet ($0.05) returned to linghuchong2
linghuchong2 collected $0.10 from pot
linghuchong2: doesn't show hand
*** SUMMARY ***
Total pot $0.10 | Rake $0
Seat 1: linghuchong2 (big blind) collected ($0.10)
Seat 2: mankar.am folded before Flop (didn't bet)
Seat 3: PlayTheBlues4U folded before Flop (didn't bet)
Seat 4: SeaofLove (button) folded before Flop (didn't bet)
Seat 6: Ty1erDurrden (small blind) folded before Flop


PokerStars Hand #205377949556:  Hold'em No Limit ($0.05/$0.10 USD) - 2019/11/02 22:21:27 ET
Table 'Antares' 6-max Seat #2 is the button
Seat 1: SeaofLove ($12.41 in chips)
Seat 2: PlayTheBlues4U ($13.16 in chips)
Seat 3: StickyChipss ($10.75 in chips)
Seat 6: boxerpupp727 ($10.15 in chips)
StickyChipss: posts small blind $0.05
rope-a-dope8: is sitting out
Jariso13: is sitting out
boxerpupp727: posts big blind $0.10
*** HOLE CARDS ***
Dealt to PlayTheBlues4U [Kd Ts]
rope-a-dope8 leaves the table
SeaofLove: raises $0.15 to $0.25
PlayTheBlues4U: folds
StickyChipss: calls $0.20
boxerpupp727: calls $0.15
*** FLOP *** [Ah 4d 5h]
Jariso13 leaves the table
StickyChipss: checks
boxerpupp727: bets $0.70
SeaofLove: calls $0.70
StickyChipss: folds
*** TURN *** [Ah 4d 5h] [2d]
boxerpupp727: checks
SeaofLove: checks
*** RIVER *** [Ah 4d 5h 2d] [Kc]
boxerpupp727: checks
SeaofLove: checks
*** SHOW DOWN ***
boxerpupp727: shows [8h Qh] (high card Ace)
SeaofLove: shows [As Qc] (a pair of Aces)
SeaofLove collected $2.04 from pot
*** SUMMARY ***
Total pot $2.15 | Rake $0.11
Board [Ah 4d 5h 2d Kc]
Seat 1: SeaofLove showed [As Qc] and won ($2.04) with a pair of Aces
Seat 2: PlayTheBlues4U (button) folded before Flop (didn't bet)
Seat 3: StickyChipss (small blind) folded on the Flop
Seat 6: boxerpupp727 (big blind) showed [8h Qh] and lost with high card Ace


PokerStars Hand #205377949481:  Hold'em No Limit ($0.05/$0.10 USD) - 2019/11/02 22:21:10 ET
Table 'Antares' 6-max Seat #1 is the button
Seat 1: SeaofLove ($12.41 in chips)
Seat 2: PlayTheBlues4U ($13.21 in chips)
Seat 3: StickyChipss ($10.85 in chips)
Seat 4: rope-a-dope8 ($18.08 in chips)
Seat 5: Jariso13 ($13.23 in chips)
Seat 6: boxerpupp727 ($10 in chips)
PlayTheBlues4U: posts small blind $0.05
StickyChipss: posts big blind $0.10
*** HOLE CARDS ***
Dealt to PlayTheBlues4U [3c Ts]
boxerpupp727 said, "gh"
rope-a-dope8: folds
Jariso13: folds
boxerpupp727: raises $0.25 to $0.35
SeaofLove: folds
PlayTheBlues4U: folds
StickyChipss: folds
Uncalled bet ($0.25) returned to boxerpupp727
boxerpupp727 collected $0.25 from pot
boxerpupp727: doesn't show hand
*** SUMMARY ***
Total pot $0.25 | Rake $0
Seat 1: SeaofLove (button) folded before Flop (didn't bet)
Seat 2: PlayTheBlues4U (small blind) folded before Flop
Seat 3: StickyChipss (big blind) folded before Flop
Seat 4: rope-a-dope8 folded before Flop (didn't bet)
Seat 5: Jariso13 folded before Flop (didn't bet)
Seat 6: boxerpupp727 collected ($0.25)


PokerStars Hand #205377949463:  Hold'em No Limit ($0.05/$0.10 USD) - 2019/11/02 22:21:05 ET
Table 'Hekate' 6-max Seat #3 is the button
Seat 1: linghuchong2 ($9.21 in chips)
Seat 2: mankar.am ($5.34 in chips)
Seat 3: PlayTheBlues4U ($37.90 in chips)
Seat 4: SeaofLove ($10.49 in chips)
Seat 6: Ty1erDurrden ($10 in chips)
SeaofLove: posts small blind $0.05
Ty1erDurrden: posts big blind $0.10
*** HOLE CARDS ***
Dealt to PlayTheBlues4U [4h Qc]
linghuchong2: folds
mankar.am: raises $0.10 to $0.20
PlayTheBlues4U: folds
SeaofLove: calls $0.15
Ty1erDurrden: folds
*** FLOP *** [Ah 2h 4d]
SeaofLove: checks
mankar.am: checks
*** TURN *** [Ah 2h 4d] [7h]
SeaofLove: bets $0.30
mankar.am: calls $0.30
*** RIVER *** [Ah 2h 4d 7h] [3d]
SeaofLove: checks
mankar.am: checks
*** SHOW DOWN ***
SeaofLove: shows [Qd Kh] (high card Ace)
mankar.am: mucks hand
SeaofLove collected $1.04 from pot
*** SUMMARY ***
Total pot $1.10 | Rake $0.06
Board [Ah 2h 4d 7h 3d]
Seat 1: linghuchong2 folded before Flop (didn't bet)
Seat 2: mankar.am mucked [9s Kd]
Seat 3: PlayTheBlues4U (button) folded before Flop (didn't bet)
Seat 4: SeaofLove (small blind) showed [Qd Kh] and won ($1.04) with high card Ace
Seat 6: Ty1erDurrden (big blind) folded before Flop


PokerStars Hand #205377949342:  Hold'em No Limit ($0.05/$0.10 USD) - 2019/11/02 22:20:34 ET
Table 'Hekate' 6-max Seat #2 is the button
Seat 1: linghuchong2 ($9.21 in chips)
Seat 2: mankar.am ($5.20 in chips)
Seat 3: PlayTheBlues4U ($37.95 in chips)
Seat 4: SeaofLove ($10.59 in chips)
Seat 5: rope-a-dope8 ($11 in chips)
Seat 6: Ty1erDurrden ($10 in chips)
PlayTheBlues4U: posts small blind $0.05
SeaofLove: posts big blind $0.10
*** HOLE CARDS ***
Dealt to PlayTheBlues4U [2d Jd]
rope-a-dope8: folds
rope-a-dope8 leaves the table
Ty1erDurrden: folds
linghuchong2: folds
mankar.am: calls $0.10
PlayTheBlues4U: folds
SeaofLove: checks
*** FLOP *** [Jh 5c 4c]
SeaofLove: checks
mankar.am: checks
*** TURN *** [Jh 5c 4c] [9d]
SeaofLove: checks
mankar.am: bets $0.10
SeaofLove: folds
Uncalled bet ($0.10) returned to mankar.am
mankar.am collected $0.24 from pot
*** SUMMARY ***
Total pot $0.25 | Rake $0.01
Board [Jh 5c 4c 9d]
Seat 1: linghuchong2 folded before Flop (didn't bet)
Seat 2: mankar.am (button) collected ($0.24)
Seat 3: PlayTheBlues4U (small blind) folded before Flop
Seat 4: SeaofLove (big blind) folded on the Turn
Seat 5: rope-a-dope8 folded before Flop (didn't bet)
Seat 6: Ty1erDurrden folded before Flop (didn't bet)


PokerStars Hand #205377949269:  Hold'em No Limit ($0.05/$0.10 USD) - 2019/11/02 22:20:14 ET
Table 'Antares' 6-max Seat #6 is the button
Seat 1: SeaofLove ($10 in chips)
Seat 2: PlayTheBlues4U ($13.31 in chips)
Seat 3: StickyChipss ($10.85 in chips)
Seat 4: rope-a-dope8 ($18.08 in chips)
Seat 5: Jariso13 ($13.33 in chips)
Seat 6: boxerpupp727 ($9.85 in chips)
SeaofLove: posts small blind $0.05
PlayTheBlues4U: posts big blind $0.10
*** HOLE CARDS ***
Dealt to PlayTheBlues4U [7s 8s]
StickyChipss: folds
rope-a-dope8: folds
Jariso13: calls $0.10
boxerpupp727: raises $0.45 to $0.55
SeaofLove: calls $0.50
PlayTheBlues4U: folds
Jariso13: folds
*** FLOP *** [Js Td 9s]
SeaofLove: bets $0.62
boxerpupp727: calls $0.62
*** TURN *** [Js Td 9s] [2c]
SeaofLove: bets $1.30
boxerpupp727: calls $1.30
*** RIVER *** [Js Td 9s 2c] [3d]
SeaofLove: bets $2.44
boxerpupp727: folds
Uncalled bet ($2.44) returned to SeaofLove
SeaofLove collected $4.88 from pot
SeaofLove: doesn't show hand
*** SUMMARY ***
Total pot $5.14 | Rake $0.26
Board [Js Td 9s 2c 3d]
Seat 1: SeaofLove (small blind) collected ($4.88)
Seat 2: PlayTheBlues4U (big blind) folded before Flop
Seat 3: StickyChipss folded before Flop (didn't bet)
Seat 4: rope-a-dope8 folded before Flop (didn't bet)
Seat 5: Jariso13 folded before Flop
Seat 6: boxerpupp727 (button) folded on the River


PokerStars Hand #205377949202:  Hold'em No Limit ($0.05/$0.10 USD) - 2019/11/02 22:19:57 ET
Table 'Hekate' 6-max Seat #1 is the button
Seat 1: linghuchong2 ($8.01 in chips)
Seat 2: mankar.am ($5.75 in chips)
Seat 3: PlayTheBlues4U ($38.05 in chips)
Seat 4: SeaofLove ($10.59 in chips)
Seat 5: rope-a-dope8 ($11 in chips)
Seat 6: Ty1erDurrden ($10 in chips)
mankar.am: posts small blind $0.05
PlayTheBlues4U: posts big blind $0.10
*** HOLE CARDS ***
Dealt to PlayTheBlues4U [3h Kc]
SeaofLove: folds
rope-a-dope8: folds
Ty1erDurrden: raises $0.15 to $0.25
linghuchong2: raises $0.15 to $0.40
mankar.am: raises $0.15 to $0.55
PlayTheBlues4U: folds
Ty1erDurrden: calls $0.30
linghuchong2: raises $7.46 to $8.01 and is all-in
mankar.am: folds
Ty1erDurrden: folds
Uncalled bet ($7.46) returned to linghuchong2
linghuchong2 collected $1.75 from pot
linghuchong2: doesn't show hand
*** SUMMARY ***
Total pot $1.75 | Rake $0
Seat 1: linghuchong2 (button) collected ($1.75)
Seat 2: mankar.am (small blind) folded before Flop
Seat 3: PlayTheBlues4U (big blind) folded before Flop
Seat 4: SeaofLove folded before Flop (didn't bet)
Seat 5: rope-a-dope8 folded before Flop (didn't bet)
Seat 6: Ty1erDurrden folded before Flop


PokerStars Hand #205377949175:  Hold'em No Limit ($0.05/$0.10 USD) - 2019/11/02 22:19:49 ET
Table 'Antares' 6-max Seat #5 is the button
Seat 1: SeaofLove ($10 in chips)
Seat 2: PlayTheBlues4U ($13.31 in chips)
Seat 3: StickyChipss ($10.85 in chips)
Seat 4: rope-a-dope8 ($17.93 in chips)
Seat 5: Jariso13 ($13.33 in chips)
Seat 6: boxerpupp727 ($9.90 in chips)
boxerpupp727: posts small blind $0.05
SeaofLove: posts big blind $0.10
*** HOLE CARDS ***
Dealt to PlayTheBlues4U [2d 8d]
PlayTheBlues4U: folds
StickyChipss: folds
rope-a-dope8: raises $0.25 to $0.35
Jariso13: folds
boxerpupp727: folds
SeaofLove: folds
Uncalled bet ($0.25) returned to rope-a-dope8
rope-a-dope8 collected $0.25 from pot
rope-a-dope8: doesn't show hand
*** SUMMARY ***
Total pot $0.25 | Rake $0
Seat 1: SeaofLove (big blind) folded before Flop
Seat 2: PlayTheBlues4U folded before Flop (didn't bet)
Seat 3: StickyChipss folded before Flop (didn't bet)
Seat 4: rope-a-dope8 collected ($0.25)
Seat 5: Jariso13 (button) folded before Flop (didn't bet)
Seat 6: boxerpupp727 (small blind) folded before Flop


PokerStars Hand #205377949079:  Hold'em No Limit ($0.05/$0.10 USD) - 2019/11/02 22:19:25 ET
Table 'Antares' 6-max Seat #4 is the button
Seat 1: TonyA747 ($20.20 in chips)
Seat 2: PlayTheBlues4U ($13.31 in chips)
Seat 3: StickyChipss ($10.85 in chips)
Seat 4: rope-a-dope8 ($17.78 in chips)
Seat 5: Jariso13 ($13.38 in chips)
Seat 6: boxerpupp727 ($10 in chips)
Jariso13: posts small blind $0.05
boxerpupp727: posts big blind $0.10
*** HOLE CARDS ***
Dealt to PlayTheBlues4U [5h 4s]
TonyA747: folds
PlayTheBlues4U: folds
StickyChipss: folds
rope-a-dope8: raises $0.30 to $0.40
TonyA747 leaves the table
Jariso13: folds
SeaofLove joins the table at seat #1
boxerpupp727: folds
Uncalled bet ($0.30) returned to rope-a-dope8
rope-a-dope8 collected $0.25 from pot
rope-a-dope8: doesn't show hand
*** SUMMARY ***
Total pot $0.25 | Rake $0
Seat 1: TonyA747 folded before Flop (didn't bet)
Seat 2: PlayTheBlues4U folded before Flop (didn't bet)
Seat 3: StickyChipss folded before Flop (didn't bet)
Seat 4: rope-a-dope8 (button) collected ($0.25)
Seat 5: Jariso13 (small blind) folded before Flop
Seat 6: boxerpupp727 (big blind) folded before Flop


PokerStars Hand #205377949050:  Hold'em No Limit ($0.05/$0.10 USD) - 2019/11/02 22:19:18 ET
Table 'Hekate' 6-max Seat #6 is the button
Seat 1: linghuchong2 ($8.06 in chips)
Seat 2: mankar.am ($6.95 in chips)
Seat 3: PlayTheBlues4U ($36.92 in chips)
Seat 4: SeaofLove ($10.59 in chips)
Seat 5: rope-a-dope8 ($11 in chips)
Seat 6: Ty1erDurrden ($10 in chips)
linghuchong2: posts small blind $0.05
mankar.am: posts big blind $0.10
*** HOLE CARDS ***
Dealt to PlayTheBlues4U [Tc Ts]
PlayTheBlues4U: raises $0.20 to $0.30
SeaofLove: folds
rope-a-dope8: folds
Ty1erDurrden: folds
linghuchong2: folds
mankar.am: raises $0.20 to $0.50
PlayTheBlues4U: calls $0.20
*** FLOP *** [5d 2d 8h]
mankar.am: checks
PlayTheBlues4U: bets $0.70
mankar.am: calls $0.70
*** TURN *** [5d 2d 8h] [6h]
mankar.am: checks
PlayTheBlues4U: bets $1.60
mankar.am: folds
Uncalled bet ($1.60) returned to PlayTheBlues4U
PlayTheBlues4U collected $2.33 from pot
PlayTheBlues4U: doesn't show hand
*** SUMMARY ***
Total pot $2.45 | Rake $0.12
Board [5d 2d 8h 6h]
Seat 1: linghuchong2 (small blind) folded before Flop
Seat 2: mankar.am (big blind) folded on the Turn
Seat 3: PlayTheBlues4U collected ($2.33)
Seat 4: SeaofLove folded before Flop (didn't bet)
Seat 5: rope-a-dope8 folded before Flop (didn't bet)
Seat 6: Ty1erDurrden (button) folded before Flop (didn't bet)


PokerStars Hand #205377948907:  Hold'em No Limit ($0.05/$0.10 USD) - 2019/11/02 22:18:40 ET
Table 'Antares' 6-max Seat #3 is the button
Seat 1: TonyA747 ($20.55 in chips)
Seat 2: PlayTheBlues4U ($13.31 in chips)
Seat 3: StickyChipss ($10 in chips)
Seat 4: rope-a-dope8 ($17.83 in chips)
Seat 5: Jariso13 ($13.48 in chips)
Seat 6: boxerpupp727 ($10 in chips)
rope-a-dope8: posts small blind $0.05
Jariso13: posts big blind $0.10
*** HOLE CARDS ***
Dealt to PlayTheBlues4U [2d 5s]
boxerpupp727: raises $0.25 to $0.35
TonyA747: calls $0.35
PlayTheBlues4U: folds
StickyChipss: raises $9.65 to $10 and is all-in
rope-a-dope8: folds
Jariso13: folds
boxerpupp727: folds
TonyA747: folds
Uncalled bet ($9.65) returned to StickyChipss
StickyChipss collected $1.20 from pot
*** SUMMARY ***
Total pot $1.20 | Rake $0
Seat 1: TonyA747 folded before Flop
Seat 2: PlayTheBlues4U folded before Flop (didn't bet)
Seat 3: StickyChipss (button) collected ($1.20)
Seat 4: rope-a-dope8 (small blind) folded before Flop
Seat 5: Jariso13 (big blind) folded before Flop
Seat 6: boxerpupp727 folded before Flop


PokerStars Hand #205377948885:  Hold'em No Limit ($0.05/$0.10 USD) - 2019/11/02 22:18:35 ET
Table 'Hekate' 6-max Seat #5 is the button
Seat 1: linghuchong2 ($6.57 in chips)
Seat 2: mankar.am ($8.55 in chips)
Seat 3: PlayTheBlues4U ($36.92 in chips)
Seat 4: SeaofLove ($10.59 in chips)
Seat 5: rope-a-dope8 ($11 in chips)
Seat 6: Ty1erDurrden ($9.90 in chips)
Ty1erDurrden: posts small blind $0.05
linghuchong2: posts big blind $0.10
*** HOLE CARDS ***
Dealt to PlayTheBlues4U [Kc 9c]
mankar.am: raises $0.10 to $0.20
PlayTheBlues4U: folds
SeaofLove: folds
rope-a-dope8: folds
Ty1erDurrden: folds
linghuchong2: calls $0.10
*** FLOP *** [7h 7c 8h]
linghuchong2: checks
mankar.am: bets $0.20
linghuchong2: calls $0.20
*** TURN *** [7h 7c 8h] [Th]
linghuchong2: checks
mankar.am: bets $0.40
linghuchong2: calls $0.40
*** RIVER *** [7h 7c 8h Th] [Td]
linghuchong2: checks
mankar.am: bets $0.80
linghuchong2: calls $0.80
*** SHOW DOWN ***
mankar.am: shows [Kd 5c] (two pair, Tens and Sevens)
linghuchong2: shows [8c 6c] (two pair, Tens and Eights)
linghuchong2 collected $3.09 from pot
*** SUMMARY ***
Total pot $3.25 | Rake $0.16
Board [7h 7c 8h Th Td]
Seat 1: linghuchong2 (big blind) showed [8c 6c] and won ($3.09) with two pair, Tens and Eights
Seat 2: mankar.am showed [Kd 5c] and lost with two pair, Tens and Sevens
Seat 3: PlayTheBlues4U folded before Flop (didn't bet)
Seat 4: SeaofLove folded before Flop (didn't bet)
Seat 5: rope-a-dope8 (button) folded before Flop (didn't bet)
Seat 6: Ty1erDurrden (small blind) folded before Flop


PokerStars Hand #205377948756:  Hold'em No Limit ($0.05/$0.10 USD) - 2019/11/02 22:18:00 ET
Table 'Hekate' 6-max Seat #4 is the button
Seat 1: linghuchong2 ($7.07 in chips)
Seat 2: mankar.am ($8.65 in chips)
Seat 3: PlayTheBlues4U ($36.92 in chips)
Seat 4: SeaofLove ($10.59 in chips)
Seat 5: rope-a-dope8 ($10.36 in chips)
Seat 6: Ty1erDurrden ($10 in chips)
rope-a-dope8: posts small blind $0.05
Ty1erDurrden: posts big blind $0.10
mankar.am: posts big blind $0.10
*** HOLE CARDS ***
Dealt to PlayTheBlues4U [6h 3c]
linghuchong2: calls $0.10
mankar.am: checks
PlayTheBlues4U: folds
SeaofLove: folds
rope-a-dope8: raises $0.40 to $0.50
Ty1erDurrden: folds
linghuchong2: calls $0.40
mankar.am: folds
*** FLOP *** [2c 7h 3s]
rope-a-dope8: bets $0.86
linghuchong2: folds
Uncalled bet ($0.86) returned to rope-a-dope8
rope-a-dope8 collected $1.14 from pot
rope-a-dope8: doesn't show hand
*** SUMMARY ***
Total pot $1.20 | Rake $0.06
Board [2c 7h 3s]
Seat 1: linghuchong2 folded on the Flop
Seat 2: mankar.am folded before Flop (didn't bet)
Seat 3: PlayTheBlues4U folded before Flop (didn't bet)
Seat 4: SeaofLove (button) folded before Flop (didn't bet)
Seat 5: rope-a-dope8 (small blind) collected ($1.14)
Seat 6: Ty1erDurrden (big blind) folded before Flop


PokerStars Hand #205377948726:  Hold'em No Limit ($0.05/$0.10 USD) - 2019/11/02 22:17:52 ET
Table 'Hekate' 6-max Seat #3 is the button
Seat 1: linghuchong2 ($7.07 in chips)
Seat 3: PlayTheBlues4U ($36.77 in chips)
Seat 4: SeaofLove ($10.64 in chips)
Seat 5: rope-a-dope8 ($10.46 in chips)
SeaofLove: posts small blind $0.05
rope-a-dope8: posts big blind $0.10
Ty1erDurrden: sits out
*** HOLE CARDS ***
Dealt to PlayTheBlues4U [Ah 7h]
linghuchong2: folds
mankar.am joins the table at seat #2
PlayTheBlues4U: raises $0.20 to $0.30
SeaofLove: folds
rope-a-dope8: folds
Uncalled bet ($0.20) returned to PlayTheBlues4U
PlayTheBlues4U collected $0.25 from pot
PlayTheBlues4U: doesn't show hand
*** SUMMARY ***
Total pot $0.25 | Rake $0
Seat 1: linghuchong2 folded before Flop (didn't bet)
Seat 3: PlayTheBlues4U (button) collected ($0.25)
Seat 4: SeaofLove (small blind) folded before Flop
Seat 5: rope-a-dope8 (big blind) folded before Flop


PokerStars Hand #205377948681:  Hold'em No Limit ($0.05/$0.10 USD) - 2019/11/02 22:17:39 ET
Table 'Hekate' 6-max Seat #1 is the button
Seat 1: linghuchong2 ($7.07 in chips)
Seat 3: PlayTheBlues4U ($36.82 in chips)
Seat 4: SeaofLove ($10.59 in chips)
Seat 5: rope-a-dope8 ($10.46 in chips)
PlayTheBlues4U: posts small blind $0.05
SeaofLove: posts big blind $0.10
Ty1erDurrden: sits out
*** HOLE CARDS ***
Dealt to PlayTheBlues4U [2h 5s]
rope-a-dope8: folds
linghuchong2: folds
PlayTheBlues4U: folds
Uncalled bet ($0.05) returned to SeaofLove
SeaofLove collected $0.10 from pot
SeaofLove: doesn't show hand
*** SUMMARY ***
Total pot $0.10 | Rake $0
Seat 1: linghuchong2 (button) folded before Flop (didn't bet)
Seat 3: PlayTheBlues4U (small blind) folded before Flop
Seat 4: SeaofLove (big blind) collected ($0.10)
Seat 5: rope-a-dope8 folded before Flop (didn't bet)


PokerStars Hand #205377948671:  Hold'em No Limit ($0.05/$0.10 USD) - 2019/11/02 22:17:35 ET
Table 'Antares' 6-max Seat #2 is the button
Seat 1: TonyA747 ($10.31 in chips)
Seat 2: PlayTheBlues4U ($13.31 in chips)
Seat 3: StickyChipss ($10 in chips)
Seat 4: rope-a-dope8 ($17.93 in chips)
Seat 5: Jariso13 ($13.48 in chips)
Seat 6: boxerpupp727 ($10 in chips)
StickyChipss: posts small blind $0.05
rope-a-dope8: posts big blind $0.10
*** HOLE CARDS ***
Dealt to PlayTheBlues4U [Td 2h]
Jariso13: folds
boxerpupp727: raises $0.25 to $0.35
TonyA747: raises $0.85 to $1.20
PlayTheBlues4U: folds
StickyChipss: calls $1.15
rope-a-dope8: folds
boxerpupp727: calls $0.85
*** FLOP *** [Qc 8c Ad]
StickyChipss: checks
boxerpupp727: checks
TonyA747: bets $3.50
StickyChipss: calls $3.50
boxerpupp727: folds
*** TURN *** [Qc 8c Ad] [9s]
StickyChipss: checks
TonyA747: bets $5.61 and is all-in
StickyChipss: calls $5.30 and is all-in
Uncalled bet ($0.31) returned to TonyA747
*** RIVER *** [Qc 8c Ad 9s] [2d]
*** SHOW DOWN ***
StickyChipss: shows [Qh Kd] (a pair of Queens)
TonyA747: shows [8d Qd] (two pair, Queens and Eights)
TonyA747 collected $20.24 from pot
*** SUMMARY ***
Total pot $21.30 | Rake $1.06
Board [Qc 8c Ad 9s 2d]
Seat 1: TonyA747 showed [8d Qd] and won ($20.24) with two pair, Queens and Eights
Seat 2: PlayTheBlues4U (button) folded before Flop (didn't bet)
Seat 3: StickyChipss (small blind) showed [Qh Kd] and lost with a pair of Queens
Seat 4: rope-a-dope8 (big blind) folded before Flop
Seat 5: Jariso13 folded before Flop (didn't bet)
Seat 6: boxerpupp727 folded on the Flop


PokerStars Hand #205377948572:  Hold'em No Limit ($0.05/$0.10 USD) - 2019/11/02 22:17:07 ET
Table 'Antares' 6-max Seat #1 is the button
Seat 1: TonyA747 ($10.66 in chips)
Seat 2: PlayTheBlues4U ($13.36 in chips)
Seat 3: StickyChipss ($10 in chips)
Seat 4: rope-a-dope8 ($17.47 in chips)
Seat 5: Jariso13 ($13.48 in chips)
Seat 6: boxerpupp727 ($9.60 in chips)
PlayTheBlues4U: posts small blind $0.05
StickyChipss: posts big blind $0.10
*** HOLE CARDS ***
Dealt to PlayTheBlues4U [Kd 4d]
rope-a-dope8: raises $0.25 to $0.35
Jariso13: folds
boxerpupp727: folds
TonyA747: calls $0.35
PlayTheBlues4U: folds
StickyChipss: folds
*** FLOP *** [As 9s 6h]
rope-a-dope8: bets $0.81
TonyA747: folds
Uncalled bet ($0.81) returned to rope-a-dope8
rope-a-dope8 collected $0.81 from pot
rope-a-dope8: doesn't show hand
*** SUMMARY ***
Total pot $0.85 | Rake $0.04
Board [As 9s 6h]
Seat 1: TonyA747 (button) folded on the Flop
Seat 2: PlayTheBlues4U (small blind) folded before Flop
Seat 3: StickyChipss (big blind) folded before Flop
Seat 4: rope-a-dope8 collected ($0.81)
Seat 5: Jariso13 folded before Flop (didn't bet)
Seat 6: boxerpupp727 folded before Flop (didn't bet)


PokerStars Hand #205377948507:  Hold'em No Limit ($0.05/$0.10 USD) - 2019/11/02 22:16:51 ET
Table 'Hekate' 6-max Seat #5 is the button
Seat 1: linghuchong2 ($7.47 in chips)
Seat 3: PlayTheBlues4U ($36.92 in chips)
Seat 4: SeaofLove ($10.59 in chips)
Seat 5: rope-a-dope8 ($10 in chips)
linghuchong2: posts small blind $0.05
PlayTheBlues4U: posts big blind $0.10
*** HOLE CARDS ***
Dealt to PlayTheBlues4U [3s 7s]
SeaofLove: folds
rope-a-dope8: raises $0.30 to $0.40
linghuchong2: calls $0.35
PlayTheBlues4U: folds
*** FLOP *** [2d 2s Ks]
linghuchong2: checks
rope-a-dope8: bets $0.86
Ty1erDurrden joins the table at seat #6
linghuchong2: folds
Uncalled bet ($0.86) returned to rope-a-dope8
rope-a-dope8 collected $0.86 from pot
rope-a-dope8: doesn't show hand
*** SUMMARY ***
Total pot $0.90 | Rake $0.04
Board [2d 2s Ks]
Seat 1: linghuchong2 (small blind) folded on the Flop
Seat 3: PlayTheBlues4U (big blind) folded before Flop
Seat 4: SeaofLove folded before Flop (didn't bet)
Seat 5: rope-a-dope8 (button) collected ($0.86)


PokerStars Hand #205377948425:  Hold'em No Limit ($0.05/$0.10 USD) - 2019/11/02 22:16:29 ET
Table 'Antares' 6-max Seat #6 is the button
Seat 1: TonyA747 ($10.71 in chips)
Seat 2: PlayTheBlues4U ($12.95 in chips)
Seat 3: StickyChipss ($10 in chips)
Seat 4: rope-a-dope8 ($17.47 in chips)
Seat 5: Jariso13 ($13.48 in chips)
Seat 6: boxerpupp727 ($7.50 in chips)
TonyA747: posts small blind $0.05
PlayTheBlues4U: posts big blind $0.10
*** HOLE CARDS ***
Dealt to PlayTheBlues4U [3h 3s]
StickyChipss: folds
rope-a-dope8: folds
Jariso13: folds
boxerpupp727: raises $0.30 to $0.40
TonyA747: folds
PlayTheBlues4U: calls $0.30
*** FLOP *** [9s 7d 5s]
PlayTheBlues4U: checks
boxerpupp727: checks
*** TURN *** [9s 7d 5s] [9d]
PlayTheBlues4U: checks
boxerpupp727: checks
*** RIVER *** [9s 7d 5s 9d] [4c]
PlayTheBlues4U: checks
boxerpupp727: checks
*** SHOW DOWN ***
PlayTheBlues4U: shows [3h 3s] (two pair, Nines and Threes)
boxerpupp727: mucks hand
PlayTheBlues4U collected $0.81 from pot
*** SUMMARY ***
Total pot $0.85 | Rake $0.04
Board [9s 7d 5s 9d 4c]
Seat 1: TonyA747 (small blind) folded before Flop
Seat 2: PlayTheBlues4U (big blind) showed [3h 3s] and won ($0.81) with two pair, Nines and Threes
Seat 3: StickyChipss folded before Flop (didn't bet)
Seat 4: rope-a-dope8 folded before Flop (didn't bet)
Seat 5: Jariso13 folded before Flop (didn't bet)
Seat 6: boxerpupp727 (button) mucked [Ac Th]


PokerStars Hand #205377948366:  Hold'em No Limit ($0.05/$0.10 USD) - 2019/11/02 22:16:12 ET
Table 'Hekate' 6-max Seat #4 is the button
Seat 1: linghuchong2 ($7.57 in chips)
Seat 3: PlayTheBlues4U ($36.92 in chips)
Seat 4: SeaofLove ($10 in chips)
Seat 5: rope-a-dope8 ($10.39 in chips)
rope-a-dope8: posts small blind $0.05
linghuchong2: posts big blind $0.10
*** HOLE CARDS ***
Dealt to PlayTheBlues4U [6d Qh]
PlayTheBlues4U said, "big hand. "
PlayTheBlues4U: folds
SeaofLove: raises $0.15 to $0.25
rope-a-dope8: calls $0.20
linghuchong2: folds
*** FLOP *** [2d 7h Tc]
rope-a-dope8: bets $0.30
SeaofLove: raises $0.78 to $1.08
rope-a-dope8: folds
Uncalled bet ($0.78) returned to SeaofLove
SeaofLove collected $1.14 from pot
SeaofLove: doesn't show hand
*** SUMMARY ***
Total pot $1.20 | Rake $0.06
Board [2d 7h Tc]
Seat 1: linghuchong2 (big blind) folded before Flop
Seat 3: PlayTheBlues4U folded before Flop (didn't bet)
Seat 4: SeaofLove (button) collected ($1.14)
Seat 5: rope-a-dope8 (small blind) folded on the Flop


PokerStars Hand #205377948324:  Hold'em No Limit ($0.05/$0.10 USD) - 2019/11/02 22:16:04 ET
Table 'Antares' 6-max Seat #5 is the button
Seat 1: TonyA747 ($10.31 in chips)
Seat 2: PlayTheBlues4U ($12.95 in chips)
Seat 3: StickyChipss ($10 in chips)
Seat 4: rope-a-dope8 ($17.47 in chips)
Seat 5: Jariso13 ($13.48 in chips)
Seat 6: boxerpupp727 ($7.90 in chips)
boxerpupp727: posts small blind $0.05
TonyA747: posts big blind $0.10
*** HOLE CARDS ***
Dealt to PlayTheBlues4U [5c 7h]
PlayTheBlues4U: folds
StickyChipss said, "nice"
StickyChipss: folds
rope-a-dope8: folds
Jariso13: folds
boxerpupp727: raises $0.30 to $0.40
TonyA747: raises $0.80 to $1.20
boxerpupp727: folds
Uncalled bet ($0.80) returned to TonyA747
TonyA747 collected $0.80 from pot
boxerpupp727 said, "thx"
TonyA747: doesn't show hand
*** SUMMARY ***
Total pot $0.80 | Rake $0
Seat 1: TonyA747 (big blind) collected ($0.80)
Seat 2: PlayTheBlues4U folded before Flop (didn't bet)
Seat 3: StickyChipss folded before Flop (didn't bet)
Seat 4: rope-a-dope8 folded before Flop (didn't bet)
Seat 5: Jariso13 (button) folded before Flop (didn't bet)
Seat 6: boxerpupp727 (small blind) folded before Flop


PokerStars Hand #205377948255:  Hold'em No Limit ($0.05/$0.10 USD) - 2019/11/02 22:15:45 ET
Table 'Hekate' 6-max Seat #3 is the button
Seat 1: linghuchong2 ($7.67 in chips)
Seat 3: PlayTheBlues4U ($36.92 in chips)
Seat 4: SeaofLove ($10 in chips)
Seat 5: rope-a-dope8 ($10.25 in chips)
SeaofLove: posts small blind $0.05
rope-a-dope8: posts big blind $0.10
*** HOLE CARDS ***
Dealt to PlayTheBlues4U [Ks 8s]
linghuchong2: calls $0.10
PlayTheBlues4U: folds
SeaofLove: folds
rope-a-dope8: checks
*** FLOP *** [Kd 2d 5s]
rope-a-dope8: bets $0.18
linghuchong2: folds
Uncalled bet ($0.18) returned to rope-a-dope8
rope-a-dope8 collected $0.24 from pot
rope-a-dope8: doesn't show hand
*** SUMMARY ***
Total pot $0.25 | Rake $0.01
Board [Kd 2d 5s]
Seat 1: linghuchong2 folded on the Flop
Seat 3: PlayTheBlues4U (button) folded before Flop (didn't bet)
Seat 4: SeaofLove (small blind) folded before Flop
Seat 5: rope-a-dope8 (big blind) collected ($0.24)


PokerStars Hand #205377948203:  Hold'em No Limit ($0.05/$0.10 USD) - 2019/11/02 22:15:33 ET
Table 'Hekate' 6-max Seat #1 is the button
Seat 1: linghuchong2 ($7.67 in chips)
Seat 3: PlayTheBlues4U ($36.97 in chips)
Seat 4: SeaofLove ($10 in chips)
Seat 5: rope-a-dope8 ($10.10 in chips)
PlayTheBlues4U: posts small blind $0.05
SeaofLove: posts big blind $0.10
*** HOLE CARDS ***
Dealt to PlayTheBlues4U [3c 9s]
rope-a-dope8: raises $0.25 to $0.35
linghuchong2: folds
PlayTheBlues4U: folds
SeaofLove: folds
Uncalled bet ($0.25) returned to rope-a-dope8
rope-a-dope8 collected $0.25 from pot
rope-a-dope8: doesn't show hand
*** SUMMARY ***
Total pot $0.25 | Rake $0
Seat 1: linghuchong2 (button) folded before Flop (didn't bet)
Seat 3: PlayTheBlues4U (small blind) folded before Flop
Seat 4: SeaofLove (big blind) folded before Flop
Seat 5: rope-a-dope8 collected ($0.25)


PokerStars Hand #205377948167:  Hold'em No Limit ($0.05/$0.10 USD) - 2019/11/02 22:15:26 ET
Table 'Hekate' 6-max Seat #5 is the button
Seat 1: linghuchong2 ($7.72 in chips)
Seat 3: PlayTheBlues4U ($36.92 in chips)
Seat 5: rope-a-dope8 ($10.10 in chips)
linghuchong2: posts small blind $0.05
PlayTheBlues4U: posts big blind $0.10
SeaofLove: sits out
*** HOLE CARDS ***
Dealt to PlayTheBlues4U [6h Kh]
rope-a-dope8: folds
linghuchong2: folds
Uncalled bet ($0.05) returned to PlayTheBlues4U
PlayTheBlues4U collected $0.10 from pot
PlayTheBlues4U: doesn't show hand
*** SUMMARY ***
Total pot $0.10 | Rake $0
Seat 1: linghuchong2 (small blind) folded before Flop
Seat 3: PlayTheBlues4U (big blind) collected ($0.10)
Seat 5: rope-a-dope8 (button) folded before Flop (didn't bet)


PokerStars Hand #205377948146:  Hold'em No Limit ($0.05/$0.10 USD) - 2019/11/02 22:15:22 ET
Table 'Antares' 6-max Seat #4 is the button
Seat 1: TonyA747 ($10.13 in chips)
Seat 2: PlayTheBlues4U ($12.95 in chips)
Seat 3: StickyChipss ($10 in chips)
Seat 4: rope-a-dope8 ($17.47 in chips)
Seat 5: Jariso13 ($13.58 in chips)
Seat 6: boxerpupp727 ($8 in chips)
Jariso13: posts small blind $0.05
boxerpupp727: posts big blind $0.10
*** HOLE CARDS ***
Dealt to PlayTheBlues4U [2d Kd]
TonyA747: calls $0.10
PlayTheBlues4U: folds
StickyChipss: folds
rope-a-dope8: folds
Jariso13: calls $0.05
boxerpupp727: checks
*** FLOP *** [9c 6s 5h]
boxerpupp727 said, "pupp is 85 pounds now lol"
Jariso13: checks
boxerpupp727: checks
TonyA747: checks
*** TURN *** [9c 6s 5h] [6h]
Jariso13: checks
boxerpupp727: checks
TonyA747: checks
*** RIVER *** [9c 6s 5h 6h] [2h]
Jariso13: checks
boxerpupp727: checks
TonyA747: checks
*** SHOW DOWN ***
Jariso13: shows [Jd Qh] (a pair of Sixes)
boxerpupp727: mucks hand
TonyA747: shows [Kh Ts] (a pair of Sixes - King kicker)
TonyA747 collected $0.28 from pot
*** SUMMARY ***
Total pot $0.30 | Rake $0.02
Board [9c 6s 5h 6h 2h]
Seat 1: TonyA747 showed [Kh Ts] and won ($0.28) with a pair of Sixes
Seat 2: PlayTheBlues4U folded before Flop (didn't bet)
Seat 3: StickyChipss folded before Flop (didn't bet)
Seat 4: rope-a-dope8 (button) folded before Flop (didn't bet)
Seat 5: Jariso13 (small blind) showed [Jd Qh] and lost with a pair of Sixes
Seat 6: boxerpupp727 (big blind) mucked [4c 7d]


PokerStars Hand #205377948096:  Hold'em No Limit ($0.05/$0.10 USD) - 2019/11/02 22:15:11 ET
Table 'Hekate' 6-max Seat #3 is the button
Seat 1: linghuchong2 ($7.82 in chips)
Seat 3: PlayTheBlues4U ($36.92 in chips)
Seat 5: rope-a-dope8 ($10 in chips)
SeaofLove will be allowed to play after the button
rope-a-dope8: posts small blind $0.05
BATHMEDIC: is sitting out
linghuchong2: posts big blind $0.10
*** HOLE CARDS ***
Dealt to PlayTheBlues4U [4s Ks]
asanxz22 leaves the table
PlayTheBlues4U: folds
BATHMEDIC leaves the table
rope-a-dope8: raises $0.30 to $0.40
linghuchong2: folds
Uncalled bet ($0.30) returned to rope-a-dope8
rope-a-dope8 collected $0.20 from pot
rope-a-dope8: doesn't show hand
*** SUMMARY ***
Total pot $0.20 | Rake $0
Seat 1: linghuchong2 (big blind) folded before Flop
Seat 3: PlayTheBlues4U (button) folded before Flop (didn't bet)
Seat 5: rope-a-dope8 (small blind) collected ($0.20)


PokerStars Hand #205377948052:  Hold'em No Limit ($0.05/$0.10 USD) - 2019/11/02 22:14:59 ET
Table 'Antares' 6-max Seat #3 is the button
Seat 1: TonyA747 ($10.13 in chips)
Seat 2: PlayTheBlues4U ($12.95 in chips)
Seat 3: StickyChipss ($10 in chips)
Seat 4: rope-a-dope8 ($17.37 in chips)
Seat 5: Jariso13 ($13.68 in chips)
rope-a-dope8: posts small blind $0.05
Jariso13: posts big blind $0.10
boxerpupp727: sits out
*** HOLE CARDS ***
Dealt to PlayTheBlues4U [4s Ad]
TonyA747: folds
PlayTheBlues4U: folds
StickyChipss: folds
StickyChipss said, "sup lil puppy"
rope-a-dope8: raises $0.30 to $0.40
Jariso13: folds
Uncalled bet ($0.30) returned to rope-a-dope8
rope-a-dope8 collected $0.20 from pot
rope-a-dope8: doesn't show hand
*** SUMMARY ***
Total pot $0.20 | Rake $0
Seat 1: TonyA747 folded before Flop (didn't bet)
Seat 2: PlayTheBlues4U folded before Flop (didn't bet)
Seat 3: StickyChipss (button) folded before Flop (didn't bet)
Seat 4: rope-a-dope8 (small blind) collected ($0.20)
Seat 5: Jariso13 (big blind) folded before Flop


PokerStars Hand #205377948008:  Hold'em No Limit ($0.05/$0.10 USD) - 2019/11/02 22:14:47 ET
Table 'Antares' 6-max Seat #2 is the button
Seat 1: TonyA747 ($10.13 in chips)
Seat 2: PlayTheBlues4U ($12.95 in chips)
Seat 3: StickyChipss ($10 in chips)
Seat 4: rope-a-dope8 ($17.32 in chips)
Seat 5: Jariso13 ($13.68 in chips)
StickyChipss: posts small blind $0.05
rope-a-dope8: posts big blind $0.10
boxerpupp727: sits out
*** HOLE CARDS ***
Dealt to PlayTheBlues4U [Th 4h]
Jariso13: folds
TonyA747: folds
PlayTheBlues4U: folds
StickyChipss: folds
Uncalled bet ($0.05) returned to rope-a-dope8
rope-a-dope8 collected $0.10 from pot
rope-a-dope8: doesn't show hand
*** SUMMARY ***
Total pot $0.10 | Rake $0
Seat 1: TonyA747 folded before Flop (didn't bet)
Seat 2: PlayTheBlues4U (button) folded before Flop (didn't bet)
Seat 3: StickyChipss (small blind) folded before Flop
Seat 4: rope-a-dope8 (big blind) collected ($0.10)
Seat 5: Jariso13 folded before Flop (didn't bet)


PokerStars Hand #205377947794:  Hold'em No Limit ($0.05/$0.10 USD) - 2019/11/02 22:13:54 ET
Table 'Hekate' 6-max Seat #2 is the button
Seat 1: linghuchong2 ($7.82 in chips)
Seat 2: asanxz22 ($9.80 in chips)
Seat 3: PlayTheBlues4U ($18.29 in chips)
Seat 5: rope-a-dope8 ($10.13 in chips)
Seat 6: BATHMEDIC ($5.77 in chips)
PlayTheBlues4U: posts small blind $0.05
rope-a-dope8: posts big blind $0.10
*** HOLE CARDS ***
Dealt to PlayTheBlues4U [Kc Ac]
BATHMEDIC: raises $0.10 to $0.20
linghuchong2: folds
asanxz22: raises $0.10 to $0.30
PlayTheBlues4U: raises $0.60 to $0.90
rope-a-dope8: raises $2.30 to $3.20
BATHMEDIC: folds
asanxz22: calls $2.90
PlayTheBlues4U: raises $3.50 to $6.70
rope-a-dope8: raises $3.43 to $10.13 and is all-in
SeaofLove joins the table at seat #4
asanxz22: calls $6.60 and is all-in
PlayTheBlues4U: calls $3.43
*** FLOP *** [Td 2s 9c]
*** TURN *** [Td 2s 9c] [4h]
*** RIVER *** [Td 2s 9c 4h] [3c]
*** SHOW DOWN ***
PlayTheBlues4U: shows [Kc Ac] (high card Ace)
rope-a-dope8: shows [Qs Ad] (high card Ace - lower kicker)
PlayTheBlues4U collected $0.64 from side pot
asanxz22: shows [Kh Jh] (high card King)
PlayTheBlues4U collected $28.12 from main pot
*** SUMMARY ***
Total pot $30.26 Main pot $28.12. Side pot $0.64. | Rake $1.50
Board [Td 2s 9c 4h 3c]
Seat 1: linghuchong2 folded before Flop (didn't bet)
Seat 2: asanxz22 (button) showed [Kh Jh] and lost with high card King
Seat 3: PlayTheBlues4U (small blind) showed [Kc Ac] and won ($28.76) with high card Ace
Seat 5: rope-a-dope8 (big blind) showed [Qs Ad] and lost with high card Ace
Seat 6: BATHMEDIC folded before Flop


PokerStars Hand #205377947731:  Hold'em No Limit ($0.05/$0.10 USD) - 2019/11/02 22:13:35 ET
Table 'Antares' 6-max Seat #1 is the button
Seat 1: TonyA747 ($9.76 in chips)
Seat 2: PlayTheBlues4U ($13.15 in chips)
Seat 3: StickyChipss ($10 in chips)
Seat 4: rope-a-dope8 ($17.32 in chips)
Seat 5: Jariso13 ($13.68 in chips)
PlayTheBlues4U: posts small blind $0.05
StickyChipss: posts big blind $0.10
*** HOLE CARDS ***
Dealt to PlayTheBlues4U [9s Ah]
rope-a-dope8: folds
Jariso13: folds
boxerpupp727 joins the table at seat #6
TonyA747: raises $0.10 to $0.20
PlayTheBlues4U: calls $0.15
StickyChipss: calls $0.10
*** FLOP *** [5d 8d 4h]
PlayTheBlues4U: checks
StickyChipss: checks
TonyA747: bets $1.80
boxerpupp727 said, "sup sticky icky"
PlayTheBlues4U: folds
StickyChipss: folds
Uncalled bet ($1.80) returned to TonyA747
TonyA747 collected $0.57 from pot
TonyA747: doesn't show hand
*** SUMMARY ***
Total pot $0.60 | Rake $0.03
Board [5d 8d 4h]
Seat 1: TonyA747 (button) collected ($0.57)
Seat 2: PlayTheBlues4U (small blind) folded on the Flop
Seat 3: StickyChipss (big blind) folded on the Flop
Seat 4: rope-a-dope8 folded before Flop (didn't bet)
Seat 5: Jariso13 folded before Flop (didn't bet)


PokerStars Hand #205377947668:  Hold'em No Limit ($0.05/$0.10 USD) - 2019/11/02 22:13:21 ET
Table 'Antares' 6-max Seat #5 is the button
Seat 1: TonyA747 ($9.36 in chips)
Seat 2: PlayTheBlues4U ($13.25 in chips)
Seat 4: rope-a-dope8 ($17.32 in chips)
Seat 5: Jariso13 ($13.98 in chips)
TonyA747: posts small blind $0.05
PlayTheBlues4U: posts big blind $0.10
StickyChipss: sits out
*** HOLE CARDS ***
Dealt to PlayTheBlues4U [Ts 9d]
rope-a-dope8: folds
Jariso13: raises $0.20 to $0.30
TonyA747: raises $0.70 to $1
PlayTheBlues4U: folds
Jariso13: folds
Uncalled bet ($0.70) returned to TonyA747
TonyA747 collected $0.70 from pot
TonyA747: doesn't show hand
*** SUMMARY ***
Total pot $0.70 | Rake $0
Seat 1: TonyA747 (small blind) collected ($0.70)
Seat 2: PlayTheBlues4U (big blind) folded before Flop
Seat 4: rope-a-dope8 folded before Flop (didn't bet)
Seat 5: Jariso13 (button) folded before Flop


PokerStars Hand #205377947583:  Hold'em No Limit ($0.05/$0.10 USD) - 2019/11/02 22:13:00 ET
Table 'Hekate' 6-max Seat #1 is the button
Seat 1: linghuchong2 ($7.82 in chips)
Seat 2: asanxz22 ($11.90 in chips)
Seat 3: PlayTheBlues4U ($16.31 in chips)
Seat 5: rope-a-dope8 ($10.13 in chips)
Seat 6: BATHMEDIC ($5.87 in chips)
asanxz22: posts small blind $0.05
PlayTheBlues4U: posts big blind $0.10
*** HOLE CARDS ***
Dealt to PlayTheBlues4U [3c Ad]
rope-a-dope8: folds
BATHMEDIC: calls $0.10
linghuchong2: folds
asanxz22: calls $0.05
PlayTheBlues4U: checks
*** FLOP *** [6h 4d 5d]
asanxz22: bets $0.10
PlayTheBlues4U: calls $0.10
BATHMEDIC: folds
*** TURN *** [6h 4d 5d] [2d]
asanxz22: bets $0.50
PlayTheBlues4U: calls $0.50
*** RIVER *** [6h 4d 5d 2d] [4c]
asanxz22: bets $1.40
PlayTheBlues4U: calls $1.40
*** SHOW DOWN ***
asanxz22: shows [9h 4h] (three of a kind, Fours)
PlayTheBlues4U: shows [3c Ad] (a straight, Deuce to Six)
PlayTheBlues4U collected $4.08 from pot
*** SUMMARY ***
Total pot $4.30 | Rake $0.22
Board [6h 4d 5d 2d 4c]
Seat 1: linghuchong2 (button) folded before Flop (didn't bet)
Seat 2: asanxz22 (small blind) showed [9h 4h] and lost with three of a kind, Fours
Seat 3: PlayTheBlues4U (big blind) showed [3c Ad] and won ($4.08) with a straight, Deuce to Six
Seat 5: rope-a-dope8 folded before Flop (didn't bet)
Seat 6: BATHMEDIC folded on the Flop


PokerStars Hand #205377947390:  Hold'em No Limit ($0.05/$0.10 USD) - 2019/11/02 22:12:12 ET
Table 'Antares' 6-max Seat #4 is the button
Seat 1: TonyA747 ($11.14 in chips)
Seat 2: PlayTheBlues4U ($13.70 in chips)
Seat 4: rope-a-dope8 ($15.24 in chips)
Seat 5: Jariso13 ($14.03 in chips)
Jariso13: posts small blind $0.05
TonyA747: posts big blind $0.10
StickyChipss: sits out
*** HOLE CARDS ***
Dealt to PlayTheBlues4U [2h 2c]
PlayTheBlues4U: calls $0.10
rope-a-dope8: raises $0.35 to $0.45
Jariso13: folds
TonyA747: calls $0.35
PlayTheBlues4U: calls $0.35
*** FLOP *** [Jc 3d 7d]
TonyA747: checks
PlayTheBlues4U: checks
rope-a-dope8: bets $1.33
TonyA747: calls $1.33
PlayTheBlues4U: folds
*** TURN *** [Jc 3d 7d] [Ks]
TonyA747: checks
rope-a-dope8: bets $1.93
TonyA747: folds
Uncalled bet ($1.93) returned to rope-a-dope8
rope-a-dope8 collected $3.86 from pot
rope-a-dope8: doesn't show hand
*** SUMMARY ***
Total pot $4.06 | Rake $0.20
Board [Jc 3d 7d Ks]
Seat 1: TonyA747 (big blind) folded on the Turn
Seat 2: PlayTheBlues4U folded on the Flop
Seat 4: rope-a-dope8 (button) collected ($3.86)
Seat 5: Jariso13 (small blind) folded before Flop


PokerStars Hand #205377947371:  Hold'em No Limit ($0.05/$0.10 USD) - 2019/11/02 22:12:08 ET
Table 'Hekate' 6-max Seat #6 is the button
Seat 1: linghuchong2 ($6.89 in chips)
Seat 2: asanxz22 ($12 in chips)
Seat 3: PlayTheBlues4U ($16.76 in chips)
Seat 5: rope-a-dope8 ($10.58 in chips)
Seat 6: BATHMEDIC ($5.87 in chips)
linghuchong2: posts small blind $0.05
asanxz22: posts big blind $0.10
*** HOLE CARDS ***
Dealt to PlayTheBlues4U [3h 3s]
PlayTheBlues4U: calls $0.10
boxerpupp727 was removed from the table for failing to post
boxerpupp727 leaves the table
rope-a-dope8: raises $0.35 to $0.45
BATHMEDIC: folds
linghuchong2: calls $0.40
asanxz22: folds
PlayTheBlues4U: calls $0.35
*** FLOP *** [Js 8c Qh]
linghuchong2: bets $0.70
PlayTheBlues4U: folds
rope-a-dope8: folds
Uncalled bet ($0.70) returned to linghuchong2
linghuchong2 collected $1.38 from pot
linghuchong2: doesn't show hand
*** SUMMARY ***
Total pot $1.45 | Rake $0.07
Board [Js 8c Qh]
Seat 1: linghuchong2 (small blind) collected ($1.38)
Seat 2: asanxz22 (big blind) folded before Flop
Seat 3: PlayTheBlues4U folded on the Flop
Seat 5: rope-a-dope8 folded on the Flop
Seat 6: BATHMEDIC (button) folded before Flop (didn't bet)


PokerStars Hand #205377947309:  Hold'em No Limit ($0.05/$0.10 USD) - 2019/11/02 22:11:54 ET
Table 'Hekate' 6-max Seat #5 is the button
Seat 1: linghuchong2 ($6.99 in chips)
Seat 2: asanxz22 ($12 in chips)
Seat 3: PlayTheBlues4U ($16.76 in chips)
Seat 5: rope-a-dope8 ($10.58 in chips)
Seat 6: BATHMEDIC ($5.77 in chips)
BATHMEDIC: posts small blind $0.05
linghuchong2: posts big blind $0.10
*** HOLE CARDS ***
Dealt to PlayTheBlues4U [6d 4h]
asanxz22: folds
PlayTheBlues4U: folds
rope-a-dope8: folds
BATHMEDIC: raises $0.10 to $0.20
linghuchong2: folds
Uncalled bet ($0.10) returned to BATHMEDIC
BATHMEDIC collected $0.20 from pot
*** SUMMARY ***
Total pot $0.20 | Rake $0
Seat 1: linghuchong2 (big blind) folded before Flop
Seat 2: asanxz22 folded before Flop (didn't bet)
Seat 3: PlayTheBlues4U folded before Flop (didn't bet)
Seat 5: rope-a-dope8 (button) folded before Flop (didn't bet)
Seat 6: BATHMEDIC (small blind) collected ($0.20)


PokerStars Hand #205377947173:  Hold'em No Limit ($0.05/$0.10 USD) - 2019/11/02 22:11:23 ET
Table 'Antares' 6-max Seat #2 is the button
Seat 1: TonyA747 ($12.74 in chips)
Seat 2: PlayTheBlues4U ($13.70 in chips)
Seat 4: rope-a-dope8 ($15.29 in chips)
Seat 5: Jariso13 ($12.54 in chips)
rope-a-dope8: posts small blind $0.05
Jariso13: posts big blind $0.10
*** HOLE CARDS ***
Dealt to PlayTheBlues4U [9c Qh]
TonyA747: calls $0.10
PlayTheBlues4U: folds
rope-a-dope8: folds
Jariso13: checks
*** FLOP *** [3d 5d Js]
Jariso13: bets $0.20
TonyA747: calls $0.20
*** TURN *** [3d 5d Js] [Th]
Jariso13: bets $0.50
TonyA747: calls $0.50
*** RIVER *** [3d 5d Js Th] [6s]
Jariso13: checks
TonyA747: bets $0.80
Jariso13: calls $0.80
*** SHOW DOWN ***
TonyA747: shows [Qs 8s] (high card Queen)
Jariso13: shows [Ah Jd] (a pair of Jacks)
Jariso13 collected $3.09 from pot
*** SUMMARY ***
Total pot $3.25 | Rake $0.16
Board [3d 5d Js Th 6s]
Seat 1: TonyA747 showed [Qs 8s] and lost with high card Queen
Seat 2: PlayTheBlues4U (button) folded before Flop (didn't bet)
Seat 4: rope-a-dope8 (small blind) folded before Flop
Seat 5: Jariso13 (big blind) showed [Ah Jd] and won ($3.09) with a pair of Jacks


PokerStars Hand #205377947087:  Hold'em No Limit ($0.05/$0.10 USD) - 2019/11/02 22:11:03 ET
Table 'Hekate' 6-max Seat #3 is the button
Seat 1: linghuchong2 ($7.09 in chips)
Seat 2: asanxz22 ($12 in chips)
Seat 3: PlayTheBlues4U ($17.66 in chips)
Seat 5: rope-a-dope8 ($10.63 in chips)
Seat 6: BATHMEDIC ($4.82 in chips)
rope-a-dope8: posts small blind $0.05
BATHMEDIC: posts big blind $0.10
*** HOLE CARDS ***
Dealt to PlayTheBlues4U [Ks Ac]
linghuchong2: calls $0.10
asanxz22: folds
PlayTheBlues4U: raises $0.30 to $0.40
rope-a-dope8: folds
BATHMEDIC: calls $0.30
linghuchong2: folds
*** FLOP *** [Th 4c 7s]
BATHMEDIC: checks
PlayTheBlues4U: bets $0.50
BATHMEDIC: raises $0.80 to $1.30
PlayTheBlues4U: folds
Uncalled bet ($0.80) returned to BATHMEDIC
BATHMEDIC collected $1.85 from pot
*** SUMMARY ***
Total pot $1.95 | Rake $0.10
Board [Th 4c 7s]
Seat 1: linghuchong2 folded before Flop
Seat 2: asanxz22 folded before Flop (didn't bet)
Seat 3: PlayTheBlues4U (button) folded on the Flop
Seat 5: rope-a-dope8 (small blind) folded before Flop
Seat 6: BATHMEDIC (big blind) collected ($1.85)


PokerStars Hand #205377947044:  Hold'em No Limit ($0.05/$0.10 USD) - 2019/11/02 22:10:52 ET
Table 'Antares' 6-max Seat #1 is the button
Seat 1: TonyA747 ($12.33 in chips)
Seat 2: PlayTheBlues4U ($13.75 in chips)
Seat 4: rope-a-dope8 ($15.39 in chips)
Seat 5: Jariso13 ($12.84 in chips)
PlayTheBlues4U: posts small blind $0.05
rope-a-dope8: posts big blind $0.10
*** HOLE CARDS ***
Dealt to PlayTheBlues4U [Kc 5s]
Jariso13: raises $0.20 to $0.30
TonyA747: calls $0.30
PlayTheBlues4U: folds
rope-a-dope8: folds
*** FLOP *** [4d Qd 6d]
Jariso13: checks
TonyA747: bets $0.70
Jariso13: folds
Uncalled bet ($0.70) returned to TonyA747
TonyA747 collected $0.71 from pot
TonyA747: doesn't show hand
*** SUMMARY ***
Total pot $0.75 | Rake $0.04
Board [4d Qd 6d]
Seat 1: TonyA747 (button) collected ($0.71)
Seat 2: PlayTheBlues4U (small blind) folded before Flop
Seat 4: rope-a-dope8 (big blind) folded before Flop
Seat 5: Jariso13 folded on the Flop


PokerStars Hand #205377946929:  Hold'em No Limit ($0.05/$0.10 USD) - 2019/11/02 22:10:24 ET
Table 'Antares' 6-max Seat #5 is the button
Seat 1: TonyA747 ($12.24 in chips)
Seat 2: PlayTheBlues4U ($13.85 in chips)
Seat 4: rope-a-dope8 ($15.39 in chips)
Seat 5: Jariso13 ($12.84 in chips)
TonyA747: posts small blind $0.05
PlayTheBlues4U: posts big blind $0.10
*** HOLE CARDS ***
Dealt to PlayTheBlues4U [2c 4c]
rope-a-dope8: folds
Jariso13: folds
TonyA747: calls $0.05
PlayTheBlues4U: checks
*** FLOP *** [5c Qs 6h]
TonyA747: checks
PlayTheBlues4U: checks
*** TURN *** [5c Qs 6h] [4d]
TonyA747: bets $0.10
PlayTheBlues4U: folds
Uncalled bet ($0.10) returned to TonyA747
TonyA747 collected $0.19 from pot
TonyA747: doesn't show hand
*** SUMMARY ***
Total pot $0.20 | Rake $0.01
Board [5c Qs 6h 4d]
Seat 1: TonyA747 (small blind) collected ($0.19)
Seat 2: PlayTheBlues4U (big blind) folded on the Turn
Seat 4: rope-a-dope8 folded before Flop (didn't bet)
Seat 5: Jariso13 (button) folded before Flop (didn't bet)


PokerStars Hand #205377946770:  Hold'em No Limit ($0.05/$0.10 USD) - 2019/11/02 22:09:45 ET
Table 'Hekate' 6-max Seat #2 is the button
Seat 1: linghuchong2 ($7.09 in chips)
Seat 2: asanxz22 ($12 in chips)
Seat 3: PlayTheBlues4U ($18.36 in chips)
Seat 5: rope-a-dope8 ($10 in chips)
Seat 6: BATHMEDIC ($4.82 in chips)
PlayTheBlues4U: posts small blind $0.05
rope-a-dope8: posts big blind $0.10
*** HOLE CARDS ***
Dealt to PlayTheBlues4U [9h 9d]
BATHMEDIC: folds
linghuchong2: folds
asanxz22: folds
PlayTheBlues4U: raises $0.20 to $0.30
rope-a-dope8: raises $0.40 to $0.70
PlayTheBlues4U: calls $0.40
*** FLOP *** [3h 6h Ad]
PlayTheBlues4U: checks
rope-a-dope8: checks
*** TURN *** [3h 6h Ad] [Qc]
PlayTheBlues4U: checks
rope-a-dope8: checks
*** RIVER *** [3h 6h Ad Qc] [Jd]
PlayTheBlues4U: checks
rope-a-dope8: bets $1.33
PlayTheBlues4U: folds
Uncalled bet ($1.33) returned to rope-a-dope8
rope-a-dope8 collected $1.33 from pot
rope-a-dope8: doesn't show hand
*** SUMMARY ***
Total pot $1.40 | Rake $0.07
Board [3h 6h Ad Qc Jd]
Seat 1: linghuchong2 folded before Flop (didn't bet)
Seat 2: asanxz22 (button) folded before Flop (didn't bet)
Seat 3: PlayTheBlues4U (small blind) folded on the River
Seat 5: rope-a-dope8 (big blind) collected ($1.33)
Seat 6: BATHMEDIC folded before Flop (didn't bet)


PokerStars Hand #205377946590:  Hold'em No Limit ($0.05/$0.10 USD) - 2019/11/02 22:09:03 ET
Table 'Antares' 6-max Seat #4 is the button
Seat 1: TonyA747 ($12.24 in chips)
Seat 2: PlayTheBlues4U ($13.85 in chips)
Seat 4: rope-a-dope8 ($16.12 in chips)
Seat 5: Jariso13 ($12.09 in chips)
Seat 6: sins07 ($12.39 in chips)
Jariso13: posts small blind $0.05
sins07: posts big blind $0.10
*** HOLE CARDS ***
Dealt to PlayTheBlues4U [6h 5d]
TonyA747: folds
PlayTheBlues4U: folds
rope-a-dope8: raises $0.25 to $0.35
Jariso13: calls $0.30
sins07: folds
*** FLOP *** [4s 2h 8c]
Jariso13: checks
sins07 leaves the table
rope-a-dope8: bets $0.38
Jariso13: calls $0.38
*** TURN *** [4s 2h 8c] [Jd]
Jariso13: bets $0.70
rope-a-dope8: folds
Uncalled bet ($0.70) returned to Jariso13
Jariso13 collected $1.48 from pot
Jariso13: doesn't show hand
*** SUMMARY ***
Total pot $1.56 | Rake $0.08
Board [4s 2h 8c Jd]
Seat 1: TonyA747 folded before Flop (didn't bet)
Seat 2: PlayTheBlues4U folded before Flop (didn't bet)
Seat 4: rope-a-dope8 (button) folded on the Turn
Seat 5: Jariso13 (small blind) collected ($1.48)
Seat 6: sins07 (big blind) folded before Flop


PokerStars Hand #205377946448:  Hold'em No Limit ($0.05/$0.10 USD) - 2019/11/02 22:08:28 ET
Table 'Antares' 6-max Seat #2 is the button
Seat 1: TonyA747 ($12.54 in chips)
Seat 2: PlayTheBlues4U ($13.85 in chips)
Seat 4: rope-a-dope8 ($16.17 in chips)
Seat 5: Jariso13 ($12.19 in chips)
Seat 6: sins07 ($11.98 in chips)
rope-a-dope8: posts small blind $0.05
Jariso13: posts big blind $0.10
*** HOLE CARDS ***
Dealt to PlayTheBlues4U [7c Qh]
sins07: raises $0.20 to $0.30
TonyA747: calls $0.30
PlayTheBlues4U: folds
rope-a-dope8: folds
Jariso13: folds
*** FLOP *** [As 3c Kd]
sins07: bets $0.50
TonyA747: folds
Uncalled bet ($0.50) returned to sins07
sins07 collected $0.71 from pot
sins07: doesn't show hand
*** SUMMARY ***
Total pot $0.75 | Rake $0.04
Board [As 3c Kd]
Seat 1: TonyA747 folded on the Flop
Seat 2: PlayTheBlues4U (button) folded before Flop (didn't bet)
Seat 4: rope-a-dope8 (small blind) folded before Flop
Seat 5: Jariso13 (big blind) folded before Flop
Seat 6: sins07 collected ($0.71)


PokerStars Hand #205377946389:  Hold'em No Limit ($0.05/$0.10 USD) - 2019/11/02 22:08:15 ET
Table 'Hekate' 6-max Seat #1 is the button
Seat 1: linghuchong2 ($7.09 in chips)
Seat 2: asanxz22 ($12.05 in chips)
Seat 3: PlayTheBlues4U ($9.64 in chips)
Seat 5: rope-a-dope8 ($10 in chips)
Seat 6: BATHMEDIC ($4.82 in chips)
asanxz22: posts small blind $0.05
PlayTheBlues4U: posts big blind $0.10
*** HOLE CARDS ***
Dealt to PlayTheBlues4U [Qh Qc]
rope-a-dope8: raises $0.25 to $0.35
BATHMEDIC: folds
linghuchong2: folds
asanxz22: folds
PlayTheBlues4U: raises $0.55 to $0.90
rope-a-dope8: raises $1.85 to $2.75
PlayTheBlues4U: raises $2.75 to $5.50
rope-a-dope8: calls $2.75
*** FLOP *** [4s 6c 7c]
PlayTheBlues4U: bets $4.14 and is all-in
rope-a-dope8: calls $4.14
*** TURN *** [4s 6c 7c] [Kd]
*** RIVER *** [4s 6c 7c Kd] [2s]
*** SHOW DOWN ***
PlayTheBlues4U: shows [Qh Qc] (a pair of Queens)
rope-a-dope8: shows [Ac Js] (high card Ace)
PlayTheBlues4U collected $18.36 from pot
*** SUMMARY ***
Total pot $19.33 | Rake $0.97
Board [4s 6c 7c Kd 2s]
Seat 1: linghuchong2 (button) folded before Flop (didn't bet)
Seat 2: asanxz22 (small blind) folded before Flop
Seat 3: PlayTheBlues4U (big blind) showed [Qh Qc] and won ($18.36) with a pair of Queens
Seat 5: rope-a-dope8 showed [Ac Js] and lost with high card Ace
Seat 6: BATHMEDIC folded before Flop (didn't bet)


PokerStars Hand #205377946251:  Hold'em No Limit ($0.05/$0.10 USD) - 2019/11/02 22:07:41 ET
Table 'Antares' 6-max Seat #1 is the button
Seat 1: TonyA747 ($12.26 in chips)
Seat 2: PlayTheBlues4U ($13.95 in chips)
Seat 4: rope-a-dope8 ($16.27 in chips)
Seat 5: Jariso13 ($12.19 in chips)
Seat 6: sins07 ($12.08 in chips)
PlayTheBlues4U: posts small blind $0.05
rope-a-dope8: posts big blind $0.10
*** HOLE CARDS ***
Dealt to PlayTheBlues4U [8d 3d]
Jariso13: folds
sins07: calls $0.10
TonyA747: calls $0.10
PlayTheBlues4U: calls $0.05
rope-a-dope8: checks
*** FLOP *** [Ah Js 9s]
PlayTheBlues4U: checks
rope-a-dope8: checks
sins07: checks
TonyA747: bets $0.40
PlayTheBlues4U: folds
rope-a-dope8: folds
sins07: folds
Uncalled bet ($0.40) returned to TonyA747
TonyA747 collected $0.38 from pot
TonyA747: doesn't show hand
*** SUMMARY ***
Total pot $0.40 | Rake $0.02
Board [Ah Js 9s]
Seat 1: TonyA747 (button) collected ($0.38)
Seat 2: PlayTheBlues4U (small blind) folded on the Flop
Seat 4: rope-a-dope8 (big blind) folded on the Flop
Seat 5: Jariso13 folded before Flop (didn't bet)
Seat 6: sins07 folded on the Flop


PokerStars Hand #205377946231:  Hold'em No Limit ($0.05/$0.10 USD) - 2019/11/02 22:07:35 ET
Table 'Hekate' 6-max Seat #6 is the button
Seat 1: linghuchong2 ($7.19 in chips)
Seat 2: asanxz22 ($11.96 in chips)
Seat 3: PlayTheBlues4U ($9.64 in chips)
Seat 5: rope-a-dope8 ($10 in chips)
Seat 6: BATHMEDIC ($4.82 in chips)
linghuchong2: posts small blind $0.05
asanxz22: posts big blind $0.10
*** HOLE CARDS ***
Dealt to PlayTheBlues4U [Tc Jc]
PlayTheBlues4U: folds
rope-a-dope8: folds
BATHMEDIC: folds
linghuchong2: calls $0.05
asanxz22: checks
*** FLOP *** [2s Td 4s]
linghuchong2: checks
asanxz22: checks
*** TURN *** [2s Td 4s] [Ad]
linghuchong2: checks
asanxz22: checks
*** RIVER *** [2s Td 4s Ad] [4c]
linghuchong2: checks
asanxz22: checks
*** SHOW DOWN ***
linghuchong2: shows [9c Qc] (a pair of Fours)
asanxz22: shows [2d 8h] (two pair, Fours and Deuces)
asanxz22 collected $0.19 from pot
*** SUMMARY ***
Total pot $0.20 | Rake $0.01
Board [2s Td 4s Ad 4c]
Seat 1: linghuchong2 (small blind) showed [9c Qc] and lost with a pair of Fours
Seat 2: asanxz22 (big blind) showed [2d 8h] and won ($0.19) with two pair, Fours and Deuces
Seat 3: PlayTheBlues4U folded before Flop (didn't bet)
Seat 5: rope-a-dope8 folded before Flop (didn't bet)
Seat 6: BATHMEDIC (button) folded before Flop (didn't bet)


PokerStars Hand #205377946120:  Hold'em No Limit ($0.05/$0.10 USD) - 2019/11/02 22:07:07 ET
Table 'Antares' 6-max Seat #6 is the button
Seat 1: TonyA747 ($12.61 in chips)
Seat 2: PlayTheBlues4U ($14.05 in chips)
Seat 3: StickyChipss ($10 in chips)
Seat 4: rope-a-dope8 ($15.86 in chips)
Seat 5: Jariso13 ($12.19 in chips)
Seat 6: sins07 ($12.08 in chips)
TonyA747: posts small blind $0.05
PlayTheBlues4U: posts big blind $0.10
*** HOLE CARDS ***
Dealt to PlayTheBlues4U [3c 9d]
StickyChipss: folds
rope-a-dope8: raises $0.25 to $0.35
Jariso13: folds
sins07: folds
TonyA747: calls $0.30
PlayTheBlues4U: folds
*** FLOP *** [Qs 5c 3d]
TonyA747: checks
rope-a-dope8: bets $0.38
TonyA747: folds
Uncalled bet ($0.38) returned to rope-a-dope8
rope-a-dope8 collected $0.76 from pot
rope-a-dope8: doesn't show hand
*** SUMMARY ***
Total pot $0.80 | Rake $0.04
Board [Qs 5c 3d]
Seat 1: TonyA747 (small blind) folded on the Flop
Seat 2: PlayTheBlues4U (big blind) folded before Flop
Seat 3: StickyChipss folded before Flop (didn't bet)
Seat 4: rope-a-dope8 collected ($0.76)
Seat 5: Jariso13 folded before Flop (didn't bet)
Seat 6: sins07 (button) folded before Flop (didn't bet)


PokerStars Hand #205377946072:  Hold'em No Limit ($0.05/$0.10 USD) - 2019/11/02 22:06:57 ET
Table 'Hekate' 6-max Seat #5 is the button
Seat 1: linghuchong2 ($7.59 in chips)
Seat 2: asanxz22 ($11.50 in chips)
Seat 3: PlayTheBlues4U ($9.64 in chips)
Seat 5: rope-a-dope8 ($10 in chips)
Seat 6: BATHMEDIC ($4.92 in chips)
BATHMEDIC: posts small blind $0.05
linghuchong2: posts big blind $0.10
*** HOLE CARDS ***
Dealt to PlayTheBlues4U [Td 4h]
asanxz22: calls $0.10
PlayTheBlues4U: folds
rope-a-dope8: folds
BATHMEDIC: calls $0.05
linghuchong2: checks
*** FLOP *** [6d As 9c]
BATHMEDIC: checks
linghuchong2: checks
asanxz22: bets $0.10
BATHMEDIC: folds
linghuchong2: calls $0.10
*** TURN *** [6d As 9c] [2d]
linghuchong2: checks
asanxz22: bets $0.20
linghuchong2: calls $0.20
*** RIVER *** [6d As 9c 2d] [7h]
linghuchong2: checks
asanxz22: bets $0.90
linghuchong2: folds
Uncalled bet ($0.90) returned to asanxz22
asanxz22 collected $0.86 from pot
asanxz22: doesn't show hand
*** SUMMARY ***
Total pot $0.90 | Rake $0.04
Board [6d As 9c 2d 7h]
Seat 1: linghuchong2 (big blind) folded on the River
Seat 2: asanxz22 collected ($0.86)
Seat 3: PlayTheBlues4U folded before Flop (didn't bet)
Seat 5: rope-a-dope8 (button) folded before Flop (didn't bet)
Seat 6: BATHMEDIC (small blind) folded on the Flop


PokerStars Hand #205377945923:  Hold'em No Limit ($0.05/$0.10 USD) - 2019/11/02 22:06:15 ET
Table 'Antares' 6-max Seat #5 is the button
Seat 1: TonyA747 ($12.05 in chips)
Seat 2: PlayTheBlues4U ($14.05 in chips)
Seat 3: StickyChipss ($10.17 in chips)
Seat 4: rope-a-dope8 ($15.86 in chips)
Seat 5: Jariso13 ($12.19 in chips)
Seat 6: sins07 ($12.38 in chips)
sins07: posts small blind $0.05
TonyA747: posts big blind $0.10
*** HOLE CARDS ***
Dealt to PlayTheBlues4U [Jh Qs]
PlayTheBlues4U: folds
StickyChipss: raises $0.20 to $0.30
rope-a-dope8: folds
Jariso13: folds
sins07: calls $0.25
TonyA747: calls $0.20
*** FLOP *** [Tc 9s 2s]
sins07: checks
TonyA747: checks
StickyChipss: checks
*** TURN *** [Tc 9s 2s] [2c]
sins07: checks
TonyA747: checks
StickyChipss: checks
*** RIVER *** [Tc 9s 2s 2c] [Qd]
sins07: checks
TonyA747: bets $0.90
StickyChipss: folds
sins07: folds
Uncalled bet ($0.90) returned to TonyA747
TonyA747 collected $0.86 from pot
TonyA747: doesn't show hand
*** SUMMARY ***
Total pot $0.90 | Rake $0.04
Board [Tc 9s 2s 2c Qd]
Seat 1: TonyA747 (big blind) collected ($0.86)
Seat 2: PlayTheBlues4U folded before Flop (didn't bet)
Seat 3: StickyChipss folded on the River
Seat 4: rope-a-dope8 folded before Flop (didn't bet)
Seat 5: Jariso13 (button) folded before Flop (didn't bet)
Seat 6: sins07 (small blind) folded on the River


PokerStars Hand #205377945813:  Hold'em No Limit ($0.05/$0.10 USD) - 2019/11/02 22:05:50 ET
Table 'Antares' 6-max Seat #4 is the button
Seat 1: TonyA747 ($12.05 in chips)
Seat 2: PlayTheBlues4U ($14.05 in chips)
Seat 3: StickyChipss ($10.17 in chips)
Seat 4: rope-a-dope8 ($15.86 in chips)
Seat 5: Jariso13 ($12.24 in chips)
Seat 6: sins07 ($12.33 in chips)
Jariso13: posts small blind $0.05
sins07: posts big blind $0.10
*** HOLE CARDS ***
Dealt to PlayTheBlues4U [2c 6d]
TonyA747: folds
PlayTheBlues4U: folds
StickyChipss: folds
rope-a-dope8: folds
Jariso13: folds
Uncalled bet ($0.05) returned to sins07
sins07 collected $0.10 from pot
sins07: doesn't show hand
*** SUMMARY ***
Total pot $0.10 | Rake $0
Seat 1: TonyA747 folded before Flop (didn't bet)
Seat 2: PlayTheBlues4U folded before Flop (didn't bet)
Seat 3: StickyChipss folded before Flop (didn't bet)
Seat 4: rope-a-dope8 (button) folded before Flop (didn't bet)
Seat 5: Jariso13 (small blind) folded before Flop
Seat 6: sins07 (big blind) collected ($0.10)


PokerStars Hand #205377945775:  Hold'em No Limit ($0.05/$0.10 USD) - 2019/11/02 22:05:41 ET
Table 'Hekate' 6-max Seat #3 is the button
Seat 1: linghuchong2 ($7.69 in chips)
Seat 2: asanxz22 ($10 in chips)
Seat 3: PlayTheBlues4U ($9.64 in chips)
Seat 5: rope-a-dope8 ($10.14 in chips)
Seat 6: BATHMEDIC ($5.02 in chips)
rope-a-dope8: posts small blind $0.05
BATHMEDIC: posts big blind $0.10
asanxz22: posts big blind $0.10
*** HOLE CARDS ***
Dealt to PlayTheBlues4U [4h 3d]
linghuchong2: calls $0.10
asanxz22: checks
PlayTheBlues4U: folds
rope-a-dope8: raises $0.60 to $0.70
BATHMEDIC: folds
linghuchong2: folds
asanxz22: calls $0.60
*** FLOP *** [3c 7h 5c]
rope-a-dope8: bets $0.76
asanxz22: calls $0.76
*** TURN *** [3c 7h 5c] [Jc]
rope-a-dope8: checks
asanxz22: checks
*** RIVER *** [3c 7h 5c Jc] [3h]
rope-a-dope8: checks
asanxz22: checks
*** SHOW DOWN ***
rope-a-dope8: shows [Ah Ks] (a pair of Threes)
asanxz22: shows [2c 2s] (two pair, Threes and Deuces)
asanxz22 collected $2.96 from pot
*** SUMMARY ***
Total pot $3.12 | Rake $0.16
Board [3c 7h 5c Jc 3h]
Seat 1: linghuchong2 folded before Flop
Seat 2: asanxz22 showed [2c 2s] and won ($2.96) with two pair, Threes and Deuces
Seat 3: PlayTheBlues4U (button) folded before Flop (didn't bet)
Seat 5: rope-a-dope8 (small blind) showed [Ah Ks] and lost with a pair of Threes
Seat 6: BATHMEDIC (big blind) folded before Flop


PokerStars Hand #205377945749:  Hold'em No Limit ($0.05/$0.10 USD) - 2019/11/02 22:05:35 ET
Table 'Antares' 6-max Seat #3 is the button
Seat 1: TonyA747 ($12.05 in chips)
Seat 2: PlayTheBlues4U ($14.05 in chips)
Seat 3: StickyChipss ($10.17 in chips)
Seat 4: rope-a-dope8 ($15.76 in chips)
Seat 5: Jariso13 ($12.34 in chips)
Seat 6: sins07 ($12.33 in chips)
rope-a-dope8: posts small blind $0.05
Jariso13: posts big blind $0.10
*** HOLE CARDS ***
Dealt to PlayTheBlues4U [Qh Tc]
sins07: folds
TonyA747: folds
PlayTheBlues4U: folds
StickyChipss: folds
rope-a-dope8: raises $0.20 to $0.30
Jariso13: folds
Uncalled bet ($0.20) returned to rope-a-dope8
rope-a-dope8 collected $0.20 from pot
rope-a-dope8: doesn't show hand
*** SUMMARY ***
Total pot $0.20 | Rake $0
Seat 1: TonyA747 folded before Flop (didn't bet)
Seat 2: PlayTheBlues4U folded before Flop (didn't bet)
Seat 3: StickyChipss (button) folded before Flop (didn't bet)
Seat 4: rope-a-dope8 (small blind) collected ($0.20)
Seat 5: Jariso13 (big blind) folded before Flop
Seat 6: sins07 folded before Flop (didn't bet)


PokerStars Hand #205377945584:  Hold'em No Limit ($0.05/$0.10 USD) - 2019/11/02 22:04:54 ET
Table 'Hekate' 6-max Seat #1 is the button
Seat 1: linghuchong2 ($7.69 in chips)
Seat 3: PlayTheBlues4U ($9.69 in chips)
Seat 5: rope-a-dope8 ($10 in chips)
Seat 6: BATHMEDIC ($5.12 in chips)
PlayTheBlues4U: posts small blind $0.05
rope-a-dope8: posts big blind $0.10
*** HOLE CARDS ***
Dealt to PlayTheBlues4U [3c Qs]
BATHMEDIC: calls $0.10
linghuchong2: folds
PlayTheBlues4U: folds
rope-a-dope8: checks
*** FLOP *** [2d 8h Jh]
rope-a-dope8: bets $0.12
asanxz22 joins the table at seat #2
BATHMEDIC: folds
Uncalled bet ($0.12) returned to rope-a-dope8
rope-a-dope8 collected $0.24 from pot
rope-a-dope8: doesn't show hand
*** SUMMARY ***
Total pot $0.25 | Rake $0.01
Board [2d 8h Jh]
Seat 1: linghuchong2 (button) folded before Flop (didn't bet)
Seat 3: PlayTheBlues4U (small blind) folded before Flop
Seat 5: rope-a-dope8 (big blind) collected ($0.24)
Seat 6: BATHMEDIC folded on the Flop


PokerStars Hand #205377945562:  Hold'em No Limit ($0.05/$0.10 USD) - 2019/11/02 22:04:49 ET
Table 'Antares' 6-max Seat #2 is the button
Seat 1: TonyA747 ($10 in chips)
Seat 2: PlayTheBlues4U ($14.05 in chips)
Seat 3: StickyChipss ($10.22 in chips)
Seat 4: rope-a-dope8 ($17.51 in chips)
Seat 5: Jariso13 ($12.34 in chips)
Seat 6: sins07 ($12.78 in chips)
StickyChipss: posts small blind $0.05
rope-a-dope8: posts big blind $0.10
TonyA747: posts big blind $0.10
*** HOLE CARDS ***
Dealt to PlayTheBlues4U [As 7h]
Jariso13: folds
sins07: calls $0.10
TonyA747: raises $0.35 to $0.45
PlayTheBlues4U: folds
StickyChipss: folds
rope-a-dope8: calls $0.35
sins07: calls $0.35
*** FLOP *** [3h 2s Kd]
rope-a-dope8: checks
sins07: checks
TonyA747: bets $1.30
rope-a-dope8: calls $1.30
sins07: folds
*** TURN *** [3h 2s Kd] [2c]
rope-a-dope8: checks
TonyA747: bets $8.25 and is all-in
rope-a-dope8: folds
Uncalled bet ($8.25) returned to TonyA747
TonyA747 collected $3.80 from pot
TonyA747: doesn't show hand
*** SUMMARY ***
Total pot $4 | Rake $0.20
Board [3h 2s Kd 2c]
Seat 1: TonyA747 collected ($3.80)
Seat 2: PlayTheBlues4U (button) folded before Flop (didn't bet)
Seat 3: StickyChipss (small blind) folded before Flop
Seat 4: rope-a-dope8 (big blind) folded on the Turn
Seat 5: Jariso13 folded before Flop (didn't bet)
Seat 6: sins07 folded on the Flop


PokerStars Hand #205377945475:  Hold'em No Limit ($0.05/$0.10 USD) - 2019/11/02 22:04:27 ET
Table 'Hekate' 6-max Seat #6 is the button
Seat 1: linghuchong2 ($7.74 in chips)
Seat 3: PlayTheBlues4U ($9.79 in chips)
Seat 5: rope-a-dope8 ($10 in chips)
Seat 6: BATHMEDIC ($4.98 in chips)
linghuchong2: posts small blind $0.05
PlayTheBlues4U: posts big blind $0.10
*** HOLE CARDS ***
Dealt to PlayTheBlues4U [Jc 3s]
rope-a-dope8: folds
BATHMEDIC: calls $0.10
linghuchong2: folds
PlayTheBlues4U: checks
*** FLOP *** [Ks 9d 5s]
PlayTheBlues4U: checks
BATHMEDIC: checks
*** TURN *** [Ks 9d 5s] [2d]
PlayTheBlues4U: checks
BATHMEDIC: checks
*** RIVER *** [Ks 9d 5s 2d] [Qh]
PlayTheBlues4U: checks
BATHMEDIC: bets $0.24
PlayTheBlues4U: folds
Uncalled bet ($0.24) returned to BATHMEDIC
BATHMEDIC collected $0.24 from pot
*** SUMMARY ***
Total pot $0.25 | Rake $0.01
Board [Ks 9d 5s 2d Qh]
Seat 1: linghuchong2 (small blind) folded before Flop
Seat 3: PlayTheBlues4U (big blind) folded on the River
Seat 5: rope-a-dope8 folded before Flop (didn't bet)
Seat 6: BATHMEDIC (button) collected ($0.24)


PokerStars Hand #205377945467:  Hold'em No Limit ($0.05/$0.10 USD) - 2019/11/02 22:04:24 ET
Table 'Antares' 6-max Seat #6 is the button
Seat 2: PlayTheBlues4U ($13.85 in chips)
Seat 3: StickyChipss ($10.32 in chips)
Seat 4: rope-a-dope8 ($17.51 in chips)
Seat 5: Jariso13 ($12.34 in chips)
Seat 6: sins07 ($12.88 in chips)
PlayTheBlues4U: posts small blind $0.05
StickyChipss: posts big blind $0.10
*** HOLE CARDS ***
Dealt to PlayTheBlues4U [Kc Qd]
rope-a-dope8: folds
TonyA747 joins the table at seat #1
Jariso13: folds
sins07: calls $0.10
PlayTheBlues4U: raises $0.20 to $0.30
StickyChipss: folds
sins07: folds
Uncalled bet ($0.20) returned to PlayTheBlues4U
PlayTheBlues4U collected $0.30 from pot
PlayTheBlues4U: doesn't show hand
*** SUMMARY ***
Total pot $0.30 | Rake $0
Seat 2: PlayTheBlues4U (small blind) collected ($0.30)
Seat 3: StickyChipss (big blind) folded before Flop
Seat 4: rope-a-dope8 folded before Flop (didn't bet)
Seat 5: Jariso13 folded before Flop (didn't bet)
Seat 6: sins07 (button) folded before Flop


PokerStars Hand #205377945427:  Hold'em No Limit ($0.05/$0.10 USD) - 2019/11/02 22:04:15 ET
Table 'Hekate' 6-max Seat #5 is the button
Seat 1: linghuchong2 ($7.84 in chips)
Seat 3: PlayTheBlues4U ($9.79 in chips)
Seat 5: rope-a-dope8 ($10 in chips)
Seat 6: BATHMEDIC ($4.88 in chips)
BATHMEDIC: posts small blind $0.05
linghuchong2: posts big blind $0.10
*** HOLE CARDS ***
Dealt to PlayTheBlues4U [3s Th]
PlayTheBlues4U: folds
rope-a-dope8: folds
BATHMEDIC: raises $0.10 to $0.20
linghuchong2: folds
Uncalled bet ($0.10) returned to BATHMEDIC
BATHMEDIC collected $0.20 from pot
*** SUMMARY ***
Total pot $0.20 | Rake $0
Seat 1: linghuchong2 (big blind) folded before Flop
Seat 3: PlayTheBlues4U folded before Flop (didn't bet)
Seat 5: rope-a-dope8 (button) folded before Flop (didn't bet)
Seat 6: BATHMEDIC (small blind) collected ($0.20)


PokerStars Hand #205377945357:  Hold'em No Limit ($0.05/$0.10 USD) - 2019/11/02 22:03:55 ET
Table 'Antares' 6-max Seat #5 is the button
Seat 2: PlayTheBlues4U ($13.95 in chips)
Seat 3: StickyChipss ($10.32 in chips)
Seat 4: rope-a-dope8 ($17.51 in chips)
Seat 5: Jariso13 ($11.88 in chips)
Seat 6: sins07 ($13.28 in chips)
sins07: posts small blind $0.05
PlayTheBlues4U: posts big blind $0.10
*** HOLE CARDS ***
Dealt to PlayTheBlues4U [3s 4d]
StickyChipss: folds
rope-a-dope8: folds
Jariso13: calls $0.10
sins07: calls $0.05
PlayTheBlues4U: checks
*** FLOP *** [7c 6d 3d]
sins07: bets $0.10
PlayTheBlues4U: folds
Jariso13: calls $0.10
*** TURN *** [7c 6d 3d] [Tc]
sins07: bets $0.20
Jariso13: raises $0.50 to $0.70
sins07: folds
Uncalled bet ($0.50) returned to Jariso13
Jariso13 collected $0.86 from pot
Jariso13: doesn't show hand
*** SUMMARY ***
Total pot $0.90 | Rake $0.04
Board [7c 6d 3d Tc]
Seat 2: PlayTheBlues4U (big blind) folded on the Flop
Seat 3: StickyChipss folded before Flop (didn't bet)
Seat 4: rope-a-dope8 folded before Flop (didn't bet)
Seat 5: Jariso13 (button) collected ($0.86)
Seat 6: sins07 (small blind) folded on the Turn


PokerStars Hand #205377945266:  Hold'em No Limit ($0.05/$0.10 USD) - 2019/11/02 22:03:34 ET
Table 'Antares' 6-max Seat #4 is the button
Seat 2: PlayTheBlues4U ($13.95 in chips)
Seat 3: StickyChipss ($10.32 in chips)
Seat 4: rope-a-dope8 ($17.51 in chips)
Seat 5: Jariso13 ($12.18 in chips)
Seat 6: sins07 ($13.01 in chips)
Jariso13: posts small blind $0.05
sins07: posts big blind $0.10
*** HOLE CARDS ***
Dealt to PlayTheBlues4U [8c 2h]
PlayTheBlues4U: folds
StickyChipss: folds
rope-a-dope8: folds
Jariso13: calls $0.05
sins07: checks
*** FLOP *** [Th 5d 3d]
Jariso13: bets $0.20
sins07: calls $0.20
*** TURN *** [Th 5d 3d] [2c]
Jariso13: checks
sins07: checks
*** RIVER *** [Th 5d 3d 2c] [3s]
Jariso13: checks
sins07: checks
*** SHOW DOWN ***
Jariso13: shows [7c 6h] (a pair of Threes)
sins07: shows [5c 4d] (two pair, Fives and Threes)
sins07 collected $0.57 from pot
*** SUMMARY ***
Total pot $0.60 | Rake $0.03
Board [Th 5d 3d 2c 3s]
Seat 2: PlayTheBlues4U folded before Flop (didn't bet)
Seat 3: StickyChipss folded before Flop (didn't bet)
Seat 4: rope-a-dope8 (button) folded before Flop (didn't bet)
Seat 5: Jariso13 (small blind) showed [7c 6h] and lost with a pair of Threes
Seat 6: sins07 (big blind) showed [5c 4d] and won ($0.57) with two pair, Fives and Threes


PokerStars Hand #205377945225:  Hold'em No Limit ($0.05/$0.10 USD) - 2019/11/02 22:03:25 ET
Table 'Hekate' 6-max Seat #3 is the button
Seat 1: linghuchong2 ($8.84 in chips)
Seat 3: PlayTheBlues4U ($8.75 in chips)
Seat 5: rope-a-dope8 ($10 in chips)
Seat 6: BATHMEDIC ($4.98 in chips)
rope-a-dope8: posts small blind $0.05
BATHMEDIC: posts big blind $0.10
*** HOLE CARDS ***
Dealt to PlayTheBlues4U [5c 4c]
linghuchong2: raises $0.20 to $0.30
PlayTheBlues4U: calls $0.30
rope-a-dope8: folds
BATHMEDIC: folds
*** FLOP *** [Th 5d 5s]
linghuchong2: bets $0.70
PlayTheBlues4U: calls $0.70
*** TURN *** [Th 5d 5s] [8d]
linghuchong2: checks
PlayTheBlues4U: bets $1.40
asanxz22 was removed from the table for failing to post
asanxz22 leaves the table
linghuchong2: folds
Uncalled bet ($1.40) returned to PlayTheBlues4U
PlayTheBlues4U collected $2.04 from pot
PlayTheBlues4U: doesn't show hand
*** SUMMARY ***
Total pot $2.15 | Rake $0.11
Board [Th 5d 5s 8d]
Seat 1: linghuchong2 folded on the Turn
Seat 3: PlayTheBlues4U (button) collected ($2.04)
Seat 5: rope-a-dope8 (small blind) folded before Flop
Seat 6: BATHMEDIC (big blind) folded before Flop


PokerStars Hand #205377945171:  Hold'em No Limit ($0.05/$0.10 USD) - 2019/11/02 22:03:13 ET
Table 'Antares' 6-max Seat #3 is the button
Seat 2: PlayTheBlues4U ($13.95 in chips)
Seat 3: StickyChipss ($10.32 in chips)
Seat 4: rope-a-dope8 ($17.56 in chips)
Seat 5: Jariso13 ($12.58 in chips)
Seat 6: sins07 ($12.60 in chips)
rope-a-dope8: posts small blind $0.05
Jariso13: posts big blind $0.10
*** HOLE CARDS ***
Dealt to PlayTheBlues4U [6c Qc]
sins07: raises $0.30 to $0.40
PlayTheBlues4U: folds
StickyChipss: folds
rope-a-dope8: folds
Jariso13: calls $0.30
*** FLOP *** [4c 7c 9h]
Jariso13: checks
sins07: bets $0.50
Jariso13: folds
Uncalled bet ($0.50) returned to sins07
sins07 collected $0.81 from pot
sins07: doesn't show hand
*** SUMMARY ***
Total pot $0.85 | Rake $0.04
Board [4c 7c 9h]
Seat 2: PlayTheBlues4U folded before Flop (didn't bet)
Seat 3: StickyChipss (button) folded before Flop (didn't bet)
Seat 4: rope-a-dope8 (small blind) folded before Flop
Seat 5: Jariso13 (big blind) folded on the Flop
Seat 6: sins07 collected ($0.81)


PokerStars Hand #205377945056:  Hold'em No Limit ($0.05/$0.10 USD) - 2019/11/02 22:02:49 ET
Table 'Hekate' 6-max Seat #1 is the button
Seat 1: linghuchong2 ($8.84 in chips)
Seat 3: PlayTheBlues4U ($8.80 in chips)
Seat 5: rope-a-dope8 ($10 in chips)
Seat 6: BATHMEDIC ($4.75 in chips)
PlayTheBlues4U: posts small blind $0.05
rope-a-dope8: posts big blind $0.10
*** HOLE CARDS ***
Dealt to PlayTheBlues4U [7h 2c]
BATHMEDIC: calls $0.10
linghuchong2: folds
PlayTheBlues4U: folds
rope-a-dope8: checks
*** FLOP *** [6s 9c 4h]
rope-a-dope8: bets $0.10
BATHMEDIC: raises $0.30 to $0.40
rope-a-dope8: folds
Uncalled bet ($0.30) returned to BATHMEDIC
BATHMEDIC collected $0.43 from pot
*** SUMMARY ***
Total pot $0.45 | Rake $0.02
Board [6s 9c 4h]
Seat 1: linghuchong2 (button) folded before Flop (didn't bet)
Seat 3: PlayTheBlues4U (small blind) folded before Flop
Seat 5: rope-a-dope8 (big blind) folded on the Flop
Seat 6: BATHMEDIC collected ($0.43)


PokerStars Hand #205377945011:  Hold'em No Limit ($0.05/$0.10 USD) - 2019/11/02 22:02:39 ET
Table 'Antares' 6-max Seat #2 is the button
Seat 2: PlayTheBlues4U ($13.95 in chips)
Seat 3: StickyChipss ($10.37 in chips)
Seat 4: rope-a-dope8 ($17.58 in chips)
Seat 5: Jariso13 ($12.58 in chips)
Seat 6: sins07 ($12.62 in chips)
StickyChipss: posts small blind $0.05
rope-a-dope8: posts big blind $0.10
*** HOLE CARDS ***
Dealt to PlayTheBlues4U [3c 4h]
Jariso13: folds
sins07: calls $0.10
PlayTheBlues4U: folds
StickyChipss: folds
rope-a-dope8: checks
*** FLOP *** [Th Kh Ad]
rope-a-dope8: bets $0.10
sins07: raises $0.20 to $0.30
rope-a-dope8: calls $0.20
*** TURN *** [Th Kh Ad] [5s]
rope-a-dope8: checks
sins07: bets $0.20
rope-a-dope8: calls $0.20
*** RIVER *** [Th Kh Ad 5s] [Kc]
rope-a-dope8: bets $0.30
sins07: calls $0.30
*** SHOW DOWN ***
rope-a-dope8: shows [Ac 4s] (two pair, Aces and Kings)
sins07: shows [As 3d] (two pair, Aces and Kings)
rope-a-dope8 collected $0.88 from pot
sins07 collected $0.88 from pot
*** SUMMARY ***
Total pot $1.85 | Rake $0.09
Board [Th Kh Ad 5s Kc]
Seat 2: PlayTheBlues4U (button) folded before Flop (didn't bet)
Seat 3: StickyChipss (small blind) folded before Flop
Seat 4: rope-a-dope8 (big blind) showed [Ac 4s] and won ($0.88) with two pair, Aces and Kings
Seat 5: Jariso13 folded before Flop (didn't bet)
Seat 6: sins07 showed [As 3d] and won ($0.88) with two pair, Aces and Kings


PokerStars Hand #205377944902:  Hold'em No Limit ($0.05/$0.10 USD) - 2019/11/02 22:02:13 ET
Table 'Antares' 6-max Seat #6 is the button
Seat 2: PlayTheBlues4U ($14 in chips)
Seat 3: StickyChipss ($10.47 in chips)
Seat 4: rope-a-dope8 ($17.43 in chips)
Seat 5: Jariso13 ($12.58 in chips)
Seat 6: sins07 ($12.62 in chips)
PlayTheBlues4U: posts small blind $0.05
StickyChipss: posts big blind $0.10
*** HOLE CARDS ***
Dealt to PlayTheBlues4U [4h Jc]
rope-a-dope8: raises $0.20 to $0.30
Jariso13: folds
sins07: folds
PlayTheBlues4U: folds
StickyChipss: folds
Uncalled bet ($0.20) returned to rope-a-dope8
rope-a-dope8 collected $0.25 from pot
rope-a-dope8: doesn't show hand
*** SUMMARY ***
Total pot $0.25 | Rake $0
Seat 2: PlayTheBlues4U (small blind) folded before Flop
Seat 3: StickyChipss (big blind) folded before Flop
Seat 4: rope-a-dope8 collected ($0.25)
Seat 5: Jariso13 folded before Flop (didn't bet)
Seat 6: sins07 (button) folded before Flop (didn't bet)


PokerStars Hand #205377944889:  Hold'em No Limit ($0.02/$0.05 USD) - 2019/11/02 22:02:10 ET
Table 'Pisces' 6-max Seat #5 is the button
Seat 1: CMc172 ($4.70 in chips)
Seat 2: BaldEagleStar ($4.69 in chips)
Seat 3: PlayTheBlues4U ($6.04 in chips)
Seat 4: crazy turfer ($2.31 in chips)
Seat 5: peenpump240 ($5.84 in chips)
Seat 6: GTMuldoon ($4.56 in chips)
GTMuldoon: posts small blind $0.02
CMc172: posts big blind $0.05
*** HOLE CARDS ***
Dealt to PlayTheBlues4U [Qc Jh]
BaldEagleStar: calls $0.05
PlayTheBlues4U: folds
crazy turfer: folds
peenpump240: raises $0.05 to $0.10
GTMuldoon: folds
CMc172: folds
BaldEagleStar: calls $0.05
*** FLOP *** [Kd Ad Ah]
GTMuldoon leaves the table
Jariso13 joins the table at seat #6
BaldEagleStar: checks
peenpump240: bets $0.05
BaldEagleStar: folds
Uncalled bet ($0.05) returned to peenpump240
peenpump240 collected $0.26 from pot
peenpump240: doesn't show hand
*** SUMMARY ***
Total pot $0.27 | Rake $0.01
Board [Kd Ad Ah]
Seat 1: CMc172 (big blind) folded before Flop
Seat 2: BaldEagleStar folded on the Flop
Seat 3: PlayTheBlues4U folded before Flop (didn't bet)
Seat 4: crazy turfer folded before Flop (didn't bet)
Seat 5: peenpump240 (button) collected ($0.26)
Seat 6: GTMuldoon (small blind) folded before Flop


PokerStars Hand #205377944827:  Hold'em No Limit ($0.05/$0.10 USD) - 2019/11/02 22:01:55 ET
Table 'Antares' 6-max Seat #5 is the button
Seat 2: PlayTheBlues4U ($14.10 in chips)
Seat 3: StickyChipss ($10.32 in chips)
Seat 4: rope-a-dope8 ($17.43 in chips)
Seat 5: Jariso13 ($12.58 in chips)
Seat 6: sins07 ($12.67 in chips)
sins07: posts small blind $0.05
PlayTheBlues4U: posts big blind $0.10
*** HOLE CARDS ***
Dealt to PlayTheBlues4U [9c 4d]
StickyChipss: raises $0.20 to $0.30
rope-a-dope8: folds
Jariso13: folds
sins07: folds
PlayTheBlues4U: folds
Uncalled bet ($0.20) returned to StickyChipss
StickyChipss collected $0.25 from pot
*** SUMMARY ***
Total pot $0.25 | Rake $0
Seat 2: PlayTheBlues4U (big blind) folded before Flop
Seat 3: StickyChipss collected ($0.25)
Seat 4: rope-a-dope8 folded before Flop (didn't bet)
Seat 5: Jariso13 (button) folded before Flop (didn't bet)
Seat 6: sins07 (small blind) folded before Flop


PokerStars Hand #204850619409:  Hold'em No Limit ($0.05/$0.10 USD) - 2019/10/21 21:47:29 ET
Table 'Hesperia' 6-max Seat #6 is the button
Seat 1: BigBlue ($6.85 in chips) 
Seat 2: LanskyBanksy ($12.38 in chips) 
Seat 4: PlayTheBlues4U ($11.04 in chips) 
Seat 5: Klytu ($19.12 in chips) 
Seat 6: 123tiger711a ($11.04 in chips) 
BigBlue: posts small blind $0.05
LanskyBanksy: posts big blind $0.10
*** HOLE CARDS ***
Dealt to PlayTheBlues4U [6c Kd]
PlayTheBlues4U: folds 
Klytu: raises $0.20 to $0.30
123tiger711a: folds 
BigBlue: folds 
LanskyBanksy: folds 
Uncalled bet ($0.20) returned to Klytu
Klytu collected $0.25 from pot
Klytu: doesn't show hand 
*** SUMMARY ***
Total pot $0.25 | Rake $0 
Seat 1: BigBlue (small blind) folded before Flop
Seat 2: LanskyBanksy (big blind) folded before Flop
Seat 4: PlayTheBlues4U folded before Flop (didn't bet)
Seat 5: Klytu collected ($0.25)
Seat 6: 123tiger711a (button) folded before Flop (didn't bet)



PokerStars Hand #205008743974:  Hold'em No Limit ($0.05/$0.10 USD) - 2019/10/24 20:21:14 ET
Table 'Alrami' 6-max Seat #5 is the button
Seat 2: PlayTheBlues4U ($10 in chips) 
Seat 3: ZTP0 ($7.80 in chips) 
Seat 4: Poker150847 ($9.86 in chips) 
Seat 5: 123tiger711a ($10 in chips) 
Seat 6: dmg3000 ($9.53 in chips) 
dmg3000: posts small blind $0.05
PlayTheBlues4U: posts big blind $0.10
*** HOLE CARDS ***
Dealt to PlayTheBlues4U [4c Ac]
ZTP0: folds 
Poker150847: raises $0.10 to $0.20
123tiger711a: folds 
dmg3000: calls $0.15
csxwe joins the table at seat #1 
PlayTheBlues4U: calls $0.10
*** FLOP *** [Ah 6d Qh]
dmg3000: checks 
PlayTheBlues4U: bets $0.30
Poker150847: folds 
dmg3000: folds 
Uncalled bet ($0.30) returned to PlayTheBlues4U
PlayTheBlues4U collected $0.57 from pot
PlayTheBlues4U: doesn't show hand 
*** SUMMARY ***
Total pot $0.60 | Rake $0.03 
Board [Ah 6d Qh]
Seat 2: PlayTheBlues4U (big blind) collected ($0.57)
Seat 3: ZTP0 folded before Flop (didn't bet)
Seat 4: Poker150847 folded on the Flop
Seat 5: 123tiger711a (button) folded before Flop (didn't bet)
Seat 6: dmg3000 (small blind) folded on the Flop



PokerStars Hand #205008744210:  Hold'em No Limit ($0.05/$0.10 USD) - 2019/10/24 20:22:16 ET
Table 'Alrami' 6-max Seat #6 is the button
Seat 2: PlayTheBlues4U ($10.37 in chips) 
Seat 3: ZTP0 ($7.80 in chips) 
Seat 4: Poker150847 ($9.66 in chips) 
Seat 5: 123tiger711a ($10 in chips) 
Seat 6: dmg3000 ($9.33 in chips) 
PlayTheBlues4U: posts small blind $0.05
ZTP0: posts big blind $0.10
*** HOLE CARDS ***
Dealt to PlayTheBlues4U [5c 8d]
Poker150847: folds 
123tiger711a: calls $0.10
dmg3000: folds 
PlayTheBlues4U: folds 
ZTP0: checks 
*** FLOP *** [Qs 7d 2d]
ZTP0: checks 
123tiger711a: bets $0.10
ZTP0: calls $0.10
*** TURN *** [Qs 7d 2d] [9d]
ZTP0: checks 
123tiger711a: checks 
*** RIVER *** [Qs 7d 2d 9d] [Qh]
ZTP0: bets $0.43
123tiger711a: folds 
Uncalled bet ($0.43) returned to ZTP0
ZTP0 collected $0.43 from pot
ZTP0: doesn't show hand 
*** SUMMARY ***
Total pot $0.45 | Rake $0.02 
Board [Qs 7d 2d 9d Qh]
Seat 2: PlayTheBlues4U (small blind) folded before Flop
Seat 3: ZTP0 (big blind) collected ($0.43)
Seat 4: Poker150847 folded before Flop (didn't bet)
Seat 5: 123tiger711a folded on the River
Seat 6: dmg3000 (button) folded before Flop (didn't bet)



PokerStars Hand #205008744373:  Hold'em No Limit ($0.05/$0.10 USD) - 2019/10/24 20:23:00 ET
Table 'Alrami' 6-max Seat #2 is the button
Seat 1: csxwe ($21.56 in chips) 
Seat 2: PlayTheBlues4U ($10.32 in chips) 
Seat 3: ZTP0 ($8.03 in chips) 
Seat 4: Poker150847 ($9.66 in chips) 
Seat 5: 123tiger711a ($10 in chips) 
Seat 6: dmg3000 ($9.33 in chips) 
ZTP0: posts small blind $0.05
Poker150847: posts big blind $0.10
csxwe: posts big blind $0.10
*** HOLE CARDS ***
Dealt to PlayTheBlues4U [3h 5c]
123tiger711a: folds 
dmg3000: folds 
csxwe: checks 
PlayTheBlues4U: folds 
ZTP0: folds 
Poker150847: checks 
*** FLOP *** [5s Ac 6h]
Poker150847: checks 
csxwe: checks 
*** TURN *** [5s Ac 6h] [7h]
Poker150847: checks 
csxwe: bets $0.10
Poker150847: folds 
Uncalled bet ($0.10) returned to csxwe
csxwe collected $0.24 from pot
csxwe: doesn't show hand 
*** SUMMARY ***
Total pot $0.25 | Rake $0.01 
Board [5s Ac 6h 7h]
Seat 1: csxwe collected ($0.24)
Seat 2: PlayTheBlues4U (button) folded before Flop (didn't bet)
Seat 3: ZTP0 (small blind) folded before Flop
Seat 4: Poker150847 (big blind) folded on the Turn
Seat 5: 123tiger711a folded before Flop (didn't bet)
Seat 6: dmg3000 folded before Flop (didn't bet)



PokerStars Hand #205008744526:  Hold'em No Limit ($0.05/$0.10 USD) - 2019/10/24 20:23:39 ET
Table 'Alrami' 6-max Seat #3 is the button
Seat 1: csxwe ($21.70 in chips) 
Seat 2: PlayTheBlues4U ($10.32 in chips) 
Seat 3: ZTP0 ($7.98 in chips) 
Seat 4: Poker150847 ($9.56 in chips) 
Seat 5: 123tiger711a ($10 in chips) 
Seat 6: dmg3000 ($9.33 in chips) 
Poker150847: posts small blind $0.05
123tiger711a: posts big blind $0.10
*** HOLE CARDS ***
Dealt to PlayTheBlues4U [3s Ad]
dmg3000: raises $0.20 to $0.30
csxwe: folds 
PlayTheBlues4U: folds 
ZTP0: folds 
Poker150847: folds 
123tiger711a: folds 
Uncalled bet ($0.20) returned to dmg3000
dmg3000 collected $0.25 from pot
*** SUMMARY ***
Total pot $0.25 | Rake $0 
Seat 1: csxwe folded before Flop (didn't bet)
Seat 2: PlayTheBlues4U folded before Flop (didn't bet)
Seat 3: ZTP0 (button) folded before Flop (didn't bet)
Seat 4: Poker150847 (small blind) folded before Flop
Seat 5: 123tiger711a (big blind) folded before Flop
Seat 6: dmg3000 collected ($0.25)



PokerStars Hand #205008744591:  Hold'em No Limit ($0.05/$0.10 USD) - 2019/10/24 20:23:59 ET
Table 'Alrami' 6-max Seat #4 is the button
Seat 1: csxwe ($21.70 in chips) 
Seat 2: PlayTheBlues4U ($10.32 in chips) 
Seat 3: ZTP0 ($7.98 in chips) 
Seat 4: Poker150847 ($9.51 in chips) 
Seat 5: 123tiger711a ($10 in chips) 
Seat 6: dmg3000 ($9.48 in chips) 
123tiger711a: posts small blind $0.05
dmg3000: posts big blind $0.10
*** HOLE CARDS ***
Dealt to PlayTheBlues4U [9h 3h]
csxwe: folds 
PlayTheBlues4U: folds 
ZTP0: folds 
Poker150847: folds 
123tiger711a: calls $0.05
dmg3000: raises $0.20 to $0.30
123tiger711a: folds 
Uncalled bet ($0.20) returned to dmg3000
dmg3000 collected $0.20 from pot
*** SUMMARY ***
Total pot $0.20 | Rake $0 
Seat 1: csxwe folded before Flop (didn't bet)
Seat 2: PlayTheBlues4U folded before Flop (didn't bet)
Seat 3: ZTP0 folded before Flop (didn't bet)
Seat 4: Poker150847 (button) folded before Flop (didn't bet)
Seat 5: 123tiger711a (small blind) folded before Flop
Seat 6: dmg3000 (big blind) collected ($0.20)



PokerStars Hand #205008744661:  Hold'em No Limit ($0.05/$0.10 USD) - 2019/10/24 20:24:20 ET
Table 'Alrami' 6-max Seat #5 is the button
Seat 1: csxwe ($21.70 in chips) 
Seat 2: PlayTheBlues4U ($10.32 in chips) 
Seat 3: ZTP0 ($7.98 in chips) 
Seat 4: Poker150847 ($9.51 in chips) 
Seat 5: 123tiger711a ($10 in chips) 
Seat 6: dmg3000 ($9.58 in chips) 
dmg3000: posts small blind $0.05
csxwe: posts big blind $0.10
*** HOLE CARDS ***
Dealt to PlayTheBlues4U [5h Qd]
PlayTheBlues4U: folds 
ZTP0: raises $0.20 to $0.30
Poker150847: folds 
123tiger711a: calls $0.30
dmg3000: folds 
csxwe: folds 
*** FLOP *** [6c Ks 2c]
ZTP0: checks 
123tiger711a: checks 
*** TURN *** [6c Ks 2c] [Qs]
ZTP0: bets $0.50
123tiger711a: folds 
Uncalled bet ($0.50) returned to ZTP0
ZTP0 collected $0.71 from pot
ZTP0: doesn't show hand 
*** SUMMARY ***
Total pot $0.75 | Rake $0.04 
Board [6c Ks 2c Qs]
Seat 1: csxwe (big blind) folded before Flop
Seat 2: PlayTheBlues4U folded before Flop (didn't bet)
Seat 3: ZTP0 collected ($0.71)
Seat 4: Poker150847 folded before Flop (didn't bet)
Seat 5: 123tiger711a (button) folded on the Turn
Seat 6: dmg3000 (small blind) folded before Flop



PokerStars Hand #205008744779:  Hold'em No Limit ($0.05/$0.10 USD) - 2019/10/24 20:24:51 ET
Table 'Alrami' 6-max Seat #6 is the button
Seat 1: csxwe ($21.60 in chips) 
Seat 2: PlayTheBlues4U ($10.32 in chips) 
Seat 3: ZTP0 ($8.39 in chips) 
Seat 4: Poker150847 ($9.51 in chips) 
Seat 5: 123tiger711a ($10 in chips) 
Seat 6: dmg3000 ($9.53 in chips) 
csxwe: posts small blind $0.05
PlayTheBlues4U: posts big blind $0.10
*** HOLE CARDS ***
Dealt to PlayTheBlues4U [Qc 3c]
ZTP0: folds 
Poker150847: folds 
123tiger711a: folds 
dmg3000: folds 
csxwe: raises $0.10 to $0.20
PlayTheBlues4U: folds 
Uncalled bet ($0.10) returned to csxwe
csxwe collected $0.20 from pot
csxwe: doesn't show hand 
*** SUMMARY ***
Total pot $0.20 | Rake $0 
Seat 1: csxwe (small blind) collected ($0.20)
Seat 2: PlayTheBlues4U (big blind) folded before Flop
Seat 3: ZTP0 folded before Flop (didn't bet)
Seat 4: Poker150847 folded before Flop (didn't bet)
Seat 5: 123tiger711a folded before Flop (didn't bet)
Seat 6: dmg3000 (button) folded before Flop (didn't bet)



PokerStars Hand #205008744864:  Hold'em No Limit ($0.05/$0.10 USD) - 2019/10/24 20:25:12 ET
Table 'Alrami' 6-max Seat #1 is the button
Seat 1: csxwe ($21.70 in chips) 
Seat 2: PlayTheBlues4U ($10.22 in chips) 
Seat 3: ZTP0 ($8.39 in chips) 
Seat 4: Poker150847 ($9.51 in chips) 
Seat 5: 123tiger711a ($10 in chips) 
Seat 6: dmg3000 ($9.53 in chips) 
PlayTheBlues4U: posts small blind $0.05
ZTP0: posts big blind $0.10
*** HOLE CARDS ***
Dealt to PlayTheBlues4U [Qc 7h]
Poker150847: folds 
123tiger711a: folds 
dmg3000: folds 
csxwe: folds 
PlayTheBlues4U: folds 
Uncalled bet ($0.05) returned to ZTP0
ZTP0 collected $0.10 from pot
ZTP0: doesn't show hand 
*** SUMMARY ***
Total pot $0.10 | Rake $0 
Seat 1: csxwe (button) folded before Flop (didn't bet)
Seat 2: PlayTheBlues4U (small blind) folded before Flop
Seat 3: ZTP0 (big blind) collected ($0.10)
Seat 4: Poker150847 folded before Flop (didn't bet)
Seat 5: 123tiger711a folded before Flop (didn't bet)
Seat 6: dmg3000 folded before Flop (didn't bet)



PokerStars Hand #205008744910:  Hold'em No Limit ($0.05/$0.10 USD) - 2019/10/24 20:25:26 ET
Table 'Alrami' 6-max Seat #2 is the button
Seat 1: csxwe ($21.70 in chips) 
Seat 2: PlayTheBlues4U ($10.17 in chips) 
Seat 3: ZTP0 ($8.44 in chips) 
Seat 4: Poker150847 ($9.51 in chips) 
Seat 5: 123tiger711a ($10 in chips) 
Seat 6: dmg3000 ($9.53 in chips) 
ZTP0: posts small blind $0.05
Poker150847: posts big blind $0.10
*** HOLE CARDS ***
Dealt to PlayTheBlues4U [7c 3c]
123tiger711a: folds 
dmg3000: folds 
csxwe: folds 
PlayTheBlues4U: folds 
ZTP0: folds 
Uncalled bet ($0.05) returned to Poker150847
Poker150847 collected $0.10 from pot
*** SUMMARY ***
Total pot $0.10 | Rake $0 
Seat 1: csxwe folded before Flop (didn't bet)
Seat 2: PlayTheBlues4U (button) folded before Flop (didn't bet)
Seat 3: ZTP0 (small blind) folded before Flop
Seat 4: Poker150847 (big blind) collected ($0.10)
Seat 5: 123tiger711a folded before Flop (didn't bet)
Seat 6: dmg3000 folded before Flop (didn't bet)



PokerStars Hand #205008744971:  Hold'em No Limit ($0.05/$0.10 USD) - 2019/10/24 20:25:42 ET
Table 'Alrami' 6-max Seat #3 is the button
Seat 1: csxwe ($21.70 in chips) 
Seat 2: PlayTheBlues4U ($10.17 in chips) 
Seat 3: ZTP0 ($8.39 in chips) 
Seat 4: Poker150847 ($9.56 in chips) 
Seat 5: 123tiger711a ($10 in chips) 
Seat 6: dmg3000 ($9.53 in chips) 
Poker150847: posts small blind $0.05
123tiger711a: posts big blind $0.10
*** HOLE CARDS ***
Dealt to PlayTheBlues4U [Js 3d]
dmg3000: folds 
csxwe: folds 
PlayTheBlues4U: folds 
ZTP0: folds 
Poker150847 has timed out
Poker150847: folds 
Uncalled bet ($0.05) returned to 123tiger711a
123tiger711a collected $0.10 from pot
*** SUMMARY ***
Total pot $0.10 | Rake $0 
Seat 1: csxwe folded before Flop (didn't bet)
Seat 2: PlayTheBlues4U folded before Flop (didn't bet)
Seat 3: ZTP0 (button) folded before Flop (didn't bet)
Seat 4: Poker150847 (small blind) folded before Flop
Seat 5: 123tiger711a (big blind) collected ($0.10)
Seat 6: dmg3000 folded before Flop (didn't bet)



PokerStars Hand #205008745178:  Hold'em No Limit ($0.05/$0.10 USD) - 2019/10/24 20:26:39 ET
Table 'Alrami' 6-max Seat #5 is the button
Seat 1: csxwe ($21.70 in chips) 
Seat 2: PlayTheBlues4U ($10.17 in chips) 
Seat 3: ZTP0 ($8.39 in chips) 
Seat 5: 123tiger711a ($10.05 in chips) 
Seat 6: dmg3000 ($9.53 in chips) 
dmg3000: posts small blind $0.05
csxwe: posts big blind $0.10
*** HOLE CARDS ***
Dealt to PlayTheBlues4U [9d 4s]
PlayTheBlues4U: folds 
ZTP0: folds 
123tiger711a: folds 
dmg3000: raises $0.10 to $0.20
csxwe: folds 
Uncalled bet ($0.10) returned to dmg3000
dmg3000 collected $0.20 from pot
*** SUMMARY ***
Total pot $0.20 | Rake $0 
Seat 1: csxwe (big blind) folded before Flop
Seat 2: PlayTheBlues4U folded before Flop (didn't bet)
Seat 3: ZTP0 folded before Flop (didn't bet)
Seat 5: 123tiger711a (button) folded before Flop (didn't bet)
Seat 6: dmg3000 (small blind) collected ($0.20)



PokerStars Hand #205008745290:  Hold'em No Limit ($0.05/$0.10 USD) - 2019/10/24 20:27:09 ET
Table 'Alrami' 6-max Seat #6 is the button
Seat 1: csxwe ($21.60 in chips) 
Seat 2: PlayTheBlues4U ($10.17 in chips) 
Seat 3: ZTP0 ($8.39 in chips) 
Seat 5: 123tiger711a ($10.05 in chips) 
Seat 6: dmg3000 ($9.63 in chips) 
csxwe: posts small blind $0.05
PlayTheBlues4U: posts big blind $0.10
*** HOLE CARDS ***
Dealt to PlayTheBlues4U [6h 2d]
ZTP0: raises $0.20 to $0.30
123tiger711a: folds 
dmg3000: folds 
csxwe: folds 
PlayTheBlues4U: folds 
Uncalled bet ($0.20) returned to ZTP0
ZTP0 collected $0.25 from pot
ZTP0: doesn't show hand 
*** SUMMARY ***
Total pot $0.25 | Rake $0 
Seat 1: csxwe (small blind) folded before Flop
Seat 2: PlayTheBlues4U (big blind) folded before Flop
Seat 3: ZTP0 collected ($0.25)
Seat 5: 123tiger711a folded before Flop (didn't bet)
Seat 6: dmg3000 (button) folded before Flop (didn't bet)



PokerStars Hand #205008745328:  Hold'em No Limit ($0.05/$0.10 USD) - 2019/10/24 20:27:18 ET
Table 'Alrami' 6-max Seat #1 is the button
Seat 1: csxwe ($21.55 in chips) 
Seat 2: PlayTheBlues4U ($10.07 in chips) 
Seat 3: ZTP0 ($8.54 in chips) 
Seat 5: 123tiger711a ($10.05 in chips) 
Seat 6: dmg3000 ($9.63 in chips) 
PlayTheBlues4U: posts small blind $0.05
ZTP0: posts big blind $0.10
*** HOLE CARDS ***
Dealt to PlayTheBlues4U [Kc Ts]
123tiger711a: folds 
dmg3000: folds 
csxwe: folds 
PlayTheBlues4U: raises $0.20 to $0.30
ZTP0: folds 
Uncalled bet ($0.20) returned to PlayTheBlues4U
PlayTheBlues4U collected $0.20 from pot
PlayTheBlues4U: doesn't show hand 
*** SUMMARY ***
Total pot $0.20 | Rake $0 
Seat 1: csxwe (button) folded before Flop (didn't bet)
Seat 2: PlayTheBlues4U (small blind) collected ($0.20)
Seat 3: ZTP0 (big blind) folded before Flop
Seat 5: 123tiger711a folded before Flop (didn't bet)
Seat 6: dmg3000 folded before Flop (didn't bet)



PokerStars Hand #205008745381:  Hold'em No Limit ($0.05/$0.10 USD) - 2019/10/24 20:27:33 ET
Table 'Alrami' 6-max Seat #2 is the button
Seat 1: csxwe ($21.55 in chips) 
Seat 2: PlayTheBlues4U ($10.17 in chips) 
Seat 3: ZTP0 ($8.44 in chips) 
Seat 5: 123tiger711a ($10.05 in chips) 
Seat 6: dmg3000 ($9.63 in chips) 
ZTP0: posts small blind $0.05
123tiger711a: posts big blind $0.10
*** HOLE CARDS ***
Dealt to PlayTheBlues4U [2d Kc]
dmg3000: raises $0.20 to $0.30
csxwe: calls $0.30
PlayTheBlues4U: folds 
ZTP0: folds 
123tiger711a: folds 
*** FLOP *** [9c 5s 4c]
dmg3000: bets $0.36
csxwe: calls $0.36
*** TURN *** [9c 5s 4c] [8c]
dmg3000: bets $0.50
csxwe: calls $0.50
*** RIVER *** [9c 5s 4c 8c] [8h]
dmg3000: bets $0.70
csxwe: folds 
Uncalled bet ($0.70) returned to dmg3000
dmg3000 collected $2.35 from pot
*** SUMMARY ***
Total pot $2.47 | Rake $0.12 
Board [9c 5s 4c 8c 8h]
Seat 1: csxwe folded on the River
Seat 2: PlayTheBlues4U (button) folded before Flop (didn't bet)
Seat 3: ZTP0 (small blind) folded before Flop
Seat 5: 123tiger711a (big blind) folded before Flop
Seat 6: dmg3000 collected ($2.35)



PokerStars Hand #205008745564:  Hold'em No Limit ($0.05/$0.10 USD) - 2019/10/24 20:28:18 ET
Table 'Alrami' 6-max Seat #3 is the button
Seat 1: csxwe ($20.39 in chips) 
Seat 2: PlayTheBlues4U ($10.17 in chips) 
Seat 3: ZTP0 ($8.39 in chips) 
Seat 5: 123tiger711a ($10 in chips) 
Seat 6: dmg3000 ($10.82 in chips) 
123tiger711a: posts small blind $0.05
dmg3000: posts big blind $0.10
*** HOLE CARDS ***
Dealt to PlayTheBlues4U [9h 4c]
csxwe: folds 
PlayTheBlues4U: folds 
ZTP0: raises $0.20 to $0.30
123tiger711a: raises $0.90 to $1.20
dmg3000: folds 
ZTP0: folds 
Uncalled bet ($0.90) returned to 123tiger711a
123tiger711a collected $0.70 from pot
*** SUMMARY ***
Total pot $0.70 | Rake $0 
Seat 1: csxwe folded before Flop (didn't bet)
Seat 2: PlayTheBlues4U folded before Flop (didn't bet)
Seat 3: ZTP0 (button) folded before Flop
Seat 5: 123tiger711a (small blind) collected ($0.70)
Seat 6: dmg3000 (big blind) folded before Flop



PokerStars Hand #205008745657:  Hold'em No Limit ($0.05/$0.10 USD) - 2019/10/24 20:28:41 ET
Table 'Alrami' 6-max Seat #5 is the button
Seat 1: csxwe ($20.39 in chips) 
Seat 2: PlayTheBlues4U ($10.17 in chips) 
Seat 3: ZTP0 ($8.09 in chips) 
Seat 5: 123tiger711a ($10.40 in chips) 
Seat 6: dmg3000 ($10.72 in chips) 
dmg3000: posts small blind $0.05
csxwe: posts big blind $0.10
*** HOLE CARDS ***
Dealt to PlayTheBlues4U [6d 5d]
PlayTheBlues4U: folds 
ZTP0: raises $0.20 to $0.30
123tiger711a: calls $0.30
dmg3000: calls $0.25
csxwe: folds 
*** FLOP *** [5c Ac 2h]
dmg3000: checks 
ZTP0: checks 
123tiger711a: checks 
*** TURN *** [5c Ac 2h] [7c]
dmg3000: checks 
ZTP0: bets $0.70
123tiger711a: folds 
dmg3000: folds 
Uncalled bet ($0.70) returned to ZTP0
ZTP0 collected $0.95 from pot
ZTP0: doesn't show hand 
*** SUMMARY ***
Total pot $1 | Rake $0.05 
Board [5c Ac 2h 7c]
Seat 1: csxwe (big blind) folded before Flop
Seat 2: PlayTheBlues4U folded before Flop (didn't bet)
Seat 3: ZTP0 collected ($0.95)
Seat 5: 123tiger711a (button) folded on the Turn
Seat 6: dmg3000 (small blind) folded on the Turn



PokerStars Hand #205008745918:  Hold'em No Limit ($0.05/$0.10 USD) - 2019/10/24 20:29:42 ET
Table 'Alrami' 6-max Seat #6 is the button
Seat 1: csxwe ($20.29 in chips) 
Seat 2: PlayTheBlues4U ($10.17 in chips) 
Seat 3: ZTP0 ($8.74 in chips) 
Seat 5: 123tiger711a ($10.10 in chips) 
Seat 6: dmg3000 ($10.42 in chips) 
csxwe: posts small blind $0.05
PlayTheBlues4U: posts big blind $0.10
*** HOLE CARDS ***
Dealt to PlayTheBlues4U [7s 3d]
ZTP0: raises $0.20 to $0.30
123tiger711a: calls $0.30
dmg3000: folds 
csxwe: folds 
PlayTheBlues4U: folds 
*** FLOP *** [9h Qc Qs]
ZTP0: checks 
123tiger711a: bets $0.36
ZTP0: calls $0.36
*** TURN *** [9h Qc Qs] [Ts]
ZTP0: checks 
123tiger711a: checks 
*** RIVER *** [9h Qc Qs Ts] [Ks]
ZTP0: bets $1.40
123tiger711a: calls $1.40
*** SHOW DOWN ***
ZTP0: shows [Tc Td] (a full house, Tens full of Queens)
123tiger711a: mucks hand 
ZTP0 collected $4.06 from pot
*** SUMMARY ***
Total pot $4.27 | Rake $0.21 
Board [9h Qc Qs Ts Ks]
Seat 1: csxwe (small blind) folded before Flop
Seat 2: PlayTheBlues4U (big blind) folded before Flop
Seat 3: ZTP0 showed [Tc Td] and won ($4.06) with a full house, Tens full of Queens
Seat 5: 123tiger711a mucked [Js Jd]
Seat 6: dmg3000 (button) folded before Flop (didn't bet)



PokerStars Hand #205008746104:  Hold'em No Limit ($0.05/$0.10 USD) - 2019/10/24 20:30:26 ET
Table 'Alrami' 6-max Seat #1 is the button
Seat 1: csxwe ($20.24 in chips) 
Seat 2: PlayTheBlues4U ($10.07 in chips) 
Seat 3: ZTP0 ($10.74 in chips) 
Seat 5: 123tiger711a ($10 in chips) 
Seat 6: dmg3000 ($10.42 in chips) 
PlayTheBlues4U: posts small blind $0.05
ZTP0: posts big blind $0.10
*** HOLE CARDS ***
Dealt to PlayTheBlues4U [5s Jc]
123tiger711a: folds 
dmg3000: folds 
csxwe: folds 
PlayTheBlues4U: folds 
Uncalled bet ($0.05) returned to ZTP0
ZTP0 collected $0.10 from pot
ZTP0: doesn't show hand 
*** SUMMARY ***
Total pot $0.10 | Rake $0 
Seat 1: csxwe (button) folded before Flop (didn't bet)
Seat 2: PlayTheBlues4U (small blind) folded before Flop
Seat 3: ZTP0 (big blind) collected ($0.10)
Seat 5: 123tiger711a folded before Flop (didn't bet)
Seat 6: dmg3000 folded before Flop (didn't bet)



PokerStars Hand #205008746154:  Hold'em No Limit ($0.05/$0.10 USD) - 2019/10/24 20:30:37 ET
Table 'Alrami' 6-max Seat #2 is the button
Seat 1: csxwe ($20.24 in chips) 
Seat 2: PlayTheBlues4U ($10.02 in chips) 
Seat 3: ZTP0 ($10.79 in chips) 
Seat 5: 123tiger711a ($10 in chips) 
Seat 6: dmg3000 ($10.42 in chips) 
ZTP0: posts small blind $0.05
123tiger711a: posts big blind $0.10
*** HOLE CARDS ***
Dealt to PlayTheBlues4U [8s 9d]
dmg3000 has timed out
dmg3000: folds 
csxwe: calls $0.10
PlayTheBlues4U: folds 
ZTP0: raises $0.20 to $0.30
123tiger711a: folds 
csxwe: calls $0.20
*** FLOP *** [Js 4d Qh]
ZTP0: checks 
csxwe: checks 
*** TURN *** [Js 4d Qh] [Tc]
ZTP0: checks 
csxwe: bets $0.30
ZTP0: folds 
Uncalled bet ($0.30) returned to csxwe
csxwe collected $0.66 from pot
csxwe: doesn't show hand 
*** SUMMARY ***
Total pot $0.70 | Rake $0.04 
Board [Js 4d Qh Tc]
Seat 1: csxwe collected ($0.66)
Seat 2: PlayTheBlues4U (button) folded before Flop (didn't bet)
Seat 3: ZTP0 (small blind) folded on the Turn
Seat 5: 123tiger711a (big blind) folded before Flop
Seat 6: dmg3000 folded before Flop (didn't bet)



PokerStars Hand #205008746381:  Hold'em No Limit ($0.05/$0.10 USD) - 2019/10/24 20:31:31 ET
Table 'Alrami' 6-max Seat #3 is the button
Seat 1: csxwe ($20.60 in chips) 
Seat 2: PlayTheBlues4U ($10.02 in chips) 
Seat 3: ZTP0 ($10.49 in chips) 
Seat 5: 123tiger711a ($10 in chips) 
123tiger711a: posts small blind $0.05
csxwe: posts big blind $0.10
*** HOLE CARDS ***
Dealt to PlayTheBlues4U [Qc As]
PlayTheBlues4U: raises $0.20 to $0.30
ZTP0: folds 
123tiger711a: folds 
csxwe: calls $0.20
*** FLOP *** [9d 6d 4h]
csxwe: checks 
PlayTheBlues4U: checks 
*** TURN *** [9d 6d 4h] [5c]
csxwe: bets $0.30
PlayTheBlues4U: calls $0.30
*** RIVER *** [9d 6d 4h 5c] [Js]
csxwe: checks 
PlayTheBlues4U: checks 
*** SHOW DOWN ***
csxwe: shows [8h 7s] (a straight, Five to Nine)
PlayTheBlues4U: mucks hand 
csxwe collected $1.19 from pot
*** SUMMARY ***
Total pot $1.25 | Rake $0.06 
Board [9d 6d 4h 5c Js]
Seat 1: csxwe (big blind) showed [8h 7s] and won ($1.19) with a straight, Five to Nine
Seat 2: PlayTheBlues4U mucked [Qc As]
Seat 3: ZTP0 (button) folded before Flop (didn't bet)
Seat 5: 123tiger711a (small blind) folded before Flop



PokerStars Hand #205008746545:  Hold'em No Limit ($0.05/$0.10 USD) - 2019/10/24 20:32:11 ET
Table 'Alrami' 6-max Seat #5 is the button
Seat 1: csxwe ($21.19 in chips) 
Seat 2: PlayTheBlues4U ($9.42 in chips) 
Seat 3: ZTP0 ($10.49 in chips) 
Seat 5: 123tiger711a ($10 in chips) 
csxwe: posts small blind $0.05
PlayTheBlues4U: posts big blind $0.10
*** HOLE CARDS ***
Dealt to PlayTheBlues4U [8s 7h]
ZTP0: folds 
123tiger711a: folds 
csxwe: folds 
Uncalled bet ($0.05) returned to PlayTheBlues4U
PlayTheBlues4U collected $0.10 from pot
PlayTheBlues4U: doesn't show hand 
*** SUMMARY ***
Total pot $0.10 | Rake $0 
Seat 1: csxwe (small blind) folded before Flop
Seat 2: PlayTheBlues4U (big blind) collected ($0.10)
Seat 3: ZTP0 folded before Flop (didn't bet)
Seat 5: 123tiger711a (button) folded before Flop (didn't bet)



PokerStars Hand #205008746685:  Hold'em No Limit ($0.05/$0.10 USD) - 2019/10/24 20:32:41 ET
Table 'Alrami' 6-max Seat #1 is the button
Seat 1: csxwe ($21.14 in chips) 
Seat 2: PlayTheBlues4U ($9.47 in chips) 
Seat 3: ZTP0 ($10.49 in chips) 
Seat 5: 123tiger711a ($10 in chips) 
Seat 6: dmg3000 ($10.42 in chips) 
PlayTheBlues4U: posts small blind $0.05
ZTP0: posts big blind $0.10
dmg3000: posts small & big blinds $0.15
*** HOLE CARDS ***
Dealt to PlayTheBlues4U [6c 5s]
123tiger711a: calls $0.10
dmg3000: checks 
csxwe: calls $0.10
PlayTheBlues4U: calls $0.05
ZTP0: checks 
*** FLOP *** [Kc 5h 9s]
PlayTheBlues4U: checks 
ZTP0: checks 
123tiger711a: checks 
dmg3000: checks 
csxwe: checks 
*** TURN *** [Kc 5h 9s] [4d]
PlayTheBlues4U: checks 
ZTP0: checks 
123tiger711a: checks 
dmg3000: bets $0.10
csxwe: folds 
PlayTheBlues4U: folds 
ZTP0: calls $0.10
123tiger711a: folds 
*** RIVER *** [Kc 5h 9s 4d] [Tc]
ZTP0: checks 
dmg3000: checks 
*** SHOW DOWN ***
ZTP0: shows [7h 4c] (a pair of Fours)
dmg3000: shows [4h 2d] (a pair of Fours)
ZTP0 collected $0.36 from pot
dmg3000 collected $0.35 from pot
*** SUMMARY ***
Total pot $0.75 | Rake $0.04 
Board [Kc 5h 9s 4d Tc]
Seat 1: csxwe (button) folded on the Turn
Seat 2: PlayTheBlues4U (small blind) folded on the Turn
Seat 3: ZTP0 (big blind) showed [7h 4c] and won ($0.36) with a pair of Fours
Seat 5: 123tiger711a folded on the Turn
Seat 6: dmg3000 showed [4h 2d] and won ($0.35) with a pair of Fours



PokerStars Hand #205008747053:  Hold'em No Limit ($0.05/$0.10 USD) - 2019/10/24 20:34:03 ET
Table 'Alrami' 6-max Seat #2 is the button
Seat 1: csxwe ($21.04 in chips) 
Seat 2: PlayTheBlues4U ($9.37 in chips) 
Seat 3: ZTP0 ($10.65 in chips) 
Seat 5: 123tiger711a ($10 in chips) 
Seat 6: dmg3000 ($10.52 in chips) 
ZTP0: posts small blind $0.05
123tiger711a: posts big blind $0.10
*** HOLE CARDS ***
Dealt to PlayTheBlues4U [Kc 7d]
dmg3000: folds 
csxwe: calls $0.10
PlayTheBlues4U: folds 
ZTP0: folds 
123tiger711a: checks 
*** FLOP *** [3d As Qd]
123tiger711a: checks 
csxwe: checks 
*** TURN *** [3d As Qd] [7h]
123tiger711a: checks 
csxwe: bets $0.10
123tiger711a: folds 
Uncalled bet ($0.10) returned to csxwe
csxwe collected $0.24 from pot
csxwe: doesn't show hand 
*** SUMMARY ***
Total pot $0.25 | Rake $0.01 
Board [3d As Qd 7h]
Seat 1: csxwe collected ($0.24)
Seat 2: PlayTheBlues4U (button) folded before Flop (didn't bet)
Seat 3: ZTP0 (small blind) folded before Flop
Seat 5: 123tiger711a (big blind) folded on the Turn
Seat 6: dmg3000 folded before Flop (didn't bet)



PokerStars Hand #205008747199:  Hold'em No Limit ($0.05/$0.10 USD) - 2019/10/24 20:34:35 ET
Table 'Alrami' 6-max Seat #3 is the button
Seat 1: csxwe ($21.18 in chips) 
Seat 2: PlayTheBlues4U ($9.37 in chips) 
Seat 3: ZTP0 ($10.60 in chips) 
Seat 5: 123tiger711a ($10 in chips) 
Seat 6: dmg3000 ($10.52 in chips) 
123tiger711a: posts small blind $0.05
dmg3000: posts big blind $0.10
*** HOLE CARDS ***
Dealt to PlayTheBlues4U [8d Kd]
csxwe: raises $0.10 to $0.20
PlayTheBlues4U: folds 
ZTP0: folds 
123tiger711a: calls $0.15
dmg3000: raises $0.50 to $0.70
csxwe: calls $0.50
123tiger711a: folds 
*** FLOP *** [8c 9s Qs]
dmg3000: bets $0.76
csxwe: calls $0.76
*** TURN *** [8c 9s Qs] [Ks]
dmg3000: checks 
csxwe: checks 
*** RIVER *** [8c 9s Qs Ks] [Qc]
dmg3000: bets $0.90
csxwe: raises $2.40 to $3.30
dmg3000: folds 
Uncalled bet ($2.40) returned to csxwe
csxwe collected $4.67 from pot
csxwe: doesn't show hand 
*** SUMMARY ***
Total pot $4.92 | Rake $0.25 
Board [8c 9s Qs Ks Qc]
Seat 1: csxwe collected ($4.67)
Seat 2: PlayTheBlues4U folded before Flop (didn't bet)
Seat 3: ZTP0 (button) folded before Flop (didn't bet)
Seat 5: 123tiger711a (small blind) folded before Flop
Seat 6: dmg3000 (big blind) folded on the River



PokerStars Hand #205008747515:  Hold'em No Limit ($0.05/$0.10 USD) - 2019/10/24 20:35:42 ET
Table 'Alrami' 6-max Seat #5 is the button
Seat 1: csxwe ($23.49 in chips) 
Seat 2: PlayTheBlues4U ($9.37 in chips) 
Seat 3: ZTP0 ($10.60 in chips) 
Seat 5: 123tiger711a ($10 in chips) 
Seat 6: dmg3000 ($8.16 in chips) 
dmg3000: posts small blind $0.05
csxwe: posts big blind $0.10
*** HOLE CARDS ***
Dealt to PlayTheBlues4U [7s 5d]
PlayTheBlues4U: folds 
ZTP0: raises $0.20 to $0.30
123tiger711a: calls $0.30
dmg3000: folds 
csxwe: calls $0.20
*** FLOP *** [5s 6c Tc]
csxwe: checks 
ZTP0: checks 
123tiger711a: bets $0.45
csxwe: folds 
ZTP0: calls $0.45
*** TURN *** [5s 6c Tc] [6s]
ZTP0: checks 
123tiger711a: bets $1.76
ZTP0: folds 
Uncalled bet ($1.76) returned to 123tiger711a
123tiger711a collected $1.76 from pot
*** SUMMARY ***
Total pot $1.85 | Rake $0.09 
Board [5s 6c Tc 6s]
Seat 1: csxwe (big blind) folded on the Flop
Seat 2: PlayTheBlues4U folded before Flop (didn't bet)
Seat 3: ZTP0 folded on the Turn
Seat 5: 123tiger711a (button) collected ($1.76)
Seat 6: dmg3000 (small blind) folded before Flop



PokerStars Hand #205008747754:  Hold'em No Limit ($0.05/$0.10 USD) - 2019/10/24 20:36:33 ET
Table 'Alrami' 6-max Seat #6 is the button
Seat 1: csxwe ($23.19 in chips) 
Seat 2: PlayTheBlues4U ($9.37 in chips) 
Seat 3: ZTP0 ($9.85 in chips) 
Seat 5: 123tiger711a ($11.01 in chips) 
Seat 6: dmg3000 ($9.95 in chips) 
csxwe: posts small blind $0.05
PlayTheBlues4U: posts big blind $0.10
*** HOLE CARDS ***
Dealt to PlayTheBlues4U [2s 4s]
ZTP0: folds 
123tiger711a: folds 
dmg3000: calls $0.10
csxwe: raises $0.10 to $0.20
PlayTheBlues4U: folds 
dmg3000: calls $0.10
*** FLOP *** [Jh Qc 9c]
csxwe: bets $0.20
dmg3000: folds 
Uncalled bet ($0.20) returned to csxwe
csxwe collected $0.48 from pot
csxwe: doesn't show hand 
*** SUMMARY ***
Total pot $0.50 | Rake $0.02 
Board [Jh Qc 9c]
Seat 1: csxwe (small blind) collected ($0.48)
Seat 2: PlayTheBlues4U (big blind) folded before Flop
Seat 3: ZTP0 folded before Flop (didn't bet)
Seat 5: 123tiger711a folded before Flop (didn't bet)
Seat 6: dmg3000 (button) folded on the Flop



PokerStars Hand #205008747923:  Hold'em No Limit ($0.05/$0.10 USD) - 2019/10/24 20:37:10 ET
Table 'Alrami' 6-max Seat #1 is the button
Seat 1: csxwe ($23.47 in chips) 
Seat 2: PlayTheBlues4U ($9.27 in chips) 
Seat 3: ZTP0 ($9.85 in chips) 
Seat 5: 123tiger711a ($11.01 in chips) 
Seat 6: dmg3000 ($9.75 in chips) 
PlayTheBlues4U: posts small blind $0.05
ZTP0: posts big blind $0.10
*** HOLE CARDS ***
Dealt to PlayTheBlues4U [6d Qc]
123tiger711a: folds 
dmg3000: folds 
csxwe: folds 
PlayTheBlues4U: folds 
Uncalled bet ($0.05) returned to ZTP0
ZTP0 collected $0.10 from pot
ZTP0: doesn't show hand 
*** SUMMARY ***
Total pot $0.10 | Rake $0 
Seat 1: csxwe (button) folded before Flop (didn't bet)
Seat 2: PlayTheBlues4U (small blind) folded before Flop
Seat 3: ZTP0 (big blind) collected ($0.10)
Seat 5: 123tiger711a folded before Flop (didn't bet)
Seat 6: dmg3000 folded before Flop (didn't bet)



PokerStars Hand #205008748000:  Hold'em No Limit ($0.05/$0.10 USD) - 2019/10/24 20:37:28 ET
Table 'Alrami' 6-max Seat #2 is the button
Seat 1: csxwe ($23.47 in chips) 
Seat 2: PlayTheBlues4U ($9.22 in chips) 
Seat 3: ZTP0 ($9.90 in chips) 
Seat 5: 123tiger711a ($11.01 in chips) 
Seat 6: dmg3000 ($9.75 in chips) 
ZTP0: posts small blind $0.05
123tiger711a: posts big blind $0.10
*** HOLE CARDS ***
Dealt to PlayTheBlues4U [8d 6d]
dmg3000: calls $0.10
csxwe: calls $0.10
PlayTheBlues4U: folds 
ZTP0: folds 
123tiger711a: checks 
*** FLOP *** [5h 2d 8h]
123tiger711a: checks 
dmg3000: checks 
csxwe: checks 
*** TURN *** [5h 2d 8h] [9s]
123tiger711a: bets $0.17
dmg3000: folds 
csxwe: folds 
Uncalled bet ($0.17) returned to 123tiger711a
123tiger711a collected $0.33 from pot
*** SUMMARY ***
Total pot $0.35 | Rake $0.02 
Board [5h 2d 8h 9s]
Seat 1: csxwe folded on the Turn
Seat 2: PlayTheBlues4U (button) folded before Flop (didn't bet)
Seat 3: ZTP0 (small blind) folded before Flop
Seat 5: 123tiger711a (big blind) collected ($0.33)
Seat 6: dmg3000 folded on the Turn



PokerStars Hand #205008748178:  Hold'em No Limit ($0.05/$0.10 USD) - 2019/10/24 20:38:08 ET
Table 'Alrami' 6-max Seat #3 is the button
Seat 1: csxwe ($23.37 in chips) 
Seat 2: PlayTheBlues4U ($9.22 in chips) 
Seat 3: ZTP0 ($9.85 in chips) 
Seat 5: 123tiger711a ($11.24 in chips) 
Seat 6: dmg3000 ($9.65 in chips) 
123tiger711a: posts small blind $0.05
dmg3000: posts big blind $0.10
*** HOLE CARDS ***
Dealt to PlayTheBlues4U [9c Th]
csxwe: folds 
PlayTheBlues4U: folds 
ZTP0: raises $0.20 to $0.30
123tiger711a: folds 
dmg3000: folds 
Uncalled bet ($0.20) returned to ZTP0
ZTP0 collected $0.25 from pot
ZTP0: doesn't show hand 
*** SUMMARY ***
Total pot $0.25 | Rake $0 
Seat 1: csxwe folded before Flop (didn't bet)
Seat 2: PlayTheBlues4U folded before Flop (didn't bet)
Seat 3: ZTP0 (button) collected ($0.25)
Seat 5: 123tiger711a (small blind) folded before Flop
Seat 6: dmg3000 (big blind) folded before Flop



PokerStars Hand #205008748292:  Hold'em No Limit ($0.05/$0.10 USD) - 2019/10/24 20:38:34 ET
Table 'Alrami' 6-max Seat #5 is the button
Seat 1: csxwe ($23.37 in chips) 
Seat 2: PlayTheBlues4U ($9.22 in chips) 
Seat 3: ZTP0 ($10 in chips) 
Seat 5: 123tiger711a ($11.19 in chips) 
Seat 6: dmg3000 ($9.55 in chips) 
dmg3000: posts small blind $0.05
csxwe: posts big blind $0.10
*** HOLE CARDS ***
Dealt to PlayTheBlues4U [Jc Tc]
PlayTheBlues4U: raises $0.20 to $0.30
ZTP0: folds 
123tiger711a: calls $0.30
dmg3000: folds 
csxwe: folds 
*** FLOP *** [3h 3c Qd]
PlayTheBlues4U: bets $0.40
123tiger711a: folds 
Uncalled bet ($0.40) returned to PlayTheBlues4U
PlayTheBlues4U collected $0.71 from pot
PlayTheBlues4U: doesn't show hand 
*** SUMMARY ***
Total pot $0.75 | Rake $0.04 
Board [3h 3c Qd]
Seat 1: csxwe (big blind) folded before Flop
Seat 2: PlayTheBlues4U collected ($0.71)
Seat 3: ZTP0 folded before Flop (didn't bet)
Seat 5: 123tiger711a (button) folded on the Flop
Seat 6: dmg3000 (small blind) folded before Flop



PokerStars Hand #205008748452:  Hold'em No Limit ($0.05/$0.10 USD) - 2019/10/24 20:39:11 ET
Table 'Alrami' 6-max Seat #6 is the button
Seat 1: csxwe ($23.27 in chips) 
Seat 2: PlayTheBlues4U ($9.63 in chips) 
Seat 3: ZTP0 ($10 in chips) 
Seat 5: 123tiger711a ($10.89 in chips) 
Seat 6: dmg3000 ($9.50 in chips) 
csxwe: posts small blind $0.05
PlayTheBlues4U: posts big blind $0.10
*** HOLE CARDS ***
Dealt to PlayTheBlues4U [7s 6h]
ZTP0: folds 
123tiger711a: folds 
dmg3000: folds 
csxwe: folds 
Uncalled bet ($0.05) returned to PlayTheBlues4U
PlayTheBlues4U collected $0.10 from pot
PlayTheBlues4U: doesn't show hand 
*** SUMMARY ***
Total pot $0.10 | Rake $0 
Seat 1: csxwe (small blind) folded before Flop
Seat 2: PlayTheBlues4U (big blind) collected ($0.10)
Seat 3: ZTP0 folded before Flop (didn't bet)
Seat 5: 123tiger711a folded before Flop (didn't bet)
Seat 6: dmg3000 (button) folded before Flop (didn't bet)



PokerStars Hand #205008748508:  Hold'em No Limit ($0.05/$0.10 USD) - 2019/10/24 20:39:24 ET
Table 'Alrami' 6-max Seat #1 is the button
Seat 1: csxwe ($23.22 in chips) 
Seat 2: PlayTheBlues4U ($9.68 in chips) 
Seat 3: ZTP0 ($10 in chips) 
Seat 5: 123tiger711a ($10.89 in chips) 
Seat 6: dmg3000 ($9.50 in chips) 
PlayTheBlues4U: posts small blind $0.05
ZTP0: posts big blind $0.10
*** HOLE CARDS ***
Dealt to PlayTheBlues4U [7d Qh]
123tiger711a: folds 
dmg3000: folds 
csxwe: calls $0.10
PlayTheBlues4U: folds 
ZTP0: checks 
*** FLOP *** [Js 8h Kc]
ZTP0: checks 
csxwe: checks 
*** TURN *** [Js 8h Kc] [Jc]
ZTP0: checks 
csxwe: bets $0.10
ZTP0: folds 
Uncalled bet ($0.10) returned to csxwe
csxwe collected $0.24 from pot
csxwe: doesn't show hand 
*** SUMMARY ***
Total pot $0.25 | Rake $0.01 
Board [Js 8h Kc Jc]
Seat 1: csxwe (button) collected ($0.24)
Seat 2: PlayTheBlues4U (small blind) folded before Flop
Seat 3: ZTP0 (big blind) folded on the Turn
Seat 5: 123tiger711a folded before Flop (didn't bet)
Seat 6: dmg3000 folded before Flop (didn't bet)



PokerStars Hand #205008748632:  Hold'em No Limit ($0.05/$0.10 USD) - 2019/10/24 20:39:54 ET
Table 'Alrami' 6-max Seat #2 is the button
Seat 1: csxwe ($23.36 in chips) 
Seat 2: PlayTheBlues4U ($9.63 in chips) 
Seat 3: ZTP0 ($9.90 in chips) 
Seat 5: 123tiger711a ($10.89 in chips) 
Seat 6: dmg3000 ($9.50 in chips) 
ZTP0: posts small blind $0.05
123tiger711a: posts big blind $0.10
*** HOLE CARDS ***
Dealt to PlayTheBlues4U [Kd Ac]
dmg3000: folds 
csxwe: calls $0.10
PlayTheBlues4U: raises $0.30 to $0.40
ZTP0: folds 
123tiger711a: folds 
csxwe: calls $0.30
*** FLOP *** [Qd Jh 4d]
csxwe: checks 
PlayTheBlues4U: checks 
*** TURN *** [Qd Jh 4d] [5d]
csxwe: checks 
PlayTheBlues4U: checks 
*** RIVER *** [Qd Jh 4d 5d] [6h]
Poker150847 leaves the table
csxwe: checks 
PlayTheBlues4U: checks 
*** SHOW DOWN ***
csxwe: shows [Kh 5h] (a pair of Fives)
PlayTheBlues4U: mucks hand 
csxwe collected $0.90 from pot
*** SUMMARY ***
Total pot $0.95 | Rake $0.05 
Board [Qd Jh 4d 5d 6h]
Seat 1: csxwe showed [Kh 5h] and won ($0.90) with a pair of Fives
Seat 2: PlayTheBlues4U (button) mucked [Kd Ac]
Seat 3: ZTP0 (small blind) folded before Flop
Seat 5: 123tiger711a (big blind) folded before Flop
Seat 6: dmg3000 folded before Flop (didn't bet)



PokerStars Hand #205008748763:  Hold'em No Limit ($0.05/$0.10 USD) - 2019/10/24 20:40:22 ET
Table 'Alrami' 6-max Seat #3 is the button
Seat 1: csxwe ($23.86 in chips) 
Seat 2: PlayTheBlues4U ($9.23 in chips) 
Seat 3: ZTP0 ($9.85 in chips) 
Seat 5: 123tiger711a ($10.79 in chips) 
Seat 6: dmg3000 ($9.50 in chips) 
123tiger711a: posts small blind $0.05
dmg3000: posts big blind $0.10
*** HOLE CARDS ***
Dealt to PlayTheBlues4U [Th Jh]
csxwe: calls $0.10
PlayTheBlues4U: raises $0.20 to $0.30
ZTP0: folds 
123tiger711a: folds 
Scomscott joins the table at seat #4 
dmg3000: calls $0.20
csxwe: calls $0.20
*** FLOP *** [Qs 5c 4h]
dmg3000: checks 
csxwe: checks 
PlayTheBlues4U: bets $0.50
dmg3000: folds 
csxwe: folds 
Uncalled bet ($0.50) returned to PlayTheBlues4U
PlayTheBlues4U collected $0.90 from pot
PlayTheBlues4U: doesn't show hand 
*** SUMMARY ***
Total pot $0.95 | Rake $0.05 
Board [Qs 5c 4h]
Seat 1: csxwe folded on the Flop
Seat 2: PlayTheBlues4U collected ($0.90)
Seat 3: ZTP0 (button) folded before Flop (didn't bet)
Seat 5: 123tiger711a (small blind) folded before Flop
Seat 6: dmg3000 (big blind) folded on the Flop



PokerStars Hand #205008748997:  Hold'em No Limit ($0.05/$0.10 USD) - 2019/10/24 20:41:16 ET
Table 'Alrami' 6-max Seat #5 is the button
Seat 1: csxwe ($23.56 in chips) 
Seat 2: PlayTheBlues4U ($9.83 in chips) 
Seat 3: ZTP0 ($9.85 in chips) 
Seat 4: Scomscott ($10 in chips) 
Seat 5: 123tiger711a ($10.74 in chips) 
Seat 6: dmg3000 ($9.20 in chips) 
dmg3000: posts small blind $0.05
csxwe: posts big blind $0.10
Scomscott: posts big blind $0.10
*** HOLE CARDS ***
Dealt to PlayTheBlues4U [Jh 7d]
PlayTheBlues4U: folds 
ZTP0: raises $0.20 to $0.30
Scomscott: folds 
123tiger711a: folds 
dmg3000: calls $0.25
csxwe: folds 
*** FLOP *** [9d 9s 3h]
dmg3000: checks 
ZTP0: bets $0.40
dmg3000: calls $0.40
*** TURN *** [9d 9s 3h] [6s]
dmg3000: checks 
ZTP0: checks 
*** RIVER *** [9d 9s 3h 6s] [Kh]
dmg3000: bets $0.76
ZTP0: calls $0.76
*** SHOW DOWN ***
dmg3000: shows [8d 9h] (three of a kind, Nines)
ZTP0: mucks hand 
dmg3000 collected $2.96 from pot
*** SUMMARY ***
Total pot $3.12 | Rake $0.16 
Board [9d 9s 3h 6s Kh]
Seat 1: csxwe (big blind) folded before Flop
Seat 2: PlayTheBlues4U folded before Flop (didn't bet)
Seat 3: ZTP0 mucked [2s 2h]
Seat 4: Scomscott folded before Flop (didn't bet)
Seat 5: 123tiger711a (button) folded before Flop (didn't bet)
Seat 6: dmg3000 (small blind) showed [8d 9h] and won ($2.96) with three of a kind, Nines



PokerStars Hand #205008749240:  Hold'em No Limit ($0.05/$0.10 USD) - 2019/10/24 20:42:17 ET
Table 'Alrami' 6-max Seat #6 is the button
Seat 1: csxwe ($23.46 in chips) 
Seat 2: PlayTheBlues4U ($9.83 in chips) 
Seat 3: ZTP0 ($8.39 in chips) 
Seat 4: Scomscott ($9.90 in chips) 
Seat 5: 123tiger711a ($10.74 in chips) 
Seat 6: dmg3000 ($10.70 in chips) 
csxwe: posts small blind $0.05
PlayTheBlues4U: posts big blind $0.10
*** HOLE CARDS ***
Dealt to PlayTheBlues4U [Ad As]
ZTP0: folds 
Scomscott: folds 
123tiger711a: folds 
dmg3000: folds 
csxwe: calls $0.05
PlayTheBlues4U: raises $0.30 to $0.40
csxwe: calls $0.30
*** FLOP *** [Tc Th 4d]
csxwe: bets $6.50
csxwe said, "mc"
PlayTheBlues4U: folds 
Uncalled bet ($6.50) returned to csxwe
csxwe collected $0.76 from pot
csxwe: doesn't show hand 
*** SUMMARY ***
Total pot $0.80 | Rake $0.04 
Board [Tc Th 4d]
Seat 1: csxwe (small blind) collected ($0.76)
Seat 2: PlayTheBlues4U (big blind) folded on the Flop
Seat 3: ZTP0 folded before Flop (didn't bet)
Seat 4: Scomscott folded before Flop (didn't bet)
Seat 5: 123tiger711a folded before Flop (didn't bet)
Seat 6: dmg3000 (button) folded before Flop (didn't bet)



PokerStars Hand #205008749443:  Hold'em No Limit ($0.05/$0.10 USD) - 2019/10/24 20:43:06 ET
Table 'Alrami' 6-max Seat #1 is the button
Seat 1: csxwe ($23.82 in chips) 
Seat 2: PlayTheBlues4U ($9.43 in chips) 
Seat 3: ZTP0 ($8.39 in chips) 
Seat 4: Scomscott ($9.90 in chips) 
Seat 5: 123tiger711a ($10.74 in chips) 
Seat 6: dmg3000 ($10.70 in chips) 
PlayTheBlues4U: posts small blind $0.05
ZTP0: posts big blind $0.10
*** HOLE CARDS ***
Dealt to PlayTheBlues4U [7h 8d]
csxwe said, "ty"
Scomscott: folds 
123tiger711a: folds 
dmg3000: folds 
csxwe: calls $0.10
PlayTheBlues4U: calls $0.05
ZTP0: checks 
*** FLOP *** [5h 2h 7d]
PlayTheBlues4U: bets $0.20
ZTP0: raises $0.20 to $0.40
csxwe: folds 
PlayTheBlues4U: calls $0.20
*** TURN *** [5h 2h 7d] [8h]
PlayTheBlues4U: checks 
ZTP0: bets $0.60
PlayTheBlues4U: calls $0.60
*** RIVER *** [5h 2h 7d 8h] [4d]
PlayTheBlues4U: checks 
ZTP0: bets $1.70
PlayTheBlues4U: folds 
Uncalled bet ($1.70) returned to ZTP0
ZTP0 collected $2.18 from pot
ZTP0: doesn't show hand 
*** SUMMARY ***
Total pot $2.30 | Rake $0.12 
Board [5h 2h 7d 8h 4d]
Seat 1: csxwe (button) folded on the Flop
Seat 2: PlayTheBlues4U (small blind) folded on the River
Seat 3: ZTP0 (big blind) collected ($2.18)
Seat 4: Scomscott folded before Flop (didn't bet)
Seat 5: 123tiger711a folded before Flop (didn't bet)
Seat 6: dmg3000 folded before Flop (didn't bet)



PokerStars Hand #205008749750:  Hold'em No Limit ($0.05/$0.10 USD) - 2019/10/24 20:44:18 ET
Table 'Alrami' 6-max Seat #2 is the button
Seat 1: csxwe ($23.72 in chips) 
Seat 2: PlayTheBlues4U ($8.33 in chips) 
Seat 3: ZTP0 ($9.47 in chips) 
Seat 4: Scomscott ($9.90 in chips) 
Seat 5: 123tiger711a ($10.74 in chips) 
Seat 6: dmg3000 ($10.70 in chips) 
ZTP0: posts small blind $0.05
Scomscott: posts big blind $0.10
*** HOLE CARDS ***
Dealt to PlayTheBlues4U [Jd 2s]
123tiger711a: raises $0.40 to $0.50
dmg3000: folds 
csxwe: folds 
PlayTheBlues4U: folds 
ZTP0: raises $0.90 to $1.40
Scomscott: folds 
123tiger711a: calls $0.90
*** FLOP *** [8s 4c 4s]
ZTP0: checks 
123tiger711a: bets $1.38
ZTP0: calls $1.38
*** TURN *** [8s 4c 4s] [5s]
ZTP0: checks 
123tiger711a: checks 
*** RIVER *** [8s 4c 4s 5s] [8h]
ZTP0: bets $3
123tiger711a: calls $3
*** SHOW DOWN ***
ZTP0: shows [4d Ad] (a full house, Fours full of Eights)
123tiger711a: mucks hand 
ZTP0 collected $11.08 from pot
*** SUMMARY ***
Total pot $11.66 | Rake $0.58 
Board [8s 4c 4s 5s 8h]
Seat 1: csxwe folded before Flop (didn't bet)
Seat 2: PlayTheBlues4U (button) folded before Flop (didn't bet)
Seat 3: ZTP0 (small blind) showed [4d Ad] and won ($11.08) with a full house, Fours full of Eights
Seat 4: Scomscott (big blind) folded before Flop
Seat 5: 123tiger711a mucked [Jh Jc]
Seat 6: dmg3000 folded before Flop (didn't bet)



PokerStars Hand #205008749959:  Hold'em No Limit ($0.05/$0.10 USD) - 2019/10/24 20:45:07 ET
Table 'Alrami' 6-max Seat #3 is the button
Seat 1: csxwe ($23.72 in chips) 
Seat 2: PlayTheBlues4U ($8.33 in chips) 
Seat 3: ZTP0 ($14.77 in chips) 
Seat 4: Scomscott ($9.80 in chips) 
Seat 5: 123tiger711a ($10 in chips) 
Seat 6: dmg3000 ($10.70 in chips) 
Scomscott: posts small blind $0.05
123tiger711a: posts big blind $0.10
*** HOLE CARDS ***
Dealt to PlayTheBlues4U [8s 4h]
dmg3000: folds 
csxwe: folds 
PlayTheBlues4U: folds 
ZTP0: raises $0.20 to $0.30
Scomscott: folds 
123tiger711a: calls $0.20
*** FLOP *** [5s 2h 7s]
123tiger711a: checks 
ZTP0: bets $0.31
123tiger711a: calls $0.31
*** TURN *** [5s 2h 7s] [9d]
123tiger711a: checks 
ZTP0: checks 
*** RIVER *** [5s 2h 7s 9d] [Kc]
123tiger711a: checks 
ZTP0: checks 
*** SHOW DOWN ***
123tiger711a: shows [Jh Ks] (a pair of Kings)
ZTP0: mucks hand 
123tiger711a collected $1.21 from pot
*** SUMMARY ***
Total pot $1.27 | Rake $0.06 
Board [5s 2h 7s 9d Kc]
Seat 1: csxwe folded before Flop (didn't bet)
Seat 2: PlayTheBlues4U folded before Flop (didn't bet)
Seat 3: ZTP0 (button) mucked [6s 7h]
Seat 4: Scomscott (small blind) folded before Flop
Seat 5: 123tiger711a (big blind) showed [Jh Ks] and won ($1.21) with a pair of Kings
Seat 6: dmg3000 folded before Flop (didn't bet)



PokerStars Hand #205009472186:  Hold'em No Limit ($0.05/$0.10 USD) - 2019/10/24 20:46:00 ET
Table 'Alrami' 6-max Seat #4 is the button
Seat 1: csxwe ($23.72 in chips) 
Seat 2: PlayTheBlues4U ($10 in chips) 
Seat 3: ZTP0 ($14.16 in chips) 
Seat 4: Scomscott ($9.75 in chips) 
Seat 5: 123tiger711a ($10.60 in chips) 
Seat 6: dmg3000 ($10.70 in chips) 
123tiger711a: posts small blind $0.05
dmg3000: posts big blind $0.10
*** HOLE CARDS ***
Dealt to PlayTheBlues4U [3s 3h]
csxwe: folds 
PlayTheBlues4U: raises $0.20 to $0.30
ZTP0: folds 
Scomscott: raises $0.70 to $1
123tiger711a: folds 
dmg3000: folds 
PlayTheBlues4U: folds 
Uncalled bet ($0.70) returned to Scomscott
Scomscott collected $0.75 from pot
Scomscott: doesn't show hand 
*** SUMMARY ***
Total pot $0.75 | Rake $0 
Seat 1: csxwe folded before Flop (didn't bet)
Seat 2: PlayTheBlues4U folded before Flop
Seat 3: ZTP0 folded before Flop (didn't bet)
Seat 4: Scomscott (button) collected ($0.75)
Seat 5: 123tiger711a (small blind) folded before Flop
Seat 6: dmg3000 (big blind) folded before Flop



PokerStars Hand #205009472315:  Hold'em No Limit ($0.05/$0.10 USD) - 2019/10/24 20:46:29 ET
Table 'Alrami' 6-max Seat #5 is the button
Seat 1: csxwe ($23.72 in chips) 
Seat 2: PlayTheBlues4U ($9.70 in chips) 
Seat 3: ZTP0 ($14.16 in chips) 
Seat 4: Scomscott ($10.20 in chips) 
Seat 5: 123tiger711a ($10.55 in chips) 
Seat 6: dmg3000 ($10.60 in chips) 
dmg3000: posts small blind $0.05
csxwe: posts big blind $0.10
*** HOLE CARDS ***
Dealt to PlayTheBlues4U [Js 9s]
PlayTheBlues4U: folds 
ZTP0: folds 
Scomscott: calls $0.10
123tiger711a: folds 
dmg3000: calls $0.05
csxwe: checks 
*** FLOP *** [8c 5h 7s]
dmg3000: bets $0.14
csxwe: calls $0.14
Scomscott: folds 
*** TURN *** [8c 5h 7s] [Th]
dmg3000: bets $0.30
csxwe: calls $0.30
*** RIVER *** [8c 5h 7s Th] [Jh]
dmg3000: bets $0.56
csxwe: raises $2.24 to $2.80
dmg3000: folds 
Uncalled bet ($2.24) returned to csxwe
csxwe collected $2.18 from pot
csxwe: doesn't show hand 
*** SUMMARY ***
Total pot $2.30 | Rake $0.12 
Board [8c 5h 7s Th Jh]
Seat 1: csxwe (big blind) collected ($2.18)
Seat 2: PlayTheBlues4U folded before Flop (didn't bet)
Seat 3: ZTP0 folded before Flop (didn't bet)
Seat 4: Scomscott folded on the Flop
Seat 5: 123tiger711a (button) folded before Flop (didn't bet)
Seat 6: dmg3000 (small blind) folded on the River



PokerStars Hand #205009472610:  Hold'em No Limit ($0.05/$0.10 USD) - 2019/10/24 20:47:32 ET
Table 'Alrami' 6-max Seat #6 is the button
Seat 1: csxwe ($24.80 in chips) 
Seat 2: PlayTheBlues4U ($9.70 in chips) 
Seat 3: ZTP0 ($14.16 in chips) 
Seat 4: Scomscott ($10.10 in chips) 
Seat 5: 123tiger711a ($10.55 in chips) 
Seat 6: dmg3000 ($9.50 in chips) 
csxwe: posts small blind $0.05
PlayTheBlues4U: posts big blind $0.10
*** HOLE CARDS ***
Dealt to PlayTheBlues4U [Jc 9d]
ZTP0: raises $0.20 to $0.30
Scomscott: folds 
123tiger711a: folds 
dmg3000: folds 
csxwe: folds 
PlayTheBlues4U: folds 
Uncalled bet ($0.20) returned to ZTP0
ZTP0 collected $0.25 from pot
ZTP0: doesn't show hand 
*** SUMMARY ***
Total pot $0.25 | Rake $0 
Seat 1: csxwe (small blind) folded before Flop
Seat 2: PlayTheBlues4U (big blind) folded before Flop
Seat 3: ZTP0 collected ($0.25)
Seat 4: Scomscott folded before Flop (didn't bet)
Seat 5: 123tiger711a folded before Flop (didn't bet)
Seat 6: dmg3000 (button) folded before Flop (didn't bet)



PokerStars Hand #205009472685:  Hold'em No Limit ($0.05/$0.10 USD) - 2019/10/24 20:47:51 ET
Table 'Alrami' 6-max Seat #1 is the button
Seat 1: csxwe ($24.75 in chips) 
Seat 2: PlayTheBlues4U ($9.60 in chips) 
Seat 3: ZTP0 ($14.31 in chips) 
Seat 4: Scomscott ($10.10 in chips) 
Seat 5: 123tiger711a ($10.55 in chips) 
Seat 6: dmg3000 ($9.50 in chips) 
PlayTheBlues4U: posts small blind $0.05
ZTP0: posts big blind $0.10
*** HOLE CARDS ***
Dealt to PlayTheBlues4U [Ad Ks]
Scomscott: folds 
123tiger711a: calls $0.10
dmg3000: calls $0.10
csxwe: folds 
PlayTheBlues4U: raises $0.50 to $0.60
ZTP0: calls $0.50
123tiger711a: calls $0.50
dmg3000: folds 
*** FLOP *** [4d 2d Jd]
PlayTheBlues4U: bets $1
ZTP0: calls $1
123tiger711a: folds 
*** TURN *** [4d 2d Jd] [4h]
PlayTheBlues4U: checks 
ZTP0: checks 
*** RIVER *** [4d 2d Jd 4h] [7c]
PlayTheBlues4U: checks 
ZTP0: bets $3.70
PlayTheBlues4U: folds 
Uncalled bet ($3.70) returned to ZTP0
ZTP0 collected $3.70 from pot
ZTP0: doesn't show hand 
*** SUMMARY ***
Total pot $3.90 | Rake $0.20 
Board [4d 2d Jd 4h 7c]
Seat 1: csxwe (button) folded before Flop (didn't bet)
Seat 2: PlayTheBlues4U (small blind) folded on the River
Seat 3: ZTP0 (big blind) collected ($3.70)
Seat 4: Scomscott folded before Flop (didn't bet)
Seat 5: 123tiger711a folded on the Flop
Seat 6: dmg3000 folded before Flop



PokerStars Hand #205009472958:  Hold'em No Limit ($0.05/$0.10 USD) - 2019/10/24 20:48:53 ET
Table 'Alrami' 6-max Seat #2 is the button
Seat 1: csxwe ($24.75 in chips) 
Seat 2: PlayTheBlues4U ($8 in chips) 
Seat 3: ZTP0 ($16.41 in chips) 
Seat 4: Scomscott ($10.10 in chips) 
Seat 5: 123tiger711a ($10 in chips) 
Seat 6: dmg3000 ($9.40 in chips) 
ZTP0: posts small blind $0.05
Scomscott: posts big blind $0.10
*** HOLE CARDS ***
Dealt to PlayTheBlues4U [5s Qd]
123tiger711a: folds 
dmg3000: raises $0.25 to $0.35
csxwe: folds 
PlayTheBlues4U: folds 
ZTP0: folds 
Scomscott: folds 
Uncalled bet ($0.25) returned to dmg3000
dmg3000 collected $0.25 from pot
*** SUMMARY ***
Total pot $0.25 | Rake $0 
Seat 1: csxwe folded before Flop (didn't bet)
Seat 2: PlayTheBlues4U (button) folded before Flop (didn't bet)
Seat 3: ZTP0 (small blind) folded before Flop
Seat 4: Scomscott (big blind) folded before Flop
Seat 5: 123tiger711a folded before Flop (didn't bet)
Seat 6: dmg3000 collected ($0.25)



PokerStars Hand #205009473026:  Hold'em No Limit ($0.05/$0.10 USD) - 2019/10/24 20:49:08 ET
Table 'Alrami' 6-max Seat #3 is the button
Seat 1: csxwe ($24.75 in chips) 
Seat 2: PlayTheBlues4U ($8 in chips) 
Seat 3: ZTP0 ($16.36 in chips) 
Seat 4: Scomscott ($10 in chips) 
Seat 5: 123tiger711a ($10 in chips) 
Seat 6: dmg3000 ($9.55 in chips) 
Scomscott: posts small blind $0.05
123tiger711a: posts big blind $0.10
*** HOLE CARDS ***
Dealt to PlayTheBlues4U [Jh 6c]
dmg3000: folds 
csxwe: calls $0.10
PlayTheBlues4U: folds 
ZTP0 has timed out
ZTP0: folds 
Scomscott: calls $0.05
123tiger711a: checks 
*** FLOP *** [7c 2d 5h]
Scomscott: checks 
123tiger711a: checks 
csxwe: checks 
*** TURN *** [7c 2d 5h] [7d]
Scomscott: bets $0.24
123tiger711a: calls $0.24
csxwe: calls $0.24
*** RIVER *** [7c 2d 5h 7d] [Qd]
Scomscott: bets $0.50
123tiger711a: folds 
csxwe: folds 
Uncalled bet ($0.50) returned to Scomscott
Scomscott collected $0.97 from pot
Scomscott: doesn't show hand 
*** SUMMARY ***
Total pot $1.02 | Rake $0.05 
Board [7c 2d 5h 7d Qd]
Seat 1: csxwe folded on the River
Seat 2: PlayTheBlues4U folded before Flop (didn't bet)
Seat 3: ZTP0 (button) folded before Flop (didn't bet)
Seat 4: Scomscott (small blind) collected ($0.97)
Seat 5: 123tiger711a (big blind) folded on the River
Seat 6: dmg3000 folded before Flop (didn't bet)



PokerStars Hand #205009473332:  Hold'em No Limit ($0.05/$0.10 USD) - 2019/10/24 20:50:19 ET
Table 'Alrami' 6-max Seat #4 is the button
Seat 1: csxwe ($24.41 in chips) 
Seat 2: PlayTheBlues4U ($10 in chips) 
Seat 3: ZTP0 ($16.36 in chips) 
Seat 4: Scomscott ($10.63 in chips) 
Seat 5: 123tiger711a ($10 in chips) 
Seat 6: dmg3000 ($9.55 in chips) 
123tiger711a: posts small blind $0.05
dmg3000: posts big blind $0.10
*** HOLE CARDS ***
Dealt to PlayTheBlues4U [2d 4d]
csxwe: raises $0.10 to $0.20
PlayTheBlues4U: folds 
ZTP0: folds 
Scomscott: calls $0.20
123tiger711a: calls $0.15
dmg3000: calls $0.10
*** FLOP *** [Th 8s Td]
123tiger711a: checks 
dmg3000: checks 
csxwe: bets $0.40
Scomscott: folds 
123tiger711a: folds 
dmg3000: folds 
Uncalled bet ($0.40) returned to csxwe
csxwe collected $0.76 from pot
csxwe: doesn't show hand 
*** SUMMARY ***
Total pot $0.80 | Rake $0.04 
Board [Th 8s Td]
Seat 1: csxwe collected ($0.76)
Seat 2: PlayTheBlues4U folded before Flop (didn't bet)
Seat 3: ZTP0 folded before Flop (didn't bet)
Seat 4: Scomscott (button) folded on the Flop
Seat 5: 123tiger711a (small blind) folded on the Flop
Seat 6: dmg3000 (big blind) folded on the Flop



PokerStars Hand #205009473458:  Hold'em No Limit ($0.05/$0.10 USD) - 2019/10/24 20:50:49 ET
Table 'Alrami' 6-max Seat #5 is the button
Seat 1: csxwe ($24.97 in chips) 
Seat 2: PlayTheBlues4U ($10 in chips) 
Seat 3: ZTP0 ($16.36 in chips) 
Seat 4: Scomscott ($10.43 in chips) 
Seat 5: 123tiger711a ($10 in chips) 
Seat 6: dmg3000 ($9.35 in chips) 
dmg3000: posts small blind $0.05
csxwe: posts big blind $0.10
*** HOLE CARDS ***
Dealt to PlayTheBlues4U [As Js]
PlayTheBlues4U: raises $0.20 to $0.30
ZTP0: calls $0.30
Scomscott: folds 
123tiger711a: folds 
dmg3000: folds 
csxwe: folds 
*** FLOP *** [Td 3d Jc]
PlayTheBlues4U: bets $0.50
ZTP0: folds 
Uncalled bet ($0.50) returned to PlayTheBlues4U
PlayTheBlues4U collected $0.71 from pot
PlayTheBlues4U: doesn't show hand 
*** SUMMARY ***
Total pot $0.75 | Rake $0.04 
Board [Td 3d Jc]
Seat 1: csxwe (big blind) folded before Flop
Seat 2: PlayTheBlues4U collected ($0.71)
Seat 3: ZTP0 folded on the Flop
Seat 4: Scomscott folded before Flop (didn't bet)
Seat 5: 123tiger711a (button) folded before Flop (didn't bet)
Seat 6: dmg3000 (small blind) folded before Flop



PokerStars Hand #205009473605:  Hold'em No Limit ($0.05/$0.10 USD) - 2019/10/24 20:51:23 ET
Table 'Alrami' 6-max Seat #6 is the button
Seat 1: csxwe ($24.87 in chips) 
Seat 2: PlayTheBlues4U ($10.41 in chips) 
Seat 3: ZTP0 ($16.06 in chips) 
Seat 4: Scomscott ($10.43 in chips) 
Seat 5: 123tiger711a ($10 in chips) 
Seat 6: dmg3000 ($9.30 in chips) 
csxwe: posts small blind $0.05
PlayTheBlues4U: posts big blind $0.10
*** HOLE CARDS ***
Dealt to PlayTheBlues4U [Jc Js]
ZTP0: folds 
Scomscott: raises $0.20 to $0.30
123tiger711a: calls $0.30
dmg3000: calls $0.30
csxwe: folds 
PlayTheBlues4U: raises $1.20 to $1.50
Scomscott: folds 
123tiger711a: folds 
dmg3000: calls $1.20
*** FLOP *** [3c Th 8s]
Scomscott leaves the table
PlayTheBlues4U: bets $2.10
dmg3000: calls $2.10
*** TURN *** [3c Th 8s] [Kc]
PlayTheBlues4U: checks 
dmg3000: checks 
*** RIVER *** [3c Th 8s Kc] [5d]
PlayTheBlues4U: checks 
dmg3000: bets $3
PlayTheBlues4U: calls $3
*** SHOW DOWN ***
dmg3000: shows [8c 8d] (three of a kind, Eights)
PlayTheBlues4U: mucks hand 
dmg3000 collected $13.16 from pot
*** SUMMARY ***
Total pot $13.85 | Rake $0.69 
Board [3c Th 8s Kc 5d]
Seat 1: csxwe (small blind) folded before Flop
Seat 2: PlayTheBlues4U (big blind) mucked [Jc Js]
Seat 3: ZTP0 folded before Flop (didn't bet)
Seat 4: Scomscott folded before Flop
Seat 5: 123tiger711a folded before Flop
Seat 6: dmg3000 (button) showed [8c 8d] and won ($13.16) with three of a kind, Eights



PokerStars Hand #205009474116:  Hold'em No Limit ($0.05/$0.10 USD) - 2019/10/24 20:53:15 ET
Table 'Alrami' 6-max Seat #1 is the button
Seat 1: csxwe ($24.82 in chips) 
Seat 2: PlayTheBlues4U ($3.81 in chips) 
Seat 3: ZTP0 ($16.06 in chips) 
Seat 5: 123tiger711a ($10 in chips) 
Seat 6: dmg3000 ($15.86 in chips) 
PlayTheBlues4U: posts small blind $0.05
ZTP0: posts big blind $0.10
*** HOLE CARDS ***
Dealt to PlayTheBlues4U [2c 7h]
123tiger711a: folds 
dmg3000: folds 
csxwe: raises $0.20 to $0.30
PlayTheBlues4U: folds 
ZTP0: raises $0.60 to $0.90
csxwe: calls $0.60
*** FLOP *** [6s 9c 6h]
ZTP0: bets $1.40
csxwe: folds [Kc Qh]
Uncalled bet ($1.40) returned to ZTP0
ZTP0 collected $1.76 from pot
ZTP0: doesn't show hand 
*** SUMMARY ***
Total pot $1.85 | Rake $0.09 
Board [6s 9c 6h]
Seat 1: csxwe (button) folded on the Flop
Seat 2: PlayTheBlues4U (small blind) folded before Flop
Seat 3: ZTP0 (big blind) collected ($1.76)
Seat 5: 123tiger711a folded before Flop (didn't bet)
Seat 6: dmg3000 folded before Flop (didn't bet)



PokerStars Hand #205009474298:  Hold'em No Limit ($0.05/$0.10 USD) - 2019/10/24 20:53:57 ET
Table 'Alrami' 6-max Seat #2 is the button
Seat 1: csxwe ($23.92 in chips) 
Seat 2: PlayTheBlues4U ($10 in chips) 
Seat 3: ZTP0 ($16.92 in chips) 
Seat 5: 123tiger711a ($10 in chips) 
Seat 6: dmg3000 ($15.86 in chips) 
ZTP0: posts small blind $0.05
123tiger711a: posts big blind $0.10
*** HOLE CARDS ***
Dealt to PlayTheBlues4U [As 5c]
dmg3000: folds 
csxwe: calls $0.10
PlayTheBlues4U: folds 
ZTP0: calls $0.05
123tiger711a: checks 
*** FLOP *** [2h 9d 6c]
ZTP0: checks 
123tiger711a: checks 
csxwe: checks 
*** TURN *** [2h 9d 6c] [Ac]
ZTP0: bets $0.20
123tiger711a: folds 
csxwe: raises $0.30 to $0.50
ZTP0: folds 
Uncalled bet ($0.30) returned to csxwe
csxwe collected $0.66 from pot
csxwe: doesn't show hand 
*** SUMMARY ***
Total pot $0.70 | Rake $0.04 
Board [2h 9d 6c Ac]
Seat 1: csxwe collected ($0.66)
Seat 2: PlayTheBlues4U (button) folded before Flop (didn't bet)
Seat 3: ZTP0 (small blind) folded on the Turn
Seat 5: 123tiger711a (big blind) folded on the Turn
Seat 6: dmg3000 folded before Flop (didn't bet)



PokerStars Hand #205009474518:  Hold'em No Limit ($0.05/$0.10 USD) - 2019/10/24 20:54:44 ET
Table 'Alrami' 6-max Seat #3 is the button
Seat 1: csxwe ($24.28 in chips) 
Seat 2: PlayTheBlues4U ($10 in chips) 
Seat 3: ZTP0 ($16.62 in chips) 
Seat 5: 123tiger711a ($10 in chips) 
Seat 6: dmg3000 ($15.86 in chips) 
123tiger711a: posts small blind $0.05
dmg3000: posts big blind $0.10
*** HOLE CARDS ***
Dealt to PlayTheBlues4U [5h 3s]
csxwe: folds 
PlayTheBlues4U: folds 
ZTP0: raises $0.20 to $0.30
123tiger711a: folds 
dmg3000: folds 
Uncalled bet ($0.20) returned to ZTP0
ZTP0 collected $0.25 from pot
ZTP0: doesn't show hand 
*** SUMMARY ***
Total pot $0.25 | Rake $0 
Seat 1: csxwe folded before Flop (didn't bet)
Seat 2: PlayTheBlues4U folded before Flop (didn't bet)
Seat 3: ZTP0 (button) collected ($0.25)
Seat 5: 123tiger711a (small blind) folded before Flop
Seat 6: dmg3000 (big blind) folded before Flop



PokerStars Hand #205009474659:  Hold'em No Limit ($0.05/$0.10 USD) - 2019/10/24 20:55:13 ET
Table 'Alrami' 6-max Seat #5 is the button
Seat 1: csxwe ($24.28 in chips) 
Seat 2: PlayTheBlues4U ($10 in chips) 
Seat 3: ZTP0 ($16.77 in chips) 
Seat 5: 123tiger711a ($10 in chips) 
Seat 6: dmg3000 ($15.76 in chips) 
dmg3000: posts small blind $0.05
csxwe: posts big blind $0.10
*** HOLE CARDS ***
Dealt to PlayTheBlues4U [Th 9c]
PlayTheBlues4U: folds 
ZTP0: folds 
123tiger711a: calls $0.10
dmg3000: raises $0.20 to $0.30
csxwe: folds 
123tiger711a: calls $0.20
*** FLOP *** [Qc Kh As]
dmg3000: bets $0.33
123tiger711a: raises $1.32 to $1.65
dmg3000: folds 
Uncalled bet ($1.32) returned to 123tiger711a
123tiger711a collected $1.29 from pot
*** SUMMARY ***
Total pot $1.36 | Rake $0.07 
Board [Qc Kh As]
Seat 1: csxwe (big blind) folded before Flop
Seat 2: PlayTheBlues4U folded before Flop (didn't bet)
Seat 3: ZTP0 folded before Flop (didn't bet)
Seat 5: 123tiger711a (button) collected ($1.29)
Seat 6: dmg3000 (small blind) folded on the Flop



PokerStars Hand #205009474803:  Hold'em No Limit ($0.05/$0.10 USD) - 2019/10/24 20:55:51 ET
Table 'Alrami' 6-max Seat #6 is the button
Seat 1: csxwe ($24.18 in chips) 
Seat 2: PlayTheBlues4U ($10 in chips) 
Seat 3: ZTP0 ($16.77 in chips) 
Seat 5: 123tiger711a ($10.66 in chips) 
Seat 6: dmg3000 ($15.13 in chips) 
csxwe: posts small blind $0.05
PlayTheBlues4U: posts big blind $0.10
*** HOLE CARDS ***
Dealt to PlayTheBlues4U [Tc 6h]
ZTP0: folds 
123tiger711a: folds 
dmg3000: raises $0.25 to $0.35
csxwe: calls $0.30
PlayTheBlues4U: folds 
*** FLOP *** [7d Js 4d]
csxwe: checks 
dmg3000: bets $0.38
csxwe: folds 
Uncalled bet ($0.38) returned to dmg3000
dmg3000 collected $0.76 from pot
*** SUMMARY ***
Total pot $0.80 | Rake $0.04 
Board [7d Js 4d]
Seat 1: csxwe (small blind) folded on the Flop
Seat 2: PlayTheBlues4U (big blind) folded before Flop
Seat 3: ZTP0 folded before Flop (didn't bet)
Seat 5: 123tiger711a folded before Flop (didn't bet)
Seat 6: dmg3000 (button) collected ($0.76)



PokerStars Hand #205009474902:  Hold'em No Limit ($0.05/$0.10 USD) - 2019/10/24 20:56:17 ET
Table 'Alrami' 6-max Seat #1 is the button
Seat 1: csxwe ($23.83 in chips) 
Seat 2: PlayTheBlues4U ($9.90 in chips) 
Seat 3: ZTP0 ($16.77 in chips) 
Seat 5: 123tiger711a ($10.66 in chips) 
Seat 6: dmg3000 ($15.54 in chips) 
PlayTheBlues4U: posts small blind $0.05
ZTP0: posts big blind $0.10
*** HOLE CARDS ***
Dealt to PlayTheBlues4U [4d 7d]
123tiger711a: folds 
dmg3000: calls $0.10
csxwe: folds 
PlayTheBlues4U: folds 
ZTP0: checks 
*** FLOP *** [Ks 5s 6h]
ZTP0: checks 
dmg3000: checks 
*** TURN *** [Ks 5s 6h] [2c]
ZTP0: bets $0.30
dmg3000: folds 
Uncalled bet ($0.30) returned to ZTP0
ZTP0 collected $0.24 from pot
ZTP0: doesn't show hand 
*** SUMMARY ***
Total pot $0.25 | Rake $0.01 
Board [Ks 5s 6h 2c]
Seat 1: csxwe (button) folded before Flop (didn't bet)
Seat 2: PlayTheBlues4U (small blind) folded before Flop
Seat 3: ZTP0 (big blind) collected ($0.24)
Seat 5: 123tiger711a folded before Flop (didn't bet)
Seat 6: dmg3000 folded on the Turn



PokerStars Hand #205009475050:  Hold'em No Limit ($0.05/$0.10 USD) - 2019/10/24 20:56:57 ET
Table 'Alrami' 6-max Seat #2 is the button
Seat 1: csxwe ($23.83 in chips) 
Seat 2: PlayTheBlues4U ($9.85 in chips) 
Seat 3: ZTP0 ($16.91 in chips) 
Seat 5: 123tiger711a ($10.66 in chips) 
Seat 6: dmg3000 ($15.44 in chips) 
ZTP0: posts small blind $0.05
123tiger711a: posts big blind $0.10
*** HOLE CARDS ***
Dealt to PlayTheBlues4U [2d 9h]
dmg3000: folds 
csxwe: folds 
PlayTheBlues4U: folds 
ZTP0: raises $0.20 to $0.30
123tiger711a: calls $0.20
*** FLOP *** [2c Kc Ks]
ZTP0: checks 
123tiger711a: checks 
*** TURN *** [2c Kc Ks] [9c]
ZTP0: bets $0.30
123tiger711a: folds 
Uncalled bet ($0.30) returned to ZTP0
ZTP0 collected $0.57 from pot
ZTP0: doesn't show hand 
*** SUMMARY ***
Total pot $0.60 | Rake $0.03 
Board [2c Kc Ks 9c]
Seat 1: csxwe folded before Flop (didn't bet)
Seat 2: PlayTheBlues4U (button) folded before Flop (didn't bet)
Seat 3: ZTP0 (small blind) collected ($0.57)
Seat 5: 123tiger711a (big blind) folded on the Turn
Seat 6: dmg3000 folded before Flop (didn't bet)



PokerStars Hand #205009475149:  Hold'em No Limit ($0.05/$0.10 USD) - 2019/10/24 20:57:20 ET
Table 'Alrami' 6-max Seat #3 is the button
Seat 1: csxwe ($23.83 in chips) 
Seat 2: PlayTheBlues4U ($9.85 in chips) 
Seat 3: ZTP0 ($17.18 in chips) 
Seat 5: 123tiger711a ($10.36 in chips) 
Seat 6: dmg3000 ($15.44 in chips) 
123tiger711a: posts small blind $0.05
dmg3000: posts big blind $0.10
*** HOLE CARDS ***
Dealt to PlayTheBlues4U [8d Js]
csxwe: folds 
PlayTheBlues4U: folds 
ZTP0: folds 
123tiger711a: calls $0.05
dmg3000: raises $0.20 to $0.30
123tiger711a: folds 
Uncalled bet ($0.20) returned to dmg3000
dmg3000 collected $0.20 from pot
*** SUMMARY ***
Total pot $0.20 | Rake $0 
Seat 1: csxwe folded before Flop (didn't bet)
Seat 2: PlayTheBlues4U folded before Flop (didn't bet)
Seat 3: ZTP0 (button) folded before Flop (didn't bet)
Seat 5: 123tiger711a (small blind) folded before Flop
Seat 6: dmg3000 (big blind) collected ($0.20)



PokerStars Hand #205009475221:  Hold'em No Limit ($0.05/$0.10 USD) - 2019/10/24 20:57:39 ET
Table 'Alrami' 6-max Seat #5 is the button
Seat 1: csxwe ($23.83 in chips) 
Seat 2: PlayTheBlues4U ($9.85 in chips) 
Seat 3: ZTP0 ($17.18 in chips) 
Seat 5: 123tiger711a ($10.26 in chips) 
Seat 6: dmg3000 ($15.54 in chips) 
dmg3000: posts small blind $0.05
csxwe: posts big blind $0.10
*** HOLE CARDS ***
Dealt to PlayTheBlues4U [7d Td]
PlayTheBlues4U: folds 
ZTP0: folds 
123tiger711a: calls $0.10
dmg3000: raises $0.30 to $0.40
csxwe: folds 
123tiger711a: calls $0.30
*** FLOP *** [7h 2d 5c]
dmg3000: bets $0.30
123tiger711a: calls $0.30
*** TURN *** [7h 2d 5c] [6s]
dmg3000: checks 
123tiger711a: checks 
*** RIVER *** [7h 2d 5c 6s] [Kh]
dmg3000: bets $0.50
123tiger711a: folds 
Uncalled bet ($0.50) returned to dmg3000
dmg3000 collected $1.42 from pot
*** SUMMARY ***
Total pot $1.50 | Rake $0.08 
Board [7h 2d 5c 6s Kh]
Seat 1: csxwe (big blind) folded before Flop
Seat 2: PlayTheBlues4U folded before Flop (didn't bet)
Seat 3: ZTP0 folded before Flop (didn't bet)
Seat 5: 123tiger711a (button) folded on the River
Seat 6: dmg3000 (small blind) collected ($1.42)



PokerStars Hand #205009475413:  Hold'em No Limit ($0.05/$0.10 USD) - 2019/10/24 20:58:28 ET
Table 'Alrami' 6-max Seat #6 is the button
Seat 1: csxwe ($23.73 in chips) 
Seat 2: PlayTheBlues4U ($9.85 in chips) 
Seat 3: ZTP0 ($17.18 in chips) 
Seat 5: 123tiger711a ($10 in chips) 
Seat 6: dmg3000 ($16.26 in chips) 
csxwe: posts small blind $0.05
PlayTheBlues4U: posts big blind $0.10
*** HOLE CARDS ***
Dealt to PlayTheBlues4U [4c 7d]
ZTP0: folds 
123tiger711a: folds 
dmg3000: folds 
csxwe: calls $0.05
PlayTheBlues4U: raises $0.20 to $0.30
csxwe: calls $0.20
*** FLOP *** [Td Kh 2h]
csxwe: checks 
PlayTheBlues4U: bets $0.30
csxwe: folds 
Uncalled bet ($0.30) returned to PlayTheBlues4U
PlayTheBlues4U collected $0.57 from pot
PlayTheBlues4U: doesn't show hand 
*** SUMMARY ***
Total pot $0.60 | Rake $0.03 
Board [Td Kh 2h]
Seat 1: csxwe (small blind) folded on the Flop
Seat 2: PlayTheBlues4U (big blind) collected ($0.57)
Seat 3: ZTP0 folded before Flop (didn't bet)
Seat 5: 123tiger711a folded before Flop (didn't bet)
Seat 6: dmg3000 (button) folded before Flop (didn't bet)



PokerStars Hand #205009475574:  Hold'em No Limit ($0.05/$0.10 USD) - 2019/10/24 20:59:14 ET
Table 'Alrami' 6-max Seat #1 is the button
Seat 1: csxwe ($23.43 in chips) 
Seat 2: PlayTheBlues4U ($10.12 in chips) 
Seat 3: ZTP0 ($17.18 in chips) 
Seat 5: 123tiger711a ($10 in chips) 
Seat 6: dmg3000 ($16.26 in chips) 
PlayTheBlues4U: posts small blind $0.05
ZTP0: posts big blind $0.10
*** HOLE CARDS ***
Dealt to PlayTheBlues4U [4d 6h]
123tiger711a: folds 
dmg3000: raises $0.20 to $0.30
csxwe: folds 
PlayTheBlues4U: folds 
ZTP0: folds 
Uncalled bet ($0.20) returned to dmg3000
dmg3000 collected $0.25 from pot
*** SUMMARY ***
Total pot $0.25 | Rake $0 
Seat 1: csxwe (button) folded before Flop (didn't bet)
Seat 2: PlayTheBlues4U (small blind) folded before Flop
Seat 3: ZTP0 (big blind) folded before Flop
Seat 5: 123tiger711a folded before Flop (didn't bet)
Seat 6: dmg3000 collected ($0.25)



PokerStars Hand #205009475642:  Hold'em No Limit ($0.05/$0.10 USD) - 2019/10/24 20:59:31 ET
Table 'Alrami' 6-max Seat #2 is the button
Seat 1: csxwe ($23.43 in chips) 
Seat 2: PlayTheBlues4U ($10.07 in chips) 
Seat 3: ZTP0 ($17.08 in chips) 
Seat 5: 123tiger711a ($10 in chips) 
Seat 6: dmg3000 ($16.41 in chips) 
ZTP0: posts small blind $0.05
123tiger711a: posts big blind $0.10
*** HOLE CARDS ***
Dealt to PlayTheBlues4U [5c 9s]
dmg3000: folds 
csxwe: folds 
PlayTheBlues4U: folds 
ZTP0: raises $0.20 to $0.30
123tiger711a: calls $0.20
*** FLOP *** [3c 8s 5s]
ZTP0: bets $0.30
123tiger711a: folds 
Uncalled bet ($0.30) returned to ZTP0
ZTP0 collected $0.57 from pot
ZTP0: doesn't show hand 
*** SUMMARY ***
Total pot $0.60 | Rake $0.03 
Board [3c 8s 5s]
Seat 1: csxwe folded before Flop (didn't bet)
Seat 2: PlayTheBlues4U (button) folded before Flop (didn't bet)
Seat 3: ZTP0 (small blind) collected ($0.57)
Seat 5: 123tiger711a (big blind) folded on the Flop
Seat 6: dmg3000 folded before Flop (didn't bet)



PokerStars Hand #205009475732:  Hold'em No Limit ($0.05/$0.10 USD) - 2019/10/24 20:59:55 ET
Table 'Alrami' 6-max Seat #3 is the button
Seat 1: csxwe ($23.43 in chips) 
Seat 2: PlayTheBlues4U ($10.07 in chips) 
Seat 3: ZTP0 ($17.35 in chips) 
Seat 5: 123tiger711a ($10 in chips) 
Seat 6: dmg3000 ($16.41 in chips) 
123tiger711a: posts small blind $0.05
dmg3000: posts big blind $0.10
*** HOLE CARDS ***
Dealt to PlayTheBlues4U [7h 3d]
csxwe: calls $0.10
PlayTheBlues4U: folds 
ZTP0: raises $0.20 to $0.30
123tiger711a: folds 
dmg3000: folds 
csxwe: calls $0.20
*** FLOP *** [Jh Kd 6h]
csxwe: checks 
ZTP0: bets $0.36
csxwe: calls $0.36
*** TURN *** [Jh Kd 6h] [4d]
csxwe: checks 
ZTP0: bets $0.90
csxwe: calls $0.90
*** RIVER *** [Jh Kd 6h 4d] [2s]
csxwe: checks 
ZTP0: bets $3.11
csxwe: raises $18.76 to $21.87 and is all-in
ZTP0: folds 
Uncalled bet ($18.76) returned to csxwe
csxwe collected $9.02 from pot
csxwe: doesn't show hand 
*** SUMMARY ***
Total pot $9.49 | Rake $0.47 
Board [Jh Kd 6h 4d 2s]
Seat 1: csxwe collected ($9.02)
Seat 2: PlayTheBlues4U folded before Flop (didn't bet)
Seat 3: ZTP0 (button) folded on the River
Seat 5: 123tiger711a (small blind) folded before Flop
Seat 6: dmg3000 (big blind) folded before Flop



PokerStars Hand #205009475980:  Hold'em No Limit ($0.05/$0.10 USD) - 2019/10/24 21:00:53 ET
Table 'Alrami' 6-max Seat #5 is the button
Seat 1: csxwe ($27.78 in chips) 
Seat 2: PlayTheBlues4U ($10.07 in chips) 
Seat 3: ZTP0 ($12.68 in chips) 
Seat 5: 123tiger711a ($10 in chips) 
Seat 6: dmg3000 ($16.31 in chips) 
dmg3000: posts small blind $0.05
csxwe: posts big blind $0.10
*** HOLE CARDS ***
Dealt to PlayTheBlues4U [2d 9d]
PlayTheBlues4U: folds 
ZTP0: raises $0.20 to $0.30
123tiger711a: folds 
dmg3000: folds 
csxwe: folds 
Uncalled bet ($0.20) returned to ZTP0
ZTP0 collected $0.25 from pot
ZTP0: doesn't show hand 
*** SUMMARY ***
Total pot $0.25 | Rake $0 
Seat 1: csxwe (big blind) folded before Flop
Seat 2: PlayTheBlues4U folded before Flop (didn't bet)
Seat 3: ZTP0 collected ($0.25)
Seat 5: 123tiger711a (button) folded before Flop (didn't bet)
Seat 6: dmg3000 (small blind) folded before Flop



PokerStars Hand #205009476089:  Hold'em No Limit ($0.05/$0.10 USD) - 2019/10/24 21:01:16 ET
Table 'Alrami' 6-max Seat #6 is the button
Seat 1: csxwe ($27.68 in chips) 
Seat 2: PlayTheBlues4U ($10.07 in chips) 
Seat 3: ZTP0 ($12.83 in chips) 
Seat 5: 123tiger711a ($10 in chips) 
Seat 6: dmg3000 ($16.26 in chips) 
csxwe: posts small blind $0.05
PlayTheBlues4U: posts big blind $0.10
*** HOLE CARDS ***
Dealt to PlayTheBlues4U [Jc 9d]
ZTP0: folds 
123tiger711a: calls $0.10
ZTP0 leaves the table
dmg3000: raises $0.20 to $0.30
csxwe: folds 
PlayTheBlues4U: folds 
123tiger711a: calls $0.20
*** FLOP *** [Qc Ts 6s]
123tiger711a: checks 
dmg3000: checks 
*** TURN *** [Qc Ts 6s] [4d]
123tiger711a: bets $0.36
dmg3000: calls $0.36
*** RIVER *** [Qc Ts 6s 4d] [3d]
123tiger711a: bets $0.70
dmg3000: raises $1.40 to $2.10
123tiger711a: calls $1.40
*** SHOW DOWN ***
dmg3000: shows [4c 4s] (three of a kind, Fours)
123tiger711a: mucks hand 
dmg3000 collected $5.39 from pot
*** SUMMARY ***
Total pot $5.67 | Rake $0.28 
Board [Qc Ts 6s 4d 3d]
Seat 1: csxwe (small blind) folded before Flop
Seat 2: PlayTheBlues4U (big blind) folded before Flop
Seat 3: ZTP0 folded before Flop (didn't bet)
Seat 5: 123tiger711a mucked [8c Tc]
Seat 6: dmg3000 (button) showed [4c 4s] and won ($5.39) with three of a kind, Fours



PokerStars Hand #205009476279:  Hold'em No Limit ($0.05/$0.10 USD) - 2019/10/24 21:02:00 ET
Table 'Alrami' 6-max Seat #1 is the button
Seat 1: csxwe ($27.63 in chips) 
Seat 2: PlayTheBlues4U ($9.97 in chips) 
Seat 5: 123tiger711a ($10 in chips) 
Seat 6: dmg3000 ($18.89 in chips) 
PlayTheBlues4U: posts small blind $0.05
123tiger711a: posts big blind $0.10
*** HOLE CARDS ***
Dealt to PlayTheBlues4U [Kd 8c]
dmg3000: folds 
csxwe: folds 
PlayTheBlues4U: calls $0.05
123tiger711a: checks 
*** FLOP *** [7s 8d Ad]
PlayTheBlues4U: checks 
123tiger711a: bets $0.10
PlayTheBlues4U: calls $0.10
*** TURN *** [7s 8d Ad] [Qs]
PlayTheBlues4U: checks 
123tiger711a: bets $0.38
PlayTheBlues4U: folds 
Uncalled bet ($0.38) returned to 123tiger711a
123tiger711a collected $0.38 from pot
*** SUMMARY ***
Total pot $0.40 | Rake $0.02 
Board [7s 8d Ad Qs]
Seat 1: csxwe (button) folded before Flop (didn't bet)
Seat 2: PlayTheBlues4U (small blind) folded on the Turn
Seat 5: 123tiger711a (big blind) collected ($0.38)
Seat 6: dmg3000 folded before Flop (didn't bet)



PokerStars Hand #205009476432:  Hold'em No Limit ($0.05/$0.10 USD) - 2019/10/24 21:02:33 ET
Table 'Alrami' 6-max Seat #2 is the button
Seat 1: csxwe ($27.63 in chips) 
Seat 2: PlayTheBlues4U ($9.77 in chips) 
Seat 5: 123tiger711a ($10.18 in chips) 
Seat 6: dmg3000 ($18.89 in chips) 
123tiger711a: posts small blind $0.05
dmg3000: posts big blind $0.10
*** HOLE CARDS ***
Dealt to PlayTheBlues4U [2d 2c]
csxwe: folds 
PlayTheBlues4U: raises $0.20 to $0.30
123tiger711a: folds 
dmg3000: calls $0.20
*** FLOP *** [5d 3h Jc]
dmg3000: bets $0.31
PlayTheBlues4U: folds 
Uncalled bet ($0.31) returned to dmg3000
dmg3000 collected $0.62 from pot
*** SUMMARY ***
Total pot $0.65 | Rake $0.03 
Board [5d 3h Jc]
Seat 1: csxwe folded before Flop (didn't bet)
Seat 2: PlayTheBlues4U (button) folded on the Flop
Seat 5: 123tiger711a (small blind) folded before Flop
Seat 6: dmg3000 (big blind) collected ($0.62)



PokerStars Hand #205009476549:  Hold'em No Limit ($0.05/$0.10 USD) - 2019/10/24 21:02:59 ET
Table 'Alrami' 6-max Seat #5 is the button
Seat 1: csxwe ($27.63 in chips) 
Seat 2: PlayTheBlues4U ($9.47 in chips) 
Seat 5: 123tiger711a ($10.13 in chips) 
Seat 6: dmg3000 ($19.21 in chips) 
dmg3000: posts small blind $0.05
csxwe: posts big blind $0.10
*** HOLE CARDS ***
Dealt to PlayTheBlues4U [Th 5d]
PlayTheBlues4U: folds 
123tiger711a: calls $0.10
dmg3000: raises $0.10 to $0.20
csxwe: folds 
123tiger711a: calls $0.10
*** FLOP *** [2c 9h Jd]
dmg3000: checks 
123tiger711a: bets $0.24
dmg3000: folds 
Uncalled bet ($0.24) returned to 123tiger711a
123tiger711a collected $0.48 from pot
*** SUMMARY ***
Total pot $0.50 | Rake $0.02 
Board [2c 9h Jd]
Seat 1: csxwe (big blind) folded before Flop
Seat 2: PlayTheBlues4U folded before Flop (didn't bet)
Seat 5: 123tiger711a (button) collected ($0.48)
Seat 6: dmg3000 (small blind) folded on the Flop



PokerStars Hand #205009476662:  Hold'em No Limit ($0.05/$0.10 USD) - 2019/10/24 21:03:24 ET
Table 'Alrami' 6-max Seat #6 is the button
Seat 1: csxwe ($27.53 in chips) 
Seat 2: PlayTheBlues4U ($9.47 in chips) 
Seat 5: 123tiger711a ($10.41 in chips) 
Seat 6: dmg3000 ($19.01 in chips) 
csxwe: posts small blind $0.05
PlayTheBlues4U: posts big blind $0.10
*** HOLE CARDS ***
Dealt to PlayTheBlues4U [Js 8d]
123tiger711a: calls $0.10
dmg3000: raises $0.30 to $0.40
csxwe: folds 
PlayTheBlues4U: folds 
123tiger711a: calls $0.30
*** FLOP *** [9c Ad Kh]
123tiger711a: checks 
dmg3000: checks 
*** TURN *** [9c Ad Kh] [Jh]
123tiger711a: bets $0.45
dmg3000: folds 
Uncalled bet ($0.45) returned to 123tiger711a
123tiger711a collected $0.90 from pot
*** SUMMARY ***
Total pot $0.95 | Rake $0.05 
Board [9c Ad Kh Jh]
Seat 1: csxwe (small blind) folded before Flop
Seat 2: PlayTheBlues4U (big blind) folded before Flop
Seat 5: 123tiger711a collected ($0.90)
Seat 6: dmg3000 (button) folded on the Turn



PokerStars Hand #205009476792:  Hold'em No Limit ($0.05/$0.10 USD) - 2019/10/24 21:03:52 ET
Table 'Alrami' 6-max Seat #1 is the button
Seat 1: csxwe ($27.48 in chips) 
Seat 2: PlayTheBlues4U ($9.37 in chips) 
Seat 6: dmg3000 ($18.61 in chips) 
PlayTheBlues4U: posts small blind $0.05
123tiger711a: is sitting out 
dmg3000: posts big blind $0.10
*** HOLE CARDS ***
Dealt to PlayTheBlues4U [6d 2c]
DaGoodz33 joins the table at seat #3 
csxwe: raises $0.10 to $0.20
123tiger711a leaves the table
PlayTheBlues4U: folds 
dmg3000: calls $0.10
*** FLOP *** [8h 4d As]
crazy turfer joins the table at seat #4 
dmg3000: checks 
csxwe: bets $0.20
dmg3000: folds 
Uncalled bet ($0.20) returned to csxwe
csxwe collected $0.43 from pot
csxwe: doesn't show hand 
*** SUMMARY ***
Total pot $0.45 | Rake $0.02 
Board [8h 4d As]
Seat 1: csxwe (button) collected ($0.43)
Seat 2: PlayTheBlues4U (small blind) folded before Flop
Seat 6: dmg3000 (big blind) folded on the Flop



PokerStars Hand #205009476910:  Hold'em No Limit ($0.05/$0.10 USD) - 2019/10/24 21:04:16 ET
Table 'Alrami' 6-max Seat #2 is the button
Seat 1: csxwe ($27.71 in chips) 
Seat 2: PlayTheBlues4U ($9.32 in chips) 
Seat 6: dmg3000 ($18.41 in chips) 
dmg3000: posts small blind $0.05
csxwe: posts big blind $0.10
*** HOLE CARDS ***
Dealt to PlayTheBlues4U [2c 8h]
csxwe said, "hi good "
PlayTheBlues4U: folds 
dmg3000: calls $0.05
Mo8791 joins the table at seat #5 
csxwe: checks 
*** FLOP *** [4s 8c 7d]
dmg3000: checks 
csxwe: checks 
*** TURN *** [4s 8c 7d] [Qc]
dmg3000: checks 
csxwe: checks 
*** RIVER *** [4s 8c 7d Qc] [5d]
dmg3000: checks 
csxwe: checks 
*** SHOW DOWN ***
dmg3000: shows [4h 3s] (a pair of Fours)
csxwe: shows [5c Ks] (a pair of Fives)
csxwe collected $0.19 from pot
*** SUMMARY ***
Total pot $0.20 | Rake $0.01 
Board [4s 8c 7d Qc 5d]
Seat 1: csxwe (big blind) showed [5c Ks] and won ($0.19) with a pair of Fives
Seat 2: PlayTheBlues4U (button) folded before Flop (didn't bet)
Seat 6: dmg3000 (small blind) showed [4h 3s] and lost with a pair of Fours



PokerStars Hand #205009477099:  Hold'em No Limit ($0.05/$0.10 USD) - 2019/10/24 21:04:58 ET
Table 'Alrami' 6-max Seat #6 is the button
Seat 1: csxwe ($27.80 in chips) 
Seat 2: PlayTheBlues4U ($9.32 in chips) 
Seat 4: crazy turfer ($8 in chips) 
Seat 5: Mo8791 ($10 in chips) 
Seat 6: dmg3000 ($18.31 in chips) 
csxwe: posts small blind $0.05
PlayTheBlues4U: posts big blind $0.10
DaGoodz33: sits out 
crazy turfer: posts big blind $0.10
Mo8791: posts big blind $0.10
*** HOLE CARDS ***
Dealt to PlayTheBlues4U [8c 2d]
crazy turfer: raises $0.10 to $0.20
Mo8791: calls $0.10
dmg3000: raises $0.20 to $0.40
csxwe: folds 
PlayTheBlues4U: folds 
crazy turfer: calls $0.20
Mo8791: calls $0.20
*** FLOP *** [6d 3h Tc]
crazy turfer: checks 
Mo8791: checks 
dmg3000: checks 
*** TURN *** [6d 3h Tc] [Ts]
crazy turfer: checks 
Mo8791: bets $0.60
dmg3000: folds 
crazy turfer: calls $0.60
*** RIVER *** [6d 3h Tc Ts] [7c]
crazy turfer: checks 
Mo8791: bets $1.30
crazy turfer: calls $1.30
*** SHOW DOWN ***
Mo8791: shows [3d 3s] (a full house, Threes full of Tens)
crazy turfer: mucks hand 
Mo8791 collected $4.89 from pot
*** SUMMARY ***
Total pot $5.15 | Rake $0.26 
Board [6d 3h Tc Ts 7c]
Seat 1: csxwe (small blind) folded before Flop
Seat 2: PlayTheBlues4U (big blind) folded before Flop
Seat 4: crazy turfer mucked [Ac 9c]
Seat 5: Mo8791 showed [3d 3s] and won ($4.89) with a full house, Threes full of Tens
Seat 6: dmg3000 (button) folded on the Turn



PokerStars Hand #205009477504:  Hold'em No Limit ($0.05/$0.10 USD) - 2019/10/24 21:06:29 ET
Table 'Alrami' 6-max Seat #1 is the button
Seat 1: csxwe ($27.75 in chips) 
Seat 2: PlayTheBlues4U ($9.22 in chips) 
Seat 3: DaGoodz33 ($11.46 in chips) 
Seat 4: crazy turfer ($5.70 in chips) 
Seat 5: Mo8791 ($12.59 in chips) 
Seat 6: dmg3000 ($17.91 in chips) 
PlayTheBlues4U: posts small blind $0.05
DaGoodz33: posts big blind $0.10
*** HOLE CARDS ***
Dealt to PlayTheBlues4U [Ts 7s]
crazy turfer: raises $0.20 to $0.30
Mo8791: calls $0.30
dmg3000: raises $1.05 to $1.35
csxwe: folds 
PlayTheBlues4U: folds 
DaGoodz33: folds 
crazy turfer: calls $1.05
Mo8791: folds 
*** FLOP *** [4s Jc Kc]
crazy turfer: checks 
dmg3000: checks 
*** TURN *** [4s Jc Kc] [6h]
crazy turfer: checks 
dmg3000: bets $1.50
crazy turfer: folds 
Uncalled bet ($1.50) returned to dmg3000
dmg3000 collected $2.99 from pot
*** SUMMARY ***
Total pot $3.15 | Rake $0.16 
Board [4s Jc Kc 6h]
Seat 1: csxwe (button) folded before Flop (didn't bet)
Seat 2: PlayTheBlues4U (small blind) folded before Flop
Seat 3: DaGoodz33 (big blind) folded before Flop
Seat 4: crazy turfer folded on the Turn
Seat 5: Mo8791 folded before Flop
Seat 6: dmg3000 collected ($2.99)



PokerStars Hand #205009477689:  Hold'em No Limit ($0.05/$0.10 USD) - 2019/10/24 21:07:15 ET
Table 'Alrami' 6-max Seat #2 is the button
Seat 1: csxwe ($27.75 in chips) 
Seat 2: PlayTheBlues4U ($9.17 in chips) 
Seat 3: DaGoodz33 ($11.36 in chips) 
Seat 4: crazy turfer ($4.35 in chips) 
Seat 5: Mo8791 ($12.29 in chips) 
Seat 6: dmg3000 ($19.55 in chips) 
DaGoodz33: posts small blind $0.05
crazy turfer: posts big blind $0.10
*** HOLE CARDS ***
Dealt to PlayTheBlues4U [5h 6s]
Mo8791: raises $0.20 to $0.30
dmg3000: raises $0.75 to $1.05
csxwe: folds 
PlayTheBlues4U: folds 
DaGoodz33: folds 
crazy turfer: folds 
Mo8791: calls $0.75
*** FLOP *** [7d Ad 3d]
Mo8791: checks 
dmg3000: checks 
*** TURN *** [7d Ad 3d] [Ts]
Mo8791: bets $2.10
dmg3000: folds 
Uncalled bet ($2.10) returned to Mo8791
Mo8791 collected $2.14 from pot
Mo8791: doesn't show hand 
*** SUMMARY ***
Total pot $2.25 | Rake $0.11 
Board [7d Ad 3d Ts]
Seat 1: csxwe folded before Flop (didn't bet)
Seat 2: PlayTheBlues4U (button) folded before Flop (didn't bet)
Seat 3: DaGoodz33 (small blind) folded before Flop
Seat 4: crazy turfer (big blind) folded before Flop
Seat 5: Mo8791 collected ($2.14)
Seat 6: dmg3000 folded on the Turn



PokerStars Hand #205009477894:  Hold'em No Limit ($0.05/$0.10 USD) - 2019/10/24 21:08:06 ET
Table 'Alrami' 6-max Seat #3 is the button
Seat 1: csxwe ($27.75 in chips) 
Seat 2: PlayTheBlues4U ($9.17 in chips) 
Seat 3: DaGoodz33 ($11.31 in chips) 
Seat 4: crazy turfer ($4.25 in chips) 
Seat 5: Mo8791 ($13.38 in chips) 
Seat 6: dmg3000 ($18.50 in chips) 
crazy turfer: posts small blind $0.05
Mo8791: posts big blind $0.10
*** HOLE CARDS ***
Dealt to PlayTheBlues4U [7d Ks]
dmg3000: raises $0.25 to $0.35
csxwe: folds 
PlayTheBlues4U: folds 
DaGoodz33: folds 
crazy turfer: folds 
Mo8791: folds 
Uncalled bet ($0.25) returned to dmg3000
dmg3000 collected $0.25 from pot
*** SUMMARY ***
Total pot $0.25 | Rake $0 
Seat 1: csxwe folded before Flop (didn't bet)
Seat 2: PlayTheBlues4U folded before Flop (didn't bet)
Seat 3: DaGoodz33 (button) folded before Flop (didn't bet)
Seat 4: crazy turfer (small blind) folded before Flop
Seat 5: Mo8791 (big blind) folded before Flop
Seat 6: dmg3000 collected ($0.25)



PokerStars Hand #205009477995:  Hold'em No Limit ($0.05/$0.10 USD) - 2019/10/24 21:08:30 ET
Table 'Alrami' 6-max Seat #4 is the button
Seat 1: csxwe ($27.75 in chips) 
Seat 2: PlayTheBlues4U ($9.17 in chips) 
Seat 3: DaGoodz33 ($11.31 in chips) 
Seat 4: crazy turfer ($4.20 in chips) 
Seat 5: Mo8791 ($13.28 in chips) 
Seat 6: dmg3000 ($18.65 in chips) 
Mo8791: posts small blind $0.05
dmg3000: posts big blind $0.10
*** HOLE CARDS ***
Dealt to PlayTheBlues4U [2d 9c]
csxwe: folds 
PlayTheBlues4U: folds 
DaGoodz33: raises $0.25 to $0.35
crazy turfer: folds 
Mo8791: folds 
dmg3000: folds 
Uncalled bet ($0.25) returned to DaGoodz33
dmg3000 leaves the table
DaGoodz33 collected $0.25 from pot
DaGoodz33: doesn't show hand 
*** SUMMARY ***
Total pot $0.25 | Rake $0 
Seat 1: csxwe folded before Flop (didn't bet)
Seat 2: PlayTheBlues4U folded before Flop (didn't bet)
Seat 3: DaGoodz33 collected ($0.25)
Seat 4: crazy turfer (button) folded before Flop (didn't bet)
Seat 5: Mo8791 (small blind) folded before Flop
Seat 6: dmg3000 (big blind) folded before Flop



PokerStars Hand #205009478074:  Hold'em No Limit ($0.05/$0.10 USD) - 2019/10/24 21:08:48 ET
Table 'Alrami' 6-max Seat #5 is the button
Seat 1: csxwe ($27.75 in chips) 
Seat 2: PlayTheBlues4U ($9.17 in chips) 
Seat 3: DaGoodz33 ($11.46 in chips) 
Seat 4: crazy turfer ($4.20 in chips) 
Seat 5: Mo8791 ($13.23 in chips) 
csxwe: posts small blind $0.05
PlayTheBlues4U: posts big blind $0.10
*** HOLE CARDS ***
Dealt to PlayTheBlues4U [Tc 2s]
DaGoodz33: calls $0.10
crazy turfer: folds 
Mo8791: calls $0.10
csxwe: folds 
PlayTheBlues4U: checks 
*** FLOP *** [3d 3c 8c]
PlayTheBlues4U: checks 
DaGoodz33: bets $0.33
Mo8791: folds 
PlayTheBlues4U: folds 
Uncalled bet ($0.33) returned to DaGoodz33
DaGoodz33 collected $0.33 from pot
DaGoodz33: doesn't show hand 
*** SUMMARY ***
Total pot $0.35 | Rake $0.02 
Board [3d 3c 8c]
Seat 1: csxwe (small blind) folded before Flop
Seat 2: PlayTheBlues4U (big blind) folded on the Flop
Seat 3: DaGoodz33 collected ($0.33)
Seat 4: crazy turfer folded before Flop (didn't bet)
Seat 5: Mo8791 (button) folded on the Flop



PokerStars Hand #205009478208:  Hold'em No Limit ($0.05/$0.10 USD) - 2019/10/24 21:09:19 ET
Table 'Alrami' 6-max Seat #1 is the button
Seat 1: csxwe ($27.70 in chips) 
Seat 2: PlayTheBlues4U ($9.07 in chips) 
Seat 4: crazy turfer ($4.20 in chips) 
Seat 5: Mo8791 ($13.13 in chips) 
PlayTheBlues4U: posts small blind $0.05
DaGoodz33: is sitting out 
crazy turfer: posts big blind $0.10
*** HOLE CARDS ***
Dealt to PlayTheBlues4U [7d Js]
Mo8791: folds 
csxwe: folds 
PlayTheBlues4U: folds 
Uncalled bet ($0.05) returned to crazy turfer
crazy turfer collected $0.10 from pot
*** SUMMARY ***
Total pot $0.10 | Rake $0 
Seat 1: csxwe (button) folded before Flop (didn't bet)
Seat 2: PlayTheBlues4U (small blind) folded before Flop
Seat 4: crazy turfer (big blind) collected ($0.10)
Seat 5: Mo8791 folded before Flop (didn't bet)



PokerStars Hand #205009478257:  Hold'em No Limit ($0.05/$0.10 USD) - 2019/10/24 21:09:30 ET
Table 'Alrami' 6-max Seat #2 is the button
Seat 1: csxwe ($27.70 in chips) 
Seat 2: PlayTheBlues4U ($9.02 in chips) 
Seat 4: crazy turfer ($4.25 in chips) 
Seat 5: Mo8791 ($13.13 in chips) 
crazy turfer: posts small blind $0.05
Mo8791: posts big blind $0.10
*** HOLE CARDS ***
Dealt to PlayTheBlues4U [3s 7c]
csxwe: folds 
PlayTheBlues4U: folds 
crazy turfer: raises $0.10 to $0.20
Mo8791: calls $0.10
*** FLOP *** [5c Jd Tc]
crazy turfer: checks 
Mo8791: checks 
*** TURN *** [5c Jd Tc] [Th]
crazy turfer: checks 
Mo8791: checks 
*** RIVER *** [5c Jd Tc Th] [4c]
crazy turfer: checks 
Mo8791: bets $0.20
crazy turfer: folds 
Uncalled bet ($0.20) returned to Mo8791
Mo8791 collected $0.38 from pot
Mo8791: doesn't show hand 
*** SUMMARY ***
Total pot $0.40 | Rake $0.02 
Board [5c Jd Tc Th 4c]
Seat 1: csxwe folded before Flop (didn't bet)
Seat 2: PlayTheBlues4U (button) folded before Flop (didn't bet)
Seat 4: crazy turfer (small blind) folded on the River
Seat 5: Mo8791 (big blind) collected ($0.38)



PokerStars Hand #205009478505:  Hold'em No Limit ($0.05/$0.10 USD) - 2019/10/24 21:10:26 ET
Table 'Alrami' 6-max Seat #4 is the button
Seat 1: csxwe ($27.70 in chips) 
Seat 2: PlayTheBlues4U ($9.02 in chips) 
Seat 4: crazy turfer ($8.05 in chips) 
Seat 5: Mo8791 ($13.31 in chips) 
Mo8791: posts small blind $0.05
csxwe: posts big blind $0.10
*** HOLE CARDS ***
Dealt to PlayTheBlues4U [8h Qh]
PlayTheBlues4U: folds 
crazy turfer: calls $0.10
Mo8791: calls $0.05
csxwe: checks 
*** FLOP *** [7h 4s 8d]
Mo8791: checks 
csxwe: bets $0.10
crazy turfer: calls $0.10
Mo8791: calls $0.10
*** TURN *** [7h 4s 8d] [Js]
Mo8791: checks 
DaGoodz33 leaves the table
csxwe: checks 
crazy turfer: checks 
*** RIVER *** [7h 4s 8d Js] [6s]
Mo8791: checks 
csxwe: bets $0.60
crazy turfer: folds 
Mo8791: calls $0.60
*** SHOW DOWN ***
csxwe: shows [9c Ts] (a straight, Seven to Jack)
Mo8791: mucks hand 
csxwe collected $1.71 from pot
*** SUMMARY ***
Total pot $1.80 | Rake $0.09 
Board [7h 4s 8d Js 6s]
Seat 1: csxwe (big blind) showed [9c Ts] and won ($1.71) with a straight, Seven to Jack
Seat 2: PlayTheBlues4U folded before Flop (didn't bet)
Seat 4: crazy turfer (button) folded on the River
Seat 5: Mo8791 (small blind) mucked [5s 5c]



PokerStars Hand #205009478678:  Hold'em No Limit ($0.05/$0.10 USD) - 2019/10/24 21:11:06 ET
Table 'Alrami' 6-max Seat #5 is the button
Seat 1: csxwe ($28.61 in chips) 
Seat 2: PlayTheBlues4U ($9.02 in chips) 
Seat 4: crazy turfer ($7.85 in chips) 
Seat 5: Mo8791 ($12.51 in chips) 
csxwe: posts small blind $0.05
PlayTheBlues4U: posts big blind $0.10
*** HOLE CARDS ***
Dealt to PlayTheBlues4U [2c Kc]
crazy turfer: calls $0.10
Mo8791: calls $0.10
csxwe: calls $0.05
PlayTheBlues4U: checks 
*** FLOP *** [4s Jd 7d]
csxwe: checks 
PlayTheBlues4U: checks 
crazy turfer: bets $0.40
Mo8791: folds 
csxwe: folds 
PlayTheBlues4U: folds 
Uncalled bet ($0.40) returned to crazy turfer
crazy turfer collected $0.38 from pot
*** SUMMARY ***
Total pot $0.40 | Rake $0.02 
Board [4s Jd 7d]
Seat 1: csxwe (small blind) folded on the Flop
Seat 2: PlayTheBlues4U (big blind) folded on the Flop
Seat 4: crazy turfer collected ($0.38)
Seat 5: Mo8791 (button) folded on the Flop



PokerStars Hand #205009478866:  Hold'em No Limit ($0.05/$0.10 USD) - 2019/10/24 21:11:48 ET
Table 'Alrami' 6-max Seat #1 is the button
Seat 1: csxwe ($28.51 in chips) 
Seat 2: PlayTheBlues4U ($8.92 in chips) 
Seat 4: crazy turfer ($8.13 in chips) 
Seat 5: Mo8791 ($12.41 in chips) 
PlayTheBlues4U: posts small blind $0.05
crazy turfer: posts big blind $0.10
*** HOLE CARDS ***
Dealt to PlayTheBlues4U [Ac Kd]
SuWasup joins the table at seat #3 
Mo8791: raises $0.20 to $0.30
csxwe: folds 
PlayTheBlues4U: raises $0.60 to $0.90
crazy turfer: folds 
Mo8791: calls $0.60
*** FLOP *** [7d 9s 5d]
PlayTheBlues4U: checks 
Mo8791: checks 
*** TURN *** [7d 9s 5d] [Kc]
PlayTheBlues4U: bets $1.20
Mo8791: calls $1.20
*** RIVER *** [7d 9s 5d Kc] [5c]
PlayTheBlues4U: bets $2.10
SuWasup leaves the table
Mo8791: calls $2.10
*** SHOW DOWN ***
PlayTheBlues4U: shows [Ac Kd] (two pair, Kings and Fives)
Mo8791: mucks hand 
PlayTheBlues4U collected $8.08 from pot
*** SUMMARY ***
Total pot $8.50 | Rake $0.42 
Board [7d 9s 5d Kc 5c]
Seat 1: csxwe (button) folded before Flop (didn't bet)
Seat 2: PlayTheBlues4U (small blind) showed [Ac Kd] and won ($8.08) with two pair, Kings and Fives
Seat 4: crazy turfer (big blind) folded before Flop
Seat 5: Mo8791 mucked [9h Qc]



PokerStars Hand #205009479241:  Hold'em No Limit ($0.05/$0.10 USD) - 2019/10/24 21:13:15 ET
Table 'Alrami' 6-max Seat #2 is the button
Seat 1: csxwe ($28.51 in chips) 
Seat 2: PlayTheBlues4U ($12.80 in chips) 
Seat 4: crazy turfer ($8.03 in chips) 
Seat 5: Mo8791 ($8.21 in chips) 
crazy turfer: posts small blind $0.05
Mo8791: posts big blind $0.10
*** HOLE CARDS ***
Dealt to PlayTheBlues4U [Qc Kh]
csxwe: calls $0.10
PlayTheBlues4U: raises $0.30 to $0.40
crazy turfer: folds 
Mo8791: folds 
csxwe: calls $0.30
*** FLOP *** [Ks 2s 6d]
csxwe: checks 
PlayTheBlues4U: bets $0.50
csxwe: folds 
Uncalled bet ($0.50) returned to PlayTheBlues4U
PlayTheBlues4U collected $0.90 from pot
PlayTheBlues4U: doesn't show hand 
*** SUMMARY ***
Total pot $0.95 | Rake $0.05 
Board [Ks 2s 6d]
Seat 1: csxwe folded on the Flop
Seat 2: PlayTheBlues4U (button) collected ($0.90)
Seat 4: crazy turfer (small blind) folded before Flop
Seat 5: Mo8791 (big blind) folded before Flop



PokerStars Hand #205009479381:  Hold'em No Limit ($0.05/$0.10 USD) - 2019/10/24 21:13:45 ET
Table 'Alrami' 6-max Seat #4 is the button
Seat 1: csxwe ($28.11 in chips) 
Seat 2: PlayTheBlues4U ($13.30 in chips) 
Seat 4: crazy turfer ($7.98 in chips) 
Seat 5: Mo8791 ($8.11 in chips) 
Mo8791: posts small blind $0.05
csxwe: posts big blind $0.10
*** HOLE CARDS ***
Dealt to PlayTheBlues4U [3d 5h]
PlayTheBlues4U: folds 
crazy turfer: raises $0.10 to $0.20
Mo8791: folds 
csxwe: calls $0.10
*** FLOP *** [2h 7c Kd]
csxwe: checks 
crazy turfer: checks 
*** TURN *** [2h 7c Kd] [Qc]
csxwe: checks 
crazy turfer: checks 
*** RIVER *** [2h 7c Kd Qc] [3h]
csxwe: checks 
crazy turfer: checks 
*** SHOW DOWN ***
csxwe: shows [9c 8c] (high card King)
crazy turfer: shows [Td Jh] (high card King - Queen+Jack kicker)
crazy turfer collected $0.43 from pot
*** SUMMARY ***
Total pot $0.45 | Rake $0.02 
Board [2h 7c Kd Qc 3h]
Seat 1: csxwe (big blind) showed [9c 8c] and lost with high card King
Seat 2: PlayTheBlues4U folded before Flop (didn't bet)
Seat 4: crazy turfer (button) showed [Td Jh] and won ($0.43) with high card King
Seat 5: Mo8791 (small blind) folded before Flop



PokerStars Hand #205009479535:  Hold'em No Limit ($0.05/$0.10 USD) - 2019/10/24 21:14:17 ET
Table 'Alrami' 6-max Seat #5 is the button
Seat 1: csxwe ($27.91 in chips) 
Seat 2: PlayTheBlues4U ($13.30 in chips) 
Seat 4: crazy turfer ($8.21 in chips) 
Seat 5: Mo8791 ($8.06 in chips) 
csxwe: posts small blind $0.05
PlayTheBlues4U: posts big blind $0.10
*** HOLE CARDS ***
Dealt to PlayTheBlues4U [8c Jd]
crazy turfer: calls $0.10
Mo8791: calls $0.10
csxwe: calls $0.05
PlayTheBlues4U: checks 
*** FLOP *** [Jh 3c Td]
csxwe: checks 
PlayTheBlues4U: checks 
crazy turfer: checks 
Mo8791: checks 
*** TURN *** [Jh 3c Td] [2s]
csxwe: checks 
PlayTheBlues4U: bets $0.20
crazy turfer: folds 
Mo8791: calls $0.20
csxwe: folds 
*** RIVER *** [Jh 3c Td 2s] [3s]
PlayTheBlues4U: checks 
Mo8791: bets $0.80
PlayTheBlues4U: calls $0.80
*** SHOW DOWN ***
Mo8791: shows [Qs 8d] (a pair of Threes)
PlayTheBlues4U: shows [8c Jd] (two pair, Jacks and Threes)
PlayTheBlues4U collected $2.28 from pot
*** SUMMARY ***
Total pot $2.40 | Rake $0.12 
Board [Jh 3c Td 2s 3s]
Seat 1: csxwe (small blind) folded on the Turn
Seat 2: PlayTheBlues4U (big blind) showed [8c Jd] and won ($2.28) with two pair, Jacks and Threes
Seat 4: crazy turfer folded on the Turn
Seat 5: Mo8791 (button) showed [Qs 8d] and lost with a pair of Threes



PokerStars Hand #205009479922:  Hold'em No Limit ($0.05/$0.10 USD) - 2019/10/24 21:15:43 ET
Table 'Alrami' 6-max Seat #1 is the button
Seat 1: csxwe ($27.81 in chips) 
Seat 2: PlayTheBlues4U ($14.48 in chips) 
Seat 4: crazy turfer ($8.11 in chips) 
Seat 5: Mo8791 ($6.96 in chips) 
PlayTheBlues4U: posts small blind $0.05
crazy turfer: posts big blind $0.10
*** HOLE CARDS ***
Dealt to PlayTheBlues4U [Qh Ah]
Mo8791: folds 
csxwe: raises $0.10 to $0.20
PlayTheBlues4U: raises $0.40 to $0.60
crazy turfer: folds 
csxwe: calls $0.40
*** FLOP *** [2d 4c 7d]
PlayTheBlues4U: checks 
csxwe: checks 
*** TURN *** [2d 4c 7d] [Js]
PlayTheBlues4U: bets $0.70
csxwe: calls $0.70
*** RIVER *** [2d 4c 7d Js] [Qd]
Mo8791 is disconnected 
PlayTheBlues4U: bets $1.70
csxwe: folds 
Uncalled bet ($1.70) returned to PlayTheBlues4U
PlayTheBlues4U collected $2.56 from pot
PlayTheBlues4U: doesn't show hand 
*** SUMMARY ***
Total pot $2.70 | Rake $0.14 
Board [2d 4c 7d Js Qd]
Seat 1: csxwe (button) folded on the River
Seat 2: PlayTheBlues4U (small blind) collected ($2.56)
Seat 4: crazy turfer (big blind) folded before Flop
Seat 5: Mo8791 folded before Flop (didn't bet)



PokerStars Hand #205010162254:  Hold'em No Limit ($0.05/$0.10 USD) - 2019/10/24 21:16:34 ET
Table 'Alrami' 6-max Seat #2 is the button
Seat 1: csxwe ($26.51 in chips) 
Seat 2: PlayTheBlues4U ($15.74 in chips) 
Seat 4: crazy turfer ($8.01 in chips) 
Seat 5: Mo8791 ($6.96 in chips) 
crazy turfer: posts small blind $0.05
Mo8791 is connected 
Mo8791: posts big blind $0.10
*** HOLE CARDS ***
Dealt to PlayTheBlues4U [Qs 2d]
csxwe: folds 
PlayTheBlues4U: folds 
crazy turfer: calls $0.05
Mo8791: checks 
*** FLOP *** [7c 4s 9s]
crazy turfer: checks 
Mo8791: checks 
*** TURN *** [7c 4s 9s] [7h]
crazy turfer: checks 
Mo8791: checks 
*** RIVER *** [7c 4s 9s 7h] [3s]
crazy turfer: checks 
Mo8791: checks 
*** SHOW DOWN ***
crazy turfer: shows [Kh 3d] (two pair, Sevens and Threes)
Mo8791: mucks hand 
crazy turfer collected $0.19 from pot
*** SUMMARY ***
Total pot $0.20 | Rake $0.01 
Board [7c 4s 9s 7h 3s]
Seat 1: csxwe folded before Flop (didn't bet)
Seat 2: PlayTheBlues4U (button) folded before Flop (didn't bet)
Seat 4: crazy turfer (small blind) showed [Kh 3d] and won ($0.19) with two pair, Sevens and Threes
Seat 5: Mo8791 (big blind) mucked [8h 2c]



PokerStars Hand #205010162482:  Hold'em No Limit ($0.05/$0.10 USD) - 2019/10/24 21:17:23 ET
Table 'Alrami' 6-max Seat #4 is the button
Seat 1: csxwe ($26.51 in chips) 
Seat 2: PlayTheBlues4U ($15.74 in chips) 
Seat 4: crazy turfer ($8.10 in chips) 
Seat 5: Mo8791 ($6.86 in chips) 
Mo8791: posts small blind $0.05
csxwe: posts big blind $0.10
*** HOLE CARDS ***
Dealt to PlayTheBlues4U [7d 6c]
PlayTheBlues4U: folds 
crazy turfer: folds 
Mo8791: raises $0.20 to $0.30
csxwe: folds 
Uncalled bet ($0.20) returned to Mo8791
Mo8791 collected $0.20 from pot
Mo8791: doesn't show hand 
*** SUMMARY ***
Total pot $0.20 | Rake $0 
Seat 1: csxwe (big blind) folded before Flop
Seat 2: PlayTheBlues4U folded before Flop (didn't bet)
Seat 4: crazy turfer (button) folded before Flop (didn't bet)
Seat 5: Mo8791 (small blind) collected ($0.20)



PokerStars Hand #205010162681:  Hold'em No Limit ($0.05/$0.10 USD) - 2019/10/24 21:18:08 ET
Table 'Alrami' 6-max Seat #5 is the button
Seat 1: csxwe ($26.41 in chips) 
Seat 2: PlayTheBlues4U ($15.74 in chips) 
Seat 4: crazy turfer ($8.10 in chips) 
Seat 5: Mo8791 ($6.96 in chips) 
csxwe: posts small blind $0.05
PlayTheBlues4U: posts big blind $0.10
*** HOLE CARDS ***
Dealt to PlayTheBlues4U [5c 4s]
crazy turfer: folds 
Mo8791: folds 
csxwe: folds 
Uncalled bet ($0.05) returned to PlayTheBlues4U
PlayTheBlues4U collected $0.10 from pot
PlayTheBlues4U: doesn't show hand 
*** SUMMARY ***
Total pot $0.10 | Rake $0 
Seat 1: csxwe (small blind) folded before Flop
Seat 2: PlayTheBlues4U (big blind) collected ($0.10)
Seat 4: crazy turfer folded before Flop (didn't bet)
Seat 5: Mo8791 (button) folded before Flop (didn't bet)



PokerStars Hand #205010162737:  Hold'em No Limit ($0.05/$0.10 USD) - 2019/10/24 21:18:22 ET
Table 'Alrami' 6-max Seat #1 is the button
Seat 1: csxwe ($26.36 in chips) 
Seat 2: PlayTheBlues4U ($15.79 in chips) 
Seat 4: crazy turfer ($8.10 in chips) 
Seat 5: Mo8791 ($6.96 in chips) 
PlayTheBlues4U: posts small blind $0.05
crazy turfer: posts big blind $0.10
*** HOLE CARDS ***
Dealt to PlayTheBlues4U [4s 8c]
Mo8791: folds 
csxwe: raises $0.20 to $0.30
PlayTheBlues4U: folds 
crazy turfer: folds 
Uncalled bet ($0.20) returned to csxwe
csxwe collected $0.25 from pot
csxwe: doesn't show hand 
*** SUMMARY ***
Total pot $0.25 | Rake $0 
Seat 1: csxwe (button) collected ($0.25)
Seat 2: PlayTheBlues4U (small blind) folded before Flop
Seat 4: crazy turfer (big blind) folded before Flop
Seat 5: Mo8791 folded before Flop (didn't bet)



PokerStars Hand #205010162793:  Hold'em No Limit ($0.05/$0.10 USD) - 2019/10/24 21:18:35 ET
Table 'Alrami' 6-max Seat #2 is the button
Seat 1: csxwe ($26.51 in chips) 
Seat 2: PlayTheBlues4U ($15.74 in chips) 
Seat 4: crazy turfer ($8 in chips) 
Seat 5: Mo8791 ($6.96 in chips) 
crazy turfer: posts small blind $0.05
Mo8791: posts big blind $0.10
*** HOLE CARDS ***
Dealt to PlayTheBlues4U [Kd 2s]
csxwe: calls $0.10
PlayTheBlues4U: folds 
crazy turfer: raises $0.30 to $0.40
Mo8791: folds 
csxwe: calls $0.30
*** FLOP *** [6h Kh Js]
crazy turfer: bets $0.40
csxwe: folds 
Uncalled bet ($0.40) returned to crazy turfer
crazy turfer collected $0.86 from pot
*** SUMMARY ***
Total pot $0.90 | Rake $0.04 
Board [6h Kh Js]
Seat 1: csxwe folded on the Flop
Seat 2: PlayTheBlues4U (button) folded before Flop (didn't bet)
Seat 4: crazy turfer (small blind) collected ($0.86)
Seat 5: Mo8791 (big blind) folded before Flop



PokerStars Hand #205010162914:  Hold'em No Limit ($0.05/$0.10 USD) - 2019/10/24 21:19:02 ET
Table 'Alrami' 6-max Seat #4 is the button
Seat 1: csxwe ($26.11 in chips) 
Seat 2: PlayTheBlues4U ($15.74 in chips) 
Seat 4: crazy turfer ($8.46 in chips) 
Seat 5: Mo8791 ($6.86 in chips) 
Mo8791: posts small blind $0.05
csxwe: posts big blind $0.10
*** HOLE CARDS ***
Dealt to PlayTheBlues4U [Th Qs]
PlayTheBlues4U: raises $0.20 to $0.30
crazy turfer: calls $0.30
Mo8791: folds 
csxwe: folds 
*** FLOP *** [4c 3h Js]
PlayTheBlues4U: bets $0.20
crazy turfer: calls $0.20
*** TURN *** [4c 3h Js] [Kh]
PlayTheBlues4U: checks 
crazy turfer: checks 
*** RIVER *** [4c 3h Js Kh] [2s]
PlayTheBlues4U: checks 
crazy turfer: checks 
*** SHOW DOWN ***
PlayTheBlues4U: shows [Th Qs] (high card King)
crazy turfer: mucks hand 
PlayTheBlues4U collected $1.09 from pot
*** SUMMARY ***
Total pot $1.15 | Rake $0.06 
Board [4c 3h Js Kh 2s]
Seat 1: csxwe (big blind) folded before Flop
Seat 2: PlayTheBlues4U showed [Th Qs] and won ($1.09) with high card King
Seat 4: crazy turfer (button) mucked [Ts 9s]
Seat 5: Mo8791 (small blind) folded before Flop



PokerStars Hand #205010163042:  Hold'em No Limit ($0.05/$0.10 USD) - 2019/10/24 21:19:31 ET
Table 'Alrami' 6-max Seat #5 is the button
Seat 1: csxwe ($26.01 in chips) 
Seat 2: PlayTheBlues4U ($16.33 in chips) 
Seat 4: crazy turfer ($7.96 in chips) 
Seat 5: Mo8791 ($6.81 in chips) 
csxwe: posts small blind $0.05
PlayTheBlues4U: posts big blind $0.10
*** HOLE CARDS ***
Dealt to PlayTheBlues4U [2d 4c]
crazy turfer: raises $0.10 to $0.20
Mo8791: raises $0.10 to $0.30
csxwe: folds 
PlayTheBlues4U: folds 
crazy turfer: calls $0.10
*** FLOP *** [2h Qc 4s]
crazy turfer: checks 
Mo8791: checks 
*** TURN *** [2h Qc 4s] [4h]
crazy turfer: bets $0.10
Mo8791: calls $0.10
*** RIVER *** [2h Qc 4s 4h] [4d]
crazy turfer: checks 
Mo8791: checks 
*** SHOW DOWN ***
crazy turfer: shows [6d Ac] (three of a kind, Fours)
Mo8791: shows [Jc As] (three of a kind, Fours)
PlayTheBlues4U said, "folded 24 lol"
crazy turfer collected $0.45 from pot
Mo8791 collected $0.45 from pot
*** SUMMARY ***
Total pot $0.95 | Rake $0.05 
Board [2h Qc 4s 4h 4d]
Seat 1: csxwe (small blind) folded before Flop
Seat 2: PlayTheBlues4U (big blind) folded before Flop
Seat 4: crazy turfer showed [6d Ac] and won ($0.45) with three of a kind, Fours
Seat 5: Mo8791 (button) showed [Jc As] and won ($0.45) with three of a kind, Fours



PokerStars Hand #205010163292:  Hold'em No Limit ($0.05/$0.10 USD) - 2019/10/24 21:20:26 ET
Table 'Alrami' 6-max Seat #1 is the button
Seat 1: csxwe ($25.96 in chips) 
Seat 2: PlayTheBlues4U ($16.23 in chips) 
Seat 4: crazy turfer ($8.01 in chips) 
Seat 5: Mo8791 ($6.86 in chips) 
PlayTheBlues4U: posts small blind $0.05
crazy turfer: posts big blind $0.10
*** HOLE CARDS ***
Dealt to PlayTheBlues4U [Jh 4h]
Mo8791: folds 
csxwe: folds 
PlayTheBlues4U: calls $0.05
crazy turfer: checks 
*** FLOP *** [Qh 3c 6s]
PlayTheBlues4U: checks 
crazy turfer: bets $0.20
PlayTheBlues4U: folds 
Uncalled bet ($0.20) returned to crazy turfer
crazy turfer collected $0.19 from pot
*** SUMMARY ***
Total pot $0.20 | Rake $0.01 
Board [Qh 3c 6s]
Seat 1: csxwe (button) folded before Flop (didn't bet)
Seat 2: PlayTheBlues4U (small blind) folded on the Flop
Seat 4: crazy turfer (big blind) collected ($0.19)
Seat 5: Mo8791 folded before Flop (didn't bet)



PokerStars Hand #205010163408:  Hold'em No Limit ($0.05/$0.10 USD) - 2019/10/24 21:20:51 ET
Table 'Alrami' 6-max Seat #2 is the button
Seat 1: csxwe ($25.96 in chips) 
Seat 2: PlayTheBlues4U ($16.13 in chips) 
Seat 4: crazy turfer ($8.10 in chips) 
Seat 5: Mo8791 ($6.86 in chips) 
crazy turfer: posts small blind $0.05
Mo8791: posts big blind $0.10
*** HOLE CARDS ***
Dealt to PlayTheBlues4U [5h 6s]
csxwe: raises $0.10 to $0.20
PlayTheBlues4U: folds 
crazy turfer: calls $0.15
Mo8791: calls $0.10
*** FLOP *** [Tc As Ah]
crazy turfer: checks 
Mo8791: checks 
csxwe: checks 
*** TURN *** [Tc As Ah] [7s]
crazy turfer: checks 
Mo8791: checks 
csxwe: checks 
*** RIVER *** [Tc As Ah 7s] [5s]
crazy turfer: checks 
Mo8791: checks 
csxwe: checks 
*** SHOW DOWN ***
crazy turfer: shows [Js Qc] (a pair of Aces)
Mo8791: shows [9c 5c] (two pair, Aces and Fives)
csxwe: mucks hand 
Mo8791 collected $0.57 from pot
*** SUMMARY ***
Total pot $0.60 | Rake $0.03 
Board [Tc As Ah 7s 5s]
Seat 1: csxwe mucked [Kc Qd]
Seat 2: PlayTheBlues4U (button) folded before Flop (didn't bet)
Seat 4: crazy turfer (small blind) showed [Js Qc] and lost with a pair of Aces
Seat 5: Mo8791 (big blind) showed [9c 5c] and won ($0.57) with two pair, Aces and Fives



PokerStars Hand #205010163615:  Hold'em No Limit ($0.05/$0.10 USD) - 2019/10/24 21:21:38 ET
Table 'Alrami' 6-max Seat #4 is the button
Seat 1: csxwe ($25.76 in chips) 
Seat 2: PlayTheBlues4U ($16.13 in chips) 
Seat 4: crazy turfer ($7.90 in chips) 
Seat 5: Mo8791 ($7.23 in chips) 
Mo8791: posts small blind $0.05
csxwe: posts big blind $0.10
*** HOLE CARDS ***
Dealt to PlayTheBlues4U [Tc 3c]
PlayTheBlues4U: folds 
crazy turfer: calls $0.10
Mo8791: calls $0.05
csxwe: checks 
*** FLOP *** [8d Js Kd]
Mo8791: checks 
csxwe: checks 
crazy turfer: bets $0.30
Mo8791: folds 
csxwe: folds 
Uncalled bet ($0.30) returned to crazy turfer
crazy turfer collected $0.28 from pot
*** SUMMARY ***
Total pot $0.30 | Rake $0.02 
Board [8d Js Kd]
Seat 1: csxwe (big blind) folded on the Flop
Seat 2: PlayTheBlues4U folded before Flop (didn't bet)
Seat 4: crazy turfer (button) collected ($0.28)
Seat 5: Mo8791 (small blind) folded on the Flop



PokerStars Hand #205010163875:  Hold'em No Limit ($0.05/$0.10 USD) - 2019/10/24 21:22:34 ET
Table 'Alrami' 6-max Seat #5 is the button
Seat 1: csxwe ($25.66 in chips) 
Seat 2: PlayTheBlues4U ($16.13 in chips) 
Seat 4: crazy turfer ($8.08 in chips) 
Seat 5: Mo8791 ($7.13 in chips) 
csxwe: posts small blind $0.05
PlayTheBlues4U: posts big blind $0.10
*** HOLE CARDS ***
Dealt to PlayTheBlues4U [7c Jd]
crazy turfer: folds 
Mo8791: folds 
csxwe: calls $0.05
PlayTheBlues4U: checks 
*** FLOP *** [5s 5h 8c]
csxwe: checks 
PlayTheBlues4U: checks 
*** TURN *** [5s 5h 8c] [8h]
csxwe: checks 
PlayTheBlues4U: bets $0.10
csxwe: folds 
Uncalled bet ($0.10) returned to PlayTheBlues4U
PlayTheBlues4U collected $0.19 from pot
PlayTheBlues4U: doesn't show hand 
*** SUMMARY ***
Total pot $0.20 | Rake $0.01 
Board [5s 5h 8c 8h]
Seat 1: csxwe (small blind) folded on the Turn
Seat 2: PlayTheBlues4U (big blind) collected ($0.19)
Seat 4: crazy turfer folded before Flop (didn't bet)
Seat 5: Mo8791 (button) folded before Flop (didn't bet)



PokerStars Hand #205010164025:  Hold'em No Limit ($0.05/$0.10 USD) - 2019/10/24 21:23:06 ET
Table 'Alrami' 6-max Seat #1 is the button
Seat 1: csxwe ($25.56 in chips) 
Seat 2: PlayTheBlues4U ($16.22 in chips) 
Seat 4: crazy turfer ($8.08 in chips) 
Seat 5: Mo8791 ($7.13 in chips) 
PlayTheBlues4U: posts small blind $0.05
crazy turfer: posts big blind $0.10
*** HOLE CARDS ***
Dealt to PlayTheBlues4U [8c 2c]
Mo8791: folds 
csxwe: raises $0.20 to $0.30
PlayTheBlues4U: folds 
crazy turfer: folds 
Uncalled bet ($0.20) returned to csxwe
csxwe collected $0.25 from pot
csxwe: doesn't show hand 
*** SUMMARY ***
Total pot $0.25 | Rake $0 
Seat 1: csxwe (button) collected ($0.25)
Seat 2: PlayTheBlues4U (small blind) folded before Flop
Seat 4: crazy turfer (big blind) folded before Flop
Seat 5: Mo8791 folded before Flop (didn't bet)



PokerStars Hand #205010164128:  Hold'em No Limit ($0.05/$0.10 USD) - 2019/10/24 21:23:28 ET
Table 'Alrami' 6-max Seat #2 is the button
Seat 1: csxwe ($25.71 in chips) 
Seat 2: PlayTheBlues4U ($16.17 in chips) 
Seat 4: crazy turfer ($7.98 in chips) 
Seat 5: Mo8791 ($7.13 in chips) 
crazy turfer: posts small blind $0.05
Mo8791: posts big blind $0.10
*** HOLE CARDS ***
Dealt to PlayTheBlues4U [7d 9s]
csxwe: folds 
PlayTheBlues4U: raises $0.20 to $0.30
crazy turfer: folds 
Mo8791: folds 
Uncalled bet ($0.20) returned to PlayTheBlues4U
PlayTheBlues4U collected $0.25 from pot
PlayTheBlues4U: doesn't show hand 
*** SUMMARY ***
Total pot $0.25 | Rake $0 
Seat 1: csxwe folded before Flop (didn't bet)
Seat 2: PlayTheBlues4U (button) collected ($0.25)
Seat 4: crazy turfer (small blind) folded before Flop
Seat 5: Mo8791 (big blind) folded before Flop



PokerStars Hand #205010164284:  Hold'em No Limit ($0.05/$0.10 USD) - 2019/10/24 21:24:01 ET
Table 'Alrami' 6-max Seat #4 is the button
Seat 1: csxwe ($25.71 in chips) 
Seat 2: PlayTheBlues4U ($16.32 in chips) 
Seat 4: crazy turfer ($7.93 in chips) 
Seat 5: Mo8791 ($7.03 in chips) 
Mo8791: posts small blind $0.05
csxwe: posts big blind $0.10
*** HOLE CARDS ***
Dealt to PlayTheBlues4U [4d 3h]
Envoy1006 joins the table at seat #3 
PlayTheBlues4U: folds 
crazy turfer: raises $0.10 to $0.20
Mo8791: calls $0.15
csxwe: calls $0.10
*** FLOP *** [5d 2d Jh]
Redd0412 joins the table at seat #6 
Mo8791: checks 
csxwe: checks 
crazy turfer: bets $0.70
Mo8791: folds 
csxwe: folds 
Uncalled bet ($0.70) returned to crazy turfer
crazy turfer collected $0.57 from pot
*** SUMMARY ***
Total pot $0.60 | Rake $0.03 
Board [5d 2d Jh]
Seat 1: csxwe (big blind) folded on the Flop
Seat 2: PlayTheBlues4U folded before Flop (didn't bet)
Seat 4: crazy turfer (button) collected ($0.57)
Seat 5: Mo8791 (small blind) folded on the Flop



PokerStars Hand #205010164463:  Hold'em No Limit ($0.05/$0.10 USD) - 2019/10/24 21:24:39 ET
Table 'Alrami' 6-max Seat #5 is the button
Seat 1: csxwe ($25.51 in chips) 
Seat 2: PlayTheBlues4U ($16.32 in chips) 
Seat 4: crazy turfer ($8.30 in chips) 
Seat 5: Mo8791 ($6.83 in chips) 
csxwe: posts small blind $0.05
PlayTheBlues4U: posts big blind $0.10
Envoy1006: sits out 
*** HOLE CARDS ***
Dealt to PlayTheBlues4U [5c 6h]
crazy turfer: raises $0.25 to $0.35
Mo8791: folds 
csxwe: calls $0.30
PlayTheBlues4U: folds 
*** FLOP *** [Th 2s Kc]
csxwe: checks 
crazy turfer: bets $0.70
csxwe: folds 
Uncalled bet ($0.70) returned to crazy turfer
crazy turfer collected $0.76 from pot
*** SUMMARY ***
Total pot $0.80 | Rake $0.04 
Board [Th 2s Kc]
Seat 1: csxwe (small blind) folded on the Flop
Seat 2: PlayTheBlues4U (big blind) folded before Flop
Seat 4: crazy turfer collected ($0.76)
Seat 5: Mo8791 (button) folded before Flop (didn't bet)



PokerStars Hand #205010164569:  Hold'em No Limit ($0.05/$0.10 USD) - 2019/10/24 21:25:04 ET
Table 'Alrami' 6-max Seat #1 is the button
Seat 1: csxwe ($25.16 in chips) 
Seat 2: PlayTheBlues4U ($16.22 in chips) 
Seat 3: Envoy1006 ($8 in chips) 
Seat 4: crazy turfer ($8.71 in chips) 
Seat 5: Mo8791 ($6.83 in chips) 
Seat 6: Redd0412 ($10 in chips) 
PlayTheBlues4U: posts small blind $0.05
Envoy1006: posts big blind $0.10
Redd0412: posts big blind $0.10
*** HOLE CARDS ***
Dealt to PlayTheBlues4U [7s 5s]
crazy turfer: folds 
Mo8791: raises $0.20 to $0.30
Redd0412: calls $0.20
csxwe: folds 
PlayTheBlues4U: folds 
Envoy1006: calls $0.20
*** FLOP *** [Kd 7c 9d]
Envoy1006: checks 
Mo8791: bets $0.50
Redd0412: folds 
Envoy1006: calls $0.50
*** TURN *** [Kd 7c 9d] [8h]
Envoy1006: bets $0.90
Mo8791: calls $0.90
*** RIVER *** [Kd 7c 9d 8h] [Ad]
Envoy1006: bets $3.60
Mo8791: calls $3.60
*** SHOW DOWN ***
Envoy1006: shows [Td 6d] (a flush, Ace high)
Mo8791: mucks hand 
Envoy1006 collected $10.40 from pot
*** SUMMARY ***
Total pot $10.95 | Rake $0.55 
Board [Kd 7c 9d 8h Ad]
Seat 1: csxwe (button) folded before Flop (didn't bet)
Seat 2: PlayTheBlues4U (small blind) folded before Flop
Seat 3: Envoy1006 (big blind) showed [Td 6d] and won ($10.40) with a flush, Ace high
Seat 4: crazy turfer folded before Flop (didn't bet)
Seat 5: Mo8791 mucked [Kc As]
Seat 6: Redd0412 folded on the Flop



PokerStars Hand #205010164889:  Hold'em No Limit ($0.05/$0.10 USD) - 2019/10/24 21:26:16 ET
Table 'Alrami' 6-max Seat #2 is the button
Seat 1: csxwe ($25.16 in chips) 
Seat 2: PlayTheBlues4U ($16.17 in chips) 
Seat 3: Envoy1006 ($13.10 in chips) 
Seat 4: crazy turfer ($8.71 in chips) 
Seat 5: Mo8791 ($1.53 in chips) 
Seat 6: Redd0412 ($9.70 in chips) 
Envoy1006: posts small blind $0.05
crazy turfer: posts big blind $0.10
*** HOLE CARDS ***
Dealt to PlayTheBlues4U [Ah 6d]
Mo8791: folds 
Redd0412: raises $0.10 to $0.20
csxwe: folds 
PlayTheBlues4U: folds 
Envoy1006: folds 
crazy turfer: calls $0.10
*** FLOP *** [8h 4d 5h]
crazy turfer: checks 
Redd0412 said, "cmon  csx"
Redd0412 is disconnected 
Redd0412 is connected 
Redd0412: checks 
*** TURN *** [8h 4d 5h] [Jd]
crazy turfer: checks 
Redd0412: bets $0.20
crazy turfer: folds 
Uncalled bet ($0.20) returned to Redd0412
Redd0412 collected $0.43 from pot
Redd0412: doesn't show hand 
*** SUMMARY ***
Total pot $0.45 | Rake $0.02 
Board [8h 4d 5h Jd]
Seat 1: csxwe folded before Flop (didn't bet)
Seat 2: PlayTheBlues4U (button) folded before Flop (didn't bet)
Seat 3: Envoy1006 (small blind) folded before Flop
Seat 4: crazy turfer (big blind) folded on the Turn
Seat 5: Mo8791 folded before Flop (didn't bet)
Seat 6: Redd0412 collected ($0.43)



PokerStars Hand #205010165184:  Hold'em No Limit ($0.05/$0.10 USD) - 2019/10/24 21:27:23 ET
Table 'Alrami' 6-max Seat #3 is the button
Seat 1: csxwe ($25.16 in chips) 
Seat 2: PlayTheBlues4U ($16.17 in chips) 
Seat 3: Envoy1006 ($13.05 in chips) 
Seat 4: crazy turfer ($8.51 in chips) 
Seat 5: Mo8791 ($1.53 in chips) 
Seat 6: Redd0412 ($9.93 in chips) 
crazy turfer: posts small blind $0.05
Mo8791: posts big blind $0.10
*** HOLE CARDS ***
Dealt to PlayTheBlues4U [8c 9s]
Redd0412: calls $0.10
csxwe: folds 
PlayTheBlues4U: folds 
Envoy1006: raises $0.20 to $0.30
crazy turfer: calls $0.25
Mo8791: calls $0.20
Redd0412: calls $0.20
*** FLOP *** [3h 2h Qc]
crazy turfer: checks 
Mo8791: checks 
Redd0412: checks 
Envoy1006: checks 
*** TURN *** [3h 2h Qc] [5h]
crazy turfer: checks 
Mo8791: checks 
Redd0412: checks 
Envoy1006: checks 
*** RIVER *** [3h 2h Qc 5h] [3s]
crazy turfer: checks 
Mo8791: checks 
Redd0412: checks 
Envoy1006: bets $0.60
crazy turfer: folds 
Mo8791: calls $0.60
Redd0412: calls $0.60
*** SHOW DOWN ***
Envoy1006: shows [Jh Kd] (a pair of Threes)
Mo8791: shows [5d Tc] (two pair, Fives and Threes)
Redd0412: shows [6h 6d] (two pair, Sixes and Threes)
Redd0412 collected $2.85 from pot
*** SUMMARY ***
Total pot $3 | Rake $0.15 
Board [3h 2h Qc 5h 3s]
Seat 1: csxwe folded before Flop (didn't bet)
Seat 2: PlayTheBlues4U folded before Flop (didn't bet)
Seat 3: Envoy1006 (button) showed [Jh Kd] and lost with a pair of Threes
Seat 4: crazy turfer (small blind) folded on the River
Seat 5: Mo8791 (big blind) showed [5d Tc] and lost with two pair, Fives and Threes
Seat 6: Redd0412 showed [6h 6d] and won ($2.85) with two pair, Sixes and Threes



PokerStars Hand #205010165461:  Hold'em No Limit ($0.05/$0.10 USD) - 2019/10/24 21:28:28 ET
Table 'Alrami' 6-max Seat #4 is the button
Seat 1: csxwe ($25.16 in chips) 
Seat 2: PlayTheBlues4U ($16.17 in chips) 
Seat 3: Envoy1006 ($12.15 in chips) 
Seat 4: crazy turfer ($8.21 in chips) 
Seat 5: Mo8791 ($0.63 in chips) 
Seat 6: Redd0412 ($11.88 in chips) 
Mo8791: posts small blind $0.05
Redd0412: posts big blind $0.10
*** HOLE CARDS ***
Dealt to PlayTheBlues4U [Ad Ks]
csxwe: calls $0.10
PlayTheBlues4U: raises $0.30 to $0.40
Envoy1006: calls $0.40
crazy turfer: folds 
Mo8791: calls $0.35
Redd0412: calls $0.30
csxwe: calls $0.30
*** FLOP *** [5h Tc 3c]
Mo8791: checks 
Redd0412: checks 
csxwe: checks 
PlayTheBlues4U: checks 
Envoy1006: checks 
*** TURN *** [5h Tc 3c] [As]
Mo8791: checks 
Redd0412: checks 
csxwe: checks 
PlayTheBlues4U: bets $1.20
Envoy1006: folds 
Mo8791: calls $0.23 and is all-in
Redd0412: calls $1.20
csxwe: folds 
*** RIVER *** [5h Tc 3c As] [Js]
Redd0412: checks 
PlayTheBlues4U: bets $2.20
Redd0412: folds 
Uncalled bet ($2.20) returned to PlayTheBlues4U
*** SHOW DOWN ***
PlayTheBlues4U: shows [Ad Ks] (a pair of Aces)
PlayTheBlues4U collected $1.84 from side pot
Mo8791: shows [4s Ts] (a pair of Tens)
PlayTheBlues4U collected $2.56 from main pot
*** SUMMARY ***
Total pot $4.63 Main pot $2.56. Side pot $1.84. | Rake $0.23 
Board [5h Tc 3c As Js]
Seat 1: csxwe folded on the Turn
Seat 2: PlayTheBlues4U showed [Ad Ks] and won ($4.40) with a pair of Aces
Seat 3: Envoy1006 folded on the Turn
Seat 4: crazy turfer (button) folded before Flop (didn't bet)
Seat 5: Mo8791 (small blind) showed [4s Ts] and lost with a pair of Tens
Seat 6: Redd0412 (big blind) folded on the River



PokerStars Hand #205010165855:  Hold'em No Limit ($0.05/$0.10 USD) - 2019/10/24 21:29:59 ET
Table 'Alrami' 6-max Seat #6 is the button
Seat 1: csxwe ($24.76 in chips) 
Seat 2: PlayTheBlues4U ($18.97 in chips) 
Seat 3: Envoy1006 ($11.75 in chips) 
Seat 4: crazy turfer ($8.21 in chips) 
Seat 6: Redd0412 ($10.28 in chips) 
csxwe: posts small blind $0.05
PlayTheBlues4U: posts big blind $0.10
*** HOLE CARDS ***
Dealt to PlayTheBlues4U [Ts 5h]
Envoy1006: folds 
crazy turfer: calls $0.10
Redd0412: folds 
Mo8791 leaves the table
csxwe: calls $0.05
PlayTheBlues4U: checks 
*** FLOP *** [As 8d 4c]
csxwe: checks 
PlayTheBlues4U: checks 
crazy turfer: checks 
*** TURN *** [As 8d 4c] [Qs]
csxwe: checks 
PlayTheBlues4U: checks 
crazy turfer: checks 
*** RIVER *** [As 8d 4c Qs] [6c]
csxwe: bets $0.10
PlayTheBlues4U: folds 
crazy turfer: folds 
Uncalled bet ($0.10) returned to csxwe
csxwe collected $0.28 from pot
davetass joins the table at seat #5 
csxwe: doesn't show hand 
*** SUMMARY ***
Total pot $0.30 | Rake $0.02 
Board [As 8d 4c Qs 6c]
Seat 1: csxwe (small blind) collected ($0.28)
Seat 2: PlayTheBlues4U (big blind) folded on the River
Seat 3: Envoy1006 folded before Flop (didn't bet)
Seat 4: crazy turfer folded on the River
Seat 6: Redd0412 (button) folded before Flop (didn't bet)



PokerStars Hand #205010165999:  Hold'em No Limit ($0.05/$0.10 USD) - 2019/10/24 21:30:34 ET
Table 'Alrami' 6-max Seat #1 is the button
Seat 1: csxwe ($24.94 in chips) 
Seat 2: PlayTheBlues4U ($18.87 in chips) 
Seat 3: Envoy1006 ($11.75 in chips) 
Seat 4: crazy turfer ($8.11 in chips) 
Seat 6: Redd0412 ($10.28 in chips) 
PlayTheBlues4U: posts small blind $0.05
Envoy1006: posts big blind $0.10
davetass: sits out 
*** HOLE CARDS ***
Dealt to PlayTheBlues4U [Ah Ks]
crazy turfer: folds 
Redd0412: calls $0.10
csxwe: folds 
PlayTheBlues4U: raises $0.40 to $0.50
Envoy1006: folds 
Redd0412: calls $0.40
*** FLOP *** [6h Ad 8s]
PlayTheBlues4U: bets $0.60
Redd0412: raises $1.10 to $1.70
PlayTheBlues4U: calls $1.10
*** TURN *** [6h Ad 8s] [Tc]
PlayTheBlues4U: checks 
Redd0412: bets $2.30
PlayTheBlues4U: calls $2.30
*** RIVER *** [6h Ad 8s Tc] [Jc]
PlayTheBlues4U: checks 
Redd0412: checks 
*** SHOW DOWN ***
PlayTheBlues4U: shows [Ah Ks] (a pair of Aces)
Redd0412: mucks hand 
PlayTheBlues4U collected $8.64 from pot
*** SUMMARY ***
Total pot $9.10 | Rake $0.46 
Board [6h Ad 8s Tc Jc]
Seat 1: csxwe (button) folded before Flop (didn't bet)
Seat 2: PlayTheBlues4U (small blind) showed [Ah Ks] and won ($8.64) with a pair of Aces
Seat 3: Envoy1006 (big blind) folded before Flop
Seat 4: crazy turfer folded before Flop (didn't bet)
Seat 6: Redd0412 mucked [3s Ac]



PokerStars Hand #205010166382:  Hold'em No Limit ($0.05/$0.10 USD) - 2019/10/24 21:32:03 ET
Table 'Alrami' 6-max Seat #2 is the button
Seat 1: csxwe ($24.94 in chips) 
Seat 2: PlayTheBlues4U ($23.01 in chips) 
Seat 3: Envoy1006 ($11.65 in chips) 
Seat 4: crazy turfer ($8.11 in chips) 
Seat 5: davetass ($8 in chips) 
Seat 6: Redd0412 ($5.78 in chips) 
Envoy1006: posts small blind $0.05
crazy turfer: posts big blind $0.10
davetass: posts big blind $0.10
*** HOLE CARDS ***
Dealt to PlayTheBlues4U [4c 3s]
davetass: checks 
Redd0412: calls $0.10
csxwe: folds 
PlayTheBlues4U: folds 
Envoy1006: calls $0.05
crazy turfer: checks 
*** FLOP *** [9s Qc 4d]
Envoy1006: checks 
crazy turfer: checks 
davetass: checks 
Redd0412: checks 
*** TURN *** [9s Qc 4d] [3c]
Envoy1006: checks 
crazy turfer: checks 
davetass: checks 
Redd0412: checks 
*** RIVER *** [9s Qc 4d 3c] [Ah]
Envoy1006: checks 
crazy turfer: checks 
davetass: checks 
Redd0412: checks 
*** SHOW DOWN ***
Envoy1006: shows [Ks Th] (high card Ace)
crazy turfer: shows [7h 4s] (a pair of Fours)
davetass: mucks hand 
Redd0412: mucks hand 
crazy turfer collected $0.38 from pot
*** SUMMARY ***
Total pot $0.40 | Rake $0.02 
Board [9s Qc 4d 3c Ah]
Seat 1: csxwe folded before Flop (didn't bet)
Seat 2: PlayTheBlues4U (button) folded before Flop (didn't bet)
Seat 3: Envoy1006 (small blind) showed [Ks Th] and lost with high card Ace
Seat 4: crazy turfer (big blind) showed [7h 4s] and won ($0.38) with a pair of Fours
Seat 5: davetass mucked [8s Td]
Seat 6: Redd0412 mucked [Jc 5c]



PokerStars Hand #205010166502:  Hold'em No Limit ($0.05/$0.10 USD) - 2019/10/24 21:32:31 ET
Table 'Alrami' 6-max Seat #3 is the button
Seat 1: csxwe ($24.94 in chips) 
Seat 2: PlayTheBlues4U ($23.01 in chips) 
Seat 3: Envoy1006 ($11.55 in chips) 
Seat 4: crazy turfer ($8.39 in chips) 
Seat 5: davetass ($7.90 in chips) 
Seat 6: Redd0412 ($5.68 in chips) 
crazy turfer: posts small blind $0.05
davetass: posts big blind $0.10
*** HOLE CARDS ***
Dealt to PlayTheBlues4U [Jd Ks]
Redd0412: folds 
csxwe: folds 
PlayTheBlues4U: raises $0.20 to $0.30
Envoy1006: folds 
crazy turfer: folds 
davetass: calls $0.20
*** FLOP *** [Js Td Ac]
davetass: checks 
PlayTheBlues4U: checks 
*** TURN *** [Js Td Ac] [9c]
davetass: bets $0.30
PlayTheBlues4U: calls $0.30
*** RIVER *** [Js Td Ac 9c] [7h]
davetass: bets $0.60
PlayTheBlues4U: folds 
Uncalled bet ($0.60) returned to davetass
davetass collected $1.19 from pot
davetass: doesn't show hand 
*** SUMMARY ***
Total pot $1.25 | Rake $0.06 
Board [Js Td Ac 9c 7h]
Seat 1: csxwe folded before Flop (didn't bet)
Seat 2: PlayTheBlues4U folded on the River
Seat 3: Envoy1006 (button) folded before Flop (didn't bet)
Seat 4: crazy turfer (small blind) folded before Flop
Seat 5: davetass (big blind) collected ($1.19)
Seat 6: Redd0412 folded before Flop (didn't bet)



PokerStars Hand #205010166732:  Hold'em No Limit ($0.05/$0.10 USD) - 2019/10/24 21:33:23 ET
Table 'Alrami' 6-max Seat #4 is the button
Seat 1: csxwe ($24.94 in chips) 
Seat 2: PlayTheBlues4U ($22.41 in chips) 
Seat 3: Envoy1006 ($11.55 in chips) 
Seat 4: crazy turfer ($8.34 in chips) 
Seat 5: davetass ($8.49 in chips) 
Seat 6: Redd0412 ($5.68 in chips) 
davetass: posts small blind $0.05
Redd0412: posts big blind $0.10
*** HOLE CARDS ***
Dealt to PlayTheBlues4U [3c 3d]
csxwe: folds 
PlayTheBlues4U: calls $0.10
Envoy1006: calls $0.10
crazy turfer: folds 
davetass: calls $0.05
Redd0412: checks 
*** FLOP *** [Qh Td 2c]
davetass: checks 
Redd0412: checks 
PlayTheBlues4U: checks 
Envoy1006: checks 
*** TURN *** [Qh Td 2c] [4h]
davetass: checks 
Redd0412: checks 
PlayTheBlues4U: checks 
Envoy1006: checks 
*** RIVER *** [Qh Td 2c 4h] [9s]
davetass: checks 
Redd0412: checks 
PlayTheBlues4U: checks 
Envoy1006: checks 
*** SHOW DOWN ***
davetass: shows [5d 5h] (a pair of Fives)
Redd0412: mucks hand 
PlayTheBlues4U: mucks hand 
Envoy1006: mucks hand 
davetass collected $0.38 from pot
csxwe said, "Dave chets"
*** SUMMARY ***
Total pot $0.40 | Rake $0.02 
Board [Qh Td 2c 4h 9s]
Seat 1: csxwe folded before Flop (didn't bet)
Seat 2: PlayTheBlues4U mucked [3c 3d]
Seat 3: Envoy1006 mucked [8d Ah]
Seat 4: crazy turfer (button) folded before Flop (didn't bet)
Seat 5: davetass (small blind) showed [5d 5h] and won ($0.38) with a pair of Fives
Seat 6: Redd0412 (big blind) mucked [Kh 6h]



PokerStars Hand #205010166939:  Hold'em No Limit ($0.05/$0.10 USD) - 2019/10/24 21:34:10 ET
Table 'Alrami' 6-max Seat #5 is the button
Seat 1: csxwe ($24.94 in chips) 
Seat 2: PlayTheBlues4U ($22.31 in chips) 
Seat 4: crazy turfer ($8.34 in chips) 
Seat 5: davetass ($8.77 in chips) 
Seat 6: Redd0412 ($5.58 in chips) 
Redd0412: posts small blind $0.05
csxwe: posts big blind $0.10
*** HOLE CARDS ***
Dealt to PlayTheBlues4U [7h 4h]
PlayTheBlues4U: folds 
crazy turfer: calls $0.10
davetass: calls $0.10
Redd0412: calls $0.05
csxwe: checks 
*** FLOP *** [4s 4c 9d]
davetass said, "hehe"
Redd0412: checks 
csxwe: checks 
crazy turfer: checks 
davetass: checks 
*** TURN *** [4s 4c 9d] [3c]
Redd0412: bets $0.20
csxwe: calls $0.20
davetass said, "doing better bud?"
crazy turfer: folds 
davetass: folds 
*** RIVER *** [4s 4c 9d 3c] [8d]
Redd0412: checks 
csxwe: checks 
*** SHOW DOWN ***
Redd0412: shows [3d Ks] (two pair, Fours and Threes)
csxwe: mucks hand 
Redd0412 collected $0.76 from pot
*** SUMMARY ***
Total pot $0.80 | Rake $0.04 
Board [4s 4c 9d 3c 8d]
Seat 1: csxwe (big blind) mucked [3h 5d]
Seat 2: PlayTheBlues4U folded before Flop (didn't bet)
Seat 4: crazy turfer folded on the Turn
Seat 5: davetass (button) folded on the Turn
Seat 6: Redd0412 (small blind) showed [3d Ks] and won ($0.76) with two pair, Fours and Threes



PokerStars Hand #205010167107:  Hold'em No Limit ($0.05/$0.10 USD) - 2019/10/24 21:34:48 ET
Table 'Alrami' 6-max Seat #6 is the button
Seat 1: csxwe ($24.64 in chips) 
Seat 2: PlayTheBlues4U ($22.31 in chips) 
Seat 4: crazy turfer ($8.24 in chips) 
Seat 5: davetass ($8.67 in chips) 
Seat 6: Redd0412 ($6.04 in chips) 
csxwe: posts small blind $0.05
PlayTheBlues4U: posts big blind $0.10
*** HOLE CARDS ***
Dealt to PlayTheBlues4U [5c Ts]
crazy turfer: folds 
davetass: calls $0.10
Redd0412: calls $0.10
csxwe: folds 
PlayTheBlues4U: checks 
*** FLOP *** [As Tc Qc]
PlayTheBlues4U: checks 
davetass: bets $0.10
Redd0412: calls $0.10
csxwe said, "yeah 8.27 better soon"
PlayTheBlues4U: folds 
*** TURN *** [As Tc Qc] [8d]
davetass: checks 
Redd0412: checks 
*** RIVER *** [As Tc Qc 8d] [6s]
clovvnfiesta joins the table at seat #3 
davetass: checks 
csxwe said, ".r7"
Redd0412: bets $0.50
davetass: calls $0.50
*** SHOW DOWN ***
Redd0412: shows [Ad 8h] (two pair, Aces and Eights)
davetass: mucks hand 
Redd0412 collected $1.47 from pot
*** SUMMARY ***
Total pot $1.55 | Rake $0.08 
Board [As Tc Qc 8d 6s]
Seat 1: csxwe (small blind) folded before Flop
Seat 2: PlayTheBlues4U (big blind) folded on the Flop
Seat 4: crazy turfer folded before Flop (didn't bet)
Seat 5: davetass mucked [Td Kc]
Seat 6: Redd0412 (button) showed [Ad 8h] and won ($1.47) with two pair, Aces and Eights



PokerStars Hand #205010167262:  Hold'em No Limit ($0.05/$0.10 USD) - 2019/10/24 21:35:26 ET
Table 'Alrami' 6-max Seat #1 is the button
Seat 1: csxwe ($24.59 in chips) 
Seat 2: PlayTheBlues4U ($22.21 in chips) 
Seat 3: clovvnfiesta ($4 in chips) 
Seat 4: crazy turfer ($8.24 in chips) 
Seat 5: davetass ($7.97 in chips) 
Seat 6: Redd0412 ($6.81 in chips) 
PlayTheBlues4U: posts small blind $0.05
clovvnfiesta: posts big blind $0.10
*** HOLE CARDS ***
Dealt to PlayTheBlues4U [Ac 2s]
crazy turfer: folds 
davetass: calls $0.10
Redd0412: folds 
csxwe: folds 
davetass said, "hopefully ur uo"
PlayTheBlues4U: folds 
clovvnfiesta: checks 
*** FLOP *** [Td 3h 5h]
davetass said, "up"
clovvnfiesta: checks 
davetass: checks 
*** TURN *** [Td 3h 5h] [7d]
clovvnfiesta: bets $0.10
davetass: calls $0.10
*** RIVER *** [Td 3h 5h 7d] [2d]
clovvnfiesta: checks 
davetass: checks 
*** SHOW DOWN ***
clovvnfiesta: shows [Jd 7c] (a pair of Sevens)
davetass: shows [Ts 8h] (a pair of Tens)
davetass collected $0.43 from pot
*** SUMMARY ***
Total pot $0.45 | Rake $0.02 
Board [Td 3h 5h 7d 2d]
Seat 1: csxwe (button) folded before Flop (didn't bet)
Seat 2: PlayTheBlues4U (small blind) folded before Flop
Seat 3: clovvnfiesta (big blind) showed [Jd 7c] and lost with a pair of Sevens
Seat 4: crazy turfer folded before Flop (didn't bet)
Seat 5: davetass showed [Ts 8h] and won ($0.43) with a pair of Tens
Seat 6: Redd0412 folded before Flop (didn't bet)



PokerStars Hand #205010167378:  Hold'em No Limit ($0.05/$0.10 USD) - 2019/10/24 21:35:57 ET
Table 'Alrami' 6-max Seat #2 is the button
Seat 1: csxwe ($24.59 in chips) 
Seat 2: PlayTheBlues4U ($22.16 in chips) 
Seat 3: clovvnfiesta ($3.80 in chips) 
Seat 4: crazy turfer ($8.24 in chips) 
Seat 5: davetass ($8.20 in chips) 
Seat 6: Redd0412 ($6.81 in chips) 
clovvnfiesta: posts small blind $0.05
crazy turfer: posts big blind $0.10
*** HOLE CARDS ***
Dealt to PlayTheBlues4U [7h Qh]
davetass: folds 
Redd0412: calls $0.10
csxwe: folds 
PlayTheBlues4U: folds 
csxwe said, "nah still like 1900 down"
clovvnfiesta: calls $0.05
crazy turfer: checks 
*** FLOP *** [8h Kc Js]
clovvnfiesta: bets $0.10
crazy turfer: calls $0.10
davetass said, "lol"
Redd0412: calls $0.10
*** TURN *** [8h Kc Js] [As]
clovvnfiesta: checks 
crazy turfer: checks 
Redd0412: checks 
*** RIVER *** [8h Kc Js As] [4c]
clovvnfiesta: bets $0.10
davetass said, "issues man u gots issues"
crazy turfer: calls $0.10
Redd0412: folds 
*** SHOW DOWN ***
clovvnfiesta: shows [Kd Ts] (a pair of Kings)
crazy turfer: mucks hand 
clovvnfiesta collected $0.76 from pot
*** SUMMARY ***
Total pot $0.80 | Rake $0.04 
Board [8h Kc Js As 4c]
Seat 1: csxwe folded before Flop (didn't bet)
Seat 2: PlayTheBlues4U (button) folded before Flop (didn't bet)
Seat 3: clovvnfiesta (small blind) showed [Kd Ts] and won ($0.76) with a pair of Kings
Seat 4: crazy turfer (big blind) mucked [3h Jd]
Seat 5: davetass folded before Flop (didn't bet)
Seat 6: Redd0412 folded on the River



PokerStars Hand #205010167543:  Hold'em No Limit ($0.05/$0.10 USD) - 2019/10/24 21:36:40 ET
Table 'Alrami' 6-max Seat #3 is the button
Seat 1: csxwe ($24.59 in chips) 
Seat 2: PlayTheBlues4U ($22.16 in chips) 
Seat 3: clovvnfiesta ($4.26 in chips) 
Seat 4: crazy turfer ($7.94 in chips) 
Seat 5: davetass ($8.20 in chips) 
Seat 6: Redd0412 ($6.61 in chips) 
crazy turfer: posts small blind $0.05
davetass: posts big blind $0.10
*** HOLE CARDS ***
Dealt to PlayTheBlues4U [5h 5d]
csxwe said, "I pay cor cun and gamble"
PlayTheBlues4U said, "we talking about sportsbetting because i resembe that remark"
Redd0412: calls $0.10
csxwe: folds 
PlayTheBlues4U: calls $0.10
clovvnfiesta: folds 
crazy turfer: calls $0.05
davetass: checks 
*** FLOP *** [Qs 4s 4d]
davetass said, "he iz"
crazy turfer: bets $0.10
davetass: folds 
csxwe said, "nah just ooker"
Redd0412: folds 
PlayTheBlues4U: calls $0.10
*** TURN *** [Qs 4s 4d] [2s]
crazy turfer: bets $0.10
PlayTheBlues4U: folds 
Uncalled bet ($0.10) returned to crazy turfer
crazy turfer collected $0.57 from pot
*** SUMMARY ***
Total pot $0.60 | Rake $0.03 
Board [Qs 4s 4d 2s]
Seat 1: csxwe folded before Flop (didn't bet)
Seat 2: PlayTheBlues4U folded on the Turn
Seat 3: clovvnfiesta (button) folded before Flop (didn't bet)
Seat 4: crazy turfer (small blind) collected ($0.57)
Seat 5: davetass (big blind) folded on the Flop
Seat 6: Redd0412 folded on the Flop



PokerStars Hand #205010167706:  Hold'em No Limit ($0.05/$0.10 USD) - 2019/10/24 21:37:20 ET
Table 'Alrami' 6-max Seat #4 is the button
Seat 1: csxwe ($24.59 in chips) 
Seat 2: PlayTheBlues4U ($21.96 in chips) 
Seat 3: clovvnfiesta ($4.26 in chips) 
Seat 4: crazy turfer ($8.31 in chips) 
Seat 5: davetass ($8.10 in chips) 
Seat 6: Redd0412 ($6.51 in chips) 
davetass: posts small blind $0.05
Redd0412: posts big blind $0.10
*** HOLE CARDS ***
Dealt to PlayTheBlues4U [2s 4d]
csxwe: folds 
PlayTheBlues4U said, "ookers?"
PlayTheBlues4U: folds 
clovvnfiesta: folds 
crazy turfer: calls $0.10
davetass: folds 
csxwe said, "poker"
Redd0412: raises $0.10 to $0.20
crazy turfer: calls $0.10
*** FLOP *** [Qh 6c Ad]
davetass said, "dude hes got a bottle in his hand"
Redd0412: bets $0.40
crazy turfer: folds 
Uncalled bet ($0.40) returned to Redd0412
Redd0412 collected $0.43 from pot
Redd0412: doesn't show hand 
*** SUMMARY ***
Total pot $0.45 | Rake $0.02 
Board [Qh 6c Ad]
Seat 1: csxwe folded before Flop (didn't bet)
Seat 2: PlayTheBlues4U folded before Flop (didn't bet)
Seat 3: clovvnfiesta folded before Flop (didn't bet)
Seat 4: crazy turfer (button) folded on the Flop
Seat 5: davetass (small blind) folded before Flop
Seat 6: Redd0412 (big blind) collected ($0.43)



PokerStars Hand #205010167818:  Hold'em No Limit ($0.05/$0.10 USD) - 2019/10/24 21:37:46 ET
Table 'Alrami' 6-max Seat #5 is the button
Seat 1: csxwe ($24.59 in chips) 
Seat 2: PlayTheBlues4U ($21.96 in chips) 
Seat 3: clovvnfiesta ($4.26 in chips) 
Seat 4: crazy turfer ($8.11 in chips) 
Seat 5: davetass ($8.05 in chips) 
Seat 6: Redd0412 ($6.74 in chips) 
Redd0412: posts small blind $0.05
csxwe: posts big blind $0.10
*** HOLE CARDS ***
Dealt to PlayTheBlues4U [As Jc]
PlayTheBlues4U said, "you saying I don't?"
csxwe said, "I sell tilt juice "
PlayTheBlues4U: raises $0.20 to $0.30
clovvnfiesta: folds 
crazy turfer: folds 
davetass: folds 
davetass said, "dan left"
Redd0412: calls $0.25
PlayTheBlues4U said, "fight milk"
csxwe: folds 
*** FLOP *** [7s 8c 7c]
Redd0412: checks 
PlayTheBlues4U: checks 
*** TURN *** [7s 8c 7c] [2h]
Redd0412: checks 
PlayTheBlues4U: checks 
*** RIVER *** [7s 8c 7c 2h] [3s]
Redd0412: checks 
PlayTheBlues4U: checks 
*** SHOW DOWN ***
Redd0412: shows [Jd Kd] (a pair of Sevens)
PlayTheBlues4U: shows [As Jc] (a pair of Sevens - Ace kicker)
PlayTheBlues4U collected $0.66 from pot
*** SUMMARY ***
Total pot $0.70 | Rake $0.04 
Board [7s 8c 7c 2h 3s]
Seat 1: csxwe (big blind) folded before Flop
Seat 2: PlayTheBlues4U showed [As Jc] and won ($0.66) with a pair of Sevens
Seat 3: clovvnfiesta folded before Flop (didn't bet)
Seat 4: crazy turfer folded before Flop (didn't bet)
Seat 5: davetass (button) folded before Flop (didn't bet)
Seat 6: Redd0412 (small blind) showed [Jd Kd] and lost with a pair of Sevens



PokerStars Hand #205010168014:  Hold'em No Limit ($0.05/$0.10 USD) - 2019/10/24 21:38:33 ET
Table 'Alrami' 6-max Seat #6 is the button
Seat 1: csxwe ($24.49 in chips) 
Seat 2: PlayTheBlues4U ($22.32 in chips) 
Seat 3: clovvnfiesta ($4.26 in chips) 
Seat 4: crazy turfer ($8.11 in chips) 
Seat 5: davetass ($8.05 in chips) 
Seat 6: Redd0412 ($6.44 in chips) 
csxwe: posts small blind $0.05
PlayTheBlues4U: posts big blind $0.10
*** HOLE CARDS ***
Dealt to PlayTheBlues4U [Th 8s]
davetass said, "you were drinking the coolaid"
clovvnfiesta: folds 
crazy turfer: folds 
davetass: folds 
Redd0412: calls $0.10
csxwe: folds 
PlayTheBlues4U: checks 
*** FLOP *** [Ts Tc 8d]
csxwe said, "I drink heroin "
PlayTheBlues4U: checks 
Redd0412: bets $0.10
PlayTheBlues4U: calls $0.10
*** TURN *** [Ts Tc 8d] [8h]
PlayTheBlues4U: bets $0.40
davetass said, "thats not good"
Redd0412: raises $0.40 to $0.80
csxwe said, "u try"
csxwe said, "gooood"
PlayTheBlues4U: raises $0.80 to $1.60
Redd0412: folds 
Uncalled bet ($0.80) returned to PlayTheBlues4U
PlayTheBlues4U collected $1.95 from pot
PlayTheBlues4U: doesn't show hand 
*** SUMMARY ***
Total pot $2.05 | Rake $0.10 
Board [Ts Tc 8d 8h]
Seat 1: csxwe (small blind) folded before Flop
Seat 2: PlayTheBlues4U (big blind) collected ($1.95)
Seat 3: clovvnfiesta folded before Flop (didn't bet)
Seat 4: crazy turfer folded before Flop (didn't bet)
Seat 5: davetass folded before Flop (didn't bet)
Seat 6: Redd0412 (button) folded on the Turn



PokerStars Hand #205010168349:  Hold'em No Limit ($0.05/$0.10 USD) - 2019/10/24 21:39:51 ET
Table 'Alrami' 6-max Seat #1 is the button
Seat 1: csxwe ($24.44 in chips) 
Seat 2: PlayTheBlues4U ($23.27 in chips) 
Seat 3: clovvnfiesta ($4.26 in chips) 
Seat 4: crazy turfer ($8.11 in chips) 
Seat 5: davetass ($8.05 in chips) 
Seat 6: Redd0412 ($5.44 in chips) 
PlayTheBlues4U: posts small blind $0.05
clovvnfiesta: posts big blind $0.10
*** HOLE CARDS ***
Dealt to PlayTheBlues4U [9c Qh]
davetass said, "nah my opus x habbit is expensive enough"
crazy turfer: calls $0.10
davetass: folds 
Redd0412: calls $0.10
csxwe: calls $0.10
PlayTheBlues4U said, "i just got 10 new cigars today"
csxwe said, "p ussy"
PlayTheBlues4U: folds 
clovvnfiesta: checks 
*** FLOP *** [As Tc 2s]
clovvnfiesta: checks 
crazy turfer: checks 
Redd0412: checks 
csxwe: checks 
*** TURN *** [As Tc 2s] [7h]
clovvnfiesta: checks 
crazy turfer: bets $0.50
Redd0412: folds 
PlayTheBlues4U said, "mostly montecristo"
csxwe: calls $0.50
davetass said, "heck ive smoked 10 cigars today"
clovvnfiesta: folds 
*** RIVER *** [As Tc 2s 7h] [4s]
crazy turfer: bets $0.70
csxwe: raises $1.40 to $2.10
crazy turfer: folds 
Uncalled bet ($1.40) returned to csxwe
csxwe collected $2.71 from pot
csxwe: doesn't show hand 
*** SUMMARY ***
Total pot $2.85 | Rake $0.14 
Board [As Tc 2s 7h 4s]
Seat 1: csxwe (button) collected ($2.71)
Seat 2: PlayTheBlues4U (small blind) folded before Flop
Seat 3: clovvnfiesta (big blind) folded on the Turn
Seat 4: crazy turfer folded on the River
Seat 5: davetass folded before Flop (didn't bet)
Seat 6: Redd0412 folded on the Turn



PokerStars Hand #205010168621:  Hold'em No Limit ($0.05/$0.10 USD) - 2019/10/24 21:40:59 ET
Table 'Alrami' 6-max Seat #2 is the button
Seat 1: csxwe ($25.85 in chips) 
Seat 2: PlayTheBlues4U ($23.22 in chips) 
Seat 3: clovvnfiesta ($4.16 in chips) 
Seat 4: crazy turfer ($6.81 in chips) 
Seat 5: davetass ($8.05 in chips) 
Seat 6: Redd0412 ($5.34 in chips) 
clovvnfiesta: posts small blind $0.05
crazy turfer: posts big blind $0.10
*** HOLE CARDS ***
Dealt to PlayTheBlues4U [Ac Ad]
PlayTheBlues4U said, "i camping this weekend, they gonna be lost in a tragic serie"
davetass: folds 
Redd0412: calls $0.10
PlayTheBlues4U said, "of small fires"
csxwe: folds 
PlayTheBlues4U: raises $0.30 to $0.40
clovvnfiesta: folds 
crazy turfer: calls $0.30
Redd0412: calls $0.30
*** FLOP *** [Qs 7d 7s]
davetass said, "from the DR?"
crazy turfer: checks 
Redd0412: checks 
PlayTheBlues4U: bets $0.90
crazy turfer: folds 
csxwe said, "have fun blue"
Redd0412: raises $0.90 to $1.80
PlayTheBlues4U: calls $0.90
*** TURN *** [Qs 7d 7s] [6h]
Redd0412: bets $3.14 and is all-in
PlayTheBlues4U: calls $3.14
*** RIVER *** [Qs 7d 7s 6h] [3c]
*** SHOW DOWN ***
Redd0412: shows [9d Qh] (two pair, Queens and Sevens)
PlayTheBlues4U: shows [Ac Ad] (two pair, Aces and Sevens)
PlayTheBlues4U collected $10.57 from pot
*** SUMMARY ***
Total pot $11.13 | Rake $0.56 
Board [Qs 7d 7s 6h 3c]
Seat 1: csxwe folded before Flop (didn't bet)
Seat 2: PlayTheBlues4U (button) showed [Ac Ad] and won ($10.57) with two pair, Aces and Sevens
Seat 3: clovvnfiesta (small blind) folded before Flop
Seat 4: crazy turfer (big blind) folded on the Flop
Seat 5: davetass folded before Flop (didn't bet)
Seat 6: Redd0412 showed [9d Qh] and lost with two pair, Queens and Sevens



PokerStars Hand #205010168845:  Hold'em No Limit ($0.05/$0.10 USD) - 2019/10/24 21:41:51 ET
Table 'Alrami' 6-max Seat #3 is the button
Seat 1: csxwe ($25.85 in chips) 
Seat 2: PlayTheBlues4U ($28.45 in chips) 
Seat 3: clovvnfiesta ($4.11 in chips) 
Seat 4: crazy turfer ($10 in chips) 
Seat 5: davetass ($8.05 in chips) 
crazy turfer: posts small blind $0.05
davetass: posts big blind $0.10
*** HOLE CARDS ***
Dealt to PlayTheBlues4U [7s 5c]
csxwe: folds 
PlayTheBlues4U: folds 
clovvnfiesta: folds 
crazy turfer: raises $0.10 to $0.20
davetass: calls $0.10
*** FLOP *** [Qs 2h Qc]
crazy turfer: checks 
davetass: bets $0.20
crazy turfer: folds 
Uncalled bet ($0.20) returned to davetass
davetass collected $0.38 from pot
csxwe said, "sigh I had dibs on that stack"
davetass: doesn't show hand 
*** SUMMARY ***
Total pot $0.40 | Rake $0.02 
Board [Qs 2h Qc]
Seat 1: csxwe folded before Flop (didn't bet)
Seat 2: PlayTheBlues4U folded before Flop (didn't bet)
Seat 3: clovvnfiesta (button) folded before Flop (didn't bet)
Seat 4: crazy turfer (small blind) folded on the Flop
Seat 5: davetass (big blind) collected ($0.38)



PokerStars Hand #205010168925:  Hold'em No Limit ($0.05/$0.10 USD) - 2019/10/24 21:42:13 ET
Table 'Alrami' 6-max Seat #4 is the button
Seat 1: csxwe ($25.85 in chips) 
Seat 2: PlayTheBlues4U ($28.45 in chips) 
Seat 3: clovvnfiesta ($4.11 in chips) 
Seat 4: crazy turfer ($9.80 in chips) 
Seat 5: davetass ($8.23 in chips) 
davetass: posts small blind $0.05
csxwe: posts big blind $0.10
*** HOLE CARDS ***
Dealt to PlayTheBlues4U [7c 5c]
PlayTheBlues4U: folds 
clovvnfiesta: folds 
crazy turfer: calls $0.10
davetass: calls $0.05
csxwe: checks 
*** FLOP *** [Ks Tc Qh]
davetass: checks 
csxwe: checks 
davetass said, "ha owned"
crazy turfer: checks 
*** TURN *** [Ks Tc Qh] [8d]
davetass: checks 
csxwe: checks 
crazy turfer: checks 
*** RIVER *** [Ks Tc Qh 8d] [8c]
davetass: bets $0.10
csxwe: folds 
crazy turfer: folds 
Uncalled bet ($0.10) returned to davetass
davetass collected $0.28 from pot
davetass: doesn't show hand 
*** SUMMARY ***
Total pot $0.30 | Rake $0.02 
Board [Ks Tc Qh 8d 8c]
Seat 1: csxwe (big blind) folded on the River
Seat 2: PlayTheBlues4U folded before Flop (didn't bet)
Seat 3: clovvnfiesta folded before Flop (didn't bet)
Seat 4: crazy turfer (button) folded on the River
Seat 5: davetass (small blind) collected ($0.28)



PokerStars Hand #205010169056:  Hold'em No Limit ($0.05/$0.10 USD) - 2019/10/24 21:42:43 ET
Table 'Alrami' 6-max Seat #5 is the button
Seat 1: csxwe ($25.75 in chips) 
Seat 2: PlayTheBlues4U ($28.45 in chips) 
Seat 3: clovvnfiesta ($4.11 in chips) 
Seat 4: crazy turfer ($9.70 in chips) 
Seat 5: davetass ($8.41 in chips) 
csxwe: posts small blind $0.05
PlayTheBlues4U: posts big blind $0.10
*** HOLE CARDS ***
Dealt to PlayTheBlues4U [8d Ah]
clovvnfiesta: folds 
crazy turfer: folds 
davetass: folds 
csxwe: folds 
Uncalled bet ($0.05) returned to PlayTheBlues4U
PlayTheBlues4U collected $0.10 from pot
PlayTheBlues4U: doesn't show hand 
*** SUMMARY ***
Total pot $0.10 | Rake $0 
Seat 1: csxwe (small blind) folded before Flop
Seat 2: PlayTheBlues4U (big blind) collected ($0.10)
Seat 3: clovvnfiesta folded before Flop (didn't bet)
Seat 4: crazy turfer folded before Flop (didn't bet)
Seat 5: davetass (button) folded before Flop (didn't bet)



PokerStars Hand #205010169087:  Hold'em No Limit ($0.05/$0.10 USD) - 2019/10/24 21:42:50 ET
Table 'Alrami' 6-max Seat #1 is the button
Seat 1: csxwe ($25.70 in chips) 
Seat 2: PlayTheBlues4U ($28.50 in chips) 
Seat 3: clovvnfiesta ($4.11 in chips) 
Seat 4: crazy turfer ($9.70 in chips) 
Seat 5: davetass ($8.41 in chips) 
PlayTheBlues4U: posts small blind $0.05
clovvnfiesta: posts big blind $0.10
*** HOLE CARDS ***
Dealt to PlayTheBlues4U [7d Ts]
crazy turfer: calls $0.10
davetass: calls $0.10
csxwe: folds 
PlayTheBlues4U: folds 
clovvnfiesta: checks 
*** FLOP *** [7c Td 2c]
clovvnfiesta: checks 
crazy turfer: bets $0.30
davetass: folds 
clovvnfiesta: folds 
Uncalled bet ($0.30) returned to crazy turfer
crazy turfer collected $0.33 from pot
*** SUMMARY ***
Total pot $0.35 | Rake $0.02 
Board [7c Td 2c]
Seat 1: csxwe (button) folded before Flop (didn't bet)
Seat 2: PlayTheBlues4U (small blind) folded before Flop
Seat 3: clovvnfiesta (big blind) folded on the Flop
Seat 4: crazy turfer collected ($0.33)
Seat 5: davetass folded on the Flop



PokerStars Hand #205010169222:  Hold'em No Limit ($0.05/$0.10 USD) - 2019/10/24 21:43:25 ET
Table 'Alrami' 6-max Seat #2 is the button
Seat 1: csxwe ($25.70 in chips) 
Seat 2: PlayTheBlues4U ($28.45 in chips) 
Seat 3: clovvnfiesta ($4.01 in chips) 
Seat 4: crazy turfer ($9.93 in chips) 
Seat 5: davetass ($8.31 in chips) 
clovvnfiesta: posts small blind $0.05
crazy turfer: posts big blind $0.10
*** HOLE CARDS ***
Dealt to PlayTheBlues4U [4h Th]
davetass: folds 
csxwe: raises $0.20 to $0.30
PlayTheBlues4U: folds 
clovvnfiesta: folds 
crazy turfer: calls $0.20
*** FLOP *** [Js Kc 6s]
crazy turfer: bets $0.20
csxwe: calls $0.20
*** TURN *** [Js Kc 6s] [Td]
crazy turfer: bets $0.20
csxwe: folds 
Uncalled bet ($0.20) returned to crazy turfer
crazy turfer collected $1 from pot
*** SUMMARY ***
Total pot $1.05 | Rake $0.05 
Board [Js Kc 6s Td]
Seat 1: csxwe folded on the Turn
Seat 2: PlayTheBlues4U (button) folded before Flop (didn't bet)
Seat 3: clovvnfiesta (small blind) folded before Flop
Seat 4: crazy turfer (big blind) collected ($1)
Seat 5: davetass folded before Flop (didn't bet)



PokerStars Hand #205010169307:  Hold'em No Limit ($0.05/$0.10 USD) - 2019/10/24 21:43:46 ET
Table 'Alrami' 6-max Seat #3 is the button
Seat 1: csxwe ($25.20 in chips) 
Seat 2: PlayTheBlues4U ($28.45 in chips) 
Seat 3: clovvnfiesta ($3.96 in chips) 
Seat 4: crazy turfer ($10.43 in chips) 
Seat 5: davetass ($8.31 in chips) 
crazy turfer: posts small blind $0.05
davetass: posts big blind $0.10
*** HOLE CARDS ***
Dealt to PlayTheBlues4U [7h 6s]
csxwe: folds 
PlayTheBlues4U: folds 
clovvnfiesta: folds 
crazy turfer: calls $0.05
csxwe said, "owned "
davetass: checks 
*** FLOP *** [2s 3c 9h]
crazy turfer: bets $0.10
davetass: calls $0.10
*** TURN *** [2s 3c 9h] [Qh]
crazy turfer: checks 
davetass: checks 
*** RIVER *** [2s 3c 9h Qh] [Ad]
crazy turfer: checks 
davetass: checks 
*** SHOW DOWN ***
crazy turfer: shows [3h 4c] (a pair of Threes)
davetass: shows [7d 9s] (a pair of Nines)
davetass collected $0.38 from pot
*** SUMMARY ***
Total pot $0.40 | Rake $0.02 
Board [2s 3c 9h Qh Ad]
Seat 1: csxwe folded before Flop (didn't bet)
Seat 2: PlayTheBlues4U folded before Flop (didn't bet)
Seat 3: clovvnfiesta (button) folded before Flop (didn't bet)
Seat 4: crazy turfer (small blind) showed [3h 4c] and lost with a pair of Threes
Seat 5: davetass (big blind) showed [7d 9s] and won ($0.38) with a pair of Nines



PokerStars Hand #205010169407:  Hold'em No Limit ($0.05/$0.10 USD) - 2019/10/24 21:44:10 ET
Table 'Alrami' 6-max Seat #4 is the button
Seat 1: csxwe ($25.20 in chips) 
Seat 2: PlayTheBlues4U ($28.45 in chips) 
Seat 3: clovvnfiesta ($3.96 in chips) 
Seat 4: crazy turfer ($10.23 in chips) 
Seat 5: davetass ($8.49 in chips) 
davetass: posts small blind $0.05
csxwe: posts big blind $0.10
*** HOLE CARDS ***
Dealt to PlayTheBlues4U [Qh 7h]
davetass said, "lol"
PlayTheBlues4U: folds 
clovvnfiesta: folds 
crazy turfer: folds 
davetass: folds 
Uncalled bet ($0.05) returned to csxwe
csxwe collected $0.10 from pot
csxwe: doesn't show hand 
*** SUMMARY ***
Total pot $0.10 | Rake $0 
Seat 1: csxwe (big blind) collected ($0.10)
Seat 2: PlayTheBlues4U folded before Flop (didn't bet)
Seat 3: clovvnfiesta folded before Flop (didn't bet)
Seat 4: crazy turfer (button) folded before Flop (didn't bet)
Seat 5: davetass (small blind) folded before Flop



PokerStars Hand #205010169450:  Hold'em No Limit ($0.05/$0.10 USD) - 2019/10/24 21:44:21 ET
Table 'Alrami' 6-max Seat #5 is the button
Seat 1: csxwe ($25.25 in chips) 
Seat 2: PlayTheBlues4U ($28.45 in chips) 
Seat 3: clovvnfiesta ($3.96 in chips) 
Seat 4: crazy turfer ($10.23 in chips) 
Seat 5: davetass ($8.44 in chips) 
csxwe: posts small blind $0.05
PlayTheBlues4U: posts big blind $0.10
*** HOLE CARDS ***
Dealt to PlayTheBlues4U [4c Jh]
clovvnfiesta: folds 
crazy turfer: folds 
davetass: folds 
csxwe: folds 
Uncalled bet ($0.05) returned to PlayTheBlues4U
PlayTheBlues4U collected $0.10 from pot
PlayTheBlues4U: doesn't show hand 
*** SUMMARY ***
Total pot $0.10 | Rake $0 
Seat 1: csxwe (small blind) folded before Flop
Seat 2: PlayTheBlues4U (big blind) collected ($0.10)
Seat 3: clovvnfiesta folded before Flop (didn't bet)
Seat 4: crazy turfer folded before Flop (didn't bet)
Seat 5: davetass (button) folded before Flop (didn't bet)



PokerStars Hand #205010169486:  Hold'em No Limit ($0.05/$0.10 USD) - 2019/10/24 21:44:30 ET
Table 'Alrami' 6-max Seat #1 is the button
Seat 1: csxwe ($25.20 in chips) 
Seat 2: PlayTheBlues4U ($28.50 in chips) 
Seat 3: clovvnfiesta ($3.96 in chips) 
Seat 4: crazy turfer ($10.23 in chips) 
Seat 5: davetass ($8.44 in chips) 
PlayTheBlues4U: posts small blind $0.05
clovvnfiesta: posts big blind $0.10
*** HOLE CARDS ***
Dealt to PlayTheBlues4U [7h Qd]
crazy turfer: calls $0.10
davetass: folds 
csxwe: raises $0.35 to $0.45
PlayTheBlues4U: folds 
clovvnfiesta: folds 
crazy turfer: folds 
Uncalled bet ($0.35) returned to csxwe
csxwe collected $0.35 from pot
csxwe: doesn't show hand 
*** SUMMARY ***
Total pot $0.35 | Rake $0 
Seat 1: csxwe (button) collected ($0.35)
Seat 2: PlayTheBlues4U (small blind) folded before Flop
Seat 3: clovvnfiesta (big blind) folded before Flop
Seat 4: crazy turfer folded before Flop
Seat 5: davetass folded before Flop (didn't bet)



PokerStars Hand #205010169614:  Hold'em No Limit ($0.05/$0.10 USD) - 2019/10/24 21:44:59 ET
Table 'Alrami' 6-max Seat #2 is the button
Seat 1: csxwe ($25.45 in chips) 
Seat 2: PlayTheBlues4U ($28.45 in chips) 
Seat 3: clovvnfiesta ($3.86 in chips) 
Seat 4: crazy turfer ($10.13 in chips) 
Seat 5: davetass ($8.44 in chips) 
clovvnfiesta: posts small blind $0.05
crazy turfer: posts big blind $0.10
*** HOLE CARDS ***
Dealt to PlayTheBlues4U [3h 3s]
davetass: folds 
csxwe: folds 
PlayTheBlues4U: raises $0.10 to $0.20
clovvnfiesta: folds 
crazy turfer: calls $0.10
*** FLOP *** [Js 2d 9h]
crazy turfer: checks 
PlayTheBlues4U: checks 
*** TURN *** [Js 2d 9h] [3d]
crazy turfer: checks 
PlayTheBlues4U: bets $0.40
crazy turfer: folds 
Uncalled bet ($0.40) returned to PlayTheBlues4U
PlayTheBlues4U collected $0.43 from pot
PlayTheBlues4U: doesn't show hand 
*** SUMMARY ***
Total pot $0.45 | Rake $0.02 
Board [Js 2d 9h 3d]
Seat 1: csxwe folded before Flop (didn't bet)
Seat 2: PlayTheBlues4U (button) collected ($0.43)
Seat 3: clovvnfiesta (small blind) folded before Flop
Seat 4: crazy turfer (big blind) folded on the Turn
Seat 5: davetass folded before Flop (didn't bet)



PokerStars Hand #205010169776:  Hold'em No Limit ($0.05/$0.10 USD) - 2019/10/24 21:45:40 ET
Table 'Alrami' 6-max Seat #3 is the button
Seat 1: csxwe ($25.45 in chips) 
Seat 2: PlayTheBlues4U ($28.68 in chips) 
Seat 3: clovvnfiesta ($3.81 in chips) 
Seat 4: crazy turfer ($9.93 in chips) 
Seat 5: davetass ($8.44 in chips) 
crazy turfer: posts small blind $0.05
davetass: posts big blind $0.10
*** HOLE CARDS ***
Dealt to PlayTheBlues4U [2h 5s]
csxwe: calls $0.10
PlayTheBlues4U: folds 
clovvnfiesta: folds 
crazy turfer: calls $0.05
davetass: raises $0.20 to $0.30
csxwe: calls $0.20
crazy turfer: folds 
*** FLOP *** [Ts As 6c]
davetass: bets $0.10
csxwe: calls $0.10
*** TURN *** [Ts As 6c] [5h]
davetass: bets $0.10
csxwe: calls $0.10
*** RIVER *** [Ts As 6c 5h] [9d]
davetass: bets $0.10
csxwe: calls $0.10
*** SHOW DOWN ***
davetass: shows [Ad Tc] (two pair, Aces and Tens)
csxwe: mucks hand 
davetass collected $1.24 from pot
*** SUMMARY ***
Total pot $1.30 | Rake $0.06 
Board [Ts As 6c 5h 9d]
Seat 1: csxwe mucked [9s 7s]
Seat 2: PlayTheBlues4U folded before Flop (didn't bet)
Seat 3: clovvnfiesta (button) folded before Flop (didn't bet)
Seat 4: crazy turfer (small blind) folded before Flop
Seat 5: davetass (big blind) showed [Ad Tc] and won ($1.24) with two pair, Aces and Tens



PokerStars Hand #205010169909:  Hold'em No Limit ($0.05/$0.10 USD) - 2019/10/24 21:46:11 ET
Table 'Alrami' 6-max Seat #4 is the button
Seat 1: csxwe ($24.85 in chips) 
Seat 2: PlayTheBlues4U ($28.68 in chips) 
Seat 3: clovvnfiesta ($3.81 in chips) 
Seat 4: crazy turfer ($9.83 in chips) 
Seat 5: davetass ($9.08 in chips) 
davetass: posts small blind $0.05
csxwe: posts big blind $0.10
*** HOLE CARDS ***
Dealt to PlayTheBlues4U [2h 9c]
PlayTheBlues4U: folds 
clovvnfiesta: folds 
crazy turfer: calls $0.10
davetass: calls $0.05
csxwe: checks 
*** FLOP *** [6h 9h 8s]
davetass: checks 
csxwe: checks 
crazy turfer: bets $0.20
csxwe said, "l.e"
davetass: folds 
csxwe: folds 
Uncalled bet ($0.20) returned to crazy turfer
davetass said, "owned"
crazy turfer collected $0.28 from pot
*** SUMMARY ***
Total pot $0.30 | Rake $0.02 
Board [6h 9h 8s]
Seat 1: csxwe (big blind) folded on the Flop
Seat 2: PlayTheBlues4U folded before Flop (didn't bet)
Seat 3: clovvnfiesta folded before Flop (didn't bet)
Seat 4: crazy turfer (button) collected ($0.28)
Seat 5: davetass (small blind) folded on the Flop



PokerStars Hand #205010169995:  Hold'em No Limit ($0.05/$0.10 USD) - 2019/10/24 21:46:35 ET
Table 'Alrami' 6-max Seat #5 is the button
Seat 1: csxwe ($24.75 in chips) 
Seat 2: PlayTheBlues4U ($28.68 in chips) 
Seat 3: clovvnfiesta ($3.81 in chips) 
Seat 4: crazy turfer ($10.01 in chips) 
Seat 5: davetass ($8.98 in chips) 
csxwe: posts small blind $0.05
PlayTheBlues4U: posts big blind $0.10
*** HOLE CARDS ***
Dealt to PlayTheBlues4U [8d 2c]
csxwe said, "xie"
clovvnfiesta: folds 
crazy turfer: raises $0.10 to $0.20
davetass: folds 
csxwe: folds 
PlayTheBlues4U: folds 
Uncalled bet ($0.10) returned to crazy turfer
crazy turfer collected $0.25 from pot
*** SUMMARY ***
Total pot $0.25 | Rake $0 
Seat 1: csxwe (small blind) folded before Flop
Seat 2: PlayTheBlues4U (big blind) folded before Flop
Seat 3: clovvnfiesta folded before Flop (didn't bet)
Seat 4: crazy turfer collected ($0.25)
Seat 5: davetass (button) folded before Flop (didn't bet)



PokerStars Hand #205010977351:  Hold'em No Limit ($0.05/$0.10 USD) - 2019/10/24 21:46:48 ET
Table 'Alrami' 6-max Seat #1 is the button
Seat 1: csxwe ($24.70 in chips) 
Seat 2: PlayTheBlues4U ($28.58 in chips) 
Seat 3: clovvnfiesta ($3.81 in chips) 
Seat 4: crazy turfer ($10.16 in chips) 
Seat 5: davetass ($8.98 in chips) 
PlayTheBlues4U: posts small blind $0.05
clovvnfiesta: posts big blind $0.10
*** HOLE CARDS ***
Dealt to PlayTheBlues4U [8d 6s]
crazy turfer: calls $0.10
davetass: folds 
csxwe: raises $0.35 to $0.45
PlayTheBlues4U: folds 
clovvnfiesta: folds 
crazy turfer: folds 
Uncalled bet ($0.35) returned to csxwe
davetass said, "talkin jibbish again?"
csxwe collected $0.35 from pot
csxwe: doesn't show hand 
*** SUMMARY ***
Total pot $0.35 | Rake $0 
Seat 1: csxwe (button) collected ($0.35)
Seat 2: PlayTheBlues4U (small blind) folded before Flop
Seat 3: clovvnfiesta (big blind) folded before Flop
Seat 4: crazy turfer folded before Flop
Seat 5: davetass folded before Flop (didn't bet)



PokerStars Hand #205010977413:  Hold'em No Limit ($0.05/$0.10 USD) - 2019/10/24 21:47:02 ET
Table 'Alrami' 6-max Seat #2 is the button
Seat 1: csxwe ($24.95 in chips) 
Seat 2: PlayTheBlues4U ($28.53 in chips) 
Seat 3: clovvnfiesta ($3.71 in chips) 
Seat 4: crazy turfer ($10.06 in chips) 
Seat 5: davetass ($8.98 in chips) 
clovvnfiesta: posts small blind $0.05
crazy turfer: posts big blind $0.10
*** HOLE CARDS ***
Dealt to PlayTheBlues4U [7s 4h]
davetass: raises $0.20 to $0.30
csxwe: folds 
PlayTheBlues4U: folds 
clovvnfiesta: folds 
crazy turfer: folds 
Uncalled bet ($0.20) returned to davetass
davetass collected $0.25 from pot
davetass: doesn't show hand 
*** SUMMARY ***
Total pot $0.25 | Rake $0 
Seat 1: csxwe folded before Flop (didn't bet)
Seat 2: PlayTheBlues4U (button) folded before Flop (didn't bet)
Seat 3: clovvnfiesta (small blind) folded before Flop
Seat 4: crazy turfer (big blind) folded before Flop
Seat 5: davetass collected ($0.25)



PokerStars Hand #205010977470:  Hold'em No Limit ($0.05/$0.10 USD) - 2019/10/24 21:47:15 ET
Table 'Alrami' 6-max Seat #3 is the button
Seat 1: csxwe ($24.95 in chips) 
Seat 2: PlayTheBlues4U ($28.53 in chips) 
Seat 3: clovvnfiesta ($3.66 in chips) 
Seat 4: crazy turfer ($9.96 in chips) 
Seat 5: davetass ($9.13 in chips) 
crazy turfer: posts small blind $0.05
davetass: posts big blind $0.10
*** HOLE CARDS ***
Dealt to PlayTheBlues4U [Qc Th]
csxwe: folds 
PlayTheBlues4U said, "you csx like railroad?"
PlayTheBlues4U: folds 
clovvnfiesta: calls $0.10
davetass said, "off the tracks"
csxwe said, "no  cybersecurity "
crazy turfer: calls $0.05
davetass: checks 
*** FLOP *** [6s 3d Qs]
crazy turfer: bets $0.30
davetass: folds 
PlayTheBlues4U said, "not a bad thing to do in times like these"
clovvnfiesta: calls $0.30
*** TURN *** [6s 3d Qs] [7s]
crazy turfer: bets $0.50
clovvnfiesta: folds 
Uncalled bet ($0.50) returned to crazy turfer
crazy turfer collected $0.86 from pot
*** SUMMARY ***
Total pot $0.90 | Rake $0.04 
Board [6s 3d Qs 7s]
Seat 1: csxwe folded before Flop (didn't bet)
Seat 2: PlayTheBlues4U folded before Flop (didn't bet)
Seat 3: clovvnfiesta (button) folded on the Turn
Seat 4: crazy turfer (small blind) collected ($0.86)
Seat 5: davetass (big blind) folded on the Flop



PokerStars Hand #205010977755:  Hold'em No Limit ($0.05/$0.10 USD) - 2019/10/24 21:48:27 ET
Table 'Alrami' 6-max Seat #4 is the button
Seat 1: csxwe ($24.95 in chips) 
Seat 2: PlayTheBlues4U ($28.53 in chips) 
Seat 3: clovvnfiesta ($3.26 in chips) 
Seat 4: crazy turfer ($10.42 in chips) 
Seat 5: davetass ($9.03 in chips) 
davetass: posts small blind $0.05
csxwe: posts big blind $0.10
*** HOLE CARDS ***
Dealt to PlayTheBlues4U [Ah 7d]
PlayTheBlues4U: folds 
clovvnfiesta: folds 
csxwe said, "23 year veteran  in industry "
davetass said, "dont suk out on him hecwill hack u"
crazy turfer: calls $0.10
davetass: calls $0.05
csxwe: checks 
*** FLOP *** [3s 8s 6s]
davetass: checks 
PlayTheBlues4U said, "HE CAN SEE WHERE IP"
csxwe: bets $0.10
crazy turfer: calls $0.10
davetass: calls $0.10
*** TURN *** [3s 8s 6s] [9d]
csxwe said, "I see cardz"
davetass: checks 
csxwe: bets $0.30
davetass said, "lol"
crazy turfer: raises $0.30 to $0.60
davetass: folds 
csxwe: raises $0.90 to $1.50
crazy turfer: calls $0.90
*** RIVER *** [3s 8s 6s 9d] [6h]
PlayTheBlues4U said, "i see at least 2 hand, maybe more"
csxwe: checks 
crazy turfer: bets $8.72 and is all-in
csxwe: calls $8.72
*** SHOW DOWN ***
crazy turfer: shows [3c 6c] (a full house, Sixes full of Threes)
csxwe: shows [4s Js] (a flush, Jack high)
crazy turfer collected $19.99 from pot
*** SUMMARY ***
Total pot $21.04 | Rake $1.05 
Board [3s 8s 6s 9d 6h]
Seat 1: csxwe (big blind) showed [4s Js] and lost with a flush, Jack high
Seat 2: PlayTheBlues4U folded before Flop (didn't bet)
Seat 3: clovvnfiesta folded before Flop (didn't bet)
Seat 4: crazy turfer (button) showed [3c 6c] and won ($19.99) with a full house, Sixes full of Threes
Seat 5: davetass (small blind) folded on the Turn



PokerStars Hand #205010978022:  Hold'em No Limit ($0.05/$0.10 USD) - 2019/10/24 21:49:34 ET
Table 'Alrami' 6-max Seat #5 is the button
Seat 1: csxwe ($14.53 in chips) 
Seat 2: PlayTheBlues4U ($28.53 in chips) 
Seat 3: clovvnfiesta ($4 in chips) 
Seat 4: crazy turfer ($19.99 in chips) 
Seat 5: davetass ($8.83 in chips) 
csxwe: posts small blind $0.05
PlayTheBlues4U: posts big blind $0.10
*** HOLE CARDS ***
Dealt to PlayTheBlues4U [Js 8d]
clovvnfiesta: folds 
csxwe said, "nh"
crazy turfer: calls $0.10
davetass: folds 
davetass said, "ouch"
crazy turfer said, "tx"
davetass said, "nh"
csxwe: calls $0.05
PlayTheBlues4U: checks 
*** FLOP *** [8s Tc Jh]
PlayTheBlues4U said, "wow"
csxwe: bets $0.20
PlayTheBlues4U: raises $0.50 to $0.70
crazy turfer: folds 
csxwe: raises $1.70 to $2.40
PlayTheBlues4U: calls $1.70
*** TURN *** [8s Tc Jh] [7c]
csxwe: bets $12.03 and is all-in
PlayTheBlues4U: folds 
Uncalled bet ($12.03) returned to csxwe
csxwe collected $4.84 from pot
csxwe: doesn't show hand 
*** SUMMARY ***
Total pot $5.10 | Rake $0.26 
Board [8s Tc Jh 7c]
Seat 1: csxwe (small blind) collected ($4.84)
Seat 2: PlayTheBlues4U (big blind) folded on the Turn
Seat 3: clovvnfiesta folded before Flop (didn't bet)
Seat 4: crazy turfer folded on the Flop
Seat 5: davetass (button) folded before Flop (didn't bet)



PokerStars Hand #205010978249:  Hold'em No Limit ($0.05/$0.10 USD) - 2019/10/24 21:50:35 ET
Table 'Alrami' 6-max Seat #1 is the button
Seat 1: csxwe ($16.87 in chips) 
Seat 2: PlayTheBlues4U ($26.03 in chips) 
Seat 3: clovvnfiesta ($4 in chips) 
Seat 4: crazy turfer ($19.89 in chips) 
Seat 5: davetass ($8.83 in chips) 
PlayTheBlues4U: posts small blind $0.05
clovvnfiesta: posts big blind $0.10
*** HOLE CARDS ***
Dealt to PlayTheBlues4U [As 9c]
crazy turfer: calls $0.10
davetass: folds 
csxwe: calls $0.10
PlayTheBlues4U said, "had you until the turn!"
PlayTheBlues4U: calls $0.05
clovvnfiesta: checks 
*** FLOP *** [3s 4h Js]
PlayTheBlues4U: checks 
davetass said, "no the river silly"
clovvnfiesta: checks 
crazy turfer: checks 
csxwe: checks 
*** TURN *** [3s 4h Js] [2c]
csxwe said, "happenz"
PlayTheBlues4U said, "talking about with csx"
PlayTheBlues4U: checks 
clovvnfiesta: checks 
davetass said, "yea"
crazy turfer: checks 
csxwe: bets $0.10
PlayTheBlues4U: folds 
clovvnfiesta: folds 
crazy turfer: folds 
Uncalled bet ($0.10) returned to csxwe
davetass said, "turf rivered him"
csxwe collected $0.38 from pot
csxwe: doesn't show hand 
*** SUMMARY ***
Total pot $0.40 | Rake $0.02 
Board [3s 4h Js 2c]
Seat 1: csxwe (button) collected ($0.38)
Seat 2: PlayTheBlues4U (small blind) folded on the Turn
Seat 3: clovvnfiesta (big blind) folded on the Turn
Seat 4: crazy turfer folded on the Turn
Seat 5: davetass folded before Flop (didn't bet)



PokerStars Hand #205010978513:  Hold'em No Limit ($0.05/$0.10 USD) - 2019/10/24 21:51:43 ET
Table 'Alrami' 6-max Seat #2 is the button
Seat 1: csxwe ($17.15 in chips) 
Seat 2: PlayTheBlues4U ($25.93 in chips) 
Seat 3: clovvnfiesta ($3.90 in chips) 
Seat 4: crazy turfer ($19.79 in chips) 
Seat 5: davetass ($8.83 in chips) 
clovvnfiesta: posts small blind $0.05
crazy turfer: posts big blind $0.10
*** HOLE CARDS ***
Dealt to PlayTheBlues4U [4c 4d]
davetass: calls $0.10
csxwe: folds 
PlayTheBlues4U: calls $0.10
clovvnfiesta: folds 
crazy turfer: checks 
*** FLOP *** [6h 9s 6s]
crazy turfer: bets $0.20
davetass: folds 
PlayTheBlues4U: folds 
Uncalled bet ($0.20) returned to crazy turfer
crazy turfer collected $0.33 from pot
*** SUMMARY ***
Total pot $0.35 | Rake $0.02 
Board [6h 9s 6s]
Seat 1: csxwe folded before Flop (didn't bet)
Seat 2: PlayTheBlues4U (button) folded on the Flop
Seat 3: clovvnfiesta (small blind) folded before Flop
Seat 4: crazy turfer (big blind) collected ($0.33)
Seat 5: davetass folded on the Flop



PokerStars Hand #205010978603:  Hold'em No Limit ($0.05/$0.10 USD) - 2019/10/24 21:52:05 ET
Table 'Alrami' 6-max Seat #3 is the button
Seat 1: csxwe ($17.15 in chips) 
Seat 2: PlayTheBlues4U ($25.83 in chips) 
Seat 3: clovvnfiesta ($3.85 in chips) 
Seat 4: crazy turfer ($20.02 in chips) 
Seat 5: davetass ($8.73 in chips) 
crazy turfer: posts small blind $0.05
davetass: posts big blind $0.10
*** HOLE CARDS ***
Dealt to PlayTheBlues4U [8d 3s]
csxwe: folds 
PlayTheBlues4U: folds 
clovvnfiesta: folds 
crazy turfer: folds 
Uncalled bet ($0.05) returned to davetass
davetass collected $0.10 from pot
davetass: doesn't show hand 
*** SUMMARY ***
Total pot $0.10 | Rake $0 
Seat 1: csxwe folded before Flop (didn't bet)
Seat 2: PlayTheBlues4U folded before Flop (didn't bet)
Seat 3: clovvnfiesta (button) folded before Flop (didn't bet)
Seat 4: crazy turfer (small blind) folded before Flop
Seat 5: davetass (big blind) collected ($0.10)



PokerStars Hand #205010978631:  Hold'em No Limit ($0.05/$0.10 USD) - 2019/10/24 21:52:13 ET
Table 'Alrami' 6-max Seat #4 is the button
Seat 1: csxwe ($17.15 in chips) 
Seat 2: PlayTheBlues4U ($25.83 in chips) 
Seat 3: clovvnfiesta ($3.85 in chips) 
Seat 4: crazy turfer ($19.97 in chips) 
Seat 5: davetass ($8.78 in chips) 
davetass: posts small blind $0.05
csxwe: posts big blind $0.10
*** HOLE CARDS ***
Dealt to PlayTheBlues4U [9d 9s]
csxwe said, "was nasty "
PlayTheBlues4U: raises $0.20 to $0.30
clovvnfiesta: folds 
crazy turfer: calls $0.30
davetass: folds 
csxwe: folds 
*** FLOP *** [Kc 2s 8h]
PlayTheBlues4U: bets $0.40
crazy turfer: folds 
Uncalled bet ($0.40) returned to PlayTheBlues4U
PlayTheBlues4U collected $0.71 from pot
PlayTheBlues4U: doesn't show hand 
*** SUMMARY ***
Total pot $0.75 | Rake $0.04 
Board [Kc 2s 8h]
Seat 1: csxwe (big blind) folded before Flop
Seat 2: PlayTheBlues4U collected ($0.71)
Seat 3: clovvnfiesta folded before Flop (didn't bet)
Seat 4: crazy turfer (button) folded on the Flop
Seat 5: davetass (small blind) folded before Flop



PokerStars Hand #205010978742:  Hold'em No Limit ($0.05/$0.10 USD) - 2019/10/24 21:52:39 ET
Table 'Alrami' 6-max Seat #5 is the button
Seat 1: csxwe ($17.05 in chips) 
Seat 2: PlayTheBlues4U ($26.24 in chips) 
Seat 3: clovvnfiesta ($3.85 in chips) 
Seat 4: crazy turfer ($19.67 in chips) 
Seat 5: davetass ($8.73 in chips) 
csxwe: posts small blind $0.05
PlayTheBlues4U: posts big blind $0.10
*** HOLE CARDS ***
Dealt to PlayTheBlues4U [5h 9d]
clovvnfiesta: folds 
crazy turfer: folds 
davetass: folds 
csxwe: folds 
Uncalled bet ($0.05) returned to PlayTheBlues4U
PlayTheBlues4U collected $0.10 from pot
PlayTheBlues4U: doesn't show hand 
*** SUMMARY ***
Total pot $0.10 | Rake $0 
Seat 1: csxwe (small blind) folded before Flop
Seat 2: PlayTheBlues4U (big blind) collected ($0.10)
Seat 3: clovvnfiesta folded before Flop (didn't bet)
Seat 4: crazy turfer folded before Flop (didn't bet)
Seat 5: davetass (button) folded before Flop (didn't bet)



PokerStars Hand #205010978775:  Hold'em No Limit ($0.05/$0.10 USD) - 2019/10/24 21:52:47 ET
Table 'Alrami' 6-max Seat #1 is the button
Seat 1: csxwe ($17 in chips) 
Seat 2: PlayTheBlues4U ($26.29 in chips) 
Seat 3: clovvnfiesta ($3.85 in chips) 
Seat 4: crazy turfer ($19.67 in chips) 
Seat 5: davetass ($8.73 in chips) 
PlayTheBlues4U: posts small blind $0.05
clovvnfiesta: posts big blind $0.10
*** HOLE CARDS ***
Dealt to PlayTheBlues4U [Ah 2h]
crazy turfer: raises $0.10 to $0.20
davetass: folds 
csxwe: calls $0.20
PlayTheBlues4U: calls $0.15
clovvnfiesta: folds 
*** FLOP *** [Qs Kh 5d]
PlayTheBlues4U: checks 
crazy turfer: bets $0.20
csxwe: folds 
PlayTheBlues4U: folds 
Uncalled bet ($0.20) returned to crazy turfer
crazy turfer collected $0.66 from pot
*** SUMMARY ***
Total pot $0.70 | Rake $0.04 
Board [Qs Kh 5d]
Seat 1: csxwe (button) folded on the Flop
Seat 2: PlayTheBlues4U (small blind) folded on the Flop
Seat 3: clovvnfiesta (big blind) folded before Flop
Seat 4: crazy turfer collected ($0.66)
Seat 5: davetass folded before Flop (didn't bet)



PokerStars Hand #205010978887:  Hold'em No Limit ($0.05/$0.10 USD) - 2019/10/24 21:53:15 ET
Table 'Alrami' 6-max Seat #2 is the button
Seat 1: csxwe ($16.80 in chips) 
Seat 2: PlayTheBlues4U ($26.09 in chips) 
Seat 3: clovvnfiesta ($3.75 in chips) 
Seat 4: crazy turfer ($20.13 in chips) 
Seat 5: davetass ($8.73 in chips) 
clovvnfiesta: posts small blind $0.05
crazy turfer: posts big blind $0.10
*** HOLE CARDS ***
Dealt to PlayTheBlues4U [7d Td]
davetass: raises $0.20 to $0.30
csxwe: folds 
PlayTheBlues4U: folds 
clovvnfiesta: folds 
crazy turfer: folds 
Uncalled bet ($0.20) returned to davetass
davetass collected $0.25 from pot
davetass: doesn't show hand 
*** SUMMARY ***
Total pot $0.25 | Rake $0 
Seat 1: csxwe folded before Flop (didn't bet)
Seat 2: PlayTheBlues4U (button) folded before Flop (didn't bet)
Seat 3: clovvnfiesta (small blind) folded before Flop
Seat 4: crazy turfer (big blind) folded before Flop
Seat 5: davetass collected ($0.25)



PokerStars Hand #205010978944:  Hold'em No Limit ($0.05/$0.10 USD) - 2019/10/24 21:53:31 ET
Table 'Alrami' 6-max Seat #3 is the button
Seat 1: csxwe ($16.80 in chips) 
Seat 2: PlayTheBlues4U ($26.09 in chips) 
Seat 3: clovvnfiesta ($3.70 in chips) 
Seat 4: crazy turfer ($20.03 in chips) 
Seat 5: davetass ($8.88 in chips) 
crazy turfer: posts small blind $0.05
davetass: posts big blind $0.10
*** HOLE CARDS ***
Dealt to PlayTheBlues4U [9c Jc]
crazy turfer said, "dont worry ill give it back"
csxwe: raises $0.10 to $0.20
PlayTheBlues4U: folds 
clovvnfiesta: folds 
crazy turfer: folds 
davetass: folds 
Uncalled bet ($0.10) returned to csxwe
davetass said, "lol we all do turf we all do"
csxwe collected $0.25 from pot
csxwe: doesn't show hand 
*** SUMMARY ***
Total pot $0.25 | Rake $0 
Seat 1: csxwe collected ($0.25)
Seat 2: PlayTheBlues4U folded before Flop (didn't bet)
Seat 3: clovvnfiesta (button) folded before Flop (didn't bet)
Seat 4: crazy turfer (small blind) folded before Flop
Seat 5: davetass (big blind) folded before Flop



PokerStars Hand #205010979033:  Hold'em No Limit ($0.05/$0.10 USD) - 2019/10/24 21:53:54 ET
Table 'Alrami' 6-max Seat #4 is the button
Seat 1: csxwe ($16.95 in chips) 
Seat 2: PlayTheBlues4U ($26.09 in chips) 
Seat 3: clovvnfiesta ($3.70 in chips) 
Seat 4: crazy turfer ($19.98 in chips) 
Seat 5: davetass ($8.78 in chips) 
davetass: posts small blind $0.05
csxwe: posts big blind $0.10
*** HOLE CARDS ***
Dealt to PlayTheBlues4U [Qd As]
PlayTheBlues4U: raises $0.20 to $0.30
clovvnfiesta: folds 
crazy turfer: folds 
davetass: calls $0.25
csxwe: calls $0.20
*** FLOP *** [8c 4s Ad]
crazy turfer said, "you got that right"
davetass: checks 
csxwe: checks 
PlayTheBlues4U: bets $0.60
davetass: raises $2.10 to $2.70
csxwe: folds 
davetass said, "im showin"
PlayTheBlues4U: folds 
Uncalled bet ($2.10) returned to davetass
davetass collected $2 from pot
Redd0412 was removed from the table for failing to post
Redd0412 leaves the table
davetass: doesn't show hand 
*** SUMMARY ***
Total pot $2.10 | Rake $0.10 
Board [8c 4s Ad]
Seat 1: csxwe (big blind) folded on the Flop
Seat 2: PlayTheBlues4U folded on the Flop
Seat 3: clovvnfiesta folded before Flop (didn't bet)
Seat 4: crazy turfer (button) folded before Flop (didn't bet)
Seat 5: davetass (small blind) collected ($2)



PokerStars Hand #205010979272:  Hold'em No Limit ($0.05/$0.10 USD) - 2019/10/24 21:54:58 ET
Table 'Alrami' 6-max Seat #5 is the button
Seat 1: csxwe ($16.65 in chips) 
Seat 2: PlayTheBlues4U ($25.19 in chips) 
Seat 3: clovvnfiesta ($3.70 in chips) 
Seat 4: crazy turfer ($19.98 in chips) 
Seat 5: davetass ($9.88 in chips) 
csxwe: posts small blind $0.05
PlayTheBlues4U: posts big blind $0.10
*** HOLE CARDS ***
Dealt to PlayTheBlues4U [Kh Qc]
ng2414 joins the table at seat #6 
davetass said, "u see em?"
clovvnfiesta: folds 
crazy turfer: folds 
davetass: calls $0.10
csxwe: folds 
csxwe said, "too stoned"
davetass said, "lol"
PlayTheBlues4U: raises $0.20 to $0.30
davetass: calls $0.20
*** FLOP *** [8c 7c Kd]
PlayTheBlues4U: bets $0.50
davetass: folds 
Uncalled bet ($0.50) returned to PlayTheBlues4U
PlayTheBlues4U collected $0.62 from pot
PlayTheBlues4U: doesn't show hand 
*** SUMMARY ***
Total pot $0.65 | Rake $0.03 
Board [8c 7c Kd]
Seat 1: csxwe (small blind) folded before Flop
Seat 2: PlayTheBlues4U (big blind) collected ($0.62)
Seat 3: clovvnfiesta folded before Flop (didn't bet)
Seat 4: crazy turfer folded before Flop (didn't bet)
Seat 5: davetass (button) folded on the Flop



PokerStars Hand #205010979405:  Hold'em No Limit ($0.05/$0.10 USD) - 2019/10/24 21:55:40 ET
Table 'Alrami' 6-max Seat #1 is the button
Seat 1: csxwe ($16.60 in chips) 
Seat 2: PlayTheBlues4U ($25.51 in chips) 
Seat 3: clovvnfiesta ($3.70 in chips) 
Seat 4: crazy turfer ($19.98 in chips) 
Seat 5: davetass ($9.58 in chips) 
PlayTheBlues4U: posts small blind $0.05
clovvnfiesta: posts big blind $0.10
ng2414: sits out 
*** HOLE CARDS ***
Dealt to PlayTheBlues4U [2d 5s]
crazy turfer: folds 
davetass: folds 
csxwe: folds 
PlayTheBlues4U: folds 
Uncalled bet ($0.05) returned to clovvnfiesta
clovvnfiesta collected $0.10 from pot
clovvnfiesta: doesn't show hand 
*** SUMMARY ***
Total pot $0.10 | Rake $0 
Seat 1: csxwe (button) folded before Flop (didn't bet)
Seat 2: PlayTheBlues4U (small blind) folded before Flop
Seat 3: clovvnfiesta (big blind) collected ($0.10)
Seat 4: crazy turfer folded before Flop (didn't bet)
Seat 5: davetass folded before Flop (didn't bet)



PokerStars Hand #205010979432:  Hold'em No Limit ($0.05/$0.10 USD) - 2019/10/24 21:55:49 ET
Table 'Alrami' 6-max Seat #2 is the button
Seat 1: csxwe ($16.60 in chips) 
Seat 2: PlayTheBlues4U ($25.46 in chips) 
Seat 3: clovvnfiesta ($3.75 in chips) 
Seat 4: crazy turfer ($19.98 in chips) 
Seat 5: davetass ($9.58 in chips) 
clovvnfiesta: posts small blind $0.05
crazy turfer: posts big blind $0.10
ng2414: sits out 
*** HOLE CARDS ***
Dealt to PlayTheBlues4U [Jc Qh]
davetass: calls $0.10
csxwe: folds 
PlayTheBlues4U: raises $0.20 to $0.30
PlayTheBlues4U said, "anyone else lagging a bit?"
PlayTheBlues4U said, "i click the button, just waits a few seconds"
clovvnfiesta: folds 
crazy turfer: folds 
davetass: calls $0.20
*** FLOP *** [5d 9h Ad]
davetass: bets $0.40
PlayTheBlues4U: folds 
Uncalled bet ($0.40) returned to davetass
davetass collected $0.71 from pot
davetass: doesn't show hand 
*** SUMMARY ***
Total pot $0.75 | Rake $0.04 
Board [5d 9h Ad]
Seat 1: csxwe folded before Flop (didn't bet)
Seat 2: PlayTheBlues4U (button) folded on the Flop
Seat 3: clovvnfiesta (small blind) folded before Flop
Seat 4: crazy turfer (big blind) folded before Flop
Seat 5: davetass collected ($0.71)



PokerStars Hand #205010979563:  Hold'em No Limit ($0.05/$0.10 USD) - 2019/10/24 21:56:34 ET
Table 'Alrami' 6-max Seat #3 is the button
Seat 1: csxwe ($16.60 in chips) 
Seat 2: PlayTheBlues4U ($25.16 in chips) 
Seat 3: clovvnfiesta ($3.70 in chips) 
Seat 4: crazy turfer ($19.88 in chips) 
Seat 5: davetass ($9.99 in chips) 
crazy turfer: posts small blind $0.05
davetass: posts big blind $0.10
ng2414: sits out 
*** HOLE CARDS ***
Dealt to PlayTheBlues4U [Kd Tc]
PlayTheBlues4U said, "i cant beat dave"
csxwe: raises $0.10 to $0.20
davetass said, "i can"
davetass said, "had a10"
csxwe said, "need some tilt juice?"
davetass said, "ace 10"
PlayTheBlues4U has timed out
PlayTheBlues4U: folds 
PlayTheBlues4U is disconnected 
clovvnfiesta: calls $0.20
crazy turfer: calls $0.15
davetass: folds 
*** FLOP *** [Ks Td 2d]
crazy turfer: checks 
csxwe: bets $0.30
clovvnfiesta: folds 
crazy turfer: folds 
Uncalled bet ($0.30) returned to csxwe
csxwe collected $0.66 from pot
csxwe: doesn't show hand 
*** SUMMARY ***
Total pot $0.70 | Rake $0.04 
Board [Ks Td 2d]
Seat 1: csxwe collected ($0.66)
Seat 2: PlayTheBlues4U folded before Flop (didn't bet)
Seat 3: clovvnfiesta (button) folded on the Flop
Seat 4: crazy turfer (small blind) folded on the Flop
Seat 5: davetass (big blind) folded before Flop



PokerStars Hand #205010979762:  Hold'em No Limit ($0.05/$0.10 USD) - 2019/10/24 21:57:45 ET
Table 'Alrami' 6-max Seat #4 is the button
Seat 1: csxwe ($17.06 in chips) 
Seat 2: PlayTheBlues4U ($25.16 in chips) 
Seat 3: clovvnfiesta ($3.50 in chips) 
Seat 4: crazy turfer ($19.68 in chips) 
Seat 5: davetass ($9.89 in chips) 
Seat 6: ng2414 ($10 in chips) 
davetass: posts small blind $0.05
ng2414: posts big blind $0.10
*** HOLE CARDS ***
Dealt to PlayTheBlues4U [9c 2c]
csxwe: folds 
PlayTheBlues4U: folds 
clovvnfiesta: folds 
crazy turfer: folds 
davetass: folds 
Uncalled bet ($0.05) returned to ng2414
ng2414 collected $0.10 from pot
*** SUMMARY ***
Total pot $0.10 | Rake $0 
Seat 1: csxwe folded before Flop (didn't bet)
Seat 2: PlayTheBlues4U folded before Flop (didn't bet)
Seat 3: clovvnfiesta folded before Flop (didn't bet)
Seat 4: crazy turfer (button) folded before Flop (didn't bet)
Seat 5: davetass (small blind) folded before Flop
Seat 6: ng2414 (big blind) collected ($0.10)



PokerStars Hand #205010979817:  Hold'em No Limit ($0.05/$0.10 USD) - 2019/10/24 21:58:02 ET
Table 'Alrami' 6-max Seat #5 is the button
Seat 1: csxwe ($17.06 in chips) 
Seat 2: PlayTheBlues4U ($25.16 in chips) 
Seat 3: clovvnfiesta ($3.50 in chips) 
Seat 4: crazy turfer ($19.68 in chips) 
Seat 5: davetass ($9.84 in chips) 
Seat 6: ng2414 ($10.05 in chips) 
ng2414: posts small blind $0.05
csxwe: posts big blind $0.10
*** HOLE CARDS ***
Dealt to PlayTheBlues4U [Qc 7s]
PlayTheBlues4U said, "i make my own tilt juice"
PlayTheBlues4U said, "freshly squeezed"
PlayTheBlues4U: folds 
clovvnfiesta: folds 
davetass said, "sug g"
ng2414 said, "was good"
davetass said, "sup"
crazy turfer: calls $0.10
davetass: folds 
ng2414: calls $0.05
csxwe: checks 
*** FLOP *** [7h Tc 3c]
ng2414: checks 
davetass said, "livin the dream"
csxwe: checks 
crazy turfer: bets $0.20
ng2414: folds 
csxwe: folds 
Uncalled bet ($0.20) returned to crazy turfer
crazy turfer collected $0.28 from pot
*** SUMMARY ***
Total pot $0.30 | Rake $0.02 
Board [7h Tc 3c]
Seat 1: csxwe (big blind) folded on the Flop
Seat 2: PlayTheBlues4U folded before Flop (didn't bet)
Seat 3: clovvnfiesta folded before Flop (didn't bet)
Seat 4: crazy turfer collected ($0.28)
Seat 5: davetass (button) folded before Flop (didn't bet)
Seat 6: ng2414 (small blind) folded on the Flop



PokerStars Hand #205010979959:  Hold'em No Limit ($0.05/$0.10 USD) - 2019/10/24 21:58:49 ET
Table 'Alrami' 6-max Seat #6 is the button
Seat 1: csxwe ($16.96 in chips) 
Seat 2: PlayTheBlues4U ($25.16 in chips) 
Seat 3: clovvnfiesta ($3.50 in chips) 
Seat 4: crazy turfer ($19.86 in chips) 
Seat 5: davetass ($9.84 in chips) 
Seat 6: ng2414 ($9.95 in chips) 
csxwe: posts small blind $0.05
PlayTheBlues4U: posts big blind $0.10
*** HOLE CARDS ***
Dealt to PlayTheBlues4U [2s Ah]
clovvnfiesta: folds 
crazy turfer: folds 
davetass: folds 
ng2414: folds 
csxwe: folds 
Uncalled bet ($0.05) returned to PlayTheBlues4U
PlayTheBlues4U collected $0.10 from pot
PlayTheBlues4U: doesn't show hand 
*** SUMMARY ***
Total pot $0.10 | Rake $0 
Seat 1: csxwe (small blind) folded before Flop
Seat 2: PlayTheBlues4U (big blind) collected ($0.10)
Seat 3: clovvnfiesta folded before Flop (didn't bet)
Seat 4: crazy turfer folded before Flop (didn't bet)
Seat 5: davetass folded before Flop (didn't bet)
Seat 6: ng2414 (button) folded before Flop (didn't bet)



PokerStars Hand #205011487833:  Hold'em No Limit ($0.05/$0.10 USD) - 2019/10/24 21:59:13 ET
Table 'Alrami' 6-max Seat #1 is the button
Seat 1: csxwe ($16.91 in chips) 
Seat 2: PlayTheBlues4U ($25.21 in chips) 
Seat 3: clovvnfiesta ($3.50 in chips) 
Seat 4: crazy turfer ($19.86 in chips) 
Seat 5: davetass ($9.84 in chips) 
Seat 6: ng2414 ($9.95 in chips) 
PlayTheBlues4U: posts small blind $0.05
clovvnfiesta: posts big blind $0.10
*** HOLE CARDS ***
Dealt to PlayTheBlues4U [6d 8d]
crazy turfer: folds 
davetass: folds 
ng2414: folds 
csxwe: folds 
PlayTheBlues4U: calls $0.05
clovvnfiesta: checks 
*** FLOP *** [Jd 8c As]
PlayTheBlues4U: checks 
clovvnfiesta: checks 
*** TURN *** [Jd 8c As] [5s]
PlayTheBlues4U: bets $0.10
clovvnfiesta: folds 
Uncalled bet ($0.10) returned to PlayTheBlues4U
PlayTheBlues4U collected $0.19 from pot
PlayTheBlues4U: doesn't show hand 
*** SUMMARY ***
Total pot $0.20 | Rake $0.01 
Board [Jd 8c As 5s]
Seat 1: csxwe (button) folded before Flop (didn't bet)
Seat 2: PlayTheBlues4U (small blind) collected ($0.19)
Seat 3: clovvnfiesta (big blind) folded on the Turn
Seat 4: crazy turfer folded before Flop (didn't bet)
Seat 5: davetass folded before Flop (didn't bet)
Seat 6: ng2414 folded before Flop (didn't bet)



PokerStars Hand #205011487934:  Hold'em No Limit ($0.05/$0.10 USD) - 2019/10/24 21:59:48 ET
Table 'Alrami' 6-max Seat #2 is the button
Seat 1: csxwe ($16.91 in chips) 
Seat 2: PlayTheBlues4U ($25.30 in chips) 
Seat 3: clovvnfiesta ($3.40 in chips) 
Seat 4: crazy turfer ($19.86 in chips) 
Seat 5: davetass ($9.84 in chips) 
Seat 6: ng2414 ($9.95 in chips) 
clovvnfiesta: posts small blind $0.05
crazy turfer: posts big blind $0.10
*** HOLE CARDS ***
Dealt to PlayTheBlues4U [Js Td]
davetass: folds 
ng2414: folds 
csxwe: folds 
PlayTheBlues4U: raises $0.15 to $0.25
clovvnfiesta: folds 
crazy turfer: calls $0.15
*** FLOP *** [Kc Ac Ts]
crazy turfer: checks 
PlayTheBlues4U: checks 
*** TURN *** [Kc Ac Ts] [2d]
crazy turfer: checks 
PlayTheBlues4U: checks 
*** RIVER *** [Kc Ac Ts 2d] [Ad]
crazy turfer: checks 
PlayTheBlues4U: checks 
*** SHOW DOWN ***
crazy turfer: shows [7s 5c] (a pair of Aces)
PlayTheBlues4U: shows [Js Td] (two pair, Aces and Tens)
PlayTheBlues4U collected $0.52 from pot
*** SUMMARY ***
Total pot $0.55 | Rake $0.03 
Board [Kc Ac Ts 2d Ad]
Seat 1: csxwe folded before Flop (didn't bet)
Seat 2: PlayTheBlues4U (button) showed [Js Td] and won ($0.52) with two pair, Aces and Tens
Seat 3: clovvnfiesta (small blind) folded before Flop
Seat 4: crazy turfer (big blind) showed [7s 5c] and lost with a pair of Aces
Seat 5: davetass folded before Flop (didn't bet)
Seat 6: ng2414 folded before Flop (didn't bet)



PokerStars Hand #205011488027:  Hold'em No Limit ($0.05/$0.10 USD) - 2019/10/24 22:00:19 ET
Table 'Alrami' 6-max Seat #3 is the button
Seat 1: csxwe ($16.91 in chips) 
Seat 2: PlayTheBlues4U ($25.57 in chips) 
Seat 3: clovvnfiesta ($4 in chips) 
Seat 4: crazy turfer ($19.61 in chips) 
Seat 5: davetass ($9.84 in chips) 
Seat 6: ng2414 ($9.95 in chips) 
crazy turfer: posts small blind $0.05
davetass: posts big blind $0.10
*** HOLE CARDS ***
Dealt to PlayTheBlues4U [6c Ah]
ng2414: folds 
csxwe: folds 
PlayTheBlues4U: folds 
clovvnfiesta: folds 
crazy turfer: calls $0.05
davetass: checks 
*** FLOP *** [9c 3c 8d]
crazy turfer: checks 
davetass: bets $0.10
crazy turfer: folds 
Uncalled bet ($0.10) returned to davetass
davetass collected $0.19 from pot
davetass: doesn't show hand 
*** SUMMARY ***
Total pot $0.20 | Rake $0.01 
Board [9c 3c 8d]
Seat 1: csxwe folded before Flop (didn't bet)
Seat 2: PlayTheBlues4U folded before Flop (didn't bet)
Seat 3: clovvnfiesta (button) folded before Flop (didn't bet)
Seat 4: crazy turfer (small blind) folded on the Flop
Seat 5: davetass (big blind) collected ($0.19)
Seat 6: ng2414 folded before Flop (didn't bet)



PokerStars Hand #205011488103:  Hold'em No Limit ($0.05/$0.10 USD) - 2019/10/24 22:00:42 ET
Table 'Alrami' 6-max Seat #4 is the button
Seat 1: csxwe ($16.91 in chips) 
Seat 2: PlayTheBlues4U ($25.57 in chips) 
Seat 3: clovvnfiesta ($4 in chips) 
Seat 4: crazy turfer ($19.51 in chips) 
Seat 5: davetass ($9.93 in chips) 
Seat 6: ng2414 ($9.95 in chips) 
davetass: posts small blind $0.05
ng2414: posts big blind $0.10
*** HOLE CARDS ***
Dealt to PlayTheBlues4U [4h Ks]
csxwe: folds 
PlayTheBlues4U: folds 
clovvnfiesta: folds 
crazy turfer: calls $0.10
davetass: folds 
ng2414: checks 
*** FLOP *** [Ad 7d 8h]
ng2414: checks 
crazy turfer: bets $0.10
ng2414: folds 
Uncalled bet ($0.10) returned to crazy turfer
crazy turfer collected $0.24 from pot
*** SUMMARY ***
Total pot $0.25 | Rake $0.01 
Board [Ad 7d 8h]
Seat 1: csxwe folded before Flop (didn't bet)
Seat 2: PlayTheBlues4U folded before Flop (didn't bet)
Seat 3: clovvnfiesta folded before Flop (didn't bet)
Seat 4: crazy turfer (button) collected ($0.24)
Seat 5: davetass (small blind) folded before Flop
Seat 6: ng2414 (big blind) folded on the Flop



PokerStars Hand #205011488242:  Hold'em No Limit ($0.05/$0.10 USD) - 2019/10/24 22:01:17 ET
Table 'Alrami' 6-max Seat #5 is the button
Seat 1: csxwe ($16.91 in chips) 
Seat 2: PlayTheBlues4U ($25.57 in chips) 
Seat 3: clovvnfiesta ($4 in chips) 
Seat 4: crazy turfer ($19.65 in chips) 
Seat 5: davetass ($9.88 in chips) 
Seat 6: ng2414 ($9.85 in chips) 
ng2414: posts small blind $0.05
csxwe: posts big blind $0.10
*** HOLE CARDS ***
Dealt to PlayTheBlues4U [Ks 6d]
PlayTheBlues4U: folds 
clovvnfiesta: folds 
crazy turfer: folds 
davetass: folds 
ng2414: folds 
Uncalled bet ($0.05) returned to csxwe
csxwe collected $0.10 from pot
csxwe: doesn't show hand 
*** SUMMARY ***
Total pot $0.10 | Rake $0 
Seat 1: csxwe (big blind) collected ($0.10)
Seat 2: PlayTheBlues4U folded before Flop (didn't bet)
Seat 3: clovvnfiesta folded before Flop (didn't bet)
Seat 4: crazy turfer folded before Flop (didn't bet)
Seat 5: davetass (button) folded before Flop (didn't bet)
Seat 6: ng2414 (small blind) folded before Flop



PokerStars Hand #205011488282:  Hold'em No Limit ($0.05/$0.10 USD) - 2019/10/24 22:01:30 ET
Table 'Alrami' 6-max Seat #6 is the button
Seat 1: csxwe ($16.96 in chips) 
Seat 2: PlayTheBlues4U ($25.57 in chips) 
Seat 3: clovvnfiesta ($4 in chips) 
Seat 4: crazy turfer ($19.65 in chips) 
Seat 5: davetass ($9.88 in chips) 
Seat 6: ng2414 ($9.80 in chips) 
csxwe: posts small blind $0.05
PlayTheBlues4U: posts big blind $0.10
*** HOLE CARDS ***
Dealt to PlayTheBlues4U [9s Kh]
clovvnfiesta: folds 
crazy turfer: calls $0.10
davetass: folds 
ng2414: calls $0.10
csxwe: raises $0.10 to $0.20
PlayTheBlues4U: calls $0.10
csxwe said, "owned "
davetass said, "lol"
crazy turfer: calls $0.10
PlayTheBlues4U said, "everyone loves that"
davetass said, "ur a beast"
ng2414: calls $0.10
*** FLOP *** [Kd 4d 9c]
csxwe: checks 
PlayTheBlues4U: bets $0.50
crazy turfer: folds 
ng2414: folds 
csxwe: calls $0.50
*** TURN *** [Kd 4d 9c] [8c]
csxwe: checks 
PlayTheBlues4U: bets $1.30
csxwe: folds [Js Qs]
Uncalled bet ($1.30) returned to PlayTheBlues4U
PlayTheBlues4U collected $1.71 from pot
PlayTheBlues4U: doesn't show hand 
*** SUMMARY ***
Total pot $1.80 | Rake $0.09 
Board [Kd 4d 9c 8c]
Seat 1: csxwe (small blind) folded on the Turn
Seat 2: PlayTheBlues4U (big blind) collected ($1.71)
Seat 3: clovvnfiesta folded before Flop (didn't bet)
Seat 4: crazy turfer folded on the Flop
Seat 5: davetass folded before Flop (didn't bet)
Seat 6: ng2414 (button) folded on the Flop



PokerStars Hand #205011488569:  Hold'em No Limit ($0.05/$0.10 USD) - 2019/10/24 22:02:42 ET
Table 'Alrami' 6-max Seat #1 is the button
Seat 1: csxwe ($16.26 in chips) 
Seat 2: PlayTheBlues4U ($26.58 in chips) 
Seat 3: clovvnfiesta ($4 in chips) 
Seat 4: crazy turfer ($19.45 in chips) 
Seat 5: davetass ($9.88 in chips) 
Seat 6: ng2414 ($9.60 in chips) 
PlayTheBlues4U: posts small blind $0.05
clovvnfiesta: posts big blind $0.10
*** HOLE CARDS ***
Dealt to PlayTheBlues4U [Qd 6h]
crazy turfer: folds 
davetass: raises $0.20 to $0.30
ng2414: folds 
PlayTheBlues4U said, "king"
csxwe: raises $0.20 to $0.50
PlayTheBlues4U: folds 
clovvnfiesta: folds 
davetass: calls $0.20
*** FLOP *** [Ad 6d 4s]
davetass: checks 
csxwe: checks 
*** TURN *** [Ad 6d 4s] [Th]
davetass: bets $0.10
csxwe: calls $0.10
*** RIVER *** [Ad 6d 4s Th] [Jc]
davetass: bets $0.10
csxwe: raises $0.70 to $0.80
davetass: calls $0.70
*** SHOW DOWN ***
csxwe: shows [5c 5h] (a pair of Fives)
davetass: shows [Ah Kd] (a pair of Aces)
davetass collected $2.80 from pot
*** SUMMARY ***
Total pot $2.95 | Rake $0.15 
Board [Ad 6d 4s Th Jc]
Seat 1: csxwe (button) showed [5c 5h] and lost with a pair of Fives
Seat 2: PlayTheBlues4U (small blind) folded before Flop
Seat 3: clovvnfiesta (big blind) folded before Flop
Seat 4: crazy turfer folded before Flop (didn't bet)
Seat 5: davetass showed [Ah Kd] and won ($2.80) with a pair of Aces
Seat 6: ng2414 folded before Flop (didn't bet)



PokerStars Hand #205011488688:  Hold'em No Limit ($0.05/$0.10 USD) - 2019/10/24 22:03:12 ET
Table 'Alrami' 6-max Seat #2 is the button
Seat 1: csxwe ($14.86 in chips) 
Seat 2: PlayTheBlues4U ($26.53 in chips) 
Seat 3: clovvnfiesta ($3.90 in chips) 
Seat 4: crazy turfer ($19.45 in chips) 
Seat 5: davetass ($11.28 in chips) 
Seat 6: ng2414 ($9.60 in chips) 
clovvnfiesta: posts small blind $0.05
crazy turfer: posts big blind $0.10
*** HOLE CARDS ***
Dealt to PlayTheBlues4U [4c 5s]
davetass: folds 
PlayTheBlues4U said, "sooooted"
csxwe said, "wtf  if off"
ng2414: folds 
davetass said, "owned"
csxwe: folds 
PlayTheBlues4U: folds 
clovvnfiesta: raises $0.10 to $0.20
csxwe said, "bff off"
crazy turfer: folds 
Uncalled bet ($0.10) returned to clovvnfiesta
clovvnfiesta collected $0.20 from pot
clovvnfiesta: doesn't show hand 
*** SUMMARY ***
Total pot $0.20 | Rake $0 
Seat 1: csxwe folded before Flop (didn't bet)
Seat 2: PlayTheBlues4U (button) folded before Flop (didn't bet)
Seat 3: clovvnfiesta (small blind) collected ($0.20)
Seat 4: crazy turfer (big blind) folded before Flop
Seat 5: davetass folded before Flop (didn't bet)
Seat 6: ng2414 folded before Flop (didn't bet)



PokerStars Hand #205011488811:  Hold'em No Limit ($0.05/$0.10 USD) - 2019/10/24 22:03:41 ET
Table 'Alrami' 6-max Seat #3 is the button
Seat 1: csxwe ($14.86 in chips) 
Seat 2: PlayTheBlues4U ($26.53 in chips) 
Seat 3: clovvnfiesta ($4 in chips) 
Seat 4: crazy turfer ($19.35 in chips) 
Seat 5: davetass ($11.28 in chips) 
Seat 6: ng2414 ($9.60 in chips) 
crazy turfer: posts small blind $0.05
davetass: posts big blind $0.10
*** HOLE CARDS ***
Dealt to PlayTheBlues4U [6c 6s]
PlayTheBlues4U said, "yea! best friends forever off"
davetass said, "lol"
ng2414: folds 
csxwe: folds 
PlayTheBlues4U: calls $0.10
davetass said, "i knew what he meant"
clovvnfiesta: folds 
crazy turfer: folds 
davetass: checks 
*** FLOP *** [2h 9c Kd]
davetass: checks 
PlayTheBlues4U: checks 
*** TURN *** [2h 9c Kd] [Jc]
davetass: bets $0.10
csxwe said, "done"
PlayTheBlues4U: folds [6c 6s]
Uncalled bet ($0.10) returned to davetass
davetass collected $0.24 from pot
davetass: doesn't show hand 
*** SUMMARY ***
Total pot $0.25 | Rake $0.01 
Board [2h 9c Kd Jc]
Seat 1: csxwe folded before Flop (didn't bet)
Seat 2: PlayTheBlues4U folded on the Turn
Seat 3: clovvnfiesta (button) folded before Flop (didn't bet)
Seat 4: crazy turfer (small blind) folded before Flop
Seat 5: davetass (big blind) collected ($0.24)
Seat 6: ng2414 folded before Flop (didn't bet)



PokerStars Hand #205008743799:  Hold'em No Limit ($0.05/$0.10 USD) - 2019/10/24 20:20:29 ET
Table 'Atala' 6-max Seat #6 is the button
Seat 1: BernieGB ($6.21 in chips) 
Seat 2: PlayTheBlues4U ($10 in chips) 
Seat 3: blackey 35 ($21.06 in chips) 
Seat 4: Jl roll ($44.01 in chips) 
Seat 5: ZTP0 ($8.22 in chips) 
Seat 6: dmg3000 ($19.12 in chips) 
BernieGB: posts small blind $0.05
PlayTheBlues4U: posts big blind $0.10
*** HOLE CARDS ***
Dealt to PlayTheBlues4U [2h 6d]
blackey 35: folds 
Jl roll: folds 
ZTP0: raises $0.20 to $0.30
dmg3000: calls $0.30
BernieGB: calls $0.25
PlayTheBlues4U: folds 
*** FLOP *** [3s 5s Js]
BernieGB: checks 
ZTP0: checks 
dmg3000: bets $0.60
BernieGB: raises $1.40 to $2
ZTP0: folds 
dmg3000: folds 
Uncalled bet ($1.40) returned to BernieGB
BernieGB collected $2.09 from pot
*** SUMMARY ***
Total pot $2.20 | Rake $0.11 
Board [3s 5s Js]
Seat 1: BernieGB (small blind) collected ($2.09)
Seat 2: PlayTheBlues4U (big blind) folded before Flop
Seat 3: blackey 35 folded before Flop (didn't bet)
Seat 4: Jl roll folded before Flop (didn't bet)
Seat 5: ZTP0 folded on the Flop
Seat 6: dmg3000 (button) folded on the Flop



PokerStars Hand #205008743989:  Hold'em No Limit ($0.05/$0.10 USD) - 2019/10/24 20:21:17 ET
Table 'Atala' 6-max Seat #1 is the button
Seat 1: BernieGB ($7.40 in chips) 
Seat 2: PlayTheBlues4U ($9.90 in chips) 
Seat 3: blackey 35 ($21.06 in chips) 
Seat 4: Jl roll ($44.01 in chips) 
Seat 5: ZTP0 ($7.92 in chips) 
Seat 6: dmg3000 ($18.22 in chips) 
PlayTheBlues4U: posts small blind $0.05
blackey 35: posts big blind $0.10
*** HOLE CARDS ***
Dealt to PlayTheBlues4U [Jh Kc]
Jl roll: calls $0.10
ZTP0: raises $0.20 to $0.30
dmg3000: folds 
BernieGB: raises $0.90 to $1.20
PlayTheBlues4U: folds 
blackey 35: folds 
Jl roll: folds 
ZTP0: calls $0.90
*** FLOP *** [4h 7c 5s]
ZTP0: checks 
BernieGB: bets $1.80
ZTP0: calls $1.80
*** TURN *** [4h 7c 5s] [8c]
ZTP0: checks 
BernieGB: checks 
*** RIVER *** [4h 7c 5s 8c] [Kh]
ZTP0: bets $4.92 and is all-in
BernieGB: calls $4.40 and is all-in
Uncalled bet ($0.52) returned to ZTP0
*** SHOW DOWN ***
ZTP0: shows [Ts As] (high card Ace)
BernieGB: shows [Ac Ad] (a pair of Aces)
BernieGB collected $14.30 from pot
*** SUMMARY ***
Total pot $15.05 | Rake $0.75 
Board [4h 7c 5s 8c Kh]
Seat 1: BernieGB (button) showed [Ac Ad] and won ($14.30) with a pair of Aces
Seat 2: PlayTheBlues4U (small blind) folded before Flop
Seat 3: blackey 35 (big blind) folded before Flop
Seat 4: Jl roll folded before Flop
Seat 5: ZTP0 showed [Ts As] and lost with high card Ace
Seat 6: dmg3000 folded before Flop (didn't bet)



PokerStars Hand #205008744146:  Hold'em No Limit ($0.05/$0.10 USD) - 2019/10/24 20:22:00 ET
Table 'Atala' 6-max Seat #2 is the button
Seat 1: BernieGB ($14.30 in chips) 
Seat 2: PlayTheBlues4U ($9.85 in chips) 
Seat 3: blackey 35 ($20.96 in chips) 
Seat 4: Jl roll ($43.91 in chips) 
Seat 6: dmg3000 ($18.22 in chips) 
blackey 35: posts small blind $0.05
Jl roll: posts big blind $0.10
*** HOLE CARDS ***
Dealt to PlayTheBlues4U [3c Ad]
dmg3000: folds 
BernieGB: folds 
PlayTheBlues4U: raises $0.15 to $0.25
blackey 35: folds 
Jl roll: folds 
Uncalled bet ($0.15) returned to PlayTheBlues4U
PlayTheBlues4U collected $0.25 from pot
PlayTheBlues4U: doesn't show hand 
*** SUMMARY ***
Total pot $0.25 | Rake $0 
Seat 1: BernieGB folded before Flop (didn't bet)
Seat 2: PlayTheBlues4U (button) collected ($0.25)
Seat 3: blackey 35 (small blind) folded before Flop
Seat 4: Jl roll (big blind) folded before Flop
Seat 6: dmg3000 folded before Flop (didn't bet)



PokerStars Hand #205008744257:  Hold'em No Limit ($0.05/$0.10 USD) - 2019/10/24 20:22:28 ET
Table 'Atala' 6-max Seat #3 is the button
Seat 1: BernieGB ($14.30 in chips) 
Seat 2: PlayTheBlues4U ($10 in chips) 
Seat 3: blackey 35 ($20.91 in chips) 
Seat 4: Jl roll ($43.81 in chips) 
Seat 6: dmg3000 ($18.22 in chips) 
Jl roll: posts small blind $0.05
dmg3000: posts big blind $0.10
*** HOLE CARDS ***
Dealt to PlayTheBlues4U [8c Ac]
BernieGB: folds 
PlayTheBlues4U: raises $0.20 to $0.30
blackey 35: folds 
Jl roll: calls $0.25
dmg3000: folds 
*** FLOP *** [3h 4h Ks]
Jl roll: checks 
PlayTheBlues4U: bets $0.40
Jl roll: calls $0.40
*** TURN *** [3h 4h Ks] [9d]
colinsdad16 joins the table at seat #5 
Jl roll: checks 
PlayTheBlues4U: checks 
*** RIVER *** [3h 4h Ks 9d] [Jd]
Jl roll: bets $1.40
PlayTheBlues4U: folds 
Uncalled bet ($1.40) returned to Jl roll
Jl roll collected $1.42 from pot
Jl roll: doesn't show hand 
*** SUMMARY ***
Total pot $1.50 | Rake $0.08 
Board [3h 4h Ks 9d Jd]
Seat 1: BernieGB folded before Flop (didn't bet)
Seat 2: PlayTheBlues4U folded on the River
Seat 3: blackey 35 (button) folded before Flop (didn't bet)
Seat 4: Jl roll (small blind) collected ($1.42)
Seat 6: dmg3000 (big blind) folded before Flop



PokerStars Hand #205008744417:  Hold'em No Limit ($0.05/$0.10 USD) - 2019/10/24 20:23:12 ET
Table 'Atala' 6-max Seat #4 is the button
Seat 1: BernieGB ($14.30 in chips) 
Seat 2: PlayTheBlues4U ($9.30 in chips) 
Seat 3: blackey 35 ($20.91 in chips) 
Seat 4: Jl roll ($44.53 in chips) 
Seat 6: dmg3000 ($18.12 in chips) 
dmg3000: posts small blind $0.05
BernieGB: posts big blind $0.10
*** HOLE CARDS ***
Dealt to PlayTheBlues4U [5d 3s]
PlayTheBlues4U: folds 
blackey 35: folds 
Jl roll: folds 
dmg3000: raises $0.20 to $0.30
BernieGB: folds 
Uncalled bet ($0.20) returned to dmg3000
dmg3000 collected $0.20 from pot
*** SUMMARY ***
Total pot $0.20 | Rake $0 
Seat 1: BernieGB (big blind) folded before Flop
Seat 2: PlayTheBlues4U folded before Flop (didn't bet)
Seat 3: blackey 35 folded before Flop (didn't bet)
Seat 4: Jl roll (button) folded before Flop (didn't bet)
Seat 6: dmg3000 (small blind) collected ($0.20)



PokerStars Hand #205008744468:  Hold'em No Limit ($0.05/$0.10 USD) - 2019/10/24 20:23:24 ET
Table 'Atala' 6-max Seat #6 is the button
Seat 1: BernieGB ($14.20 in chips) 
Seat 2: PlayTheBlues4U ($9.30 in chips) 
Seat 3: blackey 35 ($20.91 in chips) 
Seat 4: Jl roll ($44.53 in chips) 
Seat 5: colinsdad16 ($10 in chips) 
Seat 6: dmg3000 ($18.22 in chips) 
BernieGB: posts small blind $0.05
PlayTheBlues4U: posts big blind $0.10
colinsdad16: posts big blind $0.10
*** HOLE CARDS ***
Dealt to PlayTheBlues4U [Kd Ks]
blackey 35: raises $0.10 to $0.20
Jl roll: calls $0.20
colinsdad16: folds 
dmg3000: folds 
BernieGB: calls $0.15
PlayTheBlues4U: raises $0.80 to $1
blackey 35: calls $0.80
Jl roll: calls $0.80
BernieGB: folds 
*** FLOP *** [Qd 8c 9d]
PlayTheBlues4U: bets $2
blackey 35: folds 
Jl roll: calls $2
*** TURN *** [Qd 8c 9d] [7d]
PlayTheBlues4U: checks 
Jl roll: bets $1.10
PlayTheBlues4U: calls $1.10
*** RIVER *** [Qd 8c 9d 7d] [Ah]
PlayTheBlues4U: checks 
Jl roll: checks 
*** SHOW DOWN ***
PlayTheBlues4U: shows [Kd Ks] (a pair of Kings)
Jl roll: mucks hand 
PlayTheBlues4U collected $9.02 from pot
*** SUMMARY ***
Total pot $9.50 | Rake $0.48 
Board [Qd 8c 9d 7d Ah]
Seat 1: BernieGB (small blind) folded before Flop
Seat 2: PlayTheBlues4U (big blind) showed [Kd Ks] and won ($9.02) with a pair of Kings
Seat 3: blackey 35 folded on the Flop
Seat 4: Jl roll mucked [Th Qh]
Seat 5: colinsdad16 folded before Flop (didn't bet)
Seat 6: dmg3000 (button) folded before Flop (didn't bet)



PokerStars Hand #205008744748:  Hold'em No Limit ($0.05/$0.10 USD) - 2019/10/24 20:24:42 ET
Table 'Atala' 6-max Seat #1 is the button
Seat 1: BernieGB ($14 in chips) 
Seat 2: PlayTheBlues4U ($14.22 in chips) 
Seat 3: blackey 35 ($19.91 in chips) 
Seat 4: Jl roll ($40.43 in chips) 
Seat 5: colinsdad16 ($9.90 in chips) 
Seat 6: dmg3000 ($18.22 in chips) 
PlayTheBlues4U: posts small blind $0.05
blackey 35: posts big blind $0.10
*** HOLE CARDS ***
Dealt to PlayTheBlues4U [Th 2c]
Jl roll: folds 
colinsdad16: folds 
dmg3000: raises $0.25 to $0.35
BernieGB: folds 
PlayTheBlues4U: folds 
blackey 35: folds 
Uncalled bet ($0.25) returned to dmg3000
dmg3000 collected $0.25 from pot
*** SUMMARY ***
Total pot $0.25 | Rake $0 
Seat 1: BernieGB (button) folded before Flop (didn't bet)
Seat 2: PlayTheBlues4U (small blind) folded before Flop
Seat 3: blackey 35 (big blind) folded before Flop
Seat 4: Jl roll folded before Flop (didn't bet)
Seat 5: colinsdad16 folded before Flop (didn't bet)
Seat 6: dmg3000 collected ($0.25)



PokerStars Hand #205008744806:  Hold'em No Limit ($0.05/$0.10 USD) - 2019/10/24 20:24:57 ET
Table 'Atala' 6-max Seat #2 is the button
Seat 1: BernieGB ($14 in chips) 
Seat 2: PlayTheBlues4U ($14.17 in chips) 
Seat 3: blackey 35 ($19.81 in chips) 
Seat 4: Jl roll ($40.43 in chips) 
Seat 5: colinsdad16 ($9.90 in chips) 
Seat 6: dmg3000 ($18.37 in chips) 
blackey 35: posts small blind $0.05
Jl roll: posts big blind $0.10
*** HOLE CARDS ***
Dealt to PlayTheBlues4U [Tc 2d]
colinsdad16: folds 
dmg3000: raises $0.20 to $0.30
BernieGB: calls $0.30
PlayTheBlues4U: folds 
blackey 35: folds 
Jl roll: calls $0.20
*** FLOP *** [8s 8c 8d]
Jl roll: checks 
dmg3000: checks 
BernieGB: checks 
*** TURN *** [8s 8c 8d] [4d]
Jl roll: bets $0.20
dmg3000: calls $0.20
BernieGB: folds 
*** RIVER *** [8s 8c 8d 4d] [2s]
Jl roll: bets $1.20
dmg3000: folds 
Uncalled bet ($1.20) returned to Jl roll
Jl roll collected $1.28 from pot
Jl roll: doesn't show hand 
*** SUMMARY ***
Total pot $1.35 | Rake $0.07 
Board [8s 8c 8d 4d 2s]
Seat 1: BernieGB folded on the Turn
Seat 2: PlayTheBlues4U (button) folded before Flop (didn't bet)
Seat 3: blackey 35 (small blind) folded before Flop
Seat 4: Jl roll (big blind) collected ($1.28)
Seat 5: colinsdad16 folded before Flop (didn't bet)
Seat 6: dmg3000 folded on the River



PokerStars Hand #205008744991:  Hold'em No Limit ($0.05/$0.10 USD) - 2019/10/24 20:25:47 ET
Table 'Atala' 6-max Seat #3 is the button
Seat 1: BernieGB ($13.70 in chips) 
Seat 2: PlayTheBlues4U ($14.17 in chips) 
Seat 3: blackey 35 ($19.76 in chips) 
Seat 4: Jl roll ($41.21 in chips) 
Seat 5: colinsdad16 ($9.90 in chips) 
Seat 6: dmg3000 ($17.87 in chips) 
Jl roll: posts small blind $0.05
colinsdad16: posts big blind $0.10
*** HOLE CARDS ***
Dealt to PlayTheBlues4U [5h Js]
dmg3000: raises $0.25 to $0.35
BernieGB: folds 
PlayTheBlues4U: folds 
blackey 35: folds 
Jl roll: calls $0.30
colinsdad16: folds 
*** FLOP *** [8d 3d 5s]
Jl roll: checks 
dmg3000: bets $0.40
Jl roll: folds 
Uncalled bet ($0.40) returned to dmg3000
dmg3000 collected $0.76 from pot
*** SUMMARY ***
Total pot $0.80 | Rake $0.04 
Board [8d 3d 5s]
Seat 1: BernieGB folded before Flop (didn't bet)
Seat 2: PlayTheBlues4U folded before Flop (didn't bet)
Seat 3: blackey 35 (button) folded before Flop (didn't bet)
Seat 4: Jl roll (small blind) folded on the Flop
Seat 5: colinsdad16 (big blind) folded before Flop
Seat 6: dmg3000 collected ($0.76)



PokerStars Hand #205008745132:  Hold'em No Limit ($0.05/$0.10 USD) - 2019/10/24 20:26:26 ET
Table 'Atala' 6-max Seat #4 is the button
Seat 1: BernieGB ($13.70 in chips) 
Seat 2: PlayTheBlues4U ($14.17 in chips) 
Seat 3: blackey 35 ($19.76 in chips) 
Seat 4: Jl roll ($40.86 in chips) 
Seat 5: colinsdad16 ($9.80 in chips) 
Seat 6: dmg3000 ($18.28 in chips) 
colinsdad16: posts small blind $0.05
dmg3000: posts big blind $0.10
*** HOLE CARDS ***
Dealt to PlayTheBlues4U [5d Ad]
BernieGB: folds 
PlayTheBlues4U: raises $0.20 to $0.30
blackey 35: calls $0.30
Jl roll: folds 
colinsdad16: folds 
dmg3000: calls $0.20
*** FLOP *** [9h 4s Qh]
dmg3000: checks 
PlayTheBlues4U: checks 
blackey 35: bets $0.50
dmg3000: folds 
PlayTheBlues4U: folds 
Uncalled bet ($0.50) returned to blackey 35
blackey 35 collected $0.90 from pot
*** SUMMARY ***
Total pot $0.95 | Rake $0.05 
Board [9h 4s Qh]
Seat 1: BernieGB folded before Flop (didn't bet)
Seat 2: PlayTheBlues4U folded on the Flop
Seat 3: blackey 35 collected ($0.90)
Seat 4: Jl roll (button) folded before Flop (didn't bet)
Seat 5: colinsdad16 (small blind) folded before Flop
Seat 6: dmg3000 (big blind) folded on the Flop



PokerStars Hand #205008745291:  Hold'em No Limit ($0.05/$0.10 USD) - 2019/10/24 20:27:09 ET
Table 'Atala' 6-max Seat #5 is the button
Seat 1: BernieGB ($13.70 in chips) 
Seat 2: PlayTheBlues4U ($13.87 in chips) 
Seat 3: blackey 35 ($20.36 in chips) 
Seat 4: Jl roll ($40.86 in chips) 
Seat 5: colinsdad16 ($9.75 in chips) 
Seat 6: dmg3000 ($17.98 in chips) 
dmg3000: posts small blind $0.05
BernieGB: posts big blind $0.10
*** HOLE CARDS ***
Dealt to PlayTheBlues4U [3h Th]
PlayTheBlues4U: folds 
blackey 35: folds 
Jl roll: calls $0.10
colinsdad16: raises $0.35 to $0.45
dmg3000: folds 
BernieGB: folds 
Jl roll: calls $0.35
*** FLOP *** [5s 6h 3d]
Jl roll: bets $0.30
colinsdad16: calls $0.30
*** TURN *** [5s 6h 3d] [2c]
Jl roll: checks 
colinsdad16: bets $1.60
Jl roll: folds 
Uncalled bet ($1.60) returned to colinsdad16
colinsdad16 collected $1.57 from pot
colinsdad16: doesn't show hand 
*** SUMMARY ***
Total pot $1.65 | Rake $0.08 
Board [5s 6h 3d 2c]
Seat 1: BernieGB (big blind) folded before Flop
Seat 2: PlayTheBlues4U folded before Flop (didn't bet)
Seat 3: blackey 35 folded before Flop (didn't bet)
Seat 4: Jl roll folded on the Turn
Seat 5: colinsdad16 (button) collected ($1.57)
Seat 6: dmg3000 (small blind) folded before Flop



PokerStars Hand #205008745468:  Hold'em No Limit ($0.05/$0.10 USD) - 2019/10/24 20:27:54 ET
Table 'Atala' 6-max Seat #6 is the button
Seat 1: BernieGB ($13.60 in chips) 
Seat 2: PlayTheBlues4U ($13.87 in chips) 
Seat 3: blackey 35 ($20.36 in chips) 
Seat 4: Jl roll ($40.11 in chips) 
Seat 5: colinsdad16 ($10.57 in chips) 
Seat 6: dmg3000 ($17.93 in chips) 
BernieGB: posts small blind $0.05
PlayTheBlues4U: posts big blind $0.10
*** HOLE CARDS ***
Dealt to PlayTheBlues4U [7h Jc]
blackey 35: folds 
Jl roll: calls $0.10
colinsdad16: folds 
dmg3000: raises $0.20 to $0.30
BernieGB: folds 
PlayTheBlues4U: folds 
Jl roll: calls $0.20
*** FLOP *** [5d Ah Ac]
Jl roll: checks 
dmg3000: checks 
*** TURN *** [5d Ah Ac] [8s]
Jl roll: checks 
dmg3000: checks 
*** RIVER *** [5d Ah Ac 8s] [8c]
Jl roll: bets $0.20
dmg3000: folds 
Uncalled bet ($0.20) returned to Jl roll
Jl roll collected $0.71 from pot
Jl roll: doesn't show hand 
*** SUMMARY ***
Total pot $0.75 | Rake $0.04 
Board [5d Ah Ac 8s 8c]
Seat 1: BernieGB (small blind) folded before Flop
Seat 2: PlayTheBlues4U (big blind) folded before Flop
Seat 3: blackey 35 folded before Flop (didn't bet)
Seat 4: Jl roll collected ($0.71)
Seat 5: colinsdad16 folded before Flop (didn't bet)
Seat 6: dmg3000 (button) folded on the River



PokerStars Hand #205008745690:  Hold'em No Limit ($0.05/$0.10 USD) - 2019/10/24 20:28:47 ET
Table 'Atala' 6-max Seat #1 is the button
Seat 1: BernieGB ($13.55 in chips) 
Seat 2: PlayTheBlues4U ($13.77 in chips) 
Seat 3: blackey 35 ($20.36 in chips) 
Seat 4: Jl roll ($40.52 in chips) 
Seat 5: colinsdad16 ($10.57 in chips) 
Seat 6: dmg3000 ($17.63 in chips) 
PlayTheBlues4U: posts small blind $0.05
blackey 35: posts big blind $0.10
*** HOLE CARDS ***
Dealt to PlayTheBlues4U [4c Jc]
Jl roll: calls $0.10
colinsdad16: folds 
dmg3000: folds 
BernieGB: folds 
PlayTheBlues4U: folds 
blackey 35: checks 
*** FLOP *** [5h 2s 6h]
blackey 35: bets $0.10
Jl roll: calls $0.10
*** TURN *** [5h 2s 6h] [6d]
blackey 35: checks 
Jl roll: checks 
*** RIVER *** [5h 2s 6h 6d] [2h]
blackey 35: bets $0.30
Jl roll: calls $0.30
*** SHOW DOWN ***
blackey 35: shows [2d 7s] (a full house, Deuces full of Sixes)
Jl roll: mucks hand 
blackey 35 collected $1 from pot
*** SUMMARY ***
Total pot $1.05 | Rake $0.05 
Board [5h 2s 6h 6d 2h]
Seat 1: BernieGB (button) folded before Flop (didn't bet)
Seat 2: PlayTheBlues4U (small blind) folded before Flop
Seat 3: blackey 35 (big blind) showed [2d 7s] and won ($1) with a full house, Deuces full of Sixes
Seat 4: Jl roll mucked [Ts Qc]
Seat 5: colinsdad16 folded before Flop (didn't bet)
Seat 6: dmg3000 folded before Flop (didn't bet)



PokerStars Hand #205008745887:  Hold'em No Limit ($0.05/$0.10 USD) - 2019/10/24 20:29:35 ET
Table 'Atala' 6-max Seat #2 is the button
Seat 1: BernieGB ($13.55 in chips) 
Seat 2: PlayTheBlues4U ($13.72 in chips) 
Seat 3: blackey 35 ($20.86 in chips) 
Seat 4: Jl roll ($40.02 in chips) 
Seat 5: colinsdad16 ($10.57 in chips) 
Seat 6: dmg3000 ($17.63 in chips) 
blackey 35: posts small blind $0.05
Jl roll: posts big blind $0.10
*** HOLE CARDS ***
Dealt to PlayTheBlues4U [8c 3h]
colinsdad16: calls $0.10
dmg3000: folds 
BernieGB: folds 
PlayTheBlues4U: folds 
blackey 35: calls $0.05
Jl roll: checks 
*** FLOP *** [3c 2c 3d]
blackey 35: checks 
Jl roll: checks 
colinsdad16: checks 
*** TURN *** [3c 2c 3d] [7d]
blackey 35: checks 
Jl roll: checks 
colinsdad16: checks 
*** RIVER *** [3c 2c 3d 7d] [7s]
blackey 35: checks 
Jl roll: checks 
colinsdad16: checks 
*** SHOW DOWN ***
blackey 35: shows [8s 9d] (two pair, Sevens and Threes)
Jl roll: shows [4d Ac] (two pair, Sevens and Threes - Ace kicker)
colinsdad16: mucks hand 
Jl roll collected $0.28 from pot
*** SUMMARY ***
Total pot $0.30 | Rake $0.02 
Board [3c 2c 3d 7d 7s]
Seat 1: BernieGB folded before Flop (didn't bet)
Seat 2: PlayTheBlues4U (button) folded before Flop (didn't bet)
Seat 3: blackey 35 (small blind) showed [8s 9d] and lost with two pair, Sevens and Threes
Seat 4: Jl roll (big blind) showed [4d Ac] and won ($0.28) with two pair, Sevens and Threes
Seat 5: colinsdad16 mucked [Qd Ts]
Seat 6: dmg3000 folded before Flop (didn't bet)



PokerStars Hand #205008746037:  Hold'em No Limit ($0.05/$0.10 USD) - 2019/10/24 20:30:11 ET
Table 'Atala' 6-max Seat #3 is the button
Seat 1: BernieGB ($13.55 in chips) 
Seat 2: PlayTheBlues4U ($13.72 in chips) 
Seat 3: blackey 35 ($20.76 in chips) 
Seat 4: Jl roll ($40.20 in chips) 
Seat 5: colinsdad16 ($10.47 in chips) 
Seat 6: dmg3000 ($17.63 in chips) 
Jl roll: posts small blind $0.05
colinsdad16: posts big blind $0.10
*** HOLE CARDS ***
Dealt to PlayTheBlues4U [6c 7h]
dmg3000: raises $0.25 to $0.35
BernieGB: calls $0.35
PlayTheBlues4U: folds 
blackey 35: folds 
Jl roll: calls $0.30
colinsdad16: folds 
*** FLOP *** [Ks 9d Qs]
Jl roll: checks 
dmg3000: bets $0.55
BernieGB: folds 
Jl roll: folds 
Uncalled bet ($0.55) returned to dmg3000
dmg3000 collected $1.09 from pot
*** SUMMARY ***
Total pot $1.15 | Rake $0.06 
Board [Ks 9d Qs]
Seat 1: BernieGB folded on the Flop
Seat 2: PlayTheBlues4U folded before Flop (didn't bet)
Seat 3: blackey 35 (button) folded before Flop (didn't bet)
Seat 4: Jl roll (small blind) folded on the Flop
Seat 5: colinsdad16 (big blind) folded before Flop
Seat 6: dmg3000 collected ($1.09)



PokerStars Hand #205008746142:  Hold'em No Limit ($0.05/$0.10 USD) - 2019/10/24 20:30:35 ET
Table 'Atala' 6-max Seat #4 is the button
Seat 1: BernieGB ($13.20 in chips) 
Seat 2: PlayTheBlues4U ($13.72 in chips) 
Seat 3: blackey 35 ($20.76 in chips) 
Seat 4: Jl roll ($39.85 in chips) 
Seat 5: colinsdad16 ($10.37 in chips) 
Seat 6: dmg3000 ($18.37 in chips) 
colinsdad16: posts small blind $0.05
dmg3000: posts big blind $0.10
*** HOLE CARDS ***
Dealt to PlayTheBlues4U [6d 3d]
BernieGB: folds 
PlayTheBlues4U: folds 
blackey 35: calls $0.10
Jl roll: folds 
colinsdad16: folds 
dmg3000: checks 
*** FLOP *** [Qd Th Kc]
dmg3000: checks 
blackey 35: bets $0.10
dmg3000: folds 
Uncalled bet ($0.10) returned to blackey 35
blackey 35 collected $0.24 from pot
blackey 35: shows [Qs]
*** SUMMARY ***
Total pot $0.25 | Rake $0.01 
Board [Qd Th Kc]
Seat 1: BernieGB folded before Flop (didn't bet)
Seat 2: PlayTheBlues4U folded before Flop (didn't bet)
Seat 3: blackey 35 collected ($0.24)
Seat 4: Jl roll (button) folded before Flop (didn't bet)
Seat 5: colinsdad16 (small blind) folded before Flop
Seat 6: dmg3000 (big blind) folded on the Flop



PokerStars Hand #205008746420:  Hold'em No Limit ($0.05/$0.10 USD) - 2019/10/24 20:31:41 ET
Table 'Atala' 6-max Seat #5 is the button
Seat 1: BernieGB ($13.20 in chips) 
Seat 2: PlayTheBlues4U ($13.72 in chips) 
Seat 3: blackey 35 ($20.90 in chips) 
Seat 4: Jl roll ($39.85 in chips) 
Seat 5: colinsdad16 ($10.32 in chips) 
Seat 6: dmg3000 ($18.27 in chips) 
dmg3000: posts small blind $0.05
BernieGB: posts big blind $0.10
*** HOLE CARDS ***
Dealt to PlayTheBlues4U [Jd Kd]
PlayTheBlues4U: raises $0.20 to $0.30
blackey 35: folds 
Jl roll: calls $0.30
colinsdad16: calls $0.30
dmg3000: folds 
BernieGB: folds 
*** FLOP *** [6s 3h Qh]
PlayTheBlues4U: bets $0.60
Jl roll: calls $0.60
colinsdad16: calls $0.60
*** TURN *** [6s 3h Qh] [Jc]
PlayTheBlues4U: checks 
Jl roll: checks 
colinsdad16: checks 
*** RIVER *** [6s 3h Qh Jc] [6c]
PlayTheBlues4U: checks 
Jl roll: checks 
colinsdad16: bets $1.50
PlayTheBlues4U: folds 
Jl roll: folds 
Uncalled bet ($1.50) returned to colinsdad16
colinsdad16 collected $2.71 from pot
colinsdad16: doesn't show hand 
*** SUMMARY ***
Total pot $2.85 | Rake $0.14 
Board [6s 3h Qh Jc 6c]
Seat 1: BernieGB (big blind) folded before Flop
Seat 2: PlayTheBlues4U folded on the River
Seat 3: blackey 35 folded before Flop (didn't bet)
Seat 4: Jl roll folded on the River
Seat 5: colinsdad16 (button) collected ($2.71)
Seat 6: dmg3000 (small blind) folded before Flop



PokerStars Hand #205008746743:  Hold'em No Limit ($0.05/$0.10 USD) - 2019/10/24 20:32:55 ET
Table 'Atala' 6-max Seat #6 is the button
Seat 1: BernieGB ($13.10 in chips) 
Seat 2: PlayTheBlues4U ($12.82 in chips) 
Seat 3: blackey 35 ($20.90 in chips) 
Seat 4: Jl roll ($38.95 in chips) 
Seat 6: dmg3000 ($18.22 in chips) 
BernieGB: posts small blind $0.05
PlayTheBlues4U: posts big blind $0.10
*** HOLE CARDS ***
Dealt to PlayTheBlues4U [3d 3c]
blackey 35: calls $0.10
Jl roll: folds 
colinsdad16 leaves the table
dmg3000: folds 
BernieGB: folds 
PlayTheBlues4U: raises $0.20 to $0.30
blackey 35: calls $0.20
*** FLOP *** [8h 4d 5d]
dirty5001 joins the table at seat #5 
PlayTheBlues4U: bets $0.30
blackey 35: calls $0.30
*** TURN *** [8h 4d 5d] [Qd]
PlayTheBlues4U: checks 
blackey 35: bets $0.60
PlayTheBlues4U: folds 
Uncalled bet ($0.60) returned to blackey 35
blackey 35 collected $1.19 from pot
*** SUMMARY ***
Total pot $1.25 | Rake $0.06 
Board [8h 4d 5d Qd]
Seat 1: BernieGB (small blind) folded before Flop
Seat 2: PlayTheBlues4U (big blind) folded on the Turn
Seat 3: blackey 35 collected ($1.19)
Seat 4: Jl roll folded before Flop (didn't bet)
Seat 6: dmg3000 (button) folded before Flop (didn't bet)



PokerStars Hand #205008747013:  Hold'em No Limit ($0.05/$0.10 USD) - 2019/10/24 20:33:54 ET
Table 'Atala' 6-max Seat #1 is the button
Seat 1: BernieGB ($13.05 in chips) 
Seat 2: PlayTheBlues4U ($12.22 in chips) 
Seat 3: blackey 35 ($21.49 in chips) 
Seat 4: Jl roll ($38.95 in chips) 
Seat 6: dmg3000 ($18.22 in chips) 
PlayTheBlues4U: posts small blind $0.05
blackey 35: posts big blind $0.10
dirty5001: sits out 
*** HOLE CARDS ***
Dealt to PlayTheBlues4U [8d 9d]
Jl roll: calls $0.10
dmg3000: raises $0.30 to $0.40
BernieGB: folds 
PlayTheBlues4U: folds 
blackey 35: folds 
Jl roll: calls $0.30
*** FLOP *** [5c Jd 8c]
Jl roll: checks 
dmg3000: checks 
*** TURN *** [5c Jd 8c] [5s]
Jl roll: bets $0.30
dmg3000: calls $0.30
*** RIVER *** [5c Jd 8c 5s] [2h]
Jl roll: bets $1.10
dmg3000: folds 
Uncalled bet ($1.10) returned to Jl roll
Jl roll collected $1.47 from pot
Jl roll: doesn't show hand 
*** SUMMARY ***
Total pot $1.55 | Rake $0.08 
Board [5c Jd 8c 5s 2h]
Seat 1: BernieGB (button) folded before Flop (didn't bet)
Seat 2: PlayTheBlues4U (small blind) folded before Flop
Seat 3: blackey 35 (big blind) folded before Flop
Seat 4: Jl roll collected ($1.47)
Seat 6: dmg3000 folded on the River



PokerStars Hand #205008747204:  Hold'em No Limit ($0.05/$0.10 USD) - 2019/10/24 20:34:35 ET
Table 'Atala' 6-max Seat #2 is the button
Seat 1: BernieGB ($13.05 in chips) 
Seat 2: PlayTheBlues4U ($12.17 in chips) 
Seat 3: blackey 35 ($21.39 in chips) 
Seat 4: Jl roll ($39.72 in chips) 
Seat 6: dmg3000 ($17.52 in chips) 
blackey 35: posts small blind $0.05
Jl roll: posts big blind $0.10
dirty5001: sits out 
*** HOLE CARDS ***
Dealt to PlayTheBlues4U [3c Qd]
dmg3000: folds 
BernieGB: raises $0.20 to $0.30
PlayTheBlues4U: folds 
blackey 35: folds 
Jl roll: calls $0.20
*** FLOP *** [Jc Qs Kh]
Jl roll: bets $0.60
BernieGB: folds 
Uncalled bet ($0.60) returned to Jl roll
Jl roll collected $0.62 from pot
Jl roll: doesn't show hand 
*** SUMMARY ***
Total pot $0.65 | Rake $0.03 
Board [Jc Qs Kh]
Seat 1: BernieGB folded on the Flop
Seat 2: PlayTheBlues4U (button) folded before Flop (didn't bet)
Seat 3: blackey 35 (small blind) folded before Flop
Seat 4: Jl roll (big blind) collected ($0.62)
Seat 6: dmg3000 folded before Flop (didn't bet)



PokerStars Hand #205008747321:  Hold'em No Limit ($0.05/$0.10 USD) - 2019/10/24 20:35:00 ET
Table 'Atala' 6-max Seat #3 is the button
Seat 1: BernieGB ($12.75 in chips) 
Seat 2: PlayTheBlues4U ($12.17 in chips) 
Seat 3: blackey 35 ($21.34 in chips) 
Seat 4: Jl roll ($40.04 in chips) 
Seat 5: dirty5001 ($10 in chips) 
Seat 6: dmg3000 ($17.52 in chips) 
Jl roll: posts small blind $0.05
dirty5001: posts big blind $0.10
*** HOLE CARDS ***
Dealt to PlayTheBlues4U [Qs 9s]
dmg3000: folds 
BernieGB: raises $0.25 to $0.35
PlayTheBlues4U: folds 
blackey 35: folds 
Jl roll: calls $0.30
dirty5001: folds 
*** FLOP *** [4c Ks 9c]
Jl roll: checks 
BernieGB: checks 
*** TURN *** [4c Ks 9c] [Js]
Jl roll: checks 
BernieGB: bets $0.38
Jl roll: folds 
Uncalled bet ($0.38) returned to BernieGB
BernieGB collected $0.76 from pot
*** SUMMARY ***
Total pot $0.80 | Rake $0.04 
Board [4c Ks 9c Js]
Seat 1: BernieGB collected ($0.76)
Seat 2: PlayTheBlues4U folded before Flop (didn't bet)
Seat 3: blackey 35 (button) folded before Flop (didn't bet)
Seat 4: Jl roll (small blind) folded on the Turn
Seat 5: dirty5001 (big blind) folded before Flop
Seat 6: dmg3000 folded before Flop (didn't bet)



PokerStars Hand #205008747464:  Hold'em No Limit ($0.05/$0.10 USD) - 2019/10/24 20:35:29 ET
Table 'Atala' 6-max Seat #4 is the button
Seat 1: BernieGB ($13.16 in chips) 
Seat 2: PlayTheBlues4U ($12.17 in chips) 
Seat 3: blackey 35 ($21.34 in chips) 
Seat 4: Jl roll ($39.69 in chips) 
Seat 5: dirty5001 ($9.90 in chips) 
Seat 6: dmg3000 ($17.52 in chips) 
dirty5001: posts small blind $0.05
dmg3000: posts big blind $0.10
*** HOLE CARDS ***
Dealt to PlayTheBlues4U [7d 9d]
BernieGB: folds 
PlayTheBlues4U: raises $0.20 to $0.30
blackey 35: folds 
Jl roll: folds 
dirty5001: folds 
dmg3000: calls $0.20
*** FLOP *** [3s Jc Ah]
dmg3000: checks 
PlayTheBlues4U: bets $0.40
dmg3000: folds 
Uncalled bet ($0.40) returned to PlayTheBlues4U
PlayTheBlues4U collected $0.62 from pot
PlayTheBlues4U: doesn't show hand 
*** SUMMARY ***
Total pot $0.65 | Rake $0.03 
Board [3s Jc Ah]
Seat 1: BernieGB folded before Flop (didn't bet)
Seat 2: PlayTheBlues4U collected ($0.62)
Seat 3: blackey 35 folded before Flop (didn't bet)
Seat 4: Jl roll (button) folded before Flop (didn't bet)
Seat 5: dirty5001 (small blind) folded before Flop
Seat 6: dmg3000 (big blind) folded on the Flop



PokerStars Hand #205008747605:  Hold'em No Limit ($0.05/$0.10 USD) - 2019/10/24 20:36:02 ET
Table 'Atala' 6-max Seat #5 is the button
Seat 1: BernieGB ($13.16 in chips) 
Seat 2: PlayTheBlues4U ($12.49 in chips) 
Seat 3: blackey 35 ($21.34 in chips) 
Seat 4: Jl roll ($39.69 in chips) 
Seat 5: dirty5001 ($9.85 in chips) 
Seat 6: dmg3000 ($17.22 in chips) 
dmg3000: posts small blind $0.05
BernieGB: posts big blind $0.10
*** HOLE CARDS ***
Dealt to PlayTheBlues4U [Qh 9s]
PlayTheBlues4U: folds 
blackey 35: folds 
Jl roll: folds 
dirty5001: folds 
dmg3000: calls $0.05
BernieGB: checks 
*** FLOP *** [9c 8h Th]
dmg3000: bets $0.10
BernieGB: calls $0.10
*** TURN *** [9c 8h Th] [3s]
dmg3000: bets $0.20
BernieGB: calls $0.20
*** RIVER *** [9c 8h Th 3s] [2h]
dmg3000: bets $0.38
BernieGB: folds 
Uncalled bet ($0.38) returned to dmg3000
dmg3000 collected $0.76 from pot
*** SUMMARY ***
Total pot $0.80 | Rake $0.04 
Board [9c 8h Th 3s 2h]
Seat 1: BernieGB (big blind) folded on the River
Seat 2: PlayTheBlues4U folded before Flop (didn't bet)
Seat 3: blackey 35 folded before Flop (didn't bet)
Seat 4: Jl roll folded before Flop (didn't bet)
Seat 5: dirty5001 (button) folded before Flop (didn't bet)
Seat 6: dmg3000 (small blind) collected ($0.76)



PokerStars Hand #205008747789:  Hold'em No Limit ($0.05/$0.10 USD) - 2019/10/24 20:36:42 ET
Table 'Atala' 6-max Seat #6 is the button
Seat 1: BernieGB ($12.76 in chips) 
Seat 2: PlayTheBlues4U ($12.49 in chips) 
Seat 3: blackey 35 ($21.34 in chips) 
Seat 4: Jl roll ($39.69 in chips) 
Seat 5: dirty5001 ($9.85 in chips) 
Seat 6: dmg3000 ($17.58 in chips) 
BernieGB: posts small blind $0.05
PlayTheBlues4U: posts big blind $0.10
*** HOLE CARDS ***
Dealt to PlayTheBlues4U [7c Qc]
blackey 35: calls $0.10
Jl roll: folds 
dirty5001: folds 
dmg3000: raises $0.35 to $0.45
BernieGB: folds 
PlayTheBlues4U: folds 
blackey 35: calls $0.35
*** FLOP *** [7s 6s Ts]
blackey 35: bets $1
dmg3000: calls $1
*** TURN *** [7s 6s Ts] [3c]
blackey 35: bets $1.50
dmg3000: calls $1.50
*** RIVER *** [7s 6s Ts 3c] [2h]
blackey 35: bets $3
dmg3000: raises $5.10 to $8.10
blackey 35: folds 
Uncalled bet ($5.10) returned to dmg3000
dmg3000 collected $11.45 from pot
*** SUMMARY ***
Total pot $12.05 | Rake $0.60 
Board [7s 6s Ts 3c 2h]
Seat 1: BernieGB (small blind) folded before Flop
Seat 2: PlayTheBlues4U (big blind) folded before Flop
Seat 3: blackey 35 folded on the River
Seat 4: Jl roll folded before Flop (didn't bet)
Seat 5: dirty5001 folded before Flop (didn't bet)
Seat 6: dmg3000 (button) collected ($11.45)



PokerStars Hand #205008748312:  Hold'em No Limit ($0.05/$0.10 USD) - 2019/10/24 20:38:39 ET
Table 'Atala' 6-max Seat #1 is the button
Seat 1: BernieGB ($12.71 in chips) 
Seat 2: PlayTheBlues4U ($12.39 in chips) 
Seat 3: blackey 35 ($15.39 in chips) 
Seat 4: Jl roll ($39.69 in chips) 
Seat 5: dirty5001 ($9.85 in chips) 
Seat 6: dmg3000 ($23.08 in chips) 
PlayTheBlues4U: posts small blind $0.05
blackey 35: posts big blind $0.10
*** HOLE CARDS ***
Dealt to PlayTheBlues4U [Js Qs]
Jl roll: calls $0.10
dirty5001: folds 
dmg3000: folds 
BernieGB: folds 
PlayTheBlues4U: raises $0.30 to $0.40
blackey 35: calls $0.30
Jl roll: folds 
*** FLOP *** [Ks 3h 9c]
PlayTheBlues4U: checks 
blackey 35: bets $0.30
PlayTheBlues4U: calls $0.30
*** TURN *** [Ks 3h 9c] [As]
PlayTheBlues4U: checks 
blackey 35: bets $0.40
PlayTheBlues4U: calls $0.40
*** RIVER *** [Ks 3h 9c As] [2c]
PlayTheBlues4U: checks 
blackey 35: checks 
*** SHOW DOWN ***
PlayTheBlues4U: shows [Js Qs] (high card Ace)
blackey 35: shows [Kd 8h] (a pair of Kings)
blackey 35 collected $2.18 from pot
*** SUMMARY ***
Total pot $2.30 | Rake $0.12 
Board [Ks 3h 9c As 2c]
Seat 1: BernieGB (button) folded before Flop (didn't bet)
Seat 2: PlayTheBlues4U (small blind) showed [Js Qs] and lost with high card Ace
Seat 3: blackey 35 (big blind) showed [Kd 8h] and won ($2.18) with a pair of Kings
Seat 4: Jl roll folded before Flop
Seat 5: dirty5001 folded before Flop (didn't bet)
Seat 6: dmg3000 folded before Flop (didn't bet)



PokerStars Hand #205008748629:  Hold'em No Limit ($0.05/$0.10 USD) - 2019/10/24 20:39:53 ET
Table 'Atala' 6-max Seat #2 is the button
Seat 1: BernieGB ($12.71 in chips) 
Seat 2: PlayTheBlues4U ($11.29 in chips) 
Seat 3: blackey 35 ($16.47 in chips) 
Seat 4: Jl roll ($39.59 in chips) 
Seat 5: dirty5001 ($9.85 in chips) 
Seat 6: dmg3000 ($23.08 in chips) 
blackey 35: posts small blind $0.05
Jl roll: posts big blind $0.10
*** HOLE CARDS ***
Dealt to PlayTheBlues4U [Jc 2s]
dirty5001: calls $0.10
dmg3000: folds 
BernieGB: folds 
PlayTheBlues4U: folds 
blackey 35: folds 
Jl roll: checks 
*** FLOP *** [Jh Ac 7h]
Jl roll: checks 
dirty5001: bets $0.18
Jl roll: folds 
Uncalled bet ($0.18) returned to dirty5001
dirty5001 collected $0.24 from pot
dirty5001: doesn't show hand 
*** SUMMARY ***
Total pot $0.25 | Rake $0.01 
Board [Jh Ac 7h]
Seat 1: BernieGB folded before Flop (didn't bet)
Seat 2: PlayTheBlues4U (button) folded before Flop (didn't bet)
Seat 3: blackey 35 (small blind) folded before Flop
Seat 4: Jl roll (big blind) folded on the Flop
Seat 5: dirty5001 collected ($0.24)
Seat 6: dmg3000 folded before Flop (didn't bet)



PokerStars Hand #205008748786:  Hold'em No Limit ($0.05/$0.10 USD) - 2019/10/24 20:40:27 ET
Table 'Atala' 6-max Seat #3 is the button
Seat 1: BernieGB ($12.71 in chips) 
Seat 2: PlayTheBlues4U ($11.29 in chips) 
Seat 3: blackey 35 ($16.42 in chips) 
Seat 4: Jl roll ($39.49 in chips) 
Seat 5: dirty5001 ($9.99 in chips) 
Seat 6: dmg3000 ($23.08 in chips) 
Jl roll: posts small blind $0.05
dirty5001: posts big blind $0.10
*** HOLE CARDS ***
Dealt to PlayTheBlues4U [Th Jh]
dmg3000: calls $0.10
BernieGB: folds 
PlayTheBlues4U: raises $0.30 to $0.40
blackey 35: folds 
Jl roll: calls $0.35
dirty5001: folds 
dmg3000: folds 
*** FLOP *** [6h 7s 7c]
Jl roll: bets $0.20
PlayTheBlues4U: folds 
Uncalled bet ($0.20) returned to Jl roll
Jl roll collected $0.95 from pot
Jl roll: doesn't show hand 
*** SUMMARY ***
Total pot $1 | Rake $0.05 
Board [6h 7s 7c]
Seat 1: BernieGB folded before Flop (didn't bet)
Seat 2: PlayTheBlues4U folded on the Flop
Seat 3: blackey 35 (button) folded before Flop (didn't bet)
Seat 4: Jl roll (small blind) collected ($0.95)
Seat 5: dirty5001 (big blind) folded before Flop
Seat 6: dmg3000 folded before Flop



PokerStars Hand #205008748884:  Hold'em No Limit ($0.05/$0.10 USD) - 2019/10/24 20:40:52 ET
Table 'Atala' 6-max Seat #4 is the button
Seat 1: BernieGB ($12.71 in chips) 
Seat 2: PlayTheBlues4U ($10.89 in chips) 
Seat 3: blackey 35 ($16.42 in chips) 
Seat 4: Jl roll ($40.04 in chips) 
Seat 5: dirty5001 ($9.89 in chips) 
Seat 6: dmg3000 ($22.98 in chips) 
dirty5001: posts small blind $0.05
dmg3000: posts big blind $0.10
*** HOLE CARDS ***
Dealt to PlayTheBlues4U [7d Ad]
BernieGB: folds 
PlayTheBlues4U: raises $0.20 to $0.30
blackey 35: folds 
Jl roll: folds 
dirty5001: folds 
dmg3000: folds 
Uncalled bet ($0.20) returned to PlayTheBlues4U
PlayTheBlues4U collected $0.25 from pot
PlayTheBlues4U: doesn't show hand 
*** SUMMARY ***
Total pot $0.25 | Rake $0 
Seat 1: BernieGB folded before Flop (didn't bet)
Seat 2: PlayTheBlues4U collected ($0.25)
Seat 3: blackey 35 folded before Flop (didn't bet)
Seat 4: Jl roll (button) folded before Flop (didn't bet)
Seat 5: dirty5001 (small blind) folded before Flop
Seat 6: dmg3000 (big blind) folded before Flop



PokerStars Hand #205008748996:  Hold'em No Limit ($0.05/$0.10 USD) - 2019/10/24 20:41:16 ET
Table 'Atala' 6-max Seat #5 is the button
Seat 1: BernieGB ($12.71 in chips) 
Seat 2: PlayTheBlues4U ($11.04 in chips) 
Seat 3: blackey 35 ($16.42 in chips) 
Seat 4: Jl roll ($40.04 in chips) 
Seat 5: dirty5001 ($9.84 in chips) 
Seat 6: dmg3000 ($22.88 in chips) 
dmg3000: posts small blind $0.05
BernieGB: posts big blind $0.10
*** HOLE CARDS ***
Dealt to PlayTheBlues4U [Ad 6s]
PlayTheBlues4U: folds 
blackey 35: calls $0.10
Jl roll: calls $0.10
dirty5001: folds 
dmg3000: calls $0.05
BernieGB: checks 
*** FLOP *** [Qs 6d 3s]
dmg3000: bets $0.38
BernieGB: folds 
blackey 35: folds 
Jl roll: folds 
Uncalled bet ($0.38) returned to dmg3000
dmg3000 collected $0.38 from pot
*** SUMMARY ***
Total pot $0.40 | Rake $0.02 
Board [Qs 6d 3s]
Seat 1: BernieGB (big blind) folded on the Flop
Seat 2: PlayTheBlues4U folded before Flop (didn't bet)
Seat 3: blackey 35 folded on the Flop
Seat 4: Jl roll folded on the Flop
Seat 5: dirty5001 (button) folded before Flop (didn't bet)
Seat 6: dmg3000 (small blind) collected ($0.38)



PokerStars Hand #205008749151:  Hold'em No Limit ($0.05/$0.10 USD) - 2019/10/24 20:41:57 ET
Table 'Atala' 6-max Seat #6 is the button
Seat 1: BernieGB ($12.61 in chips) 
Seat 2: PlayTheBlues4U ($11.04 in chips) 
Seat 3: blackey 35 ($16.32 in chips) 
Seat 4: Jl roll ($39.94 in chips) 
Seat 5: dirty5001 ($9.84 in chips) 
Seat 6: dmg3000 ($23.16 in chips) 
BernieGB: posts small blind $0.05
PlayTheBlues4U: posts big blind $0.10
*** HOLE CARDS ***
Dealt to PlayTheBlues4U [2h 5c]
blackey 35: folds 
Jl roll: calls $0.10
dirty5001: folds 
dmg3000: raises $0.30 to $0.40
BernieGB: folds 
PlayTheBlues4U: folds 
Jl roll: folds 
Uncalled bet ($0.30) returned to dmg3000
dmg3000 collected $0.35 from pot
*** SUMMARY ***
Total pot $0.35 | Rake $0 
Seat 1: BernieGB (small blind) folded before Flop
Seat 2: PlayTheBlues4U (big blind) folded before Flop
Seat 3: blackey 35 folded before Flop (didn't bet)
Seat 4: Jl roll folded before Flop
Seat 5: dirty5001 folded before Flop (didn't bet)
Seat 6: dmg3000 (button) collected ($0.35)



PokerStars Hand #205008749259:  Hold'em No Limit ($0.05/$0.10 USD) - 2019/10/24 20:42:20 ET
Table 'Atala' 6-max Seat #1 is the button
Seat 1: BernieGB ($12.56 in chips) 
Seat 2: PlayTheBlues4U ($10.94 in chips) 
Seat 3: blackey 35 ($16.32 in chips) 
Seat 4: Jl roll ($39.84 in chips) 
Seat 5: dirty5001 ($9.84 in chips) 
Seat 6: dmg3000 ($23.41 in chips) 
PlayTheBlues4U: posts small blind $0.05
blackey 35: posts big blind $0.10
*** HOLE CARDS ***
Dealt to PlayTheBlues4U [Ac Js]
Jl roll: calls $0.10
dirty5001: folds 
dmg3000: folds 
BernieGB: calls $0.10
PlayTheBlues4U: raises $0.40 to $0.50
blackey 35: folds 
Jl roll: calls $0.40
BernieGB: folds 
*** FLOP *** [Qc 2d 6s]
PlayTheBlues4U: checks 
Jl roll: checks 
*** TURN *** [Qc 2d 6s] [3d]
PlayTheBlues4U: checks 
Jl roll: bets $0.40
PlayTheBlues4U: folds 
Uncalled bet ($0.40) returned to Jl roll
Jl roll collected $1.14 from pot
Jl roll: doesn't show hand 
*** SUMMARY ***
Total pot $1.20 | Rake $0.06 
Board [Qc 2d 6s 3d]
Seat 1: BernieGB (button) folded before Flop
Seat 2: PlayTheBlues4U (small blind) folded on the Turn
Seat 3: blackey 35 (big blind) folded before Flop
Seat 4: Jl roll collected ($1.14)
Seat 5: dirty5001 folded before Flop (didn't bet)
Seat 6: dmg3000 folded before Flop (didn't bet)



PokerStars Hand #205008749543:  Hold'em No Limit ($0.05/$0.10 USD) - 2019/10/24 20:43:30 ET
Table 'Atala' 6-max Seat #2 is the button
Seat 1: BernieGB ($12.46 in chips) 
Seat 2: PlayTheBlues4U ($10.44 in chips) 
Seat 3: blackey 35 ($16.22 in chips) 
Seat 4: Jl roll ($40.48 in chips) 
Seat 5: dirty5001 ($9.84 in chips) 
Seat 6: dmg3000 ($23.41 in chips) 
blackey 35: posts small blind $0.05
Jl roll: posts big blind $0.10
*** HOLE CARDS ***
Dealt to PlayTheBlues4U [3s 6h]
dirty5001: folds 
dmg3000: folds 
BernieGB: folds 
PlayTheBlues4U: folds 
blackey 35: calls $0.05
Jl roll: raises $0.30 to $0.40
blackey 35: folds 
Uncalled bet ($0.30) returned to Jl roll
Jl roll collected $0.20 from pot
Jl roll: doesn't show hand 
*** SUMMARY ***
Total pot $0.20 | Rake $0 
Seat 1: BernieGB folded before Flop (didn't bet)
Seat 2: PlayTheBlues4U (button) folded before Flop (didn't bet)
Seat 3: blackey 35 (small blind) folded before Flop
Seat 4: Jl roll (big blind) collected ($0.20)
Seat 5: dirty5001 folded before Flop (didn't bet)
Seat 6: dmg3000 folded before Flop (didn't bet)



PokerStars Hand #205008749679:  Hold'em No Limit ($0.05/$0.10 USD) - 2019/10/24 20:44:01 ET
Table 'Atala' 6-max Seat #3 is the button
Seat 1: BernieGB ($12.46 in chips) 
Seat 2: PlayTheBlues4U ($10.44 in chips) 
Seat 3: blackey 35 ($16.12 in chips) 
Seat 4: Jl roll ($40.58 in chips) 
Seat 5: dirty5001 ($9.84 in chips) 
Seat 6: dmg3000 ($23.41 in chips) 
Jl roll: posts small blind $0.05
dirty5001: posts big blind $0.10
*** HOLE CARDS ***
Dealt to PlayTheBlues4U [As 7d]
dmg3000: raises $0.25 to $0.35
BernieGB: folds 
PlayTheBlues4U: folds 
blackey 35: folds 
Jl roll: calls $0.30
dirty5001: raises $1.40 to $1.75
dmg3000: calls $1.40
Jl roll: folds 
*** FLOP *** [Qd Kc Jd]
dirty5001: bets $1.75
dmg3000: raises $7.16 to $8.91
dirty5001: calls $6.34 and is all-in
Uncalled bet ($0.82) returned to dmg3000
*** TURN *** [Qd Kc Jd] [2d]
*** RIVER *** [Qd Kc Jd 2d] [Tc]
*** SHOW DOWN ***
dirty5001: shows [Ah Ad] (a straight, Ten to Ace)
dmg3000: shows [Jh Jc] (three of a kind, Jacks)
dirty5001 collected $19.03 from pot
*** SUMMARY ***
Total pot $20.03 | Rake $1 
Board [Qd Kc Jd 2d Tc]
Seat 1: BernieGB folded before Flop (didn't bet)
Seat 2: PlayTheBlues4U folded before Flop (didn't bet)
Seat 3: blackey 35 (button) folded before Flop (didn't bet)
Seat 4: Jl roll (small blind) folded before Flop
Seat 5: dirty5001 (big blind) showed [Ah Ad] and won ($19.03) with a straight, Ten to Ace
Seat 6: dmg3000 showed [Jh Jc] and lost with three of a kind, Jacks



PokerStars Hand #205009472148:  Hold'em No Limit ($0.05/$0.10 USD) - 2019/10/24 20:45:51 ET
Table 'Atala' 6-max Seat #4 is the button
Seat 1: BernieGB ($12.46 in chips) 
Seat 2: PlayTheBlues4U ($10.44 in chips) 
Seat 3: blackey 35 ($16.12 in chips) 
Seat 4: Jl roll ($40.23 in chips) 
Seat 5: dirty5001 ($19.03 in chips) 
Seat 6: dmg3000 ($13.57 in chips) 
dirty5001: posts small blind $0.05
dmg3000: posts big blind $0.10
*** HOLE CARDS ***
Dealt to PlayTheBlues4U [7d 7s]
PlayTheBlues4U said, "oof"
BernieGB: folds 
PlayTheBlues4U: raises $0.20 to $0.30
blackey 35: folds 
Jl roll: calls $0.30
dirty5001: calls $0.25
dmg3000: calls $0.20
*** FLOP *** [5s Qs 4c]
dirty5001: checks 
dmg3000: checks 
PlayTheBlues4U: checks 
Jl roll: bets $0.20
dirty5001: folds 
dmg3000: calls $0.20
PlayTheBlues4U: calls $0.20
*** TURN *** [5s Qs 4c] [5c]
dmg3000: bets $1
PlayTheBlues4U: folds 
Jl roll: folds 
Uncalled bet ($1) returned to dmg3000
dmg3000 collected $1.71 from pot
*** SUMMARY ***
Total pot $1.80 | Rake $0.09 
Board [5s Qs 4c 5c]
Seat 1: BernieGB folded before Flop (didn't bet)
Seat 2: PlayTheBlues4U folded on the Turn
Seat 3: blackey 35 folded before Flop (didn't bet)
Seat 4: Jl roll (button) folded on the Turn
Seat 5: dirty5001 (small blind) folded on the Flop
Seat 6: dmg3000 (big blind) collected ($1.71)



PokerStars Hand #205009472461:  Hold'em No Limit ($0.05/$0.10 USD) - 2019/10/24 20:47:00 ET
Table 'Atala' 6-max Seat #5 is the button
Seat 1: BernieGB ($12.46 in chips) 
Seat 2: PlayTheBlues4U ($9.94 in chips) 
Seat 3: blackey 35 ($16.12 in chips) 
Seat 4: Jl roll ($39.73 in chips) 
Seat 5: dirty5001 ($18.73 in chips) 
Seat 6: dmg3000 ($14.78 in chips) 
dmg3000: posts small blind $0.05
BernieGB: posts big blind $0.10
*** HOLE CARDS ***
Dealt to PlayTheBlues4U [8d 2h]
PlayTheBlues4U: folds 
blackey 35: calls $0.10
Jl roll: folds 
dirty5001: calls $0.10
dmg3000: calls $0.05
BernieGB: checks 
*** FLOP *** [3h Qh Kd]
dmg3000: checks 
BernieGB: bets $0.19
blackey 35: calls $0.19
dirty5001: folds 
dmg3000: folds 
*** TURN *** [3h Qh Kd] [6d]
BernieGB: bets $0.37
blackey 35: calls $0.37
*** RIVER *** [3h Qh Kd 6d] [5d]
BernieGB: checks 
blackey 35: checks 
*** SHOW DOWN ***
BernieGB: shows [8s Qd] (a pair of Queens)
blackey 35: shows [5s Ks] (two pair, Kings and Fives)
blackey 35 collected $1.44 from pot
*** SUMMARY ***
Total pot $1.52 | Rake $0.08 
Board [3h Qh Kd 6d 5d]
Seat 1: BernieGB (big blind) showed [8s Qd] and lost with a pair of Queens
Seat 2: PlayTheBlues4U folded before Flop (didn't bet)
Seat 3: blackey 35 showed [5s Ks] and won ($1.44) with two pair, Kings and Fives
Seat 4: Jl roll folded before Flop (didn't bet)
Seat 5: dirty5001 (button) folded on the Flop
Seat 6: dmg3000 (small blind) folded on the Flop



PokerStars Hand #205009472752:  Hold'em No Limit ($0.05/$0.10 USD) - 2019/10/24 20:48:05 ET
Table 'Atala' 6-max Seat #6 is the button
Seat 1: BernieGB ($11.80 in chips) 
Seat 2: PlayTheBlues4U ($9.94 in chips) 
Seat 3: blackey 35 ($16.90 in chips) 
Seat 4: Jl roll ($39.73 in chips) 
Seat 5: dirty5001 ($18.63 in chips) 
Seat 6: dmg3000 ($14.68 in chips) 
BernieGB: posts small blind $0.05
PlayTheBlues4U: posts big blind $0.10
*** HOLE CARDS ***
Dealt to PlayTheBlues4U [8d 6d]
blackey 35: raises $0.10 to $0.20
Jl roll: folds 
dirty5001: folds 
dmg3000: calls $0.20
BernieGB: raises $0.70 to $0.90
PlayTheBlues4U: folds 
blackey 35: folds 
dmg3000: folds 
Uncalled bet ($0.70) returned to BernieGB
BernieGB collected $0.70 from pot
*** SUMMARY ***
Total pot $0.70 | Rake $0 
Seat 1: BernieGB (small blind) collected ($0.70)
Seat 2: PlayTheBlues4U (big blind) folded before Flop
Seat 3: blackey 35 folded before Flop
Seat 4: Jl roll folded before Flop (didn't bet)
Seat 5: dirty5001 folded before Flop (didn't bet)
Seat 6: dmg3000 (button) folded before Flop



PokerStars Hand #205009472937:  Hold'em No Limit ($0.05/$0.10 USD) - 2019/10/24 20:48:48 ET
Table 'Atala' 6-max Seat #1 is the button
Seat 1: BernieGB ($12.30 in chips) 
Seat 2: PlayTheBlues4U ($9.84 in chips) 
Seat 3: blackey 35 ($16.70 in chips) 
Seat 4: Jl roll ($39.73 in chips) 
Seat 5: dirty5001 ($18.63 in chips) 
Seat 6: dmg3000 ($14.48 in chips) 
PlayTheBlues4U: posts small blind $0.05
blackey 35: posts big blind $0.10
*** HOLE CARDS ***
Dealt to PlayTheBlues4U [Jc 2s]
Jl roll: folds 
dirty5001: folds 
dmg3000: calls $0.10
BernieGB: folds 
PlayTheBlues4U: folds 
blackey 35: checks 
*** FLOP *** [Ac 8s 9s]
blackey 35: checks 
dmg3000: checks 
*** TURN *** [Ac 8s 9s] [7s]
blackey 35: checks 
dmg3000: checks 
*** RIVER *** [Ac 8s 9s 7s] [Qs]
blackey 35: bets $0.10
dmg3000: folds 
Uncalled bet ($0.10) returned to blackey 35
blackey 35 collected $0.24 from pot
*** SUMMARY ***
Total pot $0.25 | Rake $0.01 
Board [Ac 8s 9s 7s Qs]
Seat 1: BernieGB (button) folded before Flop (didn't bet)
Seat 2: PlayTheBlues4U (small blind) folded before Flop
Seat 3: blackey 35 (big blind) collected ($0.24)
Seat 4: Jl roll folded before Flop (didn't bet)
Seat 5: dirty5001 folded before Flop (didn't bet)
Seat 6: dmg3000 folded on the River



PokerStars Hand #205009473083:  Hold'em No Limit ($0.05/$0.10 USD) - 2019/10/24 20:49:21 ET
Table 'Atala' 6-max Seat #2 is the button
Seat 1: BernieGB ($12.30 in chips) 
Seat 2: PlayTheBlues4U ($9.79 in chips) 
Seat 3: blackey 35 ($16.84 in chips) 
Seat 4: Jl roll ($39.73 in chips) 
Seat 5: dirty5001 ($18.63 in chips) 
Seat 6: dmg3000 ($14.38 in chips) 
blackey 35: posts small blind $0.05
Jl roll: posts big blind $0.10
*** HOLE CARDS ***
Dealt to PlayTheBlues4U [Qs 7s]
dirty5001: folds 
dmg3000: calls $0.10
BernieGB: calls $0.10
PlayTheBlues4U: folds 
blackey 35: raises $0.30 to $0.40
Jl roll: folds 
dmg3000: folds 
BernieGB: folds 
Uncalled bet ($0.30) returned to blackey 35
blackey 35 collected $0.40 from pot
*** SUMMARY ***
Total pot $0.40 | Rake $0 
Seat 1: BernieGB folded before Flop
Seat 2: PlayTheBlues4U (button) folded before Flop (didn't bet)
Seat 3: blackey 35 (small blind) collected ($0.40)
Seat 4: Jl roll (big blind) folded before Flop
Seat 5: dirty5001 folded before Flop (didn't bet)
Seat 6: dmg3000 folded before Flop



PokerStars Hand #205009473236:  Hold'em No Limit ($0.05/$0.10 USD) - 2019/10/24 20:49:57 ET
Table 'Atala' 6-max Seat #3 is the button
Seat 1: BernieGB ($12.20 in chips) 
Seat 2: PlayTheBlues4U ($9.79 in chips) 
Seat 3: blackey 35 ($17.14 in chips) 
Seat 4: Jl roll ($39.63 in chips) 
Seat 5: dirty5001 ($18.63 in chips) 
Seat 6: dmg3000 ($14.28 in chips) 
Jl roll: posts small blind $0.05
dirty5001: posts big blind $0.10
*** HOLE CARDS ***
Dealt to PlayTheBlues4U [3s Td]
dmg3000: raises $0.20 to $0.30
BernieGB: folds 
PlayTheBlues4U: folds 
blackey 35: folds 
Jl roll: calls $0.25
dirty5001: folds 
*** FLOP *** [2s Qh Jd]
Jl roll: checks 
dmg3000: bets $0.33
Jl roll: calls $0.33
*** TURN *** [2s Qh Jd] [8h]
Jl roll: bets $0.20
dmg3000: calls $0.20
*** RIVER *** [2s Qh Jd 8h] [7c]
Jl roll: checks 
dmg3000: checks 
*** SHOW DOWN ***
Jl roll: shows [Ah 6h] (high card Ace)
dmg3000: shows [Qc 9d] (a pair of Queens)
dmg3000 collected $1.67 from pot
*** SUMMARY ***
Total pot $1.76 | Rake $0.09 
Board [2s Qh Jd 8h 7c]
Seat 1: BernieGB folded before Flop (didn't bet)
Seat 2: PlayTheBlues4U folded before Flop (didn't bet)
Seat 3: blackey 35 (button) folded before Flop (didn't bet)
Seat 4: Jl roll (small blind) showed [Ah 6h] and lost with high card Ace
Seat 5: dirty5001 (big blind) folded before Flop
Seat 6: dmg3000 showed [Qc 9d] and won ($1.67) with a pair of Queens



PokerStars Hand #205009473385:  Hold'em No Limit ($0.05/$0.10 USD) - 2019/10/24 20:50:32 ET
Table 'Atala' 6-max Seat #4 is the button
Seat 1: BernieGB ($12.20 in chips) 
Seat 2: PlayTheBlues4U ($9.79 in chips) 
Seat 3: blackey 35 ($17.14 in chips) 
Seat 4: Jl roll ($38.80 in chips) 
Seat 5: dirty5001 ($18.53 in chips) 
Seat 6: dmg3000 ($15.12 in chips) 
dirty5001: posts small blind $0.05
dmg3000: posts big blind $0.10
*** HOLE CARDS ***
Dealt to PlayTheBlues4U [Kh 5c]
BernieGB: calls $0.10
PlayTheBlues4U: folds 
blackey 35: calls $0.10
Jl roll: calls $0.10
dirty5001: calls $0.05
dmg3000: checks 
*** FLOP *** [Jh 7h 3c]
dirty5001: checks 
dmg3000: bets $0.24
BernieGB: folds 
blackey 35: folds 
Jl roll: folds 
dirty5001: folds 
Uncalled bet ($0.24) returned to dmg3000
dmg3000 collected $0.48 from pot
*** SUMMARY ***
Total pot $0.50 | Rake $0.02 
Board [Jh 7h 3c]
Seat 1: BernieGB folded on the Flop
Seat 2: PlayTheBlues4U folded before Flop (didn't bet)
Seat 3: blackey 35 folded on the Flop
Seat 4: Jl roll (button) folded on the Flop
Seat 5: dirty5001 (small blind) folded on the Flop
Seat 6: dmg3000 (big blind) collected ($0.48)



PokerStars Hand #205009473538:  Hold'em No Limit ($0.05/$0.10 USD) - 2019/10/24 20:51:05 ET
Table 'Atala' 6-max Seat #5 is the button
Seat 1: BernieGB ($12.10 in chips) 
Seat 2: PlayTheBlues4U ($9.79 in chips) 
Seat 3: blackey 35 ($17.04 in chips) 
Seat 4: Jl roll ($38.70 in chips) 
Seat 5: dirty5001 ($18.43 in chips) 
Seat 6: dmg3000 ($15.50 in chips) 
dmg3000: posts small blind $0.05
BernieGB: posts big blind $0.10
*** HOLE CARDS ***
Dealt to PlayTheBlues4U [2h As]
PlayTheBlues4U: folds 
blackey 35: calls $0.10
Jl roll: folds 
dirty5001: raises $0.20 to $0.30
dmg3000: calls $0.25
BernieGB: folds 
blackey 35: calls $0.20
*** FLOP *** [3d 9s Ah]
BernieGB leaves the table
PeteyDunham joins the table at seat #1 
dmg3000: checks 
blackey 35: checks 
dirty5001: bets $0.50
dmg3000: calls $0.50
blackey 35: folds 
*** TURN *** [3d 9s Ah] [9d]
dmg3000: bets $0.60
dirty5001: calls $0.60
*** RIVER *** [3d 9s Ah 9d] [6c]
dmg3000: bets $1.52
dirty5001: calls $1.52
*** SHOW DOWN ***
dmg3000: shows [Ad 2d] (two pair, Aces and Nines)
dirty5001: shows [Ac Jd] (two pair, Aces and Nines - Jack kicker)
dirty5001 collected $5.93 from pot
*** SUMMARY ***
Total pot $6.24 | Rake $0.31 
Board [3d 9s Ah 9d 6c]
Seat 1: BernieGB (big blind) folded before Flop
Seat 2: PlayTheBlues4U folded before Flop (didn't bet)
Seat 3: blackey 35 folded on the Flop
Seat 4: Jl roll folded before Flop (didn't bet)
Seat 5: dirty5001 (button) showed [Ac Jd] and won ($5.93) with two pair, Aces and Nines
Seat 6: dmg3000 (small blind) showed [Ad 2d] and lost with two pair, Aces and Nines



PokerStars Hand #205009473825:  Hold'em No Limit ($0.05/$0.10 USD) - 2019/10/24 20:52:12 ET
Table 'Atala' 6-max Seat #6 is the button
Seat 2: PlayTheBlues4U ($9.79 in chips) 
Seat 3: blackey 35 ($16.74 in chips) 
Seat 4: Jl roll ($38.70 in chips) 
Seat 5: dirty5001 ($21.44 in chips) 
Seat 6: dmg3000 ($12.58 in chips) 
PlayTheBlues4U: posts small blind $0.05
blackey 35: posts big blind $0.10
*** HOLE CARDS ***
Dealt to PlayTheBlues4U [4d 8s]
Jl roll: calls $0.10
dirty5001: folds 
dmg3000: folds 
PlayTheBlues4U: folds 
blackey 35: checks 
*** FLOP *** [5c 4h Qc]
blackey 35: bets $0.20
Jl roll: folds 
Uncalled bet ($0.20) returned to blackey 35
blackey 35 collected $0.24 from pot
*** SUMMARY ***
Total pot $0.25 | Rake $0.01 
Board [5c 4h Qc]
Seat 2: PlayTheBlues4U (small blind) folded before Flop
Seat 3: blackey 35 (big blind) collected ($0.24)
Seat 4: Jl roll folded on the Flop
Seat 5: dirty5001 folded before Flop (didn't bet)
Seat 6: dmg3000 (button) folded before Flop (didn't bet)



PokerStars Hand #205009473980:  Hold'em No Limit ($0.05/$0.10 USD) - 2019/10/24 20:52:46 ET
Table 'Atala' 6-max Seat #2 is the button
Seat 1: PeteyDunham ($10 in chips) 
Seat 2: PlayTheBlues4U ($9.74 in chips) 
Seat 3: blackey 35 ($16.88 in chips) 
Seat 4: Jl roll ($38.60 in chips) 
Seat 5: dirty5001 ($21.44 in chips) 
Seat 6: dmg3000 ($12.58 in chips) 
blackey 35: posts small blind $0.05
Jl roll: posts big blind $0.10
PeteyDunham: posts big blind $0.10
*** HOLE CARDS ***
Dealt to PlayTheBlues4U [2s Ts]
dirty5001: calls $0.10
dmg3000: folds 
PeteyDunham: checks 
PlayTheBlues4U: folds 
blackey 35: calls $0.05
Jl roll: checks 
*** FLOP *** [5c 4h 3c]
blackey 35: checks 
Jl roll: bets $0.20
dirty5001: folds 
PeteyDunham: raises $0.80 to $1
dirty5001 leaves the table
blackey 35: folds 
Jl roll: calls $0.80
*** TURN *** [5c 4h 3c] [5s]
Jl roll: checks 
PeteyDunham: bets $2.30
Jl roll: folds 
Uncalled bet ($2.30) returned to PeteyDunham
PeteyDunham collected $2.28 from pot
PeteyDunham: doesn't show hand 
*** SUMMARY ***
Total pot $2.40 | Rake $0.12 
Board [5c 4h 3c 5s]
Seat 1: PeteyDunham collected ($2.28)
Seat 2: PlayTheBlues4U (button) folded before Flop (didn't bet)
Seat 3: blackey 35 (small blind) folded on the Flop
Seat 4: Jl roll (big blind) folded on the Turn
Seat 5: dirty5001 folded on the Flop
Seat 6: dmg3000 folded before Flop (didn't bet)



PokerStars Hand #205009474228:  Hold'em No Limit ($0.05/$0.10 USD) - 2019/10/24 20:53:39 ET
Table 'Atala' 6-max Seat #3 is the button
Seat 1: PeteyDunham ($11.18 in chips) 
Seat 2: PlayTheBlues4U ($9.74 in chips) 
Seat 3: blackey 35 ($16.78 in chips) 
Seat 4: Jl roll ($37.50 in chips) 
Seat 6: dmg3000 ($12.58 in chips) 
Jl roll: posts small blind $0.05
dmg3000: posts big blind $0.10
*** HOLE CARDS ***
Dealt to PlayTheBlues4U [9h 4c]
PeteyDunham: folds 
PlayTheBlues4U: folds 
blackey 35: calls $0.10
Jl roll: folds 
dmg3000: raises $0.20 to $0.30
blackey 35: calls $0.20
*** FLOP *** [Jh Ts Qh]
dmg3000: checks 
blackey 35: checks 
*** TURN *** [Jh Ts Qh] [5s]
dmg3000: checks 
blackey 35: checks 
*** RIVER *** [Jh Ts Qh 5s] [5h]
dmg3000: bets $0.30
blackey 35: raises $0.30 to $0.60
dmg3000: folds 
Uncalled bet ($0.30) returned to blackey 35
blackey 35 collected $1.19 from pot
*** SUMMARY ***
Total pot $1.25 | Rake $0.06 
Board [Jh Ts Qh 5s 5h]
Seat 1: PeteyDunham folded before Flop (didn't bet)
Seat 2: PlayTheBlues4U folded before Flop (didn't bet)
Seat 3: blackey 35 (button) collected ($1.19)
Seat 4: Jl roll (small blind) folded before Flop
Seat 6: dmg3000 (big blind) folded on the River



PokerStars Hand #205009474471:  Hold'em No Limit ($0.05/$0.10 USD) - 2019/10/24 20:54:34 ET
Table 'Atala' 6-max Seat #4 is the button
Seat 1: PeteyDunham ($11.18 in chips) 
Seat 2: PlayTheBlues4U ($9.74 in chips) 
Seat 3: blackey 35 ($17.37 in chips) 
Seat 4: Jl roll ($37.45 in chips) 
Seat 6: dmg3000 ($11.98 in chips) 
dmg3000: posts small blind $0.05
PeteyDunham: posts big blind $0.10
*** HOLE CARDS ***
Dealt to PlayTheBlues4U [Td 8c]
PlayTheBlues4U: folds 
blackey 35: calls $0.10
Jl roll: folds 
dmg3000: calls $0.05
papag555 joins the table at seat #5 
PeteyDunham: checks 
*** FLOP *** [6d Ts 5h]
dmg3000: checks 
PeteyDunham: bets $1.20
blackey 35: folds 
dmg3000: folds 
Uncalled bet ($1.20) returned to PeteyDunham
PeteyDunham collected $0.28 from pot
PeteyDunham: doesn't show hand 
*** SUMMARY ***
Total pot $0.30 | Rake $0.02 
Board [6d Ts 5h]
Seat 1: PeteyDunham (big blind) collected ($0.28)
Seat 2: PlayTheBlues4U folded before Flop (didn't bet)
Seat 3: blackey 35 folded on the Flop
Seat 4: Jl roll (button) folded before Flop (didn't bet)
Seat 6: dmg3000 (small blind) folded on the Flop



PokerStars Hand #205009474723:  Hold'em No Limit ($0.05/$0.10 USD) - 2019/10/24 20:55:30 ET
Table 'Atala' 6-max Seat #6 is the button
Seat 1: PeteyDunham ($11.36 in chips) 
Seat 2: PlayTheBlues4U ($9.74 in chips) 
Seat 3: blackey 35 ($17.27 in chips) 
Seat 4: Jl roll ($37.45 in chips) 
Seat 5: papag555 ($10 in chips) 
Seat 6: dmg3000 ($11.88 in chips) 
PeteyDunham: posts small blind $0.05
PlayTheBlues4U: posts big blind $0.10
papag555: posts big blind $0.10
*** HOLE CARDS ***
Dealt to PlayTheBlues4U [3c Ac]
blackey 35 has timed out
blackey 35: folds 
Jl roll: calls $0.10
papag555: checks 
dmg3000: folds 
PeteyDunham: calls $0.05
PlayTheBlues4U: checks 
*** FLOP *** [5h Ks Js]
PeteyDunham: checks 
PlayTheBlues4U: checks 
Jl roll: checks 
papag555: checks 
*** TURN *** [5h Ks Js] [4c]
PeteyDunham: checks 
PlayTheBlues4U: checks 
Jl roll: bets $0.50
papag555: folds 
PeteyDunham: folds 
PlayTheBlues4U: folds 
Uncalled bet ($0.50) returned to Jl roll
Jl roll collected $0.38 from pot
Jl roll: doesn't show hand 
*** SUMMARY ***
Total pot $0.40 | Rake $0.02 
Board [5h Ks Js 4c]
Seat 1: PeteyDunham (small blind) folded on the Turn
Seat 2: PlayTheBlues4U (big blind) folded on the Turn
Seat 3: blackey 35 folded before Flop (didn't bet)
Seat 4: Jl roll collected ($0.38)
Seat 5: papag555 folded on the Turn (didn't bet)
Seat 6: dmg3000 (button) folded before Flop (didn't bet)



PokerStars Hand #205009474924:  Hold'em No Limit ($0.05/$0.10 USD) - 2019/10/24 20:56:24 ET
Table 'Atala' 6-max Seat #1 is the button
Seat 1: PeteyDunham ($11.26 in chips) 
Seat 2: PlayTheBlues4U ($9.64 in chips) 
Seat 3: blackey 35 ($17.27 in chips) 
Seat 4: Jl roll ($37.73 in chips) 
Seat 5: papag555 ($9.90 in chips) 
Seat 6: dmg3000 ($11.88 in chips) 
PlayTheBlues4U: posts small blind $0.05
blackey 35: posts big blind $0.10
*** HOLE CARDS ***
Dealt to PlayTheBlues4U [Td 7c]
Jl roll: folds 
papag555: folds 
dmg3000: folds 
PeteyDunham: calls $0.10
PlayTheBlues4U: calls $0.05
blackey 35: checks 
*** FLOP *** [3c 3h 8s]
PlayTheBlues4U: checks 
blackey 35: checks 
PeteyDunham: checks 
*** TURN *** [3c 3h 8s] [6h]
PlayTheBlues4U: checks 
blackey 35: checks 
PeteyDunham: bets $0.50
PlayTheBlues4U: folds 
blackey 35: folds 
Uncalled bet ($0.50) returned to PeteyDunham
PeteyDunham collected $0.28 from pot
PeteyDunham: doesn't show hand 
*** SUMMARY ***
Total pot $0.30 | Rake $0.02 
Board [3c 3h 8s 6h]
Seat 1: PeteyDunham (button) collected ($0.28)
Seat 2: PlayTheBlues4U (small blind) folded on the Turn
Seat 3: blackey 35 (big blind) folded on the Turn
Seat 4: Jl roll folded before Flop (didn't bet)
Seat 5: papag555 folded before Flop (didn't bet)
Seat 6: dmg3000 folded before Flop (didn't bet)



PokerStars Hand #205009475129:  Hold'em No Limit ($0.05/$0.10 USD) - 2019/10/24 20:57:17 ET
Table 'Atala' 6-max Seat #2 is the button
Seat 1: PeteyDunham ($11.44 in chips) 
Seat 2: PlayTheBlues4U ($9.54 in chips) 
Seat 3: blackey 35 ($17.17 in chips) 
Seat 4: Jl roll ($37.73 in chips) 
Seat 5: papag555 ($9.90 in chips) 
Seat 6: dmg3000 ($11.88 in chips) 
blackey 35: posts small blind $0.05
Jl roll: posts big blind $0.10
*** HOLE CARDS ***
Dealt to PlayTheBlues4U [4c 3d]
papag555: raises $0.20 to $0.30
dmg3000: calls $0.30
PeteyDunham: calls $0.30
PlayTheBlues4U: folds 
blackey 35: folds 
Jl roll: calls $0.20
*** FLOP *** [Qc 5c Jh]
Jl roll: checks 
papag555: bets $1.20
dmg3000: folds 
PeteyDunham: folds 
Jl roll: folds 
Uncalled bet ($1.20) returned to papag555
papag555 collected $1.19 from pot
papag555: doesn't show hand 
*** SUMMARY ***
Total pot $1.25 | Rake $0.06 
Board [Qc 5c Jh]
Seat 1: PeteyDunham folded on the Flop
Seat 2: PlayTheBlues4U (button) folded before Flop (didn't bet)
Seat 3: blackey 35 (small blind) folded before Flop
Seat 4: Jl roll (big blind) folded on the Flop
Seat 5: papag555 collected ($1.19)
Seat 6: dmg3000 folded on the Flop



PokerStars Hand #205009475260:  Hold'em No Limit ($0.05/$0.10 USD) - 2019/10/24 20:57:48 ET
Table 'Atala' 6-max Seat #3 is the button
Seat 1: PeteyDunham ($11.14 in chips) 
Seat 2: PlayTheBlues4U ($9.54 in chips) 
Seat 3: blackey 35 ($17.12 in chips) 
Seat 4: Jl roll ($37.43 in chips) 
Seat 5: papag555 ($10.79 in chips) 
Seat 6: dmg3000 ($11.58 in chips) 
Jl roll: posts small blind $0.05
papag555: posts big blind $0.10
*** HOLE CARDS ***
Dealt to PlayTheBlues4U [3s 9h]
dmg3000: raises $0.10 to $0.20
PeteyDunham: raises $0.40 to $0.60
PlayTheBlues4U: folds 
blackey 35: folds 
Jl roll: folds 
papag555: folds 
dmg3000: folds 
Uncalled bet ($0.40) returned to PeteyDunham
PeteyDunham collected $0.55 from pot
PeteyDunham: doesn't show hand 
*** SUMMARY ***
Total pot $0.55 | Rake $0 
Seat 1: PeteyDunham collected ($0.55)
Seat 2: PlayTheBlues4U folded before Flop (didn't bet)
Seat 3: blackey 35 (button) folded before Flop (didn't bet)
Seat 4: Jl roll (small blind) folded before Flop
Seat 5: papag555 (big blind) folded before Flop
Seat 6: dmg3000 folded before Flop



PokerStars Hand #205009475364:  Hold'em No Limit ($0.05/$0.10 USD) - 2019/10/24 20:58:17 ET
Table 'Atala' 6-max Seat #4 is the button
Seat 1: PeteyDunham ($11.49 in chips) 
Seat 2: PlayTheBlues4U ($9.54 in chips) 
Seat 3: blackey 35 ($17.12 in chips) 
Seat 4: Jl roll ($37.38 in chips) 
Seat 5: papag555 ($10.69 in chips) 
Seat 6: dmg3000 ($11.38 in chips) 
papag555: posts small blind $0.05
dmg3000: posts big blind $0.10
*** HOLE CARDS ***
Dealt to PlayTheBlues4U [4h As]
PeteyDunham: folds 
PlayTheBlues4U: folds 
blackey 35: folds 
Jl roll: raises $0.40 to $0.50
papag555: folds 
dmg3000: folds 
Uncalled bet ($0.40) returned to Jl roll
Jl roll collected $0.25 from pot
Jl roll: doesn't show hand 
*** SUMMARY ***
Total pot $0.25 | Rake $0 
Seat 1: PeteyDunham folded before Flop (didn't bet)
Seat 2: PlayTheBlues4U folded before Flop (didn't bet)
Seat 3: blackey 35 folded before Flop (didn't bet)
Seat 4: Jl roll (button) collected ($0.25)
Seat 5: papag555 (small blind) folded before Flop
Seat 6: dmg3000 (big blind) folded before Flop



PokerStars Hand #205009475476:  Hold'em No Limit ($0.05/$0.10 USD) - 2019/10/24 20:58:45 ET
Table 'Atala' 6-max Seat #5 is the button
Seat 1: PeteyDunham ($11.49 in chips) 
Seat 2: PlayTheBlues4U ($9.54 in chips) 
Seat 3: blackey 35 ($17.12 in chips) 
Seat 4: Jl roll ($37.53 in chips) 
Seat 5: papag555 ($10.64 in chips) 
Seat 6: dmg3000 ($11.28 in chips) 
dmg3000: posts small blind $0.05
PeteyDunham: posts big blind $0.10
*** HOLE CARDS ***
Dealt to PlayTheBlues4U [8d 5h]
PlayTheBlues4U: folds 
blackey 35: folds 
Jl roll: folds 
papag555: raises $0.20 to $0.30
dmg3000: folds 
PeteyDunham: calls $0.20
*** FLOP *** [Ah 9s Kc]
PeteyDunham: checks 
papag555: bets $0.40
PeteyDunham: folds 
Uncalled bet ($0.40) returned to papag555
papag555 collected $0.62 from pot
papag555: doesn't show hand 
*** SUMMARY ***
Total pot $0.65 | Rake $0.03 
Board [Ah 9s Kc]
Seat 1: PeteyDunham (big blind) folded on the Flop
Seat 2: PlayTheBlues4U folded before Flop (didn't bet)
Seat 3: blackey 35 folded before Flop (didn't bet)
Seat 4: Jl roll folded before Flop (didn't bet)
Seat 5: papag555 (button) collected ($0.62)
Seat 6: dmg3000 (small blind) folded before Flop



PokerStars Hand #205009475646:  Hold'em No Limit ($0.05/$0.10 USD) - 2019/10/24 20:59:32 ET
Table 'Atala' 6-max Seat #6 is the button
Seat 1: PeteyDunham ($11.19 in chips) 
Seat 2: PlayTheBlues4U ($9.54 in chips) 
Seat 3: blackey 35 ($17.12 in chips) 
Seat 4: Jl roll ($37.53 in chips) 
Seat 5: papag555 ($10.96 in chips) 
Seat 6: dmg3000 ($11.23 in chips) 
PeteyDunham: posts small blind $0.05
PlayTheBlues4U: posts big blind $0.10
*** HOLE CARDS ***
Dealt to PlayTheBlues4U [Tc Js]
blackey 35: calls $0.10
Jl roll: folds 
papag555: folds 
dmg3000: folds 
PeteyDunham: calls $0.05
PlayTheBlues4U: checks 
*** FLOP *** [Th 3d As]
PeteyDunham: checks 
PlayTheBlues4U: checks 
blackey 35: checks 
*** TURN *** [Th 3d As] [4d]
PeteyDunham: bets $0.30
PlayTheBlues4U: calls $0.30
blackey 35: folds 
*** RIVER *** [Th 3d As 4d] [Ks]
PeteyDunham: checks 
PlayTheBlues4U: checks 
*** SHOW DOWN ***
PeteyDunham: shows [3c Qc] (a pair of Threes)
PlayTheBlues4U: shows [Tc Js] (a pair of Tens)
PlayTheBlues4U collected $0.86 from pot
*** SUMMARY ***
Total pot $0.90 | Rake $0.04 
Board [Th 3d As 4d Ks]
Seat 1: PeteyDunham (small blind) showed [3c Qc] and lost with a pair of Threes
Seat 2: PlayTheBlues4U (big blind) showed [Tc Js] and won ($0.86) with a pair of Tens
Seat 3: blackey 35 folded on the Turn
Seat 4: Jl roll folded before Flop (didn't bet)
Seat 5: papag555 folded before Flop (didn't bet)
Seat 6: dmg3000 (button) folded before Flop (didn't bet)



PokerStars Hand #205009476014:  Hold'em No Limit ($0.05/$0.10 USD) - 2019/10/24 21:01:01 ET
Table 'Atala' 6-max Seat #1 is the button
Seat 1: PeteyDunham ($10.79 in chips) 
Seat 2: PlayTheBlues4U ($10 in chips) 
Seat 3: blackey 35 ($17.02 in chips) 
Seat 4: Jl roll ($37.53 in chips) 
Seat 5: papag555 ($10.96 in chips) 
Seat 6: dmg3000 ($11.23 in chips) 
PlayTheBlues4U: posts small blind $0.05
blackey 35: posts big blind $0.10
*** HOLE CARDS ***
Dealt to PlayTheBlues4U [9d Ad]
Jl roll: folds 
papag555: folds 
dmg3000: calls $0.10
PeteyDunham: calls $0.10
PlayTheBlues4U: raises $0.40 to $0.50
blackey 35: folds 
dmg3000: folds 
PeteyDunham: calls $0.40
*** FLOP *** [6c 7c 2h]
PlayTheBlues4U: bets $0.70
PeteyDunham: raises $2.50 to $3.20
PlayTheBlues4U: folds 
Uncalled bet ($2.50) returned to PeteyDunham
PeteyDunham collected $2.47 from pot
PeteyDunham: doesn't show hand 
*** SUMMARY ***
Total pot $2.60 | Rake $0.13 
Board [6c 7c 2h]
Seat 1: PeteyDunham (button) collected ($2.47)
Seat 2: PlayTheBlues4U (small blind) folded on the Flop
Seat 3: blackey 35 (big blind) folded before Flop
Seat 4: Jl roll folded before Flop (didn't bet)
Seat 5: papag555 folded before Flop (didn't bet)
Seat 6: dmg3000 folded before Flop



PokerStars Hand #205009476330:  Hold'em No Limit ($0.05/$0.10 USD) - 2019/10/24 21:02:12 ET
Table 'Atala' 6-max Seat #2 is the button
Seat 1: PeteyDunham ($12.06 in chips) 
Seat 2: PlayTheBlues4U ($8.80 in chips) 
Seat 3: blackey 35 ($16.92 in chips) 
Seat 4: Jl roll ($37.53 in chips) 
Seat 5: papag555 ($10.96 in chips) 
Seat 6: dmg3000 ($11.13 in chips) 
blackey 35: posts small blind $0.05
Jl roll: posts big blind $0.10
*** HOLE CARDS ***
Dealt to PlayTheBlues4U [Kd 2h]
papag555: calls $0.10
dmg3000: calls $0.10
PeteyDunham: folds 
PlayTheBlues4U: folds 
blackey 35: calls $0.05
Jl roll: raises $0.40 to $0.50
papag555: folds 
dmg3000: folds 
blackey 35: folds 
Uncalled bet ($0.40) returned to Jl roll
Jl roll collected $0.40 from pot
Jl roll: doesn't show hand 
*** SUMMARY ***
Total pot $0.40 | Rake $0 
Seat 1: PeteyDunham folded before Flop (didn't bet)
Seat 2: PlayTheBlues4U (button) folded before Flop (didn't bet)
Seat 3: blackey 35 (small blind) folded before Flop
Seat 4: Jl roll (big blind) collected ($0.40)
Seat 5: papag555 folded before Flop
Seat 6: dmg3000 folded before Flop



PokerStars Hand #205009476515:  Hold'em No Limit ($0.05/$0.10 USD) - 2019/10/24 21:02:49 ET
Table 'Atala' 6-max Seat #3 is the button
Seat 1: PeteyDunham ($12.06 in chips) 
Seat 2: PlayTheBlues4U ($8.80 in chips) 
Seat 3: blackey 35 ($16.82 in chips) 
Seat 4: Jl roll ($37.83 in chips) 
Seat 5: papag555 ($10.86 in chips) 
Seat 6: dmg3000 ($11.03 in chips) 
Jl roll: posts small blind $0.05
papag555: posts big blind $0.10
*** HOLE CARDS ***
Dealt to PlayTheBlues4U [8s Kd]
dmg3000: raises $0.20 to $0.30
PeteyDunham has timed out
PeteyDunham: folds 
PlayTheBlues4U: folds 
blackey 35: folds 
Jl roll: calls $0.25
papag555: calls $0.20
*** FLOP *** [2s 4c 7h]
Jl roll: checks 
papag555: checks 
dmg3000: checks 
*** TURN *** [2s 4c 7h] [3s]
Jl roll: checks 
papag555: bets $0.40
dmg3000: folds 
Jl roll: folds 
Uncalled bet ($0.40) returned to papag555
papag555 collected $0.86 from pot
papag555: doesn't show hand 
*** SUMMARY ***
Total pot $0.90 | Rake $0.04 
Board [2s 4c 7h 3s]
Seat 1: PeteyDunham folded before Flop (didn't bet)
Seat 2: PlayTheBlues4U folded before Flop (didn't bet)
Seat 3: blackey 35 (button) folded before Flop (didn't bet)
Seat 4: Jl roll (small blind) folded on the Turn
Seat 5: papag555 (big blind) collected ($0.86)
Seat 6: dmg3000 folded on the Turn



PokerStars Hand #205009476863:  Hold'em No Limit ($0.05/$0.10 USD) - 2019/10/24 21:04:07 ET
Table 'Atala' 6-max Seat #4 is the button
Seat 2: PlayTheBlues4U ($8.80 in chips) 
Seat 3: blackey 35 ($16.82 in chips) 
Seat 4: Jl roll ($37.53 in chips) 
Seat 5: papag555 ($11.42 in chips) 
Seat 6: dmg3000 ($10.73 in chips) 
papag555: posts small blind $0.05
dmg3000: posts big blind $0.10
*** HOLE CARDS ***
Dealt to PlayTheBlues4U [5s 8c]
PlayTheBlues4U: folds 
blackey 35: folds 
Jl roll: calls $0.10
papag555: calls $0.05
dmg3000: raises $0.30 to $0.40
Jl roll: calls $0.30
papag555: calls $0.30
*** FLOP *** [Th Ac Js]
papag555: checks 
dmg3000: checks 
Jl roll: checks 
*** TURN *** [Th Ac Js] [3h]
papag555: checks 
dmg3000: checks 
Jl roll: checks 
*** RIVER *** [Th Ac Js 3h] [3s]
papag555: checks 
dmg3000: bets $0.57
Jl roll: folds 
papag555: calls $0.57
*** SHOW DOWN ***
dmg3000: shows [Qs Kd] (a straight, Ten to Ace)
papag555: mucks hand 
dmg3000 collected $2.22 from pot
*** SUMMARY ***
Total pot $2.34 | Rake $0.12 
Board [Th Ac Js 3h 3s]
Seat 2: PlayTheBlues4U folded before Flop (didn't bet)
Seat 3: blackey 35 folded before Flop (didn't bet)
Seat 4: Jl roll (button) folded on the River
Seat 5: papag555 (small blind) mucked [2d Jd]
Seat 6: dmg3000 (big blind) showed [Qs Kd] and won ($2.22) with a straight, Ten to Ace



PokerStars Hand #205009477160:  Hold'em No Limit ($0.05/$0.10 USD) - 2019/10/24 21:05:12 ET
Table 'Atala' 6-max Seat #5 is the button
Seat 2: PlayTheBlues4U ($8.80 in chips) 
Seat 3: blackey 35 ($16.82 in chips) 
Seat 4: Jl roll ($37.13 in chips) 
Seat 5: papag555 ($10.45 in chips) 
Seat 6: dmg3000 ($11.98 in chips) 
dmg3000: posts small blind $0.05
PlayTheBlues4U: posts big blind $0.10
*** HOLE CARDS ***
Dealt to PlayTheBlues4U [Jc 8d]
blackey 35: folds 
Jl roll: folds 
papag555: calls $0.10
dmg3000: raises $0.20 to $0.30
PlayTheBlues4U: calls $0.20
papag555: calls $0.20
*** FLOP *** [Ks 2d Jd]
dmg3000: checks 
PlayTheBlues4U: checks 
papag555: checks 
*** TURN *** [Ks 2d Jd] [7d]
dmg3000: bets $0.43
PlayTheBlues4U: calls $0.43
papag555: folds 
*** RIVER *** [Ks 2d Jd 7d] [Qs]
dmg3000: checks 
PlayTheBlues4U: checks 
*** SHOW DOWN ***
dmg3000: shows [Ad 4s] (high card Ace)
PlayTheBlues4U: shows [Jc 8d] (a pair of Jacks)
PlayTheBlues4U collected $1.67 from pot
*** SUMMARY ***
Total pot $1.76 | Rake $0.09 
Board [Ks 2d Jd 7d Qs]
Seat 2: PlayTheBlues4U (big blind) showed [Jc 8d] and won ($1.67) with a pair of Jacks
Seat 3: blackey 35 folded before Flop (didn't bet)
Seat 4: Jl roll folded before Flop (didn't bet)
Seat 5: papag555 (button) folded on the Turn
Seat 6: dmg3000 (small blind) showed [Ad 4s] and lost with high card Ace



PokerStars Hand #205009477450:  Hold'em No Limit ($0.05/$0.10 USD) - 2019/10/24 21:06:17 ET
Table 'Atala' 6-max Seat #6 is the button
Seat 2: PlayTheBlues4U ($10 in chips) 
Seat 3: blackey 35 ($16.82 in chips) 
Seat 4: Jl roll ($37.13 in chips) 
Seat 5: papag555 ($10.15 in chips) 
Seat 6: dmg3000 ($11.25 in chips) 
PlayTheBlues4U: posts small blind $0.05
blackey 35: posts big blind $0.10
*** HOLE CARDS ***
Dealt to PlayTheBlues4U [Jc 3h]
Jl roll: folds 
papag555: folds 
PeteyDunham leaves the table
dmg3000: folds 
PlayTheBlues4U: folds 
Uncalled bet ($0.05) returned to blackey 35
blackey 35 collected $0.10 from pot
*** SUMMARY ***
Total pot $0.10 | Rake $0 
Seat 2: PlayTheBlues4U (small blind) folded before Flop
Seat 3: blackey 35 (big blind) collected ($0.10)
Seat 4: Jl roll folded before Flop (didn't bet)
Seat 5: papag555 folded before Flop (didn't bet)
Seat 6: dmg3000 (button) folded before Flop (didn't bet)



PokerStars Hand #205009477496:  Hold'em No Limit ($0.05/$0.10 USD) - 2019/10/24 21:06:28 ET
Table 'Atala' 6-max Seat #2 is the button
Seat 2: PlayTheBlues4U ($9.95 in chips) 
Seat 3: blackey 35 ($16.87 in chips) 
Seat 4: Jl roll ($37.13 in chips) 
Seat 5: papag555 ($10.15 in chips) 
Seat 6: dmg3000 ($11.25 in chips) 
blackey 35: posts small blind $0.05
Jl roll: posts big blind $0.10
*** HOLE CARDS ***
Dealt to PlayTheBlues4U [5h 9c]
123tiger711a joins the table at seat #1 
papag555: folds 
dmg3000: raises $0.25 to $0.35
PlayTheBlues4U: folds 
blackey 35: calls $0.30
Jl roll: folds 
*** FLOP *** [6h 4h 7s]
blackey 35: checks 
dmg3000: checks 
*** TURN *** [6h 4h 7s] [8h]
blackey 35: checks 
dmg3000: checks 
*** RIVER *** [6h 4h 7s 8h] [7c]
blackey 35: bets $0.10
dmg3000: folds 
Uncalled bet ($0.10) returned to blackey 35
blackey 35 collected $0.76 from pot
*** SUMMARY ***
Total pot $0.80 | Rake $0.04 
Board [6h 4h 7s 8h 7c]
Seat 2: PlayTheBlues4U (button) folded before Flop (didn't bet)
Seat 3: blackey 35 (small blind) collected ($0.76)
Seat 4: Jl roll (big blind) folded before Flop
Seat 5: papag555 folded before Flop (didn't bet)
Seat 6: dmg3000 folded on the River



PokerStars Hand #205009477762:  Hold'em No Limit ($0.05/$0.10 USD) - 2019/10/24 21:07:31 ET
Table 'Atala' 6-max Seat #3 is the button
Seat 2: PlayTheBlues4U ($9.95 in chips) 
Seat 3: blackey 35 ($17.28 in chips) 
Seat 4: Jl roll ($37.03 in chips) 
Seat 5: papag555 ($10.15 in chips) 
Seat 6: dmg3000 ($10.90 in chips) 
Jl roll: posts small blind $0.05
papag555: posts big blind $0.10
123tiger711a: sits out 
*** HOLE CARDS ***
Dealt to PlayTheBlues4U [Jc Tc]
dmg3000: folds 
PlayTheBlues4U: raises $0.20 to $0.30
blackey 35: calls $0.30
Jl roll: calls $0.25
papag555: folds 
*** FLOP *** [Js 5h 4c]
Jl roll: checks 
PlayTheBlues4U: bets $0.50
blackey 35: folds 
Jl roll: folds 
Uncalled bet ($0.50) returned to PlayTheBlues4U
PlayTheBlues4U collected $0.95 from pot
PlayTheBlues4U: doesn't show hand 
*** SUMMARY ***
Total pot $1 | Rake $0.05 
Board [Js 5h 4c]
Seat 2: PlayTheBlues4U collected ($0.95)
Seat 3: blackey 35 (button) folded on the Flop
Seat 4: Jl roll (small blind) folded on the Flop
Seat 5: papag555 (big blind) folded before Flop
Seat 6: dmg3000 folded before Flop (didn't bet)



PokerStars Hand #205009477896:  Hold'em No Limit ($0.05/$0.10 USD) - 2019/10/24 21:08:06 ET
Table 'Atala' 6-max Seat #4 is the button
Seat 2: PlayTheBlues4U ($10.60 in chips) 
Seat 3: blackey 35 ($16.98 in chips) 
Seat 4: Jl roll ($36.73 in chips) 
Seat 5: papag555 ($10.05 in chips) 
Seat 6: dmg3000 ($10.90 in chips) 
papag555: posts small blind $0.05
dmg3000: posts big blind $0.10
123tiger711a: sits out 
*** HOLE CARDS ***
Dealt to PlayTheBlues4U [Kc 2s]
PlayTheBlues4U: folds 
blackey 35: raises $0.10 to $0.20
Jl roll: calls $0.20
papag555: calls $0.15
dmg3000: folds 
*** FLOP *** [Jd 4s Js]
dmg3000 leaves the table
papag555: checks 
blackey 35: bets $0.10
Jl roll: calls $0.10
papag555: folds 
*** TURN *** [Jd 4s Js] [6h]
blackey 35: bets $0.20
Jl roll: folds 
Uncalled bet ($0.20) returned to blackey 35
blackey 35 collected $0.86 from pot
*** SUMMARY ***
Total pot $0.90 | Rake $0.04 
Board [Jd 4s Js 6h]
Seat 2: PlayTheBlues4U folded before Flop (didn't bet)
Seat 3: blackey 35 collected ($0.86)
Seat 4: Jl roll (button) folded on the Turn
Seat 5: papag555 (small blind) folded on the Flop
Seat 6: dmg3000 (big blind) folded before Flop



PokerStars Hand #205009478044:  Hold'em No Limit ($0.05/$0.10 USD) - 2019/10/24 21:08:41 ET
Table 'Atala' 6-max Seat #5 is the button
Seat 2: PlayTheBlues4U ($10.60 in chips) 
Seat 3: blackey 35 ($17.54 in chips) 
Seat 4: Jl roll ($36.43 in chips) 
Seat 5: papag555 ($9.85 in chips) 
PlayTheBlues4U: posts small blind $0.05
blackey 35: posts big blind $0.10
*** HOLE CARDS ***
Dealt to PlayTheBlues4U [Ts 9s]
Jl roll: folds 
papag555: folds 
PlayTheBlues4U: raises $0.20 to $0.30
blackey 35: calls $0.20
*** FLOP *** [Ad 9c 4d]
PlayTheBlues4U: bets $0.30
blackey 35: calls $0.30
*** TURN *** [Ad 9c 4d] [8h]
PlayTheBlues4U: checks 
blackey 35: checks 
*** RIVER *** [Ad 9c 4d 8h] [6s]
PlayTheBlues4U: bets $0.60
blackey 35: calls $0.60
*** SHOW DOWN ***
PlayTheBlues4U: shows [Ts 9s] (a pair of Nines)
blackey 35: mucks hand 
PlayTheBlues4U collected $2.28 from pot
*** SUMMARY ***
Total pot $2.40 | Rake $0.12 
Board [Ad 9c 4d 8h 6s]
Seat 2: PlayTheBlues4U (small blind) showed [Ts 9s] and won ($2.28) with a pair of Nines
Seat 3: blackey 35 (big blind) mucked [Jd 4s]
Seat 4: Jl roll folded before Flop (didn't bet)
Seat 5: papag555 (button) folded before Flop (didn't bet)



PokerStars Hand #205009478265:  Hold'em No Limit ($0.05/$0.10 USD) - 2019/10/24 21:09:32 ET
Table 'Atala' 6-max Seat #2 is the button
Seat 2: PlayTheBlues4U ($11.68 in chips) 
Seat 3: blackey 35 ($16.34 in chips) 
Seat 4: Jl roll ($36.43 in chips) 
Seat 5: papag555 ($9.85 in chips) 
blackey 35: posts small blind $0.05
Jl roll: posts big blind $0.10
123tiger711a: sits out 
*** HOLE CARDS ***
Dealt to PlayTheBlues4U [8d 7s]
papag555: folds 
123tiger711a leaves the table
PlayTheBlues4U: raises $0.15 to $0.25
blackey 35: folds 
Jl roll: raises $0.15 to $0.40
PlayTheBlues4U: calls $0.15
*** FLOP *** [Kd 5h 6s]
Jl roll: bets $1.10
PlayTheBlues4U: calls $1.10
*** TURN *** [Kd 5h 6s] [6d]
Jl roll: bets $1.20
PlayTheBlues4U: folds 
Uncalled bet ($1.20) returned to Jl roll
Jl roll collected $2.90 from pot
Jl roll: doesn't show hand 
*** SUMMARY ***
Total pot $3.05 | Rake $0.15 
Board [Kd 5h 6s 6d]
Seat 2: PlayTheBlues4U (button) folded on the Turn
Seat 3: blackey 35 (small blind) folded before Flop
Seat 4: Jl roll (big blind) collected ($2.90)
Seat 5: papag555 folded before Flop (didn't bet)



PokerStars Hand #205009478570:  Hold'em No Limit ($0.05/$0.10 USD) - 2019/10/24 21:10:44 ET
Table 'Atala' 6-max Seat #3 is the button
Seat 2: PlayTheBlues4U ($10.18 in chips) 
Seat 3: blackey 35 ($16.29 in chips) 
Seat 4: Jl roll ($37.83 in chips) 
Seat 5: papag555 ($9.85 in chips) 
Jl roll: posts small blind $0.05
papag555: posts big blind $0.10
*** HOLE CARDS ***
Dealt to PlayTheBlues4U [Ad 4s]
PlayTheBlues4U: folds 
blackey 35 has timed out
blackey 35: folds 
Jl roll: calls $0.05
papag555: checks 
*** FLOP *** [Ah Kd 2c]
Jl roll: checks 
papag555: bets $0.10
Jl roll: folds 
Uncalled bet ($0.10) returned to papag555
papag555 collected $0.19 from pot
papag555: doesn't show hand 
*** SUMMARY ***
Total pot $0.20 | Rake $0.01 
Board [Ah Kd 2c]
Seat 2: PlayTheBlues4U folded before Flop (didn't bet)
Seat 3: blackey 35 (button) folded before Flop (didn't bet)
Seat 4: Jl roll (small blind) folded on the Flop
Seat 5: papag555 (big blind) collected ($0.19)



PokerStars Hand #205009478729:  Hold'em No Limit ($0.05/$0.10 USD) - 2019/10/24 21:11:18 ET
Table 'Atala' 6-max Seat #4 is the button
Seat 2: PlayTheBlues4U ($10.18 in chips) 
Seat 3: blackey 35 ($16.29 in chips) 
Seat 4: Jl roll ($37.73 in chips) 
Seat 5: papag555 ($9.94 in chips) 
papag555: posts small blind $0.05
PlayTheBlues4U: posts big blind $0.10
*** HOLE CARDS ***
Dealt to PlayTheBlues4U [Ts 8d]
blackey 35: calls $0.10
Jl roll: raises $0.30 to $0.40
papag555: folds 
PlayTheBlues4U: folds 
blackey 35: calls $0.30
*** FLOP *** [8h 5s 9c]
blackey 35: checks 
Jl roll: checks 
*** TURN *** [8h 5s 9c] [3h]
blackey 35: bets $0.20
Jl roll: calls $0.20
*** RIVER *** [8h 5s 9c 3h] [4s]
blackey 35: bets $0.50
Jl roll: folds 
Uncalled bet ($0.50) returned to blackey 35
blackey 35 collected $1.28 from pot
*** SUMMARY ***
Total pot $1.35 | Rake $0.07 
Board [8h 5s 9c 3h 4s]
Seat 2: PlayTheBlues4U (big blind) folded before Flop
Seat 3: blackey 35 collected ($1.28)
Seat 4: Jl roll (button) folded on the River
Seat 5: papag555 (small blind) folded before Flop



PokerStars Hand #205009479059:  Hold'em No Limit ($0.05/$0.10 USD) - 2019/10/24 21:12:36 ET
Table 'Atala' 6-max Seat #5 is the button
Seat 2: PlayTheBlues4U ($10.08 in chips) 
Seat 3: blackey 35 ($16.97 in chips) 
Seat 4: Jl roll ($37.13 in chips) 
Seat 5: papag555 ($9.89 in chips) 
PlayTheBlues4U: posts small blind $0.05
blackey 35: posts big blind $0.10
*** HOLE CARDS ***
Dealt to PlayTheBlues4U [As 6h]
Jl roll: folds 
papag555: folds 
PlayTheBlues4U: raises $0.20 to $0.30
blackey 35: folds 
Uncalled bet ($0.20) returned to PlayTheBlues4U
PlayTheBlues4U collected $0.20 from pot
PlayTheBlues4U: doesn't show hand 
*** SUMMARY ***
Total pot $0.20 | Rake $0 
Seat 2: PlayTheBlues4U (small blind) collected ($0.20)
Seat 3: blackey 35 (big blind) folded before Flop
Seat 4: Jl roll folded before Flop (didn't bet)
Seat 5: papag555 (button) folded before Flop (didn't bet)



PokerStars Hand #205009479183:  Hold'em No Limit ($0.05/$0.10 USD) - 2019/10/24 21:13:02 ET
Table 'Atala' 6-max Seat #2 is the button
Seat 2: PlayTheBlues4U ($10.18 in chips) 
Seat 3: blackey 35 ($16.87 in chips) 
Seat 4: Jl roll ($37.13 in chips) 
Seat 5: papag555 ($9.89 in chips) 
blackey 35: posts small blind $0.05
Jl roll: posts big blind $0.10
*** HOLE CARDS ***
Dealt to PlayTheBlues4U [Kc 6s]
papag555: folds 
PlayTheBlues4U: folds 
blackey 35: calls $0.05
Jl roll: checks 
*** FLOP *** [As Kh 3d]
blackey 35: checks 
Jl roll: checks 
*** TURN *** [As Kh 3d] [9c]
blackey 35: bets $0.10
Jl roll: folds 
Uncalled bet ($0.10) returned to blackey 35
blackey 35 collected $0.19 from pot
*** SUMMARY ***
Total pot $0.20 | Rake $0.01 
Board [As Kh 3d 9c]
Seat 2: PlayTheBlues4U (button) folded before Flop (didn't bet)
Seat 3: blackey 35 (small blind) collected ($0.19)
Seat 4: Jl roll (big blind) folded on the Turn
Seat 5: papag555 folded before Flop (didn't bet)



PokerStars Hand #205009479293:  Hold'em No Limit ($0.05/$0.10 USD) - 2019/10/24 21:13:26 ET
Table 'Atala' 6-max Seat #3 is the button
Seat 2: PlayTheBlues4U ($10.18 in chips) 
Seat 3: blackey 35 ($16.96 in chips) 
Seat 4: Jl roll ($37.03 in chips) 
Seat 5: papag555 ($9.89 in chips) 
Jl roll: posts small blind $0.05
papag555: posts big blind $0.10
*** HOLE CARDS ***
Dealt to PlayTheBlues4U [7d 4h]
PlayTheBlues4U: folds 
blackey 35: calls $0.10
Jl roll: folds 
papag555: raises $0.30 to $0.40
blackey 35: calls $0.30
*** FLOP *** [3s Jh Td]
papag555: bets $0.50
blackey 35: folds 
Uncalled bet ($0.50) returned to papag555
papag555 collected $0.81 from pot
papag555: doesn't show hand 
*** SUMMARY ***
Total pot $0.85 | Rake $0.04 
Board [3s Jh Td]
Seat 2: PlayTheBlues4U folded before Flop (didn't bet)
Seat 3: blackey 35 (button) folded on the Flop
Seat 4: Jl roll (small blind) folded before Flop
Seat 5: papag555 (big blind) collected ($0.81)



PokerStars Hand #205009479431:  Hold'em No Limit ($0.05/$0.10 USD) - 2019/10/24 21:13:55 ET
Table 'Atala' 6-max Seat #4 is the button
Seat 2: PlayTheBlues4U ($10.18 in chips) 
Seat 3: blackey 35 ($16.56 in chips) 
Seat 4: Jl roll ($36.98 in chips) 
Seat 5: papag555 ($10.30 in chips) 
papag555: posts small blind $0.05
PlayTheBlues4U: posts big blind $0.10
*** HOLE CARDS ***
Dealt to PlayTheBlues4U [Jc 8d]
blackey 35: folds 
Jl roll: calls $0.10
papag555: calls $0.05
PlayTheBlues4U: checks 
*** FLOP *** [Js 2h 5d]
papag555: checks 
PlayTheBlues4U: bets $0.20
Jl roll: calls $0.20
papag555: calls $0.20
*** TURN *** [Js 2h 5d] [Th]
papag555: checks 
PlayTheBlues4U: bets $0.60
Jl roll: folds 
papag555: calls $0.60
*** RIVER *** [Js 2h 5d Th] [Ah]
papag555: bets $2
PlayTheBlues4U: folds 
Uncalled bet ($2) returned to papag555
papag555 collected $2 from pot
papag555: doesn't show hand 
*** SUMMARY ***
Total pot $2.10 | Rake $0.10 
Board [Js 2h 5d Th Ah]
Seat 2: PlayTheBlues4U (big blind) folded on the River
Seat 3: blackey 35 folded before Flop (didn't bet)
Seat 4: Jl roll (button) folded on the Turn
Seat 5: papag555 (small blind) collected ($2)



PokerStars Hand #205009479755:  Hold'em No Limit ($0.05/$0.10 USD) - 2019/10/24 21:15:06 ET
Table 'Atala' 6-max Seat #5 is the button
Seat 2: PlayTheBlues4U ($9.28 in chips) 
Seat 3: blackey 35 ($16.56 in chips) 
Seat 4: Jl roll ($36.68 in chips) 
Seat 5: papag555 ($11.40 in chips) 
PlayTheBlues4U: posts small blind $0.05
blackey 35: posts big blind $0.10
*** HOLE CARDS ***
Dealt to PlayTheBlues4U [6d Js]
Jl roll: calls $0.10
papag555: calls $0.10
PlayTheBlues4U: folds 
blackey 35: raises $0.10 to $0.20
Jl roll: calls $0.10
papag555: calls $0.10
*** FLOP *** [7h Td 4s]
blackey 35: bets $0.30
Jl roll: folds 
papag555: calls $0.30
*** TURN *** [7h Td 4s] [Kd]
blackey 35: bets $0.40
papag555: calls $0.40
*** RIVER *** [7h Td 4s Kd] [Jh]
blackey 35: checks 
papag555: bets $1.10
blackey 35: calls $1.10
*** SHOW DOWN ***
papag555: shows [6h 7d] (a pair of Sevens)
blackey 35: shows [Ah Jc] (a pair of Jacks)
blackey 35 collected $4.04 from pot
*** SUMMARY ***
Total pot $4.25 | Rake $0.21 
Board [7h Td 4s Kd Jh]
Seat 2: PlayTheBlues4U (small blind) folded before Flop
Seat 3: blackey 35 (big blind) showed [Ah Jc] and won ($4.04) with a pair of Jacks
Seat 4: Jl roll folded on the Flop
Seat 5: papag555 (button) showed [6h 7d] and lost with a pair of Sevens



PokerStars Hand #205010162109:  Hold'em No Limit ($0.05/$0.10 USD) - 2019/10/24 21:16:03 ET
Table 'Atala' 6-max Seat #2 is the button
Seat 2: PlayTheBlues4U ($9.23 in chips) 
Seat 3: blackey 35 ($18.60 in chips) 
Seat 4: Jl roll ($36.48 in chips) 
Seat 5: papag555 ($9.40 in chips) 
blackey 35: posts small blind $0.05
Jl roll: posts big blind $0.10
*** HOLE CARDS ***
Dealt to PlayTheBlues4U [2d Jc]
papag555: calls $0.10
PlayTheBlues4U: folds 
blackey 35: folds 
Jl roll: checks 
*** FLOP *** [4h 3c Ac]
Jl roll: checks 
njmerc joins the table at seat #1 
papag555: checks 
*** TURN *** [4h 3c Ac] [Td]
Jl roll: checks 
papag555: bets $0.20
Jl roll: calls $0.20
*** RIVER *** [4h 3c Ac Td] [5s]
Jl roll: checks 
papag555: bets $0.50
Jl roll: folds 
Uncalled bet ($0.50) returned to papag555
papag555 collected $0.62 from pot
papag555: doesn't show hand 
*** SUMMARY ***
Total pot $0.65 | Rake $0.03 
Board [4h 3c Ac Td 5s]
Seat 2: PlayTheBlues4U (button) folded before Flop (didn't bet)
Seat 3: blackey 35 (small blind) folded before Flop
Seat 4: Jl roll (big blind) folded on the River
Seat 5: papag555 collected ($0.62)



PokerStars Hand #205010162332:  Hold'em No Limit ($0.05/$0.10 USD) - 2019/10/24 21:16:52 ET
Table 'Atala' 6-max Seat #3 is the button
Seat 2: PlayTheBlues4U ($9.23 in chips) 
Seat 3: blackey 35 ($18.55 in chips) 
Seat 4: Jl roll ($36.18 in chips) 
Seat 5: papag555 ($9.72 in chips) 
Jl roll: posts small blind $0.05
papag555: posts big blind $0.10
njmerc: sits out 
*** HOLE CARDS ***
Dealt to PlayTheBlues4U [5s 6d]
PlayTheBlues4U: folds 
blackey 35 has timed out
blackey 35: folds 
Jl roll: calls $0.05
papag555: checks 
*** FLOP *** [Qd 2c 5c]
Jl roll: checks 
papag555: checks 
*** TURN *** [Qd 2c 5c] [Js]
Jl roll: checks 
papag555: checks 
*** RIVER *** [Qd 2c 5c Js] [As]
Jl roll: checks 
papag555: checks 
*** SHOW DOWN ***
Jl roll: shows [6s 8s] (high card Ace)
papag555: shows [Kh 5h] (a pair of Fives)
papag555 collected $0.19 from pot
*** SUMMARY ***
Total pot $0.20 | Rake $0.01 
Board [Qd 2c 5c Js As]
Seat 2: PlayTheBlues4U folded before Flop (didn't bet)
Seat 3: blackey 35 (button) folded before Flop (didn't bet)
Seat 4: Jl roll (small blind) showed [6s 8s] and lost with high card Ace
Seat 5: papag555 (big blind) showed [Kh 5h] and won ($0.19) with a pair of Fives



PokerStars Hand #205010162580:  Hold'em No Limit ($0.05/$0.10 USD) - 2019/10/24 21:17:45 ET
Table 'Atala' 6-max Seat #4 is the button
Seat 1: njmerc ($10 in chips) 
Seat 2: PlayTheBlues4U ($9.23 in chips) 
Seat 3: blackey 35 ($18.55 in chips) 
Seat 4: Jl roll ($36.08 in chips) 
Seat 5: papag555 ($9.81 in chips) 
papag555: posts small blind $0.05
njmerc: posts big blind $0.10
*** HOLE CARDS ***
Dealt to PlayTheBlues4U [Qh 6c]
PlayTheBlues4U: folds 
blackey 35: calls $0.10
Jl roll: calls $0.10
papag555: calls $0.05
njmerc: checks 
*** FLOP *** [Jc 2c 7c]
papag555: checks 
njmerc: checks 
blackey 35: checks 
Jl roll: bets $0.30
papag555: raises $0.60 to $0.90
njmerc: folds 
blackey 35: calls $0.90
Jl roll: calls $0.60
*** TURN *** [Jc 2c 7c] [7h]
papag555: checks 
blackey 35: checks 
Jl roll: checks 
*** RIVER *** [Jc 2c 7c 7h] [9s]
papag555: bets $3
blackey 35: folds 
Jl roll: folds 
Uncalled bet ($3) returned to papag555
papag555 collected $2.94 from pot
papag555: doesn't show hand 
*** SUMMARY ***
Total pot $3.10 | Rake $0.16 
Board [Jc 2c 7c 7h 9s]
Seat 1: njmerc (big blind) folded on the Flop
Seat 2: PlayTheBlues4U folded before Flop (didn't bet)
Seat 3: blackey 35 folded on the River
Seat 4: Jl roll (button) folded on the River
Seat 5: papag555 (small blind) collected ($2.94)



PokerStars Hand #205010162855:  Hold'em No Limit ($0.05/$0.10 USD) - 2019/10/24 21:18:49 ET
Table 'Atala' 6-max Seat #5 is the button
Seat 1: njmerc ($10 in chips) 
Seat 2: PlayTheBlues4U ($9.23 in chips) 
Seat 3: blackey 35 ($17.55 in chips) 
Seat 4: Jl roll ($35.08 in chips) 
Seat 5: papag555 ($11.75 in chips) 
njmerc: posts small blind $0.05
PlayTheBlues4U: posts big blind $0.10
*** HOLE CARDS ***
Dealt to PlayTheBlues4U [3s 2d]
blackey 35: folds 
Jl roll: folds 
papag555: folds 
njmerc: folds 
Uncalled bet ($0.05) returned to PlayTheBlues4U
PlayTheBlues4U collected $0.10 from pot
PlayTheBlues4U: doesn't show hand 
*** SUMMARY ***
Total pot $0.10 | Rake $0 
Seat 1: njmerc (small blind) folded before Flop
Seat 2: PlayTheBlues4U (big blind) collected ($0.10)
Seat 3: blackey 35 folded before Flop (didn't bet)
Seat 4: Jl roll folded before Flop (didn't bet)
Seat 5: papag555 (button) folded before Flop (didn't bet)



PokerStars Hand #205010162891:  Hold'em No Limit ($0.05/$0.10 USD) - 2019/10/24 21:18:58 ET
Table 'Atala' 6-max Seat #1 is the button
Seat 1: njmerc ($10 in chips) 
Seat 2: PlayTheBlues4U ($9.28 in chips) 
Seat 3: blackey 35 ($17.55 in chips) 
Seat 4: Jl roll ($35.08 in chips) 
Seat 5: papag555 ($11.75 in chips) 
PlayTheBlues4U: posts small blind $0.05
blackey 35: posts big blind $0.10
*** HOLE CARDS ***
Dealt to PlayTheBlues4U [2s 7s]
Jl roll: raises $0.20 to $0.30
papag555: folds 
njmerc: folds 
PlayTheBlues4U: folds 
blackey 35: folds 
Uncalled bet ($0.20) returned to Jl roll
Jl roll collected $0.25 from pot
Jl roll: doesn't show hand 
*** SUMMARY ***
Total pot $0.25 | Rake $0 
Seat 1: njmerc (button) folded before Flop (didn't bet)
Seat 2: PlayTheBlues4U (small blind) folded before Flop
Seat 3: blackey 35 (big blind) folded before Flop
Seat 4: Jl roll collected ($0.25)
Seat 5: papag555 folded before Flop (didn't bet)



PokerStars Hand #205010162984:  Hold'em No Limit ($0.05/$0.10 USD) - 2019/10/24 21:19:18 ET
Table 'Atala' 6-max Seat #2 is the button
Seat 1: njmerc ($10 in chips) 
Seat 2: PlayTheBlues4U ($9.23 in chips) 
Seat 3: blackey 35 ($17.45 in chips) 
Seat 4: Jl roll ($35.23 in chips) 
Seat 5: papag555 ($11.75 in chips) 
blackey 35: posts small blind $0.05
Jl roll: posts big blind $0.10
*** HOLE CARDS ***
Dealt to PlayTheBlues4U [9c 5s]
papag555: raises $0.30 to $0.40
njmerc: calls $0.40
PlayTheBlues4U: folds 
blackey 35: folds 
Jl roll: raises $0.30 to $0.70
papag555: calls $0.30
njmerc: calls $0.30
*** FLOP *** [2h Qs 4s]
Jl roll: checks 
papag555: checks 
njmerc: checks 
*** TURN *** [2h Qs 4s] [Jh]
Jl roll: bets $0.20
papag555: calls $0.20
njmerc: raises $1.32 to $1.52
Jl roll: calls $1.32
papag555: folds 
*** RIVER *** [2h Qs 4s Jh] [7d]
Jl roll: checks 
njmerc: checks 
*** SHOW DOWN ***
Jl roll: shows [Ah Th] (high card Ace)
njmerc: mucks hand 
Jl roll collected $5.12 from pot
*** SUMMARY ***
Total pot $5.39 | Rake $0.27 
Board [2h Qs 4s Jh 7d]
Seat 1: njmerc mucked [Ts Ks]
Seat 2: PlayTheBlues4U (button) folded before Flop (didn't bet)
Seat 3: blackey 35 (small blind) folded before Flop
Seat 4: Jl roll (big blind) showed [Ah Th] and won ($5.12) with high card Ace
Seat 5: papag555 folded on the Turn



PokerStars Hand #205010163435:  Hold'em No Limit ($0.05/$0.10 USD) - 2019/10/24 21:20:56 ET
Table 'Atala' 6-max Seat #3 is the button
Seat 1: njmerc ($10 in chips) 
Seat 2: PlayTheBlues4U ($9.23 in chips) 
Seat 3: blackey 35 ($17.40 in chips) 
Seat 4: Jl roll ($38.13 in chips) 
Seat 5: papag555 ($10.85 in chips) 
Jl roll: posts small blind $0.05
papag555: posts big blind $0.10
*** HOLE CARDS ***
Dealt to PlayTheBlues4U [9d Jd]
njmerc: folds 
PlayTheBlues4U: raises $0.20 to $0.30
blackey 35: calls $0.30
Jl roll: folds 
papag555: calls $0.20
*** FLOP *** [Js As Tc]
papag555: checks 
PlayTheBlues4U: checks 
blackey 35: checks 
*** TURN *** [Js As Tc] [Kd]
papag555: checks 
PlayTheBlues4U: checks 
blackey 35: checks 
*** RIVER *** [Js As Tc Kd] [Qd]
papag555: checks 
123tiger711a joins the table at seat #6 
PlayTheBlues4U: checks 
blackey 35: checks 
*** SHOW DOWN ***
papag555: shows [8s 9s] (a straight, Ten to Ace)
PlayTheBlues4U: shows [9d Jd] (a straight, Ten to Ace)
blackey 35: shows [6s 6h] (a straight, Ten to Ace)
papag555 collected $0.30 from pot
PlayTheBlues4U collected $0.30 from pot
blackey 35 collected $0.30 from pot
*** SUMMARY ***
Total pot $0.95 | Rake $0.05 
Board [Js As Tc Kd Qd]
Seat 1: njmerc folded before Flop (didn't bet)
Seat 2: PlayTheBlues4U showed [9d Jd] and won ($0.30) with a straight, Ten to Ace
Seat 3: blackey 35 (button) showed [6s 6h] and won ($0.30) with a straight, Ten to Ace
Seat 4: Jl roll (small blind) folded before Flop
Seat 5: papag555 (big blind) showed [8s 9s] and won ($0.30) with a straight, Ten to Ace



PokerStars Hand #205010163679:  Hold'em No Limit ($0.05/$0.10 USD) - 2019/10/24 21:21:50 ET
Table 'Atala' 6-max Seat #4 is the button
Seat 1: njmerc ($10 in chips) 
Seat 2: PlayTheBlues4U ($9.23 in chips) 
Seat 3: blackey 35 ($17.40 in chips) 
Seat 4: Jl roll ($38.08 in chips) 
Seat 5: papag555 ($10.85 in chips) 
Seat 6: 123tiger711a ($10 in chips) 
papag555: posts small blind $0.05
123tiger711a: posts big blind $0.10
*** HOLE CARDS ***
Dealt to PlayTheBlues4U [9s Kh]
njmerc: folds 
PlayTheBlues4U: folds 
blackey 35: calls $0.10
Jl roll: calls $0.10
papag555: calls $0.05
123tiger711a: checks 
*** FLOP *** [Ah 9d 4h]
papag555: bets $0.30
123tiger711a: folds 
blackey 35: calls $0.30
Jl roll: folds 
*** TURN *** [Ah 9d 4h] [7h]
papag555: bets $0.50
blackey 35: folds 
Uncalled bet ($0.50) returned to papag555
papag555 collected $0.95 from pot
papag555: doesn't show hand 
*** SUMMARY ***
Total pot $1 | Rake $0.05 
Board [Ah 9d 4h 7h]
Seat 1: njmerc folded before Flop (didn't bet)
Seat 2: PlayTheBlues4U folded before Flop (didn't bet)
Seat 3: blackey 35 folded on the Turn
Seat 4: Jl roll (button) folded on the Flop
Seat 5: papag555 (small blind) collected ($0.95)
Seat 6: 123tiger711a (big blind) folded on the Flop



PokerStars Hand #205010163865:  Hold'em No Limit ($0.05/$0.10 USD) - 2019/10/24 21:22:33 ET
Table 'Atala' 6-max Seat #5 is the button
Seat 1: njmerc ($10 in chips) 
Seat 2: PlayTheBlues4U ($9.23 in chips) 
Seat 3: blackey 35 ($17 in chips) 
Seat 4: Jl roll ($37.98 in chips) 
Seat 5: papag555 ($11.40 in chips) 
Seat 6: 123tiger711a ($10 in chips) 
123tiger711a: posts small blind $0.05
njmerc: posts big blind $0.10
*** HOLE CARDS ***
Dealt to PlayTheBlues4U [6c Ah]
PlayTheBlues4U: folds 
blackey 35: folds 
Jl roll: folds 
papag555: raises $0.30 to $0.40
123tiger711a: folds 
njmerc: folds 
Uncalled bet ($0.30) returned to papag555
papag555 collected $0.25 from pot
papag555: doesn't show hand 
*** SUMMARY ***
Total pot $0.25 | Rake $0 
Seat 1: njmerc (big blind) folded before Flop
Seat 2: PlayTheBlues4U folded before Flop (didn't bet)
Seat 3: blackey 35 folded before Flop (didn't bet)
Seat 4: Jl roll folded before Flop (didn't bet)
Seat 5: papag555 (button) collected ($0.25)
Seat 6: 123tiger711a (small blind) folded before Flop



PokerStars Hand #205010164056:  Hold'em No Limit ($0.05/$0.10 USD) - 2019/10/24 21:23:13 ET
Table 'Atala' 6-max Seat #6 is the button
Seat 1: njmerc ($10 in chips) 
Seat 2: PlayTheBlues4U ($9.23 in chips) 
Seat 3: blackey 35 ($17 in chips) 
Seat 4: Jl roll ($37.98 in chips) 
Seat 5: papag555 ($11.55 in chips) 
Seat 6: 123tiger711a ($10 in chips) 
njmerc: posts small blind $0.05
PlayTheBlues4U: posts big blind $0.10
*** HOLE CARDS ***
Dealt to PlayTheBlues4U [Ks Qc]
blackey 35 has timed out
blackey 35: folds 
Jl roll: calls $0.10
papag555: folds 
123tiger711a: folds 
njmerc: calls $0.05
PlayTheBlues4U: raises $0.20 to $0.30
Jl roll: calls $0.20
njmerc: calls $0.20
*** FLOP *** [Kc 9c Qh]
njmerc: checks 
PlayTheBlues4U: bets $0.60
Jl roll: calls $0.60
njmerc: raises $1.77 to $2.37
PlayTheBlues4U: raises $6.43 to $8.80
Jl roll: folds 
njmerc: calls $6.43
*** TURN *** [Kc 9c Qh] [7d]
njmerc: bets $0.90 and is all-in
PlayTheBlues4U: calls $0.13 and is all-in
Uncalled bet ($0.77) returned to njmerc
*** RIVER *** [Kc 9c Qh 7d] [8h]
*** SHOW DOWN ***
njmerc: shows [Kd 9d] (two pair, Kings and Nines)
PlayTheBlues4U: shows [Ks Qc] (two pair, Kings and Queens)
PlayTheBlues4U collected $18.39 from pot
*** SUMMARY ***
Total pot $19.36 | Rake $0.97 
Board [Kc 9c Qh 7d 8h]
Seat 1: njmerc (small blind) showed [Kd 9d] and lost with two pair, Kings and Nines
Seat 2: PlayTheBlues4U (big blind) showed [Ks Qc] and won ($18.39) with two pair, Kings and Queens
Seat 3: blackey 35 folded before Flop (didn't bet)
Seat 4: Jl roll folded on the Flop
Seat 5: papag555 folded before Flop (didn't bet)
Seat 6: 123tiger711a (button) folded before Flop (didn't bet)



PokerStars Hand #205010164596:  Hold'em No Limit ($0.05/$0.10 USD) - 2019/10/24 21:25:10 ET
Table 'Atala' 6-max Seat #1 is the button
Seat 1: njmerc ($10 in chips) 
Seat 2: PlayTheBlues4U ($18.39 in chips) 
Seat 3: blackey 35 ($17 in chips) 
Seat 4: Jl roll ($37.08 in chips) 
Seat 5: papag555 ($11.55 in chips) 
Seat 6: 123tiger711a ($10 in chips) 
PlayTheBlues4U: posts small blind $0.05
blackey 35: posts big blind $0.10
*** HOLE CARDS ***
Dealt to PlayTheBlues4U [Ts 3c]
Jl roll: raises $0.40 to $0.50
papag555: folds 
123tiger711a: folds 
njmerc: folds 
PlayTheBlues4U: folds 
blackey 35: folds 
Uncalled bet ($0.40) returned to Jl roll
Jl roll collected $0.25 from pot
Jl roll: doesn't show hand 
*** SUMMARY ***
Total pot $0.25 | Rake $0 
Seat 1: njmerc (button) folded before Flop (didn't bet)
Seat 2: PlayTheBlues4U (small blind) folded before Flop
Seat 3: blackey 35 (big blind) folded before Flop
Seat 4: Jl roll collected ($0.25)
Seat 5: papag555 folded before Flop (didn't bet)
Seat 6: 123tiger711a folded before Flop (didn't bet)



PokerStars Hand #205010164660:  Hold'em No Limit ($0.05/$0.10 USD) - 2019/10/24 21:25:25 ET
Table 'Atala' 6-max Seat #2 is the button
Seat 1: njmerc ($10 in chips) 
Seat 2: PlayTheBlues4U ($18.34 in chips) 
Seat 3: blackey 35 ($16.90 in chips) 
Seat 4: Jl roll ($37.23 in chips) 
Seat 5: papag555 ($11.55 in chips) 
Seat 6: 123tiger711a ($10 in chips) 
blackey 35: posts small blind $0.05
Jl roll: posts big blind $0.10
*** HOLE CARDS ***
Dealt to PlayTheBlues4U [5s Qd]
papag555: folds 
123tiger711a: folds 
njmerc: folds 
PlayTheBlues4U: folds 
blackey 35: calls $0.05
Jl roll: checks 
*** FLOP *** [5h Qc 3d]
blackey 35: bets $0.10
Jl roll: folds 
Uncalled bet ($0.10) returned to blackey 35
blackey 35 collected $0.19 from pot
*** SUMMARY ***
Total pot $0.20 | Rake $0.01 
Board [5h Qc 3d]
Seat 1: njmerc folded before Flop (didn't bet)
Seat 2: PlayTheBlues4U (button) folded before Flop (didn't bet)
Seat 3: blackey 35 (small blind) collected ($0.19)
Seat 4: Jl roll (big blind) folded on the Flop
Seat 5: papag555 folded before Flop (didn't bet)
Seat 6: 123tiger711a folded before Flop (didn't bet)



PokerStars Hand #205010164817:  Hold'em No Limit ($0.05/$0.10 USD) - 2019/10/24 21:25:57 ET
Table 'Atala' 6-max Seat #3 is the button
Seat 1: njmerc ($10 in chips) 
Seat 2: PlayTheBlues4U ($18.34 in chips) 
Seat 3: blackey 35 ($16.99 in chips) 
Seat 4: Jl roll ($37.13 in chips) 
Seat 5: papag555 ($11.55 in chips) 
Seat 6: 123tiger711a ($10 in chips) 
Jl roll: posts small blind $0.05
papag555: posts big blind $0.10
*** HOLE CARDS ***
Dealt to PlayTheBlues4U [Tc Th]
123tiger711a: folds 
njmerc: folds 
PlayTheBlues4U: raises $0.20 to $0.30
blackey 35: folds 
Jl roll: calls $0.25
papag555: calls $0.20
*** FLOP *** [6d Jh 5d]
Jl roll: bets $0.30
papag555: raises $0.50 to $0.80
PlayTheBlues4U: folds 
Jl roll: calls $0.50
*** TURN *** [6d Jh 5d] [Td]
Jl roll: checks 
papag555: bets $1.20
Jl roll: calls $1.20
*** RIVER *** [6d Jh 5d Td] [4s]
Jl roll: checks 
papag555: checks 
*** SHOW DOWN ***
Jl roll: shows [Jc Kd] (a pair of Jacks)
papag555: mucks hand 
Jl roll collected $4.66 from pot
*** SUMMARY ***
Total pot $4.90 | Rake $0.24 
Board [6d Jh 5d Td 4s]
Seat 1: njmerc folded before Flop (didn't bet)
Seat 2: PlayTheBlues4U folded on the Flop
Seat 3: blackey 35 (button) folded before Flop (didn't bet)
Seat 4: Jl roll (small blind) showed [Jc Kd] and won ($4.66) with a pair of Jacks
Seat 5: papag555 (big blind) mucked [Jd 7s]
Seat 6: 123tiger711a folded before Flop (didn't bet)



PokerStars Hand #205010165126:  Hold'em No Limit ($0.05/$0.10 USD) - 2019/10/24 21:27:09 ET
Table 'Atala' 6-max Seat #4 is the button
Seat 1: njmerc ($10 in chips) 
Seat 2: PlayTheBlues4U ($18.04 in chips) 
Seat 3: blackey 35 ($16.99 in chips) 
Seat 4: Jl roll ($39.49 in chips) 
Seat 5: papag555 ($9.25 in chips) 
Seat 6: 123tiger711a ($10 in chips) 
papag555: posts small blind $0.05
123tiger711a: posts big blind $0.10
*** HOLE CARDS ***
Dealt to PlayTheBlues4U [Td 6s]
njmerc: folds 
PlayTheBlues4U: folds 
blackey 35: calls $0.10
Jl roll: calls $0.10
papag555: raises $0.40 to $0.50
123tiger711a: raises $0.40 to $0.90
blackey 35: folds 
Jl roll: calls $0.80
papag555: raises $0.50 to $1.40
123tiger711a: folds 
Jl roll: calls $0.50
*** FLOP *** [2c 4s 3c]
papag555: bets $3.60
Jl roll: folds 
Uncalled bet ($3.60) returned to papag555
papag555 collected $3.61 from pot
papag555: doesn't show hand 
*** SUMMARY ***
Total pot $3.80 | Rake $0.19 
Board [2c 4s 3c]
Seat 1: njmerc folded before Flop (didn't bet)
Seat 2: PlayTheBlues4U folded before Flop (didn't bet)
Seat 3: blackey 35 folded before Flop
Seat 4: Jl roll (button) folded on the Flop
Seat 5: papag555 (small blind) collected ($3.61)
Seat 6: 123tiger711a (big blind) folded before Flop



PokerStars Hand #205010165437:  Hold'em No Limit ($0.05/$0.10 USD) - 2019/10/24 21:28:23 ET
Table 'Atala' 6-max Seat #5 is the button
Seat 1: njmerc ($10 in chips) 
Seat 2: PlayTheBlues4U ($18.04 in chips) 
Seat 3: blackey 35 ($16.89 in chips) 
Seat 4: Jl roll ($38.09 in chips) 
Seat 5: papag555 ($11.46 in chips) 
Seat 6: 123tiger711a ($10 in chips) 
123tiger711a: posts small blind $0.05
njmerc: posts big blind $0.10
*** HOLE CARDS ***
Dealt to PlayTheBlues4U [4c 8s]
PlayTheBlues4U: folds 
blackey 35: calls $0.10
Jl roll: calls $0.10
papag555: folds 
123tiger711a: calls $0.05
njmerc: checks 
*** FLOP *** [4h 7d Kc]
123tiger711a: bets $0.10
njmerc: calls $0.10
blackey 35: raises $0.10 to $0.20
Jl roll: calls $0.20
123tiger711a: calls $0.10
njmerc: calls $0.10
*** TURN *** [4h 7d Kc] [6s]
123tiger711a: checks 
njmerc: bets $0.76
blackey 35: folds 
Jl roll: folds 
123tiger711a: folds 
Uncalled bet ($0.76) returned to njmerc
njmerc collected $1.14 from pot
njmerc: doesn't show hand 
*** SUMMARY ***
Total pot $1.20 | Rake $0.06 
Board [4h 7d Kc 6s]
Seat 1: njmerc (big blind) collected ($1.14)
Seat 2: PlayTheBlues4U folded before Flop (didn't bet)
Seat 3: blackey 35 folded on the Turn
Seat 4: Jl roll folded on the Turn
Seat 5: papag555 (button) folded before Flop (didn't bet)
Seat 6: 123tiger711a (small blind) folded on the Turn



PokerStars Hand #205010165668:  Hold'em No Limit ($0.05/$0.10 USD) - 2019/10/24 21:29:14 ET
Table 'Atala' 6-max Seat #6 is the button
Seat 1: njmerc ($10.84 in chips) 
Seat 2: PlayTheBlues4U ($18.04 in chips) 
Seat 3: blackey 35 ($16.59 in chips) 
Seat 4: Jl roll ($37.79 in chips) 
Seat 5: papag555 ($11.46 in chips) 
Seat 6: 123tiger711a ($10 in chips) 
njmerc: posts small blind $0.05
PlayTheBlues4U: posts big blind $0.10
*** HOLE CARDS ***
Dealt to PlayTheBlues4U [8h 9d]
blackey 35 has timed out
blackey 35: folds 
Jl roll: folds 
papag555: raises $0.10 to $0.20
123tiger711a: folds 
njmerc: folds 
PlayTheBlues4U: calls $0.10
*** FLOP *** [9c As Kd]
PlayTheBlues4U: checks 
papag555: bets $0.30
PlayTheBlues4U: folds 
Uncalled bet ($0.30) returned to papag555
papag555 collected $0.43 from pot
papag555: doesn't show hand 
*** SUMMARY ***
Total pot $0.45 | Rake $0.02 
Board [9c As Kd]
Seat 1: njmerc (small blind) folded before Flop
Seat 2: PlayTheBlues4U (big blind) folded on the Flop
Seat 3: blackey 35 folded before Flop (didn't bet)
Seat 4: Jl roll folded before Flop (didn't bet)
Seat 5: papag555 collected ($0.43)
Seat 6: 123tiger711a (button) folded before Flop (didn't bet)



PokerStars Hand #205010165889:  Hold'em No Limit ($0.05/$0.10 USD) - 2019/10/24 21:30:07 ET
Table 'Atala' 6-max Seat #1 is the button
Seat 1: njmerc ($10.79 in chips) 
Seat 2: PlayTheBlues4U ($17.84 in chips) 
Seat 3: blackey 35 ($16.59 in chips) 
Seat 4: Jl roll ($37.79 in chips) 
Seat 5: papag555 ($11.69 in chips) 
Seat 6: 123tiger711a ($10 in chips) 
PlayTheBlues4U: posts small blind $0.05
blackey 35: posts big blind $0.10
*** HOLE CARDS ***
Dealt to PlayTheBlues4U [4s 8h]
Jl roll: calls $0.10
papag555: calls $0.10
123tiger711a: folds 
njmerc: folds 
PlayTheBlues4U: folds 
blackey 35: checks 
*** FLOP *** [Ac Kh 7h]
blackey 35: checks 
Jl roll: checks 
papag555: checks 
*** TURN *** [Ac Kh 7h] [Qc]
blackey 35: checks 
Jl roll: bets $0.50
papag555: calls $0.50
blackey 35: folds 
*** RIVER *** [Ac Kh 7h Qc] [4d]
Jl roll: bets $1.10
papag555: folds 
Uncalled bet ($1.10) returned to Jl roll
Jl roll collected $1.28 from pot
Jl roll: doesn't show hand 
*** SUMMARY ***
Total pot $1.35 | Rake $0.07 
Board [Ac Kh 7h Qc 4d]
Seat 1: njmerc (button) folded before Flop (didn't bet)
Seat 2: PlayTheBlues4U (small blind) folded before Flop
Seat 3: blackey 35 (big blind) folded on the Turn
Seat 4: Jl roll collected ($1.28)
Seat 5: papag555 folded on the River
Seat 6: 123tiger711a folded before Flop (didn't bet)



PokerStars Hand #205010166164:  Hold'em No Limit ($0.05/$0.10 USD) - 2019/10/24 21:31:13 ET
Table 'Atala' 6-max Seat #2 is the button
Seat 1: njmerc ($10.79 in chips) 
Seat 2: PlayTheBlues4U ($17.79 in chips) 
Seat 3: blackey 35 ($16.49 in chips) 
Seat 4: Jl roll ($38.47 in chips) 
Seat 5: papag555 ($11.09 in chips) 
Seat 6: 123tiger711a ($10 in chips) 
blackey 35: posts small blind $0.05
Jl roll: posts big blind $0.10
*** HOLE CARDS ***
Dealt to PlayTheBlues4U [5h 7s]
papag555: calls $0.10
123tiger711a: calls $0.10
njmerc: calls $0.10
PlayTheBlues4U: folds 
blackey 35: calls $0.05
Jl roll: checks 
*** FLOP *** [Kd Jh Kc]
blackey 35: checks 
Jl roll: checks 
papag555: checks 
123tiger711a: bets $0.24
njmerc: folds 
blackey 35: folds 
Jl roll: folds 
papag555: folds 
Uncalled bet ($0.24) returned to 123tiger711a
123tiger711a collected $0.48 from pot
*** SUMMARY ***
Total pot $0.50 | Rake $0.02 
Board [Kd Jh Kc]
Seat 1: njmerc folded on the Flop
Seat 2: PlayTheBlues4U (button) folded before Flop (didn't bet)
Seat 3: blackey 35 (small blind) folded on the Flop
Seat 4: Jl roll (big blind) folded on the Flop
Seat 5: papag555 folded on the Flop
Seat 6: 123tiger711a collected ($0.48)



PokerStars Hand #205010166436:  Hold'em No Limit ($0.05/$0.10 USD) - 2019/10/24 21:32:16 ET
Table 'Atala' 6-max Seat #3 is the button
Seat 1: njmerc ($10.69 in chips) 
Seat 2: PlayTheBlues4U ($17.79 in chips) 
Seat 3: blackey 35 ($16.39 in chips) 
Seat 4: Jl roll ($38.37 in chips) 
Seat 5: papag555 ($10.99 in chips) 
Seat 6: 123tiger711a ($10.38 in chips) 
Jl roll: posts small blind $0.05
papag555: posts big blind $0.10
*** HOLE CARDS ***
Dealt to PlayTheBlues4U [Ac 4c]
123tiger711a: folds 
njmerc: folds 
PlayTheBlues4U: raises $0.20 to $0.30
blackey 35: calls $0.30
Jl roll: folds 
papag555: folds 
*** FLOP *** [7s 2h Tc]
PlayTheBlues4U: checks 
blackey 35: bets $0.20
PlayTheBlues4U: calls $0.20
*** TURN *** [7s 2h Tc] [Td]
PlayTheBlues4U: checks 
blackey 35: bets $0.30
PlayTheBlues4U: folds 
Uncalled bet ($0.30) returned to blackey 35
blackey 35 collected $1.09 from pot
*** SUMMARY ***
Total pot $1.15 | Rake $0.06 
Board [7s 2h Tc Td]
Seat 1: njmerc folded before Flop (didn't bet)
Seat 2: PlayTheBlues4U folded on the Turn
Seat 3: blackey 35 (button) collected ($1.09)
Seat 4: Jl roll (small blind) folded before Flop
Seat 5: papag555 (big blind) folded before Flop
Seat 6: 123tiger711a folded before Flop (didn't bet)



PokerStars Hand #205010166639:  Hold'em No Limit ($0.05/$0.10 USD) - 2019/10/24 21:33:03 ET
Table 'Atala' 6-max Seat #4 is the button
Seat 1: njmerc ($10.69 in chips) 
Seat 2: PlayTheBlues4U ($17.29 in chips) 
Seat 3: blackey 35 ($16.98 in chips) 
Seat 4: Jl roll ($38.32 in chips) 
Seat 5: papag555 ($10.89 in chips) 
Seat 6: 123tiger711a ($10.38 in chips) 
papag555: posts small blind $0.05
123tiger711a: posts big blind $0.10
*** HOLE CARDS ***
Dealt to PlayTheBlues4U [8c 5d]
njmerc: raises $0.20 to $0.30
PlayTheBlues4U: folds 
blackey 35: folds 
Jl roll: folds 
papag555: calls $0.25
123tiger711a: calls $0.20
*** FLOP *** [4s Ah Kd]
papag555: checks 
123tiger711a: checks 
njmerc: bets $0.43
papag555: calls $0.43
123tiger711a: raises $2.15 to $2.58
njmerc: folds 
papag555: folds 
Uncalled bet ($2.15) returned to 123tiger711a
123tiger711a collected $2.08 from pot
*** SUMMARY ***
Total pot $2.19 | Rake $0.11 
Board [4s Ah Kd]
Seat 1: njmerc folded on the Flop
Seat 2: PlayTheBlues4U folded before Flop (didn't bet)
Seat 3: blackey 35 folded before Flop (didn't bet)
Seat 4: Jl roll (button) folded before Flop (didn't bet)
Seat 5: papag555 (small blind) folded on the Flop
Seat 6: 123tiger711a (big blind) collected ($2.08)



PokerStars Hand #205010166873:  Hold'em No Limit ($0.05/$0.10 USD) - 2019/10/24 21:33:56 ET
Table 'Atala' 6-max Seat #5 is the button
Seat 1: njmerc ($10 in chips) 
Seat 2: PlayTheBlues4U ($17.29 in chips) 
Seat 3: blackey 35 ($16.98 in chips) 
Seat 4: Jl roll ($38.32 in chips) 
Seat 5: papag555 ($10.16 in chips) 
Seat 6: 123tiger711a ($11.73 in chips) 
123tiger711a: posts small blind $0.05
njmerc: posts big blind $0.10
*** HOLE CARDS ***
Dealt to PlayTheBlues4U [Qd Js]
PlayTheBlues4U: folds 
blackey 35: calls $0.10
Jl roll: calls $0.10
papag555: folds 
123tiger711a: calls $0.05
njmerc: checks 
*** FLOP *** [5d 8s Ac]
123tiger711a: bets $0.19
njmerc: folds 
blackey 35: folds 
Jl roll: calls $0.19
*** TURN *** [5d 8s Ac] [Kc]
123tiger711a: checks 
Jl roll: checks 
*** RIVER *** [5d 8s Ac Kc] [Jh]
123tiger711a: checks 
Jl roll: checks 
*** SHOW DOWN ***
123tiger711a: shows [9s 8h] (a pair of Eights)
Jl roll: mucks hand 
123tiger711a collected $0.74 from pot
*** SUMMARY ***
Total pot $0.78 | Rake $0.04 
Board [5d 8s Ac Kc Jh]
Seat 1: njmerc (big blind) folded on the Flop
Seat 2: PlayTheBlues4U folded before Flop (didn't bet)
Seat 3: blackey 35 folded on the Flop
Seat 4: Jl roll mucked [6c 6s]
Seat 5: papag555 (button) folded before Flop (didn't bet)
Seat 6: 123tiger711a (small blind) showed [9s 8h] and won ($0.74) with a pair of Eights



PokerStars Hand #205010167024:  Hold'em No Limit ($0.05/$0.10 USD) - 2019/10/24 21:34:31 ET
Table 'Atala' 6-max Seat #6 is the button
Seat 1: njmerc ($10 in chips) 
Seat 2: PlayTheBlues4U ($17.29 in chips) 
Seat 3: blackey 35 ($16.88 in chips) 
Seat 4: Jl roll ($38.03 in chips) 
Seat 5: papag555 ($10.16 in chips) 
Seat 6: 123tiger711a ($12.18 in chips) 
njmerc: posts small blind $0.05
PlayTheBlues4U: posts big blind $0.10
*** HOLE CARDS ***
Dealt to PlayTheBlues4U [2d Kc]
blackey 35: calls $0.10
Jl roll: folds 
papag555: calls $0.10
123tiger711a: calls $0.10
njmerc: folds 
PlayTheBlues4U: checks 
*** FLOP *** [Td 4d Tc]
PlayTheBlues4U: checks 
blackey 35: bets $0.10
papag555: folds 
123tiger711a: folds 
PlayTheBlues4U: folds 
Uncalled bet ($0.10) returned to blackey 35
blackey 35 collected $0.43 from pot
*** SUMMARY ***
Total pot $0.45 | Rake $0.02 
Board [Td 4d Tc]
Seat 1: njmerc (small blind) folded before Flop
Seat 2: PlayTheBlues4U (big blind) folded on the Flop
Seat 3: blackey 35 collected ($0.43)
Seat 4: Jl roll folded before Flop (didn't bet)
Seat 5: papag555 folded on the Flop
Seat 6: 123tiger711a (button) folded on the Flop



PokerStars Hand #205010167171:  Hold'em No Limit ($0.05/$0.10 USD) - 2019/10/24 21:35:05 ET
Table 'Atala' 6-max Seat #1 is the button
Seat 1: njmerc ($10 in chips) 
Seat 2: PlayTheBlues4U ($17.19 in chips) 
Seat 3: blackey 35 ($17.21 in chips) 
Seat 4: Jl roll ($38.03 in chips) 
Seat 5: papag555 ($10.06 in chips) 
Seat 6: 123tiger711a ($12.08 in chips) 
PlayTheBlues4U: posts small blind $0.05
blackey 35: posts big blind $0.10
*** HOLE CARDS ***
Dealt to PlayTheBlues4U [7d Js]
Jl roll: folds 
papag555: folds 
123tiger711a: folds 
njmerc: folds 
PlayTheBlues4U: folds 
Uncalled bet ($0.05) returned to blackey 35
blackey 35 collected $0.10 from pot
*** SUMMARY ***
Total pot $0.10 | Rake $0 
Seat 1: njmerc (button) folded before Flop (didn't bet)
Seat 2: PlayTheBlues4U (small blind) folded before Flop
Seat 3: blackey 35 (big blind) collected ($0.10)
Seat 4: Jl roll folded before Flop (didn't bet)
Seat 5: papag555 folded before Flop (didn't bet)
Seat 6: 123tiger711a folded before Flop (didn't bet)



PokerStars Hand #205010167308:  Hold'em No Limit ($0.05/$0.10 USD) - 2019/10/24 21:35:37 ET
Table 'Atala' 6-max Seat #2 is the button
Seat 1: njmerc ($10 in chips) 
Seat 2: PlayTheBlues4U ($17.14 in chips) 
Seat 3: blackey 35 ($17.26 in chips) 
Seat 4: Jl roll ($38.03 in chips) 
Seat 5: papag555 ($10.06 in chips) 
Seat 6: 123tiger711a ($12.08 in chips) 
blackey 35: posts small blind $0.05
Jl roll: posts big blind $0.10
*** HOLE CARDS ***
Dealt to PlayTheBlues4U [2d 9c]
papag555: calls $0.10
123tiger711a: folds 
njmerc: folds 
PlayTheBlues4U: folds 
blackey 35: calls $0.05
Jl roll: checks 
*** FLOP *** [4h Qs Kc]
blackey 35: bets $0.20
Jl roll: folds 
papag555: calls $0.20
*** TURN *** [4h Qs Kc] [4d]
blackey 35: bets $0.30
papag555: folds 
Uncalled bet ($0.30) returned to blackey 35
blackey 35 collected $0.66 from pot
*** SUMMARY ***
Total pot $0.70 | Rake $0.04 
Board [4h Qs Kc 4d]
Seat 1: njmerc folded before Flop (didn't bet)
Seat 2: PlayTheBlues4U (button) folded before Flop (didn't bet)
Seat 3: blackey 35 (small blind) collected ($0.66)
Seat 4: Jl roll (big blind) folded on the Flop
Seat 5: papag555 folded on the Turn
Seat 6: 123tiger711a folded before Flop (didn't bet)



PokerStars Hand #205010167489:  Hold'em No Limit ($0.05/$0.10 USD) - 2019/10/24 21:36:25 ET
Table 'Atala' 6-max Seat #3 is the button
Seat 1: njmerc ($10 in chips) 
Seat 2: PlayTheBlues4U ($17.14 in chips) 
Seat 3: blackey 35 ($17.62 in chips) 
Seat 4: Jl roll ($37.93 in chips) 
Seat 5: papag555 ($9.76 in chips) 
Seat 6: 123tiger711a ($12.08 in chips) 
Jl roll: posts small blind $0.05
papag555: posts big blind $0.10
*** HOLE CARDS ***
Dealt to PlayTheBlues4U [Ks 7c]
123tiger711a: folds 
njmerc: folds 
PlayTheBlues4U: folds 
blackey 35: calls $0.10
Jl roll: calls $0.05
papag555: checks 
*** FLOP *** [6c 4d 4h]
Jl roll: checks 
papag555: bets $0.30
blackey 35: folds 
Jl roll: folds 
Uncalled bet ($0.30) returned to papag555
papag555 collected $0.28 from pot
papag555: doesn't show hand 
*** SUMMARY ***
Total pot $0.30 | Rake $0.02 
Board [6c 4d 4h]
Seat 1: njmerc folded before Flop (didn't bet)
Seat 2: PlayTheBlues4U folded before Flop (didn't bet)
Seat 3: blackey 35 (button) folded on the Flop
Seat 4: Jl roll (small blind) folded on the Flop
Seat 5: papag555 (big blind) collected ($0.28)
Seat 6: 123tiger711a folded before Flop (didn't bet)



PokerStars Hand #205010167647:  Hold'em No Limit ($0.05/$0.10 USD) - 2019/10/24 21:37:07 ET
Table 'Atala' 6-max Seat #4 is the button
Seat 1: njmerc ($10 in chips) 
Seat 2: PlayTheBlues4U ($17.14 in chips) 
Seat 3: blackey 35 ($17.52 in chips) 
Seat 4: Jl roll ($37.83 in chips) 
Seat 5: papag555 ($9.94 in chips) 
Seat 6: 123tiger711a ($12.08 in chips) 
papag555: posts small blind $0.05
123tiger711a: posts big blind $0.10
*** HOLE CARDS ***
Dealt to PlayTheBlues4U [6s Jd]
njmerc: folds 
PlayTheBlues4U: folds 
blackey 35: folds 
Jl roll: folds 
papag555: calls $0.05
123tiger711a: checks 
*** FLOP *** [2s 3s Qh]
papag555: checks 
123tiger711a: checks 
*** TURN *** [2s 3s Qh] [6d]
papag555: checks 
123tiger711a: checks 
*** RIVER *** [2s 3s Qh 6d] [Qc]
papag555: checks 
123tiger711a: checks 
*** SHOW DOWN ***
papag555: shows [Kh 8c] (a pair of Queens)
123tiger711a: shows [8s Ac] (a pair of Queens - Ace kicker)
123tiger711a collected $0.19 from pot
*** SUMMARY ***
Total pot $0.20 | Rake $0.01 
Board [2s 3s Qh 6d Qc]
Seat 1: njmerc folded before Flop (didn't bet)
Seat 2: PlayTheBlues4U folded before Flop (didn't bet)
Seat 3: blackey 35 folded before Flop (didn't bet)
Seat 4: Jl roll (button) folded before Flop (didn't bet)
Seat 5: papag555 (small blind) showed [Kh 8c] and lost with a pair of Queens
Seat 6: 123tiger711a (big blind) showed [8s Ac] and won ($0.19) with a pair of Queens



PokerStars Hand #205010167867:  Hold'em No Limit ($0.05/$0.10 USD) - 2019/10/24 21:37:56 ET
Table 'Atala' 6-max Seat #5 is the button
Seat 1: njmerc ($10 in chips) 
Seat 2: PlayTheBlues4U ($17.14 in chips) 
Seat 3: blackey 35 ($17.52 in chips) 
Seat 4: Jl roll ($37.83 in chips) 
Seat 5: papag555 ($9.84 in chips) 
Seat 6: 123tiger711a ($12.17 in chips) 
123tiger711a: posts small blind $0.05
njmerc: posts big blind $0.10
*** HOLE CARDS ***
Dealt to PlayTheBlues4U [Ks As]
PlayTheBlues4U: raises $0.20 to $0.30
blackey 35: calls $0.30
Jl roll: calls $0.30
papag555: folds 
123tiger711a: folds 
njmerc: folds 
*** FLOP *** [Th 3d Qs]
PlayTheBlues4U: checks 
blackey 35: bets $0.10
Jl roll: calls $0.10
PlayTheBlues4U: calls $0.10
*** TURN *** [Th 3d Qs] [Qh]
PlayTheBlues4U: checks 
blackey 35: bets $0.20
Jl roll: calls $0.20
PlayTheBlues4U: folds 
*** RIVER *** [Th 3d Qs Qh] [Kd]
blackey 35: checks 
Jl roll: bets $3.20
blackey 35: folds 
Uncalled bet ($3.20) returned to Jl roll
Jl roll collected $1.66 from pot
Jl roll: doesn't show hand 
*** SUMMARY ***
Total pot $1.75 | Rake $0.09 
Board [Th 3d Qs Qh Kd]
Seat 1: njmerc (big blind) folded before Flop
Seat 2: PlayTheBlues4U folded on the Turn
Seat 3: blackey 35 folded on the River
Seat 4: Jl roll collected ($1.66)
Seat 5: papag555 (button) folded before Flop (didn't bet)
Seat 6: 123tiger711a (small blind) folded before Flop



PokerStars Hand #205010168240:  Hold'em No Limit ($0.05/$0.10 USD) - 2019/10/24 21:39:27 ET
Table 'Atala' 6-max Seat #6 is the button
Seat 1: njmerc ($10 in chips) 
Seat 2: PlayTheBlues4U ($16.74 in chips) 
Seat 3: blackey 35 ($16.92 in chips) 
Seat 4: Jl roll ($38.89 in chips) 
Seat 5: papag555 ($9.84 in chips) 
Seat 6: 123tiger711a ($12.12 in chips) 
njmerc: posts small blind $0.05
PlayTheBlues4U: posts big blind $0.10
*** HOLE CARDS ***
Dealt to PlayTheBlues4U [3s 7d]
blackey 35: folds 
Jl roll: folds 
papag555: calls $0.10
123tiger711a: folds 
njmerc: calls $0.05
PlayTheBlues4U: checks 
*** FLOP *** [Th As Ah]
njmerc: checks 
PlayTheBlues4U: checks 
papag555: bets $0.30
njmerc: folds 
PlayTheBlues4U: folds 
Uncalled bet ($0.30) returned to papag555
papag555 collected $0.28 from pot
papag555: doesn't show hand 
*** SUMMARY ***
Total pot $0.30 | Rake $0.02 
Board [Th As Ah]
Seat 1: njmerc (small blind) folded on the Flop
Seat 2: PlayTheBlues4U (big blind) folded on the Flop
Seat 3: blackey 35 folded before Flop (didn't bet)
Seat 4: Jl roll folded before Flop (didn't bet)
Seat 5: papag555 collected ($0.28)
Seat 6: 123tiger711a (button) folded before Flop (didn't bet)



PokerStars Hand #205010168467:  Hold'em No Limit ($0.05/$0.10 USD) - 2019/10/24 21:40:20 ET
Table 'Atala' 6-max Seat #1 is the button
Seat 1: njmerc ($10 in chips) 
Seat 2: PlayTheBlues4U ($16.64 in chips) 
Seat 3: blackey 35 ($16.92 in chips) 
Seat 4: Jl roll ($38.89 in chips) 
Seat 5: papag555 ($10.02 in chips) 
Seat 6: 123tiger711a ($12.12 in chips) 
PlayTheBlues4U: posts small blind $0.05
blackey 35: posts big blind $0.10
*** HOLE CARDS ***
Dealt to PlayTheBlues4U [Jh 6c]
Jl roll: folds 
papag555: folds 
123tiger711a: folds 
njmerc: folds 
PlayTheBlues4U: folds 
Uncalled bet ($0.05) returned to blackey 35
blackey 35 collected $0.10 from pot
*** SUMMARY ***
Total pot $0.10 | Rake $0 
Seat 1: njmerc (button) folded before Flop (didn't bet)
Seat 2: PlayTheBlues4U (small blind) folded before Flop
Seat 3: blackey 35 (big blind) collected ($0.10)
Seat 4: Jl roll folded before Flop (didn't bet)
Seat 5: papag555 folded before Flop (didn't bet)
Seat 6: 123tiger711a folded before Flop (didn't bet)



PokerStars Hand #205010168545:  Hold'em No Limit ($0.05/$0.10 USD) - 2019/10/24 21:40:39 ET
Table 'Atala' 6-max Seat #2 is the button
Seat 1: njmerc ($10 in chips) 
Seat 2: PlayTheBlues4U ($16.59 in chips) 
Seat 3: blackey 35 ($16.97 in chips) 
Seat 4: Jl roll ($38.89 in chips) 
Seat 5: papag555 ($10.02 in chips) 
Seat 6: 123tiger711a ($12.12 in chips) 
blackey 35: posts small blind $0.05
Jl roll: posts big blind $0.10
*** HOLE CARDS ***
Dealt to PlayTheBlues4U [Qh 4s]
papag555: folds 
123tiger711a: folds 
njmerc: raises $0.20 to $0.30
PlayTheBlues4U: folds 
blackey 35: folds 
Jl roll: raises $0.70 to $1
njmerc: calls $0.70
*** FLOP *** [9s Ks 9c]
Jl roll: bets $0.30
njmerc: calls $0.30
*** TURN *** [9s Ks 9c] [Kd]
Jl roll: checks 
njmerc: checks 
*** RIVER *** [9s Ks 9c Kd] [6s]
Jl roll: checks 
njmerc: checks 
*** SHOW DOWN ***
Jl roll: shows [Ac 5c] (two pair, Kings and Nines)
njmerc: shows [Ad Ts] (two pair, Kings and Nines)
Jl roll collected $1.26 from pot
njmerc collected $1.26 from pot
*** SUMMARY ***
Total pot $2.65 | Rake $0.13 
Board [9s Ks 9c Kd 6s]
Seat 1: njmerc showed [Ad Ts] and won ($1.26) with two pair, Kings and Nines
Seat 2: PlayTheBlues4U (button) folded before Flop (didn't bet)
Seat 3: blackey 35 (small blind) folded before Flop
Seat 4: Jl roll (big blind) showed [Ac 5c] and won ($1.26) with two pair, Kings and Nines
Seat 5: papag555 folded before Flop (didn't bet)
Seat 6: 123tiger711a folded before Flop (didn't bet)



PokerStars Hand #205010168714:  Hold'em No Limit ($0.05/$0.10 USD) - 2019/10/24 21:41:21 ET
Table 'Atala' 6-max Seat #3 is the button
Seat 1: njmerc ($10 in chips) 
Seat 2: PlayTheBlues4U ($16.59 in chips) 
Seat 3: blackey 35 ($16.92 in chips) 
Seat 4: Jl roll ($38.85 in chips) 
Seat 5: papag555 ($10.02 in chips) 
Seat 6: 123tiger711a ($12.12 in chips) 
Jl roll: posts small blind $0.05
papag555: posts big blind $0.10
*** HOLE CARDS ***
Dealt to PlayTheBlues4U [Qc 2h]
123tiger711a: calls $0.10
njmerc: folds 
PlayTheBlues4U: folds 
blackey 35: calls $0.10
Jl roll: calls $0.05
papag555: checks 
*** FLOP *** [Ts 3s 8s]
Jl roll: checks 
papag555: checks 
123tiger711a: checks 
blackey 35: bets $0.10
Jl roll: folds 
papag555: calls $0.10
123tiger711a: folds 
*** TURN *** [Ts 3s 8s] [2s]
papag555: checks 
blackey 35: bets $0.30
papag555: folds 
Uncalled bet ($0.30) returned to blackey 35
blackey 35 collected $0.57 from pot
*** SUMMARY ***
Total pot $0.60 | Rake $0.03 
Board [Ts 3s 8s 2s]
Seat 1: njmerc folded before Flop (didn't bet)
Seat 2: PlayTheBlues4U folded before Flop (didn't bet)
Seat 3: blackey 35 (button) collected ($0.57)
Seat 4: Jl roll (small blind) folded on the Flop
Seat 5: papag555 (big blind) folded on the Turn
Seat 6: 123tiger711a folded on the Flop



PokerStars Hand #205010169013:  Hold'em No Limit ($0.05/$0.10 USD) - 2019/10/24 21:42:32 ET
Table 'Atala' 6-max Seat #4 is the button
Seat 1: njmerc ($10 in chips) 
Seat 2: PlayTheBlues4U ($16.59 in chips) 
Seat 3: blackey 35 ($17.29 in chips) 
Seat 4: Jl roll ($38.75 in chips) 
Seat 5: papag555 ($9.82 in chips) 
Seat 6: 123tiger711a ($12.02 in chips) 
papag555: posts small blind $0.05
123tiger711a: posts big blind $0.10
*** HOLE CARDS ***
Dealt to PlayTheBlues4U [Td Kd]
njmerc: folds 
PlayTheBlues4U: folds 
blackey 35: folds 
Jl roll: folds 
papag555: calls $0.05
123tiger711a: checks 
*** FLOP *** [Ad Ah 3s]
papag555: checks 
123tiger711a: checks 
*** TURN *** [Ad Ah 3s] [Js]
papag555: checks 
123tiger711a: checks 
*** RIVER *** [Ad Ah 3s Js] [2c]
papag555: bets $0.50
123tiger711a: folds 
Uncalled bet ($0.50) returned to papag555
papag555 collected $0.19 from pot
papag555: doesn't show hand 
*** SUMMARY ***
Total pot $0.20 | Rake $0.01 
Board [Ad Ah 3s Js 2c]
Seat 1: njmerc folded before Flop (didn't bet)
Seat 2: PlayTheBlues4U folded before Flop (didn't bet)
Seat 3: blackey 35 folded before Flop (didn't bet)
Seat 4: Jl roll (button) folded before Flop (didn't bet)
Seat 5: papag555 (small blind) collected ($0.19)
Seat 6: 123tiger711a (big blind) folded on the River



PokerStars Hand #205010169170:  Hold'em No Limit ($0.05/$0.10 USD) - 2019/10/24 21:43:13 ET
Table 'Atala' 6-max Seat #5 is the button
Seat 1: njmerc ($10 in chips) 
Seat 2: PlayTheBlues4U ($16.59 in chips) 
Seat 3: blackey 35 ($17.29 in chips) 
Seat 4: Jl roll ($38.75 in chips) 
Seat 5: papag555 ($9.91 in chips) 
Seat 6: 123tiger711a ($11.92 in chips) 
123tiger711a: posts small blind $0.05
njmerc: posts big blind $0.10
*** HOLE CARDS ***
Dealt to PlayTheBlues4U [Kc 8d]
PlayTheBlues4U: folds 
blackey 35: folds 
Jl roll: raises $0.60 to $0.70
papag555: calls $0.70
123tiger711a: calls $0.65
njmerc: folds 
*** FLOP *** [3c 3d 3s]
123tiger711a: checks 
Jl roll: checks 
papag555: bets $0.80
123tiger711a: calls $0.80
Jl roll: calls $0.80
*** TURN *** [3c 3d 3s] [4c]
123tiger711a: bets $2.19
Jl roll: folds 
papag555: calls $2.19
*** RIVER *** [3c 3d 3s 4c] [Jh]
123tiger711a: bets $8.23 and is all-in
papag555: folds 
Uncalled bet ($8.23) returned to 123tiger711a
123tiger711a collected $8.53 from pot
*** SUMMARY ***
Total pot $8.98 | Rake $0.45 
Board [3c 3d 3s 4c Jh]
Seat 1: njmerc (big blind) folded before Flop
Seat 2: PlayTheBlues4U folded before Flop (didn't bet)
Seat 3: blackey 35 folded before Flop (didn't bet)
Seat 4: Jl roll folded on the Turn
Seat 5: papag555 (button) folded on the River
Seat 6: 123tiger711a (small blind) collected ($8.53)



PokerStars Hand #205010169454:  Hold'em No Limit ($0.05/$0.10 USD) - 2019/10/24 21:44:22 ET
Table 'Atala' 6-max Seat #6 is the button
Seat 1: njmerc ($10 in chips) 
Seat 2: PlayTheBlues4U ($16.59 in chips) 
Seat 3: blackey 35 ($17.29 in chips) 
Seat 4: Jl roll ($37.25 in chips) 
Seat 5: papag555 ($6.22 in chips) 
Seat 6: 123tiger711a ($16.76 in chips) 
njmerc: posts small blind $0.05
PlayTheBlues4U: posts big blind $0.10
*** HOLE CARDS ***
Dealt to PlayTheBlues4U [Kh Jh]
blackey 35: calls $0.10
Jl roll: folds 
papag555: calls $0.10
123tiger711a: calls $0.10
njmerc: folds 
PlayTheBlues4U: raises $0.40 to $0.50
blackey 35: folds 
papag555: calls $0.40
123tiger711a: folds 
*** FLOP *** [Kc Jd 7s]
PlayTheBlues4U: bets $0.90
papag555: calls $0.90
*** TURN *** [Kc Jd 7s] [Qd]
PlayTheBlues4U: bets $1.90
papag555: raises $2.92 to $4.82 and is all-in
PlayTheBlues4U: calls $2.92
*** RIVER *** [Kc Jd 7s Qd] [As]
*** SHOW DOWN ***
PlayTheBlues4U: shows [Kh Jh] (two pair, Kings and Jacks)
papag555: shows [9d Tc] (a straight, Ten to Ace)
papag555 collected $12.06 from pot
*** SUMMARY ***
Total pot $12.69 | Rake $0.63 
Board [Kc Jd 7s Qd As]
Seat 1: njmerc (small blind) folded before Flop
Seat 2: PlayTheBlues4U (big blind) showed [Kh Jh] and lost with two pair, Kings and Jacks
Seat 3: blackey 35 folded before Flop
Seat 4: Jl roll folded before Flop (didn't bet)
Seat 5: papag555 showed [9d Tc] and won ($12.06) with a straight, Ten to Ace
Seat 6: 123tiger711a (button) folded before Flop



PokerStars Hand #205010169729:  Hold'em No Limit ($0.05/$0.10 USD) - 2019/10/24 21:45:29 ET
Table 'Atala' 6-max Seat #1 is the button
Seat 1: njmerc ($10 in chips) 
Seat 2: PlayTheBlues4U ($10.37 in chips) 
Seat 3: blackey 35 ($17.19 in chips) 
Seat 4: Jl roll ($37.25 in chips) 
Seat 5: papag555 ($12.06 in chips) 
Seat 6: 123tiger711a ($16.66 in chips) 
PlayTheBlues4U: posts small blind $0.05
blackey 35: posts big blind $0.10
*** HOLE CARDS ***
Dealt to PlayTheBlues4U [Ah 2c]
Jl roll: calls $0.10
papag555: raises $0.30 to $0.40
123tiger711a: folds 
njmerc: folds 
PlayTheBlues4U said, "nh"
PlayTheBlues4U: folds 
blackey 35: folds 
Jl roll: calls $0.30
*** FLOP *** [8s 4d 3d]
Jl roll: checks 
papag555: bets $0.50
Jl roll: folds 
Uncalled bet ($0.50) returned to papag555
papag555 collected $0.90 from pot
papag555: doesn't show hand 
*** SUMMARY ***
Total pot $0.95 | Rake $0.05 
Board [8s 4d 3d]
Seat 1: njmerc (button) folded before Flop (didn't bet)
Seat 2: PlayTheBlues4U (small blind) folded before Flop
Seat 3: blackey 35 (big blind) folded before Flop
Seat 4: Jl roll folded on the Flop
Seat 5: papag555 collected ($0.90)
Seat 6: 123tiger711a folded before Flop (didn't bet)



PokerStars Hand #205010169848:  Hold'em No Limit ($0.05/$0.10 USD) - 2019/10/24 21:45:56 ET
Table 'Atala' 6-max Seat #2 is the button
Seat 1: njmerc ($10 in chips) 
Seat 2: PlayTheBlues4U ($10.32 in chips) 
Seat 3: blackey 35 ($17.09 in chips) 
Seat 4: Jl roll ($36.85 in chips) 
Seat 5: papag555 ($12.56 in chips) 
Seat 6: 123tiger711a ($16.66 in chips) 
blackey 35: posts small blind $0.05
Jl roll: posts big blind $0.10
*** HOLE CARDS ***
Dealt to PlayTheBlues4U [Jh 3c]
papag555: calls $0.10
123tiger711a: folds 
njmerc: folds 
PlayTheBlues4U: folds 
blackey 35: folds 
Jl roll: checks 
*** FLOP *** [Tc Qd Ks]
Jl roll: bets $0.20
papag555: calls $0.20
*** TURN *** [Tc Qd Ks] [Ac]
Jl roll: bets $0.30
papag555: calls $0.30
*** RIVER *** [Tc Qd Ks Ac] [4s]
Jl roll: bets $36.25 and is all-in
papag555: folds 
Uncalled bet ($36.25) returned to Jl roll
Jl roll collected $1.19 from pot
Jl roll: doesn't show hand 
*** SUMMARY ***
Total pot $1.25 | Rake $0.06 
Board [Tc Qd Ks Ac 4s]
Seat 1: njmerc folded before Flop (didn't bet)
Seat 2: PlayTheBlues4U (button) folded before Flop (didn't bet)
Seat 3: blackey 35 (small blind) folded before Flop
Seat 4: Jl roll (big blind) collected ($1.19)
Seat 5: papag555 folded on the River
Seat 6: 123tiger711a folded before Flop (didn't bet)



PokerStars Hand #205010977393:  Hold'em No Limit ($0.05/$0.10 USD) - 2019/10/24 21:46:58 ET
Table 'Atala' 6-max Seat #3 is the button
Seat 1: njmerc ($10 in chips) 
Seat 2: PlayTheBlues4U ($10.32 in chips) 
Seat 3: blackey 35 ($17.04 in chips) 
Seat 4: Jl roll ($37.44 in chips) 
Seat 5: papag555 ($11.96 in chips) 
Seat 6: 123tiger711a ($16.66 in chips) 
Jl roll: posts small blind $0.05
papag555: posts big blind $0.10
*** HOLE CARDS ***
Dealt to PlayTheBlues4U [7h 8h]
123tiger711a: folds 
njmerc: raises $0.20 to $0.30
PlayTheBlues4U: folds 
blackey 35: calls $0.30
Jl roll: calls $0.25
papag555: folds 
*** FLOP *** [Qd 3s 5s]
Jl roll: bets $0.60
njmerc: raises $1.08 to $1.68
blackey 35: folds 
Jl roll: calls $1.08
*** TURN *** [Qd 3s 5s] [Jd]
Jl roll: checks 
njmerc: bets $2.76
Jl roll: calls $2.76
*** RIVER *** [Qd 3s 5s Jd] [Tc]
Jl roll: checks 
njmerc: bets $5.26 and is all-in
Jl roll: folds 
Uncalled bet ($5.26) returned to njmerc
njmerc collected $9.39 from pot
njmerc: doesn't show hand 
*** SUMMARY ***
Total pot $9.88 | Rake $0.49 
Board [Qd 3s 5s Jd Tc]
Seat 1: njmerc collected ($9.39)
Seat 2: PlayTheBlues4U folded before Flop (didn't bet)
Seat 3: blackey 35 (button) folded on the Flop
Seat 4: Jl roll (small blind) folded on the River
Seat 5: papag555 (big blind) folded before Flop
Seat 6: 123tiger711a folded before Flop (didn't bet)



PokerStars Hand #205010977688:  Hold'em No Limit ($0.05/$0.10 USD) - 2019/10/24 21:48:09 ET
Table 'Atala' 6-max Seat #4 is the button
Seat 1: njmerc ($14.65 in chips) 
Seat 2: PlayTheBlues4U ($10.32 in chips) 
Seat 3: blackey 35 ($16.74 in chips) 
Seat 4: Jl roll ($32.70 in chips) 
Seat 5: papag555 ($11.86 in chips) 
Seat 6: 123tiger711a ($16.66 in chips) 
papag555: posts small blind $0.05
123tiger711a: posts big blind $0.10
*** HOLE CARDS ***
Dealt to PlayTheBlues4U [8c Kh]
njmerc: folds 
PlayTheBlues4U: folds 
blackey 35: folds 
Jl roll: calls $0.10
papag555: calls $0.05
123tiger711a: checks 
*** FLOP *** [7c 7h 5s]
papag555: checks 
123tiger711a: checks 
Jl roll: checks 
*** TURN *** [7c 7h 5s] [8s]
papag555: checks 
123tiger711a: checks 
Jl roll: checks 
*** RIVER *** [7c 7h 5s 8s] [2s]
papag555: checks 
123tiger711a: checks 
Jl roll: checks 
*** SHOW DOWN ***
papag555: shows [3h Tc] (a pair of Sevens)
123tiger711a: shows [Kc 9s] (a pair of Sevens - King kicker)
Jl roll: mucks hand 
123tiger711a collected $0.28 from pot
*** SUMMARY ***
Total pot $0.30 | Rake $0.02 
Board [7c 7h 5s 8s 2s]
Seat 1: njmerc folded before Flop (didn't bet)
Seat 2: PlayTheBlues4U folded before Flop (didn't bet)
Seat 3: blackey 35 folded before Flop (didn't bet)
Seat 4: Jl roll (button) mucked [Jc Qh]
Seat 5: papag555 (small blind) showed [3h Tc] and lost with a pair of Sevens
Seat 6: 123tiger711a (big blind) showed [Kc 9s] and won ($0.28) with a pair of Sevens



PokerStars Hand #205010977883:  Hold'em No Limit ($0.05/$0.10 USD) - 2019/10/24 21:48:59 ET
Table 'Atala' 6-max Seat #5 is the button
Seat 1: njmerc ($14.65 in chips) 
Seat 2: PlayTheBlues4U ($10.32 in chips) 
Seat 3: blackey 35 ($16.74 in chips) 
Seat 4: Jl roll ($32.60 in chips) 
Seat 5: papag555 ($11.76 in chips) 
Seat 6: 123tiger711a ($16.84 in chips) 
123tiger711a: posts small blind $0.05
njmerc: posts big blind $0.10
*** HOLE CARDS ***
Dealt to PlayTheBlues4U [3h 5c]
PlayTheBlues4U: folds 
blackey 35: folds 
Jl roll: folds 
papag555: calls $0.10
123tiger711a: calls $0.05
njmerc: checks 
*** FLOP *** [Ts 4c 5d]
123tiger711a: checks 
njmerc: checks 
papag555: checks 
*** TURN *** [Ts 4c 5d] [Td]
123tiger711a: bets $0.14
njmerc: folds 
papag555: calls $0.14
*** RIVER *** [Ts 4c 5d Td] [Ah]
123tiger711a: checks 
papag555: checks 
*** SHOW DOWN ***
123tiger711a: shows [4s 8h] (two pair, Tens and Fours)
papag555: shows [Js 5s] (two pair, Tens and Fives)
papag555 collected $0.55 from pot
*** SUMMARY ***
Total pot $0.58 | Rake $0.03 
Board [Ts 4c 5d Td Ah]
Seat 1: njmerc (big blind) folded on the Turn
Seat 2: PlayTheBlues4U folded before Flop (didn't bet)
Seat 3: blackey 35 folded before Flop (didn't bet)
Seat 4: Jl roll folded before Flop (didn't bet)
Seat 5: papag555 (button) showed [Js 5s] and won ($0.55) with two pair, Tens and Fives
Seat 6: 123tiger711a (small blind) showed [4s 8h] and lost with two pair, Tens and Fours



PokerStars Hand #205010978052:  Hold'em No Limit ($0.05/$0.10 USD) - 2019/10/24 21:49:42 ET
Table 'Atala' 6-max Seat #6 is the button
Seat 1: njmerc ($14.55 in chips) 
Seat 2: PlayTheBlues4U ($10.32 in chips) 
Seat 3: blackey 35 ($16.74 in chips) 
Seat 4: Jl roll ($32.60 in chips) 
Seat 5: papag555 ($12.07 in chips) 
Seat 6: 123tiger711a ($16.60 in chips) 
njmerc: posts small blind $0.05
PlayTheBlues4U: posts big blind $0.10
*** HOLE CARDS ***
Dealt to PlayTheBlues4U [3c Jc]
blackey 35: folds 
Jl roll: calls $0.10
papag555: raises $0.20 to $0.30
123tiger711a: calls $0.30
njmerc: folds 
PlayTheBlues4U: folds 
Jl roll: calls $0.20
*** FLOP *** [8s 4c 4h]
Jl roll: checks 
papag555: bets $0.40
123tiger711a: calls $0.40
Jl roll: folds 
*** TURN *** [8s 4c 4h] [Ks]
papag555: checks 
123tiger711a: checks 
*** RIVER *** [8s 4c 4h Ks] [Tc]
papag555: checks 
123tiger711a: checks 
*** SHOW DOWN ***
papag555: shows [3d 3s] (two pair, Fours and Threes)
123tiger711a: mucks hand 
papag555 collected $1.76 from pot
*** SUMMARY ***
Total pot $1.85 | Rake $0.09 
Board [8s 4c 4h Ks Tc]
Seat 1: njmerc (small blind) folded before Flop
Seat 2: PlayTheBlues4U (big blind) folded before Flop
Seat 3: blackey 35 folded before Flop (didn't bet)
Seat 4: Jl roll folded on the Flop
Seat 5: papag555 showed [3d 3s] and won ($1.76) with two pair, Fours and Threes
Seat 6: 123tiger711a (button) mucked [Qh Ac]



PokerStars Hand #205010978213:  Hold'em No Limit ($0.05/$0.10 USD) - 2019/10/24 21:50:23 ET
Table 'Atala' 6-max Seat #1 is the button
Seat 1: njmerc ($14.50 in chips) 
Seat 2: PlayTheBlues4U ($10.22 in chips) 
Seat 3: blackey 35 ($16.74 in chips) 
Seat 4: Jl roll ($32.30 in chips) 
Seat 5: papag555 ($13.13 in chips) 
Seat 6: 123tiger711a ($15.90 in chips) 
PlayTheBlues4U: posts small blind $0.05
blackey 35: posts big blind $0.10
*** HOLE CARDS ***
Dealt to PlayTheBlues4U [6c 4s]
Jl roll: folds 
papag555: folds 
123tiger711a: folds 
njmerc: folds 
PlayTheBlues4U: folds 
Uncalled bet ($0.05) returned to blackey 35
blackey 35 collected $0.10 from pot
*** SUMMARY ***
Total pot $0.10 | Rake $0 
Seat 1: njmerc (button) folded before Flop (didn't bet)
Seat 2: PlayTheBlues4U (small blind) folded before Flop
Seat 3: blackey 35 (big blind) collected ($0.10)
Seat 4: Jl roll folded before Flop (didn't bet)
Seat 5: papag555 folded before Flop (didn't bet)
Seat 6: 123tiger711a folded before Flop (didn't bet)



PokerStars Hand #205010978267:  Hold'em No Limit ($0.05/$0.10 USD) - 2019/10/24 21:50:38 ET
Table 'Atala' 6-max Seat #2 is the button
Seat 1: njmerc ($14.50 in chips) 
Seat 2: PlayTheBlues4U ($10.17 in chips) 
Seat 3: blackey 35 ($16.79 in chips) 
Seat 4: Jl roll ($32.30 in chips) 
Seat 5: papag555 ($13.13 in chips) 
Seat 6: 123tiger711a ($15.90 in chips) 
blackey 35: posts small blind $0.05
Jl roll: posts big blind $0.10
*** HOLE CARDS ***
Dealt to PlayTheBlues4U [8s 6s]
papag555: raises $0.10 to $0.20
123tiger711a: folds 
njmerc: folds 
PlayTheBlues4U: folds 
blackey 35: calls $0.15
Jl roll: calls $0.10
*** FLOP *** [2c Jc 4h]
blackey 35: bets $0.10
Jl roll: calls $0.10
papag555: calls $0.10
*** TURN *** [2c Jc 4h] [8h]
blackey 35: bets $0.20
Jl roll: raises $0.20 to $0.40
papag555: folds 
blackey 35: calls $0.20
*** RIVER *** [2c Jc 4h 8h] [8d]
blackey 35: checks 
Jl roll: bets $1.60
blackey 35: folds 
Uncalled bet ($1.60) returned to Jl roll
Jl roll collected $1.62 from pot
Jl roll: doesn't show hand 
*** SUMMARY ***
Total pot $1.70 | Rake $0.08 
Board [2c Jc 4h 8h 8d]
Seat 1: njmerc folded before Flop (didn't bet)
Seat 2: PlayTheBlues4U (button) folded before Flop (didn't bet)
Seat 3: blackey 35 (small blind) folded on the River
Seat 4: Jl roll (big blind) collected ($1.62)
Seat 5: papag555 folded on the Turn
Seat 6: 123tiger711a folded before Flop (didn't bet)



PokerStars Hand #205010978440:  Hold'em No Limit ($0.05/$0.10 USD) - 2019/10/24 21:51:24 ET
Table 'Atala' 6-max Seat #3 is the button
Seat 1: njmerc ($14.50 in chips) 
Seat 2: PlayTheBlues4U ($10.17 in chips) 
Seat 3: blackey 35 ($16.09 in chips) 
Seat 4: Jl roll ($33.22 in chips) 
Seat 5: papag555 ($12.83 in chips) 
Seat 6: 123tiger711a ($15.90 in chips) 
Jl roll: posts small blind $0.05
papag555: posts big blind $0.10
*** HOLE CARDS ***
Dealt to PlayTheBlues4U [3h 8s]
123tiger711a: folds 
njmerc: folds 
PlayTheBlues4U: folds 
blackey 35: calls $0.10
Jl roll: calls $0.05
papag555: checks 
*** FLOP *** [Qd 7h 4s]
Jl roll: checks 
papag555: bets $0.30
blackey 35: folds 
Jl roll: folds 
Uncalled bet ($0.30) returned to papag555
papag555 collected $0.28 from pot
papag555: doesn't show hand 
*** SUMMARY ***
Total pot $0.30 | Rake $0.02 
Board [Qd 7h 4s]
Seat 1: njmerc folded before Flop (didn't bet)
Seat 2: PlayTheBlues4U folded before Flop (didn't bet)
Seat 3: blackey 35 (button) folded on the Flop
Seat 4: Jl roll (small blind) folded on the Flop
Seat 5: papag555 (big blind) collected ($0.28)
Seat 6: 123tiger711a folded before Flop (didn't bet)



PokerStars Hand #205010978577:  Hold'em No Limit ($0.05/$0.10 USD) - 2019/10/24 21:51:59 ET
Table 'Atala' 6-max Seat #4 is the button
Seat 1: njmerc ($14.50 in chips) 
Seat 2: PlayTheBlues4U ($10.17 in chips) 
Seat 3: blackey 35 ($15.99 in chips) 
Seat 4: Jl roll ($33.12 in chips) 
Seat 5: papag555 ($13.01 in chips) 
Seat 6: 123tiger711a ($15.90 in chips) 
papag555: posts small blind $0.05
123tiger711a: posts big blind $0.10
*** HOLE CARDS ***
Dealt to PlayTheBlues4U [8h Ts]
njmerc: folds 
PlayTheBlues4U: folds 
blackey 35: calls $0.10
Jl roll: calls $0.10
papag555: calls $0.05
123tiger711a: checks 
*** FLOP *** [3s 8s Qs]
papag555: checks 
123tiger711a: checks 
blackey 35: bets $0.30
Jl roll: folds 
papag555: folds 
123tiger711a: folds 
Uncalled bet ($0.30) returned to blackey 35
blackey 35 collected $0.38 from pot
*** SUMMARY ***
Total pot $0.40 | Rake $0.02 
Board [3s 8s Qs]
Seat 1: njmerc folded before Flop (didn't bet)
Seat 2: PlayTheBlues4U folded before Flop (didn't bet)
Seat 3: blackey 35 collected ($0.38)
Seat 4: Jl roll (button) folded on the Flop
Seat 5: papag555 (small blind) folded on the Flop
Seat 6: 123tiger711a (big blind) folded on the Flop



PokerStars Hand #205010978690:  Hold'em No Limit ($0.05/$0.10 USD) - 2019/10/24 21:52:28 ET
Table 'Atala' 6-max Seat #5 is the button
Seat 1: njmerc ($14.50 in chips) 
Seat 2: PlayTheBlues4U ($10.17 in chips) 
Seat 3: blackey 35 ($16.27 in chips) 
Seat 4: Jl roll ($33.02 in chips) 
Seat 5: papag555 ($12.91 in chips) 
Seat 6: 123tiger711a ($15.80 in chips) 
123tiger711a: posts small blind $0.05
njmerc: posts big blind $0.10
*** HOLE CARDS ***
Dealt to PlayTheBlues4U [Ad 6d]
PlayTheBlues4U: folds 
blackey 35: calls $0.10
Jl roll: folds 
papag555: folds 
123tiger711a: calls $0.05
njmerc: checks 
*** FLOP *** [9c 2h 6s]
123tiger711a: bets $0.14
njmerc: calls $0.14
blackey 35: calls $0.14
*** TURN *** [9c 2h 6s] [8h]
123tiger711a: bets $0.34
njmerc: folds 
blackey 35: folds 
Uncalled bet ($0.34) returned to 123tiger711a
123tiger711a collected $0.68 from pot
*** SUMMARY ***
Total pot $0.72 | Rake $0.04 
Board [9c 2h 6s 8h]
Seat 1: njmerc (big blind) folded on the Turn
Seat 2: PlayTheBlues4U folded before Flop (didn't bet)
Seat 3: blackey 35 folded on the Turn
Seat 4: Jl roll folded before Flop (didn't bet)
Seat 5: papag555 (button) folded before Flop (didn't bet)
Seat 6: 123tiger711a (small blind) collected ($0.68)



PokerStars Hand #205010978869:  Hold'em No Limit ($0.05/$0.10 USD) - 2019/10/24 21:53:09 ET
Table 'Atala' 6-max Seat #6 is the button
Seat 1: njmerc ($14.26 in chips) 
Seat 2: PlayTheBlues4U ($10.17 in chips) 
Seat 3: blackey 35 ($16.03 in chips) 
Seat 4: Jl roll ($33.02 in chips) 
Seat 5: papag555 ($12.91 in chips) 
Seat 6: 123tiger711a ($16.24 in chips) 
njmerc: posts small blind $0.05
PlayTheBlues4U: posts big blind $0.10
*** HOLE CARDS ***
Dealt to PlayTheBlues4U [Td 8s]
blackey 35: calls $0.10
Jl roll: calls $0.10
papag555: folds 
123tiger711a: folds 
njmerc: calls $0.05
PlayTheBlues4U: checks 
*** FLOP *** [As 9c Jd]
njmerc: checks 
PlayTheBlues4U: checks 
blackey 35: bets $0.10
Jl roll: folds 
njmerc: folds 
PlayTheBlues4U: raises $0.30 to $0.40
blackey 35: calls $0.30
*** TURN *** [As 9c Jd] [3c]
PlayTheBlues4U: bets $0.70
blackey 35: folds 
Uncalled bet ($0.70) returned to PlayTheBlues4U
PlayTheBlues4U collected $1.14 from pot
PlayTheBlues4U: doesn't show hand 
*** SUMMARY ***
Total pot $1.20 | Rake $0.06 
Board [As 9c Jd 3c]
Seat 1: njmerc (small blind) folded on the Flop
Seat 2: PlayTheBlues4U (big blind) collected ($1.14)
Seat 3: blackey 35 folded on the Turn
Seat 4: Jl roll folded on the Flop
Seat 5: papag555 folded before Flop (didn't bet)
Seat 6: 123tiger711a (button) folded before Flop (didn't bet)



PokerStars Hand #205010979067:  Hold'em No Limit ($0.05/$0.10 USD) - 2019/10/24 21:54:02 ET
Table 'Atala' 6-max Seat #1 is the button
Seat 1: njmerc ($14.16 in chips) 
Seat 2: PlayTheBlues4U ($10.81 in chips) 
Seat 3: blackey 35 ($15.53 in chips) 
Seat 4: Jl roll ($32.92 in chips) 
Seat 5: papag555 ($12.91 in chips) 
Seat 6: 123tiger711a ($16.24 in chips) 
PlayTheBlues4U: posts small blind $0.05
blackey 35: posts big blind $0.10
*** HOLE CARDS ***
Dealt to PlayTheBlues4U [Jd 7h]
Jl roll: folds 
papag555: folds 
123tiger711a: calls $0.10
njmerc: folds 
PlayTheBlues4U: folds 
blackey 35: checks 
*** FLOP *** [Kc 2d 4s]
blackey 35: bets $0.10
123tiger711a: raises $0.44 to $0.54
blackey 35: folds 
Uncalled bet ($0.44) returned to 123tiger711a
123tiger711a collected $0.43 from pot
*** SUMMARY ***
Total pot $0.45 | Rake $0.02 
Board [Kc 2d 4s]
Seat 1: njmerc (button) folded before Flop (didn't bet)
Seat 2: PlayTheBlues4U (small blind) folded before Flop
Seat 3: blackey 35 (big blind) folded on the Flop
Seat 4: Jl roll folded before Flop (didn't bet)
Seat 5: papag555 folded before Flop (didn't bet)
Seat 6: 123tiger711a collected ($0.43)



PokerStars Hand #205010979158:  Hold'em No Limit ($0.05/$0.10 USD) - 2019/10/24 21:54:27 ET
Table 'Atala' 6-max Seat #2 is the button
Seat 1: njmerc ($14.16 in chips) 
Seat 2: PlayTheBlues4U ($10.76 in chips) 
Seat 3: blackey 35 ($15.33 in chips) 
Seat 4: Jl roll ($32.92 in chips) 
Seat 5: papag555 ($12.91 in chips) 
Seat 6: 123tiger711a ($16.47 in chips) 
blackey 35: posts small blind $0.05
Jl roll: posts big blind $0.10
*** HOLE CARDS ***
Dealt to PlayTheBlues4U [Th Ad]
papag555 has timed out
papag555: folds 
123tiger711a: folds 
njmerc: folds 
PlayTheBlues4U: raises $0.20 to $0.30
blackey 35: folds 
Jl roll: folds 
Uncalled bet ($0.20) returned to PlayTheBlues4U
PlayTheBlues4U collected $0.25 from pot
PlayTheBlues4U: doesn't show hand 
*** SUMMARY ***
Total pot $0.25 | Rake $0 
Seat 1: njmerc folded before Flop (didn't bet)
Seat 2: PlayTheBlues4U (button) collected ($0.25)
Seat 3: blackey 35 (small blind) folded before Flop
Seat 4: Jl roll (big blind) folded before Flop
Seat 5: papag555 folded before Flop (didn't bet)
Seat 6: 123tiger711a folded before Flop (didn't bet)



PokerStars Hand #205010979281:  Hold'em No Limit ($0.05/$0.10 USD) - 2019/10/24 21:54:59 ET
Table 'Atala' 6-max Seat #3 is the button
Seat 1: njmerc ($14.16 in chips) 
Seat 2: PlayTheBlues4U ($10.91 in chips) 
Seat 3: blackey 35 ($15.28 in chips) 
Seat 4: Jl roll ($32.82 in chips) 
Seat 5: papag555 ($12.91 in chips) 
Seat 6: 123tiger711a ($16.47 in chips) 
Jl roll: posts small blind $0.05
papag555: posts big blind $0.10
*** HOLE CARDS ***
Dealt to PlayTheBlues4U [Qh 6d]
123tiger711a: calls $0.10
njmerc: calls $0.10
PlayTheBlues4U: folds 
blackey 35: calls $0.10
Jl roll: calls $0.05
papag555: checks 
*** FLOP *** [4d 9c 7s]
Jl roll: checks 
papag555: checks 
123tiger711a: bets $0.24
njmerc: folds 
blackey 35: folds 
Jl roll: calls $0.24
papag555: folds 
*** TURN *** [4d 9c 7s] [5d]
Jl roll: checks 
123tiger711a: checks 
*** RIVER *** [4d 9c 7s 5d] [8d]
Jl roll: checks 
123tiger711a: bets $0.47
Jl roll: calls $0.47
*** SHOW DOWN ***
123tiger711a: shows [Jc Ts] (a straight, Seven to Jack)
Jl roll: mucks hand 
123tiger711a collected $1.82 from pot
*** SUMMARY ***
Total pot $1.92 | Rake $0.10 
Board [4d 9c 7s 5d 8d]
Seat 1: njmerc folded on the Flop
Seat 2: PlayTheBlues4U folded before Flop (didn't bet)
Seat 3: blackey 35 (button) folded on the Flop
Seat 4: Jl roll (small blind) mucked [9s Qs]
Seat 5: papag555 (big blind) folded on the Flop
Seat 6: 123tiger711a showed [Jc Ts] and won ($1.82) with a straight, Seven to Jack



PokerStars Hand #205010979427:  Hold'em No Limit ($0.05/$0.10 USD) - 2019/10/24 21:55:47 ET
Table 'Atala' 6-max Seat #4 is the button
Seat 1: njmerc ($14.06 in chips) 
Seat 2: PlayTheBlues4U ($10.91 in chips) 
Seat 3: blackey 35 ($15.18 in chips) 
Seat 4: Jl roll ($32.01 in chips) 
Seat 5: papag555 ($12.81 in chips) 
papag555: posts small blind $0.05
123tiger711a: is sitting out 
njmerc: posts big blind $0.10
*** HOLE CARDS ***
Dealt to PlayTheBlues4U [5d 7c]
123tiger711a leaves the table
PlayTheBlues4U: folds 
blackey 35: calls $0.10
Jl roll: calls $0.10
clovvnfiesta joins the table at seat #6 
papag555: calls $0.05
njmerc: checks 
*** FLOP *** [Ts 5s 9c]
papag555: checks 
njmerc: bets $0.25
blackey 35: calls $0.25
Jl roll: folds 
papag555: folds 
*** TURN *** [Ts 5s 9c] [Qs]
njmerc: checks 
blackey 35: bets $0.30
njmerc: calls $0.30
*** RIVER *** [Ts 5s 9c Qs] [Qd]
njmerc: checks 
blackey 35: bets $0.60
njmerc: folds 
Uncalled bet ($0.60) returned to blackey 35
blackey 35 collected $1.42 from pot
*** SUMMARY ***
Total pot $1.50 | Rake $0.08 
Board [Ts 5s 9c Qs Qd]
Seat 1: njmerc (big blind) folded on the River
Seat 2: PlayTheBlues4U folded before Flop (didn't bet)
Seat 3: blackey 35 collected ($1.42)
Seat 4: Jl roll (button) folded on the Flop
Seat 5: papag555 (small blind) folded on the Flop



PokerStars Hand #205010979561:  Hold'em No Limit ($0.05/$0.10 USD) - 2019/10/24 21:56:34 ET
Table 'Atala' 6-max Seat #5 is the button
Seat 1: njmerc ($13.41 in chips) 
Seat 2: PlayTheBlues4U ($10.91 in chips) 
Seat 3: blackey 35 ($15.95 in chips) 
Seat 4: Jl roll ($31.91 in chips) 
Seat 5: papag555 ($12.71 in chips) 
njmerc: posts small blind $0.05
PlayTheBlues4U: posts big blind $0.10
*** HOLE CARDS ***
Dealt to PlayTheBlues4U [Qc Jc]
blackey 35: folds 
Jl roll: folds 
papag555: raises $0.20 to $0.30
njmerc: folds 
PlayTheBlues4U: calls $0.20
*** FLOP *** [7d 6s 8s]
PlayTheBlues4U: checks 
papag555: bets $0.30
PlayTheBlues4U is disconnected 
PlayTheBlues4U is connected 
PlayTheBlues4U: folds 
Uncalled bet ($0.30) returned to papag555
papag555 collected $0.62 from pot
papag555: doesn't show hand 
*** SUMMARY ***
Total pot $0.65 | Rake $0.03 
Board [7d 6s 8s]
Seat 1: njmerc (small blind) folded before Flop
Seat 2: PlayTheBlues4U (big blind) folded on the Flop
Seat 3: blackey 35 folded before Flop (didn't bet)
Seat 4: Jl roll folded before Flop (didn't bet)
Seat 5: papag555 (button) collected ($0.62)



PokerStars Hand #205010979735:  Hold'em No Limit ($0.05/$0.10 USD) - 2019/10/24 21:57:36 ET
Table 'Atala' 6-max Seat #1 is the button
Seat 1: njmerc ($13.36 in chips) 
Seat 2: PlayTheBlues4U ($10.61 in chips) 
Seat 3: blackey 35 ($15.95 in chips) 
Seat 4: Jl roll ($31.91 in chips) 
Seat 5: papag555 ($13.03 in chips) 
PlayTheBlues4U: posts small blind $0.05
blackey 35: posts big blind $0.10
clovvnfiesta: sits out 
*** HOLE CARDS ***
Dealt to PlayTheBlues4U [5h Th]
Jl roll: folds 
papag555: folds 
njmerc: folds 
PlayTheBlues4U: folds 
Uncalled bet ($0.05) returned to blackey 35
blackey 35 collected $0.10 from pot
*** SUMMARY ***
Total pot $0.10 | Rake $0 
Seat 1: njmerc (button) folded before Flop (didn't bet)
Seat 2: PlayTheBlues4U (small blind) folded before Flop
Seat 3: blackey 35 (big blind) collected ($0.10)
Seat 4: Jl roll folded before Flop (didn't bet)
Seat 5: papag555 folded before Flop (didn't bet)



PokerStars Hand #205010979793:  Hold'em No Limit ($0.05/$0.10 USD) - 2019/10/24 21:57:54 ET
Table 'Atala' 6-max Seat #2 is the button
Seat 1: njmerc ($13.36 in chips) 
Seat 2: PlayTheBlues4U ($10.56 in chips) 
Seat 3: blackey 35 ($16 in chips) 
Seat 4: Jl roll ($31.91 in chips) 
Seat 5: papag555 ($13.03 in chips) 
blackey 35: posts small blind $0.05
Jl roll: posts big blind $0.10
clovvnfiesta: sits out 
*** HOLE CARDS ***
Dealt to PlayTheBlues4U [5s Kc]
papag555: calls $0.10
njmerc: folds 
PlayTheBlues4U: folds 
blackey 35: calls $0.05
Jl roll: checks 
*** FLOP *** [8c Ts 2h]
blackey 35: checks 
Jl roll: checks 
papag555: checks 
*** TURN *** [8c Ts 2h] [5c]
blackey 35: checks 
Jl roll: checks 
papag555: checks 
*** RIVER *** [8c Ts 2h 5c] [5h]
blackey 35: checks 
Jl roll: checks 
papag555: checks 
*** SHOW DOWN ***
blackey 35: shows [9d 6c] (a pair of Fives)
Jl roll: mucks hand 
papag555: shows [Ks Jc] (a pair of Fives - King kicker)
papag555 collected $0.28 from pot
*** SUMMARY ***
Total pot $0.30 | Rake $0.02 
Board [8c Ts 2h 5c 5h]
Seat 1: njmerc folded before Flop (didn't bet)
Seat 2: PlayTheBlues4U (button) folded before Flop (didn't bet)
Seat 3: blackey 35 (small blind) showed [9d 6c] and lost with a pair of Fives
Seat 4: Jl roll (big blind) mucked [7s 3c]
Seat 5: papag555 showed [Ks Jc] and won ($0.28) with a pair of Fives



PokerStars Hand #205010979938:  Hold'em No Limit ($0.05/$0.10 USD) - 2019/10/24 21:58:43 ET
Table 'Atala' 6-max Seat #3 is the button
Seat 1: njmerc ($13.36 in chips) 
Seat 2: PlayTheBlues4U ($10.56 in chips) 
Seat 3: blackey 35 ($15.90 in chips) 
Seat 4: Jl roll ($31.81 in chips) 
Seat 5: papag555 ($13.21 in chips) 
Jl roll: posts small blind $0.05
papag555: posts big blind $0.10
clovvnfiesta: sits out 
*** HOLE CARDS ***
Dealt to PlayTheBlues4U [2h Qd]
njmerc: folds 
PlayTheBlues4U: folds 
blackey 35: calls $0.10
Jl roll: calls $0.05
papag555: checks 
*** FLOP *** [2s 5h 3d]
Jl roll: checks 
papag555: checks 
blackey 35: checks 
*** TURN *** [2s 5h 3d] [7c]
Jl roll: checks 
papag555: checks 
blackey 35: checks 
*** RIVER *** [2s 5h 3d 7c] [Ts]
Jl roll: checks 
papag555: checks 
blackey 35: checks 
*** SHOW DOWN ***
Jl roll: shows [Qc Jh] (high card Queen)
papag555: mucks hand 
blackey 35: shows [As 6d] (high card Ace)
blackey 35 collected $0.28 from pot
*** SUMMARY ***
Total pot $0.30 | Rake $0.02 
Board [2s 5h 3d 7c Ts]
Seat 1: njmerc folded before Flop (didn't bet)
Seat 2: PlayTheBlues4U folded before Flop (didn't bet)
Seat 3: blackey 35 (button) showed [As 6d] and won ($0.28) with high card Ace
Seat 4: Jl roll (small blind) showed [Qc Jh] and lost with high card Queen
Seat 5: papag555 (big blind) mucked [8s 4d]



PokerStars Hand #205010164558:  Hold'em No Limit ($0.05/$0.10 USD) - 2019/10/24 21:25:01 ET
Table 'Delphinus' 6-max Seat #2 is the button
Seat 1: NoseyNoodle ($3.97 in chips) 
Seat 2: MM7ny ($16.16 in chips) 
Seat 3: pwr13nj ($8.92 in chips) 
Seat 4: PlayTheBlues4U ($10 in chips) 
Seat 5: erik51fun ($6.66 in chips) 
pwr13nj: posts small blind $0.05
PlayTheBlues4U: posts big blind $0.10
123tiger711a: sits out 
*** HOLE CARDS ***
Dealt to PlayTheBlues4U [As 6s]
erik51fun: calls $0.10
NoseyNoodle: folds 
MM7ny: calls $0.10
pwr13nj: calls $0.05
PlayTheBlues4U: checks 
*** FLOP *** [Kc Ah Kd]
pwr13nj: checks 
PlayTheBlues4U: bets $0.20
erik51fun: folds 
MM7ny: folds 
pwr13nj: folds 
Uncalled bet ($0.20) returned to PlayTheBlues4U
PlayTheBlues4U collected $0.38 from pot
PlayTheBlues4U: doesn't show hand 
*** SUMMARY ***
Total pot $0.40 | Rake $0.02 
Board [Kc Ah Kd]
Seat 1: NoseyNoodle folded before Flop (didn't bet)
Seat 2: MM7ny (button) folded on the Flop
Seat 3: pwr13nj (small blind) folded on the Flop
Seat 4: PlayTheBlues4U (big blind) collected ($0.38)
Seat 5: erik51fun folded on the Flop



PokerStars Hand #205010164827:  Hold'em No Limit ($0.05/$0.10 USD) - 2019/10/24 21:25:59 ET
Table 'Delphinus' 6-max Seat #3 is the button
Seat 1: NoseyNoodle ($3.97 in chips) 
Seat 2: MM7ny ($16.06 in chips) 
Seat 3: pwr13nj ($8.82 in chips) 
Seat 4: PlayTheBlues4U ($10.28 in chips) 
Seat 5: erik51fun ($6.56 in chips) 
PlayTheBlues4U: posts small blind $0.05
erik51fun: posts big blind $0.10
123tiger711a: sits out 
*** HOLE CARDS ***
Dealt to PlayTheBlues4U [Qh 4h]
NoseyNoodle: folds 
MM7ny: raises $0.20 to $0.30
pwr13nj: folds 
PlayTheBlues4U: folds 
erik51fun: calls $0.20
*** FLOP *** [Js 9s 8h]
erik51fun: bets $0.40
MM7ny: calls $0.40
*** TURN *** [Js 9s 8h] [4c]
erik51fun: checks 
MM7ny: checks 
*** RIVER *** [Js 9s 8h 4c] [6c]
erik51fun: bets $0.30
MM7ny: calls $0.30
*** SHOW DOWN ***
erik51fun: shows [2s 2h] (a pair of Deuces)
MM7ny: shows [As Ah] (a pair of Aces)
MM7ny collected $1.95 from pot
*** SUMMARY ***
Total pot $2.05 | Rake $0.10 
Board [Js 9s 8h 4c 6c]
Seat 1: NoseyNoodle folded before Flop (didn't bet)
Seat 2: MM7ny showed [As Ah] and won ($1.95) with a pair of Aces
Seat 3: pwr13nj (button) folded before Flop (didn't bet)
Seat 4: PlayTheBlues4U (small blind) folded before Flop
Seat 5: erik51fun (big blind) showed [2s 2h] and lost with a pair of Deuces



PokerStars Hand #205010165021:  Hold'em No Limit ($0.05/$0.10 USD) - 2019/10/24 21:26:45 ET
Table 'Delphinus' 6-max Seat #4 is the button
Seat 1: NoseyNoodle ($3.97 in chips) 
Seat 2: MM7ny ($17.01 in chips) 
Seat 3: pwr13nj ($8.82 in chips) 
Seat 4: PlayTheBlues4U ($10.23 in chips) 
Seat 5: erik51fun ($5.56 in chips) 
Seat 6: 123tiger711a ($10.04 in chips) 
erik51fun: posts small blind $0.05
123tiger711a: posts big blind $0.10
*** HOLE CARDS ***
Dealt to PlayTheBlues4U [Ks Th]
NoseyNoodle: folds 
MM7ny: folds 
pwr13nj: raises $0.20 to $0.30
PlayTheBlues4U: folds 
erik51fun: folds 
123tiger711a: folds 
Uncalled bet ($0.20) returned to pwr13nj
pwr13nj collected $0.25 from pot
pwr13nj: doesn't show hand 
*** SUMMARY ***
Total pot $0.25 | Rake $0 
Seat 1: NoseyNoodle folded before Flop (didn't bet)
Seat 2: MM7ny folded before Flop (didn't bet)
Seat 3: pwr13nj collected ($0.25)
Seat 4: PlayTheBlues4U (button) folded before Flop (didn't bet)
Seat 5: erik51fun (small blind) folded before Flop
Seat 6: 123tiger711a (big blind) folded before Flop



PokerStars Hand #205010165092:  Hold'em No Limit ($0.05/$0.10 USD) - 2019/10/24 21:27:01 ET
Table 'Delphinus' 6-max Seat #5 is the button
Seat 1: NoseyNoodle ($3.97 in chips) 
Seat 2: MM7ny ($17.01 in chips) 
Seat 3: pwr13nj ($8.97 in chips) 
Seat 4: PlayTheBlues4U ($10.23 in chips) 
Seat 5: erik51fun ($5.51 in chips) 
Seat 6: 123tiger711a ($10 in chips) 
123tiger711a: posts small blind $0.05
NoseyNoodle: posts big blind $0.10
*** HOLE CARDS ***
Dealt to PlayTheBlues4U [6d Jh]
MM7ny: raises $0.15 to $0.25
pwr13nj: folds 
PlayTheBlues4U: folds 
erik51fun: folds 
123tiger711a: folds 
NoseyNoodle: folds 
Uncalled bet ($0.15) returned to MM7ny
MM7ny collected $0.25 from pot
MM7ny: doesn't show hand 
*** SUMMARY ***
Total pot $0.25 | Rake $0 
Seat 1: NoseyNoodle (big blind) folded before Flop
Seat 2: MM7ny collected ($0.25)
Seat 3: pwr13nj folded before Flop (didn't bet)
Seat 4: PlayTheBlues4U folded before Flop (didn't bet)
Seat 5: erik51fun (button) folded before Flop (didn't bet)
Seat 6: 123tiger711a (small blind) folded before Flop



PokerStars Hand #205010165203:  Hold'em No Limit ($0.05/$0.10 USD) - 2019/10/24 21:27:28 ET
Table 'Delphinus' 6-max Seat #6 is the button
Seat 1: NoseyNoodle ($3.87 in chips) 
Seat 2: MM7ny ($17.16 in chips) 
Seat 3: pwr13nj ($8.97 in chips) 
Seat 4: PlayTheBlues4U ($10.23 in chips) 
Seat 5: erik51fun ($5.51 in chips) 
Seat 6: 123tiger711a ($10 in chips) 
NoseyNoodle: posts small blind $0.05
MM7ny: posts big blind $0.10
*** HOLE CARDS ***
Dealt to PlayTheBlues4U [6h 4d]
NoseyNoodle said, "my turn next for those pocket rockets"
pwr13nj: folds 
PlayTheBlues4U: folds 
erik51fun: folds 
123tiger711a: folds 
NoseyNoodle: calls $0.05
MM7ny said, "ok, but just once"
MM7ny said, "when I don't have a hand"
MM7ny: checks 
*** FLOP *** [Ac 3d 5s]
NoseyNoodle: bets $0.10
MM7ny: calls $0.10
*** TURN *** [Ac 3d 5s] [Kh]
NoseyNoodle: checks 
MM7ny: checks 
*** RIVER *** [Ac 3d 5s Kh] [Qs]
NoseyNoodle: checks 
MM7ny: checks 
*** SHOW DOWN ***
NoseyNoodle: shows [6c 5h] (a pair of Fives)
MM7ny: mucks hand 
NoseyNoodle collected $0.38 from pot
*** SUMMARY ***
Total pot $0.40 | Rake $0.02 
Board [Ac 3d 5s Kh Qs]
Seat 1: NoseyNoodle (small blind) showed [6c 5h] and won ($0.38) with a pair of Fives
Seat 2: MM7ny (big blind) mucked [4c 7h]
Seat 3: pwr13nj folded before Flop (didn't bet)
Seat 4: PlayTheBlues4U folded before Flop (didn't bet)
Seat 5: erik51fun folded before Flop (didn't bet)
Seat 6: 123tiger711a (button) folded before Flop (didn't bet)



PokerStars Hand #205010165540:  Hold'em No Limit ($0.05/$0.10 USD) - 2019/10/24 21:28:44 ET
Table 'Delphinus' 6-max Seat #1 is the button
Seat 1: NoseyNoodle ($4.05 in chips) 
Seat 2: MM7ny ($16.96 in chips) 
Seat 3: pwr13nj ($8.97 in chips) 
Seat 4: PlayTheBlues4U ($10.23 in chips) 
Seat 5: erik51fun ($5.51 in chips) 
Seat 6: 123tiger711a ($10 in chips) 
MM7ny: posts small blind $0.05
pwr13nj: posts big blind $0.10
*** HOLE CARDS ***
Dealt to PlayTheBlues4U [Ad 2c]
PlayTheBlues4U: folds 
erik51fun: folds 
123tiger711a: folds 
NoseyNoodle: raises $0.10 to $0.20
MM7ny: folds 
pwr13nj: calls $0.10
*** FLOP *** [6d 3h 9h]
pwr13nj: checks 
NoseyNoodle: bets $0.20
pwr13nj: folds 
Uncalled bet ($0.20) returned to NoseyNoodle
NoseyNoodle collected $0.43 from pot
NoseyNoodle: doesn't show hand 
*** SUMMARY ***
Total pot $0.45 | Rake $0.02 
Board [6d 3h 9h]
Seat 1: NoseyNoodle (button) collected ($0.43)
Seat 2: MM7ny (small blind) folded before Flop
Seat 3: pwr13nj (big blind) folded on the Flop
Seat 4: PlayTheBlues4U folded before Flop (didn't bet)
Seat 5: erik51fun folded before Flop (didn't bet)
Seat 6: 123tiger711a folded before Flop (didn't bet)



PokerStars Hand #205010165748:  Hold'em No Limit ($0.05/$0.10 USD) - 2019/10/24 21:29:33 ET
Table 'Delphinus' 6-max Seat #2 is the button
Seat 1: NoseyNoodle ($4.28 in chips) 
Seat 2: MM7ny ($16.91 in chips) 
Seat 3: pwr13nj ($8.77 in chips) 
Seat 4: PlayTheBlues4U ($10.23 in chips) 
Seat 5: erik51fun ($5.51 in chips) 
Seat 6: 123tiger711a ($10 in chips) 
pwr13nj: posts small blind $0.05
PlayTheBlues4U: posts big blind $0.10
*** HOLE CARDS ***
Dealt to PlayTheBlues4U [6d Qd]
erik51fun: calls $0.10
123tiger711a: calls $0.10
NoseyNoodle: folds 
MM7ny: folds 
pwr13nj: folds 
PlayTheBlues4U: checks 
*** FLOP *** [2d Jd 2h]
PlayTheBlues4U: checks 
erik51fun: checks 
123tiger711a: checks 
*** TURN *** [2d Jd 2h] [8c]
PlayTheBlues4U: checks 
NoseyNoodle said, "imagine aces vs aces"
erik51fun: bets $0.10
123tiger711a: folds 
PlayTheBlues4U: folds 
Uncalled bet ($0.10) returned to erik51fun
erik51fun collected $0.33 from pot
erik51fun: doesn't show hand 
*** SUMMARY ***
Total pot $0.35 | Rake $0.02 
Board [2d Jd 2h 8c]
Seat 1: NoseyNoodle folded before Flop (didn't bet)
Seat 2: MM7ny (button) folded before Flop (didn't bet)
Seat 3: pwr13nj (small blind) folded before Flop
Seat 4: PlayTheBlues4U (big blind) folded on the Turn
Seat 5: erik51fun collected ($0.33)
Seat 6: 123tiger711a folded on the Turn



PokerStars Hand #205010165932:  Hold'em No Limit ($0.05/$0.10 USD) - 2019/10/24 21:30:17 ET
Table 'Delphinus' 6-max Seat #3 is the button
Seat 1: NoseyNoodle ($4.28 in chips) 
Seat 2: MM7ny ($16.91 in chips) 
Seat 3: pwr13nj ($8.72 in chips) 
Seat 4: PlayTheBlues4U ($10.13 in chips) 
Seat 5: erik51fun ($5.74 in chips) 
Seat 6: 123tiger711a ($10 in chips) 
PlayTheBlues4U: posts small blind $0.05
erik51fun: posts big blind $0.10
*** HOLE CARDS ***
Dealt to PlayTheBlues4U [Qc 4s]
123tiger711a: folds 
NoseyNoodle: calls $0.10
MM7ny: calls $0.10
pwr13nj: folds 
PlayTheBlues4U: folds 
erik51fun: checks 
*** FLOP *** [8c 2s 7d]
erik51fun: bets $0.30
NoseyNoodle: folds 
MM7ny: folds 
Uncalled bet ($0.30) returned to erik51fun
erik51fun collected $0.33 from pot
erik51fun: doesn't show hand 
*** SUMMARY ***
Total pot $0.35 | Rake $0.02 
Board [8c 2s 7d]
Seat 1: NoseyNoodle folded on the Flop
Seat 2: MM7ny folded on the Flop
Seat 3: pwr13nj (button) folded before Flop (didn't bet)
Seat 4: PlayTheBlues4U (small blind) folded before Flop
Seat 5: erik51fun (big blind) collected ($0.33)
Seat 6: 123tiger711a folded before Flop (didn't bet)



PokerStars Hand #205010166052:  Hold'em No Limit ($0.05/$0.10 USD) - 2019/10/24 21:30:46 ET
Table 'Delphinus' 6-max Seat #4 is the button
Seat 1: NoseyNoodle ($4.18 in chips) 
Seat 2: MM7ny ($16.81 in chips) 
Seat 3: pwr13nj ($8.72 in chips) 
Seat 4: PlayTheBlues4U ($10.08 in chips) 
Seat 5: erik51fun ($5.97 in chips) 
Seat 6: 123tiger711a ($10 in chips) 
erik51fun: posts small blind $0.05
123tiger711a: posts big blind $0.10
*** HOLE CARDS ***
Dealt to PlayTheBlues4U [3s 4d]
NoseyNoodle: raises $0.20 to $0.30
MM7ny: folds 
pwr13nj: raises $0.60 to $0.90
PlayTheBlues4U: folds 
erik51fun: folds 
123tiger711a: folds 
NoseyNoodle: calls $0.60
*** FLOP *** [5h 2h Ad]
NoseyNoodle: checks 
pwr13nj: checks 
*** TURN *** [5h 2h Ad] [9s]
NoseyNoodle: checks 
pwr13nj: bets $0.90
NoseyNoodle: calls $0.90
*** RIVER *** [5h 2h Ad 9s] [6s]
NoseyNoodle: checks 
pwr13nj: bets $1.40
NoseyNoodle: calls $1.40
*** SHOW DOWN ***
pwr13nj: shows [Ah As] (three of a kind, Aces)
NoseyNoodle: mucks hand 
pwr13nj collected $6.22 from pot
*** SUMMARY ***
Total pot $6.55 | Rake $0.33 
Board [5h 2h Ad 9s 6s]
Seat 1: NoseyNoodle mucked [Qd Qs]
Seat 2: MM7ny folded before Flop (didn't bet)
Seat 3: pwr13nj showed [Ah As] and won ($6.22) with three of a kind, Aces
Seat 4: PlayTheBlues4U (button) folded before Flop (didn't bet)
Seat 5: erik51fun (small blind) folded before Flop
Seat 6: 123tiger711a (big blind) folded before Flop



PokerStars Hand #205010166544:  Hold'em No Limit ($0.05/$0.10 USD) - 2019/10/24 21:32:41 ET
Table 'Delphinus' 6-max Seat #5 is the button
Seat 1: NoseyNoodle ($0.98 in chips) 
Seat 2: MM7ny ($16.81 in chips) 
Seat 3: pwr13nj ($11.74 in chips) 
Seat 4: PlayTheBlues4U ($10.08 in chips) 
Seat 5: erik51fun ($5.92 in chips) 
Seat 6: 123tiger711a ($10 in chips) 
123tiger711a: posts small blind $0.05
NoseyNoodle: posts big blind $0.10
*** HOLE CARDS ***
Dealt to PlayTheBlues4U [Jd Th]
MM7ny: folds 
pwr13nj: folds 
NoseyNoodle said, "wrong hand"
PlayTheBlues4U: folds 
NoseyNoodle said, "love those aces"
erik51fun: calls $0.10
123tiger711a: calls $0.05
NoseyNoodle: raises $0.10 to $0.20
erik51fun: calls $0.10
NoseyNoodle said, "vnh"
123tiger711a: calls $0.10
*** FLOP *** [Js 9s 6h]
123tiger711a: checks 
NoseyNoodle: checks 
pwr13nj said, "ty"
erik51fun: checks 
*** TURN *** [Js 9s 6h] [9c]
123tiger711a: checks 
NoseyNoodle: checks 
erik51fun: checks 
*** RIVER *** [Js 9s 6h 9c] [3h]
MM7ny said, "they're hard to come by"
123tiger711a: checks 
NoseyNoodle: checks 
erik51fun: checks 
*** SHOW DOWN ***
123tiger711a: shows [Td Ac] (a pair of Nines)
NoseyNoodle: mucks hand 
erik51fun: shows [6c Qc] (two pair, Nines and Sixes)
erik51fun collected $0.57 from pot
*** SUMMARY ***
Total pot $0.60 | Rake $0.03 
Board [Js 9s 6h 9c 3h]
Seat 1: NoseyNoodle (big blind) mucked [Qh 4d]
Seat 2: MM7ny folded before Flop (didn't bet)
Seat 3: pwr13nj folded before Flop (didn't bet)
Seat 4: PlayTheBlues4U folded before Flop (didn't bet)
Seat 5: erik51fun (button) showed [6c Qc] and won ($0.57) with two pair, Nines and Sixes
Seat 6: 123tiger711a (small blind) showed [Td Ac] and lost with a pair of Nines



PokerStars Hand #205010166896:  Hold'em No Limit ($0.05/$0.10 USD) - 2019/10/24 21:34:00 ET
Table 'Delphinus' 6-max Seat #6 is the button
Seat 1: NoseyNoodle ($0.78 in chips) 
Seat 2: MM7ny ($16.81 in chips) 
Seat 3: pwr13nj ($11.74 in chips) 
Seat 4: PlayTheBlues4U ($10.08 in chips) 
Seat 5: erik51fun ($6.29 in chips) 
Seat 6: 123tiger711a ($10 in chips) 
NoseyNoodle: posts small blind $0.05
MM7ny: posts big blind $0.10
*** HOLE CARDS ***
Dealt to PlayTheBlues4U [Jc 8c]
pwr13nj: folds 
PlayTheBlues4U: folds 
NoseyNoodle said, "nah their swinging this way"
erik51fun: calls $0.10
123tiger711a: folds 
NoseyNoodle: calls $0.05
MM7ny: checks 
*** FLOP *** [3d Qs 8s]
NoseyNoodle: checks 
MM7ny: checks 
erik51fun: checks 
*** TURN *** [3d Qs 8s] [Th]
NoseyNoodle: bets $0.10
MM7ny: folds 
erik51fun: folds 
Uncalled bet ($0.10) returned to NoseyNoodle
NoseyNoodle collected $0.28 from pot
NoseyNoodle: doesn't show hand 
*** SUMMARY ***
Total pot $0.30 | Rake $0.02 
Board [3d Qs 8s Th]
Seat 1: NoseyNoodle (small blind) collected ($0.28)
Seat 2: MM7ny (big blind) folded on the Turn
Seat 3: pwr13nj folded before Flop (didn't bet)
Seat 4: PlayTheBlues4U folded before Flop (didn't bet)
Seat 5: erik51fun folded on the Turn
Seat 6: 123tiger711a (button) folded before Flop (didn't bet)



PokerStars Hand #205010167085:  Hold'em No Limit ($0.05/$0.10 USD) - 2019/10/24 21:34:43 ET
Table 'Delphinus' 6-max Seat #1 is the button
Seat 1: NoseyNoodle ($0.96 in chips) 
Seat 2: MM7ny ($16.71 in chips) 
Seat 3: pwr13nj ($11.74 in chips) 
Seat 4: PlayTheBlues4U ($10.08 in chips) 
Seat 5: erik51fun ($6.19 in chips) 
Seat 6: 123tiger711a ($10 in chips) 
MM7ny: posts small blind $0.05
pwr13nj: posts big blind $0.10
*** HOLE CARDS ***
Dealt to PlayTheBlues4U [5c 2c]
PlayTheBlues4U: folds 
erik51fun: folds 
123tiger711a: calls $0.10
NoseyNoodle: raises $0.86 to $0.96 and is all-in
MM7ny said, "you're not going to win much with them with 96 cents though :)"
MM7ny: folds 
pwr13nj: folds 
123tiger711a: folds 
Uncalled bet ($0.86) returned to NoseyNoodle
NoseyNoodle collected $0.35 from pot
NoseyNoodle: doesn't show hand 
*** SUMMARY ***
Total pot $0.35 | Rake $0 
Seat 1: NoseyNoodle (button) collected ($0.35)
Seat 2: MM7ny (small blind) folded before Flop
Seat 3: pwr13nj (big blind) folded before Flop
Seat 4: PlayTheBlues4U folded before Flop (didn't bet)
Seat 5: erik51fun folded before Flop (didn't bet)
Seat 6: 123tiger711a folded before Flop



PokerStars Hand #205010167218:  Hold'em No Limit ($0.05/$0.10 USD) - 2019/10/24 21:35:16 ET
Table 'Delphinus' 6-max Seat #2 is the button
Seat 1: NoseyNoodle ($1.21 in chips) 
Seat 2: MM7ny ($16.66 in chips) 
Seat 3: pwr13nj ($11.64 in chips) 
Seat 4: PlayTheBlues4U ($10.08 in chips) 
Seat 6: 123tiger711a ($10 in chips) 
pwr13nj: posts small blind $0.05
PlayTheBlues4U: posts big blind $0.10
*** HOLE CARDS ***
Dealt to PlayTheBlues4U [Ac Td]
123tiger711a: calls $0.10
NoseyNoodle: folds 
MM7ny: folds 
pwr13nj: folds 
PlayTheBlues4U: raises $0.30 to $0.40
123tiger711a: calls $0.30
*** FLOP *** [Ah Ad Kc]
NoseyNoodle said, ": )"
PlayTheBlues4U: checks 
123tiger711a: bets $0.41
PlayTheBlues4U: calls $0.41
*** TURN *** [Ah Ad Kc] [Ts]
PlayTheBlues4U: checks 
123tiger711a: checks 
*** RIVER *** [Ah Ad Kc Ts] [4c]
PlayTheBlues4U: bets $1.10
123tiger711a: folds 
Uncalled bet ($1.10) returned to PlayTheBlues4U
PlayTheBlues4U collected $1.59 from pot
PlayTheBlues4U: doesn't show hand 
*** SUMMARY ***
Total pot $1.67 | Rake $0.08 
Board [Ah Ad Kc Ts 4c]
Seat 1: NoseyNoodle folded before Flop (didn't bet)
Seat 2: MM7ny (button) folded before Flop (didn't bet)
Seat 3: pwr13nj (small blind) folded before Flop
Seat 4: PlayTheBlues4U (big blind) collected ($1.59)
Seat 6: 123tiger711a folded on the River



PokerStars Hand #205010167403:  Hold'em No Limit ($0.05/$0.10 USD) - 2019/10/24 21:36:03 ET
Table 'Delphinus' 6-max Seat #3 is the button
Seat 1: NoseyNoodle ($1.21 in chips) 
Seat 2: MM7ny ($16.66 in chips) 
Seat 3: pwr13nj ($11.59 in chips) 
Seat 4: PlayTheBlues4U ($10.86 in chips) 
Seat 6: 123tiger711a ($10 in chips) 
PlayTheBlues4U: posts small blind $0.05
123tiger711a: posts big blind $0.10
*** HOLE CARDS ***
Dealt to PlayTheBlues4U [9c 7h]
NoseyNoodle: folds 
MM7ny: raises $0.15 to $0.25
pwr13nj: folds 
PlayTheBlues4U: folds 
123tiger711a: calls $0.15
*** FLOP *** [8s 9h 9d]
123tiger711a: checks 
MM7ny: bets $0.30
123tiger711a: folds 
Uncalled bet ($0.30) returned to MM7ny
MM7ny collected $0.52 from pot
MM7ny: doesn't show hand 
*** SUMMARY ***
Total pot $0.55 | Rake $0.03 
Board [8s 9h 9d]
Seat 1: NoseyNoodle folded before Flop (didn't bet)
Seat 2: MM7ny collected ($0.52)
Seat 3: pwr13nj (button) folded before Flop (didn't bet)
Seat 4: PlayTheBlues4U (small blind) folded before Flop
Seat 6: 123tiger711a (big blind) folded on the Flop



PokerStars Hand #205010167491:  Hold'em No Limit ($0.05/$0.10 USD) - 2019/10/24 21:36:26 ET
Table 'Delphinus' 6-max Seat #4 is the button
Seat 1: NoseyNoodle ($4.76 in chips) 
Seat 2: MM7ny ($16.93 in chips) 
Seat 3: pwr13nj ($11.59 in chips) 
Seat 4: PlayTheBlues4U ($10.81 in chips) 
Seat 6: 123tiger711a ($10 in chips) 
123tiger711a: posts small blind $0.05
NoseyNoodle: posts big blind $0.10
*** HOLE CARDS ***
Dealt to PlayTheBlues4U [3d 8s]
MM7ny: calls $0.10
pwr13nj: raises $0.30 to $0.40
PlayTheBlues4U: folds 
123tiger711a: folds 
NoseyNoodle: calls $0.30
MM7ny: calls $0.30
*** FLOP *** [5d 6c Th]
NoseyNoodle: checks 
MM7ny: checks 
pwr13nj: bets $0.60
NoseyNoodle: folds 
MM7ny: calls $0.60
*** TURN *** [5d 6c Th] [9c]
MM7ny: checks 
pwr13nj: bets $2
MM7ny: folds 
Uncalled bet ($2) returned to pwr13nj
pwr13nj collected $2.33 from pot
pwr13nj: doesn't show hand 
*** SUMMARY ***
Total pot $2.45 | Rake $0.12 
Board [5d 6c Th 9c]
Seat 1: NoseyNoodle (big blind) folded on the Flop
Seat 2: MM7ny folded on the Turn
Seat 3: pwr13nj collected ($2.33)
Seat 4: PlayTheBlues4U (button) folded before Flop (didn't bet)
Seat 6: 123tiger711a (small blind) folded before Flop



PokerStars Hand #205010167735:  Hold'em No Limit ($0.05/$0.10 USD) - 2019/10/24 21:37:27 ET
Table 'Delphinus' 6-max Seat #6 is the button
Seat 1: NoseyNoodle ($4.36 in chips) 
Seat 3: pwr13nj ($12.92 in chips) 
Seat 4: PlayTheBlues4U ($10.81 in chips) 
Seat 6: 123tiger711a ($10 in chips) 
NoseyNoodle: posts small blind $0.05
MM7ny: is sitting out 
pwr13nj: posts big blind $0.10
erik51fun: sits out 
*** HOLE CARDS ***
Dealt to PlayTheBlues4U [Js 3h]
PlayTheBlues4U: folds 
123tiger711a: calls $0.10
MM7ny leaves the table
NoseyNoodle: raises $0.10 to $0.20
pwr13nj: calls $0.10
123tiger711a: calls $0.10
*** FLOP *** [9s Ac Ah]
NoseyNoodle: checks 
pwr13nj: checks 
123tiger711a: checks 
*** TURN *** [9s Ac Ah] [3d]
clovvnfiesta joins the table at seat #2 
NoseyNoodle: checks 
pwr13nj: checks 
123tiger711a: checks 
*** RIVER *** [9s Ac Ah 3d] [Jc]
NoseyNoodle: bets $0.30
pwr13nj: folds 
123tiger711a: folds 
Uncalled bet ($0.30) returned to NoseyNoodle
NoseyNoodle collected $0.57 from pot
NoseyNoodle: doesn't show hand 
*** SUMMARY ***
Total pot $0.60 | Rake $0.03 
Board [9s Ac Ah 3d Jc]
Seat 1: NoseyNoodle (small blind) collected ($0.57)
Seat 3: pwr13nj (big blind) folded on the River
Seat 4: PlayTheBlues4U folded before Flop (didn't bet)
Seat 6: 123tiger711a (button) folded on the River



PokerStars Hand #205010167916:  Hold'em No Limit ($0.05/$0.10 USD) - 2019/10/24 21:38:10 ET
Table 'Delphinus' 6-max Seat #1 is the button
Seat 1: NoseyNoodle ($4.73 in chips) 
Seat 3: pwr13nj ($12.72 in chips) 
Seat 4: PlayTheBlues4U ($10.81 in chips) 
Seat 6: 123tiger711a ($10 in chips) 
pwr13nj: posts small blind $0.05
PlayTheBlues4U: posts big blind $0.10
erik51fun: sits out 
*** HOLE CARDS ***
Dealt to PlayTheBlues4U [9h 7c]
123tiger711a: folds 
NoseyNoodle: raises $0.20 to $0.30
pwr13nj: folds 
PlayTheBlues4U: folds 
Uncalled bet ($0.20) returned to NoseyNoodle
NoseyNoodle collected $0.25 from pot
NoseyNoodle: doesn't show hand 
*** SUMMARY ***
Total pot $0.25 | Rake $0 
Seat 1: NoseyNoodle (button) collected ($0.25)
Seat 3: pwr13nj (small blind) folded before Flop
Seat 4: PlayTheBlues4U (big blind) folded before Flop
Seat 6: 123tiger711a folded before Flop (didn't bet)



PokerStars Hand #205010167978:  Hold'em No Limit ($0.05/$0.10 USD) - 2019/10/24 21:38:24 ET
Table 'Delphinus' 6-max Seat #3 is the button
Seat 1: NoseyNoodle ($4.88 in chips) 
Seat 3: pwr13nj ($12.67 in chips) 
Seat 4: PlayTheBlues4U ($10.71 in chips) 
Seat 5: erik51fun ($6.19 in chips) 
Seat 6: 123tiger711a ($10 in chips) 
PlayTheBlues4U: posts small blind $0.05
erik51fun: posts big blind $0.10
clovvnfiesta: sits out 
*** HOLE CARDS ***
Dealt to PlayTheBlues4U [5s 2s]
123tiger711a: calls $0.10
NoseyNoodle: calls $0.10
pwr13nj: folds 
PlayTheBlues4U: folds 
erik51fun: checks 
*** FLOP *** [4d 5c Kc]
erik51fun: checks 
123tiger711a: checks 
NoseyNoodle: bets $0.20
erik51fun: folds 
123tiger711a: folds 
Uncalled bet ($0.20) returned to NoseyNoodle
NoseyNoodle collected $0.33 from pot
NoseyNoodle: doesn't show hand 
*** SUMMARY ***
Total pot $0.35 | Rake $0.02 
Board [4d 5c Kc]
Seat 1: NoseyNoodle collected ($0.33)
Seat 3: pwr13nj (button) folded before Flop (didn't bet)
Seat 4: PlayTheBlues4U (small blind) folded before Flop
Seat 5: erik51fun (big blind) folded on the Flop
Seat 6: 123tiger711a folded on the Flop



PokerStars Hand #205010168176:  Hold'em No Limit ($0.05/$0.10 USD) - 2019/10/24 21:39:10 ET
Table 'Delphinus' 6-max Seat #4 is the button
Seat 1: NoseyNoodle ($5.11 in chips) 
Seat 3: pwr13nj ($12.67 in chips) 
Seat 4: PlayTheBlues4U ($10.66 in chips) 
Seat 5: erik51fun ($6.09 in chips) 
Seat 6: 123tiger711a ($10 in chips) 
erik51fun: posts small blind $0.05
123tiger711a: posts big blind $0.10
clovvnfiesta: sits out 
*** HOLE CARDS ***
Dealt to PlayTheBlues4U [9s Js]
NoseyNoodle: folds 
pwr13nj: folds 
PlayTheBlues4U: folds 
erik51fun: calls $0.05
123tiger711a: checks 
*** FLOP *** [Qs Qh 8c]
erik51fun: checks 
123tiger711a: bets $0.10
erik51fun: folds 
Uncalled bet ($0.10) returned to 123tiger711a
123tiger711a collected $0.19 from pot
*** SUMMARY ***
Total pot $0.20 | Rake $0.01 
Board [Qs Qh 8c]
Seat 1: NoseyNoodle folded before Flop (didn't bet)
Seat 3: pwr13nj folded before Flop (didn't bet)
Seat 4: PlayTheBlues4U (button) folded before Flop (didn't bet)
Seat 5: erik51fun (small blind) folded on the Flop
Seat 6: 123tiger711a (big blind) collected ($0.19)



PokerStars Hand #205010168345:  Hold'em No Limit ($0.05/$0.10 USD) - 2019/10/24 21:39:50 ET
Table 'Delphinus' 6-max Seat #5 is the button
Seat 1: NoseyNoodle ($5.11 in chips) 
Seat 3: pwr13nj ($12.67 in chips) 
Seat 4: PlayTheBlues4U ($10.66 in chips) 
Seat 5: erik51fun ($5.99 in chips) 
Seat 6: 123tiger711a ($10.09 in chips) 
123tiger711a: posts small blind $0.05
NoseyNoodle: posts big blind $0.10
clovvnfiesta: sits out 
*** HOLE CARDS ***
Dealt to PlayTheBlues4U [7h 5d]
pwr13nj: raises $0.20 to $0.30
PlayTheBlues4U: folds 
erik51fun: folds 
123tiger711a: folds 
NoseyNoodle: calls $0.20
*** FLOP *** [4h Ah Qd]
NoseyNoodle: checks 
pwr13nj: bets $0.40
NoseyNoodle: folds 
Uncalled bet ($0.40) returned to pwr13nj
pwr13nj collected $0.62 from pot
pwr13nj: doesn't show hand 
*** SUMMARY ***
Total pot $0.65 | Rake $0.03 
Board [4h Ah Qd]
Seat 1: NoseyNoodle (big blind) folded on the Flop
Seat 3: pwr13nj collected ($0.62)
Seat 4: PlayTheBlues4U folded before Flop (didn't bet)
Seat 5: erik51fun (button) folded before Flop (didn't bet)
Seat 6: 123tiger711a (small blind) folded before Flop



PokerStars Hand #205010168501:  Hold'em No Limit ($0.05/$0.10 USD) - 2019/10/24 21:40:28 ET
Table 'Delphinus' 6-max Seat #6 is the button
Seat 1: NoseyNoodle ($4.81 in chips) 
Seat 2: clovvnfiesta ($4 in chips) 
Seat 3: pwr13nj ($12.99 in chips) 
Seat 4: PlayTheBlues4U ($10.66 in chips) 
Seat 5: erik51fun ($5.99 in chips) 
Seat 6: 123tiger711a ($10.04 in chips) 
NoseyNoodle: posts small blind $0.05
clovvnfiesta: posts big blind $0.10
*** HOLE CARDS ***
Dealt to PlayTheBlues4U [2d 4d]
pwr13nj: folds 
PlayTheBlues4U: folds 
erik51fun: folds 
123tiger711a: calls $0.10
NoseyNoodle: folds 
clovvnfiesta: checks 
*** FLOP *** [6c 3d Qd]
clovvnfiesta: bets $0.10
123tiger711a: calls $0.10
*** TURN *** [6c 3d Qd] [7c]
clovvnfiesta: bets $0.10
123tiger711a: calls $0.10
*** RIVER *** [6c 3d Qd 7c] [4s]
clovvnfiesta: bets $0.10
123tiger711a: calls $0.10
*** SHOW DOWN ***
clovvnfiesta: shows [2c Qh] (a pair of Queens)
123tiger711a: mucks hand 
clovvnfiesta collected $0.81 from pot
*** SUMMARY ***
Total pot $0.85 | Rake $0.04 
Board [6c 3d Qd 7c 4s]
Seat 1: NoseyNoodle (small blind) folded before Flop
Seat 2: clovvnfiesta (big blind) showed [2c Qh] and won ($0.81) with a pair of Queens
Seat 3: pwr13nj folded before Flop (didn't bet)
Seat 4: PlayTheBlues4U folded before Flop (didn't bet)
Seat 5: erik51fun folded before Flop (didn't bet)
Seat 6: 123tiger711a (button) mucked [8h Kh]



PokerStars Hand #205010168634:  Hold'em No Limit ($0.05/$0.10 USD) - 2019/10/24 21:41:02 ET
Table 'Delphinus' 6-max Seat #1 is the button
Seat 1: NoseyNoodle ($4.76 in chips) 
Seat 2: clovvnfiesta ($4.41 in chips) 
Seat 3: pwr13nj ($12.99 in chips) 
Seat 4: PlayTheBlues4U ($10.66 in chips) 
Seat 5: erik51fun ($5.99 in chips) 
Seat 6: 123tiger711a ($10 in chips) 
clovvnfiesta: posts small blind $0.05
pwr13nj: posts big blind $0.10
*** HOLE CARDS ***
Dealt to PlayTheBlues4U [9h 2c]
PlayTheBlues4U: folds 
erik51fun: calls $0.10
123tiger711a: folds 
NoseyNoodle: calls $0.10
clovvnfiesta: folds 
pwr13nj: checks 
*** FLOP *** [Ts 9d Jd]
pwr13nj: checks 
erik51fun: bets $0.10
NoseyNoodle: folds 
pwr13nj: folds 
Uncalled bet ($0.10) returned to erik51fun
erik51fun collected $0.33 from pot
erik51fun: doesn't show hand 
*** SUMMARY ***
Total pot $0.35 | Rake $0.02 
Board [Ts 9d Jd]
Seat 1: NoseyNoodle (button) folded on the Flop
Seat 2: clovvnfiesta (small blind) folded before Flop
Seat 3: pwr13nj (big blind) folded on the Flop
Seat 4: PlayTheBlues4U folded before Flop (didn't bet)
Seat 5: erik51fun collected ($0.33)
Seat 6: 123tiger711a folded before Flop (didn't bet)



PokerStars Hand #205010168833:  Hold'em No Limit ($0.05/$0.10 USD) - 2019/10/24 21:41:49 ET
Table 'Delphinus' 6-max Seat #2 is the button
Seat 1: NoseyNoodle ($4.66 in chips) 
Seat 2: clovvnfiesta ($4.36 in chips) 
Seat 3: pwr13nj ($12.89 in chips) 
Seat 4: PlayTheBlues4U ($10.66 in chips) 
Seat 5: erik51fun ($6.22 in chips) 
Seat 6: 123tiger711a ($10 in chips) 
pwr13nj: posts small blind $0.05
PlayTheBlues4U: posts big blind $0.10
*** HOLE CARDS ***
Dealt to PlayTheBlues4U [3s 6h]
erik51fun: folds 
123tiger711a: folds 
NoseyNoodle: folds 
clovvnfiesta: folds 
pwr13nj: raises $0.20 to $0.30
PlayTheBlues4U: folds 
Uncalled bet ($0.20) returned to pwr13nj
pwr13nj collected $0.20 from pot
pwr13nj: doesn't show hand 
*** SUMMARY ***
Total pot $0.20 | Rake $0 
Seat 1: NoseyNoodle folded before Flop (didn't bet)
Seat 2: clovvnfiesta (button) folded before Flop (didn't bet)
Seat 3: pwr13nj (small blind) collected ($0.20)
Seat 4: PlayTheBlues4U (big blind) folded before Flop
Seat 5: erik51fun folded before Flop (didn't bet)
Seat 6: 123tiger711a folded before Flop (didn't bet)



PokerStars Hand #205010168897:  Hold'em No Limit ($0.05/$0.10 USD) - 2019/10/24 21:42:05 ET
Table 'Delphinus' 6-max Seat #3 is the button
Seat 1: NoseyNoodle ($4.66 in chips) 
Seat 2: clovvnfiesta ($4.36 in chips) 
Seat 3: pwr13nj ($12.99 in chips) 
Seat 4: PlayTheBlues4U ($10.56 in chips) 
Seat 5: erik51fun ($6.22 in chips) 
Seat 6: 123tiger711a ($10 in chips) 
PlayTheBlues4U: posts small blind $0.05
erik51fun: posts big blind $0.10
*** HOLE CARDS ***
Dealt to PlayTheBlues4U [Kc 7s]
123tiger711a: folds 
NoseyNoodle: folds 
clovvnfiesta: folds 
pwr13nj: folds 
PlayTheBlues4U: calls $0.05
erik51fun: checks 
*** FLOP *** [6c Ts Th]
PlayTheBlues4U: checks 
erik51fun: checks 
*** TURN *** [6c Ts Th] [5c]
PlayTheBlues4U: checks 
erik51fun: checks 
*** RIVER *** [6c Ts Th 5c] [Qs]
PlayTheBlues4U: checks 
erik51fun: checks 
*** SHOW DOWN ***
PlayTheBlues4U: shows [Kc 7s] (a pair of Tens)
erik51fun: mucks hand 
PlayTheBlues4U collected $0.19 from pot
*** SUMMARY ***
Total pot $0.20 | Rake $0.01 
Board [6c Ts Th 5c Qs]
Seat 1: NoseyNoodle folded before Flop (didn't bet)
Seat 2: clovvnfiesta folded before Flop (didn't bet)
Seat 3: pwr13nj (button) folded before Flop (didn't bet)
Seat 4: PlayTheBlues4U (small blind) showed [Kc 7s] and won ($0.19) with a pair of Tens
Seat 5: erik51fun (big blind) mucked [3d 9c]
Seat 6: 123tiger711a folded before Flop (didn't bet)



PokerStars Hand #205010169040:  Hold'em No Limit ($0.05/$0.10 USD) - 2019/10/24 21:42:39 ET
Table 'Delphinus' 6-max Seat #4 is the button
Seat 1: NoseyNoodle ($4.66 in chips) 
Seat 2: clovvnfiesta ($4.36 in chips) 
Seat 3: pwr13nj ($12.99 in chips) 
Seat 4: PlayTheBlues4U ($10.65 in chips) 
Seat 5: erik51fun ($6.12 in chips) 
Seat 6: 123tiger711a ($10 in chips) 
erik51fun: posts small blind $0.05
123tiger711a: posts big blind $0.10
*** HOLE CARDS ***
Dealt to PlayTheBlues4U [6h 6s]
NoseyNoodle: folds 
clovvnfiesta: folds 
pwr13nj: folds 
PlayTheBlues4U: raises $0.20 to $0.30
erik51fun: folds 
123tiger711a: folds 
Uncalled bet ($0.20) returned to PlayTheBlues4U
PlayTheBlues4U collected $0.25 from pot
PlayTheBlues4U: doesn't show hand 
*** SUMMARY ***
Total pot $0.25 | Rake $0 
Seat 1: NoseyNoodle folded before Flop (didn't bet)
Seat 2: clovvnfiesta folded before Flop (didn't bet)
Seat 3: pwr13nj folded before Flop (didn't bet)
Seat 4: PlayTheBlues4U (button) collected ($0.25)
Seat 5: erik51fun (small blind) folded before Flop
Seat 6: 123tiger711a (big blind) folded before Flop



PokerStars Hand #205010169115:  Hold'em No Limit ($0.05/$0.10 USD) - 2019/10/24 21:42:58 ET
Table 'Delphinus' 6-max Seat #5 is the button
Seat 1: NoseyNoodle ($4.66 in chips) 
Seat 2: clovvnfiesta ($4.36 in chips) 
Seat 3: pwr13nj ($12.99 in chips) 
Seat 4: PlayTheBlues4U ($10.80 in chips) 
Seat 5: erik51fun ($6.07 in chips) 
Seat 6: 123tiger711a ($10 in chips) 
123tiger711a: posts small blind $0.05
NoseyNoodle: posts big blind $0.10
*** HOLE CARDS ***
Dealt to PlayTheBlues4U [Ts 9s]
clovvnfiesta: folds 
pwr13nj: raises $0.20 to $0.30
PlayTheBlues4U: calls $0.30
erik51fun: folds 
123tiger711a: calls $0.25
NoseyNoodle: calls $0.20
*** FLOP *** [2h 5c 3h]
123tiger711a: checks 
NoseyNoodle: checks 
pwr13nj: checks 
PlayTheBlues4U: bets $0.60
123tiger711a: folds 
NoseyNoodle: calls $0.60
pwr13nj: folds 
*** TURN *** [2h 5c 3h] [6c]
NoseyNoodle: checks 
PlayTheBlues4U: checks 
*** RIVER *** [2h 5c 3h 6c] [7s]
NoseyNoodle: bets $0.90
PlayTheBlues4U: folds 
Uncalled bet ($0.90) returned to NoseyNoodle
NoseyNoodle collected $2.28 from pot
NoseyNoodle: doesn't show hand 
*** SUMMARY ***
Total pot $2.40 | Rake $0.12 
Board [2h 5c 3h 6c 7s]
Seat 1: NoseyNoodle (big blind) collected ($2.28)
Seat 2: clovvnfiesta folded before Flop (didn't bet)
Seat 3: pwr13nj folded on the Flop
Seat 4: PlayTheBlues4U folded on the River
Seat 5: erik51fun (button) folded before Flop (didn't bet)
Seat 6: 123tiger711a (small blind) folded on the Flop



PokerStars Hand #205010169471:  Hold'em No Limit ($0.05/$0.10 USD) - 2019/10/24 21:44:26 ET
Table 'Delphinus' 6-max Seat #6 is the button
Seat 1: NoseyNoodle ($6.04 in chips) 
Seat 2: clovvnfiesta ($4.36 in chips) 
Seat 3: pwr13nj ($12.69 in chips) 
Seat 4: PlayTheBlues4U ($9.90 in chips) 
Seat 5: erik51fun ($6.07 in chips) 
Seat 6: 123tiger711a ($10 in chips) 
NoseyNoodle: posts small blind $0.05
clovvnfiesta: posts big blind $0.10
*** HOLE CARDS ***
Dealt to PlayTheBlues4U [8c 3h]
pwr13nj: raises $0.20 to $0.30
PlayTheBlues4U: folds 
erik51fun: folds 
123tiger711a: calls $0.30
NoseyNoodle: folds 
clovvnfiesta: folds 
*** FLOP *** [Ah Ts 2d]
pwr13nj: bets $0.40
123tiger711a: calls $0.40
*** TURN *** [Ah Ts 2d] [9c]
pwr13nj: bets $0.70
123tiger711a: folds 
Uncalled bet ($0.70) returned to pwr13nj
pwr13nj collected $1.47 from pot
pwr13nj: doesn't show hand 
*** SUMMARY ***
Total pot $1.55 | Rake $0.08 
Board [Ah Ts 2d 9c]
Seat 1: NoseyNoodle (small blind) folded before Flop
Seat 2: clovvnfiesta (big blind) folded before Flop
Seat 3: pwr13nj collected ($1.47)
Seat 4: PlayTheBlues4U folded before Flop (didn't bet)
Seat 5: erik51fun folded before Flop (didn't bet)
Seat 6: 123tiger711a (button) folded on the Turn



PokerStars Hand #205010169733:  Hold'em No Limit ($0.05/$0.10 USD) - 2019/10/24 21:45:30 ET
Table 'Delphinus' 6-max Seat #1 is the button
Seat 1: NoseyNoodle ($5.99 in chips) 
Seat 2: clovvnfiesta ($4.26 in chips) 
Seat 3: pwr13nj ($13.46 in chips) 
Seat 4: PlayTheBlues4U ($9.90 in chips) 
Seat 5: erik51fun ($6.07 in chips) 
Seat 6: 123tiger711a ($10 in chips) 
clovvnfiesta: posts small blind $0.05
pwr13nj: posts big blind $0.10
*** HOLE CARDS ***
Dealt to PlayTheBlues4U [3c Ac]
PlayTheBlues4U: folds 
erik51fun: folds 
123tiger711a: folds 
NoseyNoodle: calls $0.10
clovvnfiesta: folds 
pwr13nj: checks 
*** FLOP *** [2d Td 6c]
pwr13nj: checks 
NoseyNoodle: bets $0.30
pwr13nj: folds 
Uncalled bet ($0.30) returned to NoseyNoodle
NoseyNoodle collected $0.24 from pot
NoseyNoodle: doesn't show hand 
*** SUMMARY ***
Total pot $0.25 | Rake $0.01 
Board [2d Td 6c]
Seat 1: NoseyNoodle (button) collected ($0.24)
Seat 2: clovvnfiesta (small blind) folded before Flop
Seat 3: pwr13nj (big blind) folded on the Flop
Seat 4: PlayTheBlues4U folded before Flop (didn't bet)
Seat 5: erik51fun folded before Flop (didn't bet)
Seat 6: 123tiger711a folded before Flop (didn't bet)



PokerStars Hand #205010169922:  Hold'em No Limit ($0.05/$0.10 USD) - 2019/10/24 21:46:14 ET
Table 'Delphinus' 6-max Seat #2 is the button
Seat 1: NoseyNoodle ($6.13 in chips) 
Seat 2: clovvnfiesta ($4.21 in chips) 
Seat 3: pwr13nj ($13.36 in chips) 
Seat 4: PlayTheBlues4U ($9.90 in chips) 
Seat 5: erik51fun ($6.07 in chips) 
Seat 6: 123tiger711a ($10 in chips) 
pwr13nj: posts small blind $0.05
PlayTheBlues4U: posts big blind $0.10
*** HOLE CARDS ***
Dealt to PlayTheBlues4U [Th 2h]
erik51fun: calls $0.10
123tiger711a: calls $0.10
NoseyNoodle: folds 
clovvnfiesta: calls $0.10
pwr13nj: calls $0.05
PlayTheBlues4U: checks 
*** FLOP *** [Qc 4c 6d]
pwr13nj: checks 
PlayTheBlues4U: checks 
erik51fun: bets $0.30
123tiger711a: folds 
clovvnfiesta: folds 
pwr13nj: folds 
PlayTheBlues4U: folds 
Uncalled bet ($0.30) returned to erik51fun
erik51fun collected $0.48 from pot
erik51fun: doesn't show hand 
*** SUMMARY ***
Total pot $0.50 | Rake $0.02 
Board [Qc 4c 6d]
Seat 1: NoseyNoodle folded before Flop (didn't bet)
Seat 2: clovvnfiesta (button) folded on the Flop
Seat 3: pwr13nj (small blind) folded on the Flop
Seat 4: PlayTheBlues4U (big blind) folded on the Flop
Seat 5: erik51fun collected ($0.48)
Seat 6: 123tiger711a folded on the Flop



PokerStars Hand #205010977475:  Hold'em No Limit ($0.05/$0.10 USD) - 2019/10/24 21:47:16 ET
Table 'Delphinus' 6-max Seat #3 is the button
Seat 1: NoseyNoodle ($6.13 in chips) 
Seat 2: clovvnfiesta ($4.11 in chips) 
Seat 3: pwr13nj ($13.26 in chips) 
Seat 4: PlayTheBlues4U ($9.80 in chips) 
Seat 5: erik51fun ($6.45 in chips) 
Seat 6: 123tiger711a ($10 in chips) 
PlayTheBlues4U: posts small blind $0.05
erik51fun: posts big blind $0.10
*** HOLE CARDS ***
Dealt to PlayTheBlues4U [2d 6c]
123tiger711a: calls $0.10
NoseyNoodle: calls $0.10
clovvnfiesta: calls $0.10
pwr13nj: folds 
PlayTheBlues4U: folds 
erik51fun: checks 
*** FLOP *** [7s 8d Js]
erik51fun: checks 
123tiger711a: bets $0.43
NoseyNoodle: folds 
clovvnfiesta: folds 
erik51fun: folds 
Uncalled bet ($0.43) returned to 123tiger711a
123tiger711a collected $0.43 from pot
*** SUMMARY ***
Total pot $0.45 | Rake $0.02 
Board [7s 8d Js]
Seat 1: NoseyNoodle folded on the Flop
Seat 2: clovvnfiesta folded on the Flop
Seat 3: pwr13nj (button) folded before Flop (didn't bet)
Seat 4: PlayTheBlues4U (small blind) folded before Flop
Seat 5: erik51fun (big blind) folded on the Flop
Seat 6: 123tiger711a collected ($0.43)



PokerStars Hand #205010977693:  Hold'em No Limit ($0.05/$0.10 USD) - 2019/10/24 21:48:10 ET
Table 'Delphinus' 6-max Seat #4 is the button
Seat 1: NoseyNoodle ($6.03 in chips) 
Seat 2: clovvnfiesta ($4.01 in chips) 
Seat 3: pwr13nj ($13.26 in chips) 
Seat 4: PlayTheBlues4U ($9.75 in chips) 
Seat 5: erik51fun ($6.35 in chips) 
Seat 6: 123tiger711a ($10.33 in chips) 
erik51fun: posts small blind $0.05
123tiger711a: posts big blind $0.10
*** HOLE CARDS ***
Dealt to PlayTheBlues4U [4h Jd]
NoseyNoodle: folds 
clovvnfiesta: raises $0.10 to $0.20
pwr13nj: calls $0.20
PlayTheBlues4U: folds 
erik51fun: folds 
123tiger711a: calls $0.10
*** FLOP *** [3s 3d 8s]
123tiger711a: checks 
clovvnfiesta: checks 
pwr13nj: bets $0.60
123tiger711a: folds 
clovvnfiesta: folds 
Uncalled bet ($0.60) returned to pwr13nj
pwr13nj collected $0.62 from pot
pwr13nj: doesn't show hand 
*** SUMMARY ***
Total pot $0.65 | Rake $0.03 
Board [3s 3d 8s]
Seat 1: NoseyNoodle folded before Flop (didn't bet)
Seat 2: clovvnfiesta folded on the Flop
Seat 3: pwr13nj collected ($0.62)
Seat 4: PlayTheBlues4U (button) folded before Flop (didn't bet)
Seat 5: erik51fun (small blind) folded before Flop
Seat 6: 123tiger711a (big blind) folded on the Flop



PokerStars Hand #205010977955:  Hold'em No Limit ($0.05/$0.10 USD) - 2019/10/24 21:49:15 ET
Table 'Delphinus' 6-max Seat #5 is the button
Seat 1: NoseyNoodle ($6.03 in chips) 
Seat 2: clovvnfiesta ($3.81 in chips) 
Seat 3: pwr13nj ($13.68 in chips) 
Seat 4: PlayTheBlues4U ($9.75 in chips) 
Seat 5: erik51fun ($6.30 in chips) 
Seat 6: 123tiger711a ($10.13 in chips) 
123tiger711a: posts small blind $0.05
NoseyNoodle: posts big blind $0.10
*** HOLE CARDS ***
Dealt to PlayTheBlues4U [7c Ts]
clovvnfiesta: folds 
pwr13nj: folds 
PlayTheBlues4U: folds 
erik51fun: raises $0.30 to $0.40
123tiger711a: folds 
NoseyNoodle: folds 
Uncalled bet ($0.30) returned to erik51fun
erik51fun collected $0.25 from pot
erik51fun: doesn't show hand 
*** SUMMARY ***
Total pot $0.25 | Rake $0 
Seat 1: NoseyNoodle (big blind) folded before Flop
Seat 2: clovvnfiesta folded before Flop (didn't bet)
Seat 3: pwr13nj folded before Flop (didn't bet)
Seat 4: PlayTheBlues4U folded before Flop (didn't bet)
Seat 5: erik51fun (button) collected ($0.25)
Seat 6: 123tiger711a (small blind) folded before Flop



PokerStars Hand #205010978035:  Hold'em No Limit ($0.05/$0.10 USD) - 2019/10/24 21:49:37 ET
Table 'Delphinus' 6-max Seat #6 is the button
Seat 1: NoseyNoodle ($5.93 in chips) 
Seat 2: clovvnfiesta ($3.81 in chips) 
Seat 3: pwr13nj ($13.68 in chips) 
Seat 4: PlayTheBlues4U ($9.75 in chips) 
Seat 5: erik51fun ($6.45 in chips) 
Seat 6: 123tiger711a ($10.08 in chips) 
NoseyNoodle: posts small blind $0.05
clovvnfiesta: posts big blind $0.10
*** HOLE CARDS ***
Dealt to PlayTheBlues4U [Ad Kh]
pwr13nj: folds 
PlayTheBlues4U: raises $0.20 to $0.30
erik51fun: folds 
123tiger711a: calls $0.30
NoseyNoodle: folds 
clovvnfiesta: folds 
*** FLOP *** [2d 9d Jc]
PlayTheBlues4U: checks 
123tiger711a: checks 
*** TURN *** [2d 9d Jc] [Kd]
PlayTheBlues4U: bets $0.40
123tiger711a: folds 
Uncalled bet ($0.40) returned to PlayTheBlues4U
PlayTheBlues4U collected $0.71 from pot
PlayTheBlues4U: doesn't show hand 
*** SUMMARY ***
Total pot $0.75 | Rake $0.04 
Board [2d 9d Jc Kd]
Seat 1: NoseyNoodle (small blind) folded before Flop
Seat 2: clovvnfiesta (big blind) folded before Flop
Seat 3: pwr13nj folded before Flop (didn't bet)
Seat 4: PlayTheBlues4U collected ($0.71)
Seat 5: erik51fun folded before Flop (didn't bet)
Seat 6: 123tiger711a (button) folded on the Turn



PokerStars Hand #205010978310:  Hold'em No Limit ($0.05/$0.10 USD) - 2019/10/24 21:50:53 ET
Table 'Delphinus' 6-max Seat #1 is the button
Seat 1: NoseyNoodle ($5.88 in chips) 
Seat 2: clovvnfiesta ($3.71 in chips) 
Seat 3: pwr13nj ($13.68 in chips) 
Seat 4: PlayTheBlues4U ($10.16 in chips) 
Seat 5: erik51fun ($6.45 in chips) 
Seat 6: 123tiger711a ($10 in chips) 
clovvnfiesta: posts small blind $0.05
pwr13nj: posts big blind $0.10
*** HOLE CARDS ***
Dealt to PlayTheBlues4U [Tc Kh]
PlayTheBlues4U: folds 
erik51fun: calls $0.10
123tiger711a: calls $0.10
NoseyNoodle: raises $0.20 to $0.30
clovvnfiesta: folds 
pwr13nj: folds 
erik51fun: folds 
123tiger711a: calls $0.20
*** FLOP *** [Qd Ac Kd]
123tiger711a: checks 
NoseyNoodle: bets $0.80
123tiger711a: folds 
Uncalled bet ($0.80) returned to NoseyNoodle
NoseyNoodle collected $0.81 from pot
NoseyNoodle: doesn't show hand 
*** SUMMARY ***
Total pot $0.85 | Rake $0.04 
Board [Qd Ac Kd]
Seat 1: NoseyNoodle (button) collected ($0.81)
Seat 2: clovvnfiesta (small blind) folded before Flop
Seat 3: pwr13nj (big blind) folded before Flop
Seat 4: PlayTheBlues4U folded before Flop (didn't bet)
Seat 5: erik51fun folded before Flop
Seat 6: 123tiger711a folded on the Flop



PokerStars Hand #205010978524:  Hold'em No Limit ($0.05/$0.10 USD) - 2019/10/24 21:51:46 ET
Table 'Delphinus' 6-max Seat #2 is the button
Seat 1: NoseyNoodle ($6.39 in chips) 
Seat 2: clovvnfiesta ($3.66 in chips) 
Seat 3: pwr13nj ($13.58 in chips) 
Seat 4: PlayTheBlues4U ($10.16 in chips) 
Seat 5: erik51fun ($6.35 in chips) 
Seat 6: 123tiger711a ($10 in chips) 
pwr13nj: posts small blind $0.05
PlayTheBlues4U: posts big blind $0.10
*** HOLE CARDS ***
Dealt to PlayTheBlues4U [8h Tc]
erik51fun: folds 
123tiger711a: folds 
NoseyNoodle: calls $0.10
clovvnfiesta: folds 
pwr13nj: raises $0.50 to $0.60
PlayTheBlues4U: folds 
NoseyNoodle: folds 
Uncalled bet ($0.50) returned to pwr13nj
pwr13nj collected $0.30 from pot
pwr13nj: doesn't show hand 
*** SUMMARY ***
Total pot $0.30 | Rake $0 
Seat 1: NoseyNoodle folded before Flop
Seat 2: clovvnfiesta (button) folded before Flop (didn't bet)
Seat 3: pwr13nj (small blind) collected ($0.30)
Seat 4: PlayTheBlues4U (big blind) folded before Flop
Seat 5: erik51fun folded before Flop (didn't bet)
Seat 6: 123tiger711a folded before Flop (didn't bet)



PokerStars Hand #205010978651:  Hold'em No Limit ($0.05/$0.10 USD) - 2019/10/24 21:52:19 ET
Table 'Delphinus' 6-max Seat #3 is the button
Seat 1: NoseyNoodle ($6.29 in chips) 
Seat 2: clovvnfiesta ($3.66 in chips) 
Seat 3: pwr13nj ($13.78 in chips) 
Seat 4: PlayTheBlues4U ($10.06 in chips) 
Seat 5: erik51fun ($6.35 in chips) 
Seat 6: 123tiger711a ($10 in chips) 
PlayTheBlues4U: posts small blind $0.05
erik51fun: posts big blind $0.10
*** HOLE CARDS ***
Dealt to PlayTheBlues4U [Qh Qd]
123tiger711a: folds 
NoseyNoodle: calls $0.10
clovvnfiesta: folds 
pwr13nj: folds 
PlayTheBlues4U: raises $0.30 to $0.40
erik51fun: folds 
NoseyNoodle: calls $0.30
*** FLOP *** [Ah 4h Kd]
PlayTheBlues4U: checks 
NoseyNoodle: bets $0.40
PlayTheBlues4U: folds 
Uncalled bet ($0.40) returned to NoseyNoodle
NoseyNoodle collected $0.86 from pot
NoseyNoodle: doesn't show hand 
*** SUMMARY ***
Total pot $0.90 | Rake $0.04 
Board [Ah 4h Kd]
Seat 1: NoseyNoodle collected ($0.86)
Seat 2: clovvnfiesta folded before Flop (didn't bet)
Seat 3: pwr13nj (button) folded before Flop (didn't bet)
Seat 4: PlayTheBlues4U (small blind) folded on the Flop
Seat 5: erik51fun (big blind) folded before Flop
Seat 6: 123tiger711a folded before Flop (didn't bet)



PokerStars Hand #205010978862:  Hold'em No Limit ($0.05/$0.10 USD) - 2019/10/24 21:53:08 ET
Table 'Delphinus' 6-max Seat #4 is the button
Seat 1: NoseyNoodle ($6.75 in chips) 
Seat 2: clovvnfiesta ($3.66 in chips) 
Seat 3: pwr13nj ($13.78 in chips) 
Seat 4: PlayTheBlues4U ($9.66 in chips) 
Seat 5: erik51fun ($6.25 in chips) 
Seat 6: 123tiger711a ($10 in chips) 
erik51fun: posts small blind $0.05
123tiger711a: posts big blind $0.10
*** HOLE CARDS ***
Dealt to PlayTheBlues4U [6s Jd]
NoseyNoodle: calls $0.10
clovvnfiesta: folds 
pwr13nj: folds 
PlayTheBlues4U: folds 
erik51fun: calls $0.05
123tiger711a: checks 
*** FLOP *** [8s 7c 7h]
erik51fun: checks 
123tiger711a: checks 
NoseyNoodle: checks 
*** TURN *** [8s 7c 7h] [Ts]
erik51fun: checks 
123tiger711a: checks 
NoseyNoodle: bets $0.10
erik51fun: folds 
123tiger711a: calls $0.10
*** RIVER *** [8s 7c 7h Ts] [Kc]
123tiger711a: checks 
NoseyNoodle: checks 
*** SHOW DOWN ***
123tiger711a: shows [Ks Jc] (two pair, Kings and Sevens)
NoseyNoodle: mucks hand 
123tiger711a collected $0.48 from pot
*** SUMMARY ***
Total pot $0.50 | Rake $0.02 
Board [8s 7c 7h Ts Kc]
Seat 1: NoseyNoodle mucked [Ah 2d]
Seat 2: clovvnfiesta folded before Flop (didn't bet)
Seat 3: pwr13nj folded before Flop (didn't bet)
Seat 4: PlayTheBlues4U (button) folded before Flop (didn't bet)
Seat 5: erik51fun (small blind) folded on the Turn
Seat 6: 123tiger711a (big blind) showed [Ks Jc] and won ($0.48) with two pair, Kings and Sevens



PokerStars Hand #205010979083:  Hold'em No Limit ($0.05/$0.10 USD) - 2019/10/24 21:54:07 ET
Table 'Delphinus' 6-max Seat #5 is the button
Seat 1: NoseyNoodle ($6.55 in chips) 
Seat 2: clovvnfiesta ($3.66 in chips) 
Seat 3: pwr13nj ($13.78 in chips) 
Seat 4: PlayTheBlues4U ($9.66 in chips) 
Seat 5: erik51fun ($6.15 in chips) 
Seat 6: 123tiger711a ($10.28 in chips) 
123tiger711a: posts small blind $0.05
NoseyNoodle: posts big blind $0.10
*** HOLE CARDS ***
Dealt to PlayTheBlues4U [Js 8h]
clovvnfiesta: folds 
pwr13nj: folds 
PlayTheBlues4U: folds 
erik51fun: folds 
123tiger711a: calls $0.05
NoseyNoodle: raises $0.40 to $0.50
123tiger711a: folds 
Uncalled bet ($0.40) returned to NoseyNoodle
NoseyNoodle collected $0.20 from pot
NoseyNoodle: doesn't show hand 
*** SUMMARY ***
Total pot $0.20 | Rake $0 
Seat 1: NoseyNoodle (big blind) collected ($0.20)
Seat 2: clovvnfiesta folded before Flop (didn't bet)
Seat 3: pwr13nj folded before Flop (didn't bet)
Seat 4: PlayTheBlues4U folded before Flop (didn't bet)
Seat 5: erik51fun (button) folded before Flop (didn't bet)
Seat 6: 123tiger711a (small blind) folded before Flop



PokerStars Hand #205010979164:  Hold'em No Limit ($0.05/$0.10 USD) - 2019/10/24 21:54:28 ET
Table 'Delphinus' 6-max Seat #6 is the button
Seat 1: NoseyNoodle ($6.65 in chips) 
Seat 2: clovvnfiesta ($3.66 in chips) 
Seat 3: pwr13nj ($13.78 in chips) 
Seat 4: PlayTheBlues4U ($9.66 in chips) 
Seat 5: erik51fun ($6.15 in chips) 
Seat 6: 123tiger711a ($10.18 in chips) 
NoseyNoodle: posts small blind $0.05
clovvnfiesta: posts big blind $0.10
*** HOLE CARDS ***
Dealt to PlayTheBlues4U [9c 6h]
pwr13nj: folds 
PlayTheBlues4U has timed out
PlayTheBlues4U: folds 
erik51fun: calls $0.10
123tiger711a: folds 
NoseyNoodle: calls $0.05
clovvnfiesta: checks 
*** FLOP *** [Qh 8s Th]
NoseyNoodle: checks 
clovvnfiesta: bets $0.10
erik51fun: folds 
NoseyNoodle: calls $0.10
*** TURN *** [Qh 8s Th] [Jd]
NoseyNoodle: checks 
clovvnfiesta: bets $0.24
NoseyNoodle: folds 
Uncalled bet ($0.24) returned to clovvnfiesta
clovvnfiesta collected $0.48 from pot
clovvnfiesta: doesn't show hand 
*** SUMMARY ***
Total pot $0.50 | Rake $0.02 
Board [Qh 8s Th Jd]
Seat 1: NoseyNoodle (small blind) folded on the Turn
Seat 2: clovvnfiesta (big blind) collected ($0.48)
Seat 3: pwr13nj folded before Flop (didn't bet)
Seat 4: PlayTheBlues4U folded before Flop (didn't bet)
Seat 5: erik51fun folded on the Flop
Seat 6: 123tiger711a (button) folded before Flop (didn't bet)



PokerStars Hand #205010979447:  Hold'em No Limit ($0.05/$0.10 USD) - 2019/10/24 21:55:54 ET
Table 'Delphinus' 6-max Seat #1 is the button
Seat 1: NoseyNoodle ($6.45 in chips) 
Seat 2: clovvnfiesta ($3.94 in chips) 
Seat 3: pwr13nj ($13.78 in chips) 
Seat 4: PlayTheBlues4U ($9.66 in chips) 
Seat 5: erik51fun ($6.05 in chips) 
Seat 6: 123tiger711a ($10.18 in chips) 
clovvnfiesta: posts small blind $0.05
pwr13nj: posts big blind $0.10
*** HOLE CARDS ***
Dealt to PlayTheBlues4U [7h 4c]
PlayTheBlues4U: folds 
erik51fun: folds 
123tiger711a: folds 
123tiger711a leaves the table
NoseyNoodle: raises $0.30 to $0.40
ng2414 joins the table at seat #6 
clovvnfiesta: folds 
pwr13nj: folds 
Uncalled bet ($0.30) returned to NoseyNoodle
NoseyNoodle collected $0.25 from pot
NoseyNoodle: doesn't show hand 
*** SUMMARY ***
Total pot $0.25 | Rake $0 
Seat 1: NoseyNoodle (button) collected ($0.25)
Seat 2: clovvnfiesta (small blind) folded before Flop
Seat 3: pwr13nj (big blind) folded before Flop
Seat 4: PlayTheBlues4U folded before Flop (didn't bet)
Seat 5: erik51fun folded before Flop (didn't bet)
Seat 6: 123tiger711a folded before Flop (didn't bet)



PokerStars Hand #205008744139:  Hold'em No Limit ($0.05/$0.10 USD) - 2019/10/24 20:21:57 ET
Table 'Megrez' 6-max Seat #3 is the button
Seat 1: dmg3000 ($8.95 in chips) 
Seat 2: Envoy1006 ($9.91 in chips) 
Seat 3: ZTP0 ($15.06 in chips) 
Seat 5: 123tiger711a ($10.08 in chips) 
Seat 6: PlayTheBlues4U ($10 in chips) 
123tiger711a: posts small blind $0.05
PlayTheBlues4U: posts big blind $0.10
*** HOLE CARDS ***
Dealt to PlayTheBlues4U [2c 5h]
dmg3000: folds 
Envoy1006: raises $0.20 to $0.30
ZTP0: raises $0.60 to $0.90
123tiger711a: folds 
PlayTheBlues4U: folds 
Envoy1006: calls $0.60
*** FLOP *** [3d Jd Qs]
Envoy1006: bets $0.90
ZTP0: calls $0.90
*** TURN *** [3d Jd Qs] [Ad]
Envoy1006: bets $3.60
ZTP0: calls $3.60
*** RIVER *** [3d Jd Qs Ad] [Qh]
Envoy1006: bets $2.90
ZTP0: calls $2.90
*** SHOW DOWN ***
Envoy1006: shows [Ts Ks] (a straight, Ten to Ace)
ZTP0: mucks hand 
Envoy1006 collected $15.91 from pot
*** SUMMARY ***
Total pot $16.75 | Rake $0.84 
Board [3d Jd Qs Ad Qh]
Seat 1: dmg3000 folded before Flop (didn't bet)
Seat 2: Envoy1006 showed [Ts Ks] and won ($15.91) with a straight, Ten to Ace
Seat 3: ZTP0 (button) mucked [Kh As]
Seat 5: 123tiger711a (small blind) folded before Flop
Seat 6: PlayTheBlues4U (big blind) folded before Flop



PokerStars Hand #205008744305:  Hold'em No Limit ($0.05/$0.10 USD) - 2019/10/24 20:22:43 ET
Table 'Megrez' 6-max Seat #5 is the button
Seat 1: dmg3000 ($8.95 in chips) 
Seat 2: Envoy1006 ($17.52 in chips) 
Seat 3: ZTP0 ($6.76 in chips) 
Seat 5: 123tiger711a ($10.03 in chips) 
Seat 6: PlayTheBlues4U ($9.90 in chips) 
PlayTheBlues4U: posts small blind $0.05
dmg3000: posts big blind $0.10
peteypete911: sits out 
*** HOLE CARDS ***
Dealt to PlayTheBlues4U [Td 2d]
Envoy1006: raises $0.10 to $0.20
ZTP0: folds 
ZTP0 leaves the table
123tiger711a: folds 
PlayTheBlues4U: folds 
dmg3000: raises $0.40 to $0.60
Envoy1006: calls $0.40
*** FLOP *** [8h 5c Jh]
dmg3000: bets $0.60
Envoy1006: raises $0.80 to $1.40
dmg3000: calls $0.80
*** TURN *** [8h 5c Jh] [3h]
dmg3000: checks 
Envoy1006: checks 
*** RIVER *** [8h 5c Jh 3h] [9s]
dmg3000: checks 
Envoy1006: bets $1.90
winbabywin7 joins the table at seat #3 
dmg3000: folds 
Uncalled bet ($1.90) returned to Envoy1006
Envoy1006 collected $3.85 from pot
Envoy1006: doesn't show hand 
*** SUMMARY ***
Total pot $4.05 | Rake $0.20 
Board [8h 5c Jh 3h 9s]
Seat 1: dmg3000 (big blind) folded on the River
Seat 2: Envoy1006 collected ($3.85)
Seat 3: ZTP0 folded before Flop (didn't bet)
Seat 5: 123tiger711a (button) folded before Flop (didn't bet)
Seat 6: PlayTheBlues4U (small blind) folded before Flop



PokerStars Hand #205008744479:  Hold'em No Limit ($0.05/$0.10 USD) - 2019/10/24 20:23:26 ET
Table 'Megrez' 6-max Seat #6 is the button
Seat 1: dmg3000 ($10 in chips) 
Seat 2: Envoy1006 ($19.37 in chips) 
Seat 3: winbabywin7 ($8 in chips) 
Seat 5: 123tiger711a ($10.03 in chips) 
Seat 6: PlayTheBlues4U ($9.85 in chips) 
dmg3000: posts small blind $0.05
Envoy1006: posts big blind $0.10
winbabywin7: posts big blind $0.10
peteypete911: sits out 
*** HOLE CARDS ***
Dealt to PlayTheBlues4U [4c Td]
winbabywin7: checks 
123tiger711a: folds 
PlayTheBlues4U: folds 
dmg3000: calls $0.05
Envoy1006: checks 
*** FLOP *** [3s 9d Tc]
dmg3000: checks 
Envoy1006: bets $0.10
winbabywin7: folds 
dmg3000: folds 
Uncalled bet ($0.10) returned to Envoy1006
Envoy1006 collected $0.28 from pot
Envoy1006: doesn't show hand 
*** SUMMARY ***
Total pot $0.30 | Rake $0.02 
Board [3s 9d Tc]
Seat 1: dmg3000 (small blind) folded on the Flop
Seat 2: Envoy1006 (big blind) collected ($0.28)
Seat 3: winbabywin7 folded on the Flop (didn't bet)
Seat 5: 123tiger711a folded before Flop (didn't bet)
Seat 6: PlayTheBlues4U (button) folded before Flop (didn't bet)



PokerStars Hand #205008744557:  Hold'em No Limit ($0.05/$0.10 USD) - 2019/10/24 20:23:50 ET
Table 'Megrez' 6-max Seat #1 is the button
Seat 1: dmg3000 ($9.90 in chips) 
Seat 2: Envoy1006 ($19.55 in chips) 
Seat 3: winbabywin7 ($7.90 in chips) 
Seat 5: 123tiger711a ($10.03 in chips) 
Seat 6: PlayTheBlues4U ($9.85 in chips) 
Envoy1006: posts small blind $0.05
winbabywin7: posts big blind $0.10
peteypete911: sits out 
*** HOLE CARDS ***
Dealt to PlayTheBlues4U [Qh As]
123tiger711a: calls $0.10
PlayTheBlues4U: raises $0.20 to $0.30
dmg3000: folds 
Envoy1006: folds 
winbabywin7: folds 
123tiger711a: calls $0.20
*** FLOP *** [Kh 9c 2s]
123tiger711a: checks 
PlayTheBlues4U: bets $0.40
123tiger711a: raises $1.51 to $1.91
PlayTheBlues4U: folds 
Uncalled bet ($1.51) returned to 123tiger711a
123tiger711a collected $1.47 from pot
*** SUMMARY ***
Total pot $1.55 | Rake $0.08 
Board [Kh 9c 2s]
Seat 1: dmg3000 (button) folded before Flop (didn't bet)
Seat 2: Envoy1006 (small blind) folded before Flop
Seat 3: winbabywin7 (big blind) folded before Flop
Seat 5: 123tiger711a collected ($1.47)
Seat 6: PlayTheBlues4U folded on the Flop



PokerStars Hand #205008744674:  Hold'em No Limit ($0.05/$0.10 USD) - 2019/10/24 20:24:24 ET
Table 'Megrez' 6-max Seat #2 is the button
Seat 1: dmg3000 ($9.90 in chips) 
Seat 2: Envoy1006 ($19.50 in chips) 
Seat 3: winbabywin7 ($7.80 in chips) 
Seat 4: peteypete911 ($8.15 in chips) 
Seat 5: 123tiger711a ($10.80 in chips) 
Seat 6: PlayTheBlues4U ($9.15 in chips) 
winbabywin7: posts small blind $0.05
peteypete911: posts big blind $0.10
*** HOLE CARDS ***
Dealt to PlayTheBlues4U [9s 9h]
123tiger711a: calls $0.10
PlayTheBlues4U: raises $0.20 to $0.30
dmg3000: folds 
Envoy1006: folds 
winbabywin7: folds 
peteypete911: calls $0.20
123tiger711a: calls $0.20
*** FLOP *** [Jc 8s 5h]
peteypete911: bets $0.20
123tiger711a: folds 
PlayTheBlues4U: calls $0.20
*** TURN *** [Jc 8s 5h] [2h]
peteypete911: bets $0.40
PlayTheBlues4U: folds 
Uncalled bet ($0.40) returned to peteypete911
peteypete911 collected $1.28 from pot
peteypete911: doesn't show hand 
*** SUMMARY ***
Total pot $1.35 | Rake $0.07 
Board [Jc 8s 5h 2h]
Seat 1: dmg3000 folded before Flop (didn't bet)
Seat 2: Envoy1006 (button) folded before Flop (didn't bet)
Seat 3: winbabywin7 (small blind) folded before Flop
Seat 4: peteypete911 (big blind) collected ($1.28)
Seat 5: 123tiger711a folded on the Flop
Seat 6: PlayTheBlues4U folded on the Turn



PokerStars Hand #205008744838:  Hold'em No Limit ($0.05/$0.10 USD) - 2019/10/24 20:25:05 ET
Table 'Megrez' 6-max Seat #3 is the button
Seat 1: dmg3000 ($9.90 in chips) 
Seat 2: Envoy1006 ($19.50 in chips) 
Seat 3: winbabywin7 ($7.75 in chips) 
Seat 4: peteypete911 ($8.93 in chips) 
Seat 5: 123tiger711a ($10.50 in chips) 
Seat 6: PlayTheBlues4U ($8.65 in chips) 
peteypete911: posts small blind $0.05
123tiger711a: posts big blind $0.10
*** HOLE CARDS ***
Dealt to PlayTheBlues4U [7s Qs]
PlayTheBlues4U: folds 
dmg3000: raises $0.10 to $0.20
Envoy1006: folds 
winbabywin7: folds 
peteypete911: folds 
123tiger711a: calls $0.10
*** FLOP *** [7c 9d Kh]
123tiger711a: checks 
dmg3000: checks 
*** TURN *** [7c 9d Kh] [6c]
123tiger711a: checks 
dmg3000: checks 
*** RIVER *** [7c 9d Kh 6c] [Kd]
123tiger711a: checks 
dmg3000: checks 
*** SHOW DOWN ***
123tiger711a: shows [Ah 8c] (a pair of Kings)
dmg3000: mucks hand 
123tiger711a collected $0.43 from pot
*** SUMMARY ***
Total pot $0.45 | Rake $0.02 
Board [7c 9d Kh 6c Kd]
Seat 1: dmg3000 mucked [Ac 5d]
Seat 2: Envoy1006 folded before Flop (didn't bet)
Seat 3: winbabywin7 (button) folded before Flop (didn't bet)
Seat 4: peteypete911 (small blind) folded before Flop
Seat 5: 123tiger711a (big blind) showed [Ah 8c] and won ($0.43) with a pair of Kings
Seat 6: PlayTheBlues4U folded before Flop (didn't bet)



PokerStars Hand #205008744975:  Hold'em No Limit ($0.05/$0.10 USD) - 2019/10/24 20:25:43 ET
Table 'Megrez' 6-max Seat #4 is the button
Seat 1: dmg3000 ($9.70 in chips) 
Seat 2: Envoy1006 ($19.50 in chips) 
Seat 3: winbabywin7 ($7.75 in chips) 
Seat 4: peteypete911 ($8.88 in chips) 
Seat 5: 123tiger711a ($10.73 in chips) 
Seat 6: PlayTheBlues4U ($8.65 in chips) 
123tiger711a: posts small blind $0.05
PlayTheBlues4U: posts big blind $0.10
*** HOLE CARDS ***
Dealt to PlayTheBlues4U [Jd 4c]
dmg3000: folds 
Envoy1006: folds 
winbabywin7: raises $0.20 to $0.30
peteypete911: calls $0.30
123tiger711a: folds 
PlayTheBlues4U: folds 
*** FLOP *** [Kh 6d 9h]
winbabywin7: checks 
peteypete911: bets $0.36
winbabywin7: calls $0.36
*** TURN *** [Kh 6d 9h] [8d]
winbabywin7: checks 
peteypete911: checks 
*** RIVER *** [Kh 6d 9h 8d] [7c]
winbabywin7: checks 
peteypete911: checks 
*** SHOW DOWN ***
winbabywin7: shows [3d 3s] (a pair of Threes)
peteypete911: shows [7h 8h] (two pair, Eights and Sevens)
peteypete911 collected $1.40 from pot
*** SUMMARY ***
Total pot $1.47 | Rake $0.07 
Board [Kh 6d 9h 8d 7c]
Seat 1: dmg3000 folded before Flop (didn't bet)
Seat 2: Envoy1006 folded before Flop (didn't bet)
Seat 3: winbabywin7 showed [3d 3s] and lost with a pair of Threes
Seat 4: peteypete911 (button) showed [7h 8h] and won ($1.40) with two pair, Eights and Sevens
Seat 5: 123tiger711a (small blind) folded before Flop
Seat 6: PlayTheBlues4U (big blind) folded before Flop



PokerStars Hand #205008745097:  Hold'em No Limit ($0.05/$0.10 USD) - 2019/10/24 20:26:18 ET
Table 'Megrez' 6-max Seat #5 is the button
Seat 1: dmg3000 ($9.70 in chips) 
Seat 2: Envoy1006 ($19.50 in chips) 
Seat 3: winbabywin7 ($7.09 in chips) 
Seat 4: peteypete911 ($9.62 in chips) 
Seat 5: 123tiger711a ($10.68 in chips) 
Seat 6: PlayTheBlues4U ($8.55 in chips) 
PlayTheBlues4U: posts small blind $0.05
dmg3000: posts big blind $0.10
*** HOLE CARDS ***
Dealt to PlayTheBlues4U [6s Kc]
Envoy1006: folds 
winbabywin7: calls $0.10
peteypete911: folds 
123tiger711a: calls $0.10
PlayTheBlues4U: folds 
dmg3000: checks 
*** FLOP *** [Th Kh Qd]
dmg3000: bets $0.20
winbabywin7: calls $0.20
123tiger711a: calls $0.20
*** TURN *** [Th Kh Qd] [Jh]
dmg3000: checks 
winbabywin7: checks 
123tiger711a: checks 
*** RIVER *** [Th Kh Qd Jh] [Qs]
dmg3000: bets $0.20
winbabywin7: folds 
123tiger711a: folds 
Uncalled bet ($0.20) returned to dmg3000
dmg3000 collected $0.90 from pot
*** SUMMARY ***
Total pot $0.95 | Rake $0.05 
Board [Th Kh Qd Jh Qs]
Seat 1: dmg3000 (big blind) collected ($0.90)
Seat 2: Envoy1006 folded before Flop (didn't bet)
Seat 3: winbabywin7 folded on the River
Seat 4: peteypete911 folded before Flop (didn't bet)
Seat 5: 123tiger711a (button) folded on the River
Seat 6: PlayTheBlues4U (small blind) folded before Flop



PokerStars Hand #205008745280:  Hold'em No Limit ($0.05/$0.10 USD) - 2019/10/24 20:27:06 ET
Table 'Megrez' 6-max Seat #6 is the button
Seat 1: dmg3000 ($10.30 in chips) 
Seat 2: Envoy1006 ($19.50 in chips) 
Seat 3: winbabywin7 ($6.79 in chips) 
Seat 4: peteypete911 ($9.62 in chips) 
Seat 5: 123tiger711a ($10.38 in chips) 
Seat 6: PlayTheBlues4U ($8.50 in chips) 
dmg3000: posts small blind $0.05
Envoy1006: posts big blind $0.10
*** HOLE CARDS ***
Dealt to PlayTheBlues4U [9c As]
winbabywin7: folds 
peteypete911: folds 
123tiger711a: calls $0.10
PlayTheBlues4U: raises $0.20 to $0.30
dmg3000: folds 
Envoy1006: folds 
123tiger711a: calls $0.20
*** FLOP *** [4s 9h 4c]
123tiger711a: checks 
PlayTheBlues4U: bets $0.40
123tiger711a: folds 
Uncalled bet ($0.40) returned to PlayTheBlues4U
PlayTheBlues4U collected $0.71 from pot
PlayTheBlues4U: doesn't show hand 
*** SUMMARY ***
Total pot $0.75 | Rake $0.04 
Board [4s 9h 4c]
Seat 1: dmg3000 (small blind) folded before Flop
Seat 2: Envoy1006 (big blind) folded before Flop
Seat 3: winbabywin7 folded before Flop (didn't bet)
Seat 4: peteypete911 folded before Flop (didn't bet)
Seat 5: 123tiger711a folded on the Flop
Seat 6: PlayTheBlues4U (button) collected ($0.71)



PokerStars Hand #205008745391:  Hold'em No Limit ($0.05/$0.10 USD) - 2019/10/24 20:27:35 ET
Table 'Megrez' 6-max Seat #1 is the button
Seat 1: dmg3000 ($10.25 in chips) 
Seat 2: Envoy1006 ($19.40 in chips) 
Seat 3: winbabywin7 ($6.79 in chips) 
Seat 4: peteypete911 ($9.62 in chips) 
Seat 5: 123tiger711a ($10.08 in chips) 
Seat 6: PlayTheBlues4U ($8.91 in chips) 
Envoy1006: posts small blind $0.05
winbabywin7: posts big blind $0.10
*** HOLE CARDS ***
Dealt to PlayTheBlues4U [Kc 6s]
peteypete911: calls $0.10
123tiger711a: folds 
PlayTheBlues4U: folds 
dmg3000: folds 
Envoy1006: calls $0.05
winbabywin7: checks 
*** FLOP *** [4s Jd 7d]
Envoy1006: checks 
winbabywin7: checks 
peteypete911: bets $0.28
Envoy1006: folds 
winbabywin7: calls $0.28
*** TURN *** [4s Jd 7d] [9c]
winbabywin7: checks 
peteypete911: bets $0.41
winbabywin7: folds 
Uncalled bet ($0.41) returned to peteypete911
peteypete911 collected $0.82 from pot
peteypete911: doesn't show hand 
*** SUMMARY ***
Total pot $0.86 | Rake $0.04 
Board [4s Jd 7d 9c]
Seat 1: dmg3000 (button) folded before Flop (didn't bet)
Seat 2: Envoy1006 (small blind) folded on the Flop
Seat 3: winbabywin7 (big blind) folded on the Turn
Seat 4: peteypete911 collected ($0.82)
Seat 5: 123tiger711a folded before Flop (didn't bet)
Seat 6: PlayTheBlues4U folded before Flop (didn't bet)



PokerStars Hand #205008745529:  Hold'em No Limit ($0.05/$0.10 USD) - 2019/10/24 20:28:09 ET
Table 'Megrez' 6-max Seat #2 is the button
Seat 1: dmg3000 ($10.25 in chips) 
Seat 2: Envoy1006 ($19.30 in chips) 
Seat 3: winbabywin7 ($6.41 in chips) 
Seat 4: peteypete911 ($10.06 in chips) 
Seat 5: 123tiger711a ($10.08 in chips) 
Seat 6: PlayTheBlues4U ($8.91 in chips) 
winbabywin7: posts small blind $0.05
peteypete911: posts big blind $0.10
*** HOLE CARDS ***
Dealt to PlayTheBlues4U [2c 7h]
123tiger711a: calls $0.10
PlayTheBlues4U: folds 
dmg3000: calls $0.10
Envoy1006: calls $0.10
winbabywin7: calls $0.05
peteypete911: checks 
*** FLOP *** [4h 9s 2h]
winbabywin7: checks 
peteypete911: checks 
123tiger711a: checks 
dmg3000: bets $0.24
Envoy1006: calls $0.24
winbabywin7: folds 
peteypete911: folds 
123tiger711a: folds 
*** TURN *** [4h 9s 2h] [Kd]
dmg3000: checks 
Envoy1006: bets $0.20
dmg3000: folds 
Uncalled bet ($0.20) returned to Envoy1006
Envoy1006 collected $0.93 from pot
Envoy1006: doesn't show hand 
*** SUMMARY ***
Total pot $0.98 | Rake $0.05 
Board [4h 9s 2h Kd]
Seat 1: dmg3000 folded on the Turn
Seat 2: Envoy1006 (button) collected ($0.93)
Seat 3: winbabywin7 (small blind) folded on the Flop
Seat 4: peteypete911 (big blind) folded on the Flop
Seat 5: 123tiger711a folded on the Flop
Seat 6: PlayTheBlues4U folded before Flop (didn't bet)



PokerStars Hand #205008745732:  Hold'em No Limit ($0.05/$0.10 USD) - 2019/10/24 20:28:59 ET
Table 'Megrez' 6-max Seat #3 is the button
Seat 1: dmg3000 ($9.91 in chips) 
Seat 2: Envoy1006 ($19.89 in chips) 
Seat 3: winbabywin7 ($6.31 in chips) 
Seat 4: peteypete911 ($9.96 in chips) 
Seat 5: 123tiger711a ($10 in chips) 
Seat 6: PlayTheBlues4U ($8.91 in chips) 
peteypete911: posts small blind $0.05
123tiger711a: posts big blind $0.10
*** HOLE CARDS ***
Dealt to PlayTheBlues4U [4c 5s]
PlayTheBlues4U: folds 
dmg3000: folds 
Envoy1006: calls $0.10
winbabywin7: folds 
peteypete911: folds 
123tiger711a: checks 
*** FLOP *** [Ac 5d Qd]
123tiger711a: checks 
Envoy1006: checks 
*** TURN *** [Ac 5d Qd] [7c]
123tiger711a: checks 
Envoy1006: checks 
*** RIVER *** [Ac 5d Qd 7c] [Js]
123tiger711a: checks 
Envoy1006: checks 
*** SHOW DOWN ***
123tiger711a: shows [8d Jd] (a pair of Jacks)
Envoy1006: mucks hand 
123tiger711a collected $0.24 from pot
*** SUMMARY ***
Total pot $0.25 | Rake $0.01 
Board [Ac 5d Qd 7c Js]
Seat 1: dmg3000 folded before Flop (didn't bet)
Seat 2: Envoy1006 mucked [4s 8s]
Seat 3: winbabywin7 (button) folded before Flop (didn't bet)
Seat 4: peteypete911 (small blind) folded before Flop
Seat 5: 123tiger711a (big blind) showed [8d Jd] and won ($0.24) with a pair of Jacks
Seat 6: PlayTheBlues4U folded before Flop (didn't bet)



PokerStars Hand #205008745889:  Hold'em No Limit ($0.05/$0.10 USD) - 2019/10/24 20:29:36 ET
Table 'Megrez' 6-max Seat #4 is the button
Seat 1: dmg3000 ($9.91 in chips) 
Seat 2: Envoy1006 ($19.79 in chips) 
Seat 3: winbabywin7 ($6.31 in chips) 
Seat 4: peteypete911 ($9.91 in chips) 
Seat 5: 123tiger711a ($10.14 in chips) 
Seat 6: PlayTheBlues4U ($8.91 in chips) 
123tiger711a: posts small blind $0.05
PlayTheBlues4U: posts big blind $0.10
*** HOLE CARDS ***
Dealt to PlayTheBlues4U [4c Kd]
dmg3000: raises $0.20 to $0.30
Envoy1006: folds 
winbabywin7: raises $1.15 to $1.45
peteypete911: folds 
123tiger711a: folds 
PlayTheBlues4U: folds 
dmg3000: folds 
Uncalled bet ($1.15) returned to winbabywin7
winbabywin7 collected $0.75 from pot
winbabywin7: doesn't show hand 
*** SUMMARY ***
Total pot $0.75 | Rake $0 
Seat 1: dmg3000 folded before Flop
Seat 2: Envoy1006 folded before Flop (didn't bet)
Seat 3: winbabywin7 collected ($0.75)
Seat 4: peteypete911 (button) folded before Flop (didn't bet)
Seat 5: 123tiger711a (small blind) folded before Flop
Seat 6: PlayTheBlues4U (big blind) folded before Flop



PokerStars Hand #205008746027:  Hold'em No Limit ($0.05/$0.10 USD) - 2019/10/24 20:30:08 ET
Table 'Megrez' 6-max Seat #5 is the button
Seat 1: dmg3000 ($9.61 in chips) 
Seat 2: Envoy1006 ($19.79 in chips) 
Seat 3: winbabywin7 ($6.76 in chips) 
Seat 4: peteypete911 ($9.91 in chips) 
Seat 5: 123tiger711a ($10.09 in chips) 
Seat 6: PlayTheBlues4U ($8.81 in chips) 
PlayTheBlues4U: posts small blind $0.05
dmg3000: posts big blind $0.10
*** HOLE CARDS ***
Dealt to PlayTheBlues4U [7d 2c]
Envoy1006: calls $0.10
winbabywin7: folds 
peteypete911: raises $0.30 to $0.40
123tiger711a: folds 
PlayTheBlues4U: folds 
dmg3000: folds 
Envoy1006: calls $0.30
*** FLOP *** [Ah Qs Tc]
Envoy1006: checks 
peteypete911: bets $0.50
Envoy1006: calls $0.50
*** TURN *** [Ah Qs Tc] [9s]
Envoy1006: checks 
peteypete911: checks 
*** RIVER *** [Ah Qs Tc 9s] [8s]
Envoy1006: bets $0.40
peteypete911: folds 
Uncalled bet ($0.40) returned to Envoy1006
Envoy1006 collected $1.85 from pot
Envoy1006: doesn't show hand 
*** SUMMARY ***
Total pot $1.95 | Rake $0.10 
Board [Ah Qs Tc 9s 8s]
Seat 1: dmg3000 (big blind) folded before Flop
Seat 2: Envoy1006 collected ($1.85)
Seat 3: winbabywin7 folded before Flop (didn't bet)
Seat 4: peteypete911 folded on the River
Seat 5: 123tiger711a (button) folded before Flop (didn't bet)
Seat 6: PlayTheBlues4U (small blind) folded before Flop



PokerStars Hand #205008746226:  Hold'em No Limit ($0.05/$0.10 USD) - 2019/10/24 20:30:54 ET
Table 'Megrez' 6-max Seat #6 is the button
Seat 1: dmg3000 ($9.51 in chips) 
Seat 2: Envoy1006 ($20.74 in chips) 
Seat 3: winbabywin7 ($6.76 in chips) 
Seat 4: peteypete911 ($9.01 in chips) 
Seat 5: 123tiger711a ($10.09 in chips) 
Seat 6: PlayTheBlues4U ($8.76 in chips) 
dmg3000: posts small blind $0.05
Envoy1006: posts big blind $0.10
*** HOLE CARDS ***
Dealt to PlayTheBlues4U [5d 9h]
winbabywin7: folds 
peteypete911: calls $0.10
123tiger711a: calls $0.10
PlayTheBlues4U: folds 
dmg3000: raises $0.10 to $0.20
Envoy1006: folds 
peteypete911: calls $0.10
123tiger711a: calls $0.10
*** FLOP *** [Qc Js Jc]
dmg3000: checks 
peteypete911: checks 
123tiger711a: bets $0.33
dmg3000: folds 
peteypete911: calls $0.33
*** TURN *** [Qc Js Jc] [6h]
peteypete911: checks 
123tiger711a: checks 
*** RIVER *** [Qc Js Jc 6h] [3c]
peteypete911: bets $0.20
123tiger711a: calls $0.20
*** SHOW DOWN ***
peteypete911: shows [Jd 8s] (three of a kind, Jacks)
123tiger711a: shows [Tc Kc] (a flush, King high)
123tiger711a collected $1.67 from pot
*** SUMMARY ***
Total pot $1.76 | Rake $0.09 
Board [Qc Js Jc 6h 3c]
Seat 1: dmg3000 (small blind) folded on the Flop
Seat 2: Envoy1006 (big blind) folded before Flop
Seat 3: winbabywin7 folded before Flop (didn't bet)
Seat 4: peteypete911 showed [Jd 8s] and lost with three of a kind, Jacks
Seat 5: 123tiger711a showed [Tc Kc] and won ($1.67) with a flush, King high
Seat 6: PlayTheBlues4U (button) folded before Flop (didn't bet)



PokerStars Hand #205008746502:  Hold'em No Limit ($0.05/$0.10 USD) - 2019/10/24 20:31:59 ET
Table 'Megrez' 6-max Seat #1 is the button
Seat 1: dmg3000 ($9.31 in chips) 
Seat 2: Envoy1006 ($20.64 in chips) 
Seat 3: winbabywin7 ($6.76 in chips) 
Seat 4: peteypete911 ($8.28 in chips) 
Seat 5: 123tiger711a ($11.03 in chips) 
Seat 6: PlayTheBlues4U ($8.76 in chips) 
Envoy1006: posts small blind $0.05
winbabywin7: posts big blind $0.10
*** HOLE CARDS ***
Dealt to PlayTheBlues4U [Jd 8s]
peteypete911: folds 
123tiger711a: folds 
PlayTheBlues4U: folds 
dmg3000: folds 
Envoy1006: calls $0.05
winbabywin7: checks 
*** FLOP *** [8d Kh 8h]
Envoy1006: checks 
winbabywin7: checks 
*** TURN *** [8d Kh 8h] [9s]
Envoy1006: bets $0.10
winbabywin7: folds 
Uncalled bet ($0.10) returned to Envoy1006
Envoy1006 collected $0.19 from pot
Envoy1006: doesn't show hand 
*** SUMMARY ***
Total pot $0.20 | Rake $0.01 
Board [8d Kh 8h 9s]
Seat 1: dmg3000 (button) folded before Flop (didn't bet)
Seat 2: Envoy1006 (small blind) collected ($0.19)
Seat 3: winbabywin7 (big blind) folded on the Turn
Seat 4: peteypete911 folded before Flop (didn't bet)
Seat 5: 123tiger711a folded before Flop (didn't bet)
Seat 6: PlayTheBlues4U folded before Flop (didn't bet)



PokerStars Hand #205008746681:  Hold'em No Limit ($0.05/$0.10 USD) - 2019/10/24 20:32:41 ET
Table 'Megrez' 6-max Seat #2 is the button
Seat 1: dmg3000 ($9.31 in chips) 
Seat 2: Envoy1006 ($20.73 in chips) 
Seat 3: winbabywin7 ($6.66 in chips) 
Seat 4: peteypete911 ($8.28 in chips) 
Seat 5: 123tiger711a ($11.03 in chips) 
Seat 6: PlayTheBlues4U ($8.76 in chips) 
winbabywin7: posts small blind $0.05
peteypete911: posts big blind $0.10
*** HOLE CARDS ***
Dealt to PlayTheBlues4U [9h 6h]
123tiger711a: folds 
PlayTheBlues4U: folds 
dmg3000: folds 
Envoy1006: raises $0.20 to $0.30
winbabywin7: folds 
peteypete911: calls $0.20
*** FLOP *** [3s Td 4h]
peteypete911: checks 
Envoy1006: checks 
*** TURN *** [3s Td 4h] [2c]
peteypete911: checks 
Envoy1006: checks 
*** RIVER *** [3s Td 4h 2c] [Th]
peteypete911: checks 
Envoy1006: checks 
*** SHOW DOWN ***
peteypete911: shows [Jc Kh] (a pair of Tens)
Envoy1006: shows [7c Ac] (a pair of Tens - Ace kicker)
Envoy1006 collected $0.62 from pot
*** SUMMARY ***
Total pot $0.65 | Rake $0.03 
Board [3s Td 4h 2c Th]
Seat 1: dmg3000 folded before Flop (didn't bet)
Seat 2: Envoy1006 (button) showed [7c Ac] and won ($0.62) with a pair of Tens
Seat 3: winbabywin7 (small blind) folded before Flop
Seat 4: peteypete911 (big blind) showed [Jc Kh] and lost with a pair of Tens
Seat 5: 123tiger711a folded before Flop (didn't bet)
Seat 6: PlayTheBlues4U folded before Flop (didn't bet)



PokerStars Hand #205008746829:  Hold'em No Limit ($0.05/$0.10 USD) - 2019/10/24 20:33:13 ET
Table 'Megrez' 6-max Seat #3 is the button
Seat 1: dmg3000 ($9.31 in chips) 
Seat 2: Envoy1006 ($21.05 in chips) 
Seat 3: winbabywin7 ($6.61 in chips) 
Seat 4: peteypete911 ($7.98 in chips) 
Seat 5: 123tiger711a ($11.03 in chips) 
Seat 6: PlayTheBlues4U ($8.76 in chips) 
peteypete911: posts small blind $0.05
123tiger711a: posts big blind $0.10
*** HOLE CARDS ***
Dealt to PlayTheBlues4U [Tc Td]
PlayTheBlues4U: raises $0.20 to $0.30
dmg3000: folds 
Envoy1006: folds 
winbabywin7: calls $0.30
peteypete911: folds 
123tiger711a: folds 
*** FLOP *** [Ts Ah 4h]
PlayTheBlues4U: bets $0.60
winbabywin7: raises $1.50 to $2.10
PlayTheBlues4U: raises $6.36 to $8.46 and is all-in
winbabywin7: calls $4.21 and is all-in
Uncalled bet ($2.15) returned to PlayTheBlues4U
*** TURN *** [Ts Ah 4h] [2c]
*** RIVER *** [Ts Ah 4h 2c] [Qs]
*** SHOW DOWN ***
PlayTheBlues4U: shows [Tc Td] (three of a kind, Tens)
winbabywin7: shows [9h Th] (a pair of Tens)
PlayTheBlues4U collected $12.70 from pot
*** SUMMARY ***
Total pot $13.37 | Rake $0.67 
Board [Ts Ah 4h 2c Qs]
Seat 1: dmg3000 folded before Flop (didn't bet)
Seat 2: Envoy1006 folded before Flop (didn't bet)
Seat 3: winbabywin7 (button) showed [9h Th] and lost with a pair of Tens
Seat 4: peteypete911 (small blind) folded before Flop
Seat 5: 123tiger711a (big blind) folded before Flop
Seat 6: PlayTheBlues4U showed [Tc Td] and won ($12.70) with three of a kind, Tens



PokerStars Hand #205008747084:  Hold'em No Limit ($0.05/$0.10 USD) - 2019/10/24 20:34:11 ET
Table 'Megrez' 6-max Seat #4 is the button
Seat 1: dmg3000 ($9.31 in chips) 
Seat 2: Envoy1006 ($21.05 in chips) 
Seat 4: peteypete911 ($7.93 in chips) 
Seat 5: 123tiger711a ($10.93 in chips) 
Seat 6: PlayTheBlues4U ($14.85 in chips) 
123tiger711a: posts small blind $0.05
PlayTheBlues4U: posts big blind $0.10
*** HOLE CARDS ***
Dealt to PlayTheBlues4U [4c 9c]
dmg3000: folds 
Envoy1006: folds 
peteypete911: calls $0.10
123tiger711a: calls $0.05
PlayTheBlues4U: checks 
*** FLOP *** [Jh Ad Jd]
123tiger711a: checks 
PlayTheBlues4U: checks 
peteypete911: bets $0.10
123tiger711a: folds 
PlayTheBlues4U: folds 
Uncalled bet ($0.10) returned to peteypete911
peteypete911 collected $0.28 from pot
peteypete911: doesn't show hand 
*** SUMMARY ***
Total pot $0.30 | Rake $0.02 
Board [Jh Ad Jd]
Seat 1: dmg3000 folded before Flop (didn't bet)
Seat 2: Envoy1006 folded before Flop (didn't bet)
Seat 4: peteypete911 (button) collected ($0.28)
Seat 5: 123tiger711a (small blind) folded on the Flop
Seat 6: PlayTheBlues4U (big blind) folded on the Flop



PokerStars Hand #205008747180:  Hold'em No Limit ($0.05/$0.10 USD) - 2019/10/24 20:34:30 ET
Table 'Megrez' 6-max Seat #5 is the button
Seat 1: dmg3000 ($9.31 in chips) 
Seat 2: Envoy1006 ($21.05 in chips) 
Seat 3: winbabywin7 ($8 in chips) 
Seat 4: peteypete911 ($8.11 in chips) 
Seat 5: 123tiger711a ($10.83 in chips) 
Seat 6: PlayTheBlues4U ($14.75 in chips) 
PlayTheBlues4U: posts small blind $0.05
dmg3000: posts big blind $0.10
*** HOLE CARDS ***
Dealt to PlayTheBlues4U [6s Th]
Envoy1006: raises $0.10 to $0.20
winbabywin7: calls $0.20
peteypete911: folds 
123tiger711a: calls $0.20
PlayTheBlues4U: folds 
dmg3000: raises $0.80 to $1
Envoy1006: calls $0.80
winbabywin7: folds 
123tiger711a: folds 
*** FLOP *** [Jc 6c 4h]
dmg3000: bets $1.17
Envoy1006: folds 
Uncalled bet ($1.17) returned to dmg3000
dmg3000 collected $2.33 from pot
*** SUMMARY ***
Total pot $2.45 | Rake $0.12 
Board [Jc 6c 4h]
Seat 1: dmg3000 (big blind) collected ($2.33)
Seat 2: Envoy1006 folded on the Flop
Seat 3: winbabywin7 folded before Flop
Seat 4: peteypete911 folded before Flop (didn't bet)
Seat 5: 123tiger711a (button) folded before Flop
Seat 6: PlayTheBlues4U (small blind) folded before Flop



PokerStars Hand #205008747358:  Hold'em No Limit ($0.05/$0.10 USD) - 2019/10/24 20:35:08 ET
Table 'Megrez' 6-max Seat #6 is the button
Seat 1: dmg3000 ($10.64 in chips) 
Seat 2: Envoy1006 ($20.05 in chips) 
Seat 3: winbabywin7 ($7.80 in chips) 
Seat 4: peteypete911 ($8.11 in chips) 
Seat 5: 123tiger711a ($10.63 in chips) 
Seat 6: PlayTheBlues4U ($14.70 in chips) 
dmg3000: posts small blind $0.05
Envoy1006: posts big blind $0.10
*** HOLE CARDS ***
Dealt to PlayTheBlues4U [Qs Th]
winbabywin7: raises $0.20 to $0.30
peteypete911: folds 
123tiger711a: folds 
PlayTheBlues4U: folds 
dmg3000: folds 
Envoy1006: folds 
Uncalled bet ($0.20) returned to winbabywin7
winbabywin7 collected $0.25 from pot
winbabywin7: doesn't show hand 
*** SUMMARY ***
Total pot $0.25 | Rake $0 
Seat 1: dmg3000 (small blind) folded before Flop
Seat 2: Envoy1006 (big blind) folded before Flop
Seat 3: winbabywin7 collected ($0.25)
Seat 4: peteypete911 folded before Flop (didn't bet)
Seat 5: 123tiger711a folded before Flop (didn't bet)
Seat 6: PlayTheBlues4U (button) folded before Flop (didn't bet)



PokerStars Hand #205008747444:  Hold'em No Limit ($0.05/$0.10 USD) - 2019/10/24 20:35:25 ET
Table 'Megrez' 6-max Seat #1 is the button
Seat 1: dmg3000 ($10.59 in chips) 
Seat 2: Envoy1006 ($19.95 in chips) 
Seat 3: winbabywin7 ($7.95 in chips) 
Seat 4: peteypete911 ($8.11 in chips) 
Seat 5: 123tiger711a ($10.63 in chips) 
Seat 6: PlayTheBlues4U ($14.70 in chips) 
Envoy1006: posts small blind $0.05
winbabywin7: posts big blind $0.10
*** HOLE CARDS ***
Dealt to PlayTheBlues4U [9h Qs]
peteypete911: calls $0.10
123tiger711a: folds 
PlayTheBlues4U: folds 
dmg3000: raises $0.35 to $0.45
Envoy1006: calls $0.40
winbabywin7: calls $0.35
peteypete911: folds 
*** FLOP *** [7s Js Th]
Envoy1006: checks 
winbabywin7: checks 
dmg3000: checks 
*** TURN *** [7s Js Th] [6s]
Envoy1006: bets $0.10
winbabywin7: calls $0.10
dmg3000: raises $0.60 to $0.70
Envoy1006: calls $0.60
winbabywin7: folds 
*** RIVER *** [7s Js Th 6s] [8s]
Envoy1006: checks 
dmg3000: checks 
*** SHOW DOWN ***
Envoy1006: shows [Ts Qh] (a flush, Jack high)
dmg3000: mucks hand 
Envoy1006 collected $2.80 from pot
*** SUMMARY ***
Total pot $2.95 | Rake $0.15 
Board [7s Js Th 6s 8s]
Seat 1: dmg3000 (button) mucked [9d 9s]
Seat 2: Envoy1006 (small blind) showed [Ts Qh] and won ($2.80) with a flush, Jack high
Seat 3: winbabywin7 (big blind) folded on the Turn
Seat 4: peteypete911 folded before Flop
Seat 5: 123tiger711a folded before Flop (didn't bet)
Seat 6: PlayTheBlues4U folded before Flop (didn't bet)



PokerStars Hand #205008747699:  Hold'em No Limit ($0.05/$0.10 USD) - 2019/10/24 20:36:22 ET
Table 'Megrez' 6-max Seat #2 is the button
Seat 1: dmg3000 ($9.44 in chips) 
Seat 2: Envoy1006 ($21.60 in chips) 
Seat 3: winbabywin7 ($7.40 in chips) 
Seat 4: peteypete911 ($8.01 in chips) 
Seat 5: 123tiger711a ($10.63 in chips) 
Seat 6: PlayTheBlues4U ($14.70 in chips) 
winbabywin7: posts small blind $0.05
peteypete911: posts big blind $0.10
*** HOLE CARDS ***
Dealt to PlayTheBlues4U [Js 6s]
123tiger711a: folds 
PlayTheBlues4U: folds 
dmg3000: raises $0.30 to $0.40
Envoy1006: calls $0.40
winbabywin7: folds 
peteypete911: folds 
*** FLOP *** [4c 5d 5s]
dmg3000: bets $0.45
Envoy1006: folds 
Uncalled bet ($0.45) returned to dmg3000
dmg3000 collected $0.90 from pot
*** SUMMARY ***
Total pot $0.95 | Rake $0.05 
Board [4c 5d 5s]
Seat 1: dmg3000 collected ($0.90)
Seat 2: Envoy1006 (button) folded on the Flop
Seat 3: winbabywin7 (small blind) folded before Flop
Seat 4: peteypete911 (big blind) folded before Flop
Seat 5: 123tiger711a folded before Flop (didn't bet)
Seat 6: PlayTheBlues4U folded before Flop (didn't bet)



PokerStars Hand #205008747917:  Hold'em No Limit ($0.05/$0.10 USD) - 2019/10/24 20:37:08 ET
Table 'Megrez' 6-max Seat #3 is the button
Seat 1: dmg3000 ($9.94 in chips) 
Seat 2: Envoy1006 ($21.20 in chips) 
Seat 3: winbabywin7 ($7.35 in chips) 
Seat 4: peteypete911 ($7.91 in chips) 
Seat 5: 123tiger711a ($10.63 in chips) 
Seat 6: PlayTheBlues4U ($14.70 in chips) 
peteypete911: posts small blind $0.05
123tiger711a: posts big blind $0.10
*** HOLE CARDS ***
Dealt to PlayTheBlues4U [3h 8h]
PlayTheBlues4U: folds 
dmg3000: calls $0.10
Envoy1006: folds 
winbabywin7: calls $0.10
peteypete911: calls $0.05
123tiger711a: checks 
*** FLOP *** [4d 2c Jc]
peteypete911: checks 
123tiger711a: checks 
dmg3000: checks 
winbabywin7: checks 
*** TURN *** [4d 2c Jc] [8d]
peteypete911: checks 
123tiger711a: checks 
dmg3000: checks 
winbabywin7: checks 
*** RIVER *** [4d 2c Jc 8d] [Ks]
peteypete911: checks 
123tiger711a: checks 
dmg3000: checks 
winbabywin7: checks 
*** SHOW DOWN ***
peteypete911: shows [5c Ad] (high card Ace)
123tiger711a: mucks hand 
dmg3000: shows [4s 5h] (a pair of Fours)
winbabywin7: mucks hand 
dmg3000 collected $0.38 from pot
*** SUMMARY ***
Total pot $0.40 | Rake $0.02 
Board [4d 2c Jc 8d Ks]
Seat 1: dmg3000 showed [4s 5h] and won ($0.38) with a pair of Fours
Seat 2: Envoy1006 folded before Flop (didn't bet)
Seat 3: winbabywin7 (button) mucked [Ac Qs]
Seat 4: peteypete911 (small blind) showed [5c Ad] and lost with high card Ace
Seat 5: 123tiger711a (big blind) mucked [Qh Td]
Seat 6: PlayTheBlues4U folded before Flop (didn't bet)



PokerStars Hand #205008748130:  Hold'em No Limit ($0.05/$0.10 USD) - 2019/10/24 20:37:57 ET
Table 'Megrez' 6-max Seat #4 is the button
Seat 1: dmg3000 ($10.22 in chips) 
Seat 2: Envoy1006 ($21.20 in chips) 
Seat 3: winbabywin7 ($7.25 in chips) 
Seat 4: peteypete911 ($7.81 in chips) 
Seat 5: 123tiger711a ($10.53 in chips) 
Seat 6: PlayTheBlues4U ($14.70 in chips) 
123tiger711a: posts small blind $0.05
PlayTheBlues4U: posts big blind $0.10
*** HOLE CARDS ***
Dealt to PlayTheBlues4U [7h 3c]
dmg3000: raises $0.25 to $0.35
Envoy1006: folds 
winbabywin7: folds 
peteypete911: folds 
123tiger711a: folds 
PlayTheBlues4U: folds 
Uncalled bet ($0.25) returned to dmg3000
dmg3000 collected $0.25 from pot
*** SUMMARY ***
Total pot $0.25 | Rake $0 
Seat 1: dmg3000 collected ($0.25)
Seat 2: Envoy1006 folded before Flop (didn't bet)
Seat 3: winbabywin7 folded before Flop (didn't bet)
Seat 4: peteypete911 (button) folded before Flop (didn't bet)
Seat 5: 123tiger711a (small blind) folded before Flop
Seat 6: PlayTheBlues4U (big blind) folded before Flop



PokerStars Hand #205008748218:  Hold'em No Limit ($0.05/$0.10 USD) - 2019/10/24 20:38:18 ET
Table 'Megrez' 6-max Seat #5 is the button
Seat 1: dmg3000 ($10.37 in chips) 
Seat 2: Envoy1006 ($21.20 in chips) 
Seat 3: winbabywin7 ($7.25 in chips) 
Seat 4: peteypete911 ($7.81 in chips) 
Seat 5: 123tiger711a ($10.48 in chips) 
Seat 6: PlayTheBlues4U ($14.60 in chips) 
PlayTheBlues4U: posts small blind $0.05
dmg3000: posts big blind $0.10
*** HOLE CARDS ***
Dealt to PlayTheBlues4U [5d Td]
Envoy1006: folds 
winbabywin7: folds 
peteypete911: folds 
123tiger711a: folds 
PlayTheBlues4U: raises $0.20 to $0.30
dmg3000: raises $10.07 to $10.37 and is all-in
PlayTheBlues4U: folds 
Uncalled bet ($10.07) returned to dmg3000
dmg3000 collected $0.60 from pot
*** SUMMARY ***
Total pot $0.60 | Rake $0 
Seat 1: dmg3000 (big blind) collected ($0.60)
Seat 2: Envoy1006 folded before Flop (didn't bet)
Seat 3: winbabywin7 folded before Flop (didn't bet)
Seat 4: peteypete911 folded before Flop (didn't bet)
Seat 5: 123tiger711a (button) folded before Flop (didn't bet)
Seat 6: PlayTheBlues4U (small blind) folded before Flop



PokerStars Hand #205008748356:  Hold'em No Limit ($0.05/$0.10 USD) - 2019/10/24 20:38:48 ET
Table 'Megrez' 6-max Seat #6 is the button
Seat 1: dmg3000 ($10.67 in chips) 
Seat 2: Envoy1006 ($21.20 in chips) 
Seat 3: winbabywin7 ($7.25 in chips) 
Seat 4: peteypete911 ($7.81 in chips) 
Seat 5: 123tiger711a ($10.48 in chips) 
Seat 6: PlayTheBlues4U ($14.30 in chips) 
dmg3000: posts small blind $0.05
Envoy1006: posts big blind $0.10
*** HOLE CARDS ***
Dealt to PlayTheBlues4U [Kc 8d]
winbabywin7: folds 
peteypete911: folds 
123tiger711a: raises $0.50 to $0.60
PlayTheBlues4U: folds 
dmg3000: folds 
Envoy1006: folds 
Uncalled bet ($0.50) returned to 123tiger711a
123tiger711a collected $0.25 from pot
*** SUMMARY ***
Total pot $0.25 | Rake $0 
Seat 1: dmg3000 (small blind) folded before Flop
Seat 2: Envoy1006 (big blind) folded before Flop
Seat 3: winbabywin7 folded before Flop (didn't bet)
Seat 4: peteypete911 folded before Flop (didn't bet)
Seat 5: 123tiger711a collected ($0.25)
Seat 6: PlayTheBlues4U (button) folded before Flop (didn't bet)



PokerStars Hand #205008748426:  Hold'em No Limit ($0.05/$0.10 USD) - 2019/10/24 20:39:05 ET
Table 'Megrez' 6-max Seat #1 is the button
Seat 1: dmg3000 ($10.62 in chips) 
Seat 2: Envoy1006 ($21.10 in chips) 
Seat 3: winbabywin7 ($7.25 in chips) 
Seat 4: peteypete911 ($7.81 in chips) 
Seat 5: 123tiger711a ($10.63 in chips) 
Seat 6: PlayTheBlues4U ($14.30 in chips) 
Envoy1006: posts small blind $0.05
winbabywin7: posts big blind $0.10
*** HOLE CARDS ***
Dealt to PlayTheBlues4U [3d Qs]
peteypete911: raises $0.10 to $0.20
123tiger711a: folds 
PlayTheBlues4U: folds 
dmg3000: raises $0.50 to $0.70
Envoy1006: calls $0.65
winbabywin7: folds 
peteypete911: calls $0.50
*** FLOP *** [Js 4c 3h]
Envoy1006: bets $0.30
peteypete911: folds 
dmg3000: raises $0.70 to $1
Envoy1006: calls $0.70
*** TURN *** [Js 4c 3h] [7h]
Envoy1006: checks 
dmg3000: checks 
*** RIVER *** [Js 4c 3h 7h] [4h]
Envoy1006: bets $1
dmg3000: calls $1
*** SHOW DOWN ***
Envoy1006: shows [Kh Qc] (a pair of Fours)
dmg3000: shows [Ts Th] (two pair, Tens and Fours)
dmg3000 collected $5.89 from pot
*** SUMMARY ***
Total pot $6.20 | Rake $0.31 
Board [Js 4c 3h 7h 4h]
Seat 1: dmg3000 (button) showed [Ts Th] and won ($5.89) with two pair, Tens and Fours
Seat 2: Envoy1006 (small blind) showed [Kh Qc] and lost with a pair of Fours
Seat 3: winbabywin7 (big blind) folded before Flop
Seat 4: peteypete911 folded on the Flop
Seat 5: 123tiger711a folded before Flop (didn't bet)
Seat 6: PlayTheBlues4U folded before Flop (didn't bet)



PokerStars Hand #205008748695:  Hold'em No Limit ($0.05/$0.10 USD) - 2019/10/24 20:40:06 ET
Table 'Megrez' 6-max Seat #2 is the button
Seat 1: dmg3000 ($13.81 in chips) 
Seat 2: Envoy1006 ($18.40 in chips) 
Seat 3: winbabywin7 ($7.15 in chips) 
Seat 4: peteypete911 ($7.11 in chips) 
Seat 5: 123tiger711a ($10.63 in chips) 
Seat 6: PlayTheBlues4U ($14.30 in chips) 
winbabywin7: posts small blind $0.05
peteypete911: posts big blind $0.10
*** HOLE CARDS ***
Dealt to PlayTheBlues4U [6c 8s]
123tiger711a: folds 
PlayTheBlues4U: folds 
dmg3000: folds 
Envoy1006: calls $0.10
winbabywin7: calls $0.05
peteypete911: checks 
*** FLOP *** [Kh 6h 8h]
winbabywin7: checks 
peteypete911: checks 
Envoy1006: bets $0.10
winbabywin7: raises $0.50 to $0.60
peteypete911: folds 
Envoy1006: folds 
Uncalled bet ($0.50) returned to winbabywin7
winbabywin7 collected $0.48 from pot
winbabywin7: doesn't show hand 
*** SUMMARY ***
Total pot $0.50 | Rake $0.02 
Board [Kh 6h 8h]
Seat 1: dmg3000 folded before Flop (didn't bet)
Seat 2: Envoy1006 (button) folded on the Flop
Seat 3: winbabywin7 (small blind) collected ($0.48)
Seat 4: peteypete911 (big blind) folded on the Flop
Seat 5: 123tiger711a folded before Flop (didn't bet)
Seat 6: PlayTheBlues4U folded before Flop (didn't bet)



PokerStars Hand #205008748827:  Hold'em No Limit ($0.05/$0.10 USD) - 2019/10/24 20:40:36 ET
Table 'Megrez' 6-max Seat #3 is the button
Seat 1: dmg3000 ($13.81 in chips) 
Seat 2: Envoy1006 ($18.20 in chips) 
Seat 3: winbabywin7 ($7.43 in chips) 
Seat 4: peteypete911 ($7.01 in chips) 
Seat 5: 123tiger711a ($10.63 in chips) 
Seat 6: PlayTheBlues4U ($14.30 in chips) 
peteypete911: posts small blind $0.05
123tiger711a: posts big blind $0.10
*** HOLE CARDS ***
Dealt to PlayTheBlues4U [2h Qc]
PlayTheBlues4U: folds 
dmg3000 has timed out
dmg3000: folds 
Envoy1006: calls $0.10
winbabywin7: folds 
peteypete911: folds 
123tiger711a: checks 
*** FLOP *** [8s 5d Ts]
123tiger711a: bets $0.12
Envoy1006: calls $0.12
*** TURN *** [8s 5d Ts] [9d]
123tiger711a: checks 
Envoy1006: bets $0.10
123tiger711a: calls $0.10
*** RIVER *** [8s 5d Ts 9d] [6c]
123tiger711a: checks 
Envoy1006: bets $0.10
123tiger711a: folds 
Uncalled bet ($0.10) returned to Envoy1006
Envoy1006 collected $0.66 from pot
Envoy1006: doesn't show hand 
*** SUMMARY ***
Total pot $0.69 | Rake $0.03 
Board [8s 5d Ts 9d 6c]
Seat 1: dmg3000 folded before Flop (didn't bet)
Seat 2: Envoy1006 collected ($0.66)
Seat 3: winbabywin7 (button) folded before Flop (didn't bet)
Seat 4: peteypete911 (small blind) folded before Flop
Seat 5: 123tiger711a (big blind) folded on the River
Seat 6: PlayTheBlues4U folded before Flop (didn't bet)



PokerStars Hand #205008749014:  Hold'em No Limit ($0.05/$0.10 USD) - 2019/10/24 20:41:21 ET
Table 'Megrez' 6-max Seat #4 is the button
Seat 2: Envoy1006 ($18.54 in chips) 
Seat 3: winbabywin7 ($7.43 in chips) 
Seat 4: peteypete911 ($6.96 in chips) 
Seat 5: 123tiger711a ($10.31 in chips) 
Seat 6: PlayTheBlues4U ($14.30 in chips) 
123tiger711a: posts small blind $0.05
PlayTheBlues4U: posts big blind $0.10
*** HOLE CARDS ***
Dealt to PlayTheBlues4U [8d 9s]
Envoy1006: folds 
winbabywin7: folds 
peteypete911: folds 
123tiger711a: calls $0.05
PlayTheBlues4U: raises $0.30 to $0.40
123tiger711a: calls $0.30
*** FLOP *** [4d 2c Qs]
123tiger711a: checks 
PlayTheBlues4U: bets $0.40
123tiger711a: calls $0.40
*** TURN *** [4d 2c Qs] [7h]
123tiger711a: checks 
PlayTheBlues4U: checks 
*** RIVER *** [4d 2c Qs 7h] [9c]
123tiger711a: checks 
PlayTheBlues4U: checks 
*** SHOW DOWN ***
123tiger711a: shows [6s 6h] (a pair of Sixes)
PlayTheBlues4U: shows [8d 9s] (a pair of Nines)
PlayTheBlues4U collected $1.52 from pot
*** SUMMARY ***
Total pot $1.60 | Rake $0.08 
Board [4d 2c Qs 7h 9c]
Seat 2: Envoy1006 folded before Flop (didn't bet)
Seat 3: winbabywin7 folded before Flop (didn't bet)
Seat 4: peteypete911 (button) folded before Flop (didn't bet)
Seat 5: 123tiger711a (small blind) showed [6s 6h] and lost with a pair of Sixes
Seat 6: PlayTheBlues4U (big blind) showed [8d 9s] and won ($1.52) with a pair of Nines



PokerStars Hand #205008749162:  Hold'em No Limit ($0.05/$0.10 USD) - 2019/10/24 20:41:59 ET
Table 'Megrez' 6-max Seat #5 is the button
Seat 2: Envoy1006 ($18.54 in chips) 
Seat 3: winbabywin7 ($7.43 in chips) 
Seat 4: peteypete911 ($6.96 in chips) 
Seat 5: 123tiger711a ($10 in chips) 
Seat 6: PlayTheBlues4U ($15.02 in chips) 
PlayTheBlues4U: posts small blind $0.05
Envoy1006: posts big blind $0.10
*** HOLE CARDS ***
Dealt to PlayTheBlues4U [4d Js]
winbabywin7: folds 
peteypete911: folds 
123tiger711a: calls $0.10
PlayTheBlues4U: folds 
Envoy1006: checks 
*** FLOP *** [3c 3s 9c]
Envoy1006: checks 
123tiger711a: bets $0.12
Envoy1006: folds 
Uncalled bet ($0.12) returned to 123tiger711a
123tiger711a collected $0.24 from pot
*** SUMMARY ***
Total pot $0.25 | Rake $0.01 
Board [3c 3s 9c]
Seat 2: Envoy1006 (big blind) folded on the Flop
Seat 3: winbabywin7 folded before Flop (didn't bet)
Seat 4: peteypete911 folded before Flop (didn't bet)
Seat 5: 123tiger711a (button) collected ($0.24)
Seat 6: PlayTheBlues4U (small blind) folded before Flop



PokerStars Hand #205008749248:  Hold'em No Limit ($0.05/$0.10 USD) - 2019/10/24 20:42:18 ET
Table 'Megrez' 6-max Seat #6 is the button
Seat 2: Envoy1006 ($18.44 in chips) 
Seat 3: winbabywin7 ($7.43 in chips) 
Seat 4: peteypete911 ($6.96 in chips) 
Seat 5: 123tiger711a ($10.14 in chips) 
Seat 6: PlayTheBlues4U ($14.97 in chips) 
Envoy1006: posts small blind $0.05
winbabywin7: posts big blind $0.10
*** HOLE CARDS ***
Dealt to PlayTheBlues4U [Ts 8c]
peteypete911: calls $0.10
123tiger711a: calls $0.10
PlayTheBlues4U: folds 
Envoy1006: raises $0.20 to $0.30
winbabywin7: folds 
peteypete911: calls $0.20
123tiger711a: calls $0.20
*** FLOP *** [7c Ah 2c]
Envoy1006: bets $0.50
peteypete911: calls $0.50
123tiger711a: calls $0.50
*** TURN *** [7c Ah 2c] [5d]
Envoy1006: checks 
peteypete911: bets $0.30
123tiger711a: calls $0.30
Envoy1006: folds 
*** RIVER *** [7c Ah 2c 5d] [5h]
peteypete911: bets $0.30
123tiger711a: calls $0.30
*** SHOW DOWN ***
peteypete911: shows [Ad 4d] (two pair, Aces and Fives)
123tiger711a: shows [As 3s] (two pair, Aces and Fives)
peteypete911 collected $1.76 from pot
123tiger711a collected $1.76 from pot
*** SUMMARY ***
Total pot $3.70 | Rake $0.18 
Board [7c Ah 2c 5d 5h]
Seat 2: Envoy1006 (small blind) folded on the Turn
Seat 3: winbabywin7 (big blind) folded before Flop
Seat 4: peteypete911 showed [Ad 4d] and won ($1.76) with two pair, Aces and Fives
Seat 5: 123tiger711a showed [As 3s] and won ($1.76) with two pair, Aces and Fives
Seat 6: PlayTheBlues4U (button) folded before Flop (didn't bet)



PokerStars Hand #205008749437:  Hold'em No Limit ($0.05/$0.10 USD) - 2019/10/24 20:43:03 ET
Table 'Megrez' 6-max Seat #2 is the button
Seat 2: Envoy1006 ($17.64 in chips) 
Seat 3: winbabywin7 ($7.33 in chips) 
Seat 4: peteypete911 ($7.32 in chips) 
Seat 5: 123tiger711a ($10.50 in chips) 
Seat 6: PlayTheBlues4U ($14.97 in chips) 
winbabywin7: posts small blind $0.05
peteypete911: posts big blind $0.10
*** HOLE CARDS ***
Dealt to PlayTheBlues4U [6h Ah]
123tiger711a: folds 
PlayTheBlues4U: raises $0.20 to $0.30
Envoy1006: calls $0.30
winbabywin7: folds 
peteypete911: calls $0.20
*** FLOP *** [Th Qs 5d]
peteypete911: checks 
PlayTheBlues4U: checks 
Envoy1006: checks 
*** TURN *** [Th Qs 5d] [Jh]
peteypete911: checks 
PlayTheBlues4U: checks 
Envoy1006: checks 
*** RIVER *** [Th Qs 5d Jh] [Jc]
peteypete911: checks 
PlayTheBlues4U: checks 
Envoy1006: checks 
*** SHOW DOWN ***
peteypete911: shows [Tc 9c] (two pair, Jacks and Tens)
PlayTheBlues4U: mucks hand 
Envoy1006: mucks hand 
peteypete911 collected $0.90 from pot
*** SUMMARY ***
Total pot $0.95 | Rake $0.05 
Board [Th Qs 5d Jh Jc]
Seat 2: Envoy1006 (button) mucked [7s As]
Seat 3: winbabywin7 (small blind) folded before Flop
Seat 4: peteypete911 (big blind) showed [Tc 9c] and won ($0.90) with two pair, Jacks and Tens
Seat 5: 123tiger711a folded before Flop (didn't bet)
Seat 6: PlayTheBlues4U mucked [6h Ah]



PokerStars Hand #205008749628:  Hold'em No Limit ($0.05/$0.10 USD) - 2019/10/24 20:43:48 ET
Table 'Megrez' 6-max Seat #3 is the button
Seat 1: dmg3000 ($13.81 in chips) 
Seat 2: Envoy1006 ($17.34 in chips) 
Seat 3: winbabywin7 ($7.28 in chips) 
Seat 4: peteypete911 ($7.92 in chips) 
Seat 5: 123tiger711a ($10.50 in chips) 
Seat 6: PlayTheBlues4U ($14.67 in chips) 
peteypete911: posts small blind $0.05
123tiger711a: posts big blind $0.10
dmg3000: posts small & big blinds $0.15
*** HOLE CARDS ***
Dealt to PlayTheBlues4U [9s 4s]
PlayTheBlues4U: folds 
dmg3000: checks 
Envoy1006: folds 
winbabywin7: folds 
peteypete911: folds 
123tiger711a: checks 
*** FLOP *** [6h 8c As]
123tiger711a: checks 
dmg3000: checks 
*** TURN *** [6h 8c As] [2c]
123tiger711a: checks 
dmg3000: checks 
*** RIVER *** [6h 8c As 2c] [3s]
123tiger711a: checks 
dmg3000: checks 
*** SHOW DOWN ***
123tiger711a: shows [4h Kh] (high card Ace)
dmg3000: shows [3h Qd] (a pair of Threes)
dmg3000 collected $0.28 from pot
*** SUMMARY ***
Total pot $0.30 | Rake $0.02 
Board [6h 8c As 2c 3s]
Seat 1: dmg3000 showed [3h Qd] and won ($0.28) with a pair of Threes
Seat 2: Envoy1006 folded before Flop (didn't bet)
Seat 3: winbabywin7 (button) folded before Flop (didn't bet)
Seat 4: peteypete911 (small blind) folded before Flop
Seat 5: 123tiger711a (big blind) showed [4h Kh] and lost with high card Ace
Seat 6: PlayTheBlues4U folded before Flop (didn't bet)



PokerStars Hand #205008749888:  Hold'em No Limit ($0.05/$0.10 USD) - 2019/10/24 20:44:48 ET
Table 'Megrez' 6-max Seat #4 is the button
Seat 1: dmg3000 ($13.94 in chips) 
Seat 2: Envoy1006 ($17.34 in chips) 
Seat 3: winbabywin7 ($7.28 in chips) 
Seat 4: peteypete911 ($7.87 in chips) 
Seat 5: 123tiger711a ($10.40 in chips) 
Seat 6: PlayTheBlues4U ($14.67 in chips) 
123tiger711a: posts small blind $0.05
PlayTheBlues4U: posts big blind $0.10
*** HOLE CARDS ***
Dealt to PlayTheBlues4U [7s Qd]
dmg3000: folds 
Envoy1006: folds 
winbabywin7: calls $0.10
peteypete911: calls $0.10
123tiger711a: calls $0.05
PlayTheBlues4U: checks 
*** FLOP *** [2s 8c 6h]
123tiger711a: bets $0.19
PlayTheBlues4U: folds 
winbabywin7: calls $0.19
peteypete911: calls $0.19
*** TURN *** [2s 8c 6h] [Qs]
123tiger711a: checks 
winbabywin7: checks 
peteypete911: bets $0.20
123tiger711a: folds 
winbabywin7: calls $0.20
*** RIVER *** [2s 8c 6h Qs] [2h]
winbabywin7: checks 
peteypete911: checks 
*** SHOW DOWN ***
winbabywin7: shows [8s 7c] (two pair, Eights and Deuces)
peteypete911: mucks hand 
winbabywin7 collected $1.30 from pot
*** SUMMARY ***
Total pot $1.37 | Rake $0.07 
Board [2s 8c 6h Qs 2h]
Seat 1: dmg3000 folded before Flop (didn't bet)
Seat 2: Envoy1006 folded before Flop (didn't bet)
Seat 3: winbabywin7 showed [8s 7c] and won ($1.30) with two pair, Eights and Deuces
Seat 4: peteypete911 (button) mucked [Js 6s]
Seat 5: 123tiger711a (small blind) folded on the Turn
Seat 6: PlayTheBlues4U (big blind) folded on the Flop



PokerStars Hand #205009472152:  Hold'em No Limit ($0.05/$0.10 USD) - 2019/10/24 20:45:52 ET
Table 'Megrez' 6-max Seat #5 is the button
Seat 1: dmg3000 ($13.94 in chips) 
Seat 2: Envoy1006 ($17.34 in chips) 
Seat 3: winbabywin7 ($8.09 in chips) 
Seat 4: peteypete911 ($7.38 in chips) 
Seat 5: 123tiger711a ($10.11 in chips) 
Seat 6: PlayTheBlues4U ($14.57 in chips) 
PlayTheBlues4U: posts small blind $0.05
dmg3000: posts big blind $0.10
*** HOLE CARDS ***
Dealt to PlayTheBlues4U [3d 5s]
Envoy1006: calls $0.10
winbabywin7: calls $0.10
peteypete911: calls $0.10
123tiger711a: calls $0.10
PlayTheBlues4U: folds 
dmg3000: checks 
*** FLOP *** [2s Ts 5c]
dmg3000: checks 
Envoy1006: bets $0.30
winbabywin7: raises $1.10 to $1.40
peteypete911: folds 
123tiger711a: folds 
dmg3000: folds 
Envoy1006: calls $1.10
*** TURN *** [2s Ts 5c] [Ac]
Envoy1006: checks 
winbabywin7: checks 
*** RIVER *** [2s Ts 5c Ac] [Kc]
Envoy1006: bets $4.80
winbabywin7: calls $4.80
*** SHOW DOWN ***
Envoy1006: shows [Th As] (two pair, Aces and Tens)
winbabywin7: mucks hand 
Envoy1006 collected $12.30 from pot
*** SUMMARY ***
Total pot $12.95 | Rake $0.65 
Board [2s Ts 5c Ac Kc]
Seat 1: dmg3000 (big blind) folded on the Flop
Seat 2: Envoy1006 showed [Th As] and won ($12.30) with two pair, Aces and Tens
Seat 3: winbabywin7 mucked [Ks Js]
Seat 4: peteypete911 folded on the Flop
Seat 5: 123tiger711a (button) folded on the Flop
Seat 6: PlayTheBlues4U (small blind) folded before Flop



PokerStars Hand #205009472395:  Hold'em No Limit ($0.05/$0.10 USD) - 2019/10/24 20:46:45 ET
Table 'Megrez' 6-max Seat #6 is the button
Seat 1: dmg3000 ($13.84 in chips) 
Seat 2: Envoy1006 ($23.34 in chips) 
Seat 3: winbabywin7 ($1.79 in chips) 
Seat 4: peteypete911 ($7.28 in chips) 
Seat 5: 123tiger711a ($10.01 in chips) 
Seat 6: PlayTheBlues4U ($14.52 in chips) 
dmg3000: posts small blind $0.05
Envoy1006: posts big blind $0.10
*** HOLE CARDS ***
Dealt to PlayTheBlues4U [Kd 5d]
winbabywin7: calls $0.10
peteypete911: folds 
123tiger711a: folds 
PlayTheBlues4U: folds 
dmg3000: calls $0.05
Envoy1006: checks 
*** FLOP *** [Tc 7h Ad]
dmg3000: checks 
Envoy1006: checks 
winbabywin7: checks 
*** TURN *** [Tc 7h Ad] [3h]
dmg3000: checks 
Envoy1006: checks 
winbabywin7: checks 
*** RIVER *** [Tc 7h Ad 3h] [6s]
dmg3000: bets $0.28
Envoy1006: folds 
winbabywin7: folds 
Uncalled bet ($0.28) returned to dmg3000
dmg3000 collected $0.28 from pot
*** SUMMARY ***
Total pot $0.30 | Rake $0.02 
Board [Tc 7h Ad 3h 6s]
Seat 1: dmg3000 (small blind) collected ($0.28)
Seat 2: Envoy1006 (big blind) folded on the River
Seat 3: winbabywin7 folded on the River
Seat 4: peteypete911 folded before Flop (didn't bet)
Seat 5: 123tiger711a folded before Flop (didn't bet)
Seat 6: PlayTheBlues4U (button) folded before Flop (didn't bet)



PokerStars Hand #205009472634:  Hold'em No Limit ($0.05/$0.10 USD) - 2019/10/24 20:47:38 ET
Table 'Megrez' 6-max Seat #1 is the button
Seat 1: dmg3000 ($14.02 in chips) 
Seat 2: Envoy1006 ($23.24 in chips) 
Seat 3: winbabywin7 ($1.69 in chips) 
Seat 4: peteypete911 ($7.28 in chips) 
Seat 5: 123tiger711a ($10.01 in chips) 
Seat 6: PlayTheBlues4U ($14.52 in chips) 
Envoy1006: posts small blind $0.05
winbabywin7: posts big blind $0.10
*** HOLE CARDS ***
Dealt to PlayTheBlues4U [7s 3d]
peteypete911: calls $0.10
123tiger711a: folds 
PlayTheBlues4U: folds 
dmg3000: folds 
Envoy1006: raises $0.20 to $0.30
winbabywin7: calls $0.20
peteypete911: calls $0.20
*** FLOP *** [As 2s Qd]
Envoy1006: bets $0.10
winbabywin7: folds 
peteypete911: folds 
Uncalled bet ($0.10) returned to Envoy1006
Envoy1006 collected $0.86 from pot
Envoy1006: doesn't show hand 
*** SUMMARY ***
Total pot $0.90 | Rake $0.04 
Board [As 2s Qd]
Seat 1: dmg3000 (button) folded before Flop (didn't bet)
Seat 2: Envoy1006 (small blind) collected ($0.86)
Seat 3: winbabywin7 (big blind) folded on the Flop
Seat 4: peteypete911 folded on the Flop
Seat 5: 123tiger711a folded before Flop (didn't bet)
Seat 6: PlayTheBlues4U folded before Flop (didn't bet)



PokerStars Hand #205009472778:  Hold'em No Limit ($0.05/$0.10 USD) - 2019/10/24 20:48:11 ET
Table 'Megrez' 6-max Seat #2 is the button
Seat 1: dmg3000 ($14.02 in chips) 
Seat 2: Envoy1006 ($23.80 in chips) 
Seat 3: winbabywin7 ($1.39 in chips) 
Seat 4: peteypete911 ($6.98 in chips) 
Seat 5: 123tiger711a ($10.01 in chips) 
Seat 6: PlayTheBlues4U ($14.52 in chips) 
winbabywin7: posts small blind $0.05
peteypete911: posts big blind $0.10
*** HOLE CARDS ***
Dealt to PlayTheBlues4U [Kd Ts]
123tiger711a: folds 
PlayTheBlues4U: folds 
dmg3000: raises $0.20 to $0.30
Envoy1006: folds 
winbabywin7: folds 
peteypete911: calls $0.20
*** FLOP *** [Td Tc 2c]
peteypete911: checks 
dmg3000: checks 
*** TURN *** [Td Tc 2c] [5d]
peteypete911: checks 
dmg3000: bets $0.31
peteypete911: calls $0.31
*** RIVER *** [Td Tc 2c 5d] [3c]
peteypete911: checks 
dmg3000: checks 
*** SHOW DOWN ***
peteypete911: shows [Qc Ah] (a pair of Tens)
dmg3000: mucks hand 
peteypete911 collected $1.21 from pot
*** SUMMARY ***
Total pot $1.27 | Rake $0.06 
Board [Td Tc 2c 5d 3c]
Seat 1: dmg3000 mucked [7s Ac]
Seat 2: Envoy1006 (button) folded before Flop (didn't bet)
Seat 3: winbabywin7 (small blind) folded before Flop
Seat 4: peteypete911 (big blind) showed [Qc Ah] and won ($1.21) with a pair of Tens
Seat 5: 123tiger711a folded before Flop (didn't bet)
Seat 6: PlayTheBlues4U folded before Flop (didn't bet)



PokerStars Hand #205009472966:  Hold'em No Limit ($0.05/$0.10 USD) - 2019/10/24 20:48:54 ET
Table 'Megrez' 6-max Seat #3 is the button
Seat 1: dmg3000 ($13.41 in chips) 
Seat 2: Envoy1006 ($23.80 in chips) 
Seat 3: winbabywin7 ($1.34 in chips) 
Seat 4: peteypete911 ($7.58 in chips) 
Seat 5: 123tiger711a ($10.01 in chips) 
Seat 6: PlayTheBlues4U ($14.52 in chips) 
peteypete911: posts small blind $0.05
123tiger711a: posts big blind $0.10
*** HOLE CARDS ***
Dealt to PlayTheBlues4U [9h 8d]
PlayTheBlues4U: folds 
dmg3000: folds 
Envoy1006: calls $0.10
winbabywin7: calls $0.10
peteypete911: calls $0.05
123tiger711a: checks 
*** FLOP *** [2s 6s 7h]
peteypete911: checks 
123tiger711a: bets $0.19
Envoy1006: folds 
winbabywin7: calls $0.19
peteypete911: folds 
*** TURN *** [2s 6s 7h] [2c]
123tiger711a: bets $0.37
winbabywin7: calls $0.37
*** RIVER *** [2s 6s 7h 2c] [4h]
123tiger711a: bets $1.44
winbabywin7: calls $0.68 and is all-in
Uncalled bet ($0.76) returned to 123tiger711a
*** SHOW DOWN ***
123tiger711a: shows [Td 9c] (a pair of Deuces)
winbabywin7: shows [4s 5d] (two pair, Fours and Deuces)
winbabywin7 collected $2.74 from pot
*** SUMMARY ***
Total pot $2.88 | Rake $0.14 
Board [2s 6s 7h 2c 4h]
Seat 1: dmg3000 folded before Flop (didn't bet)
Seat 2: Envoy1006 folded on the Flop
Seat 3: winbabywin7 (button) showed [4s 5d] and won ($2.74) with two pair, Fours and Deuces
Seat 4: peteypete911 (small blind) folded on the Flop
Seat 5: 123tiger711a (big blind) showed [Td 9c] and lost with a pair of Deuces
Seat 6: PlayTheBlues4U folded before Flop (didn't bet)



PokerStars Hand #205009473193:  Hold'em No Limit ($0.05/$0.10 USD) - 2019/10/24 20:49:48 ET
Table 'Megrez' 6-max Seat #4 is the button
Seat 1: dmg3000 ($13.41 in chips) 
Seat 2: Envoy1006 ($23.70 in chips) 
Seat 3: winbabywin7 ($2.74 in chips) 
Seat 4: peteypete911 ($7.48 in chips) 
Seat 5: 123tiger711a ($10 in chips) 
Seat 6: PlayTheBlues4U ($14.52 in chips) 
123tiger711a: posts small blind $0.05
PlayTheBlues4U: posts big blind $0.10
*** HOLE CARDS ***
Dealt to PlayTheBlues4U [2d Jd]
dmg3000: folds 
Envoy1006: folds 
winbabywin7: folds 
peteypete911: calls $0.10
123tiger711a: calls $0.05
PlayTheBlues4U: checks 
*** FLOP *** [4c Ks Js]
123tiger711a: checks 
PlayTheBlues4U: checks 
peteypete911: checks 
*** TURN *** [4c Ks Js] [4h]
123tiger711a: checks 
PlayTheBlues4U: bets $0.20
peteypete911: folds 
123tiger711a: folds 
Uncalled bet ($0.20) returned to PlayTheBlues4U
PlayTheBlues4U collected $0.28 from pot
PlayTheBlues4U: doesn't show hand 
*** SUMMARY ***
Total pot $0.30 | Rake $0.02 
Board [4c Ks Js 4h]
Seat 1: dmg3000 folded before Flop (didn't bet)
Seat 2: Envoy1006 folded before Flop (didn't bet)
Seat 3: winbabywin7 folded before Flop (didn't bet)
Seat 4: peteypete911 (button) folded on the Turn
Seat 5: 123tiger711a (small blind) folded on the Turn
Seat 6: PlayTheBlues4U (big blind) collected ($0.28)



PokerStars Hand #205009473353:  Hold'em No Limit ($0.05/$0.10 USD) - 2019/10/24 20:50:24 ET
Table 'Megrez' 6-max Seat #5 is the button
Seat 1: dmg3000 ($13.41 in chips) 
Seat 2: Envoy1006 ($23.70 in chips) 
Seat 3: winbabywin7 ($2.74 in chips) 
Seat 4: peteypete911 ($7.38 in chips) 
Seat 5: 123tiger711a ($10 in chips) 
Seat 6: PlayTheBlues4U ($14.70 in chips) 
PlayTheBlues4U: posts small blind $0.05
dmg3000: posts big blind $0.10
*** HOLE CARDS ***
Dealt to PlayTheBlues4U [9h Qs]
Envoy1006: calls $0.10
winbabywin7: calls $0.10
peteypete911: folds 
123tiger711a: folds 
PlayTheBlues4U: folds 
dmg3000: raises $0.35 to $0.45
Envoy1006: calls $0.35
winbabywin7: calls $0.35
*** FLOP *** [6s 5s 3s]
dmg3000: bets $0.67
Envoy1006: calls $0.67
winbabywin7: raises $1.62 to $2.29 and is all-in
dmg3000: calls $1.62
Envoy1006: calls $1.62
*** TURN *** [6s 5s 3s] [8h]
dmg3000: checks 
Envoy1006: checks 
*** RIVER *** [6s 5s 3s 8h] [2c]
dmg3000: checks 
Envoy1006: checks 
*** SHOW DOWN ***
dmg3000: shows [As Jc] (high card Ace)
Envoy1006: shows [5h 3h] (two pair, Fives and Threes)
winbabywin7: mucks hand 
Envoy1006 collected $7.86 from pot
*** SUMMARY ***
Total pot $8.27 | Rake $0.41 
Board [6s 5s 3s 8h 2c]
Seat 1: dmg3000 (big blind) showed [As Jc] and lost with high card Ace
Seat 2: Envoy1006 showed [5h 3h] and won ($7.86) with two pair, Fives and Threes
Seat 3: winbabywin7 mucked [Kc 6c]
Seat 4: peteypete911 folded before Flop (didn't bet)
Seat 5: 123tiger711a (button) folded before Flop (didn't bet)
Seat 6: PlayTheBlues4U (small blind) folded before Flop



PokerStars Hand #205009473550:  Hold'em No Limit ($0.05/$0.10 USD) - 2019/10/24 20:51:09 ET
Table 'Megrez' 6-max Seat #6 is the button
Seat 1: dmg3000 ($10.67 in chips) 
Seat 2: Envoy1006 ($28.82 in chips) 
Seat 4: peteypete911 ($7.38 in chips) 
Seat 5: 123tiger711a ($10 in chips) 
Seat 6: PlayTheBlues4U ($14.65 in chips) 
dmg3000: posts small blind $0.05
Envoy1006: posts big blind $0.10
*** HOLE CARDS ***
Dealt to PlayTheBlues4U [3d 7c]
peteypete911: calls $0.10
123tiger711a: folds 
PlayTheBlues4U: folds 
dmg3000: raises $0.30 to $0.40
Envoy1006: folds 
peteypete911: folds 
Uncalled bet ($0.30) returned to dmg3000
dmg3000 collected $0.30 from pot
*** SUMMARY ***
Total pot $0.30 | Rake $0 
Seat 1: dmg3000 (small blind) collected ($0.30)
Seat 2: Envoy1006 (big blind) folded before Flop
Seat 4: peteypete911 folded before Flop
Seat 5: 123tiger711a folded before Flop (didn't bet)
Seat 6: PlayTheBlues4U (button) folded before Flop (didn't bet)



PokerStars Hand #205009473635:  Hold'em No Limit ($0.05/$0.10 USD) - 2019/10/24 20:51:30 ET
Table 'Megrez' 6-max Seat #1 is the button
Seat 1: dmg3000 ($10.87 in chips) 
Seat 2: Envoy1006 ($28.72 in chips) 
Seat 3: winbabywin7 ($8 in chips) 
Seat 4: peteypete911 ($7.28 in chips) 
Seat 5: 123tiger711a ($10 in chips) 
Seat 6: PlayTheBlues4U ($14.65 in chips) 
Envoy1006: posts small blind $0.05
winbabywin7: posts big blind $0.10
*** HOLE CARDS ***
Dealt to PlayTheBlues4U [7h 4s]
peteypete911: folds 
123tiger711a: folds 
PlayTheBlues4U: folds 
dmg3000: folds 
Envoy1006: calls $0.05
winbabywin7: checks 
*** FLOP *** [8s Td 8h]
Envoy1006: checks 
winbabywin7: checks 
*** TURN *** [8s Td 8h] [Qd]
Envoy1006: checks 
winbabywin7: checks 
*** RIVER *** [8s Td 8h Qd] [9c]
Envoy1006: bets $0.20
winbabywin7: calls $0.20
*** SHOW DOWN ***
Envoy1006: shows [Js 5s] (a straight, Eight to Queen)
winbabywin7: mucks hand 
Envoy1006 collected $0.57 from pot
*** SUMMARY ***
Total pot $0.60 | Rake $0.03 
Board [8s Td 8h Qd 9c]
Seat 1: dmg3000 (button) folded before Flop (didn't bet)
Seat 2: Envoy1006 (small blind) showed [Js 5s] and won ($0.57) with a straight, Eight to Queen
Seat 3: winbabywin7 (big blind) mucked [7d 6h]
Seat 4: peteypete911 folded before Flop (didn't bet)
Seat 5: 123tiger711a folded before Flop (didn't bet)
Seat 6: PlayTheBlues4U folded before Flop (didn't bet)



PokerStars Hand #205009473850:  Hold'em No Limit ($0.05/$0.10 USD) - 2019/10/24 20:52:17 ET
Table 'Megrez' 6-max Seat #2 is the button
Seat 1: dmg3000 ($10.87 in chips) 
Seat 2: Envoy1006 ($28.99 in chips) 
Seat 3: winbabywin7 ($7.70 in chips) 
Seat 4: peteypete911 ($7.28 in chips) 
Seat 5: 123tiger711a ($10 in chips) 
Seat 6: PlayTheBlues4U ($14.65 in chips) 
winbabywin7: posts small blind $0.05
peteypete911: posts big blind $0.10
*** HOLE CARDS ***
Dealt to PlayTheBlues4U [Qd 9h]
123tiger711a: folds 
PlayTheBlues4U: folds 
dmg3000: raises $0.20 to $0.30
Envoy1006: folds 
winbabywin7: folds 
peteypete911: folds 
Uncalled bet ($0.20) returned to dmg3000
dmg3000 collected $0.25 from pot
*** SUMMARY ***
Total pot $0.25 | Rake $0 
Seat 1: dmg3000 collected ($0.25)
Seat 2: Envoy1006 (button) folded before Flop (didn't bet)
Seat 3: winbabywin7 (small blind) folded before Flop
Seat 4: peteypete911 (big blind) folded before Flop
Seat 5: 123tiger711a folded before Flop (didn't bet)
Seat 6: PlayTheBlues4U folded before Flop (didn't bet)



PokerStars Hand #205009473974:  Hold'em No Limit ($0.05/$0.10 USD) - 2019/10/24 20:52:44 ET
Table 'Megrez' 6-max Seat #3 is the button
Seat 1: dmg3000 ($11.02 in chips) 
Seat 2: Envoy1006 ($28.99 in chips) 
Seat 3: winbabywin7 ($7.65 in chips) 
Seat 4: peteypete911 ($7.18 in chips) 
Seat 5: 123tiger711a ($10 in chips) 
Seat 6: PlayTheBlues4U ($14.65 in chips) 
peteypete911: posts small blind $0.05
123tiger711a: posts big blind $0.10
*** HOLE CARDS ***
Dealt to PlayTheBlues4U [5d 2s]
PlayTheBlues4U has timed out
PlayTheBlues4U: folds 
dmg3000: raises $0.20 to $0.30
Envoy1006: calls $0.30
winbabywin7: calls $0.30
peteypete911: calls $0.25
123tiger711a: calls $0.20
*** FLOP *** [6h 2d 7d]
peteypete911: checks 
123tiger711a: checks 
dmg3000: checks 
Envoy1006: checks 
winbabywin7: bets $1
peteypete911: folds 
123tiger711a: folds 
dmg3000: folds 
Envoy1006: folds 
Uncalled bet ($1) returned to winbabywin7
winbabywin7 collected $1.42 from pot
winbabywin7: doesn't show hand 
*** SUMMARY ***
Total pot $1.50 | Rake $0.08 
Board [6h 2d 7d]
Seat 1: dmg3000 folded on the Flop
Seat 2: Envoy1006 folded on the Flop
Seat 3: winbabywin7 (button) collected ($1.42)
Seat 4: peteypete911 (small blind) folded on the Flop
Seat 5: 123tiger711a (big blind) folded on the Flop
Seat 6: PlayTheBlues4U folded before Flop (didn't bet)



PokerStars Hand #205009474988:  Hold'em No Limit ($0.05/$0.10 USD) - 2019/10/24 20:56:41 ET
Table 'Megrez' 6-max Seat #4 is the button
Seat 1: dmg3000 ($11.52 in chips) 
Seat 2: Envoy1006 ($26.53 in chips) 
Seat 3: evanb004 ($11.55 in chips) 
Seat 4: peteypete911 ($6.96 in chips) 
Seat 5: 123tiger711a ($10 in chips) 
Seat 6: PlayTheBlues4U ($14.65 in chips) 
123tiger711a: posts small blind $0.05
PlayTheBlues4U: posts big blind $0.10
*** HOLE CARDS ***
Dealt to PlayTheBlues4U [7d 4d]
dmg3000: folds 
Envoy1006: calls $0.10
evanb004: folds 
peteypete911: calls $0.10
123tiger711a: calls $0.05
PlayTheBlues4U: checks 
*** FLOP *** [5s Ks Ad]
123tiger711a: checks 
PlayTheBlues4U: checks 
Envoy1006: checks 
peteypete911: bets $0.20
123tiger711a: folds 
PlayTheBlues4U: folds 
Envoy1006: calls $0.20
*** TURN *** [5s Ks Ad] [2c]
Envoy1006: checks 
peteypete911: bets $0.30
Envoy1006: calls $0.30
*** RIVER *** [5s Ks Ad 2c] [Th]
Envoy1006: checks 
peteypete911: checks 
*** SHOW DOWN ***
Envoy1006: shows [Ac 3h] (a pair of Aces)
peteypete911: mucks hand 
Envoy1006 collected $1.33 from pot
*** SUMMARY ***
Total pot $1.40 | Rake $0.07 
Board [5s Ks Ad 2c Th]
Seat 1: dmg3000 folded before Flop (didn't bet)
Seat 2: Envoy1006 showed [Ac 3h] and won ($1.33) with a pair of Aces
Seat 3: evanb004 folded before Flop (didn't bet)
Seat 4: peteypete911 (button) mucked [Kh 8c]
Seat 5: 123tiger711a (small blind) folded on the Flop
Seat 6: PlayTheBlues4U (big blind) folded on the Flop



PokerStars Hand #205009475126:  Hold'em No Limit ($0.05/$0.10 USD) - 2019/10/24 20:57:16 ET
Table 'Megrez' 6-max Seat #5 is the button
Seat 1: dmg3000 ($11.52 in chips) 
Seat 2: Envoy1006 ($27.26 in chips) 
Seat 3: evanb004 ($11.55 in chips) 
Seat 4: peteypete911 ($6.36 in chips) 
Seat 5: 123tiger711a ($10 in chips) 
Seat 6: PlayTheBlues4U ($14.55 in chips) 
PlayTheBlues4U: posts small blind $0.05
dmg3000: posts big blind $0.10
*** HOLE CARDS ***
Dealt to PlayTheBlues4U [Qc 7s]
Envoy1006: calls $0.10
evanb004: folds 
peteypete911: calls $0.10
123tiger711a: folds 
PlayTheBlues4U: calls $0.05
dmg3000: checks 
*** FLOP *** [5d 6h Td]
PlayTheBlues4U: checks 
dmg3000: checks 
Envoy1006: checks 
peteypete911: checks 
*** TURN *** [5d 6h Td] [Qh]
PlayTheBlues4U: bets $0.20
dmg3000: folds 
Envoy1006: folds 
peteypete911: calls $0.20
*** RIVER *** [5d 6h Td Qh] [7c]
PlayTheBlues4U: bets $0.60
peteypete911: folds 
Uncalled bet ($0.60) returned to PlayTheBlues4U
PlayTheBlues4U collected $0.76 from pot
PlayTheBlues4U: doesn't show hand 
*** SUMMARY ***
Total pot $0.80 | Rake $0.04 
Board [5d 6h Td Qh 7c]
Seat 1: dmg3000 (big blind) folded on the Turn
Seat 2: Envoy1006 folded on the Turn
Seat 3: evanb004 folded before Flop (didn't bet)
Seat 4: peteypete911 folded on the River
Seat 5: 123tiger711a (button) folded before Flop (didn't bet)
Seat 6: PlayTheBlues4U (small blind) collected ($0.76)



PokerStars Hand #205009475379:  Hold'em No Limit ($0.05/$0.10 USD) - 2019/10/24 20:58:20 ET
Table 'Megrez' 6-max Seat #6 is the button
Seat 1: dmg3000 ($11.42 in chips) 
Seat 2: Envoy1006 ($27.16 in chips) 
Seat 3: evanb004 ($11.55 in chips) 
Seat 4: peteypete911 ($6.06 in chips) 
Seat 5: 123tiger711a ($10 in chips) 
Seat 6: PlayTheBlues4U ($15.01 in chips) 
dmg3000: posts small blind $0.05
Envoy1006: posts big blind $0.10
*** HOLE CARDS ***
Dealt to PlayTheBlues4U [3s 2c]
evanb004: raises $0.20 to $0.30
peteypete911: folds 
123tiger711a: folds 
PlayTheBlues4U: folds 
dmg3000: folds 
Envoy1006: calls $0.20
*** FLOP *** [Kd 2d Jc]
Envoy1006: checks 
evanb004: checks 
*** TURN *** [Kd 2d Jc] [Ac]
Envoy1006: bets $0.20
evanb004: calls $0.20
*** RIVER *** [Kd 2d Jc Ac] [3c]
Envoy1006: bets $1
evanb004: calls $1
*** SHOW DOWN ***
Envoy1006: shows [Qc Th] (a straight, Ten to Ace)
evanb004: shows [9c Tc] (a flush, Ace high)
evanb004 collected $2.90 from pot
*** SUMMARY ***
Total pot $3.05 | Rake $0.15 
Board [Kd 2d Jc Ac 3c]
Seat 1: dmg3000 (small blind) folded before Flop
Seat 2: Envoy1006 (big blind) showed [Qc Th] and lost with a straight, Ten to Ace
Seat 3: evanb004 showed [9c Tc] and won ($2.90) with a flush, Ace high
Seat 4: peteypete911 folded before Flop (didn't bet)
Seat 5: 123tiger711a folded before Flop (didn't bet)
Seat 6: PlayTheBlues4U (button) folded before Flop (didn't bet)



PokerStars Hand #205009475580:  Hold'em No Limit ($0.05/$0.10 USD) - 2019/10/24 20:59:15 ET
Table 'Megrez' 6-max Seat #1 is the button
Seat 1: dmg3000 ($11.37 in chips) 
Seat 2: Envoy1006 ($25.66 in chips) 
Seat 3: evanb004 ($12.95 in chips) 
Seat 4: peteypete911 ($6.06 in chips) 
Seat 5: 123tiger711a ($10 in chips) 
Seat 6: PlayTheBlues4U ($15.01 in chips) 
Envoy1006: posts small blind $0.05
evanb004: posts big blind $0.10
*** HOLE CARDS ***
Dealt to PlayTheBlues4U [9h As]
peteypete911: folds 
123tiger711a: folds 
PlayTheBlues4U: raises $0.20 to $0.30
dmg3000: calls $0.30
Envoy1006: folds 
evanb004: calls $0.20
*** FLOP *** [Ks Jh 3c]
evanb004: checks 
PlayTheBlues4U: checks 
dmg3000: checks 
*** TURN *** [Ks Jh 3c] [8h]
evanb004: checks 
PlayTheBlues4U: checks 
dmg3000: checks 
*** RIVER *** [Ks Jh 3c 8h] [7d]
evanb004: checks 
PlayTheBlues4U: bets $0.50
dmg3000: folds 
evanb004: calls $0.50
*** SHOW DOWN ***
PlayTheBlues4U: shows [9h As] (high card Ace)
evanb004: shows [8d Tc] (a pair of Eights)
evanb004 collected $1.85 from pot
*** SUMMARY ***
Total pot $1.95 | Rake $0.10 
Board [Ks Jh 3c 8h 7d]
Seat 1: dmg3000 (button) folded on the River
Seat 2: Envoy1006 (small blind) folded before Flop
Seat 3: evanb004 (big blind) showed [8d Tc] and won ($1.85) with a pair of Eights
Seat 4: peteypete911 folded before Flop (didn't bet)
Seat 5: 123tiger711a folded before Flop (didn't bet)
Seat 6: PlayTheBlues4U showed [9h As] and lost with high card Ace



PokerStars Hand #205009476016:  Hold'em No Limit ($0.05/$0.10 USD) - 2019/10/24 21:01:01 ET
Table 'Megrez' 6-max Seat #2 is the button
Seat 1: dmg3000 ($11.07 in chips) 
Seat 2: Envoy1006 ($25.61 in chips) 
Seat 3: evanb004 ($14 in chips) 
Seat 4: peteypete911 ($6.06 in chips) 
Seat 5: 123tiger711a ($10 in chips) 
Seat 6: PlayTheBlues4U ($14.21 in chips) 
evanb004: posts small blind $0.05
peteypete911: posts big blind $0.10
*** HOLE CARDS ***
Dealt to PlayTheBlues4U [3h Ad]
123tiger711a: folds 
PlayTheBlues4U: folds 
dmg3000: raises $0.25 to $0.35
Envoy1006: calls $0.35
evanb004: folds 
peteypete911: calls $0.25
*** FLOP *** [5h 4s 7h]
peteypete911: checks 
dmg3000: bets $0.52
Envoy1006: folds 
peteypete911: folds 
Uncalled bet ($0.52) returned to dmg3000
dmg3000 collected $1.04 from pot
*** SUMMARY ***
Total pot $1.10 | Rake $0.06 
Board [5h 4s 7h]
Seat 1: dmg3000 collected ($1.04)
Seat 2: Envoy1006 (button) folded on the Flop
Seat 3: evanb004 (small blind) folded before Flop
Seat 4: peteypete911 (big blind) folded on the Flop
Seat 5: 123tiger711a folded before Flop (didn't bet)
Seat 6: PlayTheBlues4U folded before Flop (didn't bet)



PokerStars Hand #205009476202:  Hold'em No Limit ($0.05/$0.10 USD) - 2019/10/24 21:01:41 ET
Table 'Megrez' 6-max Seat #3 is the button
Seat 1: dmg3000 ($11.76 in chips) 
Seat 2: Envoy1006 ($25.26 in chips) 
Seat 3: evanb004 ($13.95 in chips) 
Seat 4: peteypete911 ($5.71 in chips) 
Seat 5: 123tiger711a ($10 in chips) 
Seat 6: PlayTheBlues4U ($14.21 in chips) 
peteypete911: posts small blind $0.05
123tiger711a: posts big blind $0.10
*** HOLE CARDS ***
Dealt to PlayTheBlues4U [4c As]
PlayTheBlues4U: folds 
dmg3000: raises $0.20 to $0.30
Envoy1006: calls $0.30
evanb004: folds 
peteypete911: folds 
123tiger711a: folds 
*** FLOP *** [5c 5s 7d]
dmg3000: bets $0.36
Envoy1006: raises $0.36 to $0.72
dmg3000: calls $0.36
*** TURN *** [5c 5s 7d] [4s]
dmg3000: checks 
Envoy1006: bets $1
dmg3000: calls $1
*** RIVER *** [5c 5s 7d 4s] [9h]
dmg3000: checks 
Envoy1006: bets $2
dmg3000: folds 
Uncalled bet ($2) returned to Envoy1006
Envoy1006 collected $3.98 from pot
Envoy1006: doesn't show hand 
*** SUMMARY ***
Total pot $4.19 | Rake $0.21 
Board [5c 5s 7d 4s 9h]
Seat 1: dmg3000 folded on the River
Seat 2: Envoy1006 collected ($3.98)
Seat 3: evanb004 (button) folded before Flop (didn't bet)
Seat 4: peteypete911 (small blind) folded before Flop
Seat 5: 123tiger711a (big blind) folded before Flop
Seat 6: PlayTheBlues4U folded before Flop (didn't bet)



PokerStars Hand #205009476448:  Hold'em No Limit ($0.05/$0.10 USD) - 2019/10/24 21:02:36 ET
Table 'Megrez' 6-max Seat #4 is the button
Seat 1: dmg3000 ($9.74 in chips) 
Seat 2: Envoy1006 ($27.22 in chips) 
Seat 3: evanb004 ($13.95 in chips) 
Seat 4: peteypete911 ($5.66 in chips) 
Seat 5: 123tiger711a ($10 in chips) 
Seat 6: PlayTheBlues4U ($14.21 in chips) 
123tiger711a: posts small blind $0.05
PlayTheBlues4U: posts big blind $0.10
*** HOLE CARDS ***
Dealt to PlayTheBlues4U [Ah Jd]
dmg3000: raises $0.10 to $0.20
Envoy1006: folds 
evanb004: folds 
peteypete911: folds 
123tiger711a: folds 
PlayTheBlues4U: calls $0.10
*** FLOP *** [7c 5c Qc]
PlayTheBlues4U: checks 
dmg3000: checks 
*** TURN *** [7c 5c Qc] [9d]
PlayTheBlues4U: checks 
dmg3000: checks 
*** RIVER *** [7c 5c Qc 9d] [4h]
PlayTheBlues4U: checks 
dmg3000: bets $0.22
PlayTheBlues4U: calls $0.22
*** SHOW DOWN ***
dmg3000: shows [5d 4c] (two pair, Fives and Fours)
PlayTheBlues4U: mucks hand 
dmg3000 collected $0.85 from pot
*** SUMMARY ***
Total pot $0.89 | Rake $0.04 
Board [7c 5c Qc 9d 4h]
Seat 1: dmg3000 showed [5d 4c] and won ($0.85) with two pair, Fives and Fours
Seat 2: Envoy1006 folded before Flop (didn't bet)
Seat 3: evanb004 folded before Flop (didn't bet)
Seat 4: peteypete911 (button) folded before Flop (didn't bet)
Seat 5: 123tiger711a (small blind) folded before Flop
Seat 6: PlayTheBlues4U (big blind) mucked [Ah Jd]



PokerStars Hand #205009476836:  Hold'em No Limit ($0.05/$0.10 USD) - 2019/10/24 21:04:01 ET
Table 'Megrez' 6-max Seat #5 is the button
Seat 1: dmg3000 ($10.17 in chips) 
Seat 2: Envoy1006 ($27.22 in chips) 
Seat 3: evanb004 ($13.95 in chips) 
Seat 4: peteypete911 ($5.66 in chips) 
Seat 5: 123tiger711a ($10 in chips) 
Seat 6: PlayTheBlues4U ($13.79 in chips) 
PlayTheBlues4U: posts small blind $0.05
dmg3000: posts big blind $0.10
*** HOLE CARDS ***
Dealt to PlayTheBlues4U [2c Ts]
Envoy1006: folds 
evanb004: folds 
peteypete911: folds 
123tiger711a: folds 
PlayTheBlues4U: folds 
Uncalled bet ($0.05) returned to dmg3000
dmg3000 collected $0.10 from pot
*** SUMMARY ***
Total pot $0.10 | Rake $0 
Seat 1: dmg3000 (big blind) collected ($0.10)
Seat 2: Envoy1006 folded before Flop (didn't bet)
Seat 3: evanb004 folded before Flop (didn't bet)
Seat 4: peteypete911 folded before Flop (didn't bet)
Seat 5: 123tiger711a (button) folded before Flop (didn't bet)
Seat 6: PlayTheBlues4U (small blind) folded before Flop



PokerStars Hand #205009476878:  Hold'em No Limit ($0.05/$0.10 USD) - 2019/10/24 21:04:09 ET
Table 'Megrez' 6-max Seat #6 is the button
Seat 1: dmg3000 ($10.22 in chips) 
Seat 2: Envoy1006 ($27.22 in chips) 
Seat 3: evanb004 ($13.95 in chips) 
Seat 4: peteypete911 ($5.66 in chips) 
Seat 5: 123tiger711a ($10 in chips) 
Seat 6: PlayTheBlues4U ($13.74 in chips) 
dmg3000: posts small blind $0.05
Envoy1006: posts big blind $0.10
*** HOLE CARDS ***
Dealt to PlayTheBlues4U [7s 5s]
evanb004: folds 
peteypete911: calls $0.10
123tiger711a: folds 
PlayTheBlues4U: raises $0.20 to $0.30
dmg3000: folds 
Envoy1006: folds 
peteypete911: folds 
Uncalled bet ($0.20) returned to PlayTheBlues4U
PlayTheBlues4U collected $0.35 from pot
PlayTheBlues4U: doesn't show hand 
*** SUMMARY ***
Total pot $0.35 | Rake $0 
Seat 1: dmg3000 (small blind) folded before Flop
Seat 2: Envoy1006 (big blind) folded before Flop
Seat 3: evanb004 folded before Flop (didn't bet)
Seat 4: peteypete911 folded before Flop
Seat 5: 123tiger711a folded before Flop (didn't bet)
Seat 6: PlayTheBlues4U (button) collected ($0.35)



PokerStars Hand #205009477010:  Hold'em No Limit ($0.05/$0.10 USD) - 2019/10/24 21:04:38 ET
Table 'Megrez' 6-max Seat #1 is the button
Seat 1: dmg3000 ($10.17 in chips) 
Seat 2: Envoy1006 ($27.12 in chips) 
Seat 3: evanb004 ($13.95 in chips) 
Seat 4: peteypete911 ($5.56 in chips) 
Seat 5: 123tiger711a ($10 in chips) 
Seat 6: PlayTheBlues4U ($13.99 in chips) 
Envoy1006: posts small blind $0.05
evanb004: posts big blind $0.10
*** HOLE CARDS ***
Dealt to PlayTheBlues4U [7s 3h]
peteypete911: folds 
123tiger711a: folds 
PlayTheBlues4U: folds 
dmg3000: calls $0.10
Envoy1006: folds 
evanb004: checks 
*** FLOP *** [9c 2h Ks]
evanb004: checks 
dmg3000: checks 
*** TURN *** [9c 2h Ks] [Qs]
evanb004: checks 
dmg3000: checks 
*** RIVER *** [9c 2h Ks Qs] [7h]
evanb004: checks 
dmg3000: checks 
*** SHOW DOWN ***
evanb004: shows [5s Tc] (high card King)
dmg3000: shows [Th 8d] (high card King - Queen+Ten+Nine+Eight kicker)
dmg3000 collected $0.24 from pot
*** SUMMARY ***
Total pot $0.25 | Rake $0.01 
Board [9c 2h Ks Qs 7h]
Seat 1: dmg3000 (button) showed [Th 8d] and won ($0.24) with high card King
Seat 2: Envoy1006 (small blind) folded before Flop
Seat 3: evanb004 (big blind) showed [5s Tc] and lost with high card King
Seat 4: peteypete911 folded before Flop (didn't bet)
Seat 5: 123tiger711a folded before Flop (didn't bet)
Seat 6: PlayTheBlues4U folded before Flop (didn't bet)



PokerStars Hand #205009477281:  Hold'em No Limit ($0.05/$0.10 USD) - 2019/10/24 21:05:39 ET
Table 'Megrez' 6-max Seat #2 is the button
Seat 1: dmg3000 ($10.31 in chips) 
Seat 2: Envoy1006 ($27.07 in chips) 
Seat 3: evanb004 ($13.85 in chips) 
Seat 4: peteypete911 ($5.56 in chips) 
Seat 5: 123tiger711a ($10 in chips) 
Seat 6: PlayTheBlues4U ($13.99 in chips) 
evanb004: posts small blind $0.05
peteypete911: posts big blind $0.10
*** HOLE CARDS ***
Dealt to PlayTheBlues4U [5c 8d]
123tiger711a: folds 
PlayTheBlues4U: folds 
dmg3000: calls $0.10
Envoy1006: calls $0.10
evanb004: folds 
peteypete911: checks 
*** FLOP *** [4h Jc 2h]
peteypete911: checks 
dmg3000: bets $0.17
Envoy1006: folds 
peteypete911: calls $0.17
*** TURN *** [4h Jc 2h] [Kh]
peteypete911: checks 
dmg3000: bets $0.33
peteypete911: folds 
Uncalled bet ($0.33) returned to dmg3000
dmg3000 collected $0.66 from pot
*** SUMMARY ***
Total pot $0.69 | Rake $0.03 
Board [4h Jc 2h Kh]
Seat 1: dmg3000 collected ($0.66)
Seat 2: Envoy1006 (button) folded on the Flop
Seat 3: evanb004 (small blind) folded before Flop
Seat 4: peteypete911 (big blind) folded on the Turn
Seat 5: 123tiger711a folded before Flop (didn't bet)
Seat 6: PlayTheBlues4U folded before Flop (didn't bet)



PokerStars Hand #205009477503:  Hold'em No Limit ($0.05/$0.10 USD) - 2019/10/24 21:06:29 ET
Table 'Megrez' 6-max Seat #3 is the button
Seat 1: dmg3000 ($10.70 in chips) 
Seat 2: Envoy1006 ($26.97 in chips) 
Seat 3: evanb004 ($13.80 in chips) 
Seat 4: peteypete911 ($5.29 in chips) 
Seat 5: 123tiger711a ($10 in chips) 
Seat 6: PlayTheBlues4U ($13.99 in chips) 
peteypete911: posts small blind $0.05
123tiger711a: posts big blind $0.10
*** HOLE CARDS ***
Dealt to PlayTheBlues4U [9c 4d]
PlayTheBlues4U: folds 
dmg3000: calls $0.10
Envoy1006: folds 
evanb004: calls $0.10
peteypete911: folds 
123tiger711a: checks 
*** FLOP *** [Jc Kc As]
123tiger711a: checks 
dmg3000: checks 
evanb004: bets $0.33
123tiger711a: folds 
dmg3000: folds 
Uncalled bet ($0.33) returned to evanb004
evanb004 collected $0.33 from pot
evanb004: doesn't show hand 
*** SUMMARY ***
Total pot $0.35 | Rake $0.02 
Board [Jc Kc As]
Seat 1: dmg3000 folded on the Flop
Seat 2: Envoy1006 folded before Flop (didn't bet)
Seat 3: evanb004 (button) collected ($0.33)
Seat 4: peteypete911 (small blind) folded before Flop
Seat 5: 123tiger711a (big blind) folded on the Flop
Seat 6: PlayTheBlues4U folded before Flop (didn't bet)



PokerStars Hand #205009477685:  Hold'em No Limit ($0.05/$0.10 USD) - 2019/10/24 21:07:14 ET
Table 'Megrez' 6-max Seat #4 is the button
Seat 1: dmg3000 ($10.60 in chips) 
Seat 2: Envoy1006 ($26.97 in chips) 
Seat 3: evanb004 ($14.03 in chips) 
Seat 4: peteypete911 ($5.24 in chips) 
Seat 5: 123tiger711a ($10 in chips) 
Seat 6: PlayTheBlues4U ($13.99 in chips) 
123tiger711a: posts small blind $0.05
PlayTheBlues4U: posts big blind $0.10
*** HOLE CARDS ***
Dealt to PlayTheBlues4U [4h 8c]
dmg3000: raises $0.25 to $0.35
Envoy1006: calls $0.35
evanb004: folds 
peteypete911: folds 
123tiger711a: folds 
PlayTheBlues4U: folds 
*** FLOP *** [Js Qd Jd]
dmg3000: bets $0.41
Envoy1006: calls $0.41
*** TURN *** [Js Qd Jd] [9d]
dmg3000: checks 
Envoy1006: bets $0.80
dmg3000: calls $0.80
*** RIVER *** [Js Qd Jd 9d] [4d]
dmg3000: checks 
Envoy1006: checks 
*** SHOW DOWN ***
dmg3000: shows [Kc Qc] (two pair, Queens and Jacks)
Envoy1006: mucks hand 
dmg3000 collected $3.11 from pot
*** SUMMARY ***
Total pot $3.27 | Rake $0.16 
Board [Js Qd Jd 9d 4d]
Seat 1: dmg3000 showed [Kc Qc] and won ($3.11) with two pair, Queens and Jacks
Seat 2: Envoy1006 mucked [8h Kh]
Seat 3: evanb004 folded before Flop (didn't bet)
Seat 4: peteypete911 (button) folded before Flop (didn't bet)
Seat 5: 123tiger711a (small blind) folded before Flop
Seat 6: PlayTheBlues4U (big blind) folded before Flop



PokerStars Hand #205009477840:  Hold'em No Limit ($0.05/$0.10 USD) - 2019/10/24 21:07:52 ET
Table 'Megrez' 6-max Seat #5 is the button
Seat 1: dmg3000 ($12.15 in chips) 
Seat 2: Envoy1006 ($25.41 in chips) 
Seat 3: evanb004 ($14.03 in chips) 
Seat 4: peteypete911 ($5.24 in chips) 
Seat 5: 123tiger711a ($10 in chips) 
Seat 6: PlayTheBlues4U ($13.89 in chips) 
PlayTheBlues4U: posts small blind $0.05
dmg3000: posts big blind $0.10
*** HOLE CARDS ***
Dealt to PlayTheBlues4U [As 5s]
Envoy1006: folds 
evanb004: raises $0.10 to $0.20
peteypete911: folds 
123tiger711a: folds 
PlayTheBlues4U: calls $0.15
dmg3000: folds 
*** FLOP *** [9h 3h 5h]
dmg3000 leaves the table
PlayTheBlues4U: checks 
evanb004: checks 
*** TURN *** [9h 3h 5h] [Ts]
PlayTheBlues4U: checks 
evanb004: bets $0.17
DaGoodz33 joins the table at seat #1 
PlayTheBlues4U: folds 
Uncalled bet ($0.17) returned to evanb004
evanb004 collected $0.48 from pot
evanb004: doesn't show hand 
*** SUMMARY ***
Total pot $0.50 | Rake $0.02 
Board [9h 3h 5h Ts]
Seat 1: dmg3000 (big blind) folded before Flop
Seat 2: Envoy1006 folded before Flop (didn't bet)
Seat 3: evanb004 collected ($0.48)
Seat 4: peteypete911 folded before Flop (didn't bet)
Seat 5: 123tiger711a (button) folded before Flop (didn't bet)
Seat 6: PlayTheBlues4U (small blind) folded on the Turn



PokerStars Hand #205009478026:  Hold'em No Limit ($0.05/$0.10 USD) - 2019/10/24 21:08:36 ET
Table 'Megrez' 6-max Seat #6 is the button
Seat 2: Envoy1006 ($25.41 in chips) 
Seat 3: evanb004 ($14.31 in chips) 
Seat 4: peteypete911 ($5.24 in chips) 
Seat 5: 123tiger711a ($10 in chips) 
Seat 6: PlayTheBlues4U ($13.69 in chips) 
Envoy1006: posts small blind $0.05
evanb004: posts big blind $0.10
*** HOLE CARDS ***
Dealt to PlayTheBlues4U [Jd 7c]
peteypete911: calls $0.10
123tiger711a: folds 
PlayTheBlues4U: folds 
Envoy1006: calls $0.05
evanb004: raises $0.34 to $0.44
peteypete911: folds 
Envoy1006: calls $0.34
*** FLOP *** [2h 7h 9h]
Envoy1006: bets $0.50
evanb004: calls $0.50
*** TURN *** [2h 7h 9h] [5d]
Envoy1006: bets $0.90
evanb004: calls $0.90
*** RIVER *** [2h 7h 9h 5d] [9s]
Envoy1006: bets $2
evanb004: folds [Qc Qs]
Uncalled bet ($2) returned to Envoy1006
Envoy1006 collected $3.59 from pot
Envoy1006: doesn't show hand 
*** SUMMARY ***
Total pot $3.78 | Rake $0.19 
Board [2h 7h 9h 5d 9s]
Seat 2: Envoy1006 (small blind) collected ($3.59)
Seat 3: evanb004 (big blind) folded on the River
Seat 4: peteypete911 folded before Flop
Seat 5: 123tiger711a folded before Flop (didn't bet)
Seat 6: PlayTheBlues4U (button) folded before Flop (didn't bet)



PokerStars Hand #205009478359:  Hold'em No Limit ($0.05/$0.10 USD) - 2019/10/24 21:09:54 ET
Table 'Megrez' 6-max Seat #2 is the button
Seat 2: Envoy1006 ($27.16 in chips) 
Seat 3: evanb004 ($12.47 in chips) 
Seat 4: peteypete911 ($5.14 in chips) 
Seat 5: 123tiger711a ($10 in chips) 
Seat 6: PlayTheBlues4U ($13.69 in chips) 
evanb004: posts small blind $0.05
peteypete911: posts big blind $0.10
DaGoodz33: sits out 
*** HOLE CARDS ***
Dealt to PlayTheBlues4U [2h 9s]
123tiger711a: calls $0.10
PlayTheBlues4U: folds 
Envoy1006: calls $0.10
evanb004: calls $0.05
peteypete911: checks 
*** FLOP *** [8c Js Kh]
evanb004: checks 
peteypete911: checks 
123tiger711a: checks 
Envoy1006: checks 
*** TURN *** [8c Js Kh] [6d]
evanb004: bets $0.10
peteypete911: folds 
123tiger711a: folds 
Envoy1006: calls $0.10
*** RIVER *** [8c Js Kh 6d] [3h]
evanb004: checks 
Envoy1006: checks 
*** SHOW DOWN ***
evanb004: shows [8h Tc] (a pair of Eights)
Envoy1006: mucks hand 
evanb004 collected $0.57 from pot
*** SUMMARY ***
Total pot $0.60 | Rake $0.03 
Board [8c Js Kh 6d 3h]
Seat 2: Envoy1006 (button) mucked [5s 6s]
Seat 3: evanb004 (small blind) showed [8h Tc] and won ($0.57) with a pair of Eights
Seat 4: peteypete911 (big blind) folded on the Turn
Seat 5: 123tiger711a folded on the Turn
Seat 6: PlayTheBlues4U folded before Flop (didn't bet)



PokerStars Hand #205009478485:  Hold'em No Limit ($0.05/$0.10 USD) - 2019/10/24 21:10:22 ET
Table 'Megrez' 6-max Seat #3 is the button
Seat 2: Envoy1006 ($26.96 in chips) 
Seat 3: evanb004 ($12.84 in chips) 
Seat 4: peteypete911 ($5.04 in chips) 
Seat 6: PlayTheBlues4U ($13.69 in chips) 
peteypete911: posts small blind $0.05
123tiger711a: is sitting out 
PlayTheBlues4U: posts big blind $0.10
DaGoodz33: sits out 
*** HOLE CARDS ***
Dealt to PlayTheBlues4U [Jc 3h]
Envoy1006: folds 
evanb004: folds 
peteypete911: folds 
Uncalled bet ($0.05) returned to PlayTheBlues4U
PlayTheBlues4U collected $0.10 from pot
PlayTheBlues4U: doesn't show hand 
*** SUMMARY ***
Total pot $0.10 | Rake $0 
Seat 2: Envoy1006 folded before Flop (didn't bet)
Seat 3: evanb004 (button) folded before Flop (didn't bet)
Seat 4: peteypete911 (small blind) folded before Flop
Seat 6: PlayTheBlues4U (big blind) collected ($0.10)



PokerStars Hand #205009478516:  Hold'em No Limit ($0.05/$0.10 USD) - 2019/10/24 21:10:30 ET
Table 'Megrez' 6-max Seat #4 is the button
Seat 1: DaGoodz33 ($10 in chips) 
Seat 2: Envoy1006 ($26.96 in chips) 
Seat 3: evanb004 ($12.84 in chips) 
Seat 4: peteypete911 ($4.99 in chips) 
Seat 6: PlayTheBlues4U ($13.74 in chips) 
PlayTheBlues4U: posts small blind $0.05
DaGoodz33: posts big blind $0.10
*** HOLE CARDS ***
Dealt to PlayTheBlues4U [Td Kc]
Envoy1006: raises $0.10 to $0.20
evanb004: folds 
peteypete911: folds 
PlayTheBlues4U: folds 
DaGoodz33: folds 
Uncalled bet ($0.10) returned to Envoy1006
DaGoodz33 leaves the table
Envoy1006 collected $0.25 from pot
Envoy1006: doesn't show hand 
*** SUMMARY ***
Total pot $0.25 | Rake $0 
Seat 1: DaGoodz33 (big blind) folded before Flop
Seat 2: Envoy1006 collected ($0.25)
Seat 3: evanb004 folded before Flop (didn't bet)
Seat 4: peteypete911 (button) folded before Flop (didn't bet)
Seat 6: PlayTheBlues4U (small blind) folded before Flop



PokerStars Hand #205009478614:  Hold'em No Limit ($0.05/$0.10 USD) - 2019/10/24 21:10:53 ET
Table 'Megrez' 6-max Seat #6 is the button
Seat 2: Envoy1006 ($27.11 in chips) 
Seat 3: evanb004 ($12.84 in chips) 
Seat 4: peteypete911 ($4.99 in chips) 
Seat 5: 123tiger711a ($10 in chips) 
Seat 6: PlayTheBlues4U ($13.69 in chips) 
Envoy1006: posts small blind $0.05
evanb004: posts big blind $0.10
123tiger711a: posts small & big blinds $0.15
*** HOLE CARDS ***
Dealt to PlayTheBlues4U [6c 3s]
peteypete911: calls $0.10
123tiger711a: checks 
PlayTheBlues4U: folds 
Envoy1006: calls $0.05
evanb004: checks 
*** FLOP *** [3c 7h 8h]
Envoy1006: bets $0.10
evanb004: folds 
peteypete911: raises $0.20 to $0.30
123tiger711a: calls $0.30
Envoy1006: calls $0.20
*** TURN *** [3c 7h 8h] [As]
Envoy1006: checks 
peteypete911: checks 
123tiger711a: checks 
*** RIVER *** [3c 7h 8h As] [8c]
Envoy1006: checks 
peteypete911: bets $0.40
123tiger711a: folds 
Envoy1006: folds 
Uncalled bet ($0.40) returned to peteypete911
peteypete911 collected $1.28 from pot
peteypete911: doesn't show hand 
*** SUMMARY ***
Total pot $1.35 | Rake $0.07 
Board [3c 7h 8h As 8c]
Seat 2: Envoy1006 (small blind) folded on the River
Seat 3: evanb004 (big blind) folded on the Flop
Seat 4: peteypete911 collected ($1.28)
Seat 5: 123tiger711a folded on the River
Seat 6: PlayTheBlues4U (button) folded before Flop (didn't bet)



PokerStars Hand #205009478799:  Hold'em No Limit ($0.05/$0.10 USD) - 2019/10/24 21:11:34 ET
Table 'Megrez' 6-max Seat #2 is the button
Seat 2: Envoy1006 ($26.71 in chips) 
Seat 3: evanb004 ($12.74 in chips) 
Seat 4: peteypete911 ($5.87 in chips) 
Seat 5: 123tiger711a ($10 in chips) 
Seat 6: PlayTheBlues4U ($13.69 in chips) 
evanb004: posts small blind $0.05
peteypete911: posts big blind $0.10
*** HOLE CARDS ***
Dealt to PlayTheBlues4U [3d 6h]
123tiger711a: calls $0.10
SuWasup joins the table at seat #1 
PlayTheBlues4U: folds 
Envoy1006: calls $0.10
evanb004: folds 
peteypete911: checks 
*** FLOP *** [4h 3c Qh]
peteypete911: bets $0.33
123tiger711a: folds 
Envoy1006: calls $0.33
*** TURN *** [4h 3c Qh] [Ks]
peteypete911: bets $0.40
Envoy1006: folds 
Uncalled bet ($0.40) returned to peteypete911
peteypete911 collected $0.96 from pot
peteypete911: doesn't show hand 
*** SUMMARY ***
Total pot $1.01 | Rake $0.05 
Board [4h 3c Qh Ks]
Seat 2: Envoy1006 (button) folded on the Turn
Seat 3: evanb004 (small blind) folded before Flop
Seat 4: peteypete911 (big blind) collected ($0.96)
Seat 5: 123tiger711a folded on the Flop
Seat 6: PlayTheBlues4U folded before Flop (didn't bet)



PokerStars Hand #205009478985:  Hold'em No Limit ($0.05/$0.10 USD) - 2019/10/24 21:12:16 ET
Table 'Megrez' 6-max Seat #3 is the button
Seat 2: Envoy1006 ($26.28 in chips) 
Seat 3: evanb004 ($12.69 in chips) 
Seat 4: peteypete911 ($6.40 in chips) 
Seat 5: 123tiger711a ($10 in chips) 
Seat 6: PlayTheBlues4U ($13.69 in chips) 
peteypete911: posts small blind $0.05
123tiger711a: posts big blind $0.10
SuWasup: sits out 
*** HOLE CARDS ***
Dealt to PlayTheBlues4U [Ks Kd]
PlayTheBlues4U: raises $0.20 to $0.30
Envoy1006: calls $0.30
evanb004: folds 
peteypete911: folds 
123tiger711a: folds 
*** FLOP *** [5h Ah Jc]
evanb004 leaves the table
PlayTheBlues4U: checks 
Envoy1006: checks 
*** TURN *** [5h Ah Jc] [2c]
PlayTheBlues4U: checks 
Envoy1006: checks 
*** RIVER *** [5h Ah Jc 2c] [8h]
PlayTheBlues4U: checks 
Envoy1006: checks 
*** SHOW DOWN ***
PlayTheBlues4U: shows [Ks Kd] (a pair of Kings)
Envoy1006: mucks hand 
PlayTheBlues4U collected $0.71 from pot
*** SUMMARY ***
Total pot $0.75 | Rake $0.04 
Board [5h Ah Jc 2c 8h]
Seat 2: Envoy1006 mucked [9s Js]
Seat 3: evanb004 (button) folded before Flop (didn't bet)
Seat 4: peteypete911 (small blind) folded before Flop
Seat 5: 123tiger711a (big blind) folded before Flop
Seat 6: PlayTheBlues4U showed [Ks Kd] and won ($0.71) with a pair of Kings



PokerStars Hand #205009479164:  Hold'em No Limit ($0.05/$0.10 USD) - 2019/10/24 21:12:58 ET
Table 'Megrez' 6-max Seat #4 is the button
Seat 2: Envoy1006 ($25.98 in chips) 
Seat 4: peteypete911 ($6.35 in chips) 
Seat 5: 123tiger711a ($10 in chips) 
Seat 6: PlayTheBlues4U ($14.10 in chips) 
123tiger711a: posts small blind $0.05
PlayTheBlues4U: posts big blind $0.10
SuWasup: sits out 
*** HOLE CARDS ***
Dealt to PlayTheBlues4U [4s Ac]
SuWasup leaves the table
Envoy1006: folds 
peteypete911: calls $0.10
123tiger711a: calls $0.05
PlayTheBlues4U: raises $0.30 to $0.40
peteypete911: folds 
123tiger711a: folds 
Uncalled bet ($0.30) returned to PlayTheBlues4U
PlayTheBlues4U collected $0.30 from pot
PlayTheBlues4U: doesn't show hand 
*** SUMMARY ***
Total pot $0.30 | Rake $0 
Seat 2: Envoy1006 folded before Flop (didn't bet)
Seat 4: peteypete911 (button) folded before Flop
Seat 5: 123tiger711a (small blind) folded before Flop
Seat 6: PlayTheBlues4U (big blind) collected ($0.30)



PokerStars Hand #205009479242:  Hold'em No Limit ($0.05/$0.10 USD) - 2019/10/24 21:13:16 ET
Table 'Megrez' 6-max Seat #5 is the button
Seat 2: Envoy1006 ($25.98 in chips) 
Seat 4: peteypete911 ($6.25 in chips) 
Seat 5: 123tiger711a ($10 in chips) 
Seat 6: PlayTheBlues4U ($14.30 in chips) 
PlayTheBlues4U: posts small blind $0.05
Envoy1006: posts big blind $0.10
*** HOLE CARDS ***
Dealt to PlayTheBlues4U [9d 6c]
peteypete911: calls $0.10
123tiger711a: folds 
PlayTheBlues4U: folds 
Envoy1006: raises $0.25 to $0.35
peteypete911: calls $0.25
*** FLOP *** [7h 3d Js]
Envoy1006: bets $0.40
peteypete911: folds 
Uncalled bet ($0.40) returned to Envoy1006
Envoy1006 collected $0.71 from pot
Envoy1006: doesn't show hand 
*** SUMMARY ***
Total pot $0.75 | Rake $0.04 
Board [7h 3d Js]
Seat 2: Envoy1006 (big blind) collected ($0.71)
Seat 4: peteypete911 folded on the Flop
Seat 5: 123tiger711a (button) folded before Flop (didn't bet)
Seat 6: PlayTheBlues4U (small blind) folded before Flop



PokerStars Hand #205009479352:  Hold'em No Limit ($0.05/$0.10 USD) - 2019/10/24 21:13:40 ET
Table 'Megrez' 6-max Seat #6 is the button
Seat 2: Envoy1006 ($26.34 in chips) 
Seat 4: peteypete911 ($5.90 in chips) 
Seat 5: 123tiger711a ($10 in chips) 
Seat 6: PlayTheBlues4U ($14.25 in chips) 
Envoy1006: posts small blind $0.05
peteypete911: posts big blind $0.10
*** HOLE CARDS ***
Dealt to PlayTheBlues4U [Th 8s]
123tiger711a: folds 
PlayTheBlues4U: raises $0.20 to $0.30
Envoy1006: calls $0.25
peteypete911: folds 
*** FLOP *** [2d Kd 2s]
Envoy1006: bets $0.20
PlayTheBlues4U: folds 
Uncalled bet ($0.20) returned to Envoy1006
Envoy1006 collected $0.66 from pot
Envoy1006: doesn't show hand 
*** SUMMARY ***
Total pot $0.70 | Rake $0.04 
Board [2d Kd 2s]
Seat 2: Envoy1006 (small blind) collected ($0.66)
Seat 4: peteypete911 (big blind) folded before Flop
Seat 5: 123tiger711a folded before Flop (didn't bet)
Seat 6: PlayTheBlues4U (button) folded on the Flop



PokerStars Hand #205009479459:  Hold'em No Limit ($0.05/$0.10 USD) - 2019/10/24 21:13:59 ET
Table 'Megrez' 6-max Seat #2 is the button
Seat 2: Envoy1006 ($26.70 in chips) 
Seat 4: peteypete911 ($5.80 in chips) 
Seat 5: 123tiger711a ($10 in chips) 
Seat 6: PlayTheBlues4U ($13.95 in chips) 
peteypete911: posts small blind $0.05
123tiger711a: posts big blind $0.10
*** HOLE CARDS ***
Dealt to PlayTheBlues4U [Ts Qd]
PlayTheBlues4U: raises $0.20 to $0.30
Envoy1006: folds 
peteypete911: folds 
123tiger711a: folds 
Uncalled bet ($0.20) returned to PlayTheBlues4U
PlayTheBlues4U collected $0.25 from pot
PlayTheBlues4U: doesn't show hand 
*** SUMMARY ***
Total pot $0.25 | Rake $0 
Seat 2: Envoy1006 (button) folded before Flop (didn't bet)
Seat 4: peteypete911 (small blind) folded before Flop
Seat 5: 123tiger711a (big blind) folded before Flop
Seat 6: PlayTheBlues4U collected ($0.25)



PokerStars Hand #205009479495:  Hold'em No Limit ($0.05/$0.10 USD) - 2019/10/24 21:14:08 ET
Table 'Megrez' 6-max Seat #4 is the button
Seat 2: Envoy1006 ($26.70 in chips) 
Seat 4: peteypete911 ($5.75 in chips) 
Seat 5: 123tiger711a ($10 in chips) 
Seat 6: PlayTheBlues4U ($14.10 in chips) 
123tiger711a: posts small blind $0.05
PlayTheBlues4U: posts big blind $0.10
*** HOLE CARDS ***
Dealt to PlayTheBlues4U [Jh Qs]
Envoy1006: raises $0.10 to $0.20
peteypete911: calls $0.20
123tiger711a: folds 
PlayTheBlues4U: calls $0.10
*** FLOP *** [5s 2h Tc]
PlayTheBlues4U: checks 
Envoy1006: bets $0.30
peteypete911: calls $0.30
PlayTheBlues4U: calls $0.30
*** TURN *** [5s 2h Tc] [7s]
PlayTheBlues4U: checks 
Envoy1006: bets $0.70
peteypete911: calls $0.70
PlayTheBlues4U: folds 
*** RIVER *** [5s 2h Tc 7s] [Kc]
Envoy1006: bets $0.40
peteypete911: folds 
Uncalled bet ($0.40) returned to Envoy1006
Envoy1006 collected $2.80 from pot
Envoy1006: doesn't show hand 
*** SUMMARY ***
Total pot $2.95 | Rake $0.15 
Board [5s 2h Tc 7s Kc]
Seat 2: Envoy1006 collected ($2.80)
Seat 4: peteypete911 (button) folded on the River
Seat 5: 123tiger711a (small blind) folded before Flop
Seat 6: PlayTheBlues4U (big blind) folded on the Turn



PokerStars Hand #205009479749:  Hold'em No Limit ($0.05/$0.10 USD) - 2019/10/24 21:15:05 ET
Table 'Megrez' 6-max Seat #5 is the button
Seat 2: Envoy1006 ($28.30 in chips) 
Seat 4: peteypete911 ($4.55 in chips) 
Seat 5: 123tiger711a ($10 in chips) 
Seat 6: PlayTheBlues4U ($13.60 in chips) 
PlayTheBlues4U: posts small blind $0.05
Envoy1006: posts big blind $0.10
*** HOLE CARDS ***
Dealt to PlayTheBlues4U [4d 3c]
peteypete911: calls $0.10
123tiger711a: calls $0.10
PlayTheBlues4U: calls $0.05
Envoy1006: checks 
*** FLOP *** [Td 5d Qc]
PlayTheBlues4U: checks 
Envoy1006: bets $0.10
peteypete911: calls $0.10
123tiger711a: calls $0.10
PlayTheBlues4U: folds 
*** TURN *** [Td 5d Qc] [8h]
Envoy1006: bets $0.10
peteypete911: calls $0.10
123tiger711a: folds 
*** RIVER *** [Td 5d Qc 8h] [3s]
Envoy1006: bets $0.10
peteypete911: calls $0.10
*** SHOW DOWN ***
Envoy1006: shows [Th 7c] (a pair of Tens)
peteypete911: shows [Ts 7h] (a pair of Tens)
Envoy1006 collected $0.52 from pot
peteypete911 collected $0.52 from pot
*** SUMMARY ***
Total pot $1.10 | Rake $0.06 
Board [Td 5d Qc 8h 3s]
Seat 2: Envoy1006 (big blind) showed [Th 7c] and won ($0.52) with a pair of Tens
Seat 4: peteypete911 showed [Ts 7h] and won ($0.52) with a pair of Tens
Seat 5: 123tiger711a (button) folded on the Turn
Seat 6: PlayTheBlues4U (small blind) folded on the Flop



PokerStars Hand #205009479935:  Hold'em No Limit ($0.05/$0.10 USD) - 2019/10/24 21:15:46 ET
Table 'Megrez' 6-max Seat #6 is the button
Seat 2: Envoy1006 ($28.42 in chips) 
Seat 4: peteypete911 ($4.67 in chips) 
Seat 5: 123tiger711a ($10 in chips) 
Seat 6: PlayTheBlues4U ($13.50 in chips) 
Envoy1006: posts small blind $0.05
peteypete911: posts big blind $0.10
*** HOLE CARDS ***
Dealt to PlayTheBlues4U [3d 7h]
123tiger711a: folds 
PlayTheBlues4U: folds 
Envoy1006: folds 
Uncalled bet ($0.05) returned to peteypete911
peteypete911 collected $0.10 from pot
peteypete911: doesn't show hand 
*** SUMMARY ***
Total pot $0.10 | Rake $0 
Seat 2: Envoy1006 (small blind) folded before Flop
Seat 4: peteypete911 (big blind) collected ($0.10)
Seat 5: 123tiger711a folded before Flop (didn't bet)
Seat 6: PlayTheBlues4U (button) folded before Flop (didn't bet)



PokerStars Hand #205010162108:  Hold'em No Limit ($0.05/$0.10 USD) - 2019/10/24 21:16:03 ET
Table 'Megrez' 6-max Seat #2 is the button
Seat 2: Envoy1006 ($28.37 in chips) 
Seat 4: peteypete911 ($4.72 in chips) 
Seat 5: 123tiger711a ($10 in chips) 
Seat 6: PlayTheBlues4U ($13.50 in chips) 
peteypete911: posts small blind $0.05
123tiger711a: posts big blind $0.10
*** HOLE CARDS ***
Dealt to PlayTheBlues4U [9h Ah]
PlayTheBlues4U: raises $0.20 to $0.30
Envoy1006: calls $0.30
peteypete911: calls $0.25
123tiger711a: raises $1.20 to $1.50
PlayTheBlues4U: folds 
Envoy1006: folds 
peteypete911: folds 
Uncalled bet ($1.20) returned to 123tiger711a
123tiger711a collected $1.20 from pot
*** SUMMARY ***
Total pot $1.20 | Rake $0 
Seat 2: Envoy1006 (button) folded before Flop
Seat 4: peteypete911 (small blind) folded before Flop
Seat 5: 123tiger711a (big blind) collected ($1.20)
Seat 6: PlayTheBlues4U folded before Flop



PokerStars Hand #205010162185:  Hold'em No Limit ($0.05/$0.10 USD) - 2019/10/24 21:16:19 ET
Table 'Megrez' 6-max Seat #4 is the button
Seat 2: Envoy1006 ($28.07 in chips) 
Seat 4: peteypete911 ($4.42 in chips) 
Seat 5: 123tiger711a ($10.90 in chips) 
Seat 6: PlayTheBlues4U ($13.20 in chips) 
123tiger711a: posts small blind $0.05
PlayTheBlues4U: posts big blind $0.10
*** HOLE CARDS ***
Dealt to PlayTheBlues4U [4d 7h]
Envoy1006: calls $0.10
peteypete911: folds 
123tiger711a: calls $0.05
PlayTheBlues4U: checks 
*** FLOP *** [8d Ad Ks]
123tiger711a: checks 
PlayTheBlues4U: checks 
Envoy1006: checks 
*** TURN *** [8d Ad Ks] [8s]
123tiger711a: checks 
PlayTheBlues4U: checks 
Envoy1006: checks 
*** RIVER *** [8d Ad Ks 8s] [3c]
123tiger711a: checks 
PlayTheBlues4U: checks 
Envoy1006: checks 
*** SHOW DOWN ***
123tiger711a: shows [2h Th] (a pair of Eights)
PlayTheBlues4U: mucks hand 
Envoy1006: shows [Td Jh] (a pair of Eights - Ace+King+Jack kicker)
Envoy1006 collected $0.28 from pot
*** SUMMARY ***
Total pot $0.30 | Rake $0.02 
Board [8d Ad Ks 8s 3c]
Seat 2: Envoy1006 showed [Td Jh] and won ($0.28) with a pair of Eights
Seat 4: peteypete911 (button) folded before Flop (didn't bet)
Seat 5: 123tiger711a (small blind) showed [2h Th] and lost with a pair of Eights
Seat 6: PlayTheBlues4U (big blind) mucked [4d 7h]



PokerStars Hand #205010162329:  Hold'em No Limit ($0.05/$0.10 USD) - 2019/10/24 21:16:51 ET
Table 'Megrez' 6-max Seat #5 is the button
Seat 2: Envoy1006 ($28.25 in chips) 
Seat 4: peteypete911 ($4.42 in chips) 
Seat 5: 123tiger711a ($10.80 in chips) 
Seat 6: PlayTheBlues4U ($13.10 in chips) 
PlayTheBlues4U: posts small blind $0.05
Envoy1006: posts big blind $0.10
*** HOLE CARDS ***
Dealt to PlayTheBlues4U [7d Qc]
peteypete911: folds 
123tiger711a: calls $0.10
PlayTheBlues4U: folds 
Envoy1006: checks 
*** FLOP *** [5s Ks 3d]
Envoy1006: bets $0.10
123tiger711a: calls $0.10
*** TURN *** [5s Ks 3d] [4h]
Envoy1006: bets $0.10
123tiger711a: calls $0.10
*** RIVER *** [5s Ks 3d 4h] [4s]
Envoy1006: bets $0.10
123tiger711a: raises $0.41 to $0.51
Envoy1006: calls $0.41
*** SHOW DOWN ***
123tiger711a: shows [Qs Js] (a flush, King high)
Envoy1006: mucks hand 
123tiger711a collected $1.59 from pot
*** SUMMARY ***
Total pot $1.67 | Rake $0.08 
Board [5s Ks 3d 4h 4s]
Seat 2: Envoy1006 (big blind) mucked [5d Ac]
Seat 4: peteypete911 folded before Flop (didn't bet)
Seat 5: 123tiger711a (button) showed [Qs Js] and won ($1.59) with a flush, King high
Seat 6: PlayTheBlues4U (small blind) folded before Flop



PokerStars Hand #205010162508:  Hold'em No Limit ($0.05/$0.10 USD) - 2019/10/24 21:17:30 ET
Table 'Megrez' 6-max Seat #6 is the button
Seat 2: Envoy1006 ($27.44 in chips) 
Seat 4: peteypete911 ($4.42 in chips) 
Seat 5: 123tiger711a ($11.58 in chips) 
Seat 6: PlayTheBlues4U ($13.05 in chips) 
Envoy1006: posts small blind $0.05
peteypete911: posts big blind $0.10
*** HOLE CARDS ***
Dealt to PlayTheBlues4U [5h 4h]
123tiger711a: raises $1 to $1.10
PlayTheBlues4U: folds 
Envoy1006: folds 
peteypete911: folds 
Uncalled bet ($1) returned to 123tiger711a
123tiger711a collected $0.25 from pot
*** SUMMARY ***
Total pot $0.25 | Rake $0 
Seat 2: Envoy1006 (small blind) folded before Flop
Seat 4: peteypete911 (big blind) folded before Flop
Seat 5: 123tiger711a collected ($0.25)
Seat 6: PlayTheBlues4U (button) folded before Flop (didn't bet)



PokerStars Hand #205010162662:  Hold'em No Limit ($0.05/$0.10 USD) - 2019/10/24 21:18:04 ET
Table 'Megrez' 6-max Seat #2 is the button
Seat 2: Envoy1006 ($27.39 in chips) 
Seat 4: peteypete911 ($4.32 in chips) 
Seat 5: 123tiger711a ($11.73 in chips) 
Seat 6: PlayTheBlues4U ($13.05 in chips) 
peteypete911: posts small blind $0.05
123tiger711a: posts big blind $0.10
*** HOLE CARDS ***
Dealt to PlayTheBlues4U [8s Jc]
PlayTheBlues4U: folds 
Envoy1006: raises $0.10 to $0.20
peteypete911: calls $0.15
123tiger711a: calls $0.10
*** FLOP *** [9s 8d Js]
peteypete911: checks 
123tiger711a: checks 
Envoy1006: checks 
*** TURN *** [9s 8d Js] [7h]
peteypete911: bets $0.30
123tiger711a: folds 
Envoy1006: calls $0.30
*** RIVER *** [9s 8d Js 7h] [Qc]
peteypete911: bets $0.30
Envoy1006: calls $0.30
*** SHOW DOWN ***
peteypete911: shows [7s Th] (a straight, Eight to Queen)
Envoy1006: mucks hand 
peteypete911 collected $1.71 from pot
*** SUMMARY ***
Total pot $1.80 | Rake $0.09 
Board [9s 8d Js 7h Qc]
Seat 2: Envoy1006 (button) mucked [4h Qh]
Seat 4: peteypete911 (small blind) showed [7s Th] and won ($1.71) with a straight, Eight to Queen
Seat 5: 123tiger711a (big blind) folded on the Turn
Seat 6: PlayTheBlues4U folded before Flop (didn't bet)



PokerStars Hand #205010162787:  Hold'em No Limit ($0.05/$0.10 USD) - 2019/10/24 21:18:33 ET
Table 'Megrez' 6-max Seat #4 is the button
Seat 2: Envoy1006 ($26.59 in chips) 
Seat 4: peteypete911 ($5.23 in chips) 
Seat 5: 123tiger711a ($11.53 in chips) 
Seat 6: PlayTheBlues4U ($13.05 in chips) 
123tiger711a: posts small blind $0.05
PlayTheBlues4U: posts big blind $0.10
*** HOLE CARDS ***
Dealt to PlayTheBlues4U [7c Kd]
Envoy1006: folds 
peteypete911: folds 
123tiger711a: calls $0.05
PlayTheBlues4U: checks 
*** FLOP *** [Ts Jd Tc]
123tiger711a: bets $0.10
PlayTheBlues4U: folds 
Uncalled bet ($0.10) returned to 123tiger711a
123tiger711a collected $0.19 from pot
*** SUMMARY ***
Total pot $0.20 | Rake $0.01 
Board [Ts Jd Tc]
Seat 2: Envoy1006 folded before Flop (didn't bet)
Seat 4: peteypete911 (button) folded before Flop (didn't bet)
Seat 5: 123tiger711a (small blind) collected ($0.19)
Seat 6: PlayTheBlues4U (big blind) folded on the Flop



PokerStars Hand #205010162848:  Hold'em No Limit ($0.05/$0.10 USD) - 2019/10/24 21:18:48 ET
Table 'Megrez' 6-max Seat #5 is the button
Seat 2: Envoy1006 ($26.59 in chips) 
Seat 4: peteypete911 ($5.23 in chips) 
Seat 5: 123tiger711a ($11.62 in chips) 
Seat 6: PlayTheBlues4U ($12.95 in chips) 
PlayTheBlues4U: posts small blind $0.05
Envoy1006: posts big blind $0.10
*** HOLE CARDS ***
Dealt to PlayTheBlues4U [7c 8s]
peteypete911: raises $0.20 to $0.30
123tiger711a: folds 
PlayTheBlues4U: folds 
Envoy1006: folds 
Uncalled bet ($0.20) returned to peteypete911
peteypete911 collected $0.25 from pot
peteypete911: doesn't show hand 
*** SUMMARY ***
Total pot $0.25 | Rake $0 
Seat 2: Envoy1006 (big blind) folded before Flop
Seat 4: peteypete911 collected ($0.25)
Seat 5: 123tiger711a (button) folded before Flop (didn't bet)
Seat 6: PlayTheBlues4U (small blind) folded before Flop



PokerStars Hand #205010162889:  Hold'em No Limit ($0.05/$0.10 USD) - 2019/10/24 21:18:58 ET
Table 'Megrez' 6-max Seat #6 is the button
Seat 2: Envoy1006 ($26.49 in chips) 
Seat 4: peteypete911 ($5.38 in chips) 
Seat 5: 123tiger711a ($11.62 in chips) 
Seat 6: PlayTheBlues4U ($12.90 in chips) 
Envoy1006: posts small blind $0.05
peteypete911: posts big blind $0.10
*** HOLE CARDS ***
Dealt to PlayTheBlues4U [Kd 3s]
123tiger711a: calls $0.10
PlayTheBlues4U: folds 
Envoy1006: folds 
peteypete911: checks 
*** FLOP *** [9h Kh 9s]
peteypete911: checks 
123tiger711a: bets $0.12
peteypete911: folds 
Uncalled bet ($0.12) returned to 123tiger711a
123tiger711a collected $0.24 from pot
*** SUMMARY ***
Total pot $0.25 | Rake $0.01 
Board [9h Kh 9s]
Seat 2: Envoy1006 (small blind) folded before Flop
Seat 4: peteypete911 (big blind) folded on the Flop
Seat 5: 123tiger711a collected ($0.24)
Seat 6: PlayTheBlues4U (button) folded before Flop (didn't bet)



PokerStars Hand #205010162976:  Hold'em No Limit ($0.05/$0.10 USD) - 2019/10/24 21:19:16 ET
Table 'Megrez' 6-max Seat #2 is the button
Seat 2: Envoy1006 ($26.44 in chips) 
Seat 4: peteypete911 ($5.28 in chips) 
Seat 5: 123tiger711a ($11.76 in chips) 
Seat 6: PlayTheBlues4U ($12.90 in chips) 
peteypete911: posts small blind $0.05
123tiger711a: posts big blind $0.10
*** HOLE CARDS ***
Dealt to PlayTheBlues4U [7s Ks]
PlayTheBlues4U: folds 
Envoy1006: raises $0.20 to $0.30
peteypete911: folds 
123tiger711a: calls $0.20
*** FLOP *** [Kc 8s 4h]
123tiger711a: checks 
Envoy1006: bets $0.20
123tiger711a: calls $0.20
*** TURN *** [Kc 8s 4h] [5s]
123tiger711a: checks 
Envoy1006: bets $0.70
123tiger711a: folds 
Uncalled bet ($0.70) returned to Envoy1006
Envoy1006 collected $1 from pot
Envoy1006: doesn't show hand 
*** SUMMARY ***
Total pot $1.05 | Rake $0.05 
Board [Kc 8s 4h 5s]
Seat 2: Envoy1006 (button) collected ($1)
Seat 4: peteypete911 (small blind) folded before Flop
Seat 5: 123tiger711a (big blind) folded on the Turn
Seat 6: PlayTheBlues4U folded before Flop (didn't bet)



PokerStars Hand #205010163160:  Hold'em No Limit ($0.05/$0.10 USD) - 2019/10/24 21:19:53 ET
Table 'Megrez' 6-max Seat #4 is the button
Seat 2: Envoy1006 ($26.94 in chips) 
Seat 4: peteypete911 ($5.23 in chips) 
Seat 5: 123tiger711a ($11.26 in chips) 
Seat 6: PlayTheBlues4U ($12.90 in chips) 
123tiger711a: posts small blind $0.05
PlayTheBlues4U: posts big blind $0.10
*** HOLE CARDS ***
Dealt to PlayTheBlues4U [2d Td]
Envoy1006: calls $0.10
peteypete911: calls $0.10
123tiger711a: calls $0.05
PlayTheBlues4U: checks 
*** FLOP *** [Qc 4d Ac]
123tiger711a: checks 
PlayTheBlues4U: checks 
Envoy1006: bets $0.10
peteypete911: calls $0.10
123tiger711a: folds 
PlayTheBlues4U: folds 
*** TURN *** [Qc 4d Ac] [9s]
Envoy1006: bets $0.30
peteypete911: calls $0.30
*** RIVER *** [Qc 4d Ac 9s] [Kd]
Envoy1006: bets $0.40
peteypete911: calls $0.40
*** SHOW DOWN ***
Envoy1006: shows [As 3d] (a pair of Aces)
peteypete911: shows [Kc 9c] (two pair, Kings and Nines)
peteypete911 collected $1.90 from pot
*** SUMMARY ***
Total pot $2 | Rake $0.10 
Board [Qc 4d Ac 9s Kd]
Seat 2: Envoy1006 showed [As 3d] and lost with a pair of Aces
Seat 4: peteypete911 (button) showed [Kc 9c] and won ($1.90) with two pair, Kings and Nines
Seat 5: 123tiger711a (small blind) folded on the Flop
Seat 6: PlayTheBlues4U (big blind) folded on the Flop



PokerStars Hand #205010163325:  Hold'em No Limit ($0.05/$0.10 USD) - 2019/10/24 21:20:34 ET
Table 'Megrez' 6-max Seat #5 is the button
Seat 2: Envoy1006 ($26.04 in chips) 
Seat 4: peteypete911 ($6.23 in chips) 
Seat 5: 123tiger711a ($11.16 in chips) 
Seat 6: PlayTheBlues4U ($12.80 in chips) 
PlayTheBlues4U: posts small blind $0.05
Envoy1006: posts big blind $0.10
*** HOLE CARDS ***
Dealt to PlayTheBlues4U [Qc 4s]
peteypete911: folds 
123tiger711a: folds 
PlayTheBlues4U: folds 
Uncalled bet ($0.05) returned to Envoy1006
Envoy1006 collected $0.10 from pot
Envoy1006: doesn't show hand 
*** SUMMARY ***
Total pot $0.10 | Rake $0 
Seat 2: Envoy1006 (big blind) collected ($0.10)
Seat 4: peteypete911 folded before Flop (didn't bet)
Seat 5: 123tiger711a (button) folded before Flop (didn't bet)
Seat 6: PlayTheBlues4U (small blind) folded before Flop



PokerStars Hand #205010163375:  Hold'em No Limit ($0.05/$0.10 USD) - 2019/10/24 21:20:44 ET
Table 'Megrez' 6-max Seat #6 is the button
Seat 2: Envoy1006 ($26.09 in chips) 
Seat 4: peteypete911 ($6.23 in chips) 
Seat 5: 123tiger711a ($11.16 in chips) 
Seat 6: PlayTheBlues4U ($12.75 in chips) 
Envoy1006: posts small blind $0.05
peteypete911: posts big blind $0.10
*** HOLE CARDS ***
Dealt to PlayTheBlues4U [6s 2c]
123tiger711a: folds 
PlayTheBlues4U: folds 
Envoy1006: calls $0.05
peteypete911: raises $0.10 to $0.20
Envoy1006: calls $0.10
*** FLOP *** [9d Jh 3c]
Envoy1006: checks 
peteypete911: bets $0.38
Envoy1006: folds 
Uncalled bet ($0.38) returned to peteypete911
peteypete911 collected $0.38 from pot
peteypete911: doesn't show hand 
*** SUMMARY ***
Total pot $0.40 | Rake $0.02 
Board [9d Jh 3c]
Seat 2: Envoy1006 (small blind) folded on the Flop
Seat 4: peteypete911 (big blind) collected ($0.38)
Seat 5: 123tiger711a folded before Flop (didn't bet)
Seat 6: PlayTheBlues4U (button) folded before Flop (didn't bet)



PokerStars Hand #205010163470:  Hold'em No Limit ($0.05/$0.10 USD) - 2019/10/24 21:21:05 ET
Table 'Megrez' 6-max Seat #2 is the button
Seat 2: Envoy1006 ($25.89 in chips) 
Seat 4: peteypete911 ($6.41 in chips) 
Seat 5: 123tiger711a ($11.16 in chips) 
Seat 6: PlayTheBlues4U ($12.75 in chips) 
peteypete911: posts small blind $0.05
123tiger711a: posts big blind $0.10
*** HOLE CARDS ***
Dealt to PlayTheBlues4U [4d Ad]
PlayTheBlues4U: raises $0.20 to $0.30
Envoy1006: folds 
peteypete911: folds 
123tiger711a: folds 
Uncalled bet ($0.20) returned to PlayTheBlues4U
PlayTheBlues4U collected $0.25 from pot
PlayTheBlues4U: doesn't show hand 
*** SUMMARY ***
Total pot $0.25 | Rake $0 
Seat 2: Envoy1006 (button) folded before Flop (didn't bet)
Seat 4: peteypete911 (small blind) folded before Flop
Seat 5: 123tiger711a (big blind) folded before Flop
Seat 6: PlayTheBlues4U collected ($0.25)



PokerStars Hand #205010163516:  Hold'em No Limit ($0.05/$0.10 USD) - 2019/10/24 21:21:14 ET
Table 'Megrez' 6-max Seat #4 is the button
Seat 2: Envoy1006 ($25.89 in chips) 
Seat 4: peteypete911 ($6.36 in chips) 
Seat 5: 123tiger711a ($11.06 in chips) 
Seat 6: PlayTheBlues4U ($12.90 in chips) 
123tiger711a: posts small blind $0.05
PlayTheBlues4U: posts big blind $0.10
*** HOLE CARDS ***
Dealt to PlayTheBlues4U [2s Jd]
Envoy1006: raises $0.10 to $0.20
peteypete911: folds 
123tiger711a: folds 
PlayTheBlues4U: folds 
Uncalled bet ($0.10) returned to Envoy1006
Envoy1006 collected $0.25 from pot
Envoy1006: doesn't show hand 
*** SUMMARY ***
Total pot $0.25 | Rake $0 
Seat 2: Envoy1006 collected ($0.25)
Seat 4: peteypete911 (button) folded before Flop (didn't bet)
Seat 5: 123tiger711a (small blind) folded before Flop
Seat 6: PlayTheBlues4U (big blind) folded before Flop



PokerStars Hand #205010163548:  Hold'em No Limit ($0.05/$0.10 USD) - 2019/10/24 21:21:22 ET
Table 'Megrez' 6-max Seat #5 is the button
Seat 2: Envoy1006 ($26.04 in chips) 
Seat 4: peteypete911 ($6.36 in chips) 
Seat 5: 123tiger711a ($11.01 in chips) 
Seat 6: PlayTheBlues4U ($12.80 in chips) 
PlayTheBlues4U: posts small blind $0.05
Envoy1006: posts big blind $0.10
*** HOLE CARDS ***
Dealt to PlayTheBlues4U [7h Qd]
peteypete911: calls $0.10
123tiger711a: folds 
PlayTheBlues4U: folds 
Envoy1006: checks 
*** FLOP *** [3h Ts Qs]
Envoy1006: bets $0.10
peteypete911: raises $0.20 to $0.30
Envoy1006: calls $0.20
*** TURN *** [3h Ts Qs] [5h]
Envoy1006: checks 
peteypete911: bets $0.41
Envoy1006: calls $0.41
*** RIVER *** [3h Ts Qs 5h] [Kh]
Envoy1006: checks 
peteypete911: checks 
*** SHOW DOWN ***
Envoy1006: shows [6h 3d] (a pair of Threes)
peteypete911: shows [9c Qh] (a pair of Queens)
peteypete911 collected $1.59 from pot
*** SUMMARY ***
Total pot $1.67 | Rake $0.08 
Board [3h Ts Qs 5h Kh]
Seat 2: Envoy1006 (big blind) showed [6h 3d] and lost with a pair of Threes
Seat 4: peteypete911 showed [9c Qh] and won ($1.59) with a pair of Queens
Seat 5: 123tiger711a (button) folded before Flop (didn't bet)
Seat 6: PlayTheBlues4U (small blind) folded before Flop



PokerStars Hand #205010163683:  Hold'em No Limit ($0.05/$0.10 USD) - 2019/10/24 21:21:51 ET
Table 'Megrez' 6-max Seat #6 is the button
Seat 2: Envoy1006 ($25.23 in chips) 
Seat 4: peteypete911 ($7.14 in chips) 
Seat 5: 123tiger711a ($11.01 in chips) 
Seat 6: PlayTheBlues4U ($12.75 in chips) 
Envoy1006: posts small blind $0.05
peteypete911: posts big blind $0.10
*** HOLE CARDS ***
Dealt to PlayTheBlues4U [Kd Jh]
123tiger711a: folds 
PlayTheBlues4U: raises $0.20 to $0.30
Envoy1006: raises $0.70 to $1
peteypete911: folds 
PlayTheBlues4U: folds 
Uncalled bet ($0.70) returned to Envoy1006
Envoy1006 collected $0.70 from pot
Envoy1006: doesn't show hand 
*** SUMMARY ***
Total pot $0.70 | Rake $0 
Seat 2: Envoy1006 (small blind) collected ($0.70)
Seat 4: peteypete911 (big blind) folded before Flop
Seat 5: 123tiger711a folded before Flop (didn't bet)
Seat 6: PlayTheBlues4U (button) folded before Flop



PokerStars Hand #205010163787:  Hold'em No Limit ($0.05/$0.10 USD) - 2019/10/24 21:22:14 ET
Table 'Megrez' 6-max Seat #2 is the button
Seat 2: Envoy1006 ($25.63 in chips) 
Seat 4: peteypete911 ($7.04 in chips) 
Seat 6: PlayTheBlues4U ($12.45 in chips) 
peteypete911: posts small blind $0.05
123tiger711a: is sitting out 
PlayTheBlues4U: posts big blind $0.10
*** HOLE CARDS ***
Dealt to PlayTheBlues4U [9d Kd]
123tiger711a leaves the table
Envoy1006: raises $0.10 to $0.20
peteypete911: folds 
PlayTheBlues4U: calls $0.10
*** FLOP *** [Jd 5s 7s]
PlayTheBlues4U: checks 
Envoy1006: bets $0.20
PlayTheBlues4U: calls $0.20
*** TURN *** [Jd 5s 7s] [2h]
PlayTheBlues4U: checks 
Envoy1006: bets $0.40
PlayTheBlues4U: folds 
Uncalled bet ($0.40) returned to Envoy1006
Envoy1006 collected $0.81 from pot
Envoy1006: doesn't show hand 
*** SUMMARY ***
Total pot $0.85 | Rake $0.04 
Board [Jd 5s 7s 2h]
Seat 2: Envoy1006 (button) collected ($0.81)
Seat 4: peteypete911 (small blind) folded before Flop
Seat 6: PlayTheBlues4U (big blind) folded on the Turn



PokerStars Hand #205010163915:  Hold'em No Limit ($0.05/$0.10 USD) - 2019/10/24 21:22:42 ET
Table 'Megrez' 6-max Seat #4 is the button
Seat 2: Envoy1006 ($26.04 in chips) 
Seat 4: peteypete911 ($6.99 in chips) 
Seat 6: PlayTheBlues4U ($12.05 in chips) 
PlayTheBlues4U: posts small blind $0.05
Envoy1006: posts big blind $0.10
*** HOLE CARDS ***
Dealt to PlayTheBlues4U [4h Qd]
peteypete911: raises $0.20 to $0.30
PlayTheBlues4U: folds 
Envoy1006: raises $0.20 to $0.50
peteypete911: calls $0.20
*** FLOP *** [7d 3d 6d]
Envoy1006: checks 
peteypete911: checks 
*** TURN *** [7d 3d 6d] [Ts]
Envoy1006: bets $0.50
peteypete911: calls $0.50
*** RIVER *** [7d 3d 6d Ts] [2s]
Envoy1006: bets $1
peteypete911: calls $1
*** SHOW DOWN ***
Envoy1006: shows [Jc Qc] (high card Queen)
peteypete911: shows [Qh Qs] (a pair of Queens)
peteypete911 collected $3.85 from pot
*** SUMMARY ***
Total pot $4.05 | Rake $0.20 
Board [7d 3d 6d Ts 2s]
Seat 2: Envoy1006 (big blind) showed [Jc Qc] and lost with high card Queen
Seat 4: peteypete911 (button) showed [Qh Qs] and won ($3.85) with a pair of Queens
Seat 6: PlayTheBlues4U (small blind) folded before Flop



PokerStars Hand #205253548718:  Hold'em No Limit ($0.05/$0.10 USD) - 2019/10/29 19:12:43 ET
Table 'Ara' 6-max Seat #1 is the button
Seat 1: molahs89 ($32.95 in chips) 
Seat 2: tomasz2016 ($10.47 in chips) 
Seat 3: PlayTheBlues4U ($10 in chips) 
Seat 4: BernieGB ($11.23 in chips) 
Seat 5: Babu1738 ($10 in chips) 
Seat 6: DaBirds23 ($13.32 in chips) 
tomasz2016: posts small blind $0.05
PlayTheBlues4U: posts big blind $0.10
*** HOLE CARDS ***
Dealt to PlayTheBlues4U [Jc Qh]
BernieGB: folds 
Babu1738: folds 
DaBirds23: folds 
molahs89: folds 
tomasz2016: folds 
Uncalled bet ($0.05) returned to PlayTheBlues4U
PlayTheBlues4U collected $0.10 from pot
PlayTheBlues4U: doesn't show hand 
*** SUMMARY ***
Total pot $0.10 | Rake $0 
Seat 1: molahs89 (button) folded before Flop (didn't bet)
Seat 2: tomasz2016 (small blind) folded before Flop
Seat 3: PlayTheBlues4U (big blind) collected ($0.10)
Seat 4: BernieGB folded before Flop (didn't bet)
Seat 5: Babu1738 folded before Flop (didn't bet)
Seat 6: DaBirds23 folded before Flop (didn't bet)



PokerStars Hand #205253548771:  Hold'em No Limit ($0.05/$0.10 USD) - 2019/10/29 19:13:02 ET
Table 'Ara' 6-max Seat #2 is the button
Seat 1: molahs89 ($32.95 in chips) 
Seat 2: tomasz2016 ($10.42 in chips) 
Seat 3: PlayTheBlues4U ($10.05 in chips) 
Seat 4: BernieGB ($11.23 in chips) 
Seat 5: Babu1738 ($10 in chips) 
Seat 6: DaBirds23 ($13.32 in chips) 
PlayTheBlues4U: posts small blind $0.05
BernieGB: posts big blind $0.10
*** HOLE CARDS ***
Dealt to PlayTheBlues4U [3c As]
Babu1738: folds 
DaBirds23: folds 
molahs89: raises $0.40 to $0.50
tomasz2016: folds 
PlayTheBlues4U: folds 
BernieGB: folds 
Uncalled bet ($0.40) returned to molahs89
molahs89 collected $0.25 from pot
molahs89: doesn't show hand 
*** SUMMARY ***
Total pot $0.25 | Rake $0 
Seat 1: molahs89 collected ($0.25)
Seat 2: tomasz2016 (button) folded before Flop (didn't bet)
Seat 3: PlayTheBlues4U (small blind) folded before Flop
Seat 4: BernieGB (big blind) folded before Flop
Seat 5: Babu1738 folded before Flop (didn't bet)
Seat 6: DaBirds23 folded before Flop (didn't bet)



PokerStars Hand #205253548849:  Hold'em No Limit ($0.05/$0.10 USD) - 2019/10/29 19:13:25 ET
Table 'Ara' 6-max Seat #3 is the button
Seat 1: molahs89 ($33.10 in chips) 
Seat 2: tomasz2016 ($10.42 in chips) 
Seat 3: PlayTheBlues4U ($10 in chips) 
Seat 4: BernieGB ($11.13 in chips) 
Seat 5: Babu1738 ($10 in chips) 
Seat 6: DaBirds23 ($13.32 in chips) 
BernieGB: posts small blind $0.05
Babu1738: posts big blind $0.10
*** HOLE CARDS ***
Dealt to PlayTheBlues4U [Ts 3h]
DaBirds23: folds 
molahs89: calls $0.10
tomasz2016: calls $0.10
PlayTheBlues4U: folds 
BernieGB: folds 
Babu1738: checks 
*** FLOP *** [3c Qs 8h]
Babu1738: checks 
molahs89: bets $0.30
tomasz2016: calls $0.30
Babu1738: folds 
*** TURN *** [3c Qs 8h] [Qd]
molahs89: bets $3.10
tomasz2016: folds 
Uncalled bet ($3.10) returned to molahs89
molahs89 collected $0.90 from pot
molahs89: doesn't show hand 
*** SUMMARY ***
Total pot $0.95 | Rake $0.05 
Board [3c Qs 8h Qd]
Seat 1: molahs89 collected ($0.90)
Seat 2: tomasz2016 folded on the Turn
Seat 3: PlayTheBlues4U (button) folded before Flop (didn't bet)
Seat 4: BernieGB (small blind) folded before Flop
Seat 5: Babu1738 (big blind) folded on the Flop
Seat 6: DaBirds23 folded before Flop (didn't bet)



PokerStars Hand #205253548987:  Hold'em No Limit ($0.05/$0.10 USD) - 2019/10/29 19:14:17 ET
Table 'Ara' 6-max Seat #4 is the button
Seat 1: molahs89 ($33.60 in chips) 
Seat 2: tomasz2016 ($10.02 in chips) 
Seat 3: PlayTheBlues4U ($10 in chips) 
Seat 4: BernieGB ($11.08 in chips) 
Seat 5: Babu1738 ($10 in chips) 
Seat 6: DaBirds23 ($13.32 in chips) 
Babu1738: posts small blind $0.05
DaBirds23: posts big blind $0.10
*** HOLE CARDS ***
Dealt to PlayTheBlues4U [9s Tc]
molahs89: raises $0.10 to $0.20
tomasz2016: folds 
PlayTheBlues4U: folds 
BernieGB: folds 
Babu1738: calls $0.15
DaBirds23: folds 
*** FLOP *** [3c 6h Js]
Babu1738: checks 
molahs89: checks 
*** TURN *** [3c 6h Js] [Jc]
Babu1738: checks 
molahs89 has timed out
molahs89: checks 
*** RIVER *** [3c 6h Js Jc] [7d]
Babu1738: bets $0.36
molahs89: folds 
Uncalled bet ($0.36) returned to Babu1738
Babu1738 collected $0.48 from pot
Babu1738: doesn't show hand 
*** SUMMARY ***
Total pot $0.50 | Rake $0.02 
Board [3c 6h Js Jc 7d]
Seat 1: molahs89 folded on the River
Seat 2: tomasz2016 folded before Flop (didn't bet)
Seat 3: PlayTheBlues4U folded before Flop (didn't bet)
Seat 4: BernieGB (button) folded before Flop (didn't bet)
Seat 5: Babu1738 (small blind) collected ($0.48)
Seat 6: DaBirds23 (big blind) folded before Flop



PokerStars Hand #205253549208:  Hold'em No Limit ($0.05/$0.10 USD) - 2019/10/29 19:15:38 ET
Table 'Ara' 6-max Seat #5 is the button
Seat 1: molahs89 ($33.40 in chips) 
Seat 2: tomasz2016 ($10.02 in chips) 
Seat 3: PlayTheBlues4U ($10 in chips) 
Seat 4: BernieGB ($11.08 in chips) 
Seat 5: Babu1738 ($10.28 in chips) 
Seat 6: DaBirds23 ($13.22 in chips) 
DaBirds23: posts small blind $0.05
molahs89: posts big blind $0.10
*** HOLE CARDS ***
Dealt to PlayTheBlues4U [9c Kc]
tomasz2016: folds 
PlayTheBlues4U: raises $0.20 to $0.30
BernieGB: folds 
Babu1738: folds 
DaBirds23: folds 
molahs89: calls $0.20
*** FLOP *** [5h 2s Th]
molahs89: bets $0.40
PlayTheBlues4U: folds 
Uncalled bet ($0.40) returned to molahs89
molahs89 collected $0.62 from pot
molahs89: doesn't show hand 
*** SUMMARY ***
Total pot $0.65 | Rake $0.03 
Board [5h 2s Th]
Seat 1: molahs89 (big blind) collected ($0.62)
Seat 2: tomasz2016 folded before Flop (didn't bet)
Seat 3: PlayTheBlues4U folded on the Flop
Seat 4: BernieGB folded before Flop (didn't bet)
Seat 5: Babu1738 (button) folded before Flop (didn't bet)
Seat 6: DaBirds23 (small blind) folded before Flop



PokerStars Hand #205253549325:  Hold'em No Limit ($0.05/$0.10 USD) - 2019/10/29 19:16:19 ET
Table 'Ara' 6-max Seat #6 is the button
Seat 1: molahs89 ($33.72 in chips) 
Seat 2: tomasz2016 ($10.02 in chips) 
Seat 3: PlayTheBlues4U ($9.70 in chips) 
Seat 4: BernieGB ($11.08 in chips) 
Seat 5: Babu1738 ($10.28 in chips) 
Seat 6: DaBirds23 ($13.17 in chips) 
molahs89: posts small blind $0.05
tomasz2016: posts big blind $0.10
*** HOLE CARDS ***
Dealt to PlayTheBlues4U [Th Qs]
PlayTheBlues4U: folds 
BernieGB: folds 
Babu1738: folds 
DaBirds23: folds 
molahs89: folds 
Uncalled bet ($0.05) returned to tomasz2016
tomasz2016 collected $0.10 from pot
tomasz2016: doesn't show hand 
*** SUMMARY ***
Total pot $0.10 | Rake $0 
Seat 1: molahs89 (small blind) folded before Flop
Seat 2: tomasz2016 (big blind) collected ($0.10)
Seat 3: PlayTheBlues4U folded before Flop (didn't bet)
Seat 4: BernieGB folded before Flop (didn't bet)
Seat 5: Babu1738 folded before Flop (didn't bet)
Seat 6: DaBirds23 (button) folded before Flop (didn't bet)



PokerStars Hand #205253549421:  Hold'em No Limit ($0.05/$0.10 USD) - 2019/10/29 19:16:52 ET
Table 'Ara' 6-max Seat #1 is the button
Seat 1: molahs89 ($33.67 in chips) 
Seat 2: tomasz2016 ($10.07 in chips) 
Seat 3: PlayTheBlues4U ($9.70 in chips) 
Seat 4: BernieGB ($11.08 in chips) 
Seat 5: Babu1738 ($10.28 in chips) 
Seat 6: DaBirds23 ($13.17 in chips) 
tomasz2016: posts small blind $0.05
PlayTheBlues4U: posts big blind $0.10
*** HOLE CARDS ***
Dealt to PlayTheBlues4U [2s Qs]
BernieGB: folds 
Babu1738: folds 
DaBirds23: raises $0.20 to $0.30
molahs89 has timed out
molahs89: folds 
tomasz2016: folds 
PlayTheBlues4U: folds 
Uncalled bet ($0.20) returned to DaBirds23
DaBirds23 collected $0.25 from pot
*** SUMMARY ***
Total pot $0.25 | Rake $0 
Seat 1: molahs89 (button) folded before Flop (didn't bet)
Seat 2: tomasz2016 (small blind) folded before Flop
Seat 3: PlayTheBlues4U (big blind) folded before Flop
Seat 4: BernieGB folded before Flop (didn't bet)
Seat 5: Babu1738 folded before Flop (didn't bet)
Seat 6: DaBirds23 collected ($0.25)



PokerStars Hand #205253549555:  Hold'em No Limit ($0.05/$0.10 USD) - 2019/10/29 19:17:40 ET
Table 'Ara' 6-max Seat #2 is the button
Seat 2: tomasz2016 ($10.02 in chips) 
Seat 3: PlayTheBlues4U ($9.60 in chips) 
Seat 4: BernieGB ($11.08 in chips) 
Seat 5: Babu1738 ($10.28 in chips) 
Seat 6: DaBirds23 ($13.32 in chips) 
PlayTheBlues4U: posts small blind $0.05
BernieGB: posts big blind $0.10
*** HOLE CARDS ***
Dealt to PlayTheBlues4U [3d 2h]
Babu1738: folds 
DaBirds23: folds 
tomasz2016: folds 
PlayTheBlues4U: folds 
Uncalled bet ($0.05) returned to BernieGB
BernieGB collected $0.10 from pot
*** SUMMARY ***
Total pot $0.10 | Rake $0 
Seat 2: tomasz2016 (button) folded before Flop (didn't bet)
Seat 3: PlayTheBlues4U (small blind) folded before Flop
Seat 4: BernieGB (big blind) collected ($0.10)
Seat 5: Babu1738 folded before Flop (didn't bet)
Seat 6: DaBirds23 folded before Flop (didn't bet)



PokerStars Hand #205253549620:  Hold'em No Limit ($0.05/$0.10 USD) - 2019/10/29 19:18:01 ET
Table 'Ara' 6-max Seat #3 is the button
Seat 2: tomasz2016 ($10.02 in chips) 
Seat 3: PlayTheBlues4U ($9.55 in chips) 
Seat 4: BernieGB ($11.13 in chips) 
Seat 5: Babu1738 ($10.28 in chips) 
Seat 6: DaBirds23 ($13.32 in chips) 
BernieGB: posts small blind $0.05
Babu1738: posts big blind $0.10
*** HOLE CARDS ***
Dealt to PlayTheBlues4U [Qc 6s]
DaBirds23: folds 
tomasz2016: raises $0.25 to $0.35
PlayTheBlues4U: folds 
BernieGB: calls $0.30
Babu1738: folds 
*** FLOP *** [7h Jh Kd]
BernieGB: bets $0.51
tomasz2016: raises $0.51 to $1.02
BernieGB: calls $0.51
*** TURN *** [7h Jh Kd] [5s]
BernieGB: checks 
tomasz2016: bets $2.70
BernieGB: folds 
Uncalled bet ($2.70) returned to tomasz2016
tomasz2016 collected $2.70 from pot
tomasz2016: doesn't show hand 
*** SUMMARY ***
Total pot $2.84 | Rake $0.14 
Board [7h Jh Kd 5s]
Seat 2: tomasz2016 collected ($2.70)
Seat 3: PlayTheBlues4U (button) folded before Flop (didn't bet)
Seat 4: BernieGB (small blind) folded on the Turn
Seat 5: Babu1738 (big blind) folded before Flop
Seat 6: DaBirds23 folded before Flop (didn't bet)



PokerStars Hand #205253549695:  Hold'em No Limit ($0.05/$0.10 USD) - 2019/10/29 19:18:27 ET
Table 'Ara' 6-max Seat #4 is the button
Seat 2: tomasz2016 ($11.35 in chips) 
Seat 3: PlayTheBlues4U ($9.55 in chips) 
Seat 4: BernieGB ($9.76 in chips) 
Seat 5: Babu1738 ($10.18 in chips) 
Seat 6: DaBirds23 ($13.32 in chips) 
Babu1738: posts small blind $0.05
DaBirds23: posts big blind $0.10
*** HOLE CARDS ***
Dealt to PlayTheBlues4U [5s Js]
tomasz2016: folds 
PlayTheBlues4U: folds 
BernieGB: raises $0.20 to $0.30
Babu1738: folds 
DaBirds23: calls $0.20
*** FLOP *** [9h Kh Ah]
DaBirds23: checks 
BernieGB: checks 
*** TURN *** [9h Kh Ah] [Ad]
DaBirds23: checks 
BernieGB: checks 
*** RIVER *** [9h Kh Ah Ad] [Jd]
DaBirds23: checks 
BernieGB: checks 
*** SHOW DOWN ***
DaBirds23: shows [8s 8h] (two pair, Aces and Eights)
BernieGB: mucks hand 
DaBirds23 collected $0.62 from pot
*** SUMMARY ***
Total pot $0.65 | Rake $0.03 
Board [9h Kh Ah Ad Jd]
Seat 2: tomasz2016 folded before Flop (didn't bet)
Seat 3: PlayTheBlues4U folded before Flop (didn't bet)
Seat 4: BernieGB (button) mucked [Qc 6c]
Seat 5: Babu1738 (small blind) folded before Flop
Seat 6: DaBirds23 (big blind) showed [8s 8h] and won ($0.62) with two pair, Aces and Eights



PokerStars Hand #205253549792:  Hold'em No Limit ($0.05/$0.10 USD) - 2019/10/29 19:18:57 ET
Table 'Ara' 6-max Seat #5 is the button
Seat 2: tomasz2016 ($11.35 in chips) 
Seat 3: PlayTheBlues4U ($9.55 in chips) 
Seat 4: BernieGB ($9.46 in chips) 
Seat 5: Babu1738 ($10.13 in chips) 
Seat 6: DaBirds23 ($13.64 in chips) 
DaBirds23: posts small blind $0.05
tomasz2016: posts big blind $0.10
*** HOLE CARDS ***
Dealt to PlayTheBlues4U [As 6d]
PlayTheBlues4U: folds 
BernieGB: calls $0.10
Babu1738: folds 
DaBirds23: folds 
tomasz2016: checks 
*** FLOP *** [9s Qh Ah]
tomasz2016: checks 
BernieGB: checks 
*** TURN *** [9s Qh Ah] [6s]
tomasz2016: checks 
BernieGB: checks 
*** RIVER *** [9s Qh Ah 6s] [2d]
tomasz2016: checks 
BernieGB: checks 
*** SHOW DOWN ***
tomasz2016: shows [9d 3c] (a pair of Nines)
BernieGB: mucks hand 
tomasz2016 collected $0.24 from pot
*** SUMMARY ***
Total pot $0.25 | Rake $0.01 
Board [9s Qh Ah 6s 2d]
Seat 2: tomasz2016 (big blind) showed [9d 3c] and won ($0.24) with a pair of Nines
Seat 3: PlayTheBlues4U folded before Flop (didn't bet)
Seat 4: BernieGB mucked [Ts Kc]
Seat 5: Babu1738 (button) folded before Flop (didn't bet)
Seat 6: DaBirds23 (small blind) folded before Flop



PokerStars Hand #205253549882:  Hold'em No Limit ($0.05/$0.10 USD) - 2019/10/29 19:19:29 ET
Table 'Ara' 6-max Seat #6 is the button
Seat 2: tomasz2016 ($11.49 in chips) 
Seat 3: PlayTheBlues4U ($9.55 in chips) 
Seat 4: BernieGB ($9.36 in chips) 
Seat 5: Babu1738 ($10.13 in chips) 
Seat 6: DaBirds23 ($13.59 in chips) 
tomasz2016: posts small blind $0.05
PlayTheBlues4U: posts big blind $0.10
*** HOLE CARDS ***
Dealt to PlayTheBlues4U [9c Kh]
BernieGB: raises $0.20 to $0.30
Babu1738: folds 
DaBirds23: folds 
tomasz2016: folds 
PlayTheBlues4U: folds 
Uncalled bet ($0.20) returned to BernieGB
BernieGB collected $0.25 from pot
*** SUMMARY ***
Total pot $0.25 | Rake $0 
Seat 2: tomasz2016 (small blind) folded before Flop
Seat 3: PlayTheBlues4U (big blind) folded before Flop
Seat 4: BernieGB collected ($0.25)
Seat 5: Babu1738 folded before Flop (didn't bet)
Seat 6: DaBirds23 (button) folded before Flop (didn't bet)



PokerStars Hand #205253549923:  Hold'em No Limit ($0.05/$0.10 USD) - 2019/10/29 19:19:43 ET
Table 'Ara' 6-max Seat #2 is the button
Seat 1: molahs89 ($33.67 in chips) 
Seat 2: tomasz2016 ($11.44 in chips) 
Seat 3: PlayTheBlues4U ($9.45 in chips) 
Seat 4: BernieGB ($9.51 in chips) 
Seat 5: Babu1738 ($10.13 in chips) 
Seat 6: DaBirds23 ($13.59 in chips) 
PlayTheBlues4U: posts small blind $0.05
BernieGB: posts big blind $0.10
molahs89: posts small & big blinds $0.15
*** HOLE CARDS ***
Dealt to PlayTheBlues4U [8h 5d]
Babu1738: folds 
DaBirds23: folds 
molahs89: checks 
tomasz2016: folds 
PlayTheBlues4U: folds 
BernieGB: checks 
*** FLOP *** [Kh Qc 6s]
BernieGB: checks 
molahs89: checks 
*** TURN *** [Kh Qc 6s] [6h]
BernieGB: checks 
molahs89: checks 
*** RIVER *** [Kh Qc 6s 6h] [Js]
BernieGB: checks 
molahs89: checks 
*** SHOW DOWN ***
BernieGB: shows [9d 2s] (a pair of Sixes)
molahs89: shows [5s 4d] (a pair of Sixes)
BernieGB collected $0.14 from pot
molahs89 collected $0.14 from pot
*** SUMMARY ***
Total pot $0.30 | Rake $0.02 
Board [Kh Qc 6s 6h Js]
Seat 1: molahs89 showed [5s 4d] and won ($0.14) with a pair of Sixes
Seat 2: tomasz2016 (button) folded before Flop (didn't bet)
Seat 3: PlayTheBlues4U (small blind) folded before Flop
Seat 4: BernieGB (big blind) showed [9d 2s] and won ($0.14) with a pair of Sixes
Seat 5: Babu1738 folded before Flop (didn't bet)
Seat 6: DaBirds23 folded before Flop (didn't bet)



PokerStars Hand #205254350942:  Hold'em No Limit ($0.05/$0.10 USD) - 2019/10/29 19:20:25 ET
Table 'Ara' 6-max Seat #3 is the button
Seat 1: molahs89 ($33.66 in chips) 
Seat 2: tomasz2016 ($11.44 in chips) 
Seat 3: PlayTheBlues4U ($9.40 in chips) 
Seat 4: BernieGB ($9.55 in chips) 
Seat 5: Babu1738 ($10.13 in chips) 
Seat 6: DaBirds23 ($13.59 in chips) 
BernieGB: posts small blind $0.05
Babu1738: posts big blind $0.10
*** HOLE CARDS ***
Dealt to PlayTheBlues4U [5d Js]
DaBirds23: folds 
molahs89: raises $0.50 to $0.60
tomasz2016: folds 
PlayTheBlues4U: folds 
BernieGB: folds 
Babu1738: folds 
Uncalled bet ($0.50) returned to molahs89
molahs89 collected $0.25 from pot
molahs89: doesn't show hand 
*** SUMMARY ***
Total pot $0.25 | Rake $0 
Seat 1: molahs89 collected ($0.25)
Seat 2: tomasz2016 folded before Flop (didn't bet)
Seat 3: PlayTheBlues4U (button) folded before Flop (didn't bet)
Seat 4: BernieGB (small blind) folded before Flop
Seat 5: Babu1738 (big blind) folded before Flop
Seat 6: DaBirds23 folded before Flop (didn't bet)



PokerStars Hand #205254351038:  Hold'em No Limit ($0.05/$0.10 USD) - 2019/10/29 19:20:57 ET
Table 'Ara' 6-max Seat #4 is the button
Seat 1: molahs89 ($33.81 in chips) 
Seat 2: tomasz2016 ($11.44 in chips) 
Seat 3: PlayTheBlues4U ($9.40 in chips) 
Seat 4: BernieGB ($9.50 in chips) 
Seat 5: Babu1738 ($10.03 in chips) 
Seat 6: DaBirds23 ($13.59 in chips) 
Babu1738: posts small blind $0.05
DaBirds23: posts big blind $0.10
*** HOLE CARDS ***
Dealt to PlayTheBlues4U [Js Ac]
molahs89: raises $0.50 to $0.60
tomasz2016: folds 
PlayTheBlues4U: folds 
BernieGB: folds 
Babu1738: folds 
DaBirds23: calls $0.50
*** FLOP *** [Jc 3h 8s]
DaBirds23: checks 
molahs89: bets $0.30
DaBirds23: raises $1.49 to $1.79
molahs89: folds 
Uncalled bet ($1.49) returned to DaBirds23
DaBirds23 collected $1.76 from pot
*** SUMMARY ***
Total pot $1.85 | Rake $0.09 
Board [Jc 3h 8s]
Seat 1: molahs89 folded on the Flop
Seat 2: tomasz2016 folded before Flop (didn't bet)
Seat 3: PlayTheBlues4U folded before Flop (didn't bet)
Seat 4: BernieGB (button) folded before Flop (didn't bet)
Seat 5: Babu1738 (small blind) folded before Flop
Seat 6: DaBirds23 (big blind) collected ($1.76)



PokerStars Hand #205254351241:  Hold'em No Limit ($0.05/$0.10 USD) - 2019/10/29 19:22:02 ET
Table 'Ara' 6-max Seat #5 is the button
Seat 1: molahs89 ($32.91 in chips) 
Seat 2: tomasz2016 ($11.44 in chips) 
Seat 3: PlayTheBlues4U ($9.40 in chips) 
Seat 4: BernieGB ($9.50 in chips) 
Seat 5: Babu1738 ($10 in chips) 
Seat 6: DaBirds23 ($14.45 in chips) 
DaBirds23: posts small blind $0.05
molahs89: posts big blind $0.10
*** HOLE CARDS ***
Dealt to PlayTheBlues4U [4c Ah]
tomasz2016: folds 
PlayTheBlues4U: folds 
BernieGB: folds 
Babu1738: folds 
DaBirds23: folds 
Uncalled bet ($0.05) returned to molahs89
molahs89 collected $0.10 from pot
molahs89: doesn't show hand 
*** SUMMARY ***
Total pot $0.10 | Rake $0 
Seat 1: molahs89 (big blind) collected ($0.10)
Seat 2: tomasz2016 folded before Flop (didn't bet)
Seat 3: PlayTheBlues4U folded before Flop (didn't bet)
Seat 4: BernieGB folded before Flop (didn't bet)
Seat 5: Babu1738 (button) folded before Flop (didn't bet)
Seat 6: DaBirds23 (small blind) folded before Flop



PokerStars Hand #205253545531:  Hold'em No Limit ($0.05/$0.10 USD) - 2019/10/29 18:51:18 ET
Table 'Ariadne' 6-max Seat #1 is the button
Seat 1: PlayTheBlues4U ($10 in chips) 
Seat 2: TonyA747 ($10 in chips) 
PlayTheBlues4U: posts small blind $0.05
TonyA747: posts big blind $0.10
*** HOLE CARDS ***
Dealt to PlayTheBlues4U [8h Kh]
PlayTheBlues4U: calls $0.05
TonyA747: checks 
*** FLOP *** [Qd 8d 8c]
TonyA747: checks 
PlayTheBlues4U: bets $0.20
TonyA747: calls $0.20
*** TURN *** [Qd 8d 8c] [Qc]
TonyA747: checks 
PlayTheBlues4U: checks 
*** RIVER *** [Qd 8d 8c Qc] [2d]
TonyA747: bets $0.30
PlayTheBlues4U: raises $0.60 to $0.90
TonyA747: raises $2.90 to $3.80
PlayTheBlues4U: calls $2.90
*** SHOW DOWN ***
TonyA747: shows [2h Qs] (a full house, Queens full of Eights)
PlayTheBlues4U: mucks hand 
TonyA747 collected $7.79 from pot
*** SUMMARY ***
Total pot $8.20 | Rake $0.41 
Board [Qd 8d 8c Qc 2d]
Seat 1: PlayTheBlues4U (button) (small blind) mucked [8h Kh]
Seat 2: TonyA747 (big blind) showed [2h Qs] and won ($7.79) with a full house, Queens full of Eights



PokerStars Hand #205253545688:  Hold'em No Limit ($0.05/$0.10 USD) - 2019/10/29 18:52:20 ET
Table 'Ariadne' 6-max Seat #2 is the button
Seat 1: PlayTheBlues4U ($10 in chips) 
Seat 2: TonyA747 ($13.69 in chips) 
TonyA747: posts small blind $0.05
PlayTheBlues4U: posts big blind $0.10
*** HOLE CARDS ***
Dealt to PlayTheBlues4U [Js 4c]
TonyA747: calls $0.05
PlayTheBlues4U said, "what a first hand lol"
PlayTheBlues4U: checks 
*** FLOP *** [Qc 2c 5s]
PlayTheBlues4U: checks 
TonyA747: bets $0.10
PlayTheBlues4U: folds 
Uncalled bet ($0.10) returned to TonyA747
TonyA747 collected $0.19 from pot
TonyA747: doesn't show hand 
*** SUMMARY ***
Total pot $0.20 | Rake $0.01 
Board [Qc 2c 5s]
Seat 1: PlayTheBlues4U (big blind) folded on the Flop
Seat 2: TonyA747 (button) (small blind) collected ($0.19)



PokerStars Hand #205253545746:  Hold'em No Limit ($0.05/$0.10 USD) - 2019/10/29 18:52:41 ET
Table 'Ariadne' 6-max Seat #1 is the button
Seat 1: PlayTheBlues4U ($9.90 in chips) 
Seat 2: TonyA747 ($13.78 in chips) 
PlayTheBlues4U: posts small blind $0.05
TonyA747: posts big blind $0.10
*** HOLE CARDS ***
Dealt to PlayTheBlues4U [7h Kh]
PlayTheBlues4U: raises $0.10 to $0.20
TonyA747: calls $0.10
*** FLOP *** [Th 3d Qd]
TonyA747: bets $0.40
PlayTheBlues4U: folds 
Uncalled bet ($0.40) returned to TonyA747
TonyA747 collected $0.38 from pot
TonyA747: doesn't show hand 
*** SUMMARY ***
Total pot $0.40 | Rake $0.02 
Board [Th 3d Qd]
Seat 1: PlayTheBlues4U (button) (small blind) folded on the Flop
Seat 2: TonyA747 (big blind) collected ($0.38)



PokerStars Hand #205253545799:  Hold'em No Limit ($0.05/$0.10 USD) - 2019/10/29 18:53:04 ET
Table 'Ariadne' 6-max Seat #2 is the button
Seat 1: PlayTheBlues4U ($9.70 in chips) 
Seat 2: TonyA747 ($13.96 in chips) 
TonyA747: posts small blind $0.05
PlayTheBlues4U: posts big blind $0.10
*** HOLE CARDS ***
Dealt to PlayTheBlues4U [9s 7c]
TonyA747: calls $0.05
PlayTheBlues4U: checks 
*** FLOP *** [4s 7d Kc]
PlayTheBlues4U: checks 
TonyA747: checks 
*** TURN *** [4s 7d Kc] [3c]
PlayTheBlues4U: bets $0.10
TonyA747: folds 
Uncalled bet ($0.10) returned to PlayTheBlues4U
PlayTheBlues4U collected $0.19 from pot
PlayTheBlues4U: doesn't show hand 
*** SUMMARY ***
Total pot $0.20 | Rake $0.01 
Board [4s 7d Kc 3c]
Seat 1: PlayTheBlues4U (big blind) collected ($0.19)
Seat 2: TonyA747 (button) (small blind) folded on the Turn



PokerStars Hand #205253545863:  Hold'em No Limit ($0.05/$0.10 USD) - 2019/10/29 18:53:27 ET
Table 'Ariadne' 6-max Seat #1 is the button
Seat 1: PlayTheBlues4U ($9.79 in chips) 
Seat 2: TonyA747 ($13.86 in chips) 
PlayTheBlues4U: posts small blind $0.05
TonyA747: posts big blind $0.10
*** HOLE CARDS ***
Dealt to PlayTheBlues4U [7s Qs]
PlayTheBlues4U: calls $0.05
TonyA747: raises $0.10 to $0.20
PlayTheBlues4U: calls $0.10
*** FLOP *** [8d 5h Td]
TonyA747: bets $0.10
PlayTheBlues4U: folds 
Uncalled bet ($0.10) returned to TonyA747
TonyA747 collected $0.38 from pot
TonyA747: doesn't show hand 
*** SUMMARY ***
Total pot $0.40 | Rake $0.02 
Board [8d 5h Td]
Seat 1: PlayTheBlues4U (button) (small blind) folded on the Flop
Seat 2: TonyA747 (big blind) collected ($0.38)



PokerStars Hand #205253545911:  Hold'em No Limit ($0.05/$0.10 USD) - 2019/10/29 18:53:47 ET
Table 'Ariadne' 6-max Seat #2 is the button
Seat 1: PlayTheBlues4U ($9.59 in chips) 
Seat 2: TonyA747 ($14.04 in chips) 
TonyA747: posts small blind $0.05
PlayTheBlues4U: posts big blind $0.10
*** HOLE CARDS ***
Dealt to PlayTheBlues4U [7c 5d]
TonyA747: folds 
Uncalled bet ($0.05) returned to PlayTheBlues4U
PlayTheBlues4U collected $0.10 from pot
PlayTheBlues4U: doesn't show hand 
*** SUMMARY ***
Total pot $0.10 | Rake $0 
Seat 1: PlayTheBlues4U (big blind) collected ($0.10)
Seat 2: TonyA747 (button) (small blind) folded before Flop



PokerStars Hand #205253545922:  Hold'em No Limit ($0.05/$0.10 USD) - 2019/10/29 18:53:53 ET
Table 'Ariadne' 6-max Seat #1 is the button
Seat 1: PlayTheBlues4U ($9.64 in chips) 
Seat 2: TonyA747 ($13.99 in chips) 
PlayTheBlues4U: posts small blind $0.05
TonyA747: posts big blind $0.10
*** HOLE CARDS ***
Dealt to PlayTheBlues4U [8s 2s]
PlayTheBlues4U: calls $0.05
TonyA747: raises $0.10 to $0.20
PlayTheBlues4U: calls $0.10
*** FLOP *** [As 7d 8d]
TonyA747: bets $0.10
PlayTheBlues4U: calls $0.10
*** TURN *** [As 7d 8d] [Ts]
TonyA747: bets $0.30
PlayTheBlues4U: calls $0.30
*** RIVER *** [As 7d 8d Ts] [9s]
TonyA747: bets $1.10
PlayTheBlues4U: raises $1.80 to $2.90
TonyA747: calls $1.80
*** SHOW DOWN ***
PlayTheBlues4U: shows [8s 2s] (a flush, Ace high)
TonyA747: mucks hand 
PlayTheBlues4U collected $6.65 from pot
*** SUMMARY ***
Total pot $7 | Rake $0.35 
Board [As 7d 8d Ts 9s]
Seat 1: PlayTheBlues4U (button) (small blind) showed [8s 2s] and won ($6.65) with a flush, Ace high
Seat 2: TonyA747 (big blind) mucked [Kc Jh]



PokerStars Hand #205253546037:  Hold'em No Limit ($0.05/$0.10 USD) - 2019/10/29 18:54:41 ET
Table 'Ariadne' 6-max Seat #2 is the button
Seat 1: PlayTheBlues4U ($12.79 in chips) 
Seat 2: TonyA747 ($10.49 in chips) 
TonyA747: posts small blind $0.05
PlayTheBlues4U: posts big blind $0.10
*** HOLE CARDS ***
Dealt to PlayTheBlues4U [Jh 2c]
TonyA747: calls $0.05
PlayTheBlues4U: checks 
*** FLOP *** [3s 2d Kd]
PlayTheBlues4U: checks 
TonyA747: checks 
*** TURN *** [3s 2d Kd] [4h]
PlayTheBlues4U: bets $0.10
TonyA747: raises $0.40 to $0.50
PlayTheBlues4U: folds 
Uncalled bet ($0.40) returned to TonyA747
TonyA747 collected $0.38 from pot
TonyA747: doesn't show hand 
*** SUMMARY ***
Total pot $0.40 | Rake $0.02 
Board [3s 2d Kd 4h]
Seat 1: PlayTheBlues4U (big blind) folded on the Turn
Seat 2: TonyA747 (button) (small blind) collected ($0.38)



PokerStars Hand #205253546095:  Hold'em No Limit ($0.05/$0.10 USD) - 2019/10/29 18:55:04 ET
Table 'Ariadne' 6-max Seat #1 is the button
Seat 1: PlayTheBlues4U ($12.59 in chips) 
Seat 2: TonyA747 ($10.67 in chips) 
PlayTheBlues4U: posts small blind $0.05
TonyA747: posts big blind $0.10
*** HOLE CARDS ***
Dealt to PlayTheBlues4U [4s Ac]
PlayTheBlues4U: raises $0.10 to $0.20
TonyA747: calls $0.10
*** FLOP *** [6c Qh As]
TonyA747: checks 
PlayTheBlues4U: bets $0.30
TonyA747: folds 
Uncalled bet ($0.30) returned to PlayTheBlues4U
PlayTheBlues4U collected $0.38 from pot
PlayTheBlues4U: doesn't show hand 
*** SUMMARY ***
Total pot $0.40 | Rake $0.02 
Board [6c Qh As]
Seat 1: PlayTheBlues4U (button) (small blind) collected ($0.38)
Seat 2: TonyA747 (big blind) folded on the Flop



PokerStars Hand #205253546155:  Hold'em No Limit ($0.05/$0.10 USD) - 2019/10/29 18:55:30 ET
Table 'Ariadne' 6-max Seat #2 is the button
Seat 1: PlayTheBlues4U ($12.77 in chips) 
Seat 2: TonyA747 ($10.47 in chips) 
TonyA747: posts small blind $0.05
PlayTheBlues4U: posts big blind $0.10
*** HOLE CARDS ***
Dealt to PlayTheBlues4U [Ad Th]
TonyA747: calls $0.05
PlayTheBlues4U: raises $0.30 to $0.40
TonyA747: calls $0.30
*** FLOP *** [3c 4h Jd]
PlayTheBlues4U: checks 
TonyA747: bets $0.80
PlayTheBlues4U: calls $0.80
*** TURN *** [3c 4h Jd] [Tc]
PlayTheBlues4U: checks 
TonyA747: checks 
*** RIVER *** [3c 4h Jd Tc] [7d]
PlayTheBlues4U: checks 
TonyA747: bets $2.30
PlayTheBlues4U: calls $2.30
*** SHOW DOWN ***
TonyA747: shows [3h 5h] (a pair of Threes)
PlayTheBlues4U: shows [Ad Th] (a pair of Tens)
PlayTheBlues4U collected $6.65 from pot
*** SUMMARY ***
Total pot $7 | Rake $0.35 
Board [3c 4h Jd Tc 7d]
Seat 1: PlayTheBlues4U (big blind) showed [Ad Th] and won ($6.65) with a pair of Tens
Seat 2: TonyA747 (button) (small blind) showed [3h 5h] and lost with a pair of Threes



PokerStars Hand #205253546295:  Hold'em No Limit ($0.05/$0.10 USD) - 2019/10/29 18:56:31 ET
Table 'Ariadne' 6-max Seat #1 is the button
Seat 1: PlayTheBlues4U ($15.92 in chips) 
Seat 2: TonyA747 ($6.97 in chips) 
PlayTheBlues4U: posts small blind $0.05
TonyA747: posts big blind $0.10
*** HOLE CARDS ***
Dealt to PlayTheBlues4U [9c 9h]
PlayTheBlues4U: raises $0.20 to $0.30
TonyA747: raises $0.60 to $0.90
PlayTheBlues4U: raises $1.20 to $2.10
TonyA747: raises $4.87 to $6.97 and is all-in
PlayTheBlues4U: calls $4.87
*** FLOP *** [3c Qd 3s]
*** TURN *** [3c Qd 3s] [Ts]
*** RIVER *** [3c Qd 3s Ts] [7h]
*** SHOW DOWN ***
TonyA747: shows [8c Ad] (a pair of Threes)
PlayTheBlues4U: shows [9c 9h] (two pair, Nines and Threes)
PlayTheBlues4U collected $13.44 from pot
*** SUMMARY ***
Total pot $13.94 | Rake $0.50 
Board [3c Qd 3s Ts 7h]
Seat 1: PlayTheBlues4U (button) (small blind) showed [9c 9h] and won ($13.44) with two pair, Nines and Threes
Seat 2: TonyA747 (big blind) showed [8c Ad] and lost with a pair of Threes



PokerStars Hand #205253548198:  Hold'em No Limit ($0.05/$0.10 USD) - 2019/10/29 19:09:23 ET
Table 'Ariadne' 6-max Seat #4 is the button
Seat 1: PlayTheBlues4U ($22.39 in chips) 
Seat 2: peteypete911 ($8.21 in chips) 
Seat 4: redand66 ($6.67 in chips) 
Seat 6: Bullseye 170 ($10.14 in chips) 
Bullseye 170: posts small blind $0.05
PlayTheBlues4U: posts big blind $0.10
*** HOLE CARDS ***
Dealt to PlayTheBlues4U [8h 9d]
peteypete911: folds 
redand66: folds 
Bullseye 170: folds 
Uncalled bet ($0.05) returned to PlayTheBlues4U
PlayTheBlues4U collected $0.10 from pot
PlayTheBlues4U: doesn't show hand 
*** SUMMARY ***
Total pot $0.10 | Rake $0 
Seat 1: PlayTheBlues4U (big blind) collected ($0.10)
Seat 2: peteypete911 folded before Flop (didn't bet)
Seat 4: redand66 (button) folded before Flop (didn't bet)
Seat 6: Bullseye 170 (small blind) folded before Flop



PokerStars Hand #205253548216:  Hold'em No Limit ($0.05/$0.10 USD) - 2019/10/29 19:09:31 ET
Table 'Ariadne' 6-max Seat #6 is the button
Seat 1: PlayTheBlues4U ($22.44 in chips) 
Seat 2: peteypete911 ($8.21 in chips) 
Seat 4: redand66 ($6.67 in chips) 
Seat 6: Bullseye 170 ($10.09 in chips) 
PlayTheBlues4U: posts small blind $0.05
peteypete911: posts big blind $0.10
*** HOLE CARDS ***
Dealt to PlayTheBlues4U [Js 8d]
redand66: calls $0.10
Bullseye 170: folds 
PlayTheBlues4U: folds 
peteypete911: checks 
*** FLOP *** [Tc 2h 8c]
peteypete911: checks 
redand66: bets $0.10
peteypete911: folds 
Uncalled bet ($0.10) returned to redand66
redand66 collected $0.24 from pot
redand66: doesn't show hand 
*** SUMMARY ***
Total pot $0.25 | Rake $0.01 
Board [Tc 2h 8c]
Seat 1: PlayTheBlues4U (small blind) folded before Flop
Seat 2: peteypete911 (big blind) folded on the Flop
Seat 4: redand66 collected ($0.24)
Seat 6: Bullseye 170 (button) folded before Flop (didn't bet)



PokerStars Hand #205253548275:  Hold'em No Limit ($0.05/$0.10 USD) - 2019/10/29 19:09:54 ET
Table 'Ariadne' 6-max Seat #1 is the button
Seat 1: PlayTheBlues4U ($22.39 in chips) 
Seat 2: peteypete911 ($8.11 in chips) 
Seat 4: redand66 ($6.81 in chips) 
Seat 6: Bullseye 170 ($10.09 in chips) 
peteypete911: posts small blind $0.05
redand66: posts big blind $0.10
*** HOLE CARDS ***
Dealt to PlayTheBlues4U [7h 4h]
Bullseye 170: folds 
PlayTheBlues4U: folds 
peteypete911: calls $0.05
redand66: checks 
*** FLOP *** [Qs Qc 8c]
peteypete911: checks 
redand66: checks 
*** TURN *** [Qs Qc 8c] [3h]
peteypete911: checks 
redand66: bets $0.10
peteypete911: folds 
Uncalled bet ($0.10) returned to redand66
redand66 collected $0.19 from pot
redand66: doesn't show hand 
*** SUMMARY ***
Total pot $0.20 | Rake $0.01 
Board [Qs Qc 8c 3h]
Seat 1: PlayTheBlues4U (button) folded before Flop (didn't bet)
Seat 2: peteypete911 (small blind) folded on the Turn
Seat 4: redand66 (big blind) collected ($0.19)
Seat 6: Bullseye 170 folded before Flop (didn't bet)



PokerStars Hand #205253548370:  Hold'em No Limit ($0.05/$0.10 USD) - 2019/10/29 19:10:31 ET
Table 'Ariadne' 6-max Seat #2 is the button
Seat 1: PlayTheBlues4U ($22.39 in chips) 
Seat 2: peteypete911 ($8.01 in chips) 
Seat 4: redand66 ($6.90 in chips) 
Seat 6: Bullseye 170 ($10.09 in chips) 
redand66: posts small blind $0.05
Bullseye 170: posts big blind $0.10
*** HOLE CARDS ***
Dealt to PlayTheBlues4U [4d Js]
PlayTheBlues4U: folds 
peteypete911: folds 
redand66: calls $0.05
Bullseye 170: raises $0.30 to $0.40
redand66: folds 
Uncalled bet ($0.30) returned to Bullseye 170
Bullseye 170 collected $0.20 from pot
*** SUMMARY ***
Total pot $0.20 | Rake $0 
Seat 1: PlayTheBlues4U folded before Flop (didn't bet)
Seat 2: peteypete911 (button) folded before Flop (didn't bet)
Seat 4: redand66 (small blind) folded before Flop
Seat 6: Bullseye 170 (big blind) collected ($0.20)



PokerStars Hand #205253548398:  Hold'em No Limit ($0.05/$0.10 USD) - 2019/10/29 19:10:42 ET
Table 'Ariadne' 6-max Seat #4 is the button
Seat 1: PlayTheBlues4U ($22.39 in chips) 
Seat 2: peteypete911 ($8.01 in chips) 
Seat 4: redand66 ($6.80 in chips) 
Seat 6: Bullseye 170 ($10.19 in chips) 
Bullseye 170: posts small blind $0.05
PlayTheBlues4U: posts big blind $0.10
*** HOLE CARDS ***
Dealt to PlayTheBlues4U [Qd 4d]
peteypete911: calls $0.10
redand66: folds 
Bullseye 170: raises $0.40 to $0.50
PlayTheBlues4U: folds 
peteypete911: calls $0.40
*** FLOP *** [6h 8c Jh]
Bullseye 170: bets $0.70
peteypete911: calls $0.70
*** TURN *** [6h 8c Jh] [9d]
Bullseye 170: bets $1.19
peteypete911: folds 
Uncalled bet ($1.19) returned to Bullseye 170
Bullseye 170 collected $2.38 from pot
*** SUMMARY ***
Total pot $2.50 | Rake $0.12 
Board [6h 8c Jh 9d]
Seat 1: PlayTheBlues4U (big blind) folded before Flop
Seat 2: peteypete911 folded on the Turn
Seat 4: redand66 (button) folded before Flop (didn't bet)
Seat 6: Bullseye 170 (small blind) collected ($2.38)



PokerStars Hand #205253548472:  Hold'em No Limit ($0.05/$0.10 USD) - 2019/10/29 19:11:10 ET
Table 'Ariadne' 6-max Seat #6 is the button
Seat 1: PlayTheBlues4U ($22.29 in chips) 
Seat 2: peteypete911 ($6.81 in chips) 
Seat 4: redand66 ($6.80 in chips) 
Seat 6: Bullseye 170 ($11.37 in chips) 
PlayTheBlues4U: posts small blind $0.05
peteypete911: posts big blind $0.10
*** HOLE CARDS ***
Dealt to PlayTheBlues4U [4d Qc]
redand66: calls $0.10
Bullseye 170: folds 
PlayTheBlues4U: folds 
peteypete911: checks 
*** FLOP *** [2c Tc 3h]
peteypete911: checks 
redand66: bets $0.10
peteypete911: folds 
Uncalled bet ($0.10) returned to redand66
redand66 collected $0.24 from pot
redand66: doesn't show hand 
*** SUMMARY ***
Total pot $0.25 | Rake $0.01 
Board [2c Tc 3h]
Seat 1: PlayTheBlues4U (small blind) folded before Flop
Seat 2: peteypete911 (big blind) folded on the Flop
Seat 4: redand66 collected ($0.24)
Seat 6: Bullseye 170 (button) folded before Flop (didn't bet)



PokerStars Hand #205253548508:  Hold'em No Limit ($0.05/$0.10 USD) - 2019/10/29 19:11:25 ET
Table 'Ariadne' 6-max Seat #1 is the button
Seat 1: PlayTheBlues4U ($22.24 in chips) 
Seat 2: peteypete911 ($6.71 in chips) 
Seat 4: redand66 ($6.94 in chips) 
Seat 6: Bullseye 170 ($11.37 in chips) 
peteypete911: posts small blind $0.05
redand66: posts big blind $0.10
*** HOLE CARDS ***
Dealt to PlayTheBlues4U [7c 6h]
Bullseye 170: folds 
PlayTheBlues4U: calls $0.10
peteypete911: calls $0.05
redand66: checks 
*** FLOP *** [8h 8s 4d]
peteypete911: bets $0.10
redand66: folds 
PlayTheBlues4U: folds 
Uncalled bet ($0.10) returned to peteypete911
peteypete911 collected $0.28 from pot
peteypete911: doesn't show hand 
*** SUMMARY ***
Total pot $0.30 | Rake $0.02 
Board [8h 8s 4d]
Seat 1: PlayTheBlues4U (button) folded on the Flop
Seat 2: peteypete911 (small blind) collected ($0.28)
Seat 4: redand66 (big blind) folded on the Flop
Seat 6: Bullseye 170 folded before Flop (didn't bet)



PokerStars Hand #205253548604:  Hold'em No Limit ($0.05/$0.10 USD) - 2019/10/29 19:12:01 ET
Table 'Ariadne' 6-max Seat #2 is the button
Seat 1: PlayTheBlues4U ($22.14 in chips) 
Seat 2: peteypete911 ($6.89 in chips) 
Seat 4: redand66 ($6.84 in chips) 
Seat 6: Bullseye 170 ($11.37 in chips) 
redand66: posts small blind $0.05
Bullseye 170: posts big blind $0.10
*** HOLE CARDS ***
Dealt to PlayTheBlues4U [8c 9s]
PlayTheBlues4U: folds 
peteypete911: folds 
BearMike1 joins the table at seat #5 
redand66: folds 
Uncalled bet ($0.05) returned to Bullseye 170
Bullseye 170 collected $0.10 from pot
*** SUMMARY ***
Total pot $0.10 | Rake $0 
Seat 1: PlayTheBlues4U folded before Flop (didn't bet)
Seat 2: peteypete911 (button) folded before Flop (didn't bet)
Seat 4: redand66 (small blind) folded before Flop
Seat 6: Bullseye 170 (big blind) collected ($0.10)



PokerStars Hand #205253548623:  Hold'em No Limit ($0.05/$0.10 USD) - 2019/10/29 19:12:09 ET
Table 'Ariadne' 6-max Seat #4 is the button
Seat 1: PlayTheBlues4U ($22.14 in chips) 
Seat 2: peteypete911 ($6.89 in chips) 
Seat 4: redand66 ($6.79 in chips) 
Seat 6: Bullseye 170 ($11.42 in chips) 
Bullseye 170: posts small blind $0.05
PlayTheBlues4U: posts big blind $0.10
*** HOLE CARDS ***
Dealt to PlayTheBlues4U [5h Ah]
peteypete911: calls $0.10
redand66: calls $0.10
Bullseye 170: folds 
PlayTheBlues4U: checks 
*** FLOP *** [Td 6d 4d]
PlayTheBlues4U: checks 
peteypete911: bets $0.10
redand66: raises $0.10 to $0.20
PlayTheBlues4U: folds 
peteypete911: calls $0.10
*** TURN *** [Td 6d 4d] [8h]
peteypete911: bets $0.20
redand66: raises $0.20 to $0.40
peteypete911: calls $0.20
*** RIVER *** [Td 6d 4d 8h] [9h]
peteypete911: checks 
redand66: bets $0.40
peteypete911: calls $0.40
*** SHOW DOWN ***
redand66: shows [Kd Kh] (a pair of Kings)
peteypete911: shows [8s Th] (two pair, Tens and Eights)
peteypete911 collected $2.23 from pot
*** SUMMARY ***
Total pot $2.35 | Rake $0.12 
Board [Td 6d 4d 8h 9h]
Seat 1: PlayTheBlues4U (big blind) folded on the Flop
Seat 2: peteypete911 showed [8s Th] and won ($2.23) with two pair, Tens and Eights
Seat 4: redand66 (button) showed [Kd Kh] and lost with a pair of Kings
Seat 6: Bullseye 170 (small blind) folded before Flop



PokerStars Hand #205253548745:  Hold'em No Limit ($0.05/$0.10 USD) - 2019/10/29 19:12:54 ET
Table 'Ariadne' 6-max Seat #6 is the button
Seat 1: PlayTheBlues4U ($22.04 in chips) 
Seat 2: peteypete911 ($8.02 in chips) 
Seat 4: redand66 ($5.69 in chips) 
Seat 6: Bullseye 170 ($11.37 in chips) 
PlayTheBlues4U: posts small blind $0.05
peteypete911: posts big blind $0.10
BearMike1: sits out 
*** HOLE CARDS ***
Dealt to PlayTheBlues4U [As 6h]
redand66: folds 
Bullseye 170: folds 
PlayTheBlues4U: calls $0.05
peteypete911: raises $0.20 to $0.30
PlayTheBlues4U: folds 
Uncalled bet ($0.20) returned to peteypete911
peteypete911 collected $0.20 from pot
peteypete911: doesn't show hand 
*** SUMMARY ***
Total pot $0.20 | Rake $0 
Seat 1: PlayTheBlues4U (small blind) folded before Flop
Seat 2: peteypete911 (big blind) collected ($0.20)
Seat 4: redand66 folded before Flop (didn't bet)
Seat 6: Bullseye 170 (button) folded before Flop (didn't bet)



PokerStars Hand #205253548816:  Hold'em No Limit ($0.05/$0.10 USD) - 2019/10/29 19:13:16 ET
Table 'Ariadne' 6-max Seat #1 is the button
Seat 1: PlayTheBlues4U ($21.94 in chips) 
Seat 2: peteypete911 ($8.12 in chips) 
Seat 4: redand66 ($5.69 in chips) 
Seat 6: Bullseye 170 ($11.37 in chips) 
peteypete911: posts small blind $0.05
redand66: posts big blind $0.10
BearMike1: sits out 
*** HOLE CARDS ***
Dealt to PlayTheBlues4U [As Tc]
Bullseye 170: raises $0.20 to $0.30
PlayTheBlues4U: calls $0.30
peteypete911: folds 
redand66: calls $0.20
*** FLOP *** [9d 2h Kc]
redand66: checks 
Bullseye 170: checks 
PlayTheBlues4U: checks 
*** TURN *** [9d 2h Kc] [5c]
redand66: bets $0.30
Bullseye 170: folds 
PlayTheBlues4U: folds 
Uncalled bet ($0.30) returned to redand66
redand66 collected $0.90 from pot
redand66: doesn't show hand 
*** SUMMARY ***
Total pot $0.95 | Rake $0.05 
Board [9d 2h Kc 5c]
Seat 1: PlayTheBlues4U (button) folded on the Turn
Seat 2: peteypete911 (small blind) folded before Flop
Seat 4: redand66 (big blind) collected ($0.90)
Seat 6: Bullseye 170 folded on the Turn



PokerStars Hand #205253548907:  Hold'em No Limit ($0.05/$0.10 USD) - 2019/10/29 19:13:50 ET
Table 'Ariadne' 6-max Seat #2 is the button
Seat 1: PlayTheBlues4U ($21.64 in chips) 
Seat 2: peteypete911 ($8.07 in chips) 
Seat 4: redand66 ($6.29 in chips) 
Seat 5: BearMike1 ($8 in chips) 
Seat 6: Bullseye 170 ($11.07 in chips) 
redand66: posts small blind $0.05
BearMike1: posts big blind $0.10
*** HOLE CARDS ***
Dealt to PlayTheBlues4U [5c 8s]
Bullseye 170: folds 
PlayTheBlues4U: folds 
peteypete911: folds 
redand66: calls $0.05
dawnyp joins the table at seat #3 
BearMike1: checks 
*** FLOP *** [5s Qs 4s]
redand66: checks 
BearMike1: checks 
*** TURN *** [5s Qs 4s] [As]
redand66: bets $0.30
BearMike1: calls $0.30
*** RIVER *** [5s Qs 4s As] [Qc]
redand66: checks 
BearMike1: checks 
*** SHOW DOWN ***
redand66: shows [Td 2c] (a pair of Queens)
BearMike1: shows [2s 8h] (a flush, Ace high)
BearMike1 collected $0.76 from pot
*** SUMMARY ***
Total pot $0.80 | Rake $0.04 
Board [5s Qs 4s As Qc]
Seat 1: PlayTheBlues4U folded before Flop (didn't bet)
Seat 2: peteypete911 (button) folded before Flop (didn't bet)
Seat 4: redand66 (small blind) showed [Td 2c] and lost with a pair of Queens
Seat 5: BearMike1 (big blind) showed [2s 8h] and won ($0.76) with a flush, Ace high
Seat 6: Bullseye 170 folded before Flop (didn't bet)



PokerStars Hand #205253549015:  Hold'em No Limit ($0.05/$0.10 USD) - 2019/10/29 19:14:26 ET
Table 'Ariadne' 6-max Seat #4 is the button
Seat 1: PlayTheBlues4U ($21.64 in chips) 
Seat 2: peteypete911 ($8.07 in chips) 
Seat 3: dawnyp ($8 in chips) 
Seat 4: redand66 ($5.89 in chips) 
Seat 5: BearMike1 ($8.36 in chips) 
Seat 6: Bullseye 170 ($11.07 in chips) 
BearMike1: posts small blind $0.05
Bullseye 170: posts big blind $0.10
dawnyp: posts big blind $0.10
*** HOLE CARDS ***
Dealt to PlayTheBlues4U [4s 3h]
PlayTheBlues4U: folds 
peteypete911: calls $0.10
dawnyp: checks 
redand66: folds 
BearMike1: calls $0.05
Bullseye 170: checks 
*** FLOP *** [9c 9d 7h]
BearMike1: checks 
Bullseye 170: checks 
peteypete911: checks 
dawnyp: checks 
*** TURN *** [9c 9d 7h] [4d]
BearMike1: checks 
Bullseye 170: checks 
peteypete911: checks 
dawnyp: checks 
*** RIVER *** [9c 9d 7h 4d] [Qs]
BearMike1: checks 
Bullseye 170: checks 
peteypete911: checks 
dawnyp: checks 
*** SHOW DOWN ***
BearMike1: shows [5d Qh] (two pair, Queens and Nines)
Bullseye 170: mucks hand 
peteypete911: shows [8c Qc] (two pair, Queens and Nines - Eight kicker)
dawnyp: mucks hand 
peteypete911 collected $0.38 from pot
*** SUMMARY ***
Total pot $0.40 | Rake $0.02 
Board [9c 9d 7h 4d Qs]
Seat 1: PlayTheBlues4U folded before Flop (didn't bet)
Seat 2: peteypete911 showed [8c Qc] and won ($0.38) with two pair, Queens and Nines
Seat 3: dawnyp mucked [Td Jh]
Seat 4: redand66 (button) folded before Flop (didn't bet)
Seat 5: BearMike1 (small blind) showed [5d Qh] and lost with two pair, Queens and Nines
Seat 6: Bullseye 170 (big blind) mucked [Ad Js]



PokerStars Hand #205253549179:  Hold'em No Limit ($0.05/$0.10 USD) - 2019/10/29 19:15:29 ET
Table 'Ariadne' 6-max Seat #5 is the button
Seat 1: PlayTheBlues4U ($21.64 in chips) 
Seat 2: peteypete911 ($8.35 in chips) 
Seat 3: dawnyp ($7.90 in chips) 
Seat 4: redand66 ($5.89 in chips) 
Seat 5: BearMike1 ($8.26 in chips) 
Seat 6: Bullseye 170 ($10.97 in chips) 
Bullseye 170: posts small blind $0.05
PlayTheBlues4U: posts big blind $0.10
*** HOLE CARDS ***
Dealt to PlayTheBlues4U [5c 8h]
peteypete911: folds 
dawnyp: raises $0.10 to $0.20
redand66: folds 
BearMike1: calls $0.20
Bullseye 170: folds 
PlayTheBlues4U: calls $0.10
*** FLOP *** [Jc 8c Ks]
PlayTheBlues4U: checks 
dawnyp: bets $0.10
BearMike1: folds 
PlayTheBlues4U: folds 
Uncalled bet ($0.10) returned to dawnyp
dawnyp collected $0.62 from pot
dawnyp: doesn't show hand 
*** SUMMARY ***
Total pot $0.65 | Rake $0.03 
Board [Jc 8c Ks]
Seat 1: PlayTheBlues4U (big blind) folded on the Flop
Seat 2: peteypete911 folded before Flop (didn't bet)
Seat 3: dawnyp collected ($0.62)
Seat 4: redand66 folded before Flop (didn't bet)
Seat 5: BearMike1 (button) folded on the Flop
Seat 6: Bullseye 170 (small blind) folded before Flop



PokerStars Hand #205253549281:  Hold'em No Limit ($0.05/$0.10 USD) - 2019/10/29 19:16:04 ET
Table 'Ariadne' 6-max Seat #6 is the button
Seat 1: PlayTheBlues4U ($21.44 in chips) 
Seat 2: peteypete911 ($8.35 in chips) 
Seat 3: dawnyp ($8.32 in chips) 
Seat 4: redand66 ($5.89 in chips) 
Seat 5: BearMike1 ($8.06 in chips) 
Seat 6: Bullseye 170 ($10.92 in chips) 
PlayTheBlues4U: posts small blind $0.05
peteypete911: posts big blind $0.10
*** HOLE CARDS ***
Dealt to PlayTheBlues4U [8s 5h]
dawnyp: folds 
redand66: folds 
BearMike1: calls $0.10
Bullseye 170: folds 
PlayTheBlues4U: folds 
peteypete911: checks 
*** FLOP *** [Ad 8h Js]
peteypete911: bets $0.20
BearMike1: folds 
Uncalled bet ($0.20) returned to peteypete911
peteypete911 collected $0.24 from pot
peteypete911: doesn't show hand 
*** SUMMARY ***
Total pot $0.25 | Rake $0.01 
Board [Ad 8h Js]
Seat 1: PlayTheBlues4U (small blind) folded before Flop
Seat 2: peteypete911 (big blind) collected ($0.24)
Seat 3: dawnyp folded before Flop (didn't bet)
Seat 4: redand66 folded before Flop (didn't bet)
Seat 5: BearMike1 folded on the Flop
Seat 6: Bullseye 170 (button) folded before Flop (didn't bet)



PokerStars Hand #205253549368:  Hold'em No Limit ($0.05/$0.10 USD) - 2019/10/29 19:16:34 ET
Table 'Ariadne' 6-max Seat #1 is the button
Seat 1: PlayTheBlues4U ($21.39 in chips) 
Seat 2: peteypete911 ($8.49 in chips) 
Seat 3: dawnyp ($8.32 in chips) 
Seat 4: redand66 ($5.89 in chips) 
Seat 5: BearMike1 ($7.96 in chips) 
Seat 6: Bullseye 170 ($10.92 in chips) 
peteypete911: posts small blind $0.05
dawnyp: posts big blind $0.10
*** HOLE CARDS ***
Dealt to PlayTheBlues4U [6h 9c]
redand66: calls $0.10
BearMike1: raises $0.30 to $0.40
Bullseye 170: folds 
PlayTheBlues4U: folds 
peteypete911: folds 
dawnyp: raises $0.30 to $0.70
redand66: folds 
BearMike1: calls $0.30
*** FLOP *** [Qd As 7c]
dawnyp: checks 
BearMike1: checks 
*** TURN *** [Qd As 7c] [Jd]
dawnyp: bets $0.10
BearMike1: calls $0.10
*** RIVER *** [Qd As 7c Jd] [6s]
dawnyp: checks 
BearMike1: checks 
*** SHOW DOWN ***
dawnyp: shows [Kc Ts] (a straight, Ten to Ace)
BearMike1: mucks hand 
dawnyp collected $1.66 from pot
*** SUMMARY ***
Total pot $1.75 | Rake $0.09 
Board [Qd As 7c Jd 6s]
Seat 1: PlayTheBlues4U (button) folded before Flop (didn't bet)
Seat 2: peteypete911 (small blind) folded before Flop
Seat 3: dawnyp (big blind) showed [Kc Ts] and won ($1.66) with a straight, Ten to Ace
Seat 4: redand66 folded before Flop
Seat 5: BearMike1 mucked [9h Ah]
Seat 6: Bullseye 170 folded before Flop (didn't bet)



PokerStars Hand #205253549450:  Hold'em No Limit ($0.05/$0.10 USD) - 2019/10/29 19:17:05 ET
Table 'Ariadne' 6-max Seat #2 is the button
Seat 1: PlayTheBlues4U ($21.39 in chips) 
Seat 2: peteypete911 ($8.44 in chips) 
Seat 3: dawnyp ($9.18 in chips) 
Seat 4: redand66 ($5.79 in chips) 
Seat 5: BearMike1 ($7.16 in chips) 
Seat 6: Bullseye 170 ($10.92 in chips) 
dawnyp: posts small blind $0.05
redand66: posts big blind $0.10
*** HOLE CARDS ***
Dealt to PlayTheBlues4U [Jh 9h]
BearMike1: folds 
Bullseye 170: raises $0.20 to $0.30
PlayTheBlues4U: folds 
peteypete911: calls $0.30
dawnyp: folds 
redand66: folds 
*** FLOP *** [Ks 8s 2h]
Bullseye 170: bets $0.60
peteypete911: calls $0.60
*** TURN *** [Ks 8s 2h] [6h]
Bullseye 170: bets $1.40
peteypete911: folds 
Uncalled bet ($1.40) returned to Bullseye 170
Bullseye 170 collected $1.85 from pot
*** SUMMARY ***
Total pot $1.95 | Rake $0.10 
Board [Ks 8s 2h 6h]
Seat 1: PlayTheBlues4U folded before Flop (didn't bet)
Seat 2: peteypete911 (button) folded on the Turn
Seat 3: dawnyp (small blind) folded before Flop
Seat 4: redand66 (big blind) folded before Flop
Seat 5: BearMike1 folded before Flop (didn't bet)
Seat 6: Bullseye 170 collected ($1.85)



PokerStars Hand #205253549543:  Hold'em No Limit ($0.05/$0.10 USD) - 2019/10/29 19:17:36 ET
Table 'Ariadne' 6-max Seat #3 is the button
Seat 1: PlayTheBlues4U ($21.39 in chips) 
Seat 2: peteypete911 ($7.54 in chips) 
Seat 3: dawnyp ($9.13 in chips) 
Seat 4: redand66 ($5.69 in chips) 
Seat 5: BearMike1 ($7.16 in chips) 
Seat 6: Bullseye 170 ($11.87 in chips) 
redand66: posts small blind $0.05
BearMike1: posts big blind $0.10
*** HOLE CARDS ***
Dealt to PlayTheBlues4U [3c 5d]
Bullseye 170: folds 
PlayTheBlues4U: folds 
peteypete911: calls $0.10
dawnyp: folds 
redand66: calls $0.05
BearMike1: checks 
*** FLOP *** [7d 4c Ks]
redand66: bets $0.10
BearMike1: folds 
peteypete911: folds 
Uncalled bet ($0.10) returned to redand66
redand66 collected $0.28 from pot
redand66: doesn't show hand 
*** SUMMARY ***
Total pot $0.30 | Rake $0.02 
Board [7d 4c Ks]
Seat 1: PlayTheBlues4U folded before Flop (didn't bet)
Seat 2: peteypete911 folded on the Flop
Seat 3: dawnyp (button) folded before Flop (didn't bet)
Seat 4: redand66 (small blind) collected ($0.28)
Seat 5: BearMike1 (big blind) folded on the Flop
Seat 6: Bullseye 170 folded before Flop (didn't bet)



PokerStars Hand #205253549599:  Hold'em No Limit ($0.05/$0.10 USD) - 2019/10/29 19:17:56 ET
Table 'Ariadne' 6-max Seat #4 is the button
Seat 1: PlayTheBlues4U ($21.39 in chips) 
Seat 2: peteypete911 ($7.44 in chips) 
Seat 3: dawnyp ($9.13 in chips) 
Seat 4: redand66 ($5.87 in chips) 
Seat 5: BearMike1 ($7.06 in chips) 
Seat 6: Bullseye 170 ($11.87 in chips) 
BearMike1: posts small blind $0.05
Bullseye 170: posts big blind $0.10
*** HOLE CARDS ***
Dealt to PlayTheBlues4U [Jc 8d]
PlayTheBlues4U: folds 
peteypete911: calls $0.10
dawnyp: folds 
redand66: folds 
BearMike1: calls $0.05
Bullseye 170: checks 
*** FLOP *** [4h 6c Qc]
BearMike1: checks 
Bullseye 170: checks 
peteypete911: checks 
*** TURN *** [4h 6c Qc] [Ah]
BearMike1: checks 
Bullseye 170: bets $0.28
peteypete911: folds 
BearMike1: folds 
Uncalled bet ($0.28) returned to Bullseye 170
Bullseye 170 collected $0.28 from pot
*** SUMMARY ***
Total pot $0.30 | Rake $0.02 
Board [4h 6c Qc Ah]
Seat 1: PlayTheBlues4U folded before Flop (didn't bet)
Seat 2: peteypete911 folded on the Turn
Seat 3: dawnyp folded before Flop (didn't bet)
Seat 4: redand66 (button) folded before Flop (didn't bet)
Seat 5: BearMike1 (small blind) folded on the Turn
Seat 6: Bullseye 170 (big blind) collected ($0.28)



PokerStars Hand #205253549720:  Hold'em No Limit ($0.05/$0.10 USD) - 2019/10/29 19:18:33 ET
Table 'Ariadne' 6-max Seat #5 is the button
Seat 1: PlayTheBlues4U ($21.39 in chips) 
Seat 2: peteypete911 ($7.34 in chips) 
Seat 3: dawnyp ($9.13 in chips) 
Seat 4: redand66 ($5.87 in chips) 
Seat 5: BearMike1 ($6.96 in chips) 
Seat 6: Bullseye 170 ($12.05 in chips) 
Bullseye 170: posts small blind $0.05
PlayTheBlues4U: posts big blind $0.10
*** HOLE CARDS ***
Dealt to PlayTheBlues4U [Kd Ks]
peteypete911: folds 
dawnyp: folds 
redand66: calls $0.10
BearMike1: folds 
Bullseye 170: folds 
PlayTheBlues4U: raises $0.30 to $0.40
redand66: calls $0.30
*** FLOP *** [Ac 3c Td]
PlayTheBlues4U: checks 
redand66: checks 
*** TURN *** [Ac 3c Td] [4d]
PlayTheBlues4U: checks 
redand66: bets $0.40
PlayTheBlues4U: calls $0.40
*** RIVER *** [Ac 3c Td 4d] [8s]
PlayTheBlues4U: checks 
redand66: bets $0.50
PlayTheBlues4U: calls $0.50
*** SHOW DOWN ***
redand66: shows [4h Ah] (two pair, Aces and Fours)
PlayTheBlues4U: mucks hand 
redand66 collected $2.52 from pot
*** SUMMARY ***
Total pot $2.65 | Rake $0.13 
Board [Ac 3c Td 4d 8s]
Seat 1: PlayTheBlues4U (big blind) mucked [Kd Ks]
Seat 2: peteypete911 folded before Flop (didn't bet)
Seat 3: dawnyp folded before Flop (didn't bet)
Seat 4: redand66 showed [4h Ah] and won ($2.52) with two pair, Aces and Fours
Seat 5: BearMike1 (button) folded before Flop (didn't bet)
Seat 6: Bullseye 170 (small blind) folded before Flop



PokerStars Hand #205253549905:  Hold'em No Limit ($0.05/$0.10 USD) - 2019/10/29 19:19:39 ET
Table 'Ariadne' 6-max Seat #6 is the button
Seat 1: PlayTheBlues4U ($20.09 in chips) 
Seat 2: peteypete911 ($7.34 in chips) 
Seat 3: dawnyp ($9.13 in chips) 
Seat 4: redand66 ($7.09 in chips) 
Seat 5: BearMike1 ($6.96 in chips) 
Seat 6: Bullseye 170 ($12 in chips) 
PlayTheBlues4U: posts small blind $0.05
peteypete911: posts big blind $0.10
*** HOLE CARDS ***
Dealt to PlayTheBlues4U [6c 6h]
dawnyp: folds 
redand66: raises $0.20 to $0.30
BearMike1: folds 
Bullseye 170: folds 
PlayTheBlues4U: calls $0.25
peteypete911: calls $0.20
*** FLOP *** [2d 8h 7c]
PlayTheBlues4U: checks 
peteypete911: checks 
redand66: bets $0.30
PlayTheBlues4U: folds 
peteypete911: folds 
Uncalled bet ($0.30) returned to redand66
redand66 collected $0.86 from pot
redand66: doesn't show hand 
*** SUMMARY ***
Total pot $0.90 | Rake $0.04 
Board [2d 8h 7c]
Seat 1: PlayTheBlues4U (small blind) folded on the Flop
Seat 2: peteypete911 (big blind) folded on the Flop
Seat 3: dawnyp folded before Flop (didn't bet)
Seat 4: redand66 collected ($0.86)
Seat 5: BearMike1 folded before Flop (didn't bet)
Seat 6: Bullseye 170 (button) folded before Flop (didn't bet)



PokerStars Hand #205254350956:  Hold'em No Limit ($0.05/$0.10 USD) - 2019/10/29 19:20:30 ET
Table 'Ariadne' 6-max Seat #1 is the button
Seat 1: PlayTheBlues4U ($19.79 in chips) 
Seat 2: peteypete911 ($7.04 in chips) 
Seat 3: dawnyp ($9.13 in chips) 
Seat 4: redand66 ($7.65 in chips) 
Seat 5: BearMike1 ($6.96 in chips) 
Seat 6: Bullseye 170 ($12 in chips) 
peteypete911: posts small blind $0.05
dawnyp: posts big blind $0.10
*** HOLE CARDS ***
Dealt to PlayTheBlues4U [Th 2d]
redand66: calls $0.10
BearMike1: folds 
Bullseye 170: calls $0.10
PlayTheBlues4U: folds 
peteypete911: calls $0.05
dawnyp: checks 
*** FLOP *** [6c 4s Qc]
peteypete911: checks 
dawnyp: bets $0.10
redand66: folds 
Bullseye 170: raises $0.29 to $0.39
peteypete911: folds 
dawnyp: folds 
Uncalled bet ($0.29) returned to Bullseye 170
Bullseye 170 collected $0.57 from pot
*** SUMMARY ***
Total pot $0.60 | Rake $0.03 
Board [6c 4s Qc]
Seat 1: PlayTheBlues4U (button) folded before Flop (didn't bet)
Seat 2: peteypete911 (small blind) folded on the Flop
Seat 3: dawnyp (big blind) folded on the Flop
Seat 4: redand66 folded on the Flop
Seat 5: BearMike1 folded before Flop (didn't bet)
Seat 6: Bullseye 170 collected ($0.57)



PokerStars Hand #205254351100:  Hold'em No Limit ($0.05/$0.10 USD) - 2019/10/29 19:21:14 ET
Table 'Ariadne' 6-max Seat #2 is the button
Seat 1: PlayTheBlues4U ($19.79 in chips) 
Seat 2: peteypete911 ($6.94 in chips) 
Seat 3: dawnyp ($8.93 in chips) 
Seat 4: redand66 ($7.55 in chips) 
Seat 5: BearMike1 ($6.96 in chips) 
Seat 6: Bullseye 170 ($12.37 in chips) 
dawnyp: posts small blind $0.05
redand66: posts big blind $0.10
*** HOLE CARDS ***
Dealt to PlayTheBlues4U [7d 7h]
BearMike1: calls $0.10
Bullseye 170: folds 
PlayTheBlues4U: raises $0.20 to $0.30
peteypete911: folds 
dawnyp: folds 
redand66: folds 
BearMike1: calls $0.20
*** FLOP *** [Jh Ks 7s]
BearMike1: checks 
PlayTheBlues4U: bets $0.60
BearMike1: calls $0.60
*** TURN *** [Jh Ks 7s] [9c]
BearMike1: checks 
PlayTheBlues4U: bets $1.50
BearMike1: calls $1.50
*** RIVER *** [Jh Ks 7s 9c] [3s]
BearMike1: checks 
PlayTheBlues4U: checks 
*** SHOW DOWN ***
BearMike1: shows [Jd Td] (a pair of Jacks)
PlayTheBlues4U: shows [7d 7h] (three of a kind, Sevens)
PlayTheBlues4U collected $4.70 from pot
*** SUMMARY ***
Total pot $4.95 | Rake $0.25 
Board [Jh Ks 7s 9c 3s]
Seat 1: PlayTheBlues4U showed [7d 7h] and won ($4.70) with three of a kind, Sevens
Seat 2: peteypete911 (button) folded before Flop (didn't bet)
Seat 3: dawnyp (small blind) folded before Flop
Seat 4: redand66 (big blind) folded before Flop
Seat 5: BearMike1 showed [Jd Td] and lost with a pair of Jacks
Seat 6: Bullseye 170 folded before Flop (didn't bet)



PokerStars Hand #205254351269:  Hold'em No Limit ($0.05/$0.10 USD) - 2019/10/29 19:22:11 ET
Table 'Ariadne' 6-max Seat #3 is the button
Seat 1: PlayTheBlues4U ($22.09 in chips) 
Seat 2: peteypete911 ($6.94 in chips) 
Seat 3: dawnyp ($8.88 in chips) 
Seat 4: redand66 ($7.45 in chips) 
Seat 5: BearMike1 ($4.56 in chips) 
Seat 6: Bullseye 170 ($12.37 in chips) 
redand66: posts small blind $0.05
BearMike1: posts big blind $0.10
*** HOLE CARDS ***
Dealt to PlayTheBlues4U [Kd 9s]
Bullseye 170: folds 
PlayTheBlues4U: folds 
peteypete911: folds 
dawnyp: folds 
redand66: calls $0.05
BearMike1: checks 
*** FLOP *** [5c Ac 2h]
redand66: checks 
BearMike1: bets $0.30
redand66: calls $0.30
*** TURN *** [5c Ac 2h] [Ah]
redand66: checks 
BearMike1: checks 
*** RIVER *** [5c Ac 2h Ah] [8d]
redand66: checks 
BearMike1: checks 
*** SHOW DOWN ***
redand66: shows [9c 7c] (a pair of Aces)
BearMike1: shows [3c Ks] (a pair of Aces - King kicker)
BearMike1 collected $0.76 from pot
*** SUMMARY ***
Total pot $0.80 | Rake $0.04 
Board [5c Ac 2h Ah 8d]
Seat 1: PlayTheBlues4U folded before Flop (didn't bet)
Seat 2: peteypete911 folded before Flop (didn't bet)
Seat 3: dawnyp (button) folded before Flop (didn't bet)
Seat 4: redand66 (small blind) showed [9c 7c] and lost with a pair of Aces
Seat 5: BearMike1 (big blind) showed [3c Ks] and won ($0.76) with a pair of Aces
Seat 6: Bullseye 170 folded before Flop (didn't bet)



PokerStars Hand #205253547264:  Hold'em No Limit ($0.02/$0.05 USD) - 2019/10/29 19:03:09 ET
Table 'Callisto' 6-max Seat #3 is the button
Seat 2: yoli0820 ($8.54 in chips) 
Seat 3: zepped88 ($3.37 in chips) 
Seat 4: BearMike1 ($4.02 in chips) 
Seat 5: PlayTheBlues4U ($5 in chips) 
BearMike1: posts small blind $0.02
PlayTheBlues4U: posts big blind $0.05
Beachandsex12-1: sits out 
*** HOLE CARDS ***
Dealt to PlayTheBlues4U [9h 7d]
yoli0820: raises $0.15 to $0.20
zepped88: folds 
BearMike1: calls $0.18
PlayTheBlues4U: folds 
*** FLOP *** [Jh 5h 4c]
BearMike1: checks 
yoli0820: bets $0.45
BearMike1: calls $0.45
*** TURN *** [Jh 5h 4c] [5s]
BearMike1: checks 
yoli0820: bets $1.30
BearMike1: calls $1.30
*** RIVER *** [Jh 5h 4c 5s] [Ts]
BearMike1: checks 
yoli0820: bets $6.59 and is all-in
BearMike1: folds 
Uncalled bet ($6.59) returned to yoli0820
yoli0820 collected $3.75 from pot
yoli0820: doesn't show hand 
*** SUMMARY ***
Total pot $3.95 | Rake $0.20 
Board [Jh 5h 4c 5s Ts]
Seat 2: yoli0820 collected ($3.75)
Seat 3: zepped88 (button) folded before Flop (didn't bet)
Seat 4: BearMike1 (small blind) folded on the River
Seat 5: PlayTheBlues4U (big blind) folded before Flop



PokerStars Hand #205253547360:  Hold'em No Limit ($0.02/$0.05 USD) - 2019/10/29 19:03:44 ET
Table 'Callisto' 6-max Seat #4 is the button
Seat 1: Beachandsex12-1 ($3.25 in chips) 
Seat 2: yoli0820 ($10.34 in chips) 
Seat 3: zepped88 ($3.37 in chips) 
Seat 4: BearMike1 ($2.07 in chips) 
Seat 5: PlayTheBlues4U ($4.95 in chips) 
PlayTheBlues4U: posts small blind $0.02
Beachandsex12-1: posts big blind $0.05
*** HOLE CARDS ***
Dealt to PlayTheBlues4U [7c Jc]
yoli0820: raises $0.05 to $0.10
zepped88: calls $0.10
BearMike1: calls $0.10
PlayTheBlues4U: folds 
Beachandsex12-1: calls $0.05
*** FLOP *** [5d Ks Qh]
Beachandsex12-1: bets $0.05
termiticus33 leaves the table
yoli0820: folds 
zepped88: calls $0.05
BearMike1: folds 
*** TURN *** [5d Ks Qh] [2c]
Beachandsex12-1: checks 
yoli0820 said, "qq bear"
zepped88: bets $0.25
Beachandsex12-1: calls $0.25
*** RIVER *** [5d Ks Qh 2c] [4h]
Beachandsex12-1: checks 
zepped88: checks 
*** SHOW DOWN ***
Beachandsex12-1: shows [6c Kd] (a pair of Kings)
zepped88: mucks hand 
Beachandsex12-1 collected $0.97 from pot
*** SUMMARY ***
Total pot $1.02 | Rake $0.05 
Board [5d Ks Qh 2c 4h]
Seat 1: Beachandsex12-1 (big blind) showed [6c Kd] and won ($0.97) with a pair of Kings
Seat 2: yoli0820 folded on the Flop
Seat 3: zepped88 mucked [Ah Qc]
Seat 4: BearMike1 (button) folded on the Flop
Seat 5: PlayTheBlues4U (small blind) folded before Flop



PokerStars Hand #205253547427:  Hold'em No Limit ($0.02/$0.05 USD) - 2019/10/29 19:04:12 ET
Table 'Callisto' 6-max Seat #5 is the button
Seat 1: Beachandsex12-1 ($3.82 in chips) 
Seat 2: yoli0820 ($10.24 in chips) 
Seat 3: zepped88 ($2.97 in chips) 
Seat 4: BearMike1 ($3.97 in chips) 
Seat 5: PlayTheBlues4U ($4.93 in chips) 
Beachandsex12-1: posts small blind $0.02
yoli0820: posts big blind $0.05
*** HOLE CARDS ***
Dealt to PlayTheBlues4U [9d 5d]
zepped88: folds 
BearMike1: folds 
PlayTheBlues4U: raises $0.10 to $0.15
Beachandsex12-1: calls $0.13
yoli0820: calls $0.10
*** FLOP *** [Ts As 9h]
Beachandsex12-1: checks 
yoli0820: checks 
KooKballs joins the table at seat #6 
PlayTheBlues4U: bets $0.25
Beachandsex12-1: calls $0.25
yoli0820: folds 
*** TURN *** [Ts As 9h] [3s]
Beachandsex12-1: checks 
PlayTheBlues4U: checks 
*** RIVER *** [Ts As 9h 3s] [Ad]
Beachandsex12-1: checks 
PlayTheBlues4U: checks 
*** SHOW DOWN ***
Beachandsex12-1: shows [Jd Jh] (two pair, Aces and Jacks)
PlayTheBlues4U: mucks hand 
Beachandsex12-1 collected $0.90 from pot
*** SUMMARY ***
Total pot $0.95 | Rake $0.05 
Board [Ts As 9h 3s Ad]
Seat 1: Beachandsex12-1 (small blind) showed [Jd Jh] and won ($0.90) with two pair, Aces and Jacks
Seat 2: yoli0820 (big blind) folded on the Flop
Seat 3: zepped88 folded before Flop (didn't bet)
Seat 4: BearMike1 folded before Flop (didn't bet)
Seat 5: PlayTheBlues4U (button) mucked [9d 5d]



PokerStars Hand #205253547523:  Hold'em No Limit ($0.02/$0.05 USD) - 2019/10/29 19:04:49 ET
Table 'Callisto' 6-max Seat #1 is the button
Seat 1: Beachandsex12-1 ($4.32 in chips) 
Seat 2: yoli0820 ($10.09 in chips) 
Seat 3: zepped88 ($2.97 in chips) 
Seat 4: BearMike1 ($3.97 in chips) 
Seat 5: PlayTheBlues4U ($4.53 in chips) 
Seat 6: KooKballs ($5 in chips) 
yoli0820: posts small blind $0.02
zepped88: posts big blind $0.05
KooKballs: posts big blind $0.05
*** HOLE CARDS ***
Dealt to PlayTheBlues4U [Td 3h]
yoli0820 said, "thought u may have had the 5"
BearMike1: calls $0.05
PlayTheBlues4U: folds 
KooKballs: checks 
Beachandsex12-1: folds 
yoli0820: calls $0.03
zepped88: checks 
*** FLOP *** [4s 9h 8s]
yoli0820: checks 
zepped88: bets $0.05
BearMike1: folds 
KooKballs: folds 
yoli0820: calls $0.05
*** TURN *** [4s 9h 8s] [6c]
yoli0820: checks 
zepped88: bets $0.15
yoli0820: folds 
Uncalled bet ($0.15) returned to zepped88
zepped88 collected $0.28 from pot
zepped88: doesn't show hand 
*** SUMMARY ***
Total pot $0.30 | Rake $0.02 
Board [4s 9h 8s 6c]
Seat 1: Beachandsex12-1 (button) folded before Flop (didn't bet)
Seat 2: yoli0820 (small blind) folded on the Turn
Seat 3: zepped88 (big blind) collected ($0.28)
Seat 4: BearMike1 folded on the Flop
Seat 5: PlayTheBlues4U folded before Flop (didn't bet)
Seat 6: KooKballs folded on the Flop (didn't bet)



PokerStars Hand #205253547603:  Hold'em No Limit ($0.02/$0.05 USD) - 2019/10/29 19:05:24 ET
Table 'Callisto' 6-max Seat #2 is the button
Seat 1: Beachandsex12-1 ($4.32 in chips) 
Seat 2: yoli0820 ($9.99 in chips) 
Seat 3: zepped88 ($3.15 in chips) 
Seat 4: BearMike1 ($3.92 in chips) 
Seat 5: PlayTheBlues4U ($4.53 in chips) 
Seat 6: KooKballs ($4.95 in chips) 
zepped88: posts small blind $0.02
BearMike1: posts big blind $0.05
*** HOLE CARDS ***
Dealt to PlayTheBlues4U [Kh 8d]
PlayTheBlues4U: folds 
KooKballs: folds 
Beachandsex12-1: calls $0.05
yoli0820: folds 
zepped88: folds 
BearMike1: checks 
*** FLOP *** [Ks Qh 7s]
BearMike1: checks 
Beachandsex12-1: checks 
*** TURN *** [Ks Qh 7s] [4s]
BearMike1: checks 
Beachandsex12-1: checks 
*** RIVER *** [Ks Qh 7s 4s] [Jd]
BearMike1: checks 
Beachandsex12-1: checks 
*** SHOW DOWN ***
BearMike1: shows [3d 9h] (high card King)
Beachandsex12-1: shows [7h Ah] (a pair of Sevens)
Beachandsex12-1 collected $0.11 from pot
*** SUMMARY ***
Total pot $0.12 | Rake $0.01 
Board [Ks Qh 7s 4s Jd]
Seat 1: Beachandsex12-1 showed [7h Ah] and won ($0.11) with a pair of Sevens
Seat 2: yoli0820 (button) folded before Flop (didn't bet)
Seat 3: zepped88 (small blind) folded before Flop
Seat 4: BearMike1 (big blind) showed [3d 9h] and lost with high card King
Seat 5: PlayTheBlues4U folded before Flop (didn't bet)
Seat 6: KooKballs folded before Flop (didn't bet)



PokerStars Hand #205253547673:  Hold'em No Limit ($0.02/$0.05 USD) - 2019/10/29 19:05:49 ET
Table 'Callisto' 6-max Seat #3 is the button
Seat 1: Beachandsex12-1 ($4.38 in chips) 
Seat 2: yoli0820 ($9.99 in chips) 
Seat 3: zepped88 ($3.13 in chips) 
Seat 4: BearMike1 ($3.87 in chips) 
Seat 5: PlayTheBlues4U ($4.53 in chips) 
Seat 6: KooKballs ($4.95 in chips) 
BearMike1: posts small blind $0.02
PlayTheBlues4U: posts big blind $0.05
*** HOLE CARDS ***
Dealt to PlayTheBlues4U [Kc 4d]
KooKballs: folds 
Beachandsex12-1: calls $0.05
yoli0820: folds 
zepped88: folds 
BearMike1: calls $0.03
PlayTheBlues4U: checks 
*** FLOP *** [Jd 2d Jh]
BearMike1: checks 
PlayTheBlues4U: checks 
Beachandsex12-1: bets $0.05
BearMike1: raises $0.10 to $0.15
PlayTheBlues4U: folds 
Beachandsex12-1: calls $0.10
*** TURN *** [Jd 2d Jh] [9s]
BearMike1: bets $0.40
Beachandsex12-1: folds 
Uncalled bet ($0.40) returned to BearMike1
BearMike1 collected $0.43 from pot
BearMike1: doesn't show hand 
*** SUMMARY ***
Total pot $0.45 | Rake $0.02 
Board [Jd 2d Jh 9s]
Seat 1: Beachandsex12-1 folded on the Turn
Seat 2: yoli0820 folded before Flop (didn't bet)
Seat 3: zepped88 (button) folded before Flop (didn't bet)
Seat 4: BearMike1 (small blind) collected ($0.43)
Seat 5: PlayTheBlues4U (big blind) folded on the Flop
Seat 6: KooKballs folded before Flop (didn't bet)



PokerStars Hand #205253547744:  Hold'em No Limit ($0.02/$0.05 USD) - 2019/10/29 19:06:18 ET
Table 'Callisto' 6-max Seat #4 is the button
Seat 1: Beachandsex12-1 ($4.18 in chips) 
Seat 2: yoli0820 ($9.99 in chips) 
Seat 3: zepped88 ($3.13 in chips) 
Seat 4: BearMike1 ($4.10 in chips) 
Seat 5: PlayTheBlues4U ($5 in chips) 
Seat 6: KooKballs ($4.95 in chips) 
PlayTheBlues4U: posts small blind $0.02
KooKballs: posts big blind $0.05
*** HOLE CARDS ***
Dealt to PlayTheBlues4U [7h 7s]
Beachandsex12-1: calls $0.05
yoli0820: raises $0.05 to $0.10
zepped88: folds 
BearMike1: calls $0.10
PlayTheBlues4U: calls $0.08
KooKballs: calls $0.05
Beachandsex12-1: calls $0.05
*** FLOP *** [Tc Th 6s]
PlayTheBlues4U: checks 
KooKballs: checks 
Beachandsex12-1: checks 
yoli0820: checks 
BearMike1: bets $0.10
PlayTheBlues4U: folds 
KooKballs: folds 
Beachandsex12-1: folds 
yoli0820: folds 
Uncalled bet ($0.10) returned to BearMike1
BearMike1 collected $0.48 from pot
BearMike1: doesn't show hand 
*** SUMMARY ***
Total pot $0.50 | Rake $0.02 
Board [Tc Th 6s]
Seat 1: Beachandsex12-1 folded on the Flop
Seat 2: yoli0820 folded on the Flop
Seat 3: zepped88 folded before Flop (didn't bet)
Seat 4: BearMike1 (button) collected ($0.48)
Seat 5: PlayTheBlues4U (small blind) folded on the Flop
Seat 6: KooKballs (big blind) folded on the Flop



PokerStars Hand #205253547830:  Hold'em No Limit ($0.02/$0.05 USD) - 2019/10/29 19:06:55 ET
Table 'Callisto' 6-max Seat #5 is the button
Seat 1: Beachandsex12-1 ($4.08 in chips) 
Seat 2: yoli0820 ($9.89 in chips) 
Seat 3: zepped88 ($3.13 in chips) 
Seat 4: BearMike1 ($4.48 in chips) 
Seat 5: PlayTheBlues4U ($4.90 in chips) 
Seat 6: KooKballs ($4.85 in chips) 
KooKballs: posts small blind $0.02
Beachandsex12-1: posts big blind $0.05
*** HOLE CARDS ***
Dealt to PlayTheBlues4U [5s As]
yoli0820: raises $0.12 to $0.17
zepped88: calls $0.17
BearMike1: folds 
PlayTheBlues4U: folds 
KooKballs: folds 
Beachandsex12-1: calls $0.12
*** FLOP *** [2h Ts 3d]
Beachandsex12-1: checks 
yoli0820: bets $0.50
zepped88: calls $0.50
Beachandsex12-1: folds 
*** TURN *** [2h Ts 3d] [9d]
yoli0820: bets $9.22 and is all-in
zepped88: folds 
Uncalled bet ($9.22) returned to yoli0820
yoli0820 collected $1.45 from pot
yoli0820: doesn't show hand 
*** SUMMARY ***
Total pot $1.53 | Rake $0.08 
Board [2h Ts 3d 9d]
Seat 1: Beachandsex12-1 (big blind) folded on the Flop
Seat 2: yoli0820 collected ($1.45)
Seat 3: zepped88 folded on the Turn
Seat 4: BearMike1 folded before Flop (didn't bet)
Seat 5: PlayTheBlues4U (button) folded before Flop (didn't bet)
Seat 6: KooKballs (small blind) folded before Flop



PokerStars Hand #205253547902:  Hold'em No Limit ($0.02/$0.05 USD) - 2019/10/29 19:07:22 ET
Table 'Callisto' 6-max Seat #6 is the button
Seat 1: Beachandsex12-1 ($3.91 in chips) 
Seat 2: yoli0820 ($10.67 in chips) 
Seat 3: zepped88 ($2.46 in chips) 
Seat 4: BearMike1 ($4.48 in chips) 
Seat 5: PlayTheBlues4U ($4.90 in chips) 
Seat 6: KooKballs ($4.83 in chips) 
Beachandsex12-1: posts small blind $0.02
yoli0820: posts big blind $0.05
*** HOLE CARDS ***
Dealt to PlayTheBlues4U [4s 5h]
zepped88: folds 
BearMike1: folds 
PlayTheBlues4U: folds 
KooKballs: raises $0.10 to $0.15
Beachandsex12-1: calls $0.13
yoli0820: calls $0.10
*** FLOP *** [Qd 2s 7h]
Beachandsex12-1: bets $0.05
yoli0820: calls $0.05
KooKballs: folds 
*** TURN *** [Qd 2s 7h] [3d]
Beachandsex12-1: bets $0.05
yoli0820: calls $0.05
*** RIVER *** [Qd 2s 7h 3d] [Jc]
Beachandsex12-1: bets $0.15
yoli0820: folds 
Uncalled bet ($0.15) returned to Beachandsex12-1
Beachandsex12-1 collected $0.62 from pot
Beachandsex12-1: doesn't show hand 
*** SUMMARY ***
Total pot $0.65 | Rake $0.03 
Board [Qd 2s 7h 3d Jc]
Seat 1: Beachandsex12-1 (small blind) collected ($0.62)
Seat 2: yoli0820 (big blind) folded on the River
Seat 3: zepped88 folded before Flop (didn't bet)
Seat 4: BearMike1 folded before Flop (didn't bet)
Seat 5: PlayTheBlues4U folded before Flop (didn't bet)
Seat 6: KooKballs (button) folded on the Flop



PokerStars Hand #205253547963:  Hold'em No Limit ($0.02/$0.05 USD) - 2019/10/29 19:07:50 ET
Table 'Callisto' 6-max Seat #1 is the button
Seat 1: Beachandsex12-1 ($4.28 in chips) 
Seat 2: yoli0820 ($10.42 in chips) 
Seat 3: zepped88 ($2.46 in chips) 
Seat 4: BearMike1 ($4.48 in chips) 
Seat 5: PlayTheBlues4U ($4.90 in chips) 
Seat 6: KooKballs ($4.68 in chips) 
yoli0820: posts small blind $0.02
zepped88: posts big blind $0.05
*** HOLE CARDS ***
Dealt to PlayTheBlues4U [3d 9h]
BearMike1: folds 
PlayTheBlues4U: folds 
KooKballs: folds 
Beachandsex12-1: folds 
yoli0820: calls $0.03
zepped88: checks 
*** FLOP *** [4s 6h Ks]
yoli0820: checks 
Beachandsex12-1 leaves the table
zepped88: bets $0.05
yoli0820: calls $0.05
*** TURN *** [4s 6h Ks] [5s]
yoli0820: checks 
zepped88: checks 
*** RIVER *** [4s 6h Ks 5s] [6c]
yoli0820: checks 
zepped88: checks 
*** SHOW DOWN ***
yoli0820: shows [8d 4c] (two pair, Sixes and Fours)
zepped88: shows [Kd 3h] (two pair, Kings and Sixes)
zepped88 collected $0.19 from pot
*** SUMMARY ***
Total pot $0.20 | Rake $0.01 
Board [4s 6h Ks 5s 6c]
Seat 1: Beachandsex12-1 (button) folded before Flop (didn't bet)
Seat 2: yoli0820 (small blind) showed [8d 4c] and lost with two pair, Sixes and Fours
Seat 3: zepped88 (big blind) showed [Kd 3h] and won ($0.19) with two pair, Kings and Sixes
Seat 4: BearMike1 folded before Flop (didn't bet)
Seat 5: PlayTheBlues4U folded before Flop (didn't bet)
Seat 6: KooKballs folded before Flop (didn't bet)



PokerStars Hand #205253548055:  Hold'em No Limit ($0.02/$0.05 USD) - 2019/10/29 19:08:27 ET
Table 'Callisto' 6-max Seat #2 is the button
Seat 2: yoli0820 ($10.32 in chips) 
Seat 3: zepped88 ($2.55 in chips) 
Seat 4: BearMike1 ($4.48 in chips) 
Seat 5: PlayTheBlues4U ($4.90 in chips) 
Seat 6: KooKballs ($4.68 in chips) 
zepped88: posts small blind $0.02
BearMike1: posts big blind $0.05
*** HOLE CARDS ***
Dealt to PlayTheBlues4U [6c Jh]
PlayTheBlues4U: folds 
KooKballs: folds 
yoli0820: raises $0.10 to $0.15
zepped88: folds 
BearMike1: folds 
Uncalled bet ($0.10) returned to yoli0820
yoli0820 collected $0.12 from pot
yoli0820: doesn't show hand 
*** SUMMARY ***
Total pot $0.12 | Rake $0 
Seat 2: yoli0820 (button) collected ($0.12)
Seat 3: zepped88 (small blind) folded before Flop
Seat 4: BearMike1 (big blind) folded before Flop
Seat 5: PlayTheBlues4U folded before Flop (didn't bet)
Seat 6: KooKballs folded before Flop (didn't bet)



PokerStars Hand #205253548092:  Hold'em No Limit ($0.02/$0.05 USD) - 2019/10/29 19:08:42 ET
Table 'Callisto' 6-max Seat #3 is the button
Seat 2: yoli0820 ($10.39 in chips) 
Seat 3: zepped88 ($2.53 in chips) 
Seat 4: BearMike1 ($4.43 in chips) 
Seat 5: PlayTheBlues4U ($4.90 in chips) 
Seat 6: KooKballs ($4.68 in chips) 
BearMike1: posts small blind $0.02
PlayTheBlues4U: posts big blind $0.05
*** HOLE CARDS ***
Dealt to PlayTheBlues4U [9s 4d]
KooKballs: folds 
yoli0820: calls $0.05
zepped88: calls $0.05
BearMike1: calls $0.03
PlayTheBlues4U: checks 
*** FLOP *** [Ad Qs Jh]
BearMike1: checks 
catgotmytongue joins the table at seat #1 
PlayTheBlues4U: checks 
yoli0820: checks 
zepped88: bets $0.05
catgotmytongue leaves the table
BearMike1: calls $0.05
PlayTheBlues4U: folds 
yoli0820: folds 
*** TURN *** [Ad Qs Jh] [6h]
BearMike1: checks 
zepped88: bets $0.15
BearMike1: folds 
Uncalled bet ($0.15) returned to zepped88
zepped88 collected $0.28 from pot
zepped88: doesn't show hand 
*** SUMMARY ***
Total pot $0.30 | Rake $0.02 
Board [Ad Qs Jh 6h]
Seat 2: yoli0820 folded on the Flop
Seat 3: zepped88 (button) collected ($0.28)
Seat 4: BearMike1 (small blind) folded on the Turn
Seat 5: PlayTheBlues4U (big blind) folded on the Flop
Seat 6: KooKballs folded before Flop (didn't bet)



PokerStars Hand #205253548232:  Hold'em No Limit ($0.02/$0.05 USD) - 2019/10/29 19:09:38 ET
Table 'Callisto' 6-max Seat #4 is the button
Seat 2: yoli0820 ($10.34 in chips) 
Seat 3: zepped88 ($2.71 in chips) 
Seat 4: BearMike1 ($4.33 in chips) 
Seat 5: PlayTheBlues4U ($4.85 in chips) 
Seat 6: KooKballs ($4.68 in chips) 
PlayTheBlues4U: posts small blind $0.02
KooKballs: posts big blind $0.05
*** HOLE CARDS ***
Dealt to PlayTheBlues4U [Ah 5s]
yoli0820: raises $0.12 to $0.17
zepped88: folds 
BearMike1: folds 
PlayTheBlues4U: folds 
KooKballs: folds 
Uncalled bet ($0.12) returned to yoli0820
yoli0820 collected $0.12 from pot
yoli0820: doesn't show hand 
*** SUMMARY ***
Total pot $0.12 | Rake $0 
Seat 2: yoli0820 collected ($0.12)
Seat 3: zepped88 folded before Flop (didn't bet)
Seat 4: BearMike1 (button) folded before Flop (didn't bet)
Seat 5: PlayTheBlues4U (small blind) folded before Flop
Seat 6: KooKballs (big blind) folded before Flop



PokerStars Hand #205253548261:  Hold'em No Limit ($0.02/$0.05 USD) - 2019/10/29 19:09:50 ET
Table 'Callisto' 6-max Seat #5 is the button
Seat 2: yoli0820 ($10.41 in chips) 
Seat 3: zepped88 ($2.71 in chips) 
Seat 4: BearMike1 ($4.33 in chips) 
Seat 5: PlayTheBlues4U ($4.83 in chips) 
Seat 6: KooKballs ($4.63 in chips) 
KooKballs: posts small blind $0.02
yoli0820: posts big blind $0.05
*** HOLE CARDS ***
Dealt to PlayTheBlues4U [Jh Td]
zepped88: calls $0.05
BearMike1: folds 
PlayTheBlues4U: calls $0.05
KooKballs: calls $0.03
yoli0820: checks 
*** FLOP *** [Ac 5s 8h]
KooKballs: checks 
yoli0820: checks 
zepped88: bets $0.05
PlayTheBlues4U: folds 
KooKballs: calls $0.05
yoli0820: calls $0.05
*** TURN *** [Ac 5s 8h] [3c]
KooKballs: checks 
yoli0820: checks 
zepped88: bets $0.15
KooKballs: folds 
yoli0820: calls $0.15
*** RIVER *** [Ac 5s 8h 3c] [6c]
yoli0820: checks 
zepped88: checks 
*** SHOW DOWN ***
yoli0820: shows [Qs 5d] (a pair of Fives)
zepped88: shows [8s Ad] (two pair, Aces and Eights)
zepped88 collected $0.62 from pot
*** SUMMARY ***
Total pot $0.65 | Rake $0.03 
Board [Ac 5s 8h 3c 6c]
Seat 2: yoli0820 (big blind) showed [Qs 5d] and lost with a pair of Fives
Seat 3: zepped88 showed [8s Ad] and won ($0.62) with two pair, Aces and Eights
Seat 4: BearMike1 folded before Flop (didn't bet)
Seat 5: PlayTheBlues4U (button) folded on the Flop
Seat 6: KooKballs (small blind) folded on the Turn



PokerStars Hand #205253548389:  Hold'em No Limit ($0.02/$0.05 USD) - 2019/10/29 19:10:39 ET
Table 'Callisto' 6-max Seat #6 is the button
Seat 2: yoli0820 ($10.16 in chips) 
Seat 3: zepped88 ($3.08 in chips) 
Seat 4: BearMike1 ($4.33 in chips) 
Seat 5: PlayTheBlues4U ($4.78 in chips) 
Seat 6: KooKballs ($4.53 in chips) 
yoli0820: posts small blind $0.02
zepped88: posts big blind $0.05
*** HOLE CARDS ***
Dealt to PlayTheBlues4U [Kh 3h]
BearMike1: folds 
PlayTheBlues4U: folds 
KooKballs: folds 
yoli0820: raises $0.10 to $0.15
zepped88: folds 
Uncalled bet ($0.10) returned to yoli0820
yoli0820 collected $0.10 from pot
yoli0820: doesn't show hand 
*** SUMMARY ***
Total pot $0.10 | Rake $0 
Seat 2: yoli0820 (small blind) collected ($0.10)
Seat 3: zepped88 (big blind) folded before Flop
Seat 4: BearMike1 folded before Flop (didn't bet)
Seat 5: PlayTheBlues4U folded before Flop (didn't bet)
Seat 6: KooKballs (button) folded before Flop (didn't bet)



PokerStars Hand #205253548432:  Hold'em No Limit ($0.02/$0.05 USD) - 2019/10/29 19:10:52 ET
Table 'Callisto' 6-max Seat #2 is the button
Seat 2: yoli0820 ($10.21 in chips) 
Seat 3: zepped88 ($3.03 in chips) 
Seat 4: BearMike1 ($4.33 in chips) 
Seat 5: PlayTheBlues4U ($4.78 in chips) 
Seat 6: KooKballs ($4.53 in chips) 
zepped88: posts small blind $0.02
BearMike1: posts big blind $0.05
*** HOLE CARDS ***
Dealt to PlayTheBlues4U [2s 3d]
PlayTheBlues4U: folds 
KooKballs: folds 
yoli0820: calls $0.05
zepped88: folds 
BearMike1: raises $0.15 to $0.20
yoli0820: calls $0.15
*** FLOP *** [Th 2d 6d]
BearMike1: checks 
yoli0820: checks 
*** TURN *** [Th 2d 6d] [8s]
BearMike1: bets $0.30
yoli0820: calls $0.30
*** RIVER *** [Th 2d 6d 8s] [4s]
BearMike1: checks 
yoli0820: bets $0.50
BearMike1: folds 
Uncalled bet ($0.50) returned to yoli0820
yoli0820 collected $0.97 from pot
yoli0820: doesn't show hand 
*** SUMMARY ***
Total pot $1.02 | Rake $0.05 
Board [Th 2d 6d 8s 4s]
Seat 2: yoli0820 (button) collected ($0.97)
Seat 3: zepped88 (small blind) folded before Flop
Seat 4: BearMike1 (big blind) folded on the River
Seat 5: PlayTheBlues4U folded before Flop (didn't bet)
Seat 6: KooKballs folded before Flop (didn't bet)



PokerStars Hand #205253548550:  Hold'em No Limit ($0.02/$0.05 USD) - 2019/10/29 19:11:40 ET
Table 'Callisto' 6-max Seat #3 is the button
Seat 2: yoli0820 ($10.68 in chips) 
Seat 3: zepped88 ($3.01 in chips) 
Seat 4: BearMike1 ($3.83 in chips) 
Seat 5: PlayTheBlues4U ($4.78 in chips) 
Seat 6: KooKballs ($4.53 in chips) 
BearMike1: posts small blind $0.02
PlayTheBlues4U: posts big blind $0.05
*** HOLE CARDS ***
Dealt to PlayTheBlues4U [5d 3c]
KooKballs: folds 
cracktiznutz joins the table at seat #1 
yoli0820: folds 
zepped88: folds 
BearMike1: calls $0.03
PlayTheBlues4U: checks 
*** FLOP *** [Kd Kh 2c]
BearMike1: checks 
PlayTheBlues4U: checks 
*** TURN *** [Kd Kh 2c] [Jh]
BearMike1: checks 
PlayTheBlues4U: checks 
*** RIVER *** [Kd Kh 2c Jh] [2d]
BearMike1: checks 
PlayTheBlues4U: checks 
*** SHOW DOWN ***
BearMike1: shows [3d 4s] (two pair, Kings and Deuces)
PlayTheBlues4U: shows [5d 3c] (two pair, Kings and Deuces)
BearMike1 collected $0.05 from pot
PlayTheBlues4U collected $0.05 from pot
*** SUMMARY ***
Total pot $0.10 | Rake $0 
Board [Kd Kh 2c Jh 2d]
Seat 2: yoli0820 folded before Flop (didn't bet)
Seat 3: zepped88 (button) folded before Flop (didn't bet)
Seat 4: BearMike1 (small blind) showed [3d 4s] and won ($0.05) with two pair, Kings and Deuces
Seat 5: PlayTheBlues4U (big blind) showed [5d 3c] and won ($0.05) with two pair, Kings and Deuces
Seat 6: KooKballs folded before Flop (didn't bet)



PokerStars Hand #205253548601:  Hold'em No Limit ($0.02/$0.05 USD) - 2019/10/29 19:12:00 ET
Table 'Callisto' 6-max Seat #4 is the button
Seat 2: yoli0820 ($10.68 in chips) 
Seat 3: zepped88 ($3.01 in chips) 
Seat 4: BearMike1 ($3.83 in chips) 
Seat 5: PlayTheBlues4U ($4.78 in chips) 
Seat 6: KooKballs ($4.53 in chips) 
PlayTheBlues4U: posts small blind $0.02
KooKballs: posts big blind $0.05
cracktiznutz: sits out 
*** HOLE CARDS ***
Dealt to PlayTheBlues4U [7h 8h]
yoli0820: calls $0.05
zepped88: folds 
BearMike1: folds 
PlayTheBlues4U: calls $0.03
KooKballs: checks 
*** FLOP *** [5d 8s 2c]
PlayTheBlues4U: bets $0.10
KooKballs: folds 
yoli0820: folds 
Uncalled bet ($0.10) returned to PlayTheBlues4U
PlayTheBlues4U collected $0.14 from pot
PlayTheBlues4U: doesn't show hand 
*** SUMMARY ***
Total pot $0.15 | Rake $0.01 
Board [5d 8s 2c]
Seat 2: yoli0820 folded on the Flop
Seat 3: zepped88 folded before Flop (didn't bet)
Seat 4: BearMike1 (button) folded before Flop (didn't bet)
Seat 5: PlayTheBlues4U (small blind) collected ($0.14)
Seat 6: KooKballs (big blind) folded on the Flop



PokerStars Hand #205253548660:  Hold'em No Limit ($0.02/$0.05 USD) - 2019/10/29 19:12:23 ET
Table 'Callisto' 6-max Seat #5 is the button
Seat 1: cracktiznutz ($5 in chips) 
Seat 2: yoli0820 ($10.63 in chips) 
Seat 3: zepped88 ($3.01 in chips) 
Seat 4: BearMike1 ($3.83 in chips) 
Seat 5: PlayTheBlues4U ($4.87 in chips) 
Seat 6: KooKballs ($4.48 in chips) 
KooKballs: posts small blind $0.02
cracktiznutz: posts big blind $0.05
*** HOLE CARDS ***
Dealt to PlayTheBlues4U [2h Th]
yoli0820: folds 
zepped88: calls $0.05
BearMike1: folds 
PlayTheBlues4U: folds 
KooKballs: calls $0.03
cracktiznutz: checks 
*** FLOP *** [As 6s Ks]
KooKballs: checks 
cracktiznutz: checks 
zepped88: checks 
*** TURN *** [As 6s Ks] [Kd]
KooKballs: checks 
cracktiznutz: bets $4.95 and is all-in
zepped88: folds 
KooKballs: folds 
Uncalled bet ($4.95) returned to cracktiznutz
cracktiznutz collected $0.14 from pot
*** SUMMARY ***
Total pot $0.15 | Rake $0.01 
Board [As 6s Ks Kd]
Seat 1: cracktiznutz (big blind) collected ($0.14)
Seat 2: yoli0820 folded before Flop (didn't bet)
Seat 3: zepped88 folded on the Turn
Seat 4: BearMike1 folded before Flop (didn't bet)
Seat 5: PlayTheBlues4U (button) folded before Flop (didn't bet)
Seat 6: KooKballs (small blind) folded on the Turn



PokerStars Hand #205253548742:  Hold'em No Limit ($0.02/$0.05 USD) - 2019/10/29 19:12:54 ET
Table 'Callisto' 6-max Seat #6 is the button
Seat 1: cracktiznutz ($5.09 in chips) 
Seat 2: yoli0820 ($10.63 in chips) 
Seat 3: zepped88 ($2.96 in chips) 
Seat 4: BearMike1 ($3.83 in chips) 
Seat 5: PlayTheBlues4U ($4.87 in chips) 
Seat 6: KooKballs ($4.43 in chips) 
cracktiznutz: posts small blind $0.02
yoli0820: posts big blind $0.05
*** HOLE CARDS ***
Dealt to PlayTheBlues4U [9h Th]
zepped88: calls $0.05
BearMike1: calls $0.05
yoli0820 said, "too bad we can't play live I'd play 25 50 with u guys"
PlayTheBlues4U: calls $0.05
KooKballs: folds 
cracktiznutz: calls $0.03
yoli0820: checks 
*** FLOP *** [9d Jc 2s]
cracktiznutz: checks 
yoli0820: bets $0.05
zepped88: folds 
BearMike1: folds 
PlayTheBlues4U: calls $0.05
cracktiznutz: folds 
*** TURN *** [9d Jc 2s] [4h]
yoli0820: bets $0.10
zepped88 leaves the table
PlayTheBlues4U: calls $0.10
*** RIVER *** [9d Jc 2s 4h] [6d]
yoli0820: bets $0.25
PlayTheBlues4U: calls $0.25
*** SHOW DOWN ***
yoli0820: shows [2h Ah] (a pair of Deuces)
PlayTheBlues4U: shows [9h Th] (a pair of Nines)
PlayTheBlues4U collected $1 from pot
*** SUMMARY ***
Total pot $1.05 | Rake $0.05 
Board [9d Jc 2s 4h 6d]
Seat 1: cracktiznutz (small blind) folded on the Flop
Seat 2: yoli0820 (big blind) showed [2h Ah] and lost with a pair of Deuces
Seat 3: zepped88 folded on the Flop
Seat 4: BearMike1 folded on the Flop
Seat 5: PlayTheBlues4U showed [9h Th] and won ($1) with a pair of Nines
Seat 6: KooKballs (button) folded before Flop (didn't bet)



PokerStars Hand #205253548974:  Hold'em No Limit ($0.02/$0.05 USD) - 2019/10/29 19:14:13 ET
Table 'Callisto' 6-max Seat #1 is the button
Seat 1: cracktiznutz ($5.04 in chips) 
Seat 2: yoli0820 ($10.18 in chips) 
Seat 4: BearMike1 ($3.78 in chips) 
Seat 5: PlayTheBlues4U ($5.42 in chips) 
Seat 6: KooKballs ($4.43 in chips) 
yoli0820: posts small blind $0.02
BearMike1: posts big blind $0.05
*** HOLE CARDS ***
Dealt to PlayTheBlues4U [4h Qs]
PlayTheBlues4U: folds 
KooKballs: folds 
yoli0820 said, "nh"
cracktiznutz: raises $0.20 to $0.25
yoli0820: calls $0.23
BearMike1: folds 
*** FLOP *** [Ah Qc 6h]
yoli0820: checks 
cracktiznutz: checks 
*** TURN *** [Ah Qc 6h] [Qd]
yoli0820: bets $0.25
cracktiznutz: calls $0.25
*** RIVER *** [Ah Qc 6h Qd] [7d]
yoli0820: checks 
cracktiznutz: checks 
*** SHOW DOWN ***
yoli0820: shows [5h Ac] (two pair, Aces and Queens)
cracktiznutz: mucks hand 
yoli0820 collected $1 from pot
*** SUMMARY ***
Total pot $1.05 | Rake $0.05 
Board [Ah Qc 6h Qd 7d]
Seat 1: cracktiznutz (button) mucked [Jh Ks]
Seat 2: yoli0820 (small blind) showed [5h Ac] and won ($1) with two pair, Aces and Queens
Seat 4: BearMike1 (big blind) folded before Flop
Seat 5: PlayTheBlues4U folded before Flop (didn't bet)
Seat 6: KooKballs folded before Flop (didn't bet)



PokerStars Hand #205253549066:  Hold'em No Limit ($0.02/$0.05 USD) - 2019/10/29 19:14:43 ET
Table 'Callisto' 6-max Seat #2 is the button
Seat 1: cracktiznutz ($4.54 in chips) 
Seat 2: yoli0820 ($10.68 in chips) 
Seat 4: BearMike1 ($3.73 in chips) 
Seat 5: PlayTheBlues4U ($5.42 in chips) 
Seat 6: KooKballs ($4.43 in chips) 
BearMike1: posts small blind $0.02
PlayTheBlues4U: posts big blind $0.05
*** HOLE CARDS ***
Dealt to PlayTheBlues4U [Kc 3c]
KooKballs: folds 
cracktiznutz: folds 
yoli0820: folds 
BearMike1: calls $0.03
PlayTheBlues4U: raises $0.15 to $0.20
BearMike1: folds 
Uncalled bet ($0.15) returned to PlayTheBlues4U
PlayTheBlues4U collected $0.10 from pot
PlayTheBlues4U: doesn't show hand 
*** SUMMARY ***
Total pot $0.10 | Rake $0 
Seat 1: cracktiznutz folded before Flop (didn't bet)
Seat 2: yoli0820 (button) folded before Flop (didn't bet)
Seat 4: BearMike1 (small blind) folded before Flop
Seat 5: PlayTheBlues4U (big blind) collected ($0.10)
Seat 6: KooKballs folded before Flop (didn't bet)



PokerStars Hand #205253549158:  Hold'em No Limit ($0.02/$0.05 USD) - 2019/10/29 19:15:19 ET
Table 'Callisto' 6-max Seat #4 is the button
Seat 1: cracktiznutz ($5 in chips) 
Seat 2: yoli0820 ($10.68 in chips) 
Seat 4: BearMike1 ($3.68 in chips) 
Seat 5: PlayTheBlues4U ($5.47 in chips) 
Seat 6: KooKballs ($4.43 in chips) 
PlayTheBlues4U: posts small blind $0.02
KooKballs: posts big blind $0.05
*** HOLE CARDS ***
Dealt to PlayTheBlues4U [6d 4c]
cracktiznutz: raises $4.95 to $5 and is all-in
yoli0820: folds 
BearMike1: folds 
PlayTheBlues4U: folds 
KooKballs: folds 
Uncalled bet ($4.95) returned to cracktiznutz
cracktiznutz collected $0.12 from pot
cracktiznutz: doesn't show hand 
*** SUMMARY ***
Total pot $0.12 | Rake $0 
Seat 1: cracktiznutz collected ($0.12)
Seat 2: yoli0820 folded before Flop (didn't bet)
Seat 4: BearMike1 (button) folded before Flop (didn't bet)
Seat 5: PlayTheBlues4U (small blind) folded before Flop
Seat 6: KooKballs (big blind) folded before Flop



PokerStars Hand #205253549191:  Hold'em No Limit ($0.02/$0.05 USD) - 2019/10/29 19:15:32 ET
Table 'Callisto' 6-max Seat #5 is the button
Seat 1: cracktiznutz ($5.07 in chips) 
Seat 2: yoli0820 ($10.68 in chips) 
Seat 4: BearMike1 ($3.68 in chips) 
Seat 5: PlayTheBlues4U ($5.45 in chips) 
Seat 6: KooKballs ($4.38 in chips) 
KooKballs: posts small blind $0.02
cracktiznutz: posts big blind $0.05
*** HOLE CARDS ***
Dealt to PlayTheBlues4U [Td 7c]
yoli0820: folds 
BearMike1: calls $0.05
PlayTheBlues4U: folds 
KooKballs: raises $0.10 to $0.15
yoli0820 said, "I almost called lol"
cracktiznutz: folds 
BearMike1: folds 
Uncalled bet ($0.10) returned to KooKballs
KooKballs collected $0.15 from pot
KooKballs: doesn't show hand 
*** SUMMARY ***
Total pot $0.15 | Rake $0 
Seat 1: cracktiznutz (big blind) folded before Flop
Seat 2: yoli0820 folded before Flop (didn't bet)
Seat 4: BearMike1 folded before Flop
Seat 5: PlayTheBlues4U (button) folded before Flop (didn't bet)
Seat 6: KooKballs (small blind) collected ($0.15)



PokerStars Hand #205253549245:  Hold'em No Limit ($0.02/$0.05 USD) - 2019/10/29 19:15:51 ET
Table 'Callisto' 6-max Seat #6 is the button
Seat 1: cracktiznutz ($5.02 in chips) 
Seat 2: yoli0820 ($10.68 in chips) 
Seat 4: BearMike1 ($3.63 in chips) 
Seat 5: PlayTheBlues4U ($5.45 in chips) 
Seat 6: KooKballs ($4.48 in chips) 
cracktiznutz: posts small blind $0.02
yoli0820: posts big blind $0.05
*** HOLE CARDS ***
Dealt to PlayTheBlues4U [Qc Td]
BearMike1: folds 
PlayTheBlues4U: folds 
KooKballs: folds 
cracktiznutz: raises $4.97 to $5.02 and is all-in
yoli0820: folds 
Uncalled bet ($4.97) returned to cracktiznutz
cracktiznutz collected $0.10 from pot
cracktiznutz: doesn't show hand 
*** SUMMARY ***
Total pot $0.10 | Rake $0 
Seat 1: cracktiznutz (small blind) collected ($0.10)
Seat 2: yoli0820 (big blind) folded before Flop
Seat 4: BearMike1 folded before Flop (didn't bet)
Seat 5: PlayTheBlues4U folded before Flop (didn't bet)
Seat 6: KooKballs (button) folded before Flop (didn't bet)



PokerStars Hand #205253549277:  Hold'em No Limit ($0.02/$0.05 USD) - 2019/10/29 19:16:03 ET
Table 'Callisto' 6-max Seat #1 is the button
Seat 1: cracktiznutz ($5.07 in chips) 
Seat 2: yoli0820 ($10.63 in chips) 
Seat 4: BearMike1 ($3.63 in chips) 
Seat 5: PlayTheBlues4U ($5.45 in chips) 
Seat 6: KooKballs ($4.48 in chips) 
yoli0820: posts small blind $0.02
BearMike1: posts big blind $0.05
*** HOLE CARDS ***
Dealt to PlayTheBlues4U [8h 3s]
yoli0820 said, "come on dude"
PlayTheBlues4U: folds 
KooKballs: raises $0.10 to $0.15
cracktiznutz: calls $0.15
yoli0820: calls $0.13
BearMike1: raises $0.65 to $0.80
KooKballs: folds 
cracktiznutz: calls $0.65
yoli0820: folds 
*** FLOP *** [Ts Js Th]
BearMike1: bets $2.83 and is all-in
cracktiznutz: folds 
Uncalled bet ($2.83) returned to BearMike1
BearMike1 collected $1.80 from pot
BearMike1: doesn't show hand 
*** SUMMARY ***
Total pot $1.90 | Rake $0.10 
Board [Ts Js Th]
Seat 1: cracktiznutz (button) folded on the Flop
Seat 2: yoli0820 (small blind) folded before Flop
Seat 4: BearMike1 (big blind) collected ($1.80)
Seat 5: PlayTheBlues4U folded before Flop (didn't bet)
Seat 6: KooKballs folded before Flop



PokerStars Hand #205253549402:  Hold'em No Limit ($0.02/$0.05 USD) - 2019/10/29 19:16:45 ET
Table 'Callisto' 6-max Seat #2 is the button
Seat 1: cracktiznutz ($4.27 in chips) 
Seat 2: yoli0820 ($10.48 in chips) 
Seat 4: BearMike1 ($4.63 in chips) 
Seat 5: PlayTheBlues4U ($5.45 in chips) 
Seat 6: KooKballs ($4.33 in chips) 
BearMike1: posts small blind $0.02
PlayTheBlues4U: posts big blind $0.05
*** HOLE CARDS ***
Dealt to PlayTheBlues4U [7c 6h]
KooKballs: folds 
cracktiznutz: folds 
yoli0820: raises $0.05 to $0.10
BearMike1: calls $0.08
PlayTheBlues4U: calls $0.05
*** FLOP *** [8c Kc Jc]
BearMike1: checks 
PlayTheBlues4U: checks 
yoli0820: bets $0.15
BearMike1: folds 
PlayTheBlues4U: calls $0.15
*** TURN *** [8c Kc Jc] [Td]
PlayTheBlues4U: checks 
yoli0820: bets $0.15
PlayTheBlues4U: folds 
Uncalled bet ($0.15) returned to yoli0820
yoli0820 collected $0.57 from pot
yoli0820: doesn't show hand 
*** SUMMARY ***
Total pot $0.60 | Rake $0.03 
Board [8c Kc Jc Td]
Seat 1: cracktiznutz folded before Flop (didn't bet)
Seat 2: yoli0820 (button) collected ($0.57)
Seat 4: BearMike1 (small blind) folded on the Flop
Seat 5: PlayTheBlues4U (big blind) folded on the Turn
Seat 6: KooKballs folded before Flop (didn't bet)



PokerStars Hand #205253549608:  Hold'em No Limit ($0.02/$0.05 USD) - 2019/10/29 19:17:59 ET
Table 'Callisto' 6-max Seat #4 is the button
Seat 1: cracktiznutz ($5 in chips) 
Seat 2: yoli0820 ($10.80 in chips) 
Seat 4: BearMike1 ($4.53 in chips) 
Seat 5: PlayTheBlues4U ($5.20 in chips) 
Seat 6: KooKballs ($4.33 in chips) 
PlayTheBlues4U: posts small blind $0.02
KooKballs: posts big blind $0.05
*** HOLE CARDS ***
Dealt to PlayTheBlues4U [Qh Jd]
cracktiznutz: folds 
yoli0820: raises $0.05 to $0.10
BearMike1: folds 
PlayTheBlues4U: calls $0.08
KooKballs: calls $0.05
*** FLOP *** [6d 2s 2c]
PlayTheBlues4U: checks 
KooKballs: bets $0.15
yoli0820: calls $0.15
PlayTheBlues4U: folds 
*** TURN *** [6d 2s 2c] [8c]
KooKballs: checks 
csxwe joins the table at seat #3 
yoli0820: bets $0.25
KooKballs: folds 
Uncalled bet ($0.25) returned to yoli0820
yoli0820 collected $0.57 from pot
yoli0820: doesn't show hand 
*** SUMMARY ***
Total pot $0.60 | Rake $0.03 
Board [6d 2s 2c 8c]
Seat 1: cracktiznutz folded before Flop (didn't bet)
Seat 2: yoli0820 collected ($0.57)
Seat 4: BearMike1 (button) folded before Flop (didn't bet)
Seat 5: PlayTheBlues4U (small blind) folded on the Flop
Seat 6: KooKballs (big blind) folded on the Turn



PokerStars Hand #205253549768:  Hold'em No Limit ($0.02/$0.05 USD) - 2019/10/29 19:18:48 ET
Table 'Callisto' 6-max Seat #5 is the button
Seat 1: cracktiznutz ($5 in chips) 
Seat 2: yoli0820 ($11.12 in chips) 
Seat 4: BearMike1 ($4.53 in chips) 
Seat 5: PlayTheBlues4U ($5.10 in chips) 
Seat 6: KooKballs ($4.08 in chips) 
KooKballs: posts small blind $0.02
cracktiznutz: posts big blind $0.05
csxwe: sits out 
*** HOLE CARDS ***
Dealt to PlayTheBlues4U [Kd 6s]
yoli0820: raises $0.05 to $0.10
BearMike1: folds 
PlayTheBlues4U: folds 
KooKballs: calls $0.08
cracktiznutz: raises $0.75 to $0.85
yoli0820: folds 
KooKballs: folds 
Uncalled bet ($0.75) returned to cracktiznutz
cracktiznutz collected $0.30 from pot
cracktiznutz: doesn't show hand 
*** SUMMARY ***
Total pot $0.30 | Rake $0 
Seat 1: cracktiznutz (big blind) collected ($0.30)
Seat 2: yoli0820 folded before Flop
Seat 4: BearMike1 folded before Flop (didn't bet)
Seat 5: PlayTheBlues4U (button) folded before Flop (didn't bet)
Seat 6: KooKballs (small blind) folded before Flop



PokerStars Hand #205253549880:  Hold'em No Limit ($0.02/$0.05 USD) - 2019/10/29 19:19:29 ET
Table 'Callisto' 6-max Seat #6 is the button
Seat 1: cracktiznutz ($5.20 in chips) 
Seat 2: yoli0820 ($11.02 in chips) 
Seat 4: BearMike1 ($4.53 in chips) 
Seat 5: PlayTheBlues4U ($5.10 in chips) 
Seat 6: KooKballs ($3.98 in chips) 
cracktiznutz: posts small blind $0.02
yoli0820: posts big blind $0.05
csxwe: sits out 
*** HOLE CARDS ***
Dealt to PlayTheBlues4U [4s Kd]
BearMike1: folds 
PlayTheBlues4U: folds 
KooKballs: folds 
cracktiznutz: raises $0.15 to $0.20
yoli0820: calls $0.15
*** FLOP *** [Tc Jd 4h]
cracktiznutz: bets $0.19
yoli0820: calls $0.19
*** TURN *** [Tc Jd 4h] [Td]
cracktiznutz: bets $0.52
yoli0820: calls $0.52
*** RIVER *** [Tc Jd 4h Td] [5d]
cracktiznutz: bets $0.87
yoli0820: calls $0.87
*** SHOW DOWN ***
cracktiznutz: shows [Th Ah] (three of a kind, Tens)
yoli0820: mucks hand 
cracktiznutz collected $3.38 from pot
*** SUMMARY ***
Total pot $3.56 | Rake $0.18 
Board [Tc Jd 4h Td 5d]
Seat 1: cracktiznutz (small blind) showed [Th Ah] and won ($3.38) with three of a kind, Tens
Seat 2: yoli0820 (big blind) mucked [As Kh]
Seat 4: BearMike1 folded before Flop (didn't bet)
Seat 5: PlayTheBlues4U folded before Flop (didn't bet)
Seat 6: KooKballs (button) folded before Flop (didn't bet)



PokerStars Hand #205253549974:  Hold'em No Limit ($0.02/$0.05 USD) - 2019/10/29 19:20:00 ET
Table 'Callisto' 6-max Seat #1 is the button
Seat 1: cracktiznutz ($6.80 in chips) 
Seat 2: yoli0820 ($9.24 in chips) 
Seat 3: csxwe ($5 in chips) 
Seat 4: BearMike1 ($4.53 in chips) 
Seat 5: PlayTheBlues4U ($5.10 in chips) 
Seat 6: KooKballs ($3.98 in chips) 
yoli0820: posts small blind $0.02
csxwe: posts big blind $0.05
*** HOLE CARDS ***
Dealt to PlayTheBlues4U [Ac Ks]
BearMike1: calls $0.05
PlayTheBlues4U: raises $0.10 to $0.15
KooKballs: folds 
cracktiznutz: raises $0.25 to $0.40
yoli0820: folds 
csxwe: folds 
BearMike1: folds 
yoli0820 said, "love this site"
PlayTheBlues4U: calls $0.25
*** FLOP *** [5c 2c 7s]
PlayTheBlues4U: checks 
cracktiznutz: checks 
*** TURN *** [5c 2c 7s] [6s]
PlayTheBlues4U: bets $0.55
cracktiznutz: raises $5.85 to $6.40 and is all-in
yoli0820 said, "if I shove pre he calls"
PlayTheBlues4U: folds 
Uncalled bet ($5.85) returned to cracktiznutz
cracktiznutz collected $1.92 from pot
cracktiznutz: doesn't show hand 
*** SUMMARY ***
Total pot $2.02 | Rake $0.10 
Board [5c 2c 7s 6s]
Seat 1: cracktiznutz (button) collected ($1.92)
Seat 2: yoli0820 (small blind) folded before Flop
Seat 3: csxwe (big blind) folded before Flop
Seat 4: BearMike1 folded before Flop
Seat 5: PlayTheBlues4U folded on the Turn
Seat 6: KooKballs folded before Flop (didn't bet)



PokerStars Hand #205254351031:  Hold'em No Limit ($0.02/$0.05 USD) - 2019/10/29 19:20:54 ET
Table 'Callisto' 6-max Seat #2 is the button
Seat 1: cracktiznutz ($7.77 in chips) 
Seat 2: yoli0820 ($9.22 in chips) 
Seat 3: csxwe ($4.95 in chips) 
Seat 4: BearMike1 ($4.48 in chips) 
Seat 5: PlayTheBlues4U ($5 in chips) 
Seat 6: KooKballs ($3.98 in chips) 
csxwe: posts small blind $0.02
BearMike1 is connected 
BearMike1: posts big blind $0.05
*** HOLE CARDS ***
Dealt to PlayTheBlues4U [Tc 3c]
PlayTheBlues4U: folds 
KooKballs: folds 
cracktiznutz: folds 
yoli0820: raises $0.12 to $0.17
csxwe: folds 
BearMike1: folds 
Uncalled bet ($0.12) returned to yoli0820
yoli0820 collected $0.12 from pot
yoli0820: doesn't show hand 
*** SUMMARY ***
Total pot $0.12 | Rake $0 
Seat 1: cracktiznutz folded before Flop (didn't bet)
Seat 2: yoli0820 (button) collected ($0.12)
Seat 3: csxwe (small blind) folded before Flop
Seat 4: BearMike1 (big blind) folded before Flop
Seat 5: PlayTheBlues4U folded before Flop (didn't bet)
Seat 6: KooKballs folded before Flop (didn't bet)



PokerStars Hand #205254351146:  Hold'em No Limit ($0.02/$0.05 USD) - 2019/10/29 19:21:30 ET
Table 'Callisto' 6-max Seat #3 is the button
Seat 1: cracktiznutz ($7.77 in chips) 
Seat 2: yoli0820 ($9.29 in chips) 
Seat 3: csxwe ($4.93 in chips) 
Seat 4: BearMike1 ($4.43 in chips) 
Seat 5: PlayTheBlues4U ($5 in chips) 
Seat 6: KooKballs ($3.98 in chips) 
BearMike1: posts small blind $0.02
PlayTheBlues4U: posts big blind $0.05
*** HOLE CARDS ***
Dealt to PlayTheBlues4U [7h Jh]
KooKballs: folds 
cracktiznutz: raises $0.20 to $0.25
yoli0820: calls $0.25
csxwe: folds 
BearMike1: calls $0.23
PlayTheBlues4U: folds 
*** FLOP *** [4h 5c Ks]
BearMike1: checks 
cracktiznutz: bets $0.30
yoli0820: calls $0.30
BearMike1: folds 
*** TURN *** [4h 5c Ks] [Ad]
yoli0820 said, "wish the river was a q"
cracktiznutz: bets $0.53
yoli0820: calls $0.53
*** RIVER *** [4h 5c Ks Ad] [7c]
cracktiznutz: bets $6.69 and is all-in
yoli0820: calls $6.69
*** SHOW DOWN ***
cracktiznutz: shows [Qh Ts] (high card Ace)
yoli0820: shows [7s 5d] (two pair, Sevens and Fives)
yoli0820 collected $15.05 from pot
*** SUMMARY ***
Total pot $15.84 | Rake $0.79 
Board [4h 5c Ks Ad 7c]
Seat 1: cracktiznutz showed [Qh Ts] and lost with high card Ace
Seat 2: yoli0820 showed [7s 5d] and won ($15.05) with two pair, Sevens and Fives
Seat 3: csxwe (button) folded before Flop (didn't bet)
Seat 4: BearMike1 (small blind) folded on the Flop
Seat 5: PlayTheBlues4U (big blind) folded before Flop
Seat 6: KooKballs folded before Flop (didn't bet)



PokerStars Hand #205254351266:  Hold'em No Limit ($0.02/$0.05 USD) - 2019/10/29 19:22:09 ET
Table 'Callisto' 6-max Seat #4 is the button
Seat 2: yoli0820 ($16.57 in chips) 
Seat 3: csxwe ($4.93 in chips) 
Seat 4: BearMike1 ($4.18 in chips) 
Seat 5: PlayTheBlues4U ($4.95 in chips) 
Seat 6: KooKballs ($3.98 in chips) 
PlayTheBlues4U: posts small blind $0.02
KooKballs: posts big blind $0.05
*** HOLE CARDS ***
Dealt to PlayTheBlues4U [8s 4h]
yoli0820: calls $0.05
cracktiznutz leaves the table
csxwe: calls $0.05
yoli0820 said, "noke"
BearMike1: calls $0.05
PlayTheBlues4U: folds 
KooKballs: checks 
*** FLOP *** [3h 2d 5c]
KooKballs: checks 
yoli0820: checks 
csxwe: checks 
BearMike1: checks 
*** TURN *** [3h 2d 5c] [3c]
yoli0820 said, "joke "
KooKballs: checks 
yoli0820: bets $0.10
csxwe: folds 
BearMike1: folds 
KooKballs: calls $0.10
*** RIVER *** [3h 2d 5c 3c] [8d]
KooKballs: bets $0.40
yoli0820: folds [Kh 2h]
Uncalled bet ($0.40) returned to KooKballs
KooKballs collected $0.40 from pot
KooKballs: doesn't show hand 
*** SUMMARY ***
Total pot $0.42 | Rake $0.02 
Board [3h 2d 5c 3c 8d]
Seat 2: yoli0820 folded on the River
Seat 3: csxwe folded on the Turn
Seat 4: BearMike1 (button) folded on the Turn
Seat 5: PlayTheBlues4U (small blind) folded before Flop
Seat 6: KooKballs (big blind) collected ($0.40)



PokerStars Hand #205254351435:  Hold'em No Limit ($0.02/$0.05 USD) - 2019/10/29 19:23:04 ET
Table 'Callisto' 6-max Seat #5 is the button
Seat 2: yoli0820 ($16.42 in chips) 
Seat 3: csxwe ($4.88 in chips) 
Seat 4: BearMike1 ($4.13 in chips) 
Seat 5: PlayTheBlues4U ($4.93 in chips) 
Seat 6: KooKballs ($4.23 in chips) 
KooKballs: posts small blind $0.02
yoli0820: posts big blind $0.05
*** HOLE CARDS ***
Dealt to PlayTheBlues4U [Ac Jd]
csxwe: calls $0.05
BearMike1: raises $0.20 to $0.25
yoli0820 said, "did need that 7 to call"
PlayTheBlues4U: calls $0.25
KooKballs: folds 
yoli0820: calls $0.20
csxwe: calls $0.20
*** FLOP *** [4c Jc 3c]
yoli0820: checks 
csxwe: checks 
BearMike1: checks 
PlayTheBlues4U: bets $0.75
yoli0820: calls $0.75
csxwe: folds 
BearMike1: folds 
*** TURN *** [4c Jc 3c] [8s]
yoli0820: checks 
PlayTheBlues4U: bets $1.25
yoli0820: calls $1.25
*** RIVER *** [4c Jc 3c 8s] [4s]
yoli0820: checks 
PlayTheBlues4U: checks 
*** SHOW DOWN ***
yoli0820: shows [Jh Qc] (two pair, Jacks and Fours)
PlayTheBlues4U: shows [Ac Jd] (two pair, Jacks and Fours - Ace kicker)
PlayTheBlues4U collected $4.77 from pot
*** SUMMARY ***
Total pot $5.02 | Rake $0.25 
Board [4c Jc 3c 8s 4s]
Seat 2: yoli0820 (big blind) showed [Jh Qc] and lost with two pair, Jacks and Fours
Seat 3: csxwe folded on the Flop
Seat 4: BearMike1 folded on the Flop
Seat 5: PlayTheBlues4U (button) showed [Ac Jd] and won ($4.77) with two pair, Jacks and Fours
Seat 6: KooKballs (small blind) folded before Flop



PokerStars Hand #205253546844:  Hold'em No Limit ($0.02/$0.05 USD) - 2019/10/29 19:00:28 ET
Table 'Leo' 6-max Seat #2 is the button
Seat 2: th3h0use ($1.99 in chips) 
Seat 3: Woodruff7 ($4.57 in chips) 
Seat 5: PlayTheBlues4U ($5 in chips) 
Seat 6: Babu1738 ($5.85 in chips) 
Woodruff7: posts small blind $0.02
PlayTheBlues4U: posts big blind $0.05
@large419: sits out 
*** HOLE CARDS ***
Dealt to PlayTheBlues4U [9s Ah]
Babu1738: folds 
th3h0use: calls $0.05
Woodruff7: calls $0.03
PlayTheBlues4U: checks 
*** FLOP *** [2h Tc 5c]
Woodruff7: checks 
PlayTheBlues4U: checks 
th3h0use: bets $0.15
Woodruff7: folds 
PlayTheBlues4U: folds 
Uncalled bet ($0.15) returned to th3h0use
th3h0use collected $0.14 from pot
*** SUMMARY ***
Total pot $0.15 | Rake $0.01 
Board [2h Tc 5c]
Seat 2: th3h0use (button) collected ($0.14)
Seat 3: Woodruff7 (small blind) folded on the Flop
Seat 5: PlayTheBlues4U (big blind) folded on the Flop
Seat 6: Babu1738 folded before Flop (didn't bet)



PokerStars Hand #205253546972:  Hold'em No Limit ($0.02/$0.05 USD) - 2019/10/29 19:01:16 ET
Table 'Leo' 6-max Seat #3 is the button
Seat 2: th3h0use ($2.08 in chips) 
Seat 3: Woodruff7 ($4.97 in chips) 
Seat 5: PlayTheBlues4U ($4.95 in chips) 
Seat 6: Babu1738 ($5.85 in chips) 
PlayTheBlues4U: posts small blind $0.02
Babu1738: posts big blind $0.05
@large419: sits out 
*** HOLE CARDS ***
Dealt to PlayTheBlues4U [As 9s]
th3h0use: raises $0.05 to $0.10
Woodruff7: calls $0.10
PlayTheBlues4U: calls $0.08
Babu1738: folds 
*** FLOP *** [6s 4h 3s]
PlayTheBlues4U: checks 
th3h0use: checks 
Woodruff7: bets $0.20
PlayTheBlues4U: calls $0.20
th3h0use: calls $0.20
*** TURN *** [6s 4h 3s] [Jc]
PlayTheBlues4U: checks 
th3h0use: checks 
delm44 said, ":):)"
Woodruff7: bets $0.45
PlayTheBlues4U: calls $0.45
th3h0use: folds 
*** RIVER *** [6s 4h 3s Jc] [8h]
PlayTheBlues4U: checks 
Woodruff7: checks 
*** SHOW DOWN ***
PlayTheBlues4U: shows [As 9s] (high card Ace)
Woodruff7: shows [5d 5s] (a pair of Fives)
Woodruff7 collected $1.76 from pot
*** SUMMARY ***
Total pot $1.85 | Rake $0.09 
Board [6s 4h 3s Jc 8h]
Seat 2: th3h0use folded on the Turn
Seat 3: Woodruff7 (button) showed [5d 5s] and won ($1.76) with a pair of Fives
Seat 5: PlayTheBlues4U (small blind) showed [As 9s] and lost with high card Ace
Seat 6: Babu1738 (big blind) folded before Flop



PokerStars Hand #205253547256:  Hold'em No Limit ($0.02/$0.05 USD) - 2019/10/29 19:03:06 ET
Table 'Leo' 6-max Seat #5 is the button
Seat 1: @large419 ($5.08 in chips) 
Seat 3: Woodruff7 ($5.98 in chips) 
Seat 5: PlayTheBlues4U ($5 in chips) 
Seat 6: Babu1738 ($5.80 in chips) 
Babu1738: posts small blind $0.02
@large419: posts big blind $0.05
delm44: sits out 
*** HOLE CARDS ***
Dealt to PlayTheBlues4U [9h 7d]
Woodruff7: raises $0.07 to $0.12
PlayTheBlues4U: folds 
Babu1738: folds 
@large419: folds 
Uncalled bet ($0.07) returned to Woodruff7
Woodruff7 collected $0.12 from pot
Woodruff7: doesn't show hand 
*** SUMMARY ***
Total pot $0.12 | Rake $0 
Seat 1: @large419 (big blind) folded before Flop
Seat 3: Woodruff7 collected ($0.12)
Seat 5: PlayTheBlues4U (button) folded before Flop (didn't bet)
Seat 6: Babu1738 (small blind) folded before Flop



PokerStars Hand #205253547295:  Hold'em No Limit ($0.02/$0.05 USD) - 2019/10/29 19:03:20 ET
Table 'Leo' 6-max Seat #6 is the button
Seat 1: @large419 ($5.03 in chips) 
Seat 3: Woodruff7 ($6.05 in chips) 
Seat 5: PlayTheBlues4U ($5 in chips) 
Seat 6: Babu1738 ($5.78 in chips) 
@large419: posts small blind $0.02
Woodruff7: posts big blind $0.05
delm44: sits out 
*** HOLE CARDS ***
Dealt to PlayTheBlues4U [As 4h]
PlayTheBlues4U: folds 
Babu1738: folds 
@large419: folds 
Uncalled bet ($0.03) returned to Woodruff7
Woodruff7 collected $0.04 from pot
Woodruff7: doesn't show hand 
*** SUMMARY ***
Total pot $0.04 | Rake $0 
Seat 1: @large419 (small blind) folded before Flop
Seat 3: Woodruff7 (big blind) collected ($0.04)
Seat 5: PlayTheBlues4U folded before Flop (didn't bet)
Seat 6: Babu1738 (button) folded before Flop (didn't bet)



PokerStars Hand #205253547352:  Hold'em No Limit ($0.02/$0.05 USD) - 2019/10/29 19:03:43 ET
Table 'Leo' 6-max Seat #1 is the button
Seat 1: @large419 ($5.01 in chips) 
Seat 3: Woodruff7 ($6.07 in chips) 
Seat 4: delm44 ($5.10 in chips) 
Seat 5: PlayTheBlues4U ($5 in chips) 
Seat 6: Babu1738 ($5.78 in chips) 
Woodruff7: posts small blind $0.02
delm44: posts big blind $0.05
*** HOLE CARDS ***
Dealt to PlayTheBlues4U [7d 7s]
PlayTheBlues4U: raises $0.10 to $0.15
Babu1738: folds 
@large419: folds 
Woodruff7: calls $0.13
delm44: folds 
*** FLOP *** [Tc Kd 6s]
Woodruff7: checks 
PlayTheBlues4U: bets $0.20
Woodruff7: folds 
Uncalled bet ($0.20) returned to PlayTheBlues4U
PlayTheBlues4U collected $0.33 from pot
PlayTheBlues4U: doesn't show hand 
*** SUMMARY ***
Total pot $0.35 | Rake $0.02 
Board [Tc Kd 6s]
Seat 1: @large419 (button) folded before Flop (didn't bet)
Seat 3: Woodruff7 (small blind) folded on the Flop
Seat 4: delm44 (big blind) folded before Flop
Seat 5: PlayTheBlues4U collected ($0.33)
Seat 6: Babu1738 folded before Flop (didn't bet)



PokerStars Hand #205253547455:  Hold'em No Limit ($0.02/$0.05 USD) - 2019/10/29 19:04:19 ET
Table 'Leo' 6-max Seat #3 is the button
Seat 1: @large419 ($5.01 in chips) 
Seat 3: Woodruff7 ($5.92 in chips) 
Seat 4: delm44 ($5.05 in chips) 
Seat 5: PlayTheBlues4U ($5.18 in chips) 
Seat 6: Babu1738 ($5.78 in chips) 
delm44: posts small blind $0.02
PlayTheBlues4U: posts big blind $0.05
*** HOLE CARDS ***
Dealt to PlayTheBlues4U [8c 2c]
Babu1738: folds 
@large419: calls $0.05
Woodruff7: folds 
delm44: calls $0.03
PlayTheBlues4U: checks 
*** FLOP *** [Jh Tc 6s]
delm44: checks 
PlayTheBlues4U: checks 
@large419: checks 
*** TURN *** [Jh Tc 6s] [5h]
delm44: bets $0.14
PlayTheBlues4U: folds 
@large419: folds 
Uncalled bet ($0.14) returned to delm44
delm44 collected $0.14 from pot
delm44: doesn't show hand 
*** SUMMARY ***
Total pot $0.15 | Rake $0.01 
Board [Jh Tc 6s 5h]
Seat 1: @large419 folded on the Turn
Seat 3: Woodruff7 (button) folded before Flop (didn't bet)
Seat 4: delm44 (small blind) collected ($0.14)
Seat 5: PlayTheBlues4U (big blind) folded on the Turn
Seat 6: Babu1738 folded before Flop (didn't bet)



PokerStars Hand #205253547584:  Hold'em No Limit ($0.02/$0.05 USD) - 2019/10/29 19:05:15 ET
Table 'Leo' 6-max Seat #4 is the button
Seat 1: @large419 ($4.96 in chips) 
Seat 2: th3h0use ($1.78 in chips) 
Seat 3: Woodruff7 ($5.92 in chips) 
Seat 4: delm44 ($5.14 in chips) 
Seat 5: PlayTheBlues4U ($5.13 in chips) 
Seat 6: Babu1738 ($5.78 in chips) 
PlayTheBlues4U: posts small blind $0.02
Babu1738: posts big blind $0.05
th3h0use: posts small & big blinds $0.07
*** HOLE CARDS ***
Dealt to PlayTheBlues4U [7c 8d]
@large419: calls $0.05
th3h0use: raises $0.05 to $0.10
Woodruff7: folds 
delm44: calls $0.10
PlayTheBlues4U: folds 
Babu1738: folds 
@large419: calls $0.05
*** FLOP *** [3d Js 3c]
@large419: checks 
th3h0use: bets $0.35
delm44: folds 
@large419: folds 
Uncalled bet ($0.35) returned to th3h0use
th3h0use collected $0.37 from pot
*** SUMMARY ***
Total pot $0.39 | Rake $0.02 
Board [3d Js 3c]
Seat 1: @large419 folded on the Flop
Seat 2: th3h0use collected ($0.37)
Seat 3: Woodruff7 folded before Flop (didn't bet)
Seat 4: delm44 (button) folded on the Flop
Seat 5: PlayTheBlues4U (small blind) folded before Flop
Seat 6: Babu1738 (big blind) folded before Flop



PokerStars Hand #205253547716:  Hold'em No Limit ($0.02/$0.05 USD) - 2019/10/29 19:06:07 ET
Table 'Leo' 6-max Seat #5 is the button
Seat 1: @large419 ($4.86 in chips) 
Seat 2: th3h0use ($2.03 in chips) 
Seat 3: Woodruff7 ($5.92 in chips) 
Seat 4: delm44 ($5.04 in chips) 
Seat 5: PlayTheBlues4U ($5.11 in chips) 
Seat 6: Babu1738 ($5.73 in chips) 
Babu1738: posts small blind $0.02
@large419: posts big blind $0.05
*** HOLE CARDS ***
Dealt to PlayTheBlues4U [2s 8h]
th3h0use: calls $0.05
Woodruff7: folds 
delm44: calls $0.05
PlayTheBlues4U: folds 
Babu1738: folds 
@large419: checks 
*** FLOP *** [4d Th Ah]
@large419: checks 
th3h0use: checks 
delm44: checks 
*** TURN *** [4d Th Ah] [Ac]
@large419: checks 
th3h0use: checks 
delm44: checks 
*** RIVER *** [4d Th Ah Ac] [Ts]
@large419: checks 
th3h0use: checks 
delm44: checks 
*** SHOW DOWN ***
@large419: shows [9h Jh] (two pair, Aces and Tens)
th3h0use: shows [Kc 3s] (two pair, Aces and Tens - King kicker)
delm44: mucks hand 
th3h0use collected $0.16 from pot
*** SUMMARY ***
Total pot $0.17 | Rake $0.01 
Board [4d Th Ah Ac Ts]
Seat 1: @large419 (big blind) showed [9h Jh] and lost with two pair, Aces and Tens
Seat 2: th3h0use showed [Kc 3s] and won ($0.16) with two pair, Aces and Tens
Seat 3: Woodruff7 folded before Flop (didn't bet)
Seat 4: delm44 mucked [7s Qs]
Seat 5: PlayTheBlues4U (button) folded before Flop (didn't bet)
Seat 6: Babu1738 (small blind) folded before Flop



PokerStars Hand #205253547854:  Hold'em No Limit ($0.02/$0.05 USD) - 2019/10/29 19:07:05 ET
Table 'Leo' 6-max Seat #6 is the button
Seat 1: @large419 ($4.81 in chips) 
Seat 3: Woodruff7 ($5.92 in chips) 
Seat 4: delm44 ($4.99 in chips) 
Seat 5: PlayTheBlues4U ($5.11 in chips) 
Seat 6: Babu1738 ($5.71 in chips) 
@large419: posts small blind $0.02
Woodruff7: posts big blind $0.05
*** HOLE CARDS ***
Dealt to PlayTheBlues4U [3c 6h]
delm44: calls $0.05
PlayTheBlues4U: folds 
Babu1738: folds 
@large419: folds 
Woodruff7: checks 
*** FLOP *** [8c 5c 7h]
Woodruff7: bets $0.05
delm44: calls $0.05
*** TURN *** [8c 5c 7h] [Td]
Woodruff7: bets $0.08
delm44: raises $0.52 to $0.60
Woodruff7: folds 
Uncalled bet ($0.52) returned to delm44
delm44 collected $0.36 from pot
delm44: doesn't show hand 
*** SUMMARY ***
Total pot $0.38 | Rake $0.02 
Board [8c 5c 7h Td]
Seat 1: @large419 (small blind) folded before Flop
Seat 3: Woodruff7 (big blind) folded on the Turn
Seat 4: delm44 collected ($0.36)
Seat 5: PlayTheBlues4U folded before Flop (didn't bet)
Seat 6: Babu1738 (button) folded before Flop (didn't bet)



PokerStars Hand #205253548051:  Hold'em No Limit ($0.02/$0.05 USD) - 2019/10/29 19:08:26 ET
Table 'Leo' 6-max Seat #1 is the button
Seat 1: @large419 ($4.79 in chips) 
Seat 3: Woodruff7 ($5.74 in chips) 
Seat 4: delm44 ($5.17 in chips) 
Seat 5: PlayTheBlues4U ($5.11 in chips) 
Seat 6: Babu1738 ($5.71 in chips) 
Woodruff7: posts small blind $0.02
delm44: posts big blind $0.05
*** HOLE CARDS ***
Dealt to PlayTheBlues4U [5d Jd]
PlayTheBlues4U: folds 
Babu1738: folds 
@large419: calls $0.05
Woodruff7: folds 
delm44: checks 
*** FLOP *** [3h 9s Qh]
delm44: checks 
@large419: checks 
*** TURN *** [3h 9s Qh] [2s]
delm44: bets $0.05
@large419: folds 
Uncalled bet ($0.05) returned to delm44
delm44 collected $0.11 from pot
delm44: doesn't show hand 
*** SUMMARY ***
Total pot $0.12 | Rake $0.01 
Board [3h 9s Qh 2s]
Seat 1: @large419 (button) folded on the Turn
Seat 3: Woodruff7 (small blind) folded before Flop
Seat 4: delm44 (big blind) collected ($0.11)
Seat 5: PlayTheBlues4U folded before Flop (didn't bet)
Seat 6: Babu1738 folded before Flop (didn't bet)



PokerStars Hand #205253548192:  Hold'em No Limit ($0.02/$0.05 USD) - 2019/10/29 19:09:22 ET
Table 'Leo' 6-max Seat #3 is the button
Seat 1: @large419 ($4.74 in chips) 
Seat 3: Woodruff7 ($5.72 in chips) 
Seat 4: delm44 ($5.23 in chips) 
Seat 5: PlayTheBlues4U ($5.11 in chips) 
Seat 6: Babu1738 ($5.71 in chips) 
delm44: posts small blind $0.02
PlayTheBlues4U: posts big blind $0.05
th3h0use: sits out 
*** HOLE CARDS ***
Dealt to PlayTheBlues4U [7h 4s]
Babu1738: folds 
@large419: calls $0.05
Woodruff7: raises $0.15 to $0.20
delm44: folds 
PlayTheBlues4U: folds 
@large419: folds 
Uncalled bet ($0.15) returned to Woodruff7
Woodruff7 collected $0.17 from pot
Woodruff7: doesn't show hand 
*** SUMMARY ***
Total pot $0.17 | Rake $0 
Seat 1: @large419 folded before Flop
Seat 3: Woodruff7 (button) collected ($0.17)
Seat 4: delm44 (small blind) folded before Flop
Seat 5: PlayTheBlues4U (big blind) folded before Flop
Seat 6: Babu1738 folded before Flop (didn't bet)



PokerStars Hand #205253548253:  Hold'em No Limit ($0.02/$0.05 USD) - 2019/10/29 19:09:47 ET
Table 'Leo' 6-max Seat #4 is the button
Seat 1: @large419 ($4.69 in chips) 
Seat 3: Woodruff7 ($5.84 in chips) 
Seat 4: delm44 ($5.21 in chips) 
Seat 5: PlayTheBlues4U ($5.06 in chips) 
Seat 6: Babu1738 ($5.71 in chips) 
PlayTheBlues4U: posts small blind $0.02
Babu1738: posts big blind $0.05
th3h0use: sits out 
*** HOLE CARDS ***
Dealt to PlayTheBlues4U [Ah Jc]
@large419: folds 
Woodruff7: folds 
delm44: folds 
PlayTheBlues4U: raises $0.10 to $0.15
Babu1738: folds 
Uncalled bet ($0.10) returned to PlayTheBlues4U
PlayTheBlues4U collected $0.10 from pot
PlayTheBlues4U: doesn't show hand 
*** SUMMARY ***
Total pot $0.10 | Rake $0 
Seat 1: @large419 folded before Flop (didn't bet)
Seat 3: Woodruff7 folded before Flop (didn't bet)
Seat 4: delm44 (button) folded before Flop (didn't bet)
Seat 5: PlayTheBlues4U (small blind) collected ($0.10)
Seat 6: Babu1738 (big blind) folded before Flop



PokerStars Hand #205253548298:  Hold'em No Limit ($0.02/$0.05 USD) - 2019/10/29 19:10:03 ET
Table 'Leo' 6-max Seat #5 is the button
Seat 1: @large419 ($4.69 in chips) 
Seat 3: Woodruff7 ($5.84 in chips) 
Seat 4: delm44 ($5.21 in chips) 
Seat 5: PlayTheBlues4U ($5.11 in chips) 
Seat 6: Babu1738 ($5.66 in chips) 
Babu1738: posts small blind $0.02
@large419: posts big blind $0.05
th3h0use: sits out 
*** HOLE CARDS ***
Dealt to PlayTheBlues4U [Kh Kd]
Woodruff7: folds 
delm44: folds 
PlayTheBlues4U: raises $0.10 to $0.15
Babu1738: folds 
@large419: folds 
Uncalled bet ($0.10) returned to PlayTheBlues4U
PlayTheBlues4U collected $0.12 from pot
PlayTheBlues4U: doesn't show hand 
*** SUMMARY ***
Total pot $0.12 | Rake $0 
Seat 1: @large419 (big blind) folded before Flop
Seat 3: Woodruff7 folded before Flop (didn't bet)
Seat 4: delm44 folded before Flop (didn't bet)
Seat 5: PlayTheBlues4U (button) collected ($0.12)
Seat 6: Babu1738 (small blind) folded before Flop



PokerStars Hand #205253548364:  Hold'em No Limit ($0.02/$0.05 USD) - 2019/10/29 19:10:29 ET
Table 'Leo' 6-max Seat #6 is the button
Seat 1: @large419 ($4.64 in chips) 
Seat 2: th3h0use ($2.14 in chips) 
Seat 3: Woodruff7 ($5.84 in chips) 
Seat 4: delm44 ($5.21 in chips) 
Seat 5: PlayTheBlues4U ($5.18 in chips) 
Seat 6: Babu1738 ($5.64 in chips) 
@large419: posts small blind $0.02
th3h0use: posts big blind $0.05
*** HOLE CARDS ***
Dealt to PlayTheBlues4U [7c 3h]
Woodruff7: folds 
delm44: calls $0.05
PlayTheBlues4U: folds 
Babu1738: folds 
@large419: calls $0.03
th3h0use: checks 
*** FLOP *** [Js 3c 9d]
@large419: checks 
th3h0use: checks 
delm44: bets $0.14
@large419: folds 
th3h0use has timed out
th3h0use: folds 
Uncalled bet ($0.14) returned to delm44
delm44 collected $0.14 from pot
delm44: doesn't show hand 
*** SUMMARY ***
Total pot $0.15 | Rake $0.01 
Board [Js 3c 9d]
Seat 1: @large419 (small blind) folded on the Flop
Seat 2: th3h0use (big blind) folded on the Flop
Seat 3: Woodruff7 folded before Flop (didn't bet)
Seat 4: delm44 collected ($0.14)
Seat 5: PlayTheBlues4U folded before Flop (didn't bet)
Seat 6: Babu1738 (button) folded before Flop (didn't bet)



PokerStars Hand #205253548775:  Hold'em No Limit ($0.02/$0.05 USD) - 2019/10/29 19:13:03 ET
Table 'Leo' 6-max Seat #1 is the button
Seat 1: @large419 ($4.59 in chips) 
Seat 3: Woodruff7 ($5.84 in chips) 
Seat 4: delm44 ($5.30 in chips) 
Seat 5: PlayTheBlues4U ($5.18 in chips) 
Seat 6: Babu1738 ($5.64 in chips) 
Woodruff7: posts small blind $0.02
delm44: posts big blind $0.05
*** HOLE CARDS ***
Dealt to PlayTheBlues4U [Ac 2c]
PlayTheBlues4U: folds 
Babu1738: raises $0.07 to $0.12
@large419: folds 
Woodruff7: folds 
delm44: calls $0.07
*** FLOP *** [Qs 5h 4c]
delm44: checks 
Babu1738: bets $0.15
delm44: folds 
Uncalled bet ($0.15) returned to Babu1738
Babu1738 collected $0.25 from pot
Babu1738: doesn't show hand 
*** SUMMARY ***
Total pot $0.26 | Rake $0.01 
Board [Qs 5h 4c]
Seat 1: @large419 (button) folded before Flop (didn't bet)
Seat 3: Woodruff7 (small blind) folded before Flop
Seat 4: delm44 (big blind) folded on the Flop
Seat 5: PlayTheBlues4U folded before Flop (didn't bet)
Seat 6: Babu1738 collected ($0.25)



PokerStars Hand #205253548869:  Hold'em No Limit ($0.02/$0.05 USD) - 2019/10/29 19:13:36 ET
Table 'Leo' 6-max Seat #3 is the button
Seat 1: @large419 ($4.59 in chips) 
Seat 3: Woodruff7 ($5.82 in chips) 
Seat 4: delm44 ($5.18 in chips) 
Seat 5: PlayTheBlues4U ($5.18 in chips) 
Seat 6: Babu1738 ($5.77 in chips) 
delm44: posts small blind $0.02
PlayTheBlues4U: posts big blind $0.05
*** HOLE CARDS ***
Dealt to PlayTheBlues4U [Qs Kd]
Babu1738: folds 
@large419: calls $0.05
Woodruff7: folds 
delm44: calls $0.03
PlayTheBlues4U: raises $0.10 to $0.15
@large419: folds 
delm44: folds 
Uncalled bet ($0.10) returned to PlayTheBlues4U
PlayTheBlues4U collected $0.15 from pot
PlayTheBlues4U: doesn't show hand 
*** SUMMARY ***
Total pot $0.15 | Rake $0 
Seat 1: @large419 folded before Flop
Seat 3: Woodruff7 (button) folded before Flop (didn't bet)
Seat 4: delm44 (small blind) folded before Flop
Seat 5: PlayTheBlues4U (big blind) collected ($0.15)
Seat 6: Babu1738 folded before Flop (didn't bet)



PokerStars Hand #205253548931:  Hold'em No Limit ($0.02/$0.05 USD) - 2019/10/29 19:13:58 ET
Table 'Leo' 6-max Seat #4 is the button
Seat 1: @large419 ($4.54 in chips) 
Seat 3: Woodruff7 ($5.82 in chips) 
Seat 4: delm44 ($5.13 in chips) 
Seat 5: PlayTheBlues4U ($5.28 in chips) 
Seat 6: Babu1738 ($5.77 in chips) 
PlayTheBlues4U: posts small blind $0.02
Babu1738: posts big blind $0.05
*** HOLE CARDS ***
Dealt to PlayTheBlues4U [Jd Jh]
@large419: calls $0.05
Woodruff7: folds 
delm44: folds 
PlayTheBlues4U: raises $0.10 to $0.15
Babu1738: folds 
@large419: calls $0.10
*** FLOP *** [9s 5d 4h]
PlayTheBlues4U: bets $0.25
@large419: calls $0.25
*** TURN *** [9s 5d 4h] [2d]
PlayTheBlues4U: checks 
@large419: bets $0.41
PlayTheBlues4U: calls $0.41
*** RIVER *** [9s 5d 4h 2d] [7d]
PlayTheBlues4U: checks 
@large419: checks 
*** SHOW DOWN ***
PlayTheBlues4U: shows [Jd Jh] (a pair of Jacks)
@large419: mucks hand 
PlayTheBlues4U collected $1.59 from pot
*** SUMMARY ***
Total pot $1.67 | Rake $0.08 
Board [9s 5d 4h 2d 7d]
Seat 1: @large419 mucked [Td Tc]
Seat 3: Woodruff7 folded before Flop (didn't bet)
Seat 4: delm44 (button) folded before Flop (didn't bet)
Seat 5: PlayTheBlues4U (small blind) showed [Jd Jh] and won ($1.59) with a pair of Jacks
Seat 6: Babu1738 (big blind) folded before Flop



PokerStars Hand #205253549117:  Hold'em No Limit ($0.02/$0.05 USD) - 2019/10/29 19:15:04 ET
Table 'Leo' 6-max Seat #5 is the button
Seat 1: @large419 ($3.73 in chips) 
Seat 3: Woodruff7 ($5.82 in chips) 
Seat 4: delm44 ($5.13 in chips) 
Seat 5: PlayTheBlues4U ($6.06 in chips) 
Seat 6: Babu1738 ($5.72 in chips) 
Babu1738: posts small blind $0.02
@large419: posts big blind $0.05
th3h0use: sits out 
*** HOLE CARDS ***
Dealt to PlayTheBlues4U [9c Jc]
Woodruff7: folds 
delm44: calls $0.05
PlayTheBlues4U: folds 
Babu1738: calls $0.03
@large419: checks 
*** FLOP *** [9h 4c 9s]
Babu1738: checks 
@large419: checks 
delm44: bets $0.05
Babu1738: calls $0.05
@large419: calls $0.05
*** TURN *** [9h 4c 9s] [6c]
Babu1738: checks 
@large419: checks 
delm44: checks 
*** RIVER *** [9h 4c 9s 6c] [5d]
Babu1738: checks 
@large419: checks 
delm44: checks 
*** SHOW DOWN ***
Babu1738: shows [7c 7d] (two pair, Nines and Sevens)
@large419: mucks hand 
delm44: mucks hand 
Babu1738 collected $0.28 from pot
*** SUMMARY ***
Total pot $0.30 | Rake $0.02 
Board [9h 4c 9s 6c 5d]
Seat 1: @large419 (big blind) mucked [Qc As]
Seat 3: Woodruff7 folded before Flop (didn't bet)
Seat 4: delm44 mucked [5h Th]
Seat 5: PlayTheBlues4U (button) folded before Flop (didn't bet)
Seat 6: Babu1738 (small blind) showed [7c 7d] and won ($0.28) with two pair, Nines and Sevens



PokerStars Hand #205253549312:  Hold'em No Limit ($0.02/$0.05 USD) - 2019/10/29 19:16:15 ET
Table 'Leo' 6-max Seat #6 is the button
Seat 1: @large419 ($4.95 in chips) 
Seat 2: th3h0use ($2.09 in chips) 
Seat 3: Woodruff7 ($5.82 in chips) 
Seat 4: delm44 ($5.03 in chips) 
Seat 5: PlayTheBlues4U ($6.06 in chips) 
Seat 6: Babu1738 ($5.90 in chips) 
@large419: posts small blind $0.02
th3h0use: posts big blind $0.05
*** HOLE CARDS ***
Dealt to PlayTheBlues4U [Tc 9c]
Woodruff7: raises $0.07 to $0.12
delm44: folds 
PlayTheBlues4U: calls $0.12
Babu1738: folds 
@large419: calls $0.10
th3h0use has timed out
th3h0use: folds 
*** FLOP *** [2s Jh 6c]
@large419: checks 
Woodruff7: bets $0.20
PlayTheBlues4U: folds 
@large419: folds 
Uncalled bet ($0.20) returned to Woodruff7
Woodruff7 collected $0.39 from pot
Woodruff7: doesn't show hand 
*** SUMMARY ***
Total pot $0.41 | Rake $0.02 
Board [2s Jh 6c]
Seat 1: @large419 (small blind) folded on the Flop
Seat 2: th3h0use (big blind) folded before Flop
Seat 3: Woodruff7 collected ($0.39)
Seat 4: delm44 folded before Flop (didn't bet)
Seat 5: PlayTheBlues4U folded on the Flop
Seat 6: Babu1738 (button) folded before Flop (didn't bet)



PokerStars Hand #205253549538:  Hold'em No Limit ($0.02/$0.05 USD) - 2019/10/29 19:17:35 ET
Table 'Leo' 6-max Seat #1 is the button
Seat 1: @large419 ($4.83 in chips) 
Seat 3: Woodruff7 ($6.09 in chips) 
Seat 4: delm44 ($5.03 in chips) 
Seat 5: PlayTheBlues4U ($5.94 in chips) 
Seat 6: Babu1738 ($5.90 in chips) 
Woodruff7: posts small blind $0.02
delm44: posts big blind $0.05
*** HOLE CARDS ***
Dealt to PlayTheBlues4U [Ac 6s]
PlayTheBlues4U: folds 
Babu1738: folds 
@large419: folds 
Woodruff7: folds 
Uncalled bet ($0.03) returned to delm44
delm44 collected $0.04 from pot
delm44: doesn't show hand 
*** SUMMARY ***
Total pot $0.04 | Rake $0 
Seat 1: @large419 (button) folded before Flop (didn't bet)
Seat 3: Woodruff7 (small blind) folded before Flop
Seat 4: delm44 (big blind) collected ($0.04)
Seat 5: PlayTheBlues4U folded before Flop (didn't bet)
Seat 6: Babu1738 folded before Flop (didn't bet)



PokerStars Hand #205253549575:  Hold'em No Limit ($0.02/$0.05 USD) - 2019/10/29 19:17:48 ET
Table 'Leo' 6-max Seat #3 is the button
Seat 1: @large419 ($4.83 in chips) 
Seat 3: Woodruff7 ($6.07 in chips) 
Seat 4: delm44 ($5.05 in chips) 
Seat 5: PlayTheBlues4U ($5.94 in chips) 
Seat 6: Babu1738 ($5.90 in chips) 
delm44: posts small blind $0.02
PlayTheBlues4U: posts big blind $0.05
*** HOLE CARDS ***
Dealt to PlayTheBlues4U [Tc 7c]
Babu1738: folds 
@large419: folds 
Woodruff7: raises $0.07 to $0.12
delm44: folds 
PlayTheBlues4U: calls $0.07
*** FLOP *** [9h Jc 7d]
PlayTheBlues4U: checks 
Woodruff7: bets $0.15
PlayTheBlues4U: calls $0.15
*** TURN *** [9h Jc 7d] [6c]
PlayTheBlues4U: checks 
Woodruff7: bets $0.30
PlayTheBlues4U: raises $0.60 to $0.90
Woodruff7: calls $0.60
*** RIVER *** [9h Jc 7d 6c] [2c]
PlayTheBlues4U: bets $2.05
Woodruff7: folds 
Uncalled bet ($2.05) returned to PlayTheBlues4U
PlayTheBlues4U collected $2.24 from pot
PlayTheBlues4U: doesn't show hand 
*** SUMMARY ***
Total pot $2.36 | Rake $0.12 
Board [9h Jc 7d 6c 2c]
Seat 1: @large419 folded before Flop (didn't bet)
Seat 3: Woodruff7 (button) folded on the River
Seat 4: delm44 (small blind) folded before Flop
Seat 5: PlayTheBlues4U (big blind) collected ($2.24)
Seat 6: Babu1738 folded before Flop (didn't bet)



PokerStars Hand #205253549886:  Hold'em No Limit ($0.02/$0.05 USD) - 2019/10/29 19:19:31 ET
Table 'Leo' 6-max Seat #4 is the button
Seat 1: @large419 ($4.83 in chips) 
Seat 2: th3h0use ($2.04 in chips) 
Seat 3: Woodruff7 ($4.90 in chips) 
Seat 4: delm44 ($5.03 in chips) 
Seat 5: PlayTheBlues4U ($7.01 in chips) 
Seat 6: Babu1738 ($5.90 in chips) 
PlayTheBlues4U: posts small blind $0.02
Babu1738: posts big blind $0.05
th3h0use: posts small blind $0.02
*** HOLE CARDS ***
Dealt to PlayTheBlues4U [Kc 4h]
@large419: calls $0.05
th3h0use has timed out
th3h0use: folds 
Woodruff7: folds 
delm44: calls $0.05
PlayTheBlues4U: folds 
Babu1738: checks 
*** FLOP *** [9h 8d Jh]
Babu1738: checks 
@large419: checks 
delm44: bets $0.18
Babu1738: folds 
@large419: folds 
Uncalled bet ($0.18) returned to delm44
delm44 collected $0.18 from pot
delm44: doesn't show hand 
*** SUMMARY ***
Total pot $0.19 | Rake $0.01 
Board [9h 8d Jh]
Seat 1: @large419 folded on the Flop
Seat 2: th3h0use folded before Flop (didn't bet)
Seat 3: Woodruff7 folded before Flop (didn't bet)
Seat 4: delm44 (button) collected ($0.18)
Seat 5: PlayTheBlues4U (small blind) folded before Flop
Seat 6: Babu1738 (big blind) folded on the Flop



PokerStars Hand #205254350957:  Hold'em No Limit ($0.02/$0.05 USD) - 2019/10/29 19:20:30 ET
Table 'Leo' 6-max Seat #5 is the button
Seat 1: @large419 ($4.78 in chips) 
Seat 3: Woodruff7 ($4.90 in chips) 
Seat 4: delm44 ($5.16 in chips) 
Seat 5: PlayTheBlues4U ($6.99 in chips) 
Seat 6: Babu1738 ($5.85 in chips) 
Babu1738: posts small blind $0.02
@large419: posts big blind $0.05
*** HOLE CARDS ***
Dealt to PlayTheBlues4U [5h Jd]
Woodruff7: raises $0.07 to $0.12
delm44: folds 
PlayTheBlues4U: folds 
Babu1738: raises $0.18 to $0.30
@large419: folds 
Woodruff7: calls $0.18
*** FLOP *** [8s Ad 9s]
Babu1738: bets $0.37
Woodruff7: folds 
Uncalled bet ($0.37) returned to Babu1738
Babu1738 collected $0.62 from pot
Babu1738: doesn't show hand 
*** SUMMARY ***
Total pot $0.65 | Rake $0.03 
Board [8s Ad 9s]
Seat 1: @large419 (big blind) folded before Flop
Seat 3: Woodruff7 folded on the Flop
Seat 4: delm44 folded before Flop (didn't bet)
Seat 5: PlayTheBlues4U (button) folded before Flop (didn't bet)
Seat 6: Babu1738 (small blind) collected ($0.62)



PokerStars Hand #205254351077:  Hold'em No Limit ($0.02/$0.05 USD) - 2019/10/29 19:21:09 ET
Table 'Leo' 6-max Seat #6 is the button
Seat 1: @large419 ($4.73 in chips) 
Seat 2: th3h0use ($2.02 in chips) 
Seat 3: Woodruff7 ($4.60 in chips) 
Seat 4: delm44 ($5.16 in chips) 
Seat 5: PlayTheBlues4U ($6.99 in chips) 
Seat 6: Babu1738 ($6.17 in chips) 
@large419: posts small blind $0.02
th3h0use: posts big blind $0.05
*** HOLE CARDS ***
Dealt to PlayTheBlues4U [7c 6s]
Woodruff7: folds 
delm44: folds 
PlayTheBlues4U: folds 
Babu1738: folds 
@large419: folds 
Uncalled bet ($0.03) returned to th3h0use
th3h0use collected $0.04 from pot
*** SUMMARY ***
Total pot $0.04 | Rake $0 
Seat 1: @large419 (small blind) folded before Flop
Seat 2: th3h0use (big blind) collected ($0.04)
Seat 3: Woodruff7 folded before Flop (didn't bet)
Seat 4: delm44 folded before Flop (didn't bet)
Seat 5: PlayTheBlues4U folded before Flop (didn't bet)
Seat 6: Babu1738 (button) folded before Flop (didn't bet)



PokerStars Hand #205254351153:  Hold'em No Limit ($0.02/$0.05 USD) - 2019/10/29 19:21:33 ET
Table 'Leo' 6-max Seat #1 is the button
Seat 1: @large419 ($4.71 in chips) 
Seat 2: th3h0use ($2.04 in chips) 
Seat 3: Woodruff7 ($4.60 in chips) 
Seat 4: delm44 ($5.16 in chips) 
Seat 5: PlayTheBlues4U ($6.99 in chips) 
Seat 6: Babu1738 ($6.17 in chips) 
th3h0use: posts small blind $0.02
Woodruff7: posts big blind $0.05
*** HOLE CARDS ***
Dealt to PlayTheBlues4U [Ad 5d]
delm44: folds 
PlayTheBlues4U: folds 
Babu1738: raises $0.07 to $0.12
@large419: folds 
th3h0use has timed out
th3h0use: folds 
Woodruff7: folds 
Uncalled bet ($0.07) returned to Babu1738
Babu1738 collected $0.12 from pot
Babu1738: doesn't show hand 
*** SUMMARY ***
Total pot $0.12 | Rake $0 
Seat 1: @large419 (button) folded before Flop (didn't bet)
Seat 2: th3h0use (small blind) folded before Flop
Seat 3: Woodruff7 (big blind) folded before Flop
Seat 4: delm44 folded before Flop (didn't bet)
Seat 5: PlayTheBlues4U folded before Flop (didn't bet)
Seat 6: Babu1738 collected ($0.12)



PokerStars Hand #205254351310:  Hold'em No Limit ($0.02/$0.05 USD) - 2019/10/29 19:22:22 ET
Table 'Leo' 6-max Seat #3 is the button
Seat 1: @large419 ($4.71 in chips) 
Seat 3: Woodruff7 ($5 in chips) 
Seat 4: delm44 ($5.16 in chips) 
Seat 5: PlayTheBlues4U ($6.99 in chips) 
Seat 6: Babu1738 ($6.24 in chips) 
delm44: posts small blind $0.02
PlayTheBlues4U: posts big blind $0.05
*** HOLE CARDS ***
Dealt to PlayTheBlues4U [3c 3h]
Babu1738: folds 
@large419: calls $0.05
Woodruff7: folds 
delm44: calls $0.03
PlayTheBlues4U: checks 
*** FLOP *** [Js 9h 8d]
delm44: bets $0.05
PlayTheBlues4U: folds 
@large419: folds 
Uncalled bet ($0.05) returned to delm44
delm44 collected $0.14 from pot
delm44: doesn't show hand 
*** SUMMARY ***
Total pot $0.15 | Rake $0.01 
Board [Js 9h 8d]
Seat 1: @large419 folded on the Flop
Seat 3: Woodruff7 (button) folded before Flop (didn't bet)
Seat 4: delm44 (small blind) collected ($0.14)
Seat 5: PlayTheBlues4U (big blind) folded on the Flop
Seat 6: Babu1738 folded before Flop (didn't bet)



PokerStars Hand #205254351387:  Hold'em No Limit ($0.02/$0.05 USD) - 2019/10/29 19:22:46 ET
Table 'Leo' 6-max Seat #4 is the button
Seat 1: @large419 ($4.66 in chips) 
Seat 2: th3h0use ($2.02 in chips) 
Seat 3: Woodruff7 ($5 in chips) 
Seat 4: delm44 ($5.25 in chips) 
Seat 5: PlayTheBlues4U ($6.94 in chips) 
Seat 6: Babu1738 ($6.24 in chips) 
PlayTheBlues4U: posts small blind $0.02
Babu1738: posts big blind $0.05
*** HOLE CARDS ***
Dealt to PlayTheBlues4U [3h 9d]
@large419: folds 
th3h0use: folds 
Woodruff7: folds 
delm44: folds 
PlayTheBlues4U: folds 
Uncalled bet ($0.03) returned to Babu1738
Babu1738 collected $0.04 from pot
Babu1738: doesn't show hand 
*** SUMMARY ***
Total pot $0.04 | Rake $0 
Seat 1: @large419 folded before Flop (didn't bet)
Seat 2: th3h0use folded before Flop (didn't bet)
Seat 3: Woodruff7 folded before Flop (didn't bet)
Seat 4: delm44 (button) folded before Flop (didn't bet)
Seat 5: PlayTheBlues4U (small blind) folded before Flop
Seat 6: Babu1738 (big blind) collected ($0.04)



PokerStars Hand #205254351436:  Hold'em No Limit ($0.02/$0.05 USD) - 2019/10/29 19:23:05 ET
Table 'Leo' 6-max Seat #5 is the button
Seat 1: @large419 ($4.66 in chips) 
Seat 2: th3h0use ($2.02 in chips) 
Seat 3: Woodruff7 ($5 in chips) 
Seat 4: delm44 ($5.25 in chips) 
Seat 5: PlayTheBlues4U ($6.92 in chips) 
Seat 6: Babu1738 ($6.26 in chips) 
Babu1738: posts small blind $0.02
@large419: posts big blind $0.05
*** HOLE CARDS ***
Dealt to PlayTheBlues4U [Kh 9d]
th3h0use: raises $0.05 to $0.10
Woodruff7: raises $0.22 to $0.32
delm44: folds 
PlayTheBlues4U: folds 
Babu1738: folds 
@large419: folds 
th3h0use: calls $0.22
*** FLOP *** [9c Kc 9h]
th3h0use: checks 
Woodruff7: bets $0.35
th3h0use: folds 
Uncalled bet ($0.35) returned to Woodruff7
Woodruff7 collected $0.67 from pot
Woodruff7: doesn't show hand 
*** SUMMARY ***
Total pot $0.71 | Rake $0.04 
Board [9c Kc 9h]
Seat 1: @large419 (big blind) folded before Flop
Seat 2: th3h0use folded on the Flop
Seat 3: Woodruff7 collected ($0.67)
Seat 4: delm44 folded before Flop (didn't bet)
Seat 5: PlayTheBlues4U (button) folded before Flop (didn't bet)
Seat 6: Babu1738 (small blind) folded before Flop



PokerStars Hand #205254351587:  Hold'em No Limit ($0.02/$0.05 USD) - 2019/10/29 19:23:57 ET
Table 'Leo' 6-max Seat #6 is the button
Seat 1: @large419 ($4.61 in chips) 
Seat 2: th3h0use ($3.70 in chips) 
Seat 3: Woodruff7 ($5.35 in chips) 
Seat 4: delm44 ($5.25 in chips) 
Seat 5: PlayTheBlues4U ($6.92 in chips) 
Seat 6: Babu1738 ($6.24 in chips) 
@large419: posts small blind $0.02
th3h0use: posts big blind $0.05
*** HOLE CARDS ***
Dealt to PlayTheBlues4U [3s 2c]
Woodruff7: folds 
delm44: folds 
PlayTheBlues4U: folds 
Babu1738: folds 
@large419: calls $0.03
th3h0use: checks 
*** FLOP *** [5d 9h 8h]
@large419: checks 
th3h0use: checks 
*** TURN *** [5d 9h 8h] [6d]
@large419: checks 
th3h0use: bets $0.10
@large419: folds 
Uncalled bet ($0.10) returned to th3h0use
th3h0use collected $0.10 from pot
*** SUMMARY ***
Total pot $0.10 | Rake $0 
Board [5d 9h 8h 6d]
Seat 1: @large419 (small blind) folded on the Turn
Seat 2: th3h0use (big blind) collected ($0.10)
Seat 3: Woodruff7 folded before Flop (didn't bet)
Seat 4: delm44 folded before Flop (didn't bet)
Seat 5: PlayTheBlues4U folded before Flop (didn't bet)
Seat 6: Babu1738 (button) folded before Flop (didn't bet)
