*********** # 1 **************
PokerStars Hand #203589434317:  Hold'em No Limit ($0.01/$0.02 USD) - 2019/09/10 23:08:33 ET
Table 'Rana' 6-max Seat #2 is the button
Seat 1: PlayTheBlues4U ($2.73 in chips)
Seat 2: xxzuluzuluxx ($0.72 in chips)
Seat 4: michelina44 ($0.75 in chips)
Seat 5: catgotmytongue ($2.32 in chips)
michelina44: posts small blind $0.01
catgotmytongue: posts big blind $0.02
*** HOLE CARDS ***
Dealt to PlayTheBlues4U [3c 4s]
PlayTheBlues4U: folds
xxzuluzuluxx: raises $0.05 to $0.07
michelina44: folds
catgotmytongue: folds
Uncalled bet ($0.05) returned to xxzuluzuluxx
xxzuluzuluxx collected $0.05 from pot
xxzuluzuluxx: doesn't show hand
*** SUMMARY ***
Total pot $0.05 | Rake $0
Seat 1: PlayTheBlues4U folded before Flop (didn't bet)
Seat 2: xxzuluzuluxx (button) collected ($0.05)
Seat 4: michelina44 (small blind) folded before Flop
Seat 5: catgotmytongue (big blind) folded before Flop


*********** # 2 **************
PokerStars Hand #203589434258:  Hold'em No Limit ($0.01/$0.02 USD) - 2019/09/10 23:08:12 ET
Table 'Rana' 6-max Seat #1 is the button
Seat 1: PlayTheBlues4U ($2.73 in chips)
Seat 2: xxzuluzuluxx ($0.78 in chips)
Seat 4: michelina44 ($0.77 in chips)
Seat 5: catgotmytongue ($2.25 in chips)
xxzuluzuluxx: posts small blind $0.01
michelina44: posts big blind $0.02
*** HOLE CARDS ***
Dealt to PlayTheBlues4U [2s 6c]
catgotmytongue: raises $0.04 to $0.06
PlayTheBlues4U: folds
xxzuluzuluxx: calls $0.05
michelina44: folds
*** FLOP *** [9c 7h 2h]
xxzuluzuluxx: checks
catgotmytongue: bets $0.13
xxzuluzuluxx: folds [5s]
Uncalled bet ($0.13) returned to catgotmytongue
catgotmytongue collected $0.13 from pot
catgotmytongue: doesn't show hand
*** SUMMARY ***
Total pot $0.14 | Rake $0.01
Board [9c 7h 2h]
Seat 1: PlayTheBlues4U (button) folded before Flop (didn't bet)
Seat 2: xxzuluzuluxx (small blind) folded on the Flop
Seat 4: michelina44 (big blind) folded before Flop
Seat 5: catgotmytongue collected ($0.13)


*********** # 3 **************
PokerStars Hand #203589434196:  Hold'em No Limit ($0.01/$0.02 USD) - 2019/09/10 23:07:51 ET
Table 'Jabbah' 6-max Seat #6 is the button
Seat 2: TomT87 ($0.77 in chips)
Seat 4: TroyBoy3912 ($2.86 in chips)
Seat 5: PlayTheBlues4U ($2.18 in chips)
Seat 6: Redkin20 ($1.46 in chips)
TomT87: posts small blind $0.01
TroyBoy3912: posts big blind $0.02
*** HOLE CARDS ***
Dealt to PlayTheBlues4U [2c 8c]
PlayTheBlues4U: folds
Redkin20: calls $0.02
TomT87: folds
TroyBoy3912: checks
*** FLOP *** [Jd 2d Ks]
TroyBoy3912: checks
Redkin20: checks
*** TURN *** [Jd 2d Ks] [Qc]
TroyBoy3912: checks
Redkin20: bets $0.04
TroyBoy3912: folds
Uncalled bet ($0.04) returned to Redkin20
Redkin20 collected $0.05 from pot
Redkin20: doesn't show hand
*** SUMMARY ***
Total pot $0.05 | Rake $0
Board [Jd 2d Ks Qc]
Seat 2: TomT87 (small blind) folded before Flop
Seat 4: TroyBoy3912 (big blind) folded on the Turn
Seat 5: PlayTheBlues4U folded before Flop (didn't bet)
Seat 6: Redkin20 (button) collected ($0.05)


*********** # 4 **************
PokerStars Hand #203589434177:  Hold'em No Limit ($0.01/$0.02 USD) - 2019/09/10 23:07:46 ET
Table 'Rana' 6-max Seat #6 is the button
Seat 1: PlayTheBlues4U ($2.74 in chips)
Seat 2: xxzuluzuluxx ($0.80 in chips)
Seat 4: michelina44 ($0.77 in chips)
Seat 5: catgotmytongue ($2.22 in chips)
Seat 6: DruMoney201 ($3.12 in chips)
PlayTheBlues4U: posts small blind $0.01
xxzuluzuluxx: posts big blind $0.02
*** HOLE CARDS ***
Dealt to PlayTheBlues4U [5d Qd]
michelina44: folds
catgotmytongue: calls $0.02
DruMoney201: folds
PlayTheBlues4U: folds
xxzuluzuluxx: checks
*** FLOP *** [Ac Kh 2h]
DruMoney201 leaves the table
xxzuluzuluxx: checks
catgotmytongue: checks
*** TURN *** [Ac Kh 2h] [4s]
xxzuluzuluxx: checks
catgotmytongue: checks
*** RIVER *** [Ac Kh 2h 4s] [Kd]
xxzuluzuluxx: checks
catgotmytongue: checks
*** SHOW DOWN ***
xxzuluzuluxx: shows [3d 8c] (a pair of Kings)
catgotmytongue: shows [Qs 9s] (a pair of Kings - Ace+Queen kicker)
catgotmytongue collected $0.05 from pot
*** SUMMARY ***
Total pot $0.05 | Rake $0
Board [Ac Kh 2h 4s Kd]
Seat 1: PlayTheBlues4U (small blind) folded before Flop
Seat 2: xxzuluzuluxx (big blind) showed [3d 8c] and lost with a pair of Kings
Seat 4: michelina44 folded before Flop (didn't bet)
Seat 5: catgotmytongue showed [Qs 9s] and won ($0.05) with a pair of Kings
Seat 6: DruMoney201 (button) folded before Flop (didn't bet)


*********** # 5 **************
PokerStars Hand #203589434070:  Hold'em No Limit ($0.01/$0.02 USD) - 2019/09/10 23:07:11 ET
Table 'Rana' 6-max Seat #5 is the button
Seat 1: PlayTheBlues4U ($2.74 in chips)
Seat 4: michelina44 ($0.77 in chips)
Seat 5: catgotmytongue ($2.22 in chips)
Seat 6: DruMoney201 ($3.12 in chips)
DruMoney201: posts small blind $0.01
PlayTheBlues4U: posts big blind $0.02
*** HOLE CARDS ***
Dealt to PlayTheBlues4U [Qc 2c]
michelina44: folds
catgotmytongue: folds
DruMoney201: calls $0.01
PlayTheBlues4U: checks
*** FLOP *** [Jd Ac 9d]
DruMoney201: checks
PlayTheBlues4U: checks
*** TURN *** [Jd Ac 9d] [9h]
DruMoney201: checks
PlayTheBlues4U: checks
*** RIVER *** [Jd Ac 9d 9h] [6h]
DruMoney201: checks
PlayTheBlues4U: checks
*** SHOW DOWN ***
DruMoney201: shows [3d Qh] (a pair of Nines)
PlayTheBlues4U: shows [Qc 2c] (a pair of Nines)
DruMoney201 collected $0.02 from pot
PlayTheBlues4U collected $0.02 from pot
*** SUMMARY ***
Total pot $0.04 | Rake $0
Board [Jd Ac 9d 9h 6h]
Seat 1: PlayTheBlues4U (big blind) showed [Qc 2c] and won ($0.02) with a pair of Nines
Seat 4: michelina44 folded before Flop (didn't bet)
Seat 5: catgotmytongue (button) folded before Flop (didn't bet)
Seat 6: DruMoney201 (small blind) showed [3d Qh] and won ($0.02) with a pair of Nines


*********** # 6 **************
PokerStars Hand #203589433997:  Hold'em No Limit ($0.01/$0.02 USD) - 2019/09/10 23:06:48 ET
Table 'Jabbah' 6-max Seat #5 is the button
Seat 2: TomT87 ($0.89 in chips)
Seat 4: TroyBoy3912 ($2.86 in chips)
Seat 5: PlayTheBlues4U ($1.96 in chips)
Seat 6: Redkin20 ($1.58 in chips)
Redkin20: posts small blind $0.01
TomT87: posts big blind $0.02
*** HOLE CARDS ***
Dealt to PlayTheBlues4U [Ac 6s]
TroyBoy3912: folds
PlayTheBlues4U: raises $0.04 to $0.06
Redkin20: calls $0.05
TomT87: calls $0.04
*** FLOP *** [4c 9h Ts]
Redkin20: checks
TomT87: checks
PlayTheBlues4U: bets $0.06
Redkin20: calls $0.06
TomT87: calls $0.06
*** TURN *** [4c 9h Ts] [2s]
Redkin20: checks
TomT87: checks
PlayTheBlues4U: checks
*** RIVER *** [4c 9h Ts 2s] [5d]
Redkin20: checks
TomT87: checks
PlayTheBlues4U: checks
*** SHOW DOWN ***
Redkin20: shows [7c Jc] (high card Jack)
TomT87: shows [Qc 8c] (high card Queen)
PlayTheBlues4U: shows [Ac 6s] (high card Ace)
PlayTheBlues4U collected $0.34 from pot
*** SUMMARY ***
Total pot $0.36 | Rake $0.02
Board [4c 9h Ts 2s 5d]
Seat 2: TomT87 (big blind) showed [Qc 8c] and lost with high card Queen
Seat 4: TroyBoy3912 folded before Flop (didn't bet)
Seat 5: PlayTheBlues4U (button) showed [Ac 6s] and won ($0.34) with high card Ace
Seat 6: Redkin20 (small blind) showed [7c Jc] and lost with high card Jack


*********** # 7 **************
PokerStars Hand #203589433955:  Hold'em No Limit ($0.01/$0.02 USD) - 2019/09/10 23:06:37 ET
Table 'Rana' 6-max Seat #4 is the button
Seat 1: PlayTheBlues4U ($2.74 in chips)
Seat 4: michelina44 ($0.77 in chips)
Seat 5: catgotmytongue ($2.20 in chips)
Seat 6: DruMoney201 ($3.14 in chips)
catgotmytongue: posts small blind $0.01
DruMoney201: posts big blind $0.02
*** HOLE CARDS ***
Dealt to PlayTheBlues4U [Qd 8d]
PlayTheBlues4U: folds
michelina44: folds
catgotmytongue: raises $0.04 to $0.06
DruMoney201: folds
Uncalled bet ($0.04) returned to catgotmytongue
catgotmytongue collected $0.04 from pot
catgotmytongue: doesn't show hand
*** SUMMARY ***
Total pot $0.04 | Rake $0
Seat 1: PlayTheBlues4U folded before Flop (didn't bet)
Seat 4: michelina44 (button) folded before Flop (didn't bet)
Seat 5: catgotmytongue (small blind) collected ($0.04)
Seat 6: DruMoney201 (big blind) folded before Flop


*********** # 8 **************
PokerStars Hand #203589433871:  Hold'em No Limit ($0.01/$0.02 USD) - 2019/09/10 23:06:07 ET
Table 'Rana' 6-max Seat #2 is the button
Seat 1: PlayTheBlues4U ($2.74 in chips)
Seat 2: xxzuluzuluxx ($0.34 in chips)
Seat 4: michelina44 ($0.78 in chips)
Seat 5: catgotmytongue ($1.88 in chips)
Seat 6: DruMoney201 ($3.14 in chips)
michelina44: posts small blind $0.01
catgotmytongue: posts big blind $0.02
*** HOLE CARDS ***
Dealt to PlayTheBlues4U [2h Th]
DruMoney201: folds
PlayTheBlues4U: folds
xxzuluzuluxx: calls $0.02
michelina44: folds
catgotmytongue: checks
*** FLOP *** [Jd Ad 4c]
catgotmytongue: checks
xxzuluzuluxx: bets $0.04
catgotmytongue: raises $0.13 to $0.17
xxzuluzuluxx: raises $0.13 to $0.30
catgotmytongue: calls $0.13
*** TURN *** [Jd Ad 4c] [9c]
catgotmytongue: bets $0.02
xxzuluzuluxx: calls $0.02 and is all-in
*** RIVER *** [Jd Ad 4c 9c] [5h]
*** SHOW DOWN ***
catgotmytongue: shows [Ac 7s] (a pair of Aces)
xxzuluzuluxx: shows [As 3c] (a pair of Aces - lower kicker)
catgotmytongue collected $0.66 from pot
*** SUMMARY ***
Total pot $0.69 | Rake $0.03
Board [Jd Ad 4c 9c 5h]
Seat 1: PlayTheBlues4U folded before Flop (didn't bet)
Seat 2: xxzuluzuluxx (button) showed [As 3c] and lost with a pair of Aces
Seat 4: michelina44 (small blind) folded before Flop
Seat 5: catgotmytongue (big blind) showed [Ac 7s] and won ($0.66) with a pair of Aces
Seat 6: DruMoney201 folded before Flop (didn't bet)


*********** # 9 **************
PokerStars Hand #203589433835:  Hold'em No Limit ($0.01/$0.02 USD) - 2019/09/10 23:05:57 ET
Table 'Rana' 6-max Seat #1 is the button
Seat 1: PlayTheBlues4U ($2.74 in chips)
Seat 2: xxzuluzuluxx ($0.35 in chips)
Seat 4: michelina44 ($0.77 in chips)
Seat 5: catgotmytongue ($1.88 in chips)
Seat 6: DruMoney201 ($3.14 in chips)
xxzuluzuluxx: posts small blind $0.01
michelina44: posts big blind $0.02
*** HOLE CARDS ***
Dealt to PlayTheBlues4U [9c Kd]
catgotmytongue: folds
DruMoney201: folds
PlayTheBlues4U: folds
xxzuluzuluxx: folds
Uncalled bet ($0.01) returned to michelina44
michelina44 collected $0.02 from pot
michelina44: doesn't show hand
*** SUMMARY ***
Total pot $0.02 | Rake $0
Seat 1: PlayTheBlues4U (button) folded before Flop (didn't bet)
Seat 2: xxzuluzuluxx (small blind) folded before Flop
Seat 4: michelina44 (big blind) collected ($0.02)
Seat 5: catgotmytongue folded before Flop (didn't bet)
Seat 6: DruMoney201 folded before Flop (didn't bet)


*********** # 10 **************
PokerStars Hand #203589433807:  Hold'em No Limit ($0.01/$0.02 USD) - 2019/09/10 23:05:48 ET
Table 'Jabbah' 6-max Seat #4 is the button
Seat 2: TomT87 ($1.25 in chips)
Seat 4: TroyBoy3912 ($2.88 in chips)
Seat 5: PlayTheBlues4U ($1.98 in chips)
Seat 6: Redkin20 ($1.21 in chips)
PlayTheBlues4U: posts small blind $0.01
Redkin20: posts big blind $0.02
*** HOLE CARDS ***
Dealt to PlayTheBlues4U [7h Qd]
TomT87: calls $0.02
TroyBoy3912: calls $0.02
PlayTheBlues4U: calls $0.01
Redkin20: checks
*** FLOP *** [3h 8h 3s]
PlayTheBlues4U: checks
Redkin20: bets $0.08
TomT87: calls $0.08
TroyBoy3912: folds
PlayTheBlues4U: folds
*** TURN *** [3h 8h 3s] [8d]
Redkin20: checks
TomT87: checks
*** RIVER *** [3h 8h 3s 8d] [Ac]
Redkin20: bets $0.26
TomT87: calls $0.26
*** SHOW DOWN ***
Redkin20: shows [8c 4h] (a full house, Eights full of Threes)
TomT87: mucks hand
Redkin20 collected $0.73 from pot
*** SUMMARY ***
Total pot $0.76 | Rake $0.03
Board [3h 8h 3s 8d Ac]
Seat 2: TomT87 mucked [Jc Jh]
Seat 4: TroyBoy3912 (button) folded on the Flop
Seat 5: PlayTheBlues4U (small blind) folded on the Flop
Seat 6: Redkin20 (big blind) showed [8c 4h] and won ($0.73) with a full house, Eights full of Threes


*********** # 11 **************
PokerStars Hand #203589433697:  Hold'em No Limit ($0.01/$0.02 USD) - 2019/09/10 23:05:10 ET
Table 'Jabbah' 6-max Seat #2 is the button
Seat 2: TomT87 ($1.31 in chips)
Seat 4: TroyBoy3912 ($2.89 in chips)
Seat 5: PlayTheBlues4U ($1.92 in chips)
Seat 6: Redkin20 ($1.21 in chips)
TroyBoy3912: posts small blind $0.01
PlayTheBlues4U: posts big blind $0.02
*** HOLE CARDS ***
Dealt to PlayTheBlues4U [3c Ac]
Redkin20: folds
TomT87: calls $0.02
TroyBoy3912: folds
PlayTheBlues4U: raises $0.04 to $0.06
TomT87: calls $0.04
*** FLOP *** [2d Tc Ks]
PlayTheBlues4U: bets $0.06
TomT87: folds
Uncalled bet ($0.06) returned to PlayTheBlues4U
PlayTheBlues4U collected $0.12 from pot
PlayTheBlues4U: doesn't show hand
*** SUMMARY ***
Total pot $0.13 | Rake $0.01
Board [2d Tc Ks]
Seat 2: TomT87 (button) folded on the Flop
Seat 4: TroyBoy3912 (small blind) folded before Flop
Seat 5: PlayTheBlues4U (big blind) collected ($0.12)
Seat 6: Redkin20 folded before Flop (didn't bet)


*********** # 12 **************
PokerStars Hand #203589433669:  Hold'em No Limit ($0.01/$0.02 USD) - 2019/09/10 23:05:01 ET
Table 'Rana' 6-max Seat #6 is the button
Seat 1: PlayTheBlues4U ($2.43 in chips)
Seat 2: xxzuluzuluxx ($0.57 in chips)
Seat 4: michelina44 ($0.77 in chips)
Seat 5: catgotmytongue ($1.94 in chips)
Seat 6: DruMoney201 ($3.20 in chips)
PlayTheBlues4U: posts small blind $0.01
xxzuluzuluxx: posts big blind $0.02
*** HOLE CARDS ***
Dealt to PlayTheBlues4U [Kc Ac]
michelina44: folds
catgotmytongue: raises $0.04 to $0.06
DruMoney201: calls $0.06
PlayTheBlues4U: raises $0.16 to $0.22
xxzuluzuluxx: calls $0.20
catgotmytongue: folds
DruMoney201: folds
*** FLOP *** [Ah 4s 9h]
PlayTheBlues4U: bets $0.36
xxzuluzuluxx: folds
Uncalled bet ($0.36) returned to PlayTheBlues4U
PlayTheBlues4U collected $0.53 from pot
PlayTheBlues4U: doesn't show hand
*** SUMMARY ***
Total pot $0.56 | Rake $0.03
Board [Ah 4s 9h]
Seat 1: PlayTheBlues4U (small blind) collected ($0.53)
Seat 2: xxzuluzuluxx (big blind) folded on the Flop
Seat 4: michelina44 folded before Flop (didn't bet)
Seat 5: catgotmytongue folded before Flop
Seat 6: DruMoney201 (button) folded before Flop


*********** # 13 **************
PokerStars Hand #203589433517:  Hold'em No Limit ($0.01/$0.02 USD) - 2019/09/10 23:04:11 ET
Table 'Rana' 6-max Seat #5 is the button
Seat 1: PlayTheBlues4U ($2.47 in chips)
Seat 2: xxzuluzuluxx ($0.47 in chips)
Seat 4: michelina44 ($0.80 in chips)
Seat 5: catgotmytongue ($1.94 in chips)
Seat 6: DruMoney201 ($3.24 in chips)
DruMoney201: posts small blind $0.01
PlayTheBlues4U: posts big blind $0.02
michelina44: posts small & big blinds $0.03
*** HOLE CARDS ***
Dealt to PlayTheBlues4U [9c Tc]
xxzuluzuluxx: raises $0.02 to $0.04
michelina44: folds
catgotmytongue: folds
DruMoney201: calls $0.03
PlayTheBlues4U: calls $0.02
*** FLOP *** [Kh 3s 8d]
DruMoney201: checks
PlayTheBlues4U: checks
xxzuluzuluxx: bets $0.14
DruMoney201: folds
PlayTheBlues4U: folds
Uncalled bet ($0.14) returned to xxzuluzuluxx
xxzuluzuluxx collected $0.14 from pot
xxzuluzuluxx: doesn't show hand
*** SUMMARY ***
Total pot $0.15 | Rake $0.01
Board [Kh 3s 8d]
Seat 1: PlayTheBlues4U (big blind) folded on the Flop
Seat 2: xxzuluzuluxx collected ($0.14)
Seat 4: michelina44 folded before Flop (didn't bet)
Seat 5: catgotmytongue (button) folded before Flop (didn't bet)
Seat 6: DruMoney201 (small blind) folded on the Flop


*********** # 14 **************
PokerStars Hand #203589433443:  Hold'em No Limit ($0.01/$0.02 USD) - 2019/09/10 23:03:46 ET
Table 'Jabbah' 6-max Seat #1 is the button
Seat 1: DigBickBlad ($1.58 in chips)
Seat 2: TomT87 ($1.14 in chips)
Seat 3: PTuck626 ($2.40 in chips)
Seat 4: TroyBoy3912 ($2.89 in chips)
Seat 5: PlayTheBlues4U ($1.92 in chips)
Seat 6: Redkin20 ($1.29 in chips)
TomT87: posts small blind $0.01
PTuck626: posts big blind $0.02
*** HOLE CARDS ***
Dealt to PlayTheBlues4U [6s 5d]
TroyBoy3912: folds
PlayTheBlues4U: folds
Redkin20: calls $0.02
DigBickBlad: raises $0.02 to $0.04
TomT87: calls $0.03
PTuck626: calls $0.02
Redkin20: calls $0.02
*** FLOP *** [7c 5c 7d]
TomT87: bets $0.02
PTuck626: folds
Redkin20: calls $0.02
DigBickBlad: calls $0.02
*** TURN *** [7c 5c 7d] [9c]
TomT87: bets $0.02
Redkin20: calls $0.02
DigBickBlad: folds
*** RIVER *** [7c 5c 7d 9c] [8s]
DigBickBlad leaves the table
TomT87: bets $0.12
Redkin20: folds
Uncalled bet ($0.12) returned to TomT87
TomT87 collected $0.25 from pot
TomT87: doesn't show hand
*** SUMMARY ***
Total pot $0.26 | Rake $0.01
Board [7c 5c 7d 9c 8s]
Seat 1: DigBickBlad (button) folded on the Turn
Seat 2: TomT87 (small blind) collected ($0.25)
Seat 3: PTuck626 (big blind) folded on the Flop
Seat 4: TroyBoy3912 folded before Flop (didn't bet)
Seat 5: PlayTheBlues4U folded before Flop (didn't bet)
Seat 6: Redkin20 folded on the River


*********** # 15 **************
PokerStars Hand #203589433296:  Hold'em No Limit ($0.01/$0.02 USD) - 2019/09/10 23:03:01 ET
Table 'Rana' 6-max Seat #2 is the button
Seat 1: PlayTheBlues4U ($2.47 in chips)
Seat 2: xxzuluzuluxx ($0.49 in chips)
Seat 5: catgotmytongue ($1.96 in chips)
Seat 6: DruMoney201 ($3.20 in chips)
catgotmytongue: posts small blind $0.01
DruMoney201: posts big blind $0.02
*** HOLE CARDS ***
Dealt to PlayTheBlues4U [Jh 3s]
PlayTheBlues4U: folds
xxzuluzuluxx: calls $0.02
catgotmytongue: calls $0.01
DruMoney201: checks
*** FLOP *** [3h Js 9c]
catgotmytongue: checks
DruMoney201: checks
xxzuluzuluxx: checks
*** TURN *** [3h Js 9c] [3d]
catgotmytongue: checks
DruMoney201: checks
xxzuluzuluxx: checks
*** RIVER *** [3h Js 9c 3d] [5s]
catgotmytongue: checks
DruMoney201: checks
xxzuluzuluxx: checks
*** SHOW DOWN ***
catgotmytongue: shows [4h Ks] (a pair of Threes)
DruMoney201: shows [2c Ac] (a pair of Threes - Ace kicker)
xxzuluzuluxx: mucks hand
DruMoney201 collected $0.06 from pot
*** SUMMARY ***
Total pot $0.06 | Rake $0
Board [3h Js 9c 3d 5s]
Seat 1: PlayTheBlues4U folded before Flop (didn't bet)
Seat 2: xxzuluzuluxx (button) mucked [7h 8s]
Seat 5: catgotmytongue (small blind) showed [4h Ks] and lost with a pair of Threes
Seat 6: DruMoney201 (big blind) showed [2c Ac] and won ($0.06) with a pair of Threes


*********** # 16 **************
PokerStars Hand #203589433249:  Hold'em No Limit ($0.01/$0.02 USD) - 2019/09/10 23:02:46 ET
Table 'Jabbah' 6-max Seat #6 is the button
Seat 1: DigBickBlad ($1.72 in chips)
Seat 2: TomT87 ($0.97 in chips)
Seat 3: PTuck626 ($2.40 in chips)
Seat 4: TroyBoy3912 ($2.89 in chips)
Seat 5: PlayTheBlues4U ($1.92 in chips)
Seat 6: Redkin20 ($1.33 in chips)
DigBickBlad: posts small blind $0.01
TomT87: posts big blind $0.02
*** HOLE CARDS ***
Dealt to PlayTheBlues4U [Jh 2c]
PTuck626: folds
TroyBoy3912: folds
PlayTheBlues4U: folds
Redkin20: calls $0.02
DigBickBlad: calls $0.01
TomT87: checks
*** FLOP *** [4d Ah 2s]
DigBickBlad: checks
TomT87: bets $0.02
Redkin20: calls $0.02
DigBickBlad: calls $0.02
*** TURN *** [4d Ah 2s] [Kc]
DigBickBlad: checks
TomT87: checks
Redkin20: checks
*** RIVER *** [4d Ah 2s Kc] [2d]
DigBickBlad: bets $0.02
TomT87: raises $0.08 to $0.10
Redkin20: folds
DigBickBlad: calls $0.08
*** SHOW DOWN ***
TomT87: shows [Ac Qs] (two pair, Aces and Deuces)
DigBickBlad: mucks hand
TomT87 collected $0.31 from pot
*** SUMMARY ***
Total pot $0.32 | Rake $0.01
Board [4d Ah 2s Kc 2d]
Seat 1: DigBickBlad (small blind) mucked [3h 3d]
Seat 2: TomT87 (big blind) showed [Ac Qs] and won ($0.31) with two pair, Aces and Deuces
Seat 3: PTuck626 folded before Flop (didn't bet)
Seat 4: TroyBoy3912 folded before Flop (didn't bet)
Seat 5: PlayTheBlues4U folded before Flop (didn't bet)
Seat 6: Redkin20 (button) folded on the River


*********** # 17 **************
PokerStars Hand #203589433165:  Hold'em No Limit ($0.01/$0.02 USD) - 2019/09/10 23:02:17 ET
Table 'Rana' 6-max Seat #1 is the button
Seat 1: PlayTheBlues4U ($2.49 in chips)
Seat 2: xxzuluzuluxx ($0.51 in chips)
Seat 5: catgotmytongue ($1.92 in chips)
Seat 6: DruMoney201 ($3.20 in chips)
xxzuluzuluxx: posts small blind $0.01
catgotmytongue: posts big blind $0.02
*** HOLE CARDS ***
Dealt to PlayTheBlues4U [7d 6d]
DruMoney201: folds
PlayTheBlues4U: calls $0.02
xxzuluzuluxx: calls $0.01
catgotmytongue: checks
*** FLOP *** [2h Kc Ts]
xxzuluzuluxx: checks
catgotmytongue: checks
PlayTheBlues4U: checks
*** TURN *** [2h Kc Ts] [3h]
xxzuluzuluxx: checks
catgotmytongue: bets $0.03
PlayTheBlues4U: folds
xxzuluzuluxx: folds
Uncalled bet ($0.03) returned to catgotmytongue
catgotmytongue collected $0.06 from pot
catgotmytongue: doesn't show hand
*** SUMMARY ***
Total pot $0.06 | Rake $0
Board [2h Kc Ts 3h]
Seat 1: PlayTheBlues4U (button) folded on the Turn
Seat 2: xxzuluzuluxx (small blind) folded on the Turn
Seat 5: catgotmytongue (big blind) collected ($0.06)
Seat 6: DruMoney201 folded before Flop (didn't bet)


*********** # 18 **************
PokerStars Hand #203589433064:  Hold'em No Limit ($0.01/$0.02 USD) - 2019/09/10 23:01:44 ET
Table 'Rana' 6-max Seat #6 is the button
Seat 1: PlayTheBlues4U ($2.42 in chips)
Seat 2: xxzuluzuluxx ($0.59 in chips)
Seat 5: catgotmytongue ($1.92 in chips)
Seat 6: DruMoney201 ($3.20 in chips)
PlayTheBlues4U: posts small blind $0.01
xxzuluzuluxx: posts big blind $0.02
*** HOLE CARDS ***
Dealt to PlayTheBlues4U [8d 8h]
catgotmytongue: folds
DruMoney201: folds
PlayTheBlues4U: raises $0.02 to $0.04
xxzuluzuluxx: calls $0.02
*** FLOP *** [Kc 6s Ah]
PlayTheBlues4U: bets $0.04
xxzuluzuluxx: calls $0.04
*** TURN *** [Kc 6s Ah] [5h]
PlayTheBlues4U: checks
xxzuluzuluxx: checks
*** RIVER *** [Kc 6s Ah 5h] [Qc]
PlayTheBlues4U: checks
xxzuluzuluxx: checks
*** SHOW DOWN ***
PlayTheBlues4U: shows [8d 8h] (a pair of Eights)
xxzuluzuluxx: mucks hand
PlayTheBlues4U collected $0.15 from pot
*** SUMMARY ***
Total pot $0.16 | Rake $0.01
Board [Kc 6s Ah 5h Qc]
Seat 1: PlayTheBlues4U (small blind) showed [8d 8h] and won ($0.15) with a pair of Eights
Seat 2: xxzuluzuluxx (big blind) mucked [Js 9h]
Seat 5: catgotmytongue folded before Flop (didn't bet)
Seat 6: DruMoney201 (button) folded before Flop (didn't bet)


*********** # 19 **************
PokerStars Hand #203589432957:  Hold'em No Limit ($0.01/$0.02 USD) - 2019/09/10 23:01:05 ET
Table 'Jabbah' 6-max Seat #5 is the button
Seat 1: DigBickBlad ($1.78 in chips)
Seat 2: TomT87 ($1.13 in chips)
Seat 3: PTuck626 ($2.40 in chips)
Seat 4: TroyBoy3912 ($2.63 in chips)
Seat 5: PlayTheBlues4U ($1.92 in chips)
Seat 6: Redkin20 ($1.39 in chips)
Redkin20: posts small blind $0.01
DigBickBlad: posts big blind $0.02
*** HOLE CARDS ***
Dealt to PlayTheBlues4U [Td 8c]
TomT87: calls $0.02
PTuck626: folds
TroyBoy3912: calls $0.02
PlayTheBlues4U: folds
Redkin20: calls $0.01
DigBickBlad: checks
*** FLOP *** [4c Ts Qc]
Redkin20: checks
DigBickBlad: checks
TomT87: checks
TroyBoy3912: bets $0.04
Redkin20: calls $0.04
DigBickBlad: calls $0.04
TomT87: calls $0.04
*** TURN *** [4c Ts Qc] [8s]
Redkin20: checks
DigBickBlad: checks
TomT87: checks
TroyBoy3912: bets $0.10
Redkin20: folds
DigBickBlad: folds
TomT87: calls $0.10
*** RIVER *** [4c Ts Qc 8s] [7d]
TomT87: checks
TroyBoy3912: checks
*** SHOW DOWN ***
TomT87: shows [Js 4s] (a pair of Fours)
TroyBoy3912: shows [Jc Qs] (a pair of Queens)
TroyBoy3912 collected $0.42 from pot
*** SUMMARY ***
Total pot $0.44 | Rake $0.02
Board [4c Ts Qc 8s 7d]
Seat 1: DigBickBlad (big blind) folded on the Turn
Seat 2: TomT87 showed [Js 4s] and lost with a pair of Fours
Seat 3: PTuck626 folded before Flop (didn't bet)
Seat 4: TroyBoy3912 showed [Jc Qs] and won ($0.42) with a pair of Queens
Seat 5: PlayTheBlues4U (button) folded before Flop (didn't bet)
Seat 6: Redkin20 (small blind) folded on the Turn


*********** # 20 **************
PokerStars Hand #203589432914:  Hold'em No Limit ($0.01/$0.02 USD) - 2019/09/10 23:00:51 ET
Table 'Rana' 6-max Seat #5 is the button
Seat 1: PlayTheBlues4U ($2.54 in chips)
Seat 2: xxzuluzuluxx ($0.47 in chips)
Seat 5: catgotmytongue ($1.92 in chips)
Seat 6: DruMoney201 ($3.21 in chips)
DruMoney201: posts small blind $0.01
PlayTheBlues4U: posts big blind $0.02
*** HOLE CARDS ***
Dealt to PlayTheBlues4U [Jh Ac]
xxzuluzuluxx: calls $0.02
catgotmytongue: folds
DruMoney201: folds
PlayTheBlues4U: raises $0.04 to $0.06
xxzuluzuluxx: calls $0.04
*** FLOP *** [Ks 6s 9s]
PlayTheBlues4U: bets $0.06
xxzuluzuluxx: calls $0.06
*** TURN *** [Ks 6s 9s] [2c]
PlayTheBlues4U: checks
xxzuluzuluxx: bets $0.12
PlayTheBlues4U: folds
Uncalled bet ($0.12) returned to xxzuluzuluxx
xxzuluzuluxx collected $0.24 from pot
xxzuluzuluxx: doesn't show hand
*** SUMMARY ***
Total pot $0.25 | Rake $0.01
Board [Ks 6s 9s 2c]
Seat 1: PlayTheBlues4U (big blind) folded on the Turn
Seat 2: xxzuluzuluxx collected ($0.24)
Seat 5: catgotmytongue (button) folded before Flop (didn't bet)
Seat 6: DruMoney201 (small blind) folded before Flop


*********** # 21 **************
PokerStars Hand #203589432790:  Hold'em No Limit ($0.01/$0.02 USD) - 2019/09/10 23:00:08 ET
Table 'Rana' 6-max Seat #2 is the button
Seat 1: PlayTheBlues4U ($2.22 in chips)
Seat 2: xxzuluzuluxx ($0.79 in chips)
Seat 5: catgotmytongue ($1.93 in chips)
Seat 6: DruMoney201 ($3.23 in chips)
catgotmytongue: posts small blind $0.01
DruMoney201: posts big blind $0.02
*** HOLE CARDS ***
Dealt to PlayTheBlues4U [Td As]
PlayTheBlues4U: raises $0.04 to $0.06
xxzuluzuluxx: calls $0.06
catgotmytongue: folds
DruMoney201: folds
*** FLOP *** [5h Ts 3d]
PlayTheBlues4U: bets $0.08
xxzuluzuluxx: calls $0.08
*** TURN *** [5h Ts 3d] [Th]
PlayTheBlues4U: bets $0.18
xxzuluzuluxx: calls $0.18
*** RIVER *** [5h Ts 3d Th] [7d]
PlayTheBlues4U: bets $0.64
xxzuluzuluxx: folds [7s]
Uncalled bet ($0.64) returned to PlayTheBlues4U
PlayTheBlues4U collected $0.64 from pot
PlayTheBlues4U: doesn't show hand
*** SUMMARY ***
Total pot $0.67 | Rake $0.03
Board [5h Ts 3d Th 7d]
Seat 1: PlayTheBlues4U collected ($0.64)
Seat 2: xxzuluzuluxx (button) folded on the River
Seat 5: catgotmytongue (small blind) folded before Flop
Seat 6: DruMoney201 (big blind) folded before Flop


*********** # 22 **************
PokerStars Hand #203589432768:  Hold'em No Limit ($0.01/$0.02 USD) - 2019/09/10 23:00:01 ET
Table 'Jabbah' 6-max Seat #4 is the button
Seat 1: DigBickBlad ($1.78 in chips)
Seat 2: TomT87 ($1.13 in chips)
Seat 3: PTuck626 ($1.96 in chips)
Seat 4: TroyBoy3912 ($2.63 in chips)
Seat 5: PlayTheBlues4U ($1.94 in chips)
Seat 6: Redkin20 ($1.85 in chips)
PlayTheBlues4U: posts small blind $0.01
Redkin20: posts big blind $0.02
*** HOLE CARDS ***
Dealt to PlayTheBlues4U [3c 3h]
DigBickBlad: folds
TomT87: folds
PTuck626: calls $0.02
TroyBoy3912: folds
PlayTheBlues4U: calls $0.01
Redkin20: checks
*** FLOP *** [6c 7s 9d]
PlayTheBlues4U: checks
Redkin20: checks
PTuck626: bets $0.03
PlayTheBlues4U: folds
Redkin20: calls $0.03
*** TURN *** [6c 7s 9d] [7c]
Redkin20: checks
PTuck626: bets $0.06
Redkin20: calls $0.06
*** RIVER *** [6c 7s 9d 7c] [9s]
Redkin20: checks
PTuck626: bets $0.35
Redkin20: calls $0.35
*** SHOW DOWN ***
PTuck626: shows [Kc 8d] (two pair, Nines and Sevens)
Redkin20: mucks hand
PTuck626 collected $0.90 from pot
*** SUMMARY ***
Total pot $0.94 | Rake $0.04
Board [6c 7s 9d 7c 9s]
Seat 1: DigBickBlad folded before Flop (didn't bet)
Seat 2: TomT87 folded before Flop (didn't bet)
Seat 3: PTuck626 showed [Kc 8d] and won ($0.90) with two pair, Nines and Sevens
Seat 4: TroyBoy3912 (button) folded before Flop (didn't bet)
Seat 5: PlayTheBlues4U (small blind) folded on the Flop
Seat 6: Redkin20 (big blind) mucked [8c Qd]


*********** # 23 **************
PokerStars Hand #203589432695:  Hold'em No Limit ($0.01/$0.02 USD) - 2019/09/10 22:59:26 ET
Table 'Jabbah' 6-max Seat #3 is the button
Seat 1: DigBickBlad ($1.80 in chips)
Seat 2: TomT87 ($1.13 in chips)
Seat 3: PTuck626 ($1.96 in chips)
Seat 4: TroyBoy3912 ($2.64 in chips)
Seat 5: PlayTheBlues4U ($1.96 in chips)
Seat 6: Redkin20 ($1.80 in chips)
TroyBoy3912: posts small blind $0.01
PlayTheBlues4U: posts big blind $0.02
*** HOLE CARDS ***
Dealt to PlayTheBlues4U [7d 2c]
Redkin20: calls $0.02
DigBickBlad: calls $0.02
TomT87: folds
PTuck626: folds
TroyBoy3912: folds
PlayTheBlues4U: checks
*** FLOP *** [2s Qh 4c]
PlayTheBlues4U: checks
Redkin20: bets $0.02
DigBickBlad: folds
PlayTheBlues4U: folds
Uncalled bet ($0.02) returned to Redkin20
Redkin20 collected $0.07 from pot
Redkin20: doesn't show hand
*** SUMMARY ***
Total pot $0.07 | Rake $0
Board [2s Qh 4c]
Seat 1: DigBickBlad folded on the Flop
Seat 2: TomT87 folded before Flop (didn't bet)
Seat 3: PTuck626 (button) folded before Flop (didn't bet)
Seat 4: TroyBoy3912 (small blind) folded before Flop
Seat 5: PlayTheBlues4U (big blind) folded on the Flop
Seat 6: Redkin20 collected ($0.07)


*********** # 24 **************
PokerStars Hand #203589432687:  Hold'em No Limit ($0.01/$0.02 USD) - 2019/09/10 22:59:22 ET
Table 'Rana' 6-max Seat #1 is the button
Seat 1: PlayTheBlues4U ($2.36 in chips)
Seat 2: xxzuluzuluxx ($0.64 in chips)
Seat 5: catgotmytongue ($1.95 in chips)
Seat 6: DruMoney201 ($3.23 in chips)
xxzuluzuluxx: posts small blind $0.01
michelina44 has timed out while disconnected
michelina44: is sitting out
catgotmytongue: posts big blind $0.02
*** HOLE CARDS ***
Dealt to PlayTheBlues4U [Ah 3h]
DruMoney201: folds
PlayTheBlues4U: raises $0.04 to $0.06
xxzuluzuluxx: calls $0.05
catgotmytongue: folds
*** FLOP *** [4h 2s 6d]
xxzuluzuluxx: checks
michelina44 is disconnected
PlayTheBlues4U: bets $0.08
xxzuluzuluxx: calls $0.08
*** TURN *** [4h 2s 6d] [4s]
xxzuluzuluxx: checks
PlayTheBlues4U: checks
*** RIVER *** [4h 2s 6d 4s] [Qh]
xxzuluzuluxx: checks
PlayTheBlues4U: checks
*** SHOW DOWN ***
xxzuluzuluxx: shows [Ac 7c] (a pair of Fours)
PlayTheBlues4U: mucks hand
xxzuluzuluxx collected $0.29 from pot
*** SUMMARY ***
Total pot $0.30 | Rake $0.01
Board [4h 2s 6d 4s Qh]
Seat 1: PlayTheBlues4U (button) mucked [Ah 3h]
Seat 2: xxzuluzuluxx (small blind) showed [Ac 7c] and won ($0.29) with a pair of Fours
Seat 5: catgotmytongue (big blind) folded before Flop
Seat 6: DruMoney201 folded before Flop (didn't bet)


*********** # 25 **************
PokerStars Hand #203589432606:  Hold'em No Limit ($0.01/$0.02 USD) - 2019/09/10 22:58:41 ET
Table 'Rana' 6-max Seat #6 is the button
Seat 1: PlayTheBlues4U ($2.29 in chips)
Seat 2: xxzuluzuluxx ($0.70 in chips)
Seat 4: michelina44 ($0.80 in chips)
Seat 5: catgotmytongue ($1.97 in chips)
Seat 6: DruMoney201 ($3.23 in chips)
PlayTheBlues4U: posts small blind $0.01
xxzuluzuluxx: posts big blind $0.02
*** HOLE CARDS ***
Dealt to PlayTheBlues4U [8h Jh]
michelina44: folds
catgotmytongue: calls $0.02
DruMoney201: folds
PlayTheBlues4U: calls $0.01
xxzuluzuluxx: checks
*** FLOP *** [5c 8c Qd]
PlayTheBlues4U: bets $0.04
xxzuluzuluxx: calls $0.04
catgotmytongue: folds
*** TURN *** [5c 8c Qd] [8d]
PlayTheBlues4U: bets $0.10
xxzuluzuluxx: folds
Uncalled bet ($0.10) returned to PlayTheBlues4U
PlayTheBlues4U collected $0.13 from pot
PlayTheBlues4U: doesn't show hand
*** SUMMARY ***
Total pot $0.14 | Rake $0.01
Board [5c 8c Qd 8d]
Seat 1: PlayTheBlues4U (small blind) collected ($0.13)
Seat 2: xxzuluzuluxx (big blind) folded on the Turn
Seat 4: michelina44 folded before Flop (didn't bet)
Seat 5: catgotmytongue folded on the Flop
Seat 6: DruMoney201 (button) folded before Flop (didn't bet)


*********** # 26 **************
PokerStars Hand #203589432547:  Hold'em No Limit ($0.01/$0.02 USD) - 2019/09/10 22:58:14 ET
Table 'Rana' 6-max Seat #5 is the button
Seat 1: PlayTheBlues4U ($2.24 in chips)
Seat 2: xxzuluzuluxx ($0.70 in chips)
Seat 4: michelina44 ($0.84 in chips)
Seat 5: catgotmytongue ($1.97 in chips)
Seat 6: DruMoney201 ($3.24 in chips)
DruMoney201: posts small blind $0.01
PlayTheBlues4U: posts big blind $0.02
*** HOLE CARDS ***
Dealt to PlayTheBlues4U [2h Qd]
xxzuluzuluxx: folds
michelina44: raises $0.02 to $0.04
catgotmytongue: folds
DruMoney201: folds
PlayTheBlues4U: calls $0.02
*** FLOP *** [4c Qc 3s]
PlayTheBlues4U: checks
michelina44: checks
*** TURN *** [4c Qc 3s] [9h]
PlayTheBlues4U: bets $0.06
michelina44: folds
Uncalled bet ($0.06) returned to PlayTheBlues4U
PlayTheBlues4U collected $0.09 from pot
PlayTheBlues4U: doesn't show hand
*** SUMMARY ***
Total pot $0.09 | Rake $0
Board [4c Qc 3s 9h]
Seat 1: PlayTheBlues4U (big blind) collected ($0.09)
Seat 2: xxzuluzuluxx folded before Flop (didn't bet)
Seat 4: michelina44 folded on the Turn
Seat 5: catgotmytongue (button) folded before Flop (didn't bet)
Seat 6: DruMoney201 (small blind) folded before Flop


*********** # 27 **************
PokerStars Hand #203589432521:  Hold'em No Limit ($0.01/$0.02 USD) - 2019/09/10 22:57:59 ET
Table 'Rana' 6-max Seat #4 is the button
Seat 1: PlayTheBlues4U ($2.24 in chips)
Seat 2: xxzuluzuluxx ($0.70 in chips)
Seat 4: michelina44 ($0.84 in chips)
Seat 5: catgotmytongue ($1.95 in chips)
Seat 6: DruMoney201 ($3.26 in chips)
catgotmytongue: posts small blind $0.01
DruMoney201: posts big blind $0.02
*** HOLE CARDS ***
Dealt to PlayTheBlues4U [2s 9s]
PlayTheBlues4U: folds
xxzuluzuluxx: folds
michelina44: folds
catgotmytongue: raises $0.06 to $0.08
DruMoney201: folds
Uncalled bet ($0.06) returned to catgotmytongue
catgotmytongue collected $0.04 from pot
catgotmytongue: doesn't show hand
*** SUMMARY ***
Total pot $0.04 | Rake $0
Seat 1: PlayTheBlues4U folded before Flop (didn't bet)
Seat 2: xxzuluzuluxx folded before Flop (didn't bet)
Seat 4: michelina44 (button) folded before Flop (didn't bet)
Seat 5: catgotmytongue (small blind) collected ($0.04)
Seat 6: DruMoney201 (big blind) folded before Flop


*********** # 28 **************
PokerStars Hand #203589432457:  Hold'em No Limit ($0.01/$0.02 USD) - 2019/09/10 22:57:29 ET
Table 'Rana' 6-max Seat #2 is the button
Seat 1: PlayTheBlues4U ($2.24 in chips)
Seat 2: xxzuluzuluxx ($0.70 in chips)
Seat 4: michelina44 ($0.85 in chips)
Seat 5: catgotmytongue ($1.92 in chips)
Seat 6: DruMoney201 ($3.28 in chips)
michelina44: posts small blind $0.01
catgotmytongue: posts big blind $0.02
*** HOLE CARDS ***
Dealt to PlayTheBlues4U [3s 7c]
DruMoney201: calls $0.02
PlayTheBlues4U: folds
xxzuluzuluxx: folds
michelina44: folds
catgotmytongue: checks
*** FLOP *** [4s Th Jh]
catgotmytongue: checks
DruMoney201: checks
*** TURN *** [4s Th Jh] [6c]
catgotmytongue: checks
DruMoney201: checks
*** RIVER *** [4s Th Jh 6c] [5s]
catgotmytongue: checks
DruMoney201: checks
*** SHOW DOWN ***
catgotmytongue: shows [Kc 5c] (a pair of Fives)
DruMoney201: mucks hand
catgotmytongue collected $0.05 from pot
*** SUMMARY ***
Total pot $0.05 | Rake $0
Board [4s Th Jh 6c 5s]
Seat 1: PlayTheBlues4U folded before Flop (didn't bet)
Seat 2: xxzuluzuluxx (button) folded before Flop (didn't bet)
Seat 4: michelina44 (small blind) folded before Flop
Seat 5: catgotmytongue (big blind) showed [Kc 5c] and won ($0.05) with a pair of Fives
Seat 6: DruMoney201 mucked [9h Kd]


*********** # 29 **************
PokerStars Hand #203589432441:  Hold'em No Limit ($0.01/$0.02 USD) - 2019/09/10 22:57:21 ET
Table 'Jabbah' 6-max Seat #2 is the button
Seat 1: DigBickBlad ($2 in chips)
Seat 2: TomT87 ($1.33 in chips)
Seat 3: PTuck626 ($1.98 in chips)
Seat 4: TroyBoy3912 ($2.66 in chips)
Seat 5: PlayTheBlues4U ($1.96 in chips)
Seat 6: Redkin20 ($1.39 in chips)
PTuck626: posts small blind $0.01
TroyBoy3912: posts big blind $0.02
DigBickBlad: posts big blind $0.02
*** HOLE CARDS ***
Dealt to PlayTheBlues4U [2s 9c]
PlayTheBlues4U: folds
Redkin20: calls $0.02
DigBickBlad: checks
TomT87: calls $0.02
PTuck626: calls $0.01
TroyBoy3912: checks
*** FLOP *** [7d Ah Qh]
PTuck626: checks
TroyBoy3912: checks
Redkin20: checks
DigBickBlad: checks
TomT87: checks
*** TURN *** [7d Ah Qh] [Qd]
PTuck626: checks
TroyBoy3912: checks
Redkin20: checks
DigBickBlad: checks
TomT87: checks
*** RIVER *** [7d Ah Qh Qd] [3d]
PTuck626: checks
TroyBoy3912: checks
Redkin20: bets $0.18
DigBickBlad: calls $0.18
TomT87: calls $0.18
PTuck626: folds
TroyBoy3912: folds
*** SHOW DOWN ***
Redkin20: shows [6d 5d] (a flush, Queen high)
DigBickBlad: mucks hand
TomT87: mucks hand
Redkin20 collected $0.61 from pot
*** SUMMARY ***
Total pot $0.64 | Rake $0.03
Board [7d Ah Qh Qd 3d]
Seat 1: DigBickBlad mucked [7c 2d]
Seat 2: TomT87 (button) mucked [4s Qs]
Seat 3: PTuck626 (small blind) folded on the River
Seat 4: TroyBoy3912 (big blind) folded on the River
Seat 5: PlayTheBlues4U folded before Flop (didn't bet)
Seat 6: Redkin20 showed [6d 5d] and won ($0.61) with a flush, Queen high


*********** # 30 **************
PokerStars Hand #203589432398:  Hold'em No Limit ($0.01/$0.02 USD) - 2019/09/10 22:57:01 ET
Table 'Rana' 6-max Seat #1 is the button
Seat 1: PlayTheBlues4U ($2.24 in chips)
Seat 2: xxzuluzuluxx ($0.72 in chips)
Seat 4: michelina44 ($0.78 in chips)
Seat 5: catgotmytongue ($1.92 in chips)
Seat 6: DruMoney201 ($3.34 in chips)
xxzuluzuluxx: posts small blind $0.01
michelina44: posts big blind $0.02
*** HOLE CARDS ***
Dealt to PlayTheBlues4U [4d Qh]
catgotmytongue: folds
DruMoney201: calls $0.02
PlayTheBlues4U: folds
xxzuluzuluxx: calls $0.01
michelina44: checks
*** FLOP *** [2h Js 3c]
xxzuluzuluxx: checks
michelina44: bets $0.02
DruMoney201: calls $0.02
xxzuluzuluxx: folds
*** TURN *** [2h Js 3c] [3h]
michelina44: bets $0.02
DruMoney201: calls $0.02
*** RIVER *** [2h Js 3c 3h] [4s]
michelina44: bets $0.06
DruMoney201: folds
Uncalled bet ($0.06) returned to michelina44
michelina44 collected $0.13 from pot
michelina44: doesn't show hand
*** SUMMARY ***
Total pot $0.14 | Rake $0.01
Board [2h Js 3c 3h 4s]
Seat 1: PlayTheBlues4U (button) folded before Flop (didn't bet)
Seat 2: xxzuluzuluxx (small blind) folded on the Flop
Seat 4: michelina44 (big blind) collected ($0.13)
Seat 5: catgotmytongue folded before Flop (didn't bet)
Seat 6: DruMoney201 folded on the River


*********** # 31 **************
PokerStars Hand #203589432261:  Hold'em No Limit ($0.01/$0.02 USD) - 2019/09/10 22:55:59 ET
Table 'Orion' 6-max Seat #1 is the button
Seat 1: jford9099 ($1.81 in chips)
Seat 6: PlayTheBlues4U ($2.07 in chips)
jford9099: posts small blind $0.01
PlayTheBlues4U: posts big blind $0.02
*** HOLE CARDS ***
Dealt to PlayTheBlues4U [6h 5c]
jford9099: raises $0.06 to $0.08
PlayTheBlues4U: folds
Uncalled bet ($0.06) returned to jford9099
PlayTheBlues4U leaves the table
jford9099 collected $0.04 from pot
pepperman5757 joins the table at seat #4
jford9099: doesn't show hand
*** SUMMARY ***
Total pot $0.04 | Rake $0
Seat 1: jford9099 (button) (small blind) collected ($0.04)
Seat 6: PlayTheBlues4U (big blind) folded before Flop


*********** # 32 **************
PokerStars Hand #203589432244:  Hold'em No Limit ($0.01/$0.02 USD) - 2019/09/10 22:55:51 ET
Table 'Rana' 6-max Seat #6 is the button
Seat 1: PlayTheBlues4U ($2.51 in chips)
Seat 2: xxzuluzuluxx ($0.79 in chips)
Seat 4: michelina44 ($0.80 in chips)
Seat 5: catgotmytongue ($1.94 in chips)
Seat 6: DruMoney201 ($2.99 in chips)
PlayTheBlues4U: posts small blind $0.01
xxzuluzuluxx: posts big blind $0.02
michelina44: posts big blind $0.02
*** HOLE CARDS ***
Dealt to PlayTheBlues4U [Qd 4c]
michelina44: checks
catgotmytongue: calls $0.02
DruMoney201: calls $0.02
PlayTheBlues4U: calls $0.01
xxzuluzuluxx: checks
*** FLOP *** [2s 3s Qh]
PlayTheBlues4U: bets $0.05
xxzuluzuluxx: calls $0.05
michelina44: folds
catgotmytongue: folds
DruMoney201: calls $0.05
*** TURN *** [2s 3s Qh] [5s]
PlayTheBlues4U: bets $0.20
xxzuluzuluxx: folds
DruMoney201: calls $0.20
*** RIVER *** [2s 3s Qh 5s] [8h]
PlayTheBlues4U: checks
DruMoney201: checks
*** SHOW DOWN ***
PlayTheBlues4U: shows [Qd 4c] (a pair of Queens)
DruMoney201: shows [7s 8s] (a flush, Eight high)
DruMoney201 collected $0.62 from pot
*** SUMMARY ***
Total pot $0.65 | Rake $0.03
Board [2s 3s Qh 5s 8h]
Seat 1: PlayTheBlues4U (small blind) showed [Qd 4c] and lost with a pair of Queens
Seat 2: xxzuluzuluxx (big blind) folded on the Turn
Seat 4: michelina44 folded on the Flop (didn't bet)
Seat 5: catgotmytongue folded on the Flop
Seat 6: DruMoney201 (button) showed [7s 8s] and won ($0.62) with a flush, Eight high


*********** # 33 **************
PokerStars Hand #203589432230:  Hold'em No Limit ($0.01/$0.02 USD) - 2019/09/10 22:55:48 ET
Table 'Jabbah' 6-max Seat #6 is the button
Seat 2: TomT87 ($1.39 in chips)
Seat 3: PTuck626 ($1.91 in chips)
Seat 4: TroyBoy3912 ($2.66 in chips)
Seat 5: PlayTheBlues4U ($1.96 in chips)
Seat 6: Redkin20 ($1.41 in chips)
TomT87: posts small blind $0.01
PTuck626: posts big blind $0.02
*** HOLE CARDS ***
Dealt to PlayTheBlues4U [5h 3d]
TroyBoy3912: folds
PlayTheBlues4U: folds
Redkin20: calls $0.02
TomT87: calls $0.01
PTuck626: checks
*** FLOP *** [Jd 9s 7s]
TomT87: checks
DigBickBlad joins the table at seat #1
PTuck626: bets $0.04
Redkin20: folds
TomT87: calls $0.04
*** TURN *** [Jd 9s 7s] [Ad]
TomT87: checks
PTuck626: checks
*** RIVER *** [Jd 9s 7s Ad] [Th]
TomT87: checks
PTuck626: bets $0.15
TomT87: folds
Uncalled bet ($0.15) returned to PTuck626
PTuck626 collected $0.13 from pot
PTuck626: doesn't show hand
*** SUMMARY ***
Total pot $0.14 | Rake $0.01
Board [Jd 9s 7s Ad Th]
Seat 2: TomT87 (small blind) folded on the River
Seat 3: PTuck626 (big blind) collected ($0.13)
Seat 4: TroyBoy3912 folded before Flop (didn't bet)
Seat 5: PlayTheBlues4U folded before Flop (didn't bet)
Seat 6: Redkin20 (button) folded on the Flop


*********** # 34 **************
PokerStars Hand #203589432147:  Hold'em No Limit ($0.01/$0.02 USD) - 2019/09/10 22:55:07 ET
Table 'Orion' 6-max Seat #6 is the button
Seat 1: jford9099 ($1.89 in chips)
Seat 4: Smuggler1991 ($5.95 in chips)
Seat 6: PlayTheBlues4U ($1.98 in chips)
jford9099: posts small blind $0.01
Smuggler1991: posts big blind $0.02
*** HOLE CARDS ***
Dealt to PlayTheBlues4U [4s 3c]
PlayTheBlues4U: calls $0.02
jford9099: raises $0.04 to $0.06
Smuggler1991: folds
PlayTheBlues4U: calls $0.04
*** FLOP *** [Kh 4c 9c]
jford9099: checks
PlayTheBlues4U: checks
*** TURN *** [Kh 4c 9c] [3d]
jford9099: bets $0.02
PlayTheBlues4U: raises $0.08 to $0.10
Smuggler1991 leaves the table
jford9099: folds
Uncalled bet ($0.08) returned to PlayTheBlues4U
PlayTheBlues4U collected $0.17 from pot
PlayTheBlues4U: doesn't show hand
*** SUMMARY ***
Total pot $0.18 | Rake $0.01
Board [Kh 4c 9c 3d]
Seat 1: jford9099 (small blind) folded on the Turn
Seat 4: Smuggler1991 (big blind) folded before Flop
Seat 6: PlayTheBlues4U (button) collected ($0.17)


*********** # 35 **************
PokerStars Hand #203589432121:  Hold'em No Limit ($0.01/$0.02 USD) - 2019/09/10 22:54:55 ET
Table 'Rana' 6-max Seat #5 is the button
Seat 1: PlayTheBlues4U ($2.51 in chips)
Seat 2: xxzuluzuluxx ($0.79 in chips)
Seat 3: bigbluerodeo ($1.85 in chips)
Seat 5: catgotmytongue ($1.94 in chips)
Seat 6: DruMoney201 ($2.99 in chips)
DruMoney201: posts small blind $0.01
PlayTheBlues4U: posts big blind $0.02
*** HOLE CARDS ***
Dealt to PlayTheBlues4U [2c Qc]
xxzuluzuluxx: folds
michelina44 joins the table at seat #4
bigbluerodeo has timed out
bigbluerodeo: folds
catgotmytongue: folds
DruMoney201: calls $0.01
PlayTheBlues4U: checks
*** FLOP *** [8s 4d Jh]
DruMoney201: checks
PlayTheBlues4U: checks
*** TURN *** [8s 4d Jh] [Jc]
DruMoney201: checks
PlayTheBlues4U: checks
*** RIVER *** [8s 4d Jh Jc] [Tc]
DruMoney201: checks
PlayTheBlues4U: checks
*** SHOW DOWN ***
DruMoney201: shows [3c Qd] (a pair of Jacks)
PlayTheBlues4U: shows [2c Qc] (a pair of Jacks)
DruMoney201 collected $0.02 from pot
PlayTheBlues4U collected $0.02 from pot
*** SUMMARY ***
Total pot $0.04 | Rake $0
Board [8s 4d Jh Jc Tc]
Seat 1: PlayTheBlues4U (big blind) showed [2c Qc] and won ($0.02) with a pair of Jacks
Seat 2: xxzuluzuluxx folded before Flop (didn't bet)
Seat 3: bigbluerodeo folded before Flop (didn't bet)
Seat 5: catgotmytongue (button) folded before Flop (didn't bet)
Seat 6: DruMoney201 (small blind) showed [3c Qd] and won ($0.02) with a pair of Jacks


*********** # 36 **************
PokerStars Hand #203589432017:  Hold'em No Limit ($0.01/$0.02 USD) - 2019/09/10 22:54:21 ET
Table 'Rana' 6-max Seat #3 is the button
Seat 1: PlayTheBlues4U ($2.38 in chips)
Seat 2: xxzuluzuluxx ($0.80 in chips)
Seat 3: bigbluerodeo ($1.91 in chips)
Seat 4: LonLonMilk8 ($1.99 in chips)
Seat 5: catgotmytongue ($2 in chips)
Seat 6: DruMoney201 ($2.99 in chips)
LonLonMilk8: posts small blind $0.01
catgotmytongue: posts big blind $0.02
xxzuluzuluxx: posts small blind $0.01
*** HOLE CARDS ***
Dealt to PlayTheBlues4U [Ah As]
DruMoney201: folds
PlayTheBlues4U: raises $0.04 to $0.06
xxzuluzuluxx: folds
bigbluerodeo: calls $0.06
LonLonMilk8: folds
catgotmytongue: calls $0.04
*** FLOP *** [2s Ac 3d]
catgotmytongue: checks
PlayTheBlues4U: checks
LonLonMilk8 leaves the table
bigbluerodeo: checks
*** TURN *** [2s Ac 3d] [Kd]
catgotmytongue: checks
PlayTheBlues4U: bets $0.14
bigbluerodeo: folds
catgotmytongue: folds
Uncalled bet ($0.14) returned to PlayTheBlues4U
PlayTheBlues4U collected $0.19 from pot
PlayTheBlues4U: doesn't show hand
*** SUMMARY ***
Total pot $0.20 | Rake $0.01
Board [2s Ac 3d Kd]
Seat 1: PlayTheBlues4U collected ($0.19)
Seat 2: xxzuluzuluxx folded before Flop (didn't bet)
Seat 3: bigbluerodeo (button) folded on the Turn
Seat 4: LonLonMilk8 (small blind) folded before Flop
Seat 5: catgotmytongue (big blind) folded on the Turn
Seat 6: DruMoney201 folded before Flop (didn't bet)


*********** # 37 **************
PokerStars Hand #203588679918:  Hold'em No Limit ($0.01/$0.02 USD) - 2019/09/10 22:53:48 ET
Table 'Orion' 6-max Seat #4 is the button
Seat 1: jford9099 ($1.91 in chips)
Seat 2: maarketeer ($2.14 in chips)
Seat 4: Smuggler1991 ($5.88 in chips)
Seat 5: LonLonMilk8 ($1.53 in chips)
Seat 6: PlayTheBlues4U ($2 in chips)
LonLonMilk8: posts small blind $0.01
PlayTheBlues4U: posts big blind $0.02
*** HOLE CARDS ***
Dealt to PlayTheBlues4U [5c 2d]
jford9099: calls $0.02
maarketeer: calls $0.02
Smuggler1991: raises $0.09 to $0.11
LonLonMilk8: folds
PlayTheBlues4U: folds
jford9099: folds
maarketeer is disconnected
maarketeer has timed out while disconnected
maarketeer: folds
Uncalled bet ($0.09) returned to Smuggler1991
LonLonMilk8 leaves the table
Smuggler1991 collected $0.09 from pot
Smuggler1991: doesn't show hand
*** SUMMARY ***
Total pot $0.09 | Rake $0
Seat 1: jford9099 folded before Flop
Seat 2: maarketeer folded before Flop
Seat 4: Smuggler1991 (button) collected ($0.09)
Seat 5: LonLonMilk8 (small blind) folded before Flop
Seat 6: PlayTheBlues4U (big blind) folded before Flop


*********** # 38 **************
PokerStars Hand #203588679909:  Hold'em No Limit ($0.01/$0.02 USD) - 2019/09/10 22:53:46 ET
Table 'Rana' 6-max Seat #1 is the button
Seat 1: PlayTheBlues4U ($2.38 in chips)
Seat 3: bigbluerodeo ($1.92 in chips)
Seat 4: LonLonMilk8 ($2.01 in chips)
Seat 6: DruMoney201 ($2.96 in chips)
bigbluerodeo: posts small blind $0.01
LonLonMilk8: posts big blind $0.02
catgotmytongue: sits out
*** HOLE CARDS ***
Dealt to PlayTheBlues4U [4c 5d]
DruMoney201: calls $0.02
PlayTheBlues4U: folds
bigbluerodeo: folds
LonLonMilk8: checks
*** FLOP *** [Td 8c Th]
LonLonMilk8: checks
DruMoney201: bets $0.04
LonLonMilk8: folds
Uncalled bet ($0.04) returned to DruMoney201
DruMoney201 collected $0.05 from pot
DruMoney201: doesn't show hand
*** SUMMARY ***
Total pot $0.05 | Rake $0
Board [Td 8c Th]
Seat 1: PlayTheBlues4U (button) folded before Flop (didn't bet)
Seat 3: bigbluerodeo (small blind) folded before Flop
Seat 4: LonLonMilk8 (big blind) folded on the Flop
Seat 6: DruMoney201 collected ($0.05)


*********** # 39 **************
PokerStars Hand #203588679896:  Hold'em No Limit ($0.01/$0.02 USD) - 2019/09/10 22:53:42 ET
Table 'Jabbah' 6-max Seat #5 is the button
Seat 1: bigbluerodeo ($2.59 in chips)
Seat 2: TomT87 ($1.39 in chips)
Seat 3: PTuck626 ($1.82 in chips)
Seat 4: TroyBoy3912 ($2.66 in chips)
Seat 5: PlayTheBlues4U ($1.96 in chips)
Seat 6: Redkin20 ($1.49 in chips)
Redkin20: posts small blind $0.01
bigbluerodeo: posts big blind $0.02
*** HOLE CARDS ***
Dealt to PlayTheBlues4U [3s Jd]
TomT87: folds
PTuck626: calls $0.02
TroyBoy3912: folds
PlayTheBlues4U: folds
Redkin20: calls $0.01
bigbluerodeo: checks
*** FLOP *** [Ah 3h 8h]
Redkin20: checks
bigbluerodeo: checks
PTuck626: checks
*** TURN *** [Ah 3h 8h] [Td]
Redkin20: checks
bigbluerodeo: checks
PTuck626: bets $0.06
Redkin20: calls $0.06
bigbluerodeo: folds
*** RIVER *** [Ah 3h 8h Td] [5d]
bigbluerodeo leaves the table
Redkin20: checks
PTuck626: bets $0.20
Redkin20: folds
Uncalled bet ($0.20) returned to PTuck626
PTuck626 collected $0.17 from pot
PTuck626: doesn't show hand
*** SUMMARY ***
Total pot $0.18 | Rake $0.01
Board [Ah 3h 8h Td 5d]
Seat 1: bigbluerodeo (big blind) folded on the Turn
Seat 2: TomT87 folded before Flop (didn't bet)
Seat 3: PTuck626 collected ($0.17)
Seat 4: TroyBoy3912 folded before Flop (didn't bet)
Seat 5: PlayTheBlues4U (button) folded before Flop (didn't bet)
Seat 6: Redkin20 (small blind) folded on the River


*********** # 40 **************
PokerStars Hand #203588679712:  Hold'em No Limit ($0.01/$0.02 USD) - 2019/09/10 22:52:39 ET
Table 'Rana' 6-max Seat #6 is the button
Seat 1: PlayTheBlues4U ($2.40 in chips)
Seat 2: xxzuluzuluxx ($0.51 in chips)
Seat 3: bigbluerodeo ($1.92 in chips)
Seat 4: LonLonMilk8 ($2.04 in chips)
Seat 6: DruMoney201 ($2.45 in chips)
PlayTheBlues4U: posts small blind $0.01
xxzuluzuluxx: posts big blind $0.02
LonLonMilk8: posts small & big blinds $0.03
*** HOLE CARDS ***
Dealt to PlayTheBlues4U [Qc 3c]
catgotmytongue joins the table at seat #5
bigbluerodeo: folds
LonLonMilk8: checks
DruMoney201: calls $0.02
PlayTheBlues4U: calls $0.01
xxzuluzuluxx: checks
*** FLOP *** [5d Td 7s]
PlayTheBlues4U: checks
xxzuluzuluxx: bets $0.08
LonLonMilk8: folds
DruMoney201: calls $0.08
PlayTheBlues4U: folds
*** TURN *** [5d Td 7s] [9d]
xxzuluzuluxx: bets $0.12
DruMoney201: calls $0.12
*** RIVER *** [5d Td 7s 9d] [Th]
xxzuluzuluxx: bets $0.04
DruMoney201: raises $0.28 to $0.32
xxzuluzuluxx: calls $0.25 and is all-in
Uncalled bet ($0.03) returned to DruMoney201
*** SHOW DOWN ***
DruMoney201: shows [Ad 6d] (a flush, Ace high)
xxzuluzuluxx: shows [Tc 8c] (three of a kind, Tens)
DruMoney201 collected $1.02 from pot
*** SUMMARY ***
Total pot $1.07 | Rake $0.05
Board [5d Td 7s 9d Th]
Seat 1: PlayTheBlues4U (small blind) folded on the Flop
Seat 2: xxzuluzuluxx (big blind) showed [Tc 8c] and lost with three of a kind, Tens
Seat 3: bigbluerodeo folded before Flop (didn't bet)
Seat 4: LonLonMilk8 folded on the Flop (didn't bet)
Seat 6: DruMoney201 (button) showed [Ad 6d] and won ($1.02) with a flush, Ace high


*********** # 41 **************
PokerStars Hand #203588679630:  Hold'em No Limit ($0.01/$0.02 USD) - 2019/09/10 22:52:13 ET
Table 'Jabbah' 6-max Seat #4 is the button
Seat 1: bigbluerodeo ($2.65 in chips)
Seat 2: TomT87 ($1.39 in chips)
Seat 3: PTuck626 ($1.82 in chips)
Seat 4: TroyBoy3912 ($2.68 in chips)
Seat 5: PlayTheBlues4U ($1.98 in chips)
Seat 6: Redkin20 ($1.40 in chips)
PlayTheBlues4U: posts small blind $0.01
Redkin20: posts big blind $0.02
*** HOLE CARDS ***
Dealt to PlayTheBlues4U [2d 3c]
bigbluerodeo: calls $0.02
TomT87: folds
PTuck626: folds
TroyBoy3912: calls $0.02
PlayTheBlues4U: calls $0.01
Redkin20: raises $0.04 to $0.06
bigbluerodeo: calls $0.04
TroyBoy3912: folds
PlayTheBlues4U: folds
*** FLOP *** [3s Td 2h]
Redkin20: checks
bigbluerodeo: checks
*** TURN *** [3s Td 2h] [3h]
Redkin20: checks
bigbluerodeo: checks
*** RIVER *** [3s Td 2h 3h] [4h]
Redkin20: checks
bigbluerodeo: checks
*** SHOW DOWN ***
Redkin20: shows [Jc Kc] (a pair of Threes)
bigbluerodeo: mucks hand
Redkin20 collected $0.15 from pot
*** SUMMARY ***
Total pot $0.16 | Rake $0.01
Board [3s Td 2h 3h 4h]
Seat 1: bigbluerodeo mucked [Ks 8s]
Seat 2: TomT87 folded before Flop (didn't bet)
Seat 3: PTuck626 folded before Flop (didn't bet)
Seat 4: TroyBoy3912 (button) folded before Flop
Seat 5: PlayTheBlues4U (small blind) folded before Flop
Seat 6: Redkin20 (big blind) showed [Jc Kc] and won ($0.15) with a pair of Threes


*********** # 42 **************
PokerStars Hand #203588679535:  Hold'em No Limit ($0.01/$0.02 USD) - 2019/09/10 22:51:41 ET
Table 'Rana' 6-max Seat #3 is the button
Seat 1: PlayTheBlues4U ($2.38 in chips)
Seat 2: xxzuluzuluxx ($0.51 in chips)
Seat 3: bigbluerodeo ($1.92 in chips)
Seat 6: DruMoney201 ($2.47 in chips)
DruMoney201: posts small blind $0.01
PlayTheBlues4U: posts big blind $0.02
*** HOLE CARDS ***
Dealt to PlayTheBlues4U [7s Jc]
xxzuluzuluxx: folds
bigbluerodeo: folds
DruMoney201: calls $0.01
PlayTheBlues4U: checks
*** FLOP *** [2h Qc 4c]
DruMoney201: checks
PlayTheBlues4U: checks
*** TURN *** [2h Qc 4c] [Th]
DruMoney201: checks
PlayTheBlues4U: checks
*** RIVER *** [2h Qc 4c Th] [8d]
DruMoney201: checks
PlayTheBlues4U: checks
*** SHOW DOWN ***
DruMoney201: shows [6c 9s] (high card Queen)
PlayTheBlues4U: shows [7s Jc] (high card Queen - Jack kicker)
PlayTheBlues4U collected $0.04 from pot
*** SUMMARY ***
Total pot $0.04 | Rake $0
Board [2h Qc 4c Th 8d]
Seat 1: PlayTheBlues4U (big blind) showed [7s Jc] and won ($0.04) with high card Queen
Seat 2: xxzuluzuluxx folded before Flop (didn't bet)
Seat 3: bigbluerodeo (button) folded before Flop (didn't bet)
Seat 6: DruMoney201 (small blind) showed [6c 9s] and lost with high card Queen


*********** # 43 **************
PokerStars Hand #203588679378:  Hold'em No Limit ($0.01/$0.02 USD) - 2019/09/10 22:50:53 ET
Table 'Jabbah' 6-max Seat #3 is the button
Seat 1: bigbluerodeo ($2.65 in chips)
Seat 2: TomT87 ($1.28 in chips)
Seat 3: PTuck626 ($1.84 in chips)
Seat 4: TroyBoy3912 ($2.70 in chips)
Seat 5: PlayTheBlues4U ($2 in chips)
Seat 6: Redkin20 ($1.46 in chips)
TroyBoy3912: posts small blind $0.01
PlayTheBlues4U: posts big blind $0.02
*** HOLE CARDS ***
Dealt to PlayTheBlues4U [Kd 8d]
Redkin20: calls $0.02
bigbluerodeo: folds
TomT87: calls $0.02
PTuck626: calls $0.02
TroyBoy3912: calls $0.01
PlayTheBlues4U: checks
*** FLOP *** [5h 9d 9c]
TroyBoy3912: checks
PlayTheBlues4U: checks
Redkin20: checks
TomT87: bets $0.04
PTuck626: folds
TroyBoy3912: folds
PlayTheBlues4U: folds
Redkin20: calls $0.04
*** TURN *** [5h 9d 9c] [4h]
Redkin20: checks
TomT87: bets $0.08
Redkin20: folds
Uncalled bet ($0.08) returned to TomT87
TomT87 collected $0.17 from pot
TomT87: doesn't show hand
*** SUMMARY ***
Total pot $0.18 | Rake $0.01
Board [5h 9d 9c 4h]
Seat 1: bigbluerodeo folded before Flop (didn't bet)
Seat 2: TomT87 collected ($0.17)
Seat 3: PTuck626 (button) folded on the Flop
Seat 4: TroyBoy3912 (small blind) folded on the Flop
Seat 5: PlayTheBlues4U (big blind) folded on the Flop
Seat 6: Redkin20 folded on the Turn


*********** # 44 **************
PokerStars Hand #203588679172:  Hold'em No Limit ($0.01/$0.02 USD) - 2019/09/10 22:49:51 ET
Table 'Rana' 6-max Seat #5 is the button
Seat 2: xxzuluzuluxx ($0.55 in chips)
Seat 3: bigbluerodeo ($1.90 in chips)
Seat 4: LonLonMilk8 ($2.04 in chips)
Seat 5: PlayTheBlues4U ($2.38 in chips)
Seat 6: DruMoney201 ($2.46 in chips)
DruMoney201: posts small blind $0.01
xxzuluzuluxx: posts big blind $0.02
*** HOLE CARDS ***
Dealt to PlayTheBlues4U [4s Qs]
bigbluerodeo: folds
LonLonMilk8 has timed out
LonLonMilk8: folds
PlayTheBlues4U: folds
PlayTheBlues4U leaves the table
DruMoney201: calls $0.01
xxzuluzuluxx: checks
*** FLOP *** [2s 5s 6s]
DruMoney201: checks
xxzuluzuluxx: checks
*** TURN *** [2s 5s 6s] [6h]
DruMoney201: bets $0.02
xxzuluzuluxx: calls $0.02
*** RIVER *** [2s 5s 6s 6h] [2c]
DruMoney201: bets $0.02
xxzuluzuluxx: calls $0.02
*** SHOW DOWN ***
DruMoney201: shows [5h 3h] (two pair, Sixes and Fives)
xxzuluzuluxx: mucks hand
DruMoney201 collected $0.11 from pot
*** SUMMARY ***
Total pot $0.12 | Rake $0.01
Board [2s 5s 6s 6h 2c]
Seat 2: xxzuluzuluxx (big blind) mucked [7d Kh]
Seat 3: bigbluerodeo folded before Flop (didn't bet)
Seat 4: LonLonMilk8 folded before Flop (didn't bet)
Seat 5: PlayTheBlues4U (button) folded before Flop (didn't bet)
Seat 6: DruMoney201 (small blind) showed [5h 3h] and won ($0.11) with two pair, Sixes and Fives


*********** # 45 **************
PokerStars Hand #203588679071:  Hold'em No Limit ($0.01/$0.02 USD) - 2019/09/10 22:49:20 ET
Table 'Orion' 6-max Seat #3 is the button
Seat 1: jford9099 ($1.63 in chips)
Seat 2: maarketeer ($1.67 in chips)
Seat 3: bigbluerodeo ($2.80 in chips)
Seat 4: Smuggler1991 ($4.20 in chips)
Seat 5: LonLonMilk8 ($1.58 in chips)
Seat 6: PlayTheBlues4U ($1.91 in chips)
Smuggler1991: posts small blind $0.01
LonLonMilk8: posts big blind $0.02
*** HOLE CARDS ***
Dealt to PlayTheBlues4U [Jh Ks]
PlayTheBlues4U: folds
jford9099: raises $0.02 to $0.04
maarketeer: calls $0.04
bigbluerodeo: folds
Smuggler1991: folds
LonLonMilk8: folds
*** FLOP *** [8c 6h 6c]
jford9099: checks
maarketeer: bets $0.06
jford9099: calls $0.06
*** TURN *** [8c 6h 6c] [8s]
PlayTheBlues4U leaves the table
jford9099: checks
maarketeer: bets $0.22
jford9099: calls $0.22
*** RIVER *** [8c 6h 6c 8s] [9s]
jford9099: bets $0.32
maarketeer: raises $1.03 to $1.35 and is all-in
jford9099: folds
Uncalled bet ($1.03) returned to maarketeer
maarketeer collected $1.25 from pot
maarketeer: doesn't show hand
*** SUMMARY ***
Total pot $1.31 | Rake $0.06
Board [8c 6h 6c 8s 9s]
Seat 1: jford9099 folded on the River
Seat 2: maarketeer collected ($1.25)
Seat 3: bigbluerodeo (button) folded before Flop (didn't bet)
Seat 4: Smuggler1991 (small blind) folded before Flop
Seat 5: LonLonMilk8 (big blind) folded before Flop
Seat 6: PlayTheBlues4U folded before Flop (didn't bet)


*********** # 46 **************
PokerStars Hand #203588679042:  Hold'em No Limit ($0.01/$0.02 USD) - 2019/09/10 22:49:10 ET
Table 'Rana' 6-max Seat #4 is the button
Seat 1: delm44 ($1.82 in chips)
Seat 2: xxzuluzuluxx ($0.77 in chips)
Seat 3: bigbluerodeo ($1.90 in chips)
Seat 4: LonLonMilk8 ($2.04 in chips)
Seat 5: PlayTheBlues4U ($2.39 in chips)
Seat 6: DruMoney201 ($2.23 in chips)
PlayTheBlues4U: posts small blind $0.01
DruMoney201: posts big blind $0.02
*** HOLE CARDS ***
Dealt to PlayTheBlues4U [4c 8d]
delm44: calls $0.02
xxzuluzuluxx: calls $0.02
bigbluerodeo: folds
LonLonMilk8: folds
PlayTheBlues4U: folds
DruMoney201: checks
*** FLOP *** [2d 4s Jd]
DruMoney201: bets $0.20
delm44: folds
xxzuluzuluxx: calls $0.20
*** TURN *** [2d 4s Jd] [As]
delm44 leaves the table
DruMoney201: bets $0.44
xxzuluzuluxx: folds
Uncalled bet ($0.44) returned to DruMoney201
DruMoney201 collected $0.45 from pot
DruMoney201: doesn't show hand
*** SUMMARY ***
Total pot $0.47 | Rake $0.02
Board [2d 4s Jd As]
Seat 1: delm44 folded on the Flop
Seat 2: xxzuluzuluxx folded on the Turn
Seat 3: bigbluerodeo folded before Flop (didn't bet)
Seat 4: LonLonMilk8 (button) folded before Flop (didn't bet)
Seat 5: PlayTheBlues4U (small blind) folded before Flop
Seat 6: DruMoney201 (big blind) collected ($0.45)


*********** # 47 **************
PokerStars Hand #203588678966:  Hold'em No Limit ($0.01/$0.02 USD) - 2019/09/10 22:48:48 ET
Table 'Orion' 6-max Seat #2 is the button
Seat 1: jford9099 ($1.63 in chips)
Seat 2: maarketeer ($1.75 in chips)
Seat 3: bigbluerodeo ($2.82 in chips)
Seat 4: Smuggler1991 ($4.11 in chips)
Seat 5: LonLonMilk8 ($1.58 in chips)
Seat 6: PlayTheBlues4U ($1.91 in chips)
bigbluerodeo: posts small blind $0.01
Smuggler1991: posts big blind $0.02
*** HOLE CARDS ***
Dealt to PlayTheBlues4U [2s Jc]
LonLonMilk8: folds
PlayTheBlues4U: folds
jford9099: folds
maarketeer: calls $0.02
bigbluerodeo: calls $0.01
Smuggler1991: raises $0.06 to $0.08
maarketeer: calls $0.06
bigbluerodeo: folds
*** FLOP *** [4d 4h 3d]
Smuggler1991: bets $0.08
maarketeer: folds
Uncalled bet ($0.08) returned to Smuggler1991
Smuggler1991 collected $0.17 from pot
Smuggler1991: doesn't show hand
*** SUMMARY ***
Total pot $0.18 | Rake $0.01
Board [4d 4h 3d]
Seat 1: jford9099 folded before Flop (didn't bet)
Seat 2: maarketeer (button) folded on the Flop
Seat 3: bigbluerodeo (small blind) folded before Flop
Seat 4: Smuggler1991 (big blind) collected ($0.17)
Seat 5: LonLonMilk8 folded before Flop (didn't bet)
Seat 6: PlayTheBlues4U folded before Flop (didn't bet)


*********** # 48 **************
PokerStars Hand #203588678895:  Hold'em No Limit ($0.01/$0.02 USD) - 2019/09/10 22:48:23 ET
Table 'Rana' 6-max Seat #3 is the button
Seat 1: delm44 ($1.86 in chips)
Seat 2: xxzuluzuluxx ($0.77 in chips)
Seat 3: bigbluerodeo ($1.90 in chips)
Seat 4: LonLonMilk8 ($2.05 in chips)
Seat 5: PlayTheBlues4U ($2.34 in chips)
Seat 6: DruMoney201 ($2.23 in chips)
LonLonMilk8: posts small blind $0.01
PlayTheBlues4U: posts big blind $0.02
*** HOLE CARDS ***
Dealt to PlayTheBlues4U [4s Qs]
DruMoney201: folds
delm44: calls $0.02
xxzuluzuluxx: folds
bigbluerodeo: folds
LonLonMilk8: folds
PlayTheBlues4U: checks
*** FLOP *** [Qh Ks 8h]
PlayTheBlues4U: checks
delm44: checks
*** TURN *** [Qh Ks 8h] [6d]
PlayTheBlues4U: bets $0.02
delm44: calls $0.02
*** RIVER *** [Qh Ks 8h 6d] [9d]
PlayTheBlues4U: checks
delm44: checks
*** SHOW DOWN ***
PlayTheBlues4U: shows [4s Qs] (a pair of Queens)
delm44: mucks hand
PlayTheBlues4U collected $0.09 from pot
*** SUMMARY ***
Total pot $0.09 | Rake $0
Board [Qh Ks 8h 6d 9d]
Seat 1: delm44 mucked [6c Ad]
Seat 2: xxzuluzuluxx folded before Flop (didn't bet)
Seat 3: bigbluerodeo (button) folded before Flop (didn't bet)
Seat 4: LonLonMilk8 (small blind) folded before Flop
Seat 5: PlayTheBlues4U (big blind) showed [4s Qs] and won ($0.09) with a pair of Queens
Seat 6: DruMoney201 folded before Flop (didn't bet)


*********** # 49 **************
PokerStars Hand #203588678849:  Hold'em No Limit ($0.01/$0.02 USD) - 2019/09/10 22:48:08 ET
Table 'Orion' 6-max Seat #1 is the button
Seat 1: jford9099 ($1.65 in chips)
Seat 2: maarketeer ($1.69 in chips)
Seat 3: bigbluerodeo ($2.84 in chips)
Seat 4: Smuggler1991 ($4.11 in chips)
Seat 5: LonLonMilk8 ($1.60 in chips)
Seat 6: PlayTheBlues4U ($1.91 in chips)
maarketeer: posts small blind $0.01
bigbluerodeo: posts big blind $0.02
LonLonMilk8: posts big blind $0.02
*** HOLE CARDS ***
Dealt to PlayTheBlues4U [7d 9h]
Smuggler1991: folds
LonLonMilk8: checks
PlayTheBlues4U: folds
jford9099: calls $0.02
maarketeer: raises $0.08 to $0.10
bigbluerodeo: folds
LonLonMilk8: folds
jford9099: folds
Uncalled bet ($0.08) returned to maarketeer
maarketeer collected $0.08 from pot
maarketeer: doesn't show hand
*** SUMMARY ***
Total pot $0.08 | Rake $0
Seat 1: jford9099 (button) folded before Flop
Seat 2: maarketeer (small blind) collected ($0.08)
Seat 3: bigbluerodeo (big blind) folded before Flop
Seat 4: Smuggler1991 folded before Flop (didn't bet)
Seat 5: LonLonMilk8 folded before Flop (didn't bet)
Seat 6: PlayTheBlues4U folded before Flop (didn't bet)


*********** # 50 **************
PokerStars Hand #203588678758:  Hold'em No Limit ($0.01/$0.02 USD) - 2019/09/10 22:47:39 ET
Table 'Orion' 6-max Seat #6 is the button
Seat 1: jford9099 ($1.66 in chips)
Seat 2: maarketeer ($1.64 in chips)
Seat 3: bigbluerodeo ($2.84 in chips)
Seat 4: Smuggler1991 ($4.11 in chips)
Seat 6: PlayTheBlues4U ($1.95 in chips)
jford9099: posts small blind $0.01
maarketeer: posts big blind $0.02
LonLonMilk8: sits out
*** HOLE CARDS ***
Dealt to PlayTheBlues4U [9h 4s]
bigbluerodeo: folds
Smuggler1991: folds
PlayTheBlues4U: raises $0.02 to $0.04
jford9099: folds
maarketeer: calls $0.02
*** FLOP *** [Th Kc 3c]
maarketeer: bets $0.04
PlayTheBlues4U: folds
Uncalled bet ($0.04) returned to maarketeer
maarketeer collected $0.09 from pot
maarketeer: doesn't show hand
*** SUMMARY ***
Total pot $0.09 | Rake $0
Board [Th Kc 3c]
Seat 1: jford9099 (small blind) folded before Flop
Seat 2: maarketeer (big blind) collected ($0.09)
Seat 3: bigbluerodeo folded before Flop (didn't bet)
Seat 4: Smuggler1991 folded before Flop (didn't bet)
Seat 6: PlayTheBlues4U (button) folded on the Flop


*********** # 51 **************
PokerStars Hand #203588678708:  Hold'em No Limit ($0.01/$0.02 USD) - 2019/09/10 22:47:23 ET
Table 'Rana' 6-max Seat #2 is the button
Seat 1: delm44 ($1.64 in chips)
Seat 2: xxzuluzuluxx ($0.77 in chips)
Seat 3: bigbluerodeo ($1.91 in chips)
Seat 4: LonLonMilk8 ($2.07 in chips)
Seat 5: PlayTheBlues4U ($2.55 in chips)
Seat 6: DruMoney201 ($2.23 in chips)
bigbluerodeo: posts small blind $0.01
LonLonMilk8: posts big blind $0.02
*** HOLE CARDS ***
Dealt to PlayTheBlues4U [6h 5h]
PlayTheBlues4U: raises $0.04 to $0.06
DruMoney201: folds
delm44: raises $0.15 to $0.21
xxzuluzuluxx: folds
bigbluerodeo: folds
LonLonMilk8: folds
PlayTheBlues4U: calls $0.15
*** FLOP *** [Qh 8d 2c]
PlayTheBlues4U: checks
delm44: bets $0.22
PlayTheBlues4U: folds
Uncalled bet ($0.22) returned to delm44
delm44 collected $0.43 from pot
delm44: doesn't show hand
*** SUMMARY ***
Total pot $0.45 | Rake $0.02
Board [Qh 8d 2c]
Seat 1: delm44 collected ($0.43)
Seat 2: xxzuluzuluxx (button) folded before Flop (didn't bet)
Seat 3: bigbluerodeo (small blind) folded before Flop
Seat 4: LonLonMilk8 (big blind) folded before Flop
Seat 5: PlayTheBlues4U folded on the Flop
Seat 6: DruMoney201 folded before Flop (didn't bet)


*********** # 52 **************
PokerStars Hand #203588678554:  Hold'em No Limit ($0.01/$0.02 USD) - 2019/09/10 22:46:36 ET
Table 'Rana' 6-max Seat #1 is the button
Seat 1: delm44 ($1.71 in chips)
Seat 2: xxzuluzuluxx ($0.78 in chips)
Seat 3: bigbluerodeo ($1.93 in chips)
Seat 4: LonLonMilk8 ($1.98 in chips)
Seat 5: PlayTheBlues4U ($2.55 in chips)
Seat 6: DruMoney201 ($2.23 in chips)
xxzuluzuluxx: posts small blind $0.01
bigbluerodeo: posts big blind $0.02
*** HOLE CARDS ***
Dealt to PlayTheBlues4U [Ac 2s]
LonLonMilk8: raises $0.05 to $0.07
PlayTheBlues4U: folds
DruMoney201: folds
delm44: calls $0.07
xxzuluzuluxx: folds
bigbluerodeo: folds
*** FLOP *** [3d Ad Ts]
LonLonMilk8: bets $0.12
delm44: folds
Uncalled bet ($0.12) returned to LonLonMilk8
LonLonMilk8 collected $0.16 from pot
LonLonMilk8: doesn't show hand
*** SUMMARY ***
Total pot $0.17 | Rake $0.01
Board [3d Ad Ts]
Seat 1: delm44 (button) folded on the Flop
Seat 2: xxzuluzuluxx (small blind) folded before Flop
Seat 3: bigbluerodeo (big blind) folded before Flop
Seat 4: LonLonMilk8 collected ($0.16)
Seat 5: PlayTheBlues4U folded before Flop (didn't bet)
Seat 6: DruMoney201 folded before Flop (didn't bet)


*********** # 53 **************
PokerStars Hand #203588678474:  Hold'em No Limit ($0.01/$0.02 USD) - 2019/09/10 22:46:11 ET
Table 'Orion' 6-max Seat #4 is the button
Seat 1: jford9099 ($1.66 in chips)
Seat 2: maarketeer ($1.44 in chips)
Seat 3: bigbluerodeo ($2.84 in chips)
Seat 4: Smuggler1991 ($4.30 in chips)
Seat 5: GrowSomeNutz ($2.48 in chips)
Seat 6: PlayTheBlues4U ($1.97 in chips)
GrowSomeNutz: posts small blind $0.01
PlayTheBlues4U: posts big blind $0.02
*** HOLE CARDS ***
Dealt to PlayTheBlues4U [Td Qs]
jford9099 has timed out
jford9099: folds
maarketeer: calls $0.02
bigbluerodeo: folds
Smuggler1991: raises $0.07 to $0.09
GrowSomeNutz: folds
PlayTheBlues4U: folds
maarketeer: calls $0.07
*** FLOP *** [8s 9d 2h]
GrowSomeNutz leaves the table
LonLonMilk8 joins the table at seat #5
maarketeer: checks
Smuggler1991: bets $0.10
maarketeer: calls $0.10
*** TURN *** [8s 9d 2h] [Ts]
maarketeer: checks
Smuggler1991: checks
*** RIVER *** [8s 9d 2h Ts] [3s]
maarketeer: bets $0.20
Smuggler1991: folds
Uncalled bet ($0.20) returned to maarketeer
maarketeer collected $0.39 from pot
maarketeer: doesn't show hand
*** SUMMARY ***
Total pot $0.41 | Rake $0.02
Board [8s 9d 2h Ts 3s]
Seat 1: jford9099 folded before Flop (didn't bet)
Seat 2: maarketeer collected ($0.39)
Seat 3: bigbluerodeo folded before Flop (didn't bet)
Seat 4: Smuggler1991 (button) folded on the River
Seat 5: GrowSomeNutz (small blind) folded before Flop
Seat 6: PlayTheBlues4U (big blind) folded before Flop


*********** # 54 **************
PokerStars Hand #203588678444:  Hold'em No Limit ($0.01/$0.02 USD) - 2019/09/10 22:46:03 ET
Table 'Rana' 6-max Seat #6 is the button
Seat 1: delm44 ($1.72 in chips)
Seat 2: xxzuluzuluxx ($0.80 in chips)
Seat 3: bigbluerodeo ($1.93 in chips)
Seat 4: LonLonMilk8 ($2 in chips)
Seat 5: PlayTheBlues4U ($2.55 in chips)
Seat 6: DruMoney201 ($2.18 in chips)
delm44: posts small blind $0.01
xxzuluzuluxx: posts big blind $0.02
LonLonMilk8: posts big blind $0.02
*** HOLE CARDS ***
Dealt to PlayTheBlues4U [3d 2s]
bigbluerodeo: folds
LonLonMilk8: checks
PlayTheBlues4U: folds
DruMoney201: raises $0.07 to $0.09
delm44: folds
xxzuluzuluxx: folds
LonLonMilk8: folds
Uncalled bet ($0.07) returned to DruMoney201
DruMoney201 collected $0.07 from pot
DruMoney201: doesn't show hand
*** SUMMARY ***
Total pot $0.07 | Rake $0
Seat 1: delm44 (small blind) folded before Flop
Seat 2: xxzuluzuluxx (big blind) folded before Flop
Seat 3: bigbluerodeo folded before Flop (didn't bet)
Seat 4: LonLonMilk8 folded before Flop (didn't bet)
Seat 5: PlayTheBlues4U folded before Flop (didn't bet)
Seat 6: DruMoney201 (button) collected ($0.07)


*********** # 55 **************
PokerStars Hand #203588678251:  Hold'em No Limit ($0.01/$0.02 USD) - 2019/09/10 22:45:05 ET
Table 'Orion' 6-max Seat #3 is the button
Seat 1: jford9099 ($1.66 in chips)
Seat 2: maarketeer ($1.54 in chips)
Seat 3: bigbluerodeo ($3.24 in chips)
Seat 4: Smuggler1991 ($4.32 in chips)
Seat 5: GrowSomeNutz ($2 in chips)
Seat 6: PlayTheBlues4U ($1.97 in chips)
Smuggler1991: posts small blind $0.01
GrowSomeNutz: posts big blind $0.02
*** HOLE CARDS ***
Dealt to PlayTheBlues4U [4d 8d]
PlayTheBlues4U: folds
jford9099: folds
maarketeer: calls $0.02
bigbluerodeo: calls $0.02
Smuggler1991: calls $0.01
GrowSomeNutz: checks
*** FLOP *** [Qc 4h 3c]
Smuggler1991: checks
GrowSomeNutz: bets $0.08
maarketeer: calls $0.08
bigbluerodeo: calls $0.08
Smuggler1991: folds
*** TURN *** [Qc 4h 3c] [Jd]
GrowSomeNutz: bets $0.30
maarketeer: folds
bigbluerodeo: calls $0.30
*** RIVER *** [Qc 4h 3c Jd] [5d]
GrowSomeNutz: checks
bigbluerodeo: checks
*** SHOW DOWN ***
GrowSomeNutz: shows [Qh 8h] (a pair of Queens)
bigbluerodeo: mucks hand
GrowSomeNutz collected $0.88 from pot
*** SUMMARY ***
Total pot $0.92 | Rake $0.04
Board [Qc 4h 3c Jd 5d]
Seat 1: jford9099 folded before Flop (didn't bet)
Seat 2: maarketeer folded on the Turn
Seat 3: bigbluerodeo (button) mucked [5c 9c]
Seat 4: Smuggler1991 (small blind) folded on the Flop
Seat 5: GrowSomeNutz (big blind) showed [Qh 8h] and won ($0.88) with a pair of Queens
Seat 6: PlayTheBlues4U folded before Flop (didn't bet)


*********** # 56 **************
PokerStars Hand #203588678208:  Hold'em No Limit ($0.01/$0.02 USD) - 2019/09/10 22:44:53 ET
Table 'Rana' 6-max Seat #5 is the button
Seat 1: delm44 ($1.71 in chips)
Seat 3: bigbluerodeo ($1.95 in chips)
Seat 5: PlayTheBlues4U ($2.55 in chips)
Seat 6: DruMoney201 ($2.17 in chips)
DruMoney201: posts small blind $0.01
delm44: posts big blind $0.02
LonLonMilk8: sits out
*** HOLE CARDS ***
Dealt to PlayTheBlues4U [9d 4c]
bigbluerodeo: calls $0.02
PlayTheBlues4U: folds
DruMoney201: calls $0.01
delm44: checks
*** FLOP *** [Jc Jd Ac]
DruMoney201: checks
delm44: checks
bigbluerodeo: checks
*** TURN *** [Jc Jd Ac] [8h]
DruMoney201: checks
delm44: checks
bigbluerodeo: checks
*** RIVER *** [Jc Jd Ac 8h] [2h]
DruMoney201: checks
delm44: checks
bigbluerodeo: checks
*** SHOW DOWN ***
DruMoney201: shows [Ts 8c] (two pair, Jacks and Eights)
delm44: shows [Kd 8d] (two pair, Jacks and Eights)
bigbluerodeo: mucks hand
DruMoney201 collected $0.03 from pot
delm44 collected $0.03 from pot
xxzuluzuluxx joins the table at seat #2
*** SUMMARY ***
Total pot $0.06 | Rake $0
Board [Jc Jd Ac 8h 2h]
Seat 1: delm44 (big blind) showed [Kd 8d] and won ($0.03) with two pair, Jacks and Eights
Seat 3: bigbluerodeo mucked [7s 4s]
Seat 5: PlayTheBlues4U (button) folded before Flop (didn't bet)
Seat 6: DruMoney201 (small blind) showed [Ts 8c] and won ($0.03) with two pair, Jacks and Eights


*********** # 57 **************
PokerStars Hand #203588678154:  Hold'em No Limit ($0.01/$0.02 USD) - 2019/09/10 22:44:34 ET
Table 'Rana' 6-max Seat #3 is the button
Seat 1: delm44 ($1.71 in chips)
Seat 3: bigbluerodeo ($1.95 in chips)
Seat 5: PlayTheBlues4U ($2.53 in chips)
Seat 6: DruMoney201 ($2.19 in chips)
LonLonMilk8 will be allowed to play after the button
PlayTheBlues4U: posts small blind $0.01
DruMoney201: posts big blind $0.02
*** HOLE CARDS ***
Dealt to PlayTheBlues4U [4h 5s]
delm44: folds
bigbluerodeo: folds
PlayTheBlues4U: calls $0.01
vgctmg leaves the table
DruMoney201: checks
*** FLOP *** [Ac Jh 5h]
PlayTheBlues4U: bets $0.02
DruMoney201: folds
Uncalled bet ($0.02) returned to PlayTheBlues4U
PlayTheBlues4U collected $0.04 from pot
PlayTheBlues4U: doesn't show hand
*** SUMMARY ***
Total pot $0.04 | Rake $0
Board [Ac Jh 5h]
Seat 1: delm44 folded before Flop (didn't bet)
Seat 3: bigbluerodeo (button) folded before Flop (didn't bet)
Seat 5: PlayTheBlues4U (small blind) collected ($0.04)
Seat 6: DruMoney201 (big blind) folded on the Flop


*********** # 58 **************
PokerStars Hand #203588678070:  Hold'em No Limit ($0.01/$0.02 USD) - 2019/09/10 22:44:11 ET
Table 'Orion' 6-max Seat #2 is the button
Seat 1: jford9099 ($1.66 in chips)
Seat 2: maarketeer ($1.62 in chips)
Seat 3: bigbluerodeo ($3.15 in chips)
Seat 4: Smuggler1991 ($4.34 in chips)
Seat 6: PlayTheBlues4U ($1.97 in chips)
bigbluerodeo: posts small blind $0.01
Smuggler1991: posts big blind $0.02
GrowSomeNutz: sits out
*** HOLE CARDS ***
Dealt to PlayTheBlues4U [4c 3d]
PlayTheBlues4U: folds
jford9099: folds
maarketeer: calls $0.02
bigbluerodeo: calls $0.01
Smuggler1991: checks
*** FLOP *** [Ad Td 3h]
bigbluerodeo: bets $0.06
Smuggler1991: folds
maarketeer: calls $0.06
*** TURN *** [Ad Td 3h] [Qc]
bigbluerodeo: checks
maarketeer: checks
*** RIVER *** [Ad Td 3h Qc] [Ah]
bigbluerodeo: checks
maarketeer: checks
*** SHOW DOWN ***
bigbluerodeo: shows [Tc 2c] (two pair, Aces and Tens)
maarketeer: mucks hand
bigbluerodeo collected $0.17 from pot
*** SUMMARY ***
Total pot $0.18 | Rake $0.01
Board [Ad Td 3h Qc Ah]
Seat 1: jford9099 folded before Flop (didn't bet)
Seat 2: maarketeer (button) mucked [5d 9d]
Seat 3: bigbluerodeo (small blind) showed [Tc 2c] and won ($0.17) with two pair, Aces and Tens
Seat 4: Smuggler1991 (big blind) folded on the Flop
Seat 6: PlayTheBlues4U folded before Flop (didn't bet)


*********** # 59 **************
PokerStars Hand #203588677956:  Hold'em No Limit ($0.01/$0.02 USD) - 2019/09/10 22:43:35 ET
Table 'Orion' 6-max Seat #1 is the button
Seat 1: jford9099 ($1.62 in chips)
Seat 2: maarketeer ($1.64 in chips)
Seat 3: bigbluerodeo ($3.17 in chips)
Seat 4: Smuggler1991 ($4.34 in chips)
Seat 6: PlayTheBlues4U ($1.97 in chips)
maarketeer: posts small blind $0.01
bigbluerodeo: posts big blind $0.02
GrowSomeNutz: sits out
*** HOLE CARDS ***
Dealt to PlayTheBlues4U [4h 7s]
Smuggler1991: folds
PlayTheBlues4U: folds
jford9099: calls $0.02
maarketeer: calls $0.01
bigbluerodeo: checks
*** FLOP *** [Kd 5c Ah]
maarketeer: checks
bigbluerodeo: checks
jford9099: bets $0.04
maarketeer: folds
bigbluerodeo: folds
Uncalled bet ($0.04) returned to jford9099
jford9099 collected $0.06 from pot
jford9099: doesn't show hand
*** SUMMARY ***
Total pot $0.06 | Rake $0
Board [Kd 5c Ah]
Seat 1: jford9099 (button) collected ($0.06)
Seat 2: maarketeer (small blind) folded on the Flop
Seat 3: bigbluerodeo (big blind) folded on the Flop
Seat 4: Smuggler1991 folded before Flop (didn't bet)
Seat 6: PlayTheBlues4U folded before Flop (didn't bet)


*********** # 60 **************
PokerStars Hand #203588677928:  Hold'em No Limit ($0.01/$0.02 USD) - 2019/09/10 22:43:27 ET
Table 'Rana' 6-max Seat #2 is the button
Seat 1: delm44 ($1.63 in chips)
Seat 2: vgctmg ($0.69 in chips)
Seat 3: bigbluerodeo ($1.97 in chips)
Seat 5: PlayTheBlues4U ($2.55 in chips)
Seat 6: DruMoney201 ($2.21 in chips)
bigbluerodeo: posts small blind $0.01
PlayTheBlues4U: posts big blind $0.02
*** HOLE CARDS ***
Dealt to PlayTheBlues4U [6s 5c]
DruMoney201: calls $0.02
delm44: calls $0.02
vgctmg: calls $0.02
bigbluerodeo: calls $0.01
PlayTheBlues4U: checks
*** FLOP *** [Jc 4s As]
bigbluerodeo: checks
PlayTheBlues4U: checks
DruMoney201: checks
delm44: checks
vgctmg: checks
*** TURN *** [Jc 4s As] [Qs]
bigbluerodeo: checks
PlayTheBlues4U: checks
DruMoney201: checks
delm44: checks
vgctmg: checks
*** RIVER *** [Jc 4s As Qs] [2h]
bigbluerodeo: checks
PlayTheBlues4U: checks
DruMoney201: checks
delm44: checks
vgctmg: checks
*** SHOW DOWN ***
bigbluerodeo: shows [4c 3d] (a pair of Fours)
PlayTheBlues4U: mucks hand
DruMoney201: mucks hand
delm44: shows [8s 8h] (a pair of Eights)
vgctmg: mucks hand
delm44 collected $0.10 from pot
LonLonMilk8 joins the table at seat #4
*** SUMMARY ***
Total pot $0.10 | Rake $0
Board [Jc 4s As Qs 2h]
Seat 1: delm44 showed [8s 8h] and won ($0.10) with a pair of Eights
Seat 2: vgctmg (button) mucked [Kc 7s]
Seat 3: bigbluerodeo (small blind) showed [4c 3d] and lost with a pair of Fours
Seat 5: PlayTheBlues4U (big blind) mucked [6s 5c]
Seat 6: DruMoney201 mucked [7c 6c]


*********** # 61 **************
PokerStars Hand #203588677788:  Hold'em No Limit ($0.01/$0.02 USD) - 2019/09/10 22:42:44 ET
Table 'Rana' 6-max Seat #1 is the button
Seat 1: delm44 ($1.63 in chips)
Seat 2: vgctmg ($0.71 in chips)
Seat 3: bigbluerodeo ($1.99 in chips)
Seat 4: Sparseeye ($1.49 in chips)
Seat 5: PlayTheBlues4U ($2.55 in chips)
Seat 6: DruMoney201 ($2.17 in chips)
vgctmg: posts small blind $0.01
bigbluerodeo: posts big blind $0.02
*** HOLE CARDS ***
Dealt to PlayTheBlues4U [4c 8d]
Sparseeye: folds
PlayTheBlues4U: folds
DruMoney201: calls $0.02
delm44: folds
vgctmg: calls $0.01
bigbluerodeo: checks
*** FLOP *** [Jc 6c Jd]
vgctmg: checks
bigbluerodeo: checks
Sparseeye leaves the table
DruMoney201: bets $0.06
vgctmg: folds
bigbluerodeo: folds
Uncalled bet ($0.06) returned to DruMoney201
DruMoney201 collected $0.06 from pot
DruMoney201: doesn't show hand
*** SUMMARY ***
Total pot $0.06 | Rake $0
Board [Jc 6c Jd]
Seat 1: delm44 (button) folded before Flop (didn't bet)
Seat 2: vgctmg (small blind) folded on the Flop
Seat 3: bigbluerodeo (big blind) folded on the Flop
Seat 4: Sparseeye folded before Flop (didn't bet)
Seat 5: PlayTheBlues4U folded before Flop (didn't bet)
Seat 6: DruMoney201 collected ($0.06)


*********** # 62 **************
PokerStars Hand #203588677781:  Hold'em No Limit ($0.01/$0.02 USD) - 2019/09/10 22:42:41 ET
Table 'Orion' 6-max Seat #6 is the button
Seat 1: jford9099 ($1.79 in chips)
Seat 2: maarketeer ($1.42 in chips)
Seat 3: bigbluerodeo ($3.17 in chips)
Seat 4: Smuggler1991 ($4.41 in chips)
Seat 6: PlayTheBlues4U ($1.97 in chips)
jford9099: posts small blind $0.01
maarketeer: posts big blind $0.02
GrowSomeNutz: sits out
*** HOLE CARDS ***
Dealt to PlayTheBlues4U [Kc 6d]
bigbluerodeo: folds
Smuggler1991: raises $0.05 to $0.07
PlayTheBlues4U: folds
jford9099: calls $0.06
maarketeer: calls $0.05
*** FLOP *** [7d Qs Ts]
jford9099: bets $0.10
maarketeer: raises $0.20 to $0.30
Smuggler1991: folds
jford9099: folds
Uncalled bet ($0.20) returned to maarketeer
maarketeer collected $0.39 from pot
maarketeer: doesn't show hand
*** SUMMARY ***
Total pot $0.41 | Rake $0.02
Board [7d Qs Ts]
Seat 1: jford9099 (small blind) folded on the Flop
Seat 2: maarketeer (big blind) collected ($0.39)
Seat 3: bigbluerodeo folded before Flop (didn't bet)
Seat 4: Smuggler1991 folded on the Flop
Seat 6: PlayTheBlues4U (button) folded before Flop (didn't bet)


*********** # 63 **************
PokerStars Hand #203588677614:  Hold'em No Limit ($0.01/$0.02 USD) - 2019/09/10 22:41:43 ET
Table 'Rana' 6-max Seat #6 is the button
Seat 1: delm44 ($1.64 in chips)
Seat 2: vgctmg ($0.77 in chips)
Seat 3: bigbluerodeo ($1.78 in chips)
Seat 4: Sparseeye ($1.49 in chips)
Seat 5: PlayTheBlues4U ($2.71 in chips)
Seat 6: DruMoney201 ($2.17 in chips)
delm44: posts small blind $0.01
vgctmg: posts big blind $0.02
*** HOLE CARDS ***
Dealt to PlayTheBlues4U [Td Kd]
bigbluerodeo: calls $0.02
vgctmg said, "ugh"
Sparseeye: folds
PlayTheBlues4U: raises $0.04 to $0.06
DruMoney201: folds
delm44: folds
vgctmg: calls $0.04
bigbluerodeo: calls $0.04
*** FLOP *** [Qc 6c 5s]
vgctmg: checks
bigbluerodeo: checks
PlayTheBlues4U: checks
*** TURN *** [Qc 6c 5s] [5h]
vgctmg: checks
bigbluerodeo: checks
PlayTheBlues4U: checks
*** RIVER *** [Qc 6c 5s 5h] [5c]
vgctmg: checks
bigbluerodeo: bets $0.10
PlayTheBlues4U: calls $0.10
vgctmg: folds
*** SHOW DOWN ***
bigbluerodeo: shows [Ac 2c] (a flush, Ace high)
PlayTheBlues4U: mucks hand
bigbluerodeo collected $0.37 from pot
*** SUMMARY ***
Total pot $0.39 | Rake $0.02
Board [Qc 6c 5s 5h 5c]
Seat 1: delm44 (small blind) folded before Flop
Seat 2: vgctmg (big blind) folded on the River
Seat 3: bigbluerodeo showed [Ac 2c] and won ($0.37) with a flush, Ace high
Seat 4: Sparseeye folded before Flop (didn't bet)
Seat 5: PlayTheBlues4U mucked [Td Kd]
Seat 6: DruMoney201 (button) folded before Flop (didn't bet)


*********** # 64 **************
PokerStars Hand #203588677564:  Hold'em No Limit ($0.01/$0.02 USD) - 2019/09/10 22:41:29 ET
Table 'Orion' 6-max Seat #4 is the button
Seat 1: jford9099 ($1.81 in chips)
Seat 2: maarketeer ($1.99 in chips)
Seat 3: bigbluerodeo ($2.62 in chips)
Seat 4: Smuggler1991 ($4.41 in chips)
Seat 6: PlayTheBlues4U ($1.98 in chips)
PlayTheBlues4U: posts small blind $0.01
jford9099: posts big blind $0.02
*** HOLE CARDS ***
Dealt to PlayTheBlues4U [3d Ks]
maarketeer: calls $0.02
bigbluerodeo: raises $0.07 to $0.09
erickcoelho22 leaves the table
Smuggler1991: folds
PlayTheBlues4U: folds
GrowSomeNutz joins the table at seat #5
jford9099: folds
maarketeer: calls $0.07
*** FLOP *** [Ts Kd As]
maarketeer: checks
bigbluerodeo: bets $0.20
maarketeer: calls $0.20
*** TURN *** [Ts Kd As] [4c]
maarketeer: bets $0.28
bigbluerodeo: calls $0.28
*** RIVER *** [Ts Kd As 4c] [4h]
maarketeer: checks
bigbluerodeo: checks
*** SHOW DOWN ***
maarketeer: shows [5c 5d] (two pair, Fives and Fours)
bigbluerodeo: shows [Ac Qd] (two pair, Aces and Fours)
bigbluerodeo collected $1.12 from pot
*** SUMMARY ***
Total pot $1.17 | Rake $0.05
Board [Ts Kd As 4c 4h]
Seat 1: jford9099 (big blind) folded before Flop
Seat 2: maarketeer showed [5c 5d] and lost with two pair, Fives and Fours
Seat 3: bigbluerodeo showed [Ac Qd] and won ($1.12) with two pair, Aces and Fours
Seat 4: Smuggler1991 (button) folded before Flop (didn't bet)
Seat 6: PlayTheBlues4U (small blind) folded before Flop


*********** # 65 **************
PokerStars Hand #203588677373:  Hold'em No Limit ($0.01/$0.02 USD) - 2019/09/10 22:40:24 ET
Table 'Orion' 6-max Seat #3 is the button
Seat 1: jford9099 ($1.83 in chips)
Seat 2: maarketeer ($2.15 in chips)
Seat 3: bigbluerodeo ($2.62 in chips)
Seat 4: Smuggler1991 ($2.42 in chips)
Seat 5: erickcoelho22 ($2 in chips)
Seat 6: PlayTheBlues4U ($1.98 in chips)
Smuggler1991: posts small blind $0.01
erickcoelho22: posts big blind $0.02
*** HOLE CARDS ***
Dealt to PlayTheBlues4U [2s Ts]
PlayTheBlues4U: folds
jford9099: calls $0.02
maarketeer: raises $0.02 to $0.04
bigbluerodeo: folds
Smuggler1991: raises $0.12 to $0.16
erickcoelho22: calls $0.14
jford9099: folds
maarketeer: calls $0.12
*** FLOP *** [5c 2c 7c]
Smuggler1991: bets $0.24
erickcoelho22: calls $0.24
maarketeer: folds
*** TURN *** [5c 2c 7c] [2d]
Smuggler1991: checks
erickcoelho22: checks
*** RIVER *** [5c 2c 7c 2d] [6c]
Smuggler1991: bets $0.46
erickcoelho22: raises $1.14 to $1.60 and is all-in
Smuggler1991: calls $1.14
*** SHOW DOWN ***
erickcoelho22: shows [6s 7s] (two pair, Sevens and Sixes)
Smuggler1991: shows [Jc Kh] (a flush, Jack high)
Smuggler1991 collected $3.99 from pot
*** SUMMARY ***
Total pot $4.18 | Rake $0.19
Board [5c 2c 7c 2d 6c]
Seat 1: jford9099 folded before Flop
Seat 2: maarketeer folded on the Flop
Seat 3: bigbluerodeo (button) folded before Flop (didn't bet)
Seat 4: Smuggler1991 (small blind) showed [Jc Kh] and won ($3.99) with a flush, Jack high
Seat 5: erickcoelho22 (big blind) showed [6s 7s] and lost with two pair, Sevens and Sixes
Seat 6: PlayTheBlues4U folded before Flop (didn't bet)


*********** # 66 **************
PokerStars Hand #203588677237:  Hold'em No Limit ($0.01/$0.02 USD) - 2019/09/10 22:39:40 ET
Table 'Orion' 6-max Seat #2 is the button
Seat 1: jford9099 ($1.85 in chips)
Seat 2: maarketeer ($2.15 in chips)
Seat 3: bigbluerodeo ($2.64 in chips)
Seat 4: Smuggler1991 ($2.38 in chips)
Seat 6: PlayTheBlues4U ($1.98 in chips)
bigbluerodeo: posts small blind $0.01
Smuggler1991: posts big blind $0.02
*** HOLE CARDS ***
Dealt to PlayTheBlues4U [Jc 4s]
PlayTheBlues4U: folds
jford9099: calls $0.02
maarketeer: folds
bigbluerodeo: calls $0.01
erickcoelho22 joins the table at seat #5
Smuggler1991: checks
*** FLOP *** [Jh 6c Th]
bigbluerodeo: checks
Smuggler1991: bets $0.06
jford9099: folds
bigbluerodeo: folds
Uncalled bet ($0.06) returned to Smuggler1991
Smuggler1991 collected $0.06 from pot
Smuggler1991: doesn't show hand
*** SUMMARY ***
Total pot $0.06 | Rake $0
Board [Jh 6c Th]
Seat 1: jford9099 folded on the Flop
Seat 2: maarketeer (button) folded before Flop (didn't bet)
Seat 3: bigbluerodeo (small blind) folded on the Flop
Seat 4: Smuggler1991 (big blind) collected ($0.06)
Seat 6: PlayTheBlues4U folded before Flop (didn't bet)


*********** # 67 **************
PokerStars Hand #203588677227:  Hold'em No Limit ($0.01/$0.02 USD) - 2019/09/10 22:39:37 ET
Table 'Rana' 6-max Seat #5 is the button
Seat 1: delm44 ($1.76 in chips)
Seat 2: vgctmg ($1.43 in chips)
Seat 3: bigbluerodeo ($1.78 in chips)
Seat 4: Sparseeye ($1.49 in chips)
Seat 5: PlayTheBlues4U ($1.99 in chips)
Seat 6: DruMoney201 ($2.18 in chips)
DruMoney201: posts small blind $0.01
delm44: posts big blind $0.02
*** HOLE CARDS ***
Dealt to PlayTheBlues4U [Ac Ad]
vgctmg: calls $0.02
bigbluerodeo: folds
Sparseeye: folds
PlayTheBlues4U: raises $0.04 to $0.06
DruMoney201: folds
delm44: calls $0.04
vgctmg: raises $0.06 to $0.12
PlayTheBlues4U: calls $0.06
delm44: calls $0.06
*** FLOP *** [Qd 6c 3h]
delm44: checks
vgctmg: bets $0.18
PlayTheBlues4U: calls $0.18
delm44: folds
*** TURN *** [Qd 6c 3h] [4c]
vgctmg: bets $0.18
PlayTheBlues4U: raises $0.18 to $0.36
vgctmg: calls $0.18
*** RIVER *** [Qd 6c 3h 4c] [9s]
vgctmg: checks
PlayTheBlues4U: bets $1.33 and is all-in
vgctmg: folds
Uncalled bet ($1.33) returned to PlayTheBlues4U
PlayTheBlues4U collected $1.38 from pot
PlayTheBlues4U: doesn't show hand
*** SUMMARY ***
Total pot $1.45 | Rake $0.07
Board [Qd 6c 3h 4c 9s]
Seat 1: delm44 (big blind) folded on the Flop
Seat 2: vgctmg folded on the River
Seat 3: bigbluerodeo folded before Flop (didn't bet)
Seat 4: Sparseeye folded before Flop (didn't bet)
Seat 5: PlayTheBlues4U (button) collected ($1.38)
Seat 6: DruMoney201 (small blind) folded before Flop


*********** # 68 **************
PokerStars Hand #203588677061:  Hold'em No Limit ($0.01/$0.02 USD) - 2019/09/10 22:38:46 ET
Table 'Orion' 6-max Seat #1 is the button
Seat 1: jford9099 ($1.81 in chips)
Seat 2: maarketeer ($2.17 in chips)
Seat 3: bigbluerodeo ($2.66 in chips)
Seat 4: Smuggler1991 ($2.38 in chips)
Seat 6: PlayTheBlues4U ($1.98 in chips)
maarketeer: posts small blind $0.01
bigbluerodeo: posts big blind $0.02
*** HOLE CARDS ***
Dealt to PlayTheBlues4U [9c 6s]
Smuggler1991: folds
PlayTheBlues4U: folds
jford9099: calls $0.02
maarketeer: calls $0.01
bigbluerodeo: checks
*** FLOP *** [8c 9d 4s]
maarketeer: checks
bigbluerodeo: checks
jford9099: bets $0.06
maarketeer: folds
bigbluerodeo: folds
Uncalled bet ($0.06) returned to jford9099
jford9099 collected $0.06 from pot
jford9099: doesn't show hand
*** SUMMARY ***
Total pot $0.06 | Rake $0
Board [8c 9d 4s]
Seat 1: jford9099 (button) collected ($0.06)
Seat 2: maarketeer (small blind) folded on the Flop
Seat 3: bigbluerodeo (big blind) folded on the Flop
Seat 4: Smuggler1991 folded before Flop (didn't bet)
Seat 6: PlayTheBlues4U folded before Flop (didn't bet)


*********** # 69 **************
PokerStars Hand #203588677041:  Hold'em No Limit ($0.01/$0.02 USD) - 2019/09/10 22:38:40 ET
Table 'Rana' 6-max Seat #4 is the button
Seat 1: delm44 ($1.69 in chips)
Seat 2: vgctmg ($1.47 in chips)
Seat 3: bigbluerodeo ($1.78 in chips)
Seat 4: Sparseeye ($1.49 in chips)
Seat 5: PlayTheBlues4U ($1.75 in chips)
Seat 6: DruMoney201 ($2.20 in chips)
PlayTheBlues4U: posts small blind $0.01
DruMoney201: posts big blind $0.02
*** HOLE CARDS ***
Dealt to PlayTheBlues4U [2c Qd]
delm44: calls $0.02
vgctmg: calls $0.02
bigbluerodeo: folds
Sparseeye: folds
PlayTheBlues4U: folds
DruMoney201: checks
*** FLOP *** [Th 4c 6s]
DruMoney201: checks
delm44: checks
vgctmg: checks
*** TURN *** [Th 4c 6s] [Kd]
DruMoney201: checks
delm44: bets $0.02
vgctmg: calls $0.02
DruMoney201: folds
*** RIVER *** [Th 4c 6s Kd] [6h]
delm44: checks
vgctmg: checks
*** SHOW DOWN ***
delm44: shows [Js Jc] (two pair, Jacks and Sixes)
vgctmg: mucks hand
delm44 collected $0.11 from pot
*** SUMMARY ***
Total pot $0.11 | Rake $0
Board [Th 4c 6s Kd 6h]
Seat 1: delm44 showed [Js Jc] and won ($0.11) with two pair, Jacks and Sixes
Seat 2: vgctmg mucked [7c Tc]
Seat 3: bigbluerodeo folded before Flop (didn't bet)
Seat 4: Sparseeye (button) folded before Flop (didn't bet)
Seat 5: PlayTheBlues4U (small blind) folded before Flop
Seat 6: DruMoney201 (big blind) folded on the Turn


*********** # 70 **************
PokerStars Hand #203588676924:  Hold'em No Limit ($0.01/$0.02 USD) - 2019/09/10 22:37:59 ET
Table 'Rana' 6-max Seat #3 is the button
Seat 1: delm44 ($1.85 in chips)
Seat 2: vgctmg ($1.47 in chips)
Seat 3: bigbluerodeo ($1.78 in chips)
Seat 4: Sparseeye ($1.50 in chips)
Seat 5: PlayTheBlues4U ($1.59 in chips)
Seat 6: DruMoney201 ($2.20 in chips)
Sparseeye: posts small blind $0.01
PlayTheBlues4U: posts big blind $0.02
*** HOLE CARDS ***
Dealt to PlayTheBlues4U [Kc Jc]
DruMoney201: folds
delm44: calls $0.02
vgctmg: folds
bigbluerodeo: folds
Sparseeye: folds
PlayTheBlues4U: raises $0.04 to $0.06
delm44: calls $0.04
*** FLOP *** [Kh Jd Ad]
PlayTheBlues4U: bets $0.10
delm44: calls $0.10
*** TURN *** [Kh Jd Ad] [Qh]
PlayTheBlues4U: bets $0.16
delm44: folds
Uncalled bet ($0.16) returned to PlayTheBlues4U
PlayTheBlues4U collected $0.32 from pot
PlayTheBlues4U: doesn't show hand
*** SUMMARY ***
Total pot $0.33 | Rake $0.01
Board [Kh Jd Ad Qh]
Seat 1: delm44 folded on the Turn
Seat 2: vgctmg folded before Flop (didn't bet)
Seat 3: bigbluerodeo (button) folded before Flop (didn't bet)
Seat 4: Sparseeye (small blind) folded before Flop
Seat 5: PlayTheBlues4U (big blind) collected ($0.32)
Seat 6: DruMoney201 folded before Flop (didn't bet)


*********** # 71 **************
PokerStars Hand #203588676816:  Hold'em No Limit ($0.01/$0.02 USD) - 2019/09/10 22:37:30 ET
Table 'Orion' 6-max Seat #6 is the button
Seat 1: jford9099 ($1.96 in chips)
Seat 2: maarketeer ($2.19 in chips)
Seat 3: bigbluerodeo ($2.81 in chips)
Seat 4: Smuggler1991 ($2.08 in chips)
Seat 6: PlayTheBlues4U ($1.98 in chips)
jford9099: posts small blind $0.01
maarketeer: posts big blind $0.02
*** HOLE CARDS ***
Dealt to PlayTheBlues4U [Th 5d]
bigbluerodeo: calls $0.02
Smuggler1991: raises $0.07 to $0.09
PlayTheBlues4U: folds
jford9099: calls $0.08
maarketeer: folds
bigbluerodeo: calls $0.07
*** FLOP *** [Kh 6c 2s]
jford9099: checks
bigbluerodeo: checks
Smuggler1991: checks
*** TURN *** [Kh 6c 2s] [6h]
jford9099: bets $0.06
bigbluerodeo: calls $0.06
Smuggler1991: raises $0.22 to $0.28
jford9099: folds
bigbluerodeo: folds
Uncalled bet ($0.22) returned to Smuggler1991
Smuggler1991 collected $0.45 from pot
Smuggler1991: doesn't show hand
*** SUMMARY ***
Total pot $0.47 | Rake $0.02
Board [Kh 6c 2s 6h]
Seat 1: jford9099 (small blind) folded on the Turn
Seat 2: maarketeer (big blind) folded before Flop
Seat 3: bigbluerodeo folded on the Turn
Seat 4: Smuggler1991 collected ($0.45)
Seat 6: PlayTheBlues4U (button) folded before Flop (didn't bet)


*********** # 72 **************
PokerStars Hand #203588676794:  Hold'em No Limit ($0.01/$0.02 USD) - 2019/09/10 22:37:21 ET
Table 'Rana' 6-max Seat #2 is the button
Seat 1: delm44 ($1.85 in chips)
Seat 2: vgctmg ($1.43 in chips)
Seat 3: bigbluerodeo ($1.80 in chips)
Seat 4: Sparseeye ($1.52 in chips)
Seat 5: PlayTheBlues4U ($1.59 in chips)
Seat 6: DruMoney201 ($2.20 in chips)
bigbluerodeo: posts small blind $0.01
Sparseeye: posts big blind $0.02
*** HOLE CARDS ***
Dealt to PlayTheBlues4U [4h Qs]
PlayTheBlues4U: folds
DruMoney201: folds
delm44: folds
vgctmg: calls $0.02
bigbluerodeo: calls $0.01
Sparseeye: checks
*** FLOP *** [2s Qc 9h]
bigbluerodeo: checks
Sparseeye: checks
vgctmg: bets $0.02
bigbluerodeo: folds
Sparseeye: folds
Uncalled bet ($0.02) returned to vgctmg
vgctmg collected $0.06 from pot
vgctmg: doesn't show hand
*** SUMMARY ***
Total pot $0.06 | Rake $0
Board [2s Qc 9h]
Seat 1: delm44 folded before Flop (didn't bet)
Seat 2: vgctmg (button) collected ($0.06)
Seat 3: bigbluerodeo (small blind) folded on the Flop
Seat 4: Sparseeye (big blind) folded on the Flop
Seat 5: PlayTheBlues4U folded before Flop (didn't bet)
Seat 6: DruMoney201 folded before Flop (didn't bet)


*********** # 73 **************
PokerStars Hand #203588676728:  Hold'em No Limit ($0.01/$0.02 USD) - 2019/09/10 22:37:01 ET
Table 'Rana' 6-max Seat #1 is the button
Seat 1: delm44 ($1.85 in chips)
Seat 2: vgctmg ($1.44 in chips)
Seat 3: bigbluerodeo ($1.82 in chips)
Seat 4: Sparseeye ($1.52 in chips)
Seat 5: PlayTheBlues4U ($1.56 in chips)
Seat 6: DruMoney201 ($2.20 in chips)
vgctmg: posts small blind $0.01
bigbluerodeo: posts big blind $0.02
*** HOLE CARDS ***
Dealt to PlayTheBlues4U [Qd Ks]
Sparseeye: folds
PlayTheBlues4U: raises $0.04 to $0.06
DruMoney201: folds
delm44: folds
vgctmg: folds
bigbluerodeo: folds
Uncalled bet ($0.04) returned to PlayTheBlues4U
PlayTheBlues4U collected $0.05 from pot
PlayTheBlues4U: doesn't show hand
*** SUMMARY ***
Total pot $0.05 | Rake $0
Seat 1: delm44 (button) folded before Flop (didn't bet)
Seat 2: vgctmg (small blind) folded before Flop
Seat 3: bigbluerodeo (big blind) folded before Flop
Seat 4: Sparseeye folded before Flop (didn't bet)
Seat 5: PlayTheBlues4U collected ($0.05)
Seat 6: DruMoney201 folded before Flop (didn't bet)


*********** # 74 **************
PokerStars Hand #203588676617:  Hold'em No Limit ($0.01/$0.02 USD) - 2019/09/10 22:36:26 ET
Table 'Rana' 6-max Seat #6 is the button
Seat 1: delm44 ($1.87 in chips)
Seat 2: vgctmg ($1.42 in chips)
Seat 3: bigbluerodeo ($1.82 in chips)
Seat 5: PlayTheBlues4U ($1.56 in chips)
Seat 6: DruMoney201 ($2.20 in chips)
delm44: posts small blind $0.01
vgctmg: posts big blind $0.02
*** HOLE CARDS ***
Dealt to PlayTheBlues4U [4s Ad]
bigbluerodeo: folds
PlayTheBlues4U: folds
DruMoney201: folds
delm44: calls $0.01
vgctmg: checks
*** FLOP *** [4d Ah Ts]
delm44: checks
vgctmg: checks
*** TURN *** [4d Ah Ts] [5d]
delm44: checks
vgctmg: bets $0.02
delm44: folds
Uncalled bet ($0.02) returned to vgctmg
vgctmg collected $0.04 from pot
vgctmg: doesn't show hand
*** SUMMARY ***
Total pot $0.04 | Rake $0
Board [4d Ah Ts 5d]
Seat 1: delm44 (small blind) folded on the Turn
Seat 2: vgctmg (big blind) collected ($0.04)
Seat 3: bigbluerodeo folded before Flop (didn't bet)
Seat 5: PlayTheBlues4U folded before Flop (didn't bet)
Seat 6: DruMoney201 (button) folded before Flop (didn't bet)


*********** # 75 **************
PokerStars Hand #203588676596:  Hold'em No Limit ($0.01/$0.02 USD) - 2019/09/10 22:36:20 ET
Table 'Orion' 6-max Seat #4 is the button
Seat 1: jford9099 ($2 in chips)
Seat 2: maarketeer ($2.10 in chips)
Seat 3: bigbluerodeo ($2.85 in chips)
Seat 4: Smuggler1991 ($2.08 in chips)
Seat 6: PlayTheBlues4U ($1.60 in chips)
PlayTheBlues4U: posts small blind $0.01
jford9099: posts big blind $0.02
*** HOLE CARDS ***
Dealt to PlayTheBlues4U [9d 5h]
maarketeer: calls $0.02
bigbluerodeo: calls $0.02
Smuggler1991 is disconnected
Smuggler1991 is connected
Smuggler1991: folds
PlayTheBlues4U: calls $0.01
jford9099: checks
*** FLOP *** [Jh 6d Kh]
PlayTheBlues4U: checks
jford9099: bets $0.02
maarketeer: calls $0.02
bigbluerodeo: calls $0.02
PlayTheBlues4U: folds
*** TURN *** [Jh 6d Kh] [9c]
jford9099: checks
maarketeer: bets $0.12
bigbluerodeo: folds
jford9099: folds
Uncalled bet ($0.12) returned to maarketeer
maarketeer collected $0.13 from pot
maarketeer: doesn't show hand
*** SUMMARY ***
Total pot $0.14 | Rake $0.01
Board [Jh 6d Kh 9c]
Seat 1: jford9099 (big blind) folded on the Turn
Seat 2: maarketeer collected ($0.13)
Seat 3: bigbluerodeo folded on the Turn
Seat 4: Smuggler1991 (button) folded before Flop (didn't bet)
Seat 6: PlayTheBlues4U (small blind) folded on the Flop


*********** # 76 **************
PokerStars Hand #203588676527:  Hold'em No Limit ($0.01/$0.02 USD) - 2019/09/10 22:35:59 ET
Table 'Orion' 6-max Seat #3 is the button
Seat 1: jford9099 ($2.02 in chips)
Seat 2: maarketeer ($2 in chips)
Seat 3: bigbluerodeo ($2.91 in chips)
Seat 4: Smuggler1991 ($2.09 in chips)
Seat 6: PlayTheBlues4U ($1.62 in chips)
Smuggler1991: posts small blind $0.01
PlayTheBlues4U: posts big blind $0.02
maarketeer: posts big blind $0.02
*** HOLE CARDS ***
Dealt to PlayTheBlues4U [6h Kc]
jford9099: calls $0.02
maarketeer: raises $0.04 to $0.06
bigbluerodeo: calls $0.06
Smuggler1991: folds
PlayTheBlues4U: folds
jford9099: folds
*** FLOP *** [5h 2s 9c]
maarketeer: bets $0.08
bigbluerodeo: folds
Uncalled bet ($0.08) returned to maarketeer
maarketeer collected $0.16 from pot
maarketeer: doesn't show hand
*** SUMMARY ***
Total pot $0.17 | Rake $0.01
Board [5h 2s 9c]
Seat 1: jford9099 folded before Flop
Seat 2: maarketeer collected ($0.16)
Seat 3: bigbluerodeo (button) folded on the Flop
Seat 4: Smuggler1991 (small blind) folded before Flop
Seat 6: PlayTheBlues4U (big blind) folded before Flop


*********** # 77 **************
PokerStars Hand #203588676466:  Hold'em No Limit ($0.01/$0.02 USD) - 2019/09/10 22:35:38 ET
Table 'Rana' 6-max Seat #5 is the button
Seat 1: delm44 ($1.89 in chips)
Seat 2: vgctmg ($1.42 in chips)
Seat 3: bigbluerodeo ($1.88 in chips)
Seat 5: PlayTheBlues4U ($1.62 in chips)
Seat 6: DruMoney201 ($2.07 in chips)
DruMoney201: posts small blind $0.01
delm44: posts big blind $0.02
*** HOLE CARDS ***
Dealt to PlayTheBlues4U [Jd Qh]
vgctmg: folds
bigbluerodeo: calls $0.02
PlayTheBlues4U: raises $0.04 to $0.06
DruMoney201: calls $0.05
delm44: folds
bigbluerodeo: calls $0.04
*** FLOP *** [8d 3h 8h]
DruMoney201: checks
bigbluerodeo: checks
PlayTheBlues4U: checks
*** TURN *** [8d 3h 8h] [5d]
DruMoney201: bets $0.10
bigbluerodeo: folds
PlayTheBlues4U: folds
Uncalled bet ($0.10) returned to DruMoney201
DruMoney201 collected $0.19 from pot
DruMoney201: doesn't show hand
*** SUMMARY ***
Total pot $0.20 | Rake $0.01
Board [8d 3h 8h 5d]
Seat 1: delm44 (big blind) folded before Flop
Seat 2: vgctmg folded before Flop (didn't bet)
Seat 3: bigbluerodeo folded on the Turn
Seat 5: PlayTheBlues4U (button) folded on the Turn
Seat 6: DruMoney201 (small blind) collected ($0.19)


*********** # 78 **************
PokerStars Hand #203588676403:  Hold'em No Limit ($0.01/$0.02 USD) - 2019/09/10 22:35:15 ET
Table 'Orion' 6-max Seat #1 is the button
Seat 1: jford9099 ($2.02 in chips)
Seat 3: bigbluerodeo ($2.97 in chips)
Seat 4: Smuggler1991 ($2.04 in chips)
Seat 6: PlayTheBlues4U ($1.62 in chips)
maarketeer will be allowed to play after the button
bigbluerodeo: posts small blind $0.01
Smuggler1991: posts big blind $0.02
*** HOLE CARDS ***
Dealt to PlayTheBlues4U [4c 9s]
PlayTheBlues4U: folds
jford9099: folds
bigbluerodeo: calls $0.01
Smuggler1991: raises $0.04 to $0.06
bigbluerodeo: calls $0.04
*** FLOP *** [2d 4s Kc]
bigbluerodeo: checks
Smuggler1991: bets $0.06
bigbluerodeo: folds
Uncalled bet ($0.06) returned to Smuggler1991
Smuggler1991 collected $0.11 from pot
Smuggler1991: doesn't show hand
*** SUMMARY ***
Total pot $0.12 | Rake $0.01
Board [2d 4s Kc]
Seat 1: jford9099 (button) folded before Flop (didn't bet)
Seat 3: bigbluerodeo (small blind) folded on the Flop
Seat 4: Smuggler1991 (big blind) collected ($0.11)
Seat 6: PlayTheBlues4U folded before Flop (didn't bet)


*********** # 79 **************
PokerStars Hand #203588676220:  Hold'em No Limit ($0.01/$0.02 USD) - 2019/09/10 22:34:28 ET
Table 'Orion' 6-max Seat #6 is the button
Seat 1: jford9099 ($2.04 in chips)
Seat 3: bigbluerodeo ($2.99 in chips)
Seat 4: Smuggler1991 ($2 in chips)
Seat 6: PlayTheBlues4U ($1.62 in chips)
jford9099: posts small blind $0.01
bigbluerodeo: posts big blind $0.02
Smuggler1991: posts big blind $0.02
*** HOLE CARDS ***
Dealt to PlayTheBlues4U [Jc 5h]
Smuggler1991: checks
PlayTheBlues4U: folds
jford9099: calls $0.01
bigbluerodeo: checks
*** FLOP *** [Ad 2c 9h]
jford9099: checks
bigbluerodeo: checks
Smuggler1991: bets $0.02
jford9099: folds
maarketeer joins the table at seat #2
bigbluerodeo: folds
Uncalled bet ($0.02) returned to Smuggler1991
Smuggler1991 collected $0.06 from pot
Smuggler1991: doesn't show hand
*** SUMMARY ***
Total pot $0.06 | Rake $0
Board [Ad 2c 9h]
Seat 1: jford9099 (small blind) folded on the Flop
Seat 3: bigbluerodeo (big blind) folded on the Flop
Seat 4: Smuggler1991 collected ($0.06)
Seat 6: PlayTheBlues4U (button) folded before Flop (didn't bet)


*********** # 80 **************
PokerStars Hand #203588676159:  Hold'em No Limit ($0.01/$0.02 USD) - 2019/09/10 22:34:06 ET
Table 'Orion' 6-max Seat #3 is the button
Seat 1: jford9099 ($2.06 in chips)
Seat 3: bigbluerodeo ($2.99 in chips)
Seat 6: PlayTheBlues4U ($1.60 in chips)
PlayTheBlues4U: posts small blind $0.01
jford9099: posts big blind $0.02
*** HOLE CARDS ***
Dealt to PlayTheBlues4U [7c 9c]
bigbluerodeo: folds
Smuggler1991 joins the table at seat #4
PlayTheBlues4U: calls $0.01
jford9099: checks
*** FLOP *** [Qs 2h 2d]
PlayTheBlues4U: checks
jford9099: checks
*** TURN *** [Qs 2h 2d] [Ts]
PlayTheBlues4U: checks
jford9099: checks
*** RIVER *** [Qs 2h 2d Ts] [3s]
PlayTheBlues4U: checks
jford9099: checks
falkon28 leaves the table
*** SHOW DOWN ***
PlayTheBlues4U: shows [7c 9c] (a pair of Deuces)
jford9099: mucks hand
PlayTheBlues4U collected $0.04 from pot
*** SUMMARY ***
Total pot $0.04 | Rake $0
Board [Qs 2h 2d Ts 3s]
Seat 1: jford9099 (big blind) mucked [4d 6s]
Seat 3: bigbluerodeo (button) folded before Flop (didn't bet)
Seat 6: PlayTheBlues4U (small blind) showed [7c 9c] and won ($0.04) with a pair of Deuces


*********** # 81 **************
PokerStars Hand #203588675956:  Hold'em No Limit ($0.01/$0.02 USD) - 2019/09/10 22:33:04 ET
Table 'Rana' 6-max Seat #3 is the button
Seat 1: delm44 ($1.58 in chips)
Seat 2: vgctmg ($1.50 in chips)
Seat 3: bigbluerodeo ($1.88 in chips)
Seat 4: Sparseeye ($1.54 in chips)
Seat 5: PlayTheBlues4U ($1.84 in chips)
Seat 6: DruMoney201 ($2.09 in chips)
Sparseeye: posts small blind $0.01
PlayTheBlues4U: posts big blind $0.02
*** HOLE CARDS ***
Dealt to PlayTheBlues4U [Th Js]
DruMoney201: calls $0.02
delm44: calls $0.02
vgctmg: calls $0.02
bigbluerodeo: folds
Sparseeye: calls $0.01
PlayTheBlues4U: checks
*** FLOP *** [4c Jh 7c]
Sparseeye has timed out
Sparseeye: checks
PlayTheBlues4U: bets $0.06
DruMoney201: folds
delm44: calls $0.06
vgctmg: calls $0.06
vgctmg said, "omg"
Sparseeye has timed out
Sparseeye: folds
*** TURN *** [4c Jh 7c] [7d]
PlayTheBlues4U: bets $0.14
delm44: calls $0.14
vgctmg: folds
*** RIVER *** [4c Jh 7c 7d] [9h]
PlayTheBlues4U: checks
delm44: checks
*** SHOW DOWN ***
PlayTheBlues4U: shows [Th Js] (two pair, Jacks and Sevens)
delm44: shows [Kd Jd] (two pair, Jacks and Sevens - King kicker)
delm44 collected $0.53 from pot
*** SUMMARY ***
Total pot $0.56 | Rake $0.03
Board [4c Jh 7c 7d 9h]
Seat 1: delm44 showed [Kd Jd] and won ($0.53) with two pair, Jacks and Sevens
Seat 2: vgctmg folded on the Turn
Seat 3: bigbluerodeo (button) folded before Flop (didn't bet)
Seat 4: Sparseeye (small blind) folded on the Flop
Seat 5: PlayTheBlues4U (big blind) showed [Th Js] and lost with two pair, Jacks and Sevens
Seat 6: DruMoney201 folded on the Flop


*********** # 82 **************
PokerStars Hand #203588675914:  Hold'em No Limit ($0.01/$0.02 USD) - 2019/09/10 22:32:52 ET
Table 'Orion' 6-max Seat #2 is the button
Seat 1: jford9099 ($2.06 in chips)
Seat 2: falkon28 ($2.28 in chips)
Seat 3: bigbluerodeo ($3 in chips)
Seat 6: PlayTheBlues4U ($2 in chips)
bigbluerodeo: posts small blind $0.01
PlayTheBlues4U: posts big blind $0.02
*** HOLE CARDS ***
Dealt to PlayTheBlues4U [Qd 2h]
jford9099: folds
falkon28: raises $0.04 to $0.06
bigbluerodeo: folds
PlayTheBlues4U: calls $0.04
*** FLOP *** [9h 7d As]
PlayTheBlues4U: checks
falkon28: bets $0.04
PlayTheBlues4U: calls $0.04
*** TURN *** [9h 7d As] [4d]
PlayTheBlues4U: bets $0.12
falkon28: calls $0.12
*** RIVER *** [9h 7d As 4d] [Qc]
PlayTheBlues4U: checks
falkon28: bets $0.18
PlayTheBlues4U: calls $0.18
*** SHOW DOWN ***
falkon28: shows [Kd Ad] (a pair of Aces)
PlayTheBlues4U: mucks hand
falkon28 collected $0.77 from pot
*** SUMMARY ***
Total pot $0.81 | Rake $0.04
Board [9h 7d As 4d Qc]
Seat 1: jford9099 folded before Flop (didn't bet)
Seat 2: falkon28 (button) showed [Kd Ad] and won ($0.77) with a pair of Aces
Seat 3: bigbluerodeo (small blind) folded before Flop
Seat 6: PlayTheBlues4U (big blind) mucked [Qd 2h]


*********** # 83 **************
PokerStars Hand #203588675848:  Hold'em No Limit ($0.01/$0.02 USD) - 2019/09/10 22:32:32 ET
Table 'Orion' 6-max Seat #1 is the button
Seat 1: jford9099 ($2.08 in chips)
Seat 2: falkon28 ($2.29 in chips)
Seat 3: bigbluerodeo ($2.97 in chips)
Seat 6: PlayTheBlues4U ($2 in chips)
falkon28: posts small blind $0.01
bigbluerodeo: posts big blind $0.02
*** HOLE CARDS ***
Dealt to PlayTheBlues4U [Ks 6d]
PlayTheBlues4U: folds
jford9099: calls $0.02
falkon28: folds
bigbluerodeo: checks
*** FLOP *** [Jh Ts Kh]
bigbluerodeo: bets $0.05
jford9099: folds
Uncalled bet ($0.05) returned to bigbluerodeo
bigbluerodeo collected $0.05 from pot
bigbluerodeo: doesn't show hand
*** SUMMARY ***
Total pot $0.05 | Rake $0
Board [Jh Ts Kh]
Seat 1: jford9099 (button) folded on the Flop
Seat 2: falkon28 (small blind) folded before Flop
Seat 3: bigbluerodeo (big blind) collected ($0.05)
Seat 6: PlayTheBlues4U folded before Flop (didn't bet)


*********** # 84 **************
PokerStars Hand #203588675760:  Hold'em No Limit ($0.01/$0.02 USD) - 2019/09/10 22:32:03 ET
Table 'Orion' 6-max Seat #6 is the button
Seat 1: jford9099 ($2.10 in chips)
Seat 2: falkon28 ($2.25 in chips)
Seat 3: bigbluerodeo ($2.99 in chips)
Seat 6: PlayTheBlues4U ($2 in chips)
jford9099: posts small blind $0.01
falkon28: posts big blind $0.02
*** HOLE CARDS ***
Dealt to PlayTheBlues4U [Td 4s]
bigbluerodeo: calls $0.02
PlayTheBlues4U: folds
jford9099: calls $0.01
falkon28: raises $0.08 to $0.10
bigbluerodeo: folds
jford9099: folds
Uncalled bet ($0.08) returned to falkon28
falkon28 collected $0.06 from pot
falkon28: doesn't show hand
*** SUMMARY ***
Total pot $0.06 | Rake $0
Seat 1: jford9099 (small blind) folded before Flop
Seat 2: falkon28 (big blind) collected ($0.06)
Seat 3: bigbluerodeo folded before Flop
Seat 6: PlayTheBlues4U (button) folded before Flop (didn't bet)


*********** # 85 **************
PokerStars Hand #203588675739:  Hold'em No Limit ($0.01/$0.02 USD) - 2019/09/10 22:31:53 ET
Table 'Orion' 6-max Seat #3 is the button
Seat 1: jford9099 ($2.09 in chips)
Seat 2: falkon28 ($2.25 in chips)
Seat 3: bigbluerodeo ($2.99 in chips)
Seat 6: PlayTheBlues4U ($2.01 in chips)
PlayTheBlues4U: posts small blind $0.01
jford9099: posts big blind $0.02
*** HOLE CARDS ***
Dealt to PlayTheBlues4U [2c Jh]
falkon28: folds
bigbluerodeo: folds
PlayTheBlues4U: folds
Uncalled bet ($0.01) returned to jford9099
jford9099 collected $0.02 from pot
jford9099: doesn't show hand
*** SUMMARY ***
Total pot $0.02 | Rake $0
Seat 1: jford9099 (big blind) collected ($0.02)
Seat 2: falkon28 folded before Flop (didn't bet)
Seat 3: bigbluerodeo (button) folded before Flop (didn't bet)
Seat 6: PlayTheBlues4U (small blind) folded before Flop


*********** # 86 **************
PokerStars Hand #203588675671:  Hold'em No Limit ($0.01/$0.02 USD) - 2019/09/10 22:31:31 ET
Table 'Rana' 6-max Seat #2 is the button
Seat 1: delm44 ($1.60 in chips)
Seat 2: vgctmg ($1.52 in chips)
Seat 3: bigbluerodeo ($1.94 in chips)
Seat 4: Sparseeye ($1.60 in chips)
Seat 5: PlayTheBlues4U ($1.84 in chips)
Seat 6: DruMoney201 ($1.94 in chips)
bigbluerodeo: posts small blind $0.01
Sparseeye: posts big blind $0.02
*** HOLE CARDS ***
Dealt to PlayTheBlues4U [4d 3s]
PlayTheBlues4U: folds
DruMoney201: calls $0.02
delm44: calls $0.02
vgctmg: calls $0.02
bigbluerodeo: calls $0.01
Sparseeye: checks
*** FLOP *** [7s 5s 9s]
bigbluerodeo: checks
Sparseeye: checks
DruMoney201: checks
delm44: checks
vgctmg: checks
*** TURN *** [7s 5s 9s] [9d]
bigbluerodeo: checks
Sparseeye: checks
DruMoney201: bets $0.04
delm44: folds
vgctmg: folds
bigbluerodeo: calls $0.04
Sparseeye: calls $0.04
*** RIVER *** [7s 5s 9s 9d] [6h]
bigbluerodeo: checks
Sparseeye: checks
DruMoney201: bets $0.10
bigbluerodeo: folds
Sparseeye: folds
Uncalled bet ($0.10) returned to DruMoney201
DruMoney201 collected $0.21 from pot
DruMoney201: doesn't show hand
*** SUMMARY ***
Total pot $0.22 | Rake $0.01
Board [7s 5s 9s 9d 6h]
Seat 1: delm44 folded on the Turn
Seat 2: vgctmg (button) folded on the Turn
Seat 3: bigbluerodeo (small blind) folded on the River
Seat 4: Sparseeye (big blind) folded on the River
Seat 5: PlayTheBlues4U folded before Flop (didn't bet)
Seat 6: DruMoney201 collected ($0.21)


*********** # 87 **************
PokerStars Hand #203588675618:  Hold'em No Limit ($0.01/$0.02 USD) - 2019/09/10 22:31:15 ET
Table 'Orion' 6-max Seat #2 is the button
Seat 1: jford9099 ($2.11 in chips)
Seat 2: falkon28 ($2.25 in chips)
Seat 3: bigbluerodeo ($3.01 in chips)
Seat 6: PlayTheBlues4U ($1.97 in chips)
bigbluerodeo: posts small blind $0.01
PlayTheBlues4U: posts big blind $0.02
*** HOLE CARDS ***
Dealt to PlayTheBlues4U [9c Qh]
xxzuluzuluxx leaves the table
jford9099: calls $0.02
falkon28: folds
bigbluerodeo: calls $0.01
PlayTheBlues4U: checks
*** FLOP *** [8c 6c 2s]
bigbluerodeo: checks
PlayTheBlues4U: checks
jford9099: checks
*** TURN *** [8c 6c 2s] [Qd]
bigbluerodeo: checks
PlayTheBlues4U: bets $0.06
jford9099: folds
bigbluerodeo: folds
Uncalled bet ($0.06) returned to PlayTheBlues4U
PlayTheBlues4U collected $0.06 from pot
PlayTheBlues4U: doesn't show hand
*** SUMMARY ***
Total pot $0.06 | Rake $0
Board [8c 6c 2s Qd]
Seat 1: jford9099 folded on the Turn
Seat 2: falkon28 (button) folded before Flop (didn't bet)
Seat 3: bigbluerodeo (small blind) folded on the Turn
Seat 6: PlayTheBlues4U (big blind) collected ($0.06)


*********** # 88 **************
PokerStars Hand #203588675531:  Hold'em No Limit ($0.01/$0.02 USD) - 2019/09/10 22:30:45 ET
Table 'Orion' 6-max Seat #1 is the button
Seat 1: jford9099 ($2.11 in chips)
Seat 2: falkon28 ($2.26 in chips)
Seat 3: bigbluerodeo ($3.03 in chips)
Seat 5: xxzuluzuluxx ($6.58 in chips)
Seat 6: PlayTheBlues4U ($1.97 in chips)
falkon28: posts small blind $0.01
bigbluerodeo: posts big blind $0.02
*** HOLE CARDS ***
Dealt to PlayTheBlues4U [9s Kd]
xxzuluzuluxx: raises $0.05 to $0.07
PlayTheBlues4U: folds
jford9099: folds
falkon28: folds
bigbluerodeo: folds
Uncalled bet ($0.05) returned to xxzuluzuluxx
xxzuluzuluxx collected $0.05 from pot
xxzuluzuluxx: doesn't show hand
*** SUMMARY ***
Total pot $0.05 | Rake $0
Seat 1: jford9099 (button) folded before Flop (didn't bet)
Seat 2: falkon28 (small blind) folded before Flop
Seat 3: bigbluerodeo (big blind) folded before Flop
Seat 5: xxzuluzuluxx collected ($0.05)
Seat 6: PlayTheBlues4U folded before Flop (didn't bet)


*********** # 89 **************
PokerStars Hand #203588675489:  Hold'em No Limit ($0.01/$0.02 USD) - 2019/09/10 22:30:35 ET
Table 'Rana' 6-max Seat #1 is the button
Seat 1: delm44 ($1.60 in chips)
Seat 2: vgctmg ($1.47 in chips)
Seat 3: bigbluerodeo ($2 in chips)
Seat 5: PlayTheBlues4U ($1.84 in chips)
Seat 6: DruMoney201 ($1.94 in chips)
vgctmg: posts small blind $0.01
bigbluerodeo: posts big blind $0.02
*** HOLE CARDS ***
Dealt to PlayTheBlues4U [Th As]
Sparseeye joins the table at seat #4
PlayTheBlues4U: folds
DruMoney201: folds
delm44: folds
vgctmg: calls $0.01
bigbluerodeo: checks
*** FLOP *** [Ts 3d 7s]
vgctmg: checks
bigbluerodeo: checks
*** TURN *** [Ts 3d 7s] [2d]
vgctmg: bets $0.04
bigbluerodeo: calls $0.04
*** RIVER *** [Ts 3d 7s 2d] [Kd]
vgctmg: bets $0.08
bigbluerodeo: folds
Uncalled bet ($0.08) returned to vgctmg
vgctmg collected $0.11 from pot
vgctmg: doesn't show hand
*** SUMMARY ***
Total pot $0.12 | Rake $0.01
Board [Ts 3d 7s 2d Kd]
Seat 1: delm44 (button) folded before Flop (didn't bet)
Seat 2: vgctmg (small blind) collected ($0.11)
Seat 3: bigbluerodeo (big blind) folded on the River
Seat 5: PlayTheBlues4U folded before Flop (didn't bet)
Seat 6: DruMoney201 folded before Flop (didn't bet)


*********** # 90 **************
PokerStars Hand #203588675415:  Hold'em No Limit ($0.01/$0.02 USD) - 2019/09/10 22:30:10 ET
Table 'Orion' 6-max Seat #6 is the button
Seat 1: jford9099 ($2.04 in chips)
Seat 2: falkon28 ($2.28 in chips)
Seat 3: bigbluerodeo ($3.09 in chips)
Seat 5: xxzuluzuluxx ($6.58 in chips)
Seat 6: PlayTheBlues4U ($1.97 in chips)
jford9099: posts small blind $0.01
falkon28: posts big blind $0.02
*** HOLE CARDS ***
Dealt to PlayTheBlues4U [2s 4d]
bigbluerodeo: calls $0.02
xxzuluzuluxx: folds
seags21 leaves the table
PlayTheBlues4U: folds
jford9099: raises $0.04 to $0.06
falkon28: folds
bigbluerodeo: calls $0.04
*** FLOP *** [Jd Qs 6s]
jford9099: bets $0.06
bigbluerodeo: folds
Uncalled bet ($0.06) returned to jford9099
jford9099 collected $0.13 from pot
jford9099: doesn't show hand
*** SUMMARY ***
Total pot $0.14 | Rake $0.01
Board [Jd Qs 6s]
Seat 1: jford9099 (small blind) collected ($0.13)
Seat 2: falkon28 (big blind) folded before Flop
Seat 3: bigbluerodeo folded on the Flop
Seat 5: xxzuluzuluxx folded before Flop (didn't bet)
Seat 6: PlayTheBlues4U (button) folded before Flop (didn't bet)


*********** # 91 **************
PokerStars Hand #203588675383:  Hold'em No Limit ($0.01/$0.02 USD) - 2019/09/10 22:30:00 ET
Table 'Rana' 6-max Seat #6 is the button
Seat 1: delm44 ($1.62 in chips)
Seat 2: vgctmg ($1.49 in chips)
Seat 3: ArtOfWar440 ($4.72 in chips)
Seat 4: seags21 ($2.42 in chips)
Seat 5: PlayTheBlues4U ($1.84 in chips)
Seat 6: DruMoney201 ($1.90 in chips)
delm44: posts small blind $0.01
vgctmg: posts big blind $0.02
*** HOLE CARDS ***
Dealt to PlayTheBlues4U [Kh 7c]
ArtOfWar440: folds
seags21: folds
PlayTheBlues4U: folds
DruMoney201: calls $0.02
delm44: calls $0.01
vgctmg: checks
*** FLOP *** [6h 8c 6s]
delm44: checks
vgctmg: checks
DruMoney201: checks
*** TURN *** [6h 8c 6s] [As]
ArtOfWar440 leaves the table
delm44: checks
seags21 leaves the table
vgctmg: checks
DruMoney201: bets $0.06
bigbluerodeo joins the table at seat #3
delm44: folds
vgctmg: folds
Uncalled bet ($0.06) returned to DruMoney201
DruMoney201 collected $0.06 from pot
DruMoney201: doesn't show hand
*** SUMMARY ***
Total pot $0.06 | Rake $0
Board [6h 8c 6s As]
Seat 1: delm44 (small blind) folded on the Turn
Seat 2: vgctmg (big blind) folded on the Turn
Seat 3: ArtOfWar440 folded before Flop (didn't bet)
Seat 4: seags21 folded before Flop (didn't bet)
Seat 5: PlayTheBlues4U folded before Flop (didn't bet)
Seat 6: DruMoney201 (button) collected ($0.06)


*********** # 92 **************
PokerStars Hand #203588675369:  Hold'em No Limit ($0.01/$0.02 USD) - 2019/09/10 22:29:56 ET
Table 'Orion' 6-max Seat #5 is the button
Seat 1: jford9099 ($2.03 in chips)
Seat 2: falkon28 ($2.28 in chips)
Seat 3: bigbluerodeo ($3.09 in chips)
Seat 5: xxzuluzuluxx ($6.58 in chips)
Seat 6: PlayTheBlues4U ($1.98 in chips)
PlayTheBlues4U: posts small blind $0.01
jford9099: posts big blind $0.02
*** HOLE CARDS ***
Dealt to PlayTheBlues4U [Kh 6d]
falkon28: folds
bigbluerodeo: folds
xxzuluzuluxx: folds
PlayTheBlues4U: folds
Uncalled bet ($0.01) returned to jford9099
jford9099 collected $0.02 from pot
jford9099: doesn't show hand
*** SUMMARY ***
Total pot $0.02 | Rake $0
Seat 1: jford9099 (big blind) collected ($0.02)
Seat 2: falkon28 folded before Flop (didn't bet)
Seat 3: bigbluerodeo folded before Flop (didn't bet)
Seat 5: xxzuluzuluxx (button) folded before Flop (didn't bet)
Seat 6: PlayTheBlues4U (small blind) folded before Flop


*********** # 93 **************
PokerStars Hand #203588675319:  Hold'em No Limit ($0.01/$0.02 USD) - 2019/09/10 22:29:41 ET
Table 'Orion' 6-max Seat #3 is the button
Seat 1: jford9099 ($2 in chips)
Seat 2: falkon28 ($2.28 in chips)
Seat 3: bigbluerodeo ($3.09 in chips)
Seat 5: xxzuluzuluxx ($6.59 in chips)
Seat 6: PlayTheBlues4U ($2 in chips)
xxzuluzuluxx: posts small blind $0.01
PlayTheBlues4U: posts big blind $0.02
jford9099: posts big blind $0.02
*** HOLE CARDS ***
Dealt to PlayTheBlues4U [Qc 3h]
jford9099: raises $0.08 to $0.10
falkon28: folds
bigbluerodeo: folds
xxzuluzuluxx: folds
PlayTheBlues4U: folds
Uncalled bet ($0.08) returned to jford9099
jford9099 collected $0.05 from pot
jford9099: doesn't show hand
*** SUMMARY ***
Total pot $0.05 | Rake $0
Seat 1: jford9099 collected ($0.05)
Seat 2: falkon28 folded before Flop (didn't bet)
Seat 3: bigbluerodeo (button) folded before Flop (didn't bet)
Seat 5: xxzuluzuluxx (small blind) folded before Flop
Seat 6: PlayTheBlues4U (big blind) folded before Flop


*********** # 94 **************
PokerStars Hand #203588675222:  Hold'em No Limit ($0.01/$0.02 USD) - 2019/09/10 22:29:15 ET
Table 'Rana' 6-max Seat #5 is the button
Seat 1: delm44 ($1.64 in chips)
Seat 2: vgctmg ($1.49 in chips)
Seat 3: ArtOfWar440 ($4.64 in chips)
Seat 4: seags21 ($2.42 in chips)
Seat 5: PlayTheBlues4U ($1.90 in chips)
Seat 6: DruMoney201 ($1.91 in chips)
DruMoney201: posts small blind $0.01
delm44: posts big blind $0.02
*** HOLE CARDS ***
Dealt to PlayTheBlues4U [Qd Jh]
vgctmg: folds
ArtOfWar440: raises $0.04 to $0.06
seags21: folds
PlayTheBlues4U: calls $0.06
DruMoney201: folds
delm44: folds
*** FLOP *** [Ac Td 8c]
ArtOfWar440: bets $0.11
PlayTheBlues4U: folds
Uncalled bet ($0.11) returned to ArtOfWar440
ArtOfWar440 collected $0.14 from pot
ArtOfWar440: doesn't show hand
*** SUMMARY ***
Total pot $0.15 | Rake $0.01
Board [Ac Td 8c]
Seat 1: delm44 (big blind) folded before Flop
Seat 2: vgctmg folded before Flop (didn't bet)
Seat 3: ArtOfWar440 collected ($0.14)
Seat 4: seags21 folded before Flop (didn't bet)
Seat 5: PlayTheBlues4U (button) folded on the Flop
Seat 6: DruMoney201 (small blind) folded before Flop


*********** # 95 **************
PokerStars Hand #203588675092:  Hold'em No Limit ($0.01/$0.02 USD) - 2019/09/10 22:28:28 ET
Table 'Rana' 6-max Seat #4 is the button
Seat 1: delm44 ($1.64 in chips)
Seat 2: vgctmg ($1.57 in chips)
Seat 3: ArtOfWar440 ($4.64 in chips)
Seat 4: seags21 ($2.42 in chips)
Seat 5: PlayTheBlues4U ($1.92 in chips)
Seat 6: DruMoney201 ($1.82 in chips)
PlayTheBlues4U: posts small blind $0.01
DruMoney201: posts big blind $0.02
*** HOLE CARDS ***
Dealt to PlayTheBlues4U [Qc Td]
delm44: folds
vgctmg: calls $0.02
ArtOfWar440: folds
seags21: folds
PlayTheBlues4U: calls $0.01
DruMoney201: checks
*** FLOP *** [7c 6h 4d]
PlayTheBlues4U: checks
DruMoney201: bets $0.06
vgctmg: calls $0.06
PlayTheBlues4U: folds
*** TURN *** [7c 6h 4d] [Jc]
DruMoney201: bets $0.08
vgctmg: folds
Uncalled bet ($0.08) returned to DruMoney201
DruMoney201 collected $0.17 from pot
DruMoney201: doesn't show hand
*** SUMMARY ***
Total pot $0.18 | Rake $0.01
Board [7c 6h 4d Jc]
Seat 1: delm44 folded before Flop (didn't bet)
Seat 2: vgctmg folded on the Turn
Seat 3: ArtOfWar440 folded before Flop (didn't bet)
Seat 4: seags21 (button) folded before Flop (didn't bet)
Seat 5: PlayTheBlues4U (small blind) folded on the Flop
Seat 6: DruMoney201 (big blind) collected ($0.17)


*********** # 96 **************
PokerStars Hand #203588674891:  Hold'em No Limit ($0.01/$0.02 USD) - 2019/09/10 22:27:18 ET
Table 'Rana' 6-max Seat #3 is the button
Seat 1: delm44 ($1.68 in chips)
Seat 2: vgctmg ($1.57 in chips)
Seat 3: ArtOfWar440 ($4.64 in chips)
Seat 4: seags21 ($2.43 in chips)
Seat 5: PlayTheBlues4U ($1.94 in chips)
Seat 6: DruMoney201 ($1.75 in chips)
seags21: posts small blind $0.01
PlayTheBlues4U: posts big blind $0.02
*** HOLE CARDS ***
Dealt to PlayTheBlues4U [4h 3h]
DruMoney201: calls $0.02
delm44: calls $0.02
vgctmg: folds
ArtOfWar440: folds
seags21: folds
PlayTheBlues4U: checks
*** FLOP *** [Ad 9s 7s]
PlayTheBlues4U: checks
DruMoney201: checks
delm44: bets $0.02
PlayTheBlues4U: folds
DruMoney201: calls $0.02
*** TURN *** [Ad 9s 7s] [Ts]
DruMoney201: checks
delm44: checks
*** RIVER *** [Ad 9s 7s Ts] [8d]
DruMoney201: bets $0.06
delm44: folds
Uncalled bet ($0.06) returned to DruMoney201
DruMoney201 collected $0.11 from pot
DruMoney201: doesn't show hand
*** SUMMARY ***
Total pot $0.11 | Rake $0
Board [Ad 9s 7s Ts 8d]
Seat 1: delm44 folded on the River
Seat 2: vgctmg folded before Flop (didn't bet)
Seat 3: ArtOfWar440 (button) folded before Flop (didn't bet)
Seat 4: seags21 (small blind) folded before Flop
Seat 5: PlayTheBlues4U (big blind) folded on the Flop
Seat 6: DruMoney201 collected ($0.11)


*********** # 97 **************
PokerStars Hand #203588674785:  Hold'em No Limit ($0.01/$0.02 USD) - 2019/09/10 22:26:46 ET
Table 'Rana' 6-max Seat #2 is the button
Seat 1: delm44 ($1.68 in chips)
Seat 2: vgctmg ($1.57 in chips)
Seat 3: ArtOfWar440 ($4.65 in chips)
Seat 4: seags21 ($2.45 in chips)
Seat 5: PlayTheBlues4U ($1.86 in chips)
Seat 6: DruMoney201 ($1.81 in chips)
ArtOfWar440: posts small blind $0.01
seags21: posts big blind $0.02
*** HOLE CARDS ***
Dealt to PlayTheBlues4U [Th Ts]
PlayTheBlues4U: raises $0.04 to $0.06
DruMoney201: calls $0.06
delm44: folds
vgctmg: folds
ArtOfWar440: folds
seags21: folds
*** FLOP *** [5s Qd Qc]
PlayTheBlues4U: bets $0.06
DruMoney201: folds
Uncalled bet ($0.06) returned to PlayTheBlues4U
PlayTheBlues4U collected $0.14 from pot
PlayTheBlues4U: doesn't show hand
*** SUMMARY ***
Total pot $0.15 | Rake $0.01
Board [5s Qd Qc]
Seat 1: delm44 folded before Flop (didn't bet)
Seat 2: vgctmg (button) folded before Flop (didn't bet)
Seat 3: ArtOfWar440 (small blind) folded before Flop
Seat 4: seags21 (big blind) folded before Flop
Seat 5: PlayTheBlues4U collected ($0.14)
Seat 6: DruMoney201 folded on the Flop


*********** # 98 **************
PokerStars Hand #203588674614:  Hold'em No Limit ($0.01/$0.02 USD) - 2019/09/10 22:25:55 ET
Table 'Rana' 6-max Seat #1 is the button
Seat 1: delm44 ($1.60 in chips)
Seat 2: vgctmg ($1.59 in chips)
Seat 3: ArtOfWar440 ($4.67 in chips)
Seat 4: seags21 ($2.45 in chips)
Seat 5: PlayTheBlues4U ($1.88 in chips)
Seat 6: DruMoney201 ($1.83 in chips)
vgctmg: posts small blind $0.01
ArtOfWar440: posts big blind $0.02
*** HOLE CARDS ***
Dealt to PlayTheBlues4U [3c 3h]
seags21: folds
PlayTheBlues4U: calls $0.02
DruMoney201: calls $0.02
delm44: calls $0.02
vgctmg: calls $0.01
ArtOfWar440: checks
*** FLOP *** [6s Ah 8d]
vgctmg: checks
ArtOfWar440: checks
PlayTheBlues4U: checks
DruMoney201: checks
delm44: bets $0.10
vgctmg: folds
ArtOfWar440: folds
PlayTheBlues4U: folds
DruMoney201: folds
Uncalled bet ($0.10) returned to delm44
delm44 collected $0.10 from pot
delm44: doesn't show hand
*** SUMMARY ***
Total pot $0.10 | Rake $0
Board [6s Ah 8d]
Seat 1: delm44 (button) collected ($0.10)
Seat 2: vgctmg (small blind) folded on the Flop
Seat 3: ArtOfWar440 (big blind) folded on the Flop
Seat 4: seags21 folded before Flop (didn't bet)
Seat 5: PlayTheBlues4U folded on the Flop
Seat 6: DruMoney201 folded on the Flop


*********** # 99 **************
PokerStars Hand #203588674425:  Hold'em No Limit ($0.01/$0.02 USD) - 2019/09/10 22:24:49 ET
Table 'Rana' 6-max Seat #6 is the button
Seat 1: delm44 ($1.61 in chips)
Seat 2: vgctmg ($1.68 in chips)
Seat 3: ArtOfWar440 ($4.67 in chips)
Seat 4: seags21 ($1.90 in chips)
Seat 5: PlayTheBlues4U ($2.38 in chips)
Seat 6: DruMoney201 ($1.83 in chips)
delm44: posts small blind $0.01
vgctmg: posts big blind $0.02
*** HOLE CARDS ***
Dealt to PlayTheBlues4U [6c 7c]
ArtOfWar440: folds
PlayTheBlues4U said, "srsly"
seags21: raises $0.07 to $0.09
PlayTheBlues4U: calls $0.09
DruMoney201: folds
delm44: folds
vgctmg: calls $0.07
*** FLOP *** [4c As 8c]
vgctmg: checks
seags21: bets $0.14
PlayTheBlues4U: calls $0.14
vgctmg: folds
*** TURN *** [4c As 8c] [4h]
seags21: bets $0.27
PlayTheBlues4U: calls $0.27
*** RIVER *** [4c As 8c 4h] [8s]
seags21: bets $0.50
PlayTheBlues4U: folds
Uncalled bet ($0.50) returned to seags21
seags21 collected $1.05 from pot
seags21: doesn't show hand
*** SUMMARY ***
Total pot $1.10 | Rake $0.05
Board [4c As 8c 4h 8s]
Seat 1: delm44 (small blind) folded before Flop
Seat 2: vgctmg (big blind) folded on the Flop
Seat 3: ArtOfWar440 folded before Flop (didn't bet)
Seat 4: seags21 collected ($1.05)
Seat 5: PlayTheBlues4U folded on the River
Seat 6: DruMoney201 (button) folded before Flop (didn't bet)


*********** # 100 **************
PokerStars Hand #203588674265:  Hold'em No Limit ($0.01/$0.02 USD) - 2019/09/10 22:23:57 ET
Table 'Rana' 6-max Seat #5 is the button
Seat 1: delm44 ($1.63 in chips)
Seat 2: vgctmg ($1.68 in chips)
Seat 3: ArtOfWar440 ($4.67 in chips)
Seat 4: seags21 ($1.90 in chips)
Seat 5: PlayTheBlues4U ($2.38 in chips)
Seat 6: DruMoney201 ($1.81 in chips)
DruMoney201: posts small blind $0.01
delm44: posts big blind $0.02
*** HOLE CARDS ***
Dealt to PlayTheBlues4U [5c 7h]
vgctmg: folds
ArtOfWar440: folds
seags21: folds
PlayTheBlues4U: folds
vgctmg said, "seriously"
DruMoney201: calls $0.01
delm44: checks
*** FLOP *** [Jh 8c Ac]
DruMoney201: checks
delm44: checks
*** TURN *** [Jh 8c Ac] [6h]
DruMoney201: bets $0.04
delm44: folds
Uncalled bet ($0.04) returned to DruMoney201
DruMoney201 collected $0.04 from pot
DruMoney201: doesn't show hand
*** SUMMARY ***
Total pot $0.04 | Rake $0
Board [Jh 8c Ac 6h]
Seat 1: delm44 (big blind) folded on the Turn
Seat 2: vgctmg folded before Flop (didn't bet)
Seat 3: ArtOfWar440 folded before Flop (didn't bet)
Seat 4: seags21 folded before Flop (didn't bet)
Seat 5: PlayTheBlues4U (button) folded before Flop (didn't bet)
Seat 6: DruMoney201 (small blind) collected ($0.04)


*********** # 101 **************
PokerStars Hand #203588674186:  Hold'em No Limit ($0.01/$0.02 USD) - 2019/09/10 22:23:25 ET
Table 'Rana' 6-max Seat #4 is the button
Seat 1: delm44 ($1.63 in chips)
Seat 2: vgctmg ($1.65 in chips)
Seat 3: ArtOfWar440 ($4.67 in chips)
Seat 4: seags21 ($1.90 in chips)
Seat 5: PlayTheBlues4U ($2.39 in chips)
Seat 6: DruMoney201 ($1.83 in chips)
PlayTheBlues4U: posts small blind $0.01
DruMoney201: posts big blind $0.02
*** HOLE CARDS ***
Dealt to PlayTheBlues4U [4s Jh]
delm44: folds
vgctmg: calls $0.02
ArtOfWar440: folds
seags21: folds
PlayTheBlues4U: folds
DruMoney201: checks
*** FLOP *** [Tc 5c Jd]
DruMoney201: checks
vgctmg: bets $0.06
DruMoney201: folds
Uncalled bet ($0.06) returned to vgctmg
vgctmg collected $0.05 from pot
vgctmg: doesn't show hand
*** SUMMARY ***
Total pot $0.05 | Rake $0
Board [Tc 5c Jd]
Seat 1: delm44 folded before Flop (didn't bet)
Seat 2: vgctmg collected ($0.05)
Seat 3: ArtOfWar440 folded before Flop (didn't bet)
Seat 4: seags21 (button) folded before Flop (didn't bet)
Seat 5: PlayTheBlues4U (small blind) folded before Flop
Seat 6: DruMoney201 (big blind) folded on the Flop


*********** # 102 **************
PokerStars Hand #203588674055:  Hold'em No Limit ($0.01/$0.02 USD) - 2019/09/10 22:22:38 ET
Table 'Rana' 6-max Seat #3 is the button
Seat 1: delm44 ($1.63 in chips)
Seat 2: vgctmg ($1.67 in chips)
Seat 3: ArtOfWar440 ($4.85 in chips)
Seat 4: seags21 ($1.91 in chips)
Seat 5: PlayTheBlues4U ($2.20 in chips)
Seat 6: DruMoney201 ($1.83 in chips)
seags21: posts small blind $0.01
PlayTheBlues4U: posts big blind $0.02
*** HOLE CARDS ***
Dealt to PlayTheBlues4U [4c Ad]
DruMoney201: folds
delm44: folds
vgctmg: calls $0.02
ArtOfWar440: raises $0.06 to $0.08
seags21: folds
PlayTheBlues4U: calls $0.06
vgctmg: folds
*** FLOP *** [4d 3h 6d]
PlayTheBlues4U: checks
ArtOfWar440: bets $0.10
PlayTheBlues4U: calls $0.10
*** TURN *** [4d 3h 6d] [Jd]
PlayTheBlues4U: checks
ArtOfWar440: checks
*** RIVER *** [4d 3h 6d Jd] [Kd]
PlayTheBlues4U: bets $0.36
ArtOfWar440: folds
Uncalled bet ($0.36) returned to PlayTheBlues4U
PlayTheBlues4U collected $0.37 from pot
PlayTheBlues4U: doesn't show hand
*** SUMMARY ***
Total pot $0.39 | Rake $0.02
Board [4d 3h 6d Jd Kd]
Seat 1: delm44 folded before Flop (didn't bet)
Seat 2: vgctmg folded before Flop
Seat 3: ArtOfWar440 (button) folded on the River
Seat 4: seags21 (small blind) folded before Flop
Seat 5: PlayTheBlues4U (big blind) collected ($0.37)
Seat 6: DruMoney201 folded before Flop (didn't bet)


*********** # 103 **************
PokerStars Hand #203588674009:  Hold'em No Limit ($0.01/$0.02 USD) - 2019/09/10 22:22:20 ET
Table 'Rana' 6-max Seat #2 is the button
Seat 1: delm44 ($1.63 in chips)
Seat 2: vgctmg ($1.67 in chips)
Seat 3: ArtOfWar440 ($4.83 in chips)
Seat 4: seags21 ($1.93 in chips)
Seat 5: PlayTheBlues4U ($2.20 in chips)
Seat 6: DruMoney201 ($1.83 in chips)
ArtOfWar440: posts small blind $0.01
seags21: posts big blind $0.02
*** HOLE CARDS ***
Dealt to PlayTheBlues4U [4s Td]
PlayTheBlues4U: folds
DruMoney201: folds
delm44: folds
vgctmg: folds
ArtOfWar440: raises $0.04 to $0.06
seags21: folds
Uncalled bet ($0.04) returned to ArtOfWar440
ArtOfWar440 collected $0.04 from pot
ArtOfWar440: doesn't show hand
*** SUMMARY ***
Total pot $0.04 | Rake $0
Seat 1: delm44 folded before Flop (didn't bet)
Seat 2: vgctmg (button) folded before Flop (didn't bet)
Seat 3: ArtOfWar440 (small blind) collected ($0.04)
Seat 4: seags21 (big blind) folded before Flop
Seat 5: PlayTheBlues4U folded before Flop (didn't bet)
Seat 6: DruMoney201 folded before Flop (didn't bet)


*********** # 104 **************
PokerStars Hand #203588673892:  Hold'em No Limit ($0.01/$0.02 USD) - 2019/09/10 22:21:39 ET
Table 'Rana' 6-max Seat #1 is the button
Seat 1: delm44 ($1.57 in chips)
Seat 2: vgctmg ($1.69 in chips)
Seat 3: ArtOfWar440 ($4.85 in chips)
Seat 4: seags21 ($1.93 in chips)
Seat 5: PlayTheBlues4U ($2.20 in chips)
Seat 6: DruMoney201 ($1.85 in chips)
vgctmg: posts small blind $0.01
ArtOfWar440: posts big blind $0.02
*** HOLE CARDS ***
Dealt to PlayTheBlues4U [8h 7h]
seags21: folds
PlayTheBlues4U: folds
DruMoney201: calls $0.02
delm44: calls $0.02
vgctmg: calls $0.01
ArtOfWar440: checks
*** FLOP *** [6c Ah 4d]
vgctmg: checks
ArtOfWar440: checks
DruMoney201: checks
delm44: bets $0.10
vgctmg: folds
ArtOfWar440: folds
DruMoney201: folds
Uncalled bet ($0.10) returned to delm44
delm44 collected $0.08 from pot
delm44: doesn't show hand
*** SUMMARY ***
Total pot $0.08 | Rake $0
Board [6c Ah 4d]
Seat 1: delm44 (button) collected ($0.08)
Seat 2: vgctmg (small blind) folded on the Flop
Seat 3: ArtOfWar440 (big blind) folded on the Flop
Seat 4: seags21 folded before Flop (didn't bet)
Seat 5: PlayTheBlues4U folded before Flop (didn't bet)
Seat 6: DruMoney201 folded on the Flop


*********** # 105 **************
PokerStars Hand #203588673790:  Hold'em No Limit ($0.01/$0.02 USD) - 2019/09/10 22:21:06 ET
Table 'Rana' 6-max Seat #6 is the button
Seat 1: delm44 ($1.58 in chips)
Seat 2: vgctmg ($1.71 in chips)
Seat 3: ArtOfWar440 ($4.91 in chips)
Seat 4: seags21 ($1.93 in chips)
Seat 5: PlayTheBlues4U ($2.11 in chips)
Seat 6: DruMoney201 ($1.85 in chips)
delm44: posts small blind $0.01
vgctmg: posts big blind $0.02
*** HOLE CARDS ***
Dealt to PlayTheBlues4U [Jd Jh]
ArtOfWar440: raises $0.04 to $0.06
seags21: folds
PlayTheBlues4U: raises $0.10 to $0.16
DruMoney201: folds
delm44: folds
vgctmg: folds
ArtOfWar440: folds
Uncalled bet ($0.10) returned to PlayTheBlues4U
PlayTheBlues4U collected $0.15 from pot
PlayTheBlues4U: doesn't show hand
*** SUMMARY ***
Total pot $0.15 | Rake $0
Seat 1: delm44 (small blind) folded before Flop
Seat 2: vgctmg (big blind) folded before Flop
Seat 3: ArtOfWar440 folded before Flop
Seat 4: seags21 folded before Flop (didn't bet)
Seat 5: PlayTheBlues4U collected ($0.15)
Seat 6: DruMoney201 (button) folded before Flop (didn't bet)


*********** # 106 **************
PokerStars Hand #203588673690:  Hold'em No Limit ($0.01/$0.02 USD) - 2019/09/10 22:20:32 ET
Table 'Rana' 6-max Seat #5 is the button
Seat 1: delm44 ($1.60 in chips)
Seat 2: vgctmg ($1.71 in chips)
Seat 3: ArtOfWar440 ($4.91 in chips)
Seat 4: seags21 ($1.90 in chips)
Seat 5: PlayTheBlues4U ($2.11 in chips)
Seat 6: DruMoney201 ($1.86 in chips)
DruMoney201: posts small blind $0.01
delm44: posts big blind $0.02
*** HOLE CARDS ***
Dealt to PlayTheBlues4U [Qc 3c]
vgctmg: folds
ArtOfWar440: folds
seags21: raises $0.06 to $0.08
PlayTheBlues4U: folds
DruMoney201: folds
delm44: folds
Uncalled bet ($0.06) returned to seags21
seags21 collected $0.05 from pot
seags21: doesn't show hand
*** SUMMARY ***
Total pot $0.05 | Rake $0
Seat 1: delm44 (big blind) folded before Flop
Seat 2: vgctmg folded before Flop (didn't bet)
Seat 3: ArtOfWar440 folded before Flop (didn't bet)
Seat 4: seags21 collected ($0.05)
Seat 5: PlayTheBlues4U (button) folded before Flop (didn't bet)
Seat 6: DruMoney201 (small blind) folded before Flop


*********** # 107 **************
PokerStars Hand #203588673552:  Hold'em No Limit ($0.01/$0.02 USD) - 2019/09/10 22:19:41 ET
Table 'Rana' 6-max Seat #4 is the button
Seat 2: vgctmg ($1.68 in chips)
Seat 3: ArtOfWar440 ($4.91 in chips)
Seat 4: seags21 ($1.90 in chips)
Seat 5: PlayTheBlues4U ($2.12 in chips)
Seat 6: DruMoney201 ($1.88 in chips)
PlayTheBlues4U: posts small blind $0.01
DruMoney201: posts big blind $0.02
delm44: sits out
*** HOLE CARDS ***
Dealt to PlayTheBlues4U [5d 3s]
vgctmg: calls $0.02
ArtOfWar440: folds
seags21: folds
PlayTheBlues4U: folds
DruMoney201: checks
*** FLOP *** [Kc Js Jh]
DruMoney201: checks
vgctmg: bets $0.04
DruMoney201: folds
Uncalled bet ($0.04) returned to vgctmg
vgctmg collected $0.05 from pot
vgctmg: doesn't show hand
*** SUMMARY ***
Total pot $0.05 | Rake $0
Board [Kc Js Jh]
Seat 2: vgctmg collected ($0.05)
Seat 3: ArtOfWar440 folded before Flop (didn't bet)
Seat 4: seags21 (button) folded before Flop (didn't bet)
Seat 5: PlayTheBlues4U (small blind) folded before Flop
Seat 6: DruMoney201 (big blind) folded on the Flop


*********** # 108 **************
PokerStars Hand #203588673386:  Hold'em No Limit ($0.01/$0.02 USD) - 2019/09/10 22:18:42 ET
Table 'Rana' 6-max Seat #3 is the button
Seat 2: vgctmg ($1.68 in chips)
Seat 3: ArtOfWar440 ($4.91 in chips)
Seat 4: seags21 ($2.03 in chips)
Seat 5: PlayTheBlues4U ($2 in chips)
Seat 6: DruMoney201 ($1.88 in chips)
seags21: posts small blind $0.01
PlayTheBlues4U: posts big blind $0.02
delm44: sits out
*** HOLE CARDS ***
Dealt to PlayTheBlues4U [Ts Js]
DruMoney201: folds
vgctmg: folds
ArtOfWar440: folds
seags21: raises $0.03 to $0.05
PlayTheBlues4U: calls $0.03
*** FLOP *** [6c 8d 9s]
seags21: bets $0.04
PlayTheBlues4U: calls $0.04
*** TURN *** [6c 8d 9s] [4c]
seags21: checks
PlayTheBlues4U: checks
*** RIVER *** [6c 8d 9s 4c] [Jh]
seags21: bets $0.04
PlayTheBlues4U: raises $0.10 to $0.14
seags21: folds
Uncalled bet ($0.10) returned to PlayTheBlues4U
PlayTheBlues4U collected $0.25 from pot
PlayTheBlues4U: doesn't show hand
*** SUMMARY ***
Total pot $0.26 | Rake $0.01
Board [6c 8d 9s 4c Jh]
Seat 2: vgctmg folded before Flop (didn't bet)
Seat 3: ArtOfWar440 (button) folded before Flop (didn't bet)
Seat 4: seags21 (small blind) folded on the River
Seat 5: PlayTheBlues4U (big blind) collected ($0.25)
Seat 6: DruMoney201 folded before Flop (didn't bet)


*********** # 109 **************
PokerStars Hand #203588673368:  Hold'em No Limit ($0.01/$0.02 USD) - 2019/09/10 22:18:36 ET
Table 'Fides' 6-max Seat #5 is the button
Seat 1: Sparseeye ($1.62 in chips)
Seat 5: PlayTheBlues4U ($2 in chips)
PlayTheBlues4U: posts small blind $0.01
Sparseeye: posts big blind $0.02
*** HOLE CARDS ***
Dealt to PlayTheBlues4U [3h 9s]
PlayTheBlues4U: folds
Uncalled bet ($0.01) returned to Sparseeye
Sparseeye collected $0.02 from pot
*** SUMMARY ***
Total pot $0.02 | Rake $0
Seat 1: Sparseeye (big blind) collected ($0.02)
Seat 5: PlayTheBlues4U (button) (small blind) folded before Flop


*********** # 110 **************
PokerStars Hand #203587647734:  Hold'em No Limit ($0.05/$0.10 USD) - 2019/09/10 21:08:21 ET
Table 'Corvus' 6-max Seat #5 is the button
Seat 1: nando_abarca ($10 in chips)
Seat 2: PlayTheBlues4U ($21.22 in chips)
Seat 3: 123tiger711a ($13.40 in chips)
Seat 4: jmc926 ($12.59 in chips)
Seat 5: F3ign ($16.17 in chips)
Seat 6: BigBlue ($9.86 in chips)
BigBlue: posts small blind $0.05
nando_abarca: posts big blind $0.10
*** HOLE CARDS ***
Dealt to PlayTheBlues4U [7s 7d]
PlayTheBlues4U: raises $0.10 to $0.20
123tiger711a: folds
jmc926: folds
F3ign: folds
BigBlue: folds
nando_abarca: calls $0.10
*** FLOP *** [Tc 4c 9s]
nando_abarca: checks
PlayTheBlues4U: checks
*** TURN *** [Tc 4c 9s] [Ah]
nando_abarca: bets $0.22
PlayTheBlues4U: folds
Uncalled bet ($0.22) returned to nando_abarca
nando_abarca collected $0.43 from pot
nando_abarca: doesn't show hand
*** SUMMARY ***
Total pot $0.45 | Rake $0.02
Board [Tc 4c 9s Ah]
Seat 1: nando_abarca (big blind) collected ($0.43)
Seat 2: PlayTheBlues4U folded on the Turn
Seat 3: 123tiger711a folded before Flop (didn't bet)
Seat 4: jmc926 folded before Flop (didn't bet)
Seat 5: F3ign (button) folded before Flop (didn't bet)
Seat 6: BigBlue (small blind) folded before Flop


*********** # 111 **************
PokerStars Hand #203587647648:  Hold'em No Limit ($0.05/$0.10 USD) - 2019/09/10 21:07:57 ET
Table 'Iphigenia' 6-max Seat #2 is the button
Seat 1: kid delaw731 ($8.77 in chips)
Seat 2: nando_abarca ($8.36 in chips)
Seat 3: Nessman355 ($5.81 in chips)
Seat 4: F3ign ($22.42 in chips)
Seat 5: PlayTheBlues4U ($14.59 in chips)
Seat 6: RNixon'sHead ($19.88 in chips)
Nessman355: posts small blind $0.05
F3ign: posts big blind $0.10
*** HOLE CARDS ***
Dealt to PlayTheBlues4U [6d 9s]
PlayTheBlues4U: folds
RNixon'sHead: raises $0.15 to $0.25
kid delaw731: folds
nando_abarca: folds
Nessman355: folds
F3ign: folds
Uncalled bet ($0.15) returned to RNixon'sHead
RNixon'sHead collected $0.25 from pot
RNixon'sHead: doesn't show hand
*** SUMMARY ***
Total pot $0.25 | Rake $0
Seat 1: kid delaw731 folded before Flop (didn't bet)
Seat 2: nando_abarca (button) folded before Flop (didn't bet)
Seat 3: Nessman355 (small blind) folded before Flop
Seat 4: F3ign (big blind) folded before Flop
Seat 5: PlayTheBlues4U folded before Flop (didn't bet)
Seat 6: RNixon'sHead collected ($0.25)


*********** # 112 **************
PokerStars Hand #203587647639:  Hold'em No Limit ($0.05/$0.10 USD) - 2019/09/10 21:07:54 ET
Table 'Corvus' 6-max Seat #4 is the button
Seat 1: nando_abarca ($10 in chips)
Seat 2: PlayTheBlues4U ($21.07 in chips)
Seat 3: 123tiger711a ($13.40 in chips)
Seat 4: jmc926 ($12.59 in chips)
Seat 5: F3ign ($16.22 in chips)
Seat 6: BigBlue ($9.96 in chips)
F3ign: posts small blind $0.05
BigBlue: posts big blind $0.10
*** HOLE CARDS ***
Dealt to PlayTheBlues4U [Ah Ad]
nando_abarca: folds
PlayTheBlues4U: raises $0.20 to $0.30
123tiger711a: folds
jmc926: folds
F3ign: folds
BigBlue: folds
Uncalled bet ($0.20) returned to PlayTheBlues4U
PlayTheBlues4U collected $0.25 from pot
PlayTheBlues4U: doesn't show hand
*** SUMMARY ***
Total pot $0.25 | Rake $0
Seat 1: nando_abarca folded before Flop (didn't bet)
Seat 2: PlayTheBlues4U collected ($0.25)
Seat 3: 123tiger711a folded before Flop (didn't bet)
Seat 4: jmc926 (button) folded before Flop (didn't bet)
Seat 5: F3ign (small blind) folded before Flop
Seat 6: BigBlue (big blind) folded before Flop


*********** # 113 **************
PokerStars Hand #203587647559:  Hold'em No Limit ($0.05/$0.10 USD) - 2019/09/10 21:07:28 ET
Table 'Corvus' 6-max Seat #3 is the button
Seat 1: nando_abarca ($6.58 in chips)
Seat 2: PlayTheBlues4U ($21.07 in chips)
Seat 3: 123tiger711a ($13.25 in chips)
Seat 4: jmc926 ($12.64 in chips)
Seat 5: F3ign ($16.32 in chips)
Seat 6: BigBlue ($9.96 in chips)
jmc926: posts small blind $0.05
F3ign: posts big blind $0.10
*** HOLE CARDS ***
Dealt to PlayTheBlues4U [2d Ts]
BigBlue: folds
nando_abarca: folds
PlayTheBlues4U: folds
123tiger711a: raises $0.40 to $0.50
jmc926: folds
F3ign: folds
Uncalled bet ($0.40) returned to 123tiger711a
123tiger711a collected $0.25 from pot
*** SUMMARY ***
Total pot $0.25 | Rake $0
Seat 1: nando_abarca folded before Flop (didn't bet)
Seat 2: PlayTheBlues4U folded before Flop (didn't bet)
Seat 3: 123tiger711a (button) collected ($0.25)
Seat 4: jmc926 (small blind) folded before Flop
Seat 5: F3ign (big blind) folded before Flop
Seat 6: BigBlue folded before Flop (didn't bet)


*********** # 114 **************
PokerStars Hand #203587647532:  Hold'em No Limit ($0.05/$0.10 USD) - 2019/09/10 21:07:21 ET
Table 'Iphigenia' 6-max Seat #1 is the button
Seat 1: kid delaw731 ($8.77 in chips)
Seat 2: nando_abarca ($8.41 in chips)
Seat 3: Nessman355 ($7.45 in chips)
Seat 4: F3ign ($22.42 in chips)
Seat 5: PlayTheBlues4U ($14.59 in chips)
Seat 6: RNixon'sHead ($18.36 in chips)
nando_abarca: posts small blind $0.05
Nessman355: posts big blind $0.10
*** HOLE CARDS ***
Dealt to PlayTheBlues4U [5h Qs]
F3ign: folds
PlayTheBlues4U: folds
RNixon'sHead: raises $0.15 to $0.25
kid delaw731: folds
nando_abarca: folds
Nessman355: calls $0.15
*** FLOP *** [Ad 4s 6c]
Nessman355: checks
RNixon'sHead: checks
*** TURN *** [Ad 4s 6c] [Jc]
Nessman355: checks
RNixon'sHead: bets $0.40
Nessman355: calls $0.40
*** RIVER *** [Ad 4s 6c Jc] [2h]
Nessman355: checks
RNixon'sHead: bets $0.99
Nessman355: calls $0.99
*** SHOW DOWN ***
RNixon'sHead: shows [8h Ac] (a pair of Aces)
Nessman355: mucks hand
RNixon'sHead collected $3.16 from pot
*** SUMMARY ***
Total pot $3.33 | Rake $0.17
Board [Ad 4s 6c Jc 2h]
Seat 1: kid delaw731 (button) folded before Flop (didn't bet)
Seat 2: nando_abarca (small blind) folded before Flop
Seat 3: Nessman355 (big blind) mucked [Jh 3h]
Seat 4: F3ign folded before Flop (didn't bet)
Seat 5: PlayTheBlues4U folded before Flop (didn't bet)
Seat 6: RNixon'sHead showed [8h Ac] and won ($3.16) with a pair of Aces


*********** # 115 **************
PokerStars Hand #203587647467:  Hold'em No Limit ($0.05/$0.10 USD) - 2019/09/10 21:07:01 ET
Table 'Corvus' 6-max Seat #2 is the button
Seat 1: nando_abarca ($6.58 in chips)
Seat 2: PlayTheBlues4U ($21.07 in chips)
Seat 3: 123tiger711a ($13.55 in chips)
Seat 4: jmc926 ($12.37 in chips)
Seat 5: F3ign ($16.32 in chips)
Seat 6: BigBlue ($9.96 in chips)
123tiger711a: posts small blind $0.05
jmc926: posts big blind $0.10
*** HOLE CARDS ***
Dealt to PlayTheBlues4U [8h 2d]
F3ign: folds
BigBlue: folds
nando_abarca: folds
PlayTheBlues4U: folds
123tiger711a: calls $0.05
jmc926: raises $0.20 to $0.30
123tiger711a: calls $0.20
*** FLOP *** [Ts Th Qc]
123tiger711a: checks
jmc926: bets $0.29
123tiger711a: folds
Uncalled bet ($0.29) returned to jmc926
jmc926 collected $0.57 from pot
*** SUMMARY ***
Total pot $0.60 | Rake $0.03
Board [Ts Th Qc]
Seat 1: nando_abarca folded before Flop (didn't bet)
Seat 2: PlayTheBlues4U (button) folded before Flop (didn't bet)
Seat 3: 123tiger711a (small blind) folded on the Flop
Seat 4: jmc926 (big blind) collected ($0.57)
Seat 5: F3ign folded before Flop (didn't bet)
Seat 6: BigBlue folded before Flop (didn't bet)


*********** # 116 **************
PokerStars Hand #203587647335:  Hold'em No Limit ($0.05/$0.10 USD) - 2019/09/10 21:06:16 ET
Table 'Iphigenia' 6-max Seat #6 is the button
Seat 1: kid delaw731 ($8.82 in chips)
Seat 2: nando_abarca ($8 in chips)
Seat 3: Nessman355 ($7.85 in chips)
Seat 4: F3ign ($22.42 in chips)
Seat 5: PlayTheBlues4U ($14.59 in chips)
Seat 6: RNixon'sHead ($18.36 in chips)
kid delaw731: posts small blind $0.05
nando_abarca: posts big blind $0.10
*** HOLE CARDS ***
Dealt to PlayTheBlues4U [5c Qc]
Nessman355: calls $0.10
F3ign: folds
PlayTheBlues4U: folds
RNixon'sHead: folds
kid delaw731: folds
nando_abarca: checks
*** FLOP *** [4c 3h 5s]
nando_abarca: checks
Nessman355: bets $0.30
nando_abarca: calls $0.30
*** TURN *** [4c 3h 5s] [Ad]
nando_abarca: checks
Nessman355: checks
*** RIVER *** [4c 3h 5s Ad] [Ah]
nando_abarca: bets $0.41
Nessman355: folds
Uncalled bet ($0.41) returned to nando_abarca
nando_abarca collected $0.81 from pot
nando_abarca: doesn't show hand
*** SUMMARY ***
Total pot $0.85 | Rake $0.04
Board [4c 3h 5s Ad Ah]
Seat 1: kid delaw731 (small blind) folded before Flop
Seat 2: nando_abarca (big blind) collected ($0.81)
Seat 3: Nessman355 folded on the River
Seat 4: F3ign folded before Flop (didn't bet)
Seat 5: PlayTheBlues4U folded before Flop (didn't bet)
Seat 6: RNixon'sHead (button) folded before Flop (didn't bet)


*********** # 117 **************
PokerStars Hand #203587647188:  Hold'em No Limit ($0.05/$0.10 USD) - 2019/09/10 21:05:26 ET
Table 'Iphigenia' 6-max Seat #5 is the button
Seat 1: kid delaw731 ($8.92 in chips)
Seat 2: nando_abarca ($8 in chips)
Seat 3: Nessman355 ($7.85 in chips)
Seat 4: F3ign ($22.01 in chips)
Seat 5: PlayTheBlues4U ($14.89 in chips)
Seat 6: RNixon'sHead ($18.41 in chips)
RNixon'sHead: posts small blind $0.05
kid delaw731: posts big blind $0.10
*** HOLE CARDS ***
Dealt to PlayTheBlues4U [Qh Th]
nando_abarca: folds
Nessman355: folds
F3ign: raises $0.20 to $0.30
PlayTheBlues4U: calls $0.30
RNixon'sHead: folds
kid delaw731: folds
*** FLOP *** [5d Kd 5s]
F3ign: bets $0.36
PlayTheBlues4U: folds
Uncalled bet ($0.36) returned to F3ign
F3ign collected $0.71 from pot
F3ign: doesn't show hand
*** SUMMARY ***
Total pot $0.75 | Rake $0.04
Board [5d Kd 5s]
Seat 1: kid delaw731 (big blind) folded before Flop
Seat 2: nando_abarca folded before Flop (didn't bet)
Seat 3: Nessman355 folded before Flop (didn't bet)
Seat 4: F3ign collected ($0.71)
Seat 5: PlayTheBlues4U (button) folded on the Flop
Seat 6: RNixon'sHead (small blind) folded before Flop


*********** # 118 **************
PokerStars Hand #203587647156:  Hold'em No Limit ($0.05/$0.10 USD) - 2019/09/10 21:05:14 ET
Table 'Corvus' 6-max Seat #1 is the button
Seat 1: nando_abarca ($8.63 in chips)
Seat 2: PlayTheBlues4U ($21.12 in chips)
Seat 3: 123tiger711a ($13.65 in chips)
Seat 4: jmc926 ($10.38 in chips)
Seat 5: F3ign ($16.32 in chips)
Seat 6: BigBlue ($9.96 in chips)
PlayTheBlues4U: posts small blind $0.05
123tiger711a: posts big blind $0.10
*** HOLE CARDS ***
Dealt to PlayTheBlues4U [7s 8h]
jmc926: calls $0.10
F3ign has timed out
F3ign: folds
BigBlue: folds
nando_abarca: raises $0.35 to $0.45
PlayTheBlues4U: folds
123tiger711a: folds
jmc926: calls $0.35
*** FLOP *** [6c 8s Js]
jmc926: checks
nando_abarca: checks
*** TURN *** [6c 8s Js] [Td]
jmc926: checks
nando_abarca: bets $0.60
jmc926: calls $0.60
*** RIVER *** [6c 8s Js Td] [4h]
jmc926: checks
nando_abarca: bets $1
jmc926: calls $1
*** SHOW DOWN ***
nando_abarca: shows [Qd Kc] (high card King)
jmc926: shows [4s 4d] (three of a kind, Fours)
jmc926 collected $4.04 from pot
*** SUMMARY ***
Total pot $4.25 | Rake $0.21
Board [6c 8s Js Td 4h]
Seat 1: nando_abarca (button) showed [Qd Kc] and lost with high card King
Seat 2: PlayTheBlues4U (small blind) folded before Flop
Seat 3: 123tiger711a (big blind) folded before Flop
Seat 4: jmc926 showed [4s 4d] and won ($4.04) with three of a kind, Fours
Seat 5: F3ign folded before Flop (didn't bet)
Seat 6: BigBlue folded before Flop (didn't bet)


*********** # 119 **************
PokerStars Hand #203587647073:  Hold'em No Limit ($0.05/$0.10 USD) - 2019/09/10 21:04:49 ET
Table 'Iphigenia' 6-max Seat #4 is the button
Seat 2: nando_abarca ($8 in chips)
Seat 3: Nessman355 ($7.85 in chips)
Seat 4: F3ign ($22.01 in chips)
Seat 5: PlayTheBlues4U ($14.23 in chips)
Seat 6: RNixon'sHead ($19.14 in chips)
PlayTheBlues4U: posts small blind $0.05
RNixon'sHead: posts big blind $0.10
kid delaw731: sits out
*** HOLE CARDS ***
Dealt to PlayTheBlues4U [Qd Jh]
nando_abarca: folds
Nessman355: folds
F3ign: folds
PlayTheBlues4U: calls $0.05
RNixon'sHead: raises $0.30 to $0.40
PlayTheBlues4U: calls $0.30
*** FLOP *** [4d 6h 9s]
PlayTheBlues4U: checks
RNixon'sHead: bets $0.33
PlayTheBlues4U: calls $0.33
*** TURN *** [4d 6h 9s] [5c]
PlayTheBlues4U: checks
RNixon'sHead: checks
*** RIVER *** [4d 6h 9s 5c] [8d]
PlayTheBlues4U: bets $1
RNixon'sHead: folds
Uncalled bet ($1) returned to PlayTheBlues4U
PlayTheBlues4U collected $1.39 from pot
PlayTheBlues4U: doesn't show hand
*** SUMMARY ***
Total pot $1.46 | Rake $0.07
Board [4d 6h 9s 5c 8d]
Seat 2: nando_abarca folded before Flop (didn't bet)
Seat 3: Nessman355 folded before Flop (didn't bet)
Seat 4: F3ign (button) folded before Flop (didn't bet)
Seat 5: PlayTheBlues4U (small blind) collected ($1.39)
Seat 6: RNixon'sHead (big blind) folded on the River


*********** # 120 **************
PokerStars Hand #203587647047:  Hold'em No Limit ($0.05/$0.10 USD) - 2019/09/10 21:04:42 ET
Table 'Iphigenia' 6-max Seat #3 is the button
Seat 2: nando_abarca ($8 in chips)
Seat 3: Nessman355 ($7.85 in chips)
Seat 4: F3ign ($22.06 in chips)
Seat 5: PlayTheBlues4U ($14.18 in chips)
Seat 6: RNixon'sHead ($19.14 in chips)
F3ign: posts small blind $0.05
PlayTheBlues4U: posts big blind $0.10
kid delaw731: sits out
*** HOLE CARDS ***
Dealt to PlayTheBlues4U [7d 2h]
RNixon'sHead: folds
nando_abarca: folds
Nessman355: folds
F3ign: folds
Uncalled bet ($0.05) returned to PlayTheBlues4U
PlayTheBlues4U collected $0.10 from pot
PlayTheBlues4U: doesn't show hand
*** SUMMARY ***
Total pot $0.10 | Rake $0
Seat 2: nando_abarca folded before Flop (didn't bet)
Seat 3: Nessman355 (button) folded before Flop (didn't bet)
Seat 4: F3ign (small blind) folded before Flop
Seat 5: PlayTheBlues4U (big blind) collected ($0.10)
Seat 6: RNixon'sHead folded before Flop (didn't bet)


*********** # 121 **************
PokerStars Hand #203587647040:  Hold'em No Limit ($0.05/$0.10 USD) - 2019/09/10 21:04:40 ET
Table 'Corvus' 6-max Seat #6 is the button
Seat 1: nando_abarca ($8.68 in chips)
Seat 2: PlayTheBlues4U ($21.22 in chips)
Seat 3: 123tiger711a ($14.35 in chips)
Seat 4: jmc926 ($10.38 in chips)
Seat 5: F3ign ($16.32 in chips)
Seat 6: BigBlue ($9.19 in chips)
nando_abarca: posts small blind $0.05
PlayTheBlues4U: posts big blind $0.10
*** HOLE CARDS ***
Dealt to PlayTheBlues4U [4s Td]
123tiger711a: calls $0.10
jmc926: folds
F3ign: folds
BigBlue: raises $0.20 to $0.30
nando_abarca: folds
PlayTheBlues4U: folds
123tiger711a: calls $0.20
*** FLOP *** [9d 3s 8h]
123tiger711a: checks
BigBlue: checks
*** TURN *** [9d 3s 8h] [3c]
123tiger711a: checks
BigBlue: checks
*** RIVER *** [9d 3s 8h 3c] [7d]
123tiger711a: checks
BigBlue: bets $0.40
123tiger711a: calls $0.40
*** SHOW DOWN ***
BigBlue: shows [7h Ad] (two pair, Sevens and Threes)
123tiger711a: mucks hand
BigBlue collected $1.47 from pot
*** SUMMARY ***
Total pot $1.55 | Rake $0.08
Board [9d 3s 8h 3c 7d]
Seat 1: nando_abarca (small blind) folded before Flop
Seat 2: PlayTheBlues4U (big blind) folded before Flop
Seat 3: 123tiger711a mucked [Kd 5d]
Seat 4: jmc926 folded before Flop (didn't bet)
Seat 5: F3ign folded before Flop (didn't bet)
Seat 6: BigBlue (button) showed [7h Ad] and won ($1.47) with two pair, Sevens and Threes


*********** # 122 **************
PokerStars Hand #203587646988:  Hold'em No Limit ($0.05/$0.10 USD) - 2019/09/10 21:04:25 ET
Table 'Iphigenia' 6-max Seat #2 is the button
Seat 2: nando_abarca ($8 in chips)
Seat 3: Nessman355 ($7.90 in chips)
Seat 4: F3ign ($22.16 in chips)
Seat 5: PlayTheBlues4U ($14.18 in chips)
Seat 6: RNixon'sHead ($18.99 in chips)
Nessman355: posts small blind $0.05
F3ign: posts big blind $0.10
kid delaw731: sits out
*** HOLE CARDS ***
Dealt to PlayTheBlues4U [4s 9s]
PlayTheBlues4U: folds
RNixon'sHead: raises $0.15 to $0.25
nando_abarca: folds
Nessman355: folds
F3ign: folds
Uncalled bet ($0.15) returned to RNixon'sHead
RNixon'sHead collected $0.25 from pot
RNixon'sHead: doesn't show hand
*** SUMMARY ***
Total pot $0.25 | Rake $0
Seat 2: nando_abarca (button) folded before Flop (didn't bet)
Seat 3: Nessman355 (small blind) folded before Flop
Seat 4: F3ign (big blind) folded before Flop
Seat 5: PlayTheBlues4U folded before Flop (didn't bet)
Seat 6: RNixon'sHead collected ($0.25)


*********** # 123 **************
PokerStars Hand #203587646968:  Hold'em No Limit ($0.05/$0.10 USD) - 2019/09/10 21:04:19 ET
Table 'Corvus' 6-max Seat #5 is the button
Seat 1: nando_abarca ($8.78 in chips)
Seat 2: PlayTheBlues4U ($21.22 in chips)
Seat 3: 123tiger711a ($14.35 in chips)
Seat 4: jmc926 ($10.23 in chips)
Seat 5: F3ign ($16.32 in chips)
Seat 6: BigBlue ($9.24 in chips)
BigBlue: posts small blind $0.05
nando_abarca: posts big blind $0.10
*** HOLE CARDS ***
Dealt to PlayTheBlues4U [Td 3s]
PlayTheBlues4U: folds
123tiger711a: folds
jmc926: raises $0.20 to $0.30
F3ign: folds
BigBlue: folds
nando_abarca: folds
Uncalled bet ($0.20) returned to jmc926
jmc926 collected $0.25 from pot
*** SUMMARY ***
Total pot $0.25 | Rake $0
Seat 1: nando_abarca (big blind) folded before Flop
Seat 2: PlayTheBlues4U folded before Flop (didn't bet)
Seat 3: 123tiger711a folded before Flop (didn't bet)
Seat 4: jmc926 collected ($0.25)
Seat 5: F3ign (button) folded before Flop (didn't bet)
Seat 6: BigBlue (small blind) folded before Flop


*********** # 124 **************
PokerStars Hand #203587646887:  Hold'em No Limit ($0.05/$0.10 USD) - 2019/09/10 21:03:54 ET
Table 'Iphigenia' 6-max Seat #6 is the button
Seat 2: nando_abarca ($8.05 in chips)
Seat 3: Nessman355 ($8 in chips)
Seat 4: F3ign ($22.16 in chips)
Seat 5: PlayTheBlues4U ($14.18 in chips)
Seat 6: RNixon'sHead ($18.84 in chips)
kid delaw731 will be allowed to play after the button
nando_abarca: posts small blind $0.05
Nessman355: posts big blind $0.10
*** HOLE CARDS ***
Dealt to PlayTheBlues4U [4s Kc]
F3ign: folds
PlayTheBlues4U: folds
RNixon'sHead: raises $0.15 to $0.25
nando_abarca: folds
Nessman355: folds
Uncalled bet ($0.15) returned to RNixon'sHead
RNixon'sHead collected $0.25 from pot
RNixon'sHead: doesn't show hand
*** SUMMARY ***
Total pot $0.25 | Rake $0
Seat 2: nando_abarca (small blind) folded before Flop
Seat 3: Nessman355 (big blind) folded before Flop
Seat 4: F3ign folded before Flop (didn't bet)
Seat 5: PlayTheBlues4U folded before Flop (didn't bet)
Seat 6: RNixon'sHead (button) collected ($0.25)


*********** # 125 **************
PokerStars Hand #203587646616:  Hold'em No Limit ($0.05/$0.10 USD) - 2019/09/10 21:02:31 ET
Table 'Corvus' 6-max Seat #4 is the button
Seat 1: nando_abarca ($9.18 in chips)
Seat 2: PlayTheBlues4U ($17.86 in chips)
Seat 3: 123tiger711a ($14.35 in chips)
Seat 4: jmc926 ($10.23 in chips)
Seat 5: F3ign ($19.52 in chips)
Seat 6: BigBlue ($9.34 in chips)
F3ign: posts small blind $0.05
BigBlue: posts big blind $0.10
*** HOLE CARDS ***
Dealt to PlayTheBlues4U [Kc Kd]
nando_abarca: calls $0.10
PlayTheBlues4U: raises $0.30 to $0.40
123tiger711a: folds
jmc926: folds
F3ign: calls $0.35
BigBlue: folds
nando_abarca: calls $0.30
*** FLOP *** [7s Qh Jd]
F3ign: checks
nando_abarca: checks
PlayTheBlues4U: bets $1
F3ign: calls $1
nando_abarca: folds
*** TURN *** [7s Qh Jd] [6s]
F3ign: checks
PlayTheBlues4U: bets $1.80
F3ign: calls $1.80
*** RIVER *** [7s Qh Jd 6s] [2s]
F3ign: checks
PlayTheBlues4U: bets $3.40
F3ign: folds
Uncalled bet ($3.40) returned to PlayTheBlues4U
PlayTheBlues4U collected $6.56 from pot
PlayTheBlues4U: doesn't show hand
*** SUMMARY ***
Total pot $6.90 | Rake $0.34
Board [7s Qh Jd 6s 2s]
Seat 1: nando_abarca folded on the Flop
Seat 2: PlayTheBlues4U collected ($6.56)
Seat 3: 123tiger711a folded before Flop (didn't bet)
Seat 4: jmc926 (button) folded before Flop (didn't bet)
Seat 5: F3ign (small blind) folded on the River
Seat 6: BigBlue (big blind) folded before Flop


*********** # 126 **************
PokerStars Hand #203587646600:  Hold'em No Limit ($0.05/$0.10 USD) - 2019/09/10 21:02:28 ET
Table 'Iphigenia' 6-max Seat #5 is the button
Seat 2: nando_abarca ($9.85 in chips)
Seat 4: F3ign ($22.16 in chips)
Seat 5: PlayTheBlues4U ($14.38 in chips)
Seat 6: RNixon'sHead ($17.03 in chips)
RNixon'sHead: posts small blind $0.05
nando_abarca: posts big blind $0.10
*** HOLE CARDS ***
Dealt to PlayTheBlues4U [As 6s]
F3ign: folds
PlayTheBlues4U: raises $0.10 to $0.20
RNixon'sHead: calls $0.15
nando_abarca: raises $0.60 to $0.80
PlayTheBlues4U: folds
RNixon'sHead: calls $0.60
*** FLOP *** [7h Ks 4d]
RNixon'sHead: checks
nando_abarca: bets $1
RNixon'sHead: calls $1
*** TURN *** [7h Ks 4d] [2d]
Nessman355 joins the table at seat #3
RNixon'sHead: checks
nando_abarca: checks
*** RIVER *** [7h Ks 4d 2d] [5d]
RNixon'sHead: bets $2.91
nando_abarca: folds
Uncalled bet ($2.91) returned to RNixon'sHead
RNixon'sHead collected $3.61 from pot
RNixon'sHead: doesn't show hand
*** SUMMARY ***
Total pot $3.80 | Rake $0.19
Board [7h Ks 4d 2d 5d]
Seat 2: nando_abarca (big blind) folded on the River
Seat 4: F3ign folded before Flop (didn't bet)
Seat 5: PlayTheBlues4U (button) folded before Flop
Seat 6: RNixon'sHead (small blind) collected ($3.61)


*********** # 127 **************
PokerStars Hand #203587646554:  Hold'em No Limit ($0.05/$0.10 USD) - 2019/09/10 21:02:14 ET
Table 'Iphigenia' 6-max Seat #4 is the button
Seat 2: nando_abarca ($9.85 in chips)
Seat 4: F3ign ($22.01 in chips)
Seat 5: PlayTheBlues4U ($14.43 in chips)
Seat 6: RNixon'sHead ($17.13 in chips)
PlayTheBlues4U: posts small blind $0.05
RNixon'sHead: posts big blind $0.10
*** HOLE CARDS ***
Dealt to PlayTheBlues4U [8d Js]
nando_abarca: folds
F3ign: raises $0.20 to $0.30
PlayTheBlues4U: folds
RNixon'sHead: folds
Uncalled bet ($0.20) returned to F3ign
F3ign collected $0.25 from pot
F3ign: doesn't show hand
*** SUMMARY ***
Total pot $0.25 | Rake $0
Seat 2: nando_abarca folded before Flop (didn't bet)
Seat 4: F3ign (button) collected ($0.25)
Seat 5: PlayTheBlues4U (small blind) folded before Flop
Seat 6: RNixon'sHead (big blind) folded before Flop


*********** # 128 **************
PokerStars Hand #203587646515:  Hold'em No Limit ($0.05/$0.10 USD) - 2019/09/10 21:02:06 ET
Table 'Iphigenia' 6-max Seat #2 is the button
Seat 2: nando_abarca ($9.85 in chips)
Seat 4: F3ign ($22.06 in chips)
Seat 5: PlayTheBlues4U ($14.53 in chips)
Seat 6: RNixon'sHead ($16.98 in chips)
F3ign: posts small blind $0.05
PlayTheBlues4U: posts big blind $0.10
*** HOLE CARDS ***
Dealt to PlayTheBlues4U [Kh 6c]
RNixon'sHead: raises $0.15 to $0.25
nando_abarca: folds
F3ign: folds
PlayTheBlues4U: folds
Uncalled bet ($0.15) returned to RNixon'sHead
RNixon'sHead collected $0.25 from pot
RNixon'sHead: doesn't show hand
*** SUMMARY ***
Total pot $0.25 | Rake $0
Seat 2: nando_abarca (button) folded before Flop (didn't bet)
Seat 4: F3ign (small blind) folded before Flop
Seat 5: PlayTheBlues4U (big blind) folded before Flop
Seat 6: RNixon'sHead collected ($0.25)


*********** # 129 **************
PokerStars Hand #203587646514:  Hold'em No Limit ($0.05/$0.10 USD) - 2019/09/10 21:02:06 ET
Table 'Corvus' 6-max Seat #3 is the button
Seat 1: nando_abarca ($9.18 in chips)
Seat 2: PlayTheBlues4U ($17.86 in chips)
Seat 3: 123tiger711a ($14.21 in chips)
Seat 4: jmc926 ($10.28 in chips)
Seat 5: F3ign ($19.62 in chips)
Seat 6: BigBlue ($9.34 in chips)
jmc926: posts small blind $0.05
F3ign: posts big blind $0.10
*** HOLE CARDS ***
Dealt to PlayTheBlues4U [6s 3h]
BigBlue: folds
nando_abarca: folds
PlayTheBlues4U: folds
123tiger711a: calls $0.10
jmc926: folds
F3ign: checks
*** FLOP *** [6d Kd 6h]
F3ign: checks
123tiger711a: bets $0.12
F3ign: folds
Uncalled bet ($0.12) returned to 123tiger711a
123tiger711a collected $0.24 from pot
*** SUMMARY ***
Total pot $0.25 | Rake $0.01
Board [6d Kd 6h]
Seat 1: nando_abarca folded before Flop (didn't bet)
Seat 2: PlayTheBlues4U folded before Flop (didn't bet)
Seat 3: 123tiger711a (button) collected ($0.24)
Seat 4: jmc926 (small blind) folded before Flop
Seat 5: F3ign (big blind) folded on the Flop
Seat 6: BigBlue folded before Flop (didn't bet)


*********** # 130 **************
PokerStars Hand #203587646442:  Hold'em No Limit ($0.05/$0.10 USD) - 2019/09/10 21:01:44 ET
Table 'Iphigenia' 6-max Seat #6 is the button
Seat 2: nando_abarca ($9.90 in chips)
Seat 4: F3ign ($22.16 in chips)
Seat 5: PlayTheBlues4U ($14.53 in chips)
Seat 6: RNixon'sHead ($16.83 in chips)
nando_abarca: posts small blind $0.05
F3ign: posts big blind $0.10
*** HOLE CARDS ***
Dealt to PlayTheBlues4U [As Tc]
PlayTheBlues4U: folds
BigBlue leaves the table
RNixon'sHead: raises $0.15 to $0.25
nando_abarca: folds
F3ign: folds
Uncalled bet ($0.15) returned to RNixon'sHead
RNixon'sHead collected $0.25 from pot
RNixon'sHead: doesn't show hand
*** SUMMARY ***
Total pot $0.25 | Rake $0
Seat 2: nando_abarca (small blind) folded before Flop
Seat 4: F3ign (big blind) folded before Flop
Seat 5: PlayTheBlues4U folded before Flop (didn't bet)
Seat 6: RNixon'sHead (button) collected ($0.25)


*********** # 131 **************
PokerStars Hand #203587646335:  Hold'em No Limit ($0.05/$0.10 USD) - 2019/09/10 21:01:13 ET
Table 'Corvus' 6-max Seat #2 is the button
Seat 1: nando_abarca ($9 in chips)
Seat 2: PlayTheBlues4U ($17.86 in chips)
Seat 3: 123tiger711a ($14.31 in chips)
Seat 4: jmc926 ($10.38 in chips)
Seat 5: F3ign ($19.62 in chips)
Seat 6: BigBlue ($9.34 in chips)
123tiger711a: posts small blind $0.05
jmc926: posts big blind $0.10
*** HOLE CARDS ***
Dealt to PlayTheBlues4U [Tc Jh]
F3ign: folds
BigBlue: folds
nando_abarca: calls $0.10
PlayTheBlues4U: folds
123tiger711a: calls $0.05
jmc926: checks
*** FLOP *** [Js Ah Kh]
123tiger711a: checks
jmc926: checks
nando_abarca: bets $0.20
123tiger711a: folds
jmc926: folds
Uncalled bet ($0.20) returned to nando_abarca
nando_abarca collected $0.28 from pot
nando_abarca: doesn't show hand
*** SUMMARY ***
Total pot $0.30 | Rake $0.02
Board [Js Ah Kh]
Seat 1: nando_abarca collected ($0.28)
Seat 2: PlayTheBlues4U (button) folded before Flop (didn't bet)
Seat 3: 123tiger711a (small blind) folded on the Flop
Seat 4: jmc926 (big blind) folded on the Flop
Seat 5: F3ign folded before Flop (didn't bet)
Seat 6: BigBlue folded before Flop (didn't bet)


*********** # 132 **************
PokerStars Hand #203587646214:  Hold'em No Limit ($0.05/$0.10 USD) - 2019/09/10 21:00:43 ET
Table 'Corvus' 6-max Seat #1 is the button
Seat 1: nando_abarca ($9 in chips)
Seat 2: PlayTheBlues4U ($17.91 in chips)
Seat 3: 123tiger711a ($13.89 in chips)
Seat 4: jmc926 ($10.58 in chips)
Seat 5: F3ign ($19.82 in chips)
Seat 6: BigBlue ($9.34 in chips)
PlayTheBlues4U: posts small blind $0.05
123tiger711a: posts big blind $0.10
*** HOLE CARDS ***
Dealt to PlayTheBlues4U [5d Tc]
jmc926: raises $0.10 to $0.20
F3ign: calls $0.20
BigBlue: folds
nando_abarca: folds
PlayTheBlues4U: folds
123tiger711a: calls $0.10
*** FLOP *** [Qc 3d 7h]
123tiger711a: checks
jmc926: checks
F3ign: checks
*** TURN *** [Qc 3d 7h] [4d]
123tiger711a: bets $0.62
jmc926: folds
F3ign: folds
Uncalled bet ($0.62) returned to 123tiger711a
123tiger711a collected $0.62 from pot
*** SUMMARY ***
Total pot $0.65 | Rake $0.03
Board [Qc 3d 7h 4d]
Seat 1: nando_abarca (button) folded before Flop (didn't bet)
Seat 2: PlayTheBlues4U (small blind) folded before Flop
Seat 3: 123tiger711a (big blind) collected ($0.62)
Seat 4: jmc926 folded on the Turn
Seat 5: F3ign folded on the Turn
Seat 6: BigBlue folded before Flop (didn't bet)


*********** # 133 **************
PokerStars Hand #203587646204:  Hold'em No Limit ($0.05/$0.10 USD) - 2019/09/10 21:00:40 ET
Table 'Iphigenia' 6-max Seat #5 is the button
Seat 2: nando_abarca ($10 in chips)
Seat 3: BigBlue ($3.21 in chips)
Seat 4: F3ign ($22.16 in chips)
Seat 5: PlayTheBlues4U ($11.50 in chips)
Seat 6: RNixon'sHead ($16.88 in chips)
RNixon'sHead: posts small blind $0.05
nando_abarca: posts big blind $0.10
*** HOLE CARDS ***
Dealt to PlayTheBlues4U [Qc Kh]
BigBlue: calls $0.10
F3ign: folds
PlayTheBlues4U: raises $0.30 to $0.40
RNixon'sHead: folds
nando_abarca: folds
BigBlue: calls $0.30
*** FLOP *** [Qd 9c 6c]
BigBlue: checks
PlayTheBlues4U: bets $0.60
BigBlue: calls $0.60
*** TURN *** [Qd 9c 6c] [8h]
BigBlue: checks
PlayTheBlues4U: bets $10.50 and is all-in
BigBlue: calls $2.21 and is all-in
Uncalled bet ($8.29) returned to PlayTheBlues4U
*** RIVER *** [Qd 9c 6c 8h] [5h]
*** SHOW DOWN ***
BigBlue: shows [Js Qs] (a pair of Queens)
PlayTheBlues4U: shows [Qc Kh] (a pair of Queens - King kicker)
PlayTheBlues4U collected $6.24 from pot
*** SUMMARY ***
Total pot $6.57 | Rake $0.33
Board [Qd 9c 6c 8h 5h]
Seat 2: nando_abarca (big blind) folded before Flop
Seat 3: BigBlue showed [Js Qs] and lost with a pair of Queens
Seat 4: F3ign folded before Flop (didn't bet)
Seat 5: PlayTheBlues4U (button) showed [Qc Kh] and won ($6.24) with a pair of Queens
Seat 6: RNixon'sHead (small blind) folded before Flop


*********** # 134 **************
PokerStars Hand #203587646158:  Hold'em No Limit ($0.05/$0.10 USD) - 2019/09/10 21:00:23 ET
Table 'Iphigenia' 6-max Seat #4 is the button
Seat 2: nando_abarca ($10 in chips)
Seat 3: BigBlue ($3.21 in chips)
Seat 4: F3ign ($22.01 in chips)
Seat 5: PlayTheBlues4U ($11.55 in chips)
Seat 6: RNixon'sHead ($16.98 in chips)
PlayTheBlues4U: posts small blind $0.05
RNixon'sHead: posts big blind $0.10
*** HOLE CARDS ***
Dealt to PlayTheBlues4U [3d 5c]
nando_abarca: folds
BigBlue: folds
F3ign: raises $0.20 to $0.30
PlayTheBlues4U: folds
RNixon'sHead: folds
Uncalled bet ($0.20) returned to F3ign
F3ign collected $0.25 from pot
F3ign: doesn't show hand
*** SUMMARY ***
Total pot $0.25 | Rake $0
Seat 2: nando_abarca folded before Flop (didn't bet)
Seat 3: BigBlue folded before Flop (didn't bet)
Seat 4: F3ign (button) collected ($0.25)
Seat 5: PlayTheBlues4U (small blind) folded before Flop
Seat 6: RNixon'sHead (big blind) folded before Flop


*********** # 135 **************
PokerStars Hand #203587646082:  Hold'em No Limit ($0.05/$0.10 USD) - 2019/09/10 20:59:59 ET
Table 'Corvus' 6-max Seat #6 is the button
Seat 1: nando_abarca ($9.10 in chips)
Seat 2: PlayTheBlues4U ($17.73 in chips)
Seat 3: 123tiger711a ($13.89 in chips)
Seat 4: jmc926 ($10.68 in chips)
Seat 5: F3ign ($19.82 in chips)
Seat 6: BigBlue ($9.34 in chips)
nando_abarca: posts small blind $0.05
PlayTheBlues4U: posts big blind $0.10
*** HOLE CARDS ***
Dealt to PlayTheBlues4U [3c 4h]
123tiger711a: folds
jmc926: calls $0.10
F3ign: folds
BigBlue: folds
nando_abarca: calls $0.05
PlayTheBlues4U: checks
*** FLOP *** [7c 9d 4s]
nando_abarca: checks
PlayTheBlues4U: checks
jmc926: checks
*** TURN *** [7c 9d 4s] [7h]
nando_abarca: checks
PlayTheBlues4U: checks
jmc926: checks
*** RIVER *** [7c 9d 4s 7h] [7d]
nando_abarca: checks
PlayTheBlues4U: checks
jmc926: checks
*** SHOW DOWN ***
nando_abarca: shows [Ac Js] (three of a kind, Sevens)
PlayTheBlues4U: shows [3c 4h] (a full house, Sevens full of Fours)
jmc926: mucks hand
PlayTheBlues4U collected $0.28 from pot
*** SUMMARY ***
Total pot $0.30 | Rake $0.02
Board [7c 9d 4s 7h 7d]
Seat 1: nando_abarca (small blind) showed [Ac Js] and lost with three of a kind, Sevens
Seat 2: PlayTheBlues4U (big blind) showed [3c 4h] and won ($0.28) with a full house, Sevens full of Fours
Seat 3: 123tiger711a folded before Flop (didn't bet)
Seat 4: jmc926 mucked [Th Qs]
Seat 5: F3ign folded before Flop (didn't bet)
Seat 6: BigBlue (button) folded before Flop (didn't bet)


*********** # 136 **************
PokerStars Hand #203587646055:  Hold'em No Limit ($0.05/$0.10 USD) - 2019/09/10 20:59:49 ET
Table 'Iphigenia' 6-max Seat #3 is the button
Seat 2: nando_abarca ($5.67 in chips)
Seat 3: BigBlue ($3.21 in chips)
Seat 4: F3ign ($21.91 in chips)
Seat 5: PlayTheBlues4U ($11.65 in chips)
Seat 6: RNixon'sHead ($16.98 in chips)
F3ign: posts small blind $0.05
PlayTheBlues4U: posts big blind $0.10
*** HOLE CARDS ***
Dealt to PlayTheBlues4U [9c Qh]
RNixon'sHead: folds
nando_abarca: folds
BigBlue: folds
F3ign: raises $0.20 to $0.30
PlayTheBlues4U: folds
Uncalled bet ($0.20) returned to F3ign
F3ign collected $0.20 from pot
F3ign: doesn't show hand
*** SUMMARY ***
Total pot $0.20 | Rake $0
Seat 2: nando_abarca folded before Flop (didn't bet)
Seat 3: BigBlue (button) folded before Flop (didn't bet)
Seat 4: F3ign (small blind) collected ($0.20)
Seat 5: PlayTheBlues4U (big blind) folded before Flop
Seat 6: RNixon'sHead folded before Flop (didn't bet)


*********** # 137 **************
PokerStars Hand #203587646032:  Hold'em No Limit ($0.05/$0.10 USD) - 2019/09/10 20:59:39 ET
Table 'Corvus' 6-max Seat #5 is the button
Seat 1: nando_abarca ($9.20 in chips)
Seat 2: PlayTheBlues4U ($17.73 in chips)
Seat 3: 123tiger711a ($13.89 in chips)
Seat 4: jmc926 ($10.53 in chips)
Seat 5: F3ign ($19.82 in chips)
Seat 6: BigBlue ($9.39 in chips)
BigBlue: posts small blind $0.05
nando_abarca: posts big blind $0.10
*** HOLE CARDS ***
Dealt to PlayTheBlues4U [6c 7h]
PlayTheBlues4U: folds
123tiger711a: folds
jmc926: raises $0.20 to $0.30
F3ign: folds
BigBlue: folds
nando_abarca: folds
Uncalled bet ($0.20) returned to jmc926
jmc926 collected $0.25 from pot
*** SUMMARY ***
Total pot $0.25 | Rake $0
Seat 1: nando_abarca (big blind) folded before Flop
Seat 2: PlayTheBlues4U folded before Flop (didn't bet)
Seat 3: 123tiger711a folded before Flop (didn't bet)
Seat 4: jmc926 collected ($0.25)
Seat 5: F3ign (button) folded before Flop (didn't bet)
Seat 6: BigBlue (small blind) folded before Flop


*********** # 138 **************
PokerStars Hand #203587646028:  Hold'em No Limit ($0.05/$0.10 USD) - 2019/09/10 20:59:36 ET
Table 'Iphigenia' 6-max Seat #2 is the button
Seat 2: nando_abarca ($5.67 in chips)
Seat 3: BigBlue ($3.26 in chips)
Seat 4: F3ign ($22.01 in chips)
Seat 5: PlayTheBlues4U ($11.50 in chips)
Seat 6: RNixon'sHead ($16.98 in chips)
BigBlue: posts small blind $0.05
F3ign: posts big blind $0.10
*** HOLE CARDS ***
Dealt to PlayTheBlues4U [Qs Ks]
PlayTheBlues4U: raises $0.20 to $0.30
RNixon'sHead: folds
nando_abarca: folds
BigBlue: folds
F3ign: folds
Uncalled bet ($0.20) returned to PlayTheBlues4U
PlayTheBlues4U collected $0.25 from pot
PlayTheBlues4U: doesn't show hand
*** SUMMARY ***
Total pot $0.25 | Rake $0
Seat 2: nando_abarca (button) folded before Flop (didn't bet)
Seat 3: BigBlue (small blind) folded before Flop
Seat 4: F3ign (big blind) folded before Flop
Seat 5: PlayTheBlues4U collected ($0.25)
Seat 6: RNixon'sHead folded before Flop (didn't bet)


*********** # 139 **************
PokerStars Hand #203587645922:  Hold'em No Limit ($0.05/$0.10 USD) - 2019/09/10 20:59:01 ET
Table 'Corvus' 6-max Seat #4 is the button
Seat 1: nando_abarca ($9.20 in chips)
Seat 2: PlayTheBlues4U ($17.73 in chips)
Seat 3: 123tiger711a ($13.89 in chips)
Seat 4: jmc926 ($9.99 in chips)
Seat 5: F3ign ($20.32 in chips)
Seat 6: BigBlue ($9.49 in chips)
F3ign: posts small blind $0.05
BigBlue: posts big blind $0.10
*** HOLE CARDS ***
Dealt to PlayTheBlues4U [As Td]
nando_abarca: folds
PlayTheBlues4U: folds
123tiger711a: folds
jmc926: raises $0.40 to $0.50
F3ign: calls $0.45
BigBlue: folds
*** FLOP *** [2c 7s 6c]
F3ign: checks
jmc926: bets $0.90
F3ign: folds
Uncalled bet ($0.90) returned to jmc926
jmc926 collected $1.04 from pot
*** SUMMARY ***
Total pot $1.10 | Rake $0.06
Board [2c 7s 6c]
Seat 1: nando_abarca folded before Flop (didn't bet)
Seat 2: PlayTheBlues4U folded before Flop (didn't bet)
Seat 3: 123tiger711a folded before Flop (didn't bet)
Seat 4: jmc926 (button) collected ($1.04)
Seat 5: F3ign (small blind) folded on the Flop
Seat 6: BigBlue (big blind) folded before Flop


*********** # 140 **************
PokerStars Hand #203587645883:  Hold'em No Limit ($0.05/$0.10 USD) - 2019/09/10 20:58:47 ET
Table 'Corvus' 6-max Seat #3 is the button
Seat 1: nando_abarca ($9.20 in chips)
Seat 2: PlayTheBlues4U ($17.73 in chips)
Seat 3: 123tiger711a ($13.89 in chips)
Seat 4: jmc926 ($10.04 in chips)
Seat 5: F3ign ($20.42 in chips)
Seat 6: BigBlue ($9.34 in chips)
jmc926: posts small blind $0.05
F3ign: posts big blind $0.10
*** HOLE CARDS ***
Dealt to PlayTheBlues4U [3h 9s]
BigBlue: raises $0.20 to $0.30
nando_abarca: folds
PlayTheBlues4U: folds
123tiger711a: folds
jmc926: folds
F3ign: folds
Uncalled bet ($0.20) returned to BigBlue
BigBlue collected $0.25 from pot
BigBlue: doesn't show hand
*** SUMMARY ***
Total pot $0.25 | Rake $0
Seat 1: nando_abarca folded before Flop (didn't bet)
Seat 2: PlayTheBlues4U folded before Flop (didn't bet)
Seat 3: 123tiger711a (button) folded before Flop (didn't bet)
Seat 4: jmc926 (small blind) folded before Flop
Seat 5: F3ign (big blind) folded before Flop
Seat 6: BigBlue collected ($0.25)


*********** # 141 **************
PokerStars Hand #203587645828:  Hold'em No Limit ($0.05/$0.10 USD) - 2019/09/10 20:58:28 ET
Table 'Iphigenia' 6-max Seat #6 is the button
Seat 2: nando_abarca ($10.11 in chips)
Seat 3: BigBlue ($3.36 in chips)
Seat 4: F3ign ($22.01 in chips)
Seat 5: PlayTheBlues4U ($11.50 in chips)
Seat 6: RNixon'sHead ($12.89 in chips)
nando_abarca: posts small blind $0.05
BigBlue: posts big blind $0.10
*** HOLE CARDS ***
Dealt to PlayTheBlues4U [2d As]
F3ign: folds
PlayTheBlues4U: folds
RNixon'sHead: raises $0.15 to $0.25
nando_abarca: calls $0.20
BigBlue: folds
*** FLOP *** [3s 7h 3h]
nando_abarca: checks
RNixon'sHead: bets $0.25
nando_abarca: calls $0.25
*** TURN *** [3s 7h 3h] [6d]
nando_abarca: checks
RNixon'sHead: bets $0.71
nando_abarca: raises $1.23 to $1.94
RNixon'sHead: calls $1.23
*** RIVER *** [3s 7h 3h 6d] [Jd]
nando_abarca: bets $2
RNixon'sHead: calls $2
*** SHOW DOWN ***
nando_abarca: shows [Td Th] (two pair, Tens and Threes)
RNixon'sHead: shows [Qs Qd] (two pair, Queens and Threes)
RNixon'sHead collected $8.53 from pot
*** SUMMARY ***
Total pot $8.98 | Rake $0.45
Board [3s 7h 3h 6d Jd]
Seat 2: nando_abarca (small blind) showed [Td Th] and lost with two pair, Tens and Threes
Seat 3: BigBlue (big blind) folded before Flop
Seat 4: F3ign folded before Flop (didn't bet)
Seat 5: PlayTheBlues4U folded before Flop (didn't bet)
Seat 6: RNixon'sHead (button) showed [Qs Qd] and won ($8.53) with two pair, Queens and Threes


*********** # 142 **************
PokerStars Hand #203587645765:  Hold'em No Limit ($0.05/$0.10 USD) - 2019/09/10 20:58:05 ET
Table 'Corvus' 6-max Seat #2 is the button
Seat 1: nando_abarca ($9.30 in chips)
Seat 2: PlayTheBlues4U ($17.73 in chips)
Seat 3: 123tiger711a ($13.71 in chips)
Seat 4: jmc926 ($10.14 in chips)
Seat 5: F3ign ($20.42 in chips)
Seat 6: BigBlue ($9.34 in chips)
123tiger711a: posts small blind $0.05
jmc926: posts big blind $0.10
*** HOLE CARDS ***
Dealt to PlayTheBlues4U [6s 4h]
F3ign: folds
BigBlue: folds
nando_abarca: calls $0.10
PlayTheBlues4U: folds
123tiger711a: calls $0.05
jmc926: checks
*** FLOP *** [Kh Ts Ac]
123tiger711a: checks
jmc926: checks
nando_abarca: checks
*** TURN *** [Kh Ts Ac] [Kd]
123tiger711a: checks
jmc926: checks
nando_abarca: checks
*** RIVER *** [Kh Ts Ac Kd] [3c]
123tiger711a: checks
jmc926: checks
nando_abarca: checks
*** SHOW DOWN ***
123tiger711a: shows [5c 5h] (two pair, Kings and Fives)
jmc926: mucks hand
nando_abarca: mucks hand
123tiger711a collected $0.28 from pot
*** SUMMARY ***
Total pot $0.30 | Rake $0.02
Board [Kh Ts Ac Kd 3c]
Seat 1: nando_abarca mucked [6c 4c]
Seat 2: PlayTheBlues4U (button) folded before Flop (didn't bet)
Seat 3: 123tiger711a (small blind) showed [5c 5h] and won ($0.28) with two pair, Kings and Fives
Seat 4: jmc926 (big blind) mucked [7d Qd]
Seat 5: F3ign folded before Flop (didn't bet)
Seat 6: BigBlue folded before Flop (didn't bet)


*********** # 143 **************
PokerStars Hand #203587645706:  Hold'em No Limit ($0.05/$0.10 USD) - 2019/09/10 20:57:42 ET
Table 'Iphigenia' 6-max Seat #5 is the button
Seat 2: nando_abarca ($10.21 in chips)
Seat 3: BigBlue ($3.66 in chips)
Seat 4: F3ign ($22.01 in chips)
Seat 5: PlayTheBlues4U ($11.09 in chips)
Seat 6: RNixon'sHead ($12.94 in chips)
RNixon'sHead: posts small blind $0.05
nando_abarca: posts big blind $0.10
*** HOLE CARDS ***
Dealt to PlayTheBlues4U [Td Jh]
PlayTheBlues4U said, "Arrroooo"
BigBlue: calls $0.10
F3ign: folds
PlayTheBlues4U: raises $0.20 to $0.30
RNixon'sHead: folds
nando_abarca: folds
BigBlue: calls $0.20
*** FLOP *** [6s Jc Ad]
BigBlue: checks
PlayTheBlues4U: bets $0.50
BigBlue: folds
Uncalled bet ($0.50) returned to PlayTheBlues4U
PlayTheBlues4U collected $0.71 from pot
PlayTheBlues4U: doesn't show hand
*** SUMMARY ***
Total pot $0.75 | Rake $0.04
Board [6s Jc Ad]
Seat 2: nando_abarca (big blind) folded before Flop
Seat 3: BigBlue folded on the Flop
Seat 4: F3ign folded before Flop (didn't bet)
Seat 5: PlayTheBlues4U (button) collected ($0.71)
Seat 6: RNixon'sHead (small blind) folded before Flop


*********** # 144 **************
PokerStars Hand #203587645651:  Hold'em No Limit ($0.05/$0.10 USD) - 2019/09/10 20:57:24 ET
Table 'Corvus' 6-max Seat #1 is the button
Seat 1: nando_abarca ($9.30 in chips)
Seat 2: PlayTheBlues4U ($17.78 in chips)
Seat 3: 123tiger711a ($13.81 in chips)
Seat 4: jmc926 ($10 in chips)
Seat 5: F3ign ($20.42 in chips)
Seat 6: BigBlue ($9.34 in chips)
PlayTheBlues4U: posts small blind $0.05
123tiger711a: posts big blind $0.10
*** HOLE CARDS ***
Dealt to PlayTheBlues4U [Ts 4s]
jmc926: calls $0.10
F3ign: folds
BigBlue: folds
nando_abarca: folds
PlayTheBlues4U: folds
123tiger711a: checks
*** FLOP *** [Ad 7h 5c]
123tiger711a: checks
jmc926: checks
*** TURN *** [Ad 7h 5c] [Kd]
123tiger711a: checks
jmc926: checks
*** RIVER *** [Ad 7h 5c Kd] [7d]
123tiger711a: checks
jmc926: checks
*** SHOW DOWN ***
123tiger711a: shows [3h Js] (a pair of Sevens)
jmc926: shows [8c Qd] (a pair of Sevens - Ace+King+Queen kicker)
jmc926 collected $0.24 from pot
*** SUMMARY ***
Total pot $0.25 | Rake $0.01
Board [Ad 7h 5c Kd 7d]
Seat 1: nando_abarca (button) folded before Flop (didn't bet)
Seat 2: PlayTheBlues4U (small blind) folded before Flop
Seat 3: 123tiger711a (big blind) showed [3h Js] and lost with a pair of Sevens
Seat 4: jmc926 showed [8c Qd] and won ($0.24) with a pair of Sevens
Seat 5: F3ign folded before Flop (didn't bet)
Seat 6: BigBlue folded before Flop (didn't bet)


*********** # 145 **************
PokerStars Hand #203587645638:  Hold'em No Limit ($0.05/$0.10 USD) - 2019/09/10 20:57:20 ET
Table 'Iphigenia' 6-max Seat #4 is the button
Seat 2: nando_abarca ($10.21 in chips)
Seat 3: BigBlue ($3.66 in chips)
Seat 4: F3ign ($22.01 in chips)
Seat 5: PlayTheBlues4U ($11.14 in chips)
Seat 6: RNixon'sHead ($12.89 in chips)
PlayTheBlues4U: posts small blind $0.05
RNixon'sHead: posts big blind $0.10
*** HOLE CARDS ***
Dealt to PlayTheBlues4U [Jc 4s]
nando_abarca: folds
BigBlue: folds
F3ign: folds
PlayTheBlues4U: folds
Uncalled bet ($0.05) returned to RNixon'sHead
RNixon'sHead collected $0.10 from pot
RNixon'sHead: doesn't show hand
*** SUMMARY ***
Total pot $0.10 | Rake $0
Seat 2: nando_abarca folded before Flop (didn't bet)
Seat 3: BigBlue folded before Flop (didn't bet)
Seat 4: F3ign (button) folded before Flop (didn't bet)
Seat 5: PlayTheBlues4U (small blind) folded before Flop
Seat 6: RNixon'sHead (big blind) collected ($0.10)


*********** # 146 **************
PokerStars Hand #203587645585:  Hold'em No Limit ($0.05/$0.10 USD) - 2019/09/10 20:57:04 ET
Table 'Iphigenia' 6-max Seat #3 is the button
Seat 2: nando_abarca ($10.21 in chips)
Seat 3: BigBlue ($3.66 in chips)
Seat 4: F3ign ($22.06 in chips)
Seat 5: PlayTheBlues4U ($11.24 in chips)
Seat 6: RNixon'sHead ($12.74 in chips)
F3ign: posts small blind $0.05
PlayTheBlues4U: posts big blind $0.10
*** HOLE CARDS ***
Dealt to PlayTheBlues4U [2s 3s]
RNixon'sHead: raises $0.15 to $0.25
nando_abarca: folds
BigBlue: folds
F3ign: folds
PlayTheBlues4U: folds
Uncalled bet ($0.15) returned to RNixon'sHead
RNixon'sHead collected $0.25 from pot
RNixon'sHead: doesn't show hand
*** SUMMARY ***
Total pot $0.25 | Rake $0
Seat 2: nando_abarca folded before Flop (didn't bet)
Seat 3: BigBlue (button) folded before Flop (didn't bet)
Seat 4: F3ign (small blind) folded before Flop
Seat 5: PlayTheBlues4U (big blind) folded before Flop
Seat 6: RNixon'sHead collected ($0.25)


*********** # 147 **************
PokerStars Hand #203587645540:  Hold'em No Limit ($0.05/$0.10 USD) - 2019/09/10 20:56:47 ET
Table 'Iphigenia' 6-max Seat #2 is the button
Seat 2: nando_abarca ($10.21 in chips)
Seat 3: BigBlue ($3.71 in chips)
Seat 4: F3ign ($22.01 in chips)
Seat 5: PlayTheBlues4U ($11.24 in chips)
Seat 6: RNixon'sHead ($12.74 in chips)
BigBlue: posts small blind $0.05
F3ign: posts big blind $0.10
*** HOLE CARDS ***
Dealt to PlayTheBlues4U [Ac 4d]
PlayTheBlues4U: folds
RNixon'sHead: folds
nando_abarca: folds
BigBlue: folds
Uncalled bet ($0.05) returned to F3ign
F3ign collected $0.10 from pot
F3ign: doesn't show hand
*** SUMMARY ***
Total pot $0.10 | Rake $0
Seat 2: nando_abarca (button) folded before Flop (didn't bet)
Seat 3: BigBlue (small blind) folded before Flop
Seat 4: F3ign (big blind) collected ($0.10)
Seat 5: PlayTheBlues4U folded before Flop (didn't bet)
Seat 6: RNixon'sHead folded before Flop (didn't bet)


*********** # 148 **************
PokerStars Hand #203587645476:  Hold'em No Limit ($0.05/$0.10 USD) - 2019/09/10 20:56:28 ET
Table 'Corvus' 6-max Seat #6 is the button
Seat 1: nando_abarca ($9.40 in chips)
Seat 2: PlayTheBlues4U ($17.69 in chips)
Seat 3: 123tiger711a ($13.81 in chips)
Seat 4: jmc926 ($3.39 in chips)
Seat 5: F3ign ($20.42 in chips)
Seat 6: BigBlue ($9.34 in chips)
nando_abarca: posts small blind $0.05
PlayTheBlues4U: posts big blind $0.10
*** HOLE CARDS ***
Dealt to PlayTheBlues4U [4h Kc]
jmc926 said, "omg lol"
123tiger711a: folds
jmc926 said, "what a joke"
PlayTheBlues4U said, "oof"
jmc926: folds
F3ign: folds
BigBlue: folds
nando_abarca: calls $0.05
PlayTheBlues4U: checks
*** FLOP *** [3s 5c 9s]
nando_abarca: checks
PlayTheBlues4U: checks
*** TURN *** [3s 5c 9s] [9c]
nando_abarca: checks
PlayTheBlues4U: checks
*** RIVER *** [3s 5c 9s 9c] [9d]
jmc926 said, "glad I didn't raise the river lol"
nando_abarca: checks
PlayTheBlues4U: checks
*** SHOW DOWN ***
nando_abarca: shows [7d 6s] (three of a kind, Nines)
PlayTheBlues4U: shows [4h Kc] (three of a kind, Nines - King kicker)
PlayTheBlues4U collected $0.19 from pot
*** SUMMARY ***
Total pot $0.20 | Rake $0.01
Board [3s 5c 9s 9c 9d]
Seat 1: nando_abarca (small blind) showed [7d 6s] and lost with three of a kind, Nines
Seat 2: PlayTheBlues4U (big blind) showed [4h Kc] and won ($0.19) with three of a kind, Nines
Seat 3: 123tiger711a folded before Flop (didn't bet)
Seat 4: jmc926 folded before Flop (didn't bet)
Seat 5: F3ign folded before Flop (didn't bet)
Seat 6: BigBlue (button) folded before Flop (didn't bet)


*********** # 149 **************
PokerStars Hand #203587645379:  Hold'em No Limit ($0.05/$0.10 USD) - 2019/09/10 20:55:53 ET
Table 'Iphigenia' 6-max Seat #6 is the button
Seat 2: nando_abarca ($10.46 in chips)
Seat 3: BigBlue ($3.25 in chips)
Seat 4: F3ign ($22.01 in chips)
Seat 5: PlayTheBlues4U ($11.24 in chips)
Seat 6: RNixon'sHead ($12.99 in chips)
nando_abarca: posts small blind $0.05
BigBlue: posts big blind $0.10
*** HOLE CARDS ***
Dealt to PlayTheBlues4U [4c Ac]
F3ign: folds
PlayTheBlues4U: folds
RNixon'sHead: raises $0.15 to $0.25
nando_abarca: calls $0.20
BigBlue: calls $0.15
*** FLOP *** [Qs 5h 9c]
nando_abarca: checks
BigBlue: checks
RNixon'sHead: checks
*** TURN *** [Qs 5h 9c] [9s]
nando_abarca: checks
BigBlue: bets $0.50
RNixon'sHead: folds
nando_abarca: folds
Uncalled bet ($0.50) returned to BigBlue
BigBlue collected $0.71 from pot
BigBlue: doesn't show hand
*** SUMMARY ***
Total pot $0.75 | Rake $0.04
Board [Qs 5h 9c 9s]
Seat 2: nando_abarca (small blind) folded on the Turn
Seat 3: BigBlue (big blind) collected ($0.71)
Seat 4: F3ign folded before Flop (didn't bet)
Seat 5: PlayTheBlues4U folded before Flop (didn't bet)
Seat 6: RNixon'sHead (button) folded on the Turn


*********** # 150 **************
PokerStars Hand #203587645255:  Hold'em No Limit ($0.05/$0.10 USD) - 2019/09/10 20:55:07 ET
Table 'Corvus' 6-max Seat #5 is the button
Seat 1: nando_abarca ($9.50 in chips)
Seat 2: PlayTheBlues4U ($13.41 in chips)
Seat 3: 123tiger711a ($13.81 in chips)
Seat 4: jmc926 ($7.99 in chips)
Seat 5: F3ign ($20.42 in chips)
Seat 6: BigBlue ($9.39 in chips)
BigBlue: posts small blind $0.05
nando_abarca: posts big blind $0.10
*** HOLE CARDS ***
Dealt to PlayTheBlues4U [Jd Jc]
PlayTheBlues4U: raises $0.20 to $0.30
123tiger711a: folds
jmc926: calls $0.30
F3ign: folds
BigBlue: folds
nando_abarca: folds
*** FLOP *** [Js 2c 4h]
PlayTheBlues4U: bets $0.50
jmc926: calls $0.50
*** TURN *** [Js 2c 4h] [8h]
PlayTheBlues4U: bets $1.10
jmc926: calls $1.10
*** RIVER *** [Js 2c 4h 8h] [7c]
PlayTheBlues4U: bets $2.70
jmc926: calls $2.70
*** SHOW DOWN ***
PlayTheBlues4U: shows [Jd Jc] (three of a kind, Jacks)
jmc926: mucks hand
PlayTheBlues4U collected $8.88 from pot
*** SUMMARY ***
Total pot $9.35 | Rake $0.47
Board [Js 2c 4h 8h 7c]
Seat 1: nando_abarca (big blind) folded before Flop
Seat 2: PlayTheBlues4U showed [Jd Jc] and won ($8.88) with three of a kind, Jacks
Seat 3: 123tiger711a folded before Flop (didn't bet)
Seat 4: jmc926 mucked [4s 4d]
Seat 5: F3ign (button) folded before Flop (didn't bet)
Seat 6: BigBlue (small blind) folded before Flop


*********** # 151 **************
PokerStars Hand #203587645208:  Hold'em No Limit ($0.05/$0.10 USD) - 2019/09/10 20:54:54 ET
Table 'Corvus' 6-max Seat #4 is the button
Seat 1: nando_abarca ($9.50 in chips)
Seat 2: PlayTheBlues4U ($13.41 in chips)
Seat 3: 123tiger711a ($13.81 in chips)
Seat 4: jmc926 ($7.99 in chips)
Seat 5: F3ign ($20.32 in chips)
Seat 6: BigBlue ($9.49 in chips)
F3ign: posts small blind $0.05
BigBlue: posts big blind $0.10
*** HOLE CARDS ***
Dealt to PlayTheBlues4U [8s Ad]
nando_abarca: folds
PlayTheBlues4U: folds
123tiger711a: folds
jmc926: folds
F3ign: raises $0.20 to $0.30
BigBlue: folds
Uncalled bet ($0.20) returned to F3ign
F3ign collected $0.20 from pot
F3ign: doesn't show hand
*** SUMMARY ***
Total pot $0.20 | Rake $0
Seat 1: nando_abarca folded before Flop (didn't bet)
Seat 2: PlayTheBlues4U folded before Flop (didn't bet)
Seat 3: 123tiger711a folded before Flop (didn't bet)
Seat 4: jmc926 (button) folded before Flop (didn't bet)
Seat 5: F3ign (small blind) collected ($0.20)
Seat 6: BigBlue (big blind) folded before Flop


*********** # 152 **************
PokerStars Hand #203587645206:  Hold'em No Limit ($0.05/$0.10 USD) - 2019/09/10 20:54:54 ET
Table 'Iphigenia' 6-max Seat #5 is the button
Seat 2: nando_abarca ($10.56 in chips)
Seat 3: BigBlue ($3.25 in chips)
Seat 4: F3ign ($24.35 in chips)
Seat 5: PlayTheBlues4U ($11.24 in chips)
Seat 6: RNixon'sHead ($10.79 in chips)
RNixon'sHead: posts small blind $0.05
nando_abarca: posts big blind $0.10
*** HOLE CARDS ***
Dealt to PlayTheBlues4U [5c Ts]
BigBlue: folds
F3ign: raises $0.20 to $0.30
PlayTheBlues4U: folds
RNixon'sHead: raises $0.85 to $1.15
nando_abarca: folds
F3ign: calls $0.85
*** FLOP *** [7c 8c Jd]
PlayTheBlues4U said, "Arrooooo"
RNixon'sHead: bets $1.19
F3ign: calls $1.19
*** TURN *** [7c 8c Jd] [4h]
RNixon'sHead: bets $3.95
F3ign: folds
Uncalled bet ($3.95) returned to RNixon'sHead
RNixon'sHead collected $4.54 from pot
RNixon'sHead: doesn't show hand
*** SUMMARY ***
Total pot $4.78 | Rake $0.24
Board [7c 8c Jd 4h]
Seat 2: nando_abarca (big blind) folded before Flop
Seat 3: BigBlue folded before Flop (didn't bet)
Seat 4: F3ign folded on the Turn
Seat 5: PlayTheBlues4U (button) folded before Flop (didn't bet)
Seat 6: RNixon'sHead (small blind) collected ($4.54)


*********** # 153 **************
PokerStars Hand #203587645112:  Hold'em No Limit ($0.05/$0.10 USD) - 2019/09/10 20:54:28 ET
Table 'Corvus' 6-max Seat #3 is the button
Seat 1: nando_abarca ($9.50 in chips)
Seat 2: PlayTheBlues4U ($13.41 in chips)
Seat 3: 123tiger711a ($13.81 in chips)
Seat 4: jmc926 ($7.81 in chips)
Seat 5: F3ign ($20.52 in chips)
Seat 6: BigBlue ($9.49 in chips)
jmc926: posts small blind $0.05
F3ign: posts big blind $0.10
*** HOLE CARDS ***
Dealt to PlayTheBlues4U [Tc 3h]
BigBlue: folds
nando_abarca: folds
PlayTheBlues4U: folds
123tiger711a: folds
jmc926: raises $0.10 to $0.20
F3ign: calls $0.10
*** FLOP *** [Jd Qh 9h]
jmc926: bets $0.30
F3ign: folds
Uncalled bet ($0.30) returned to jmc926
jmc926 collected $0.38 from pot
*** SUMMARY ***
Total pot $0.40 | Rake $0.02
Board [Jd Qh 9h]
Seat 1: nando_abarca folded before Flop (didn't bet)
Seat 2: PlayTheBlues4U folded before Flop (didn't bet)
Seat 3: 123tiger711a (button) folded before Flop (didn't bet)
Seat 4: jmc926 (small blind) collected ($0.38)
Seat 5: F3ign (big blind) folded on the Flop
Seat 6: BigBlue folded before Flop (didn't bet)


*********** # 154 **************
PokerStars Hand #203587645030:  Hold'em No Limit ($0.05/$0.10 USD) - 2019/09/10 20:54:08 ET
Table 'Iphigenia' 6-max Seat #4 is the button
Seat 2: nando_abarca ($11.16 in chips)
Seat 3: BigBlue ($3.25 in chips)
Seat 4: F3ign ($24.35 in chips)
Seat 5: PlayTheBlues4U ($11.34 in chips)
Seat 6: RNixon'sHead ($10.15 in chips)
PlayTheBlues4U: posts small blind $0.05
RNixon'sHead: posts big blind $0.10
*** HOLE CARDS ***
Dealt to PlayTheBlues4U [4h 6h]
nando_abarca: calls $0.10
BigBlue: folds
F3ign: folds
PlayTheBlues4U: calls $0.05
RNixon'sHead: raises $0.50 to $0.60
nando_abarca: calls $0.50
PlayTheBlues4U: folds
*** FLOP *** [6d Tc 6c]
RNixon'sHead: bets $0.53
nando_abarca: folds
Uncalled bet ($0.53) returned to RNixon'sHead
RNixon'sHead collected $1.24 from pot
RNixon'sHead: doesn't show hand
*** SUMMARY ***
Total pot $1.30 | Rake $0.06
Board [6d Tc 6c]
Seat 2: nando_abarca folded on the Flop
Seat 3: BigBlue folded before Flop (didn't bet)
Seat 4: F3ign (button) folded before Flop (didn't bet)
Seat 5: PlayTheBlues4U (small blind) folded before Flop
Seat 6: RNixon'sHead (big blind) collected ($1.24)


*********** # 155 **************
PokerStars Hand #203587644994:  Hold'em No Limit ($0.05/$0.10 USD) - 2019/09/10 20:53:57 ET
Table 'Corvus' 6-max Seat #2 is the button
Seat 1: nando_abarca ($9.60 in chips)
Seat 2: PlayTheBlues4U ($13.16 in chips)
Seat 3: 123tiger711a ($13.86 in chips)
Seat 4: jmc926 ($7.91 in chips)
Seat 5: F3ign ($20.52 in chips)
Seat 6: BigBlue ($9.49 in chips)
123tiger711a: posts small blind $0.05
jmc926: posts big blind $0.10
*** HOLE CARDS ***
Dealt to PlayTheBlues4U [Qc Kd]
F3ign: folds
BigBlue: folds
nando_abarca: calls $0.10
PlayTheBlues4U: raises $0.30 to $0.40
123tiger711a: folds
jmc926: folds
nando_abarca: folds
Uncalled bet ($0.30) returned to PlayTheBlues4U
PlayTheBlues4U collected $0.35 from pot
PlayTheBlues4U: doesn't show hand
*** SUMMARY ***
Total pot $0.35 | Rake $0
Seat 1: nando_abarca folded before Flop
Seat 2: PlayTheBlues4U (button) collected ($0.35)
Seat 3: 123tiger711a (small blind) folded before Flop
Seat 4: jmc926 (big blind) folded before Flop
Seat 5: F3ign folded before Flop (didn't bet)
Seat 6: BigBlue folded before Flop (didn't bet)


*********** # 156 **************
PokerStars Hand #203587644993:  Hold'em No Limit ($0.05/$0.10 USD) - 2019/09/10 20:53:57 ET
Table 'Iphigenia' 6-max Seat #3 is the button
Seat 2: nando_abarca ($11.16 in chips)
Seat 3: BigBlue ($3.25 in chips)
Seat 4: F3ign ($24.40 in chips)
Seat 5: PlayTheBlues4U ($11.29 in chips)
Seat 6: RNixon'sHead ($10.15 in chips)
F3ign: posts small blind $0.05
PlayTheBlues4U: posts big blind $0.10
*** HOLE CARDS ***
Dealt to PlayTheBlues4U [Kc 5s]
RNixon'sHead: folds
nando_abarca: folds
BigBlue: folds
F3ign: folds
Uncalled bet ($0.05) returned to PlayTheBlues4U
PlayTheBlues4U collected $0.10 from pot
PlayTheBlues4U: doesn't show hand
*** SUMMARY ***
Total pot $0.10 | Rake $0
Seat 2: nando_abarca folded before Flop (didn't bet)
Seat 3: BigBlue (button) folded before Flop (didn't bet)
Seat 4: F3ign (small blind) folded before Flop
Seat 5: PlayTheBlues4U (big blind) collected ($0.10)
Seat 6: RNixon'sHead folded before Flop (didn't bet)


*********** # 157 **************
PokerStars Hand #203587644922:  Hold'em No Limit ($0.05/$0.10 USD) - 2019/09/10 20:53:38 ET
Table 'Iphigenia' 6-max Seat #2 is the button
Seat 2: nando_abarca ($11.16 in chips)
Seat 3: BigBlue ($3.30 in chips)
Seat 4: F3ign ($24.35 in chips)
Seat 5: PlayTheBlues4U ($11.29 in chips)
Seat 6: RNixon'sHead ($10.15 in chips)
BigBlue: posts small blind $0.05
F3ign: posts big blind $0.10
*** HOLE CARDS ***
Dealt to PlayTheBlues4U [6c 3h]
PlayTheBlues4U: folds
RNixon'sHead: folds
nando_abarca: folds
BigBlue: folds
Uncalled bet ($0.05) returned to F3ign
F3ign collected $0.10 from pot
F3ign: doesn't show hand
*** SUMMARY ***
Total pot $0.10 | Rake $0
Seat 2: nando_abarca (button) folded before Flop (didn't bet)
Seat 3: BigBlue (small blind) folded before Flop
Seat 4: F3ign (big blind) collected ($0.10)
Seat 5: PlayTheBlues4U folded before Flop (didn't bet)
Seat 6: RNixon'sHead folded before Flop (didn't bet)


*********** # 158 **************
PokerStars Hand #203587644827:  Hold'em No Limit ($0.05/$0.10 USD) - 2019/09/10 20:53:12 ET
Table 'Iphigenia' 6-max Seat #6 is the button
Seat 2: nando_abarca ($11.21 in chips)
Seat 3: BigBlue ($3.40 in chips)
Seat 4: F3ign ($24.35 in chips)
Seat 5: PlayTheBlues4U ($11.29 in chips)
Seat 6: RNixon'sHead ($10 in chips)
nando_abarca: posts small blind $0.05
BigBlue: posts big blind $0.10
*** HOLE CARDS ***
Dealt to PlayTheBlues4U [6s Qh]
F3ign: folds
PlayTheBlues4U: folds
RNixon'sHead: raises $0.15 to $0.25
nando_abarca: folds
BigBlue: folds
Uncalled bet ($0.15) returned to RNixon'sHead
RNixon'sHead collected $0.25 from pot
RNixon'sHead: doesn't show hand
*** SUMMARY ***
Total pot $0.25 | Rake $0
Seat 2: nando_abarca (small blind) folded before Flop
Seat 3: BigBlue (big blind) folded before Flop
Seat 4: F3ign folded before Flop (didn't bet)
Seat 5: PlayTheBlues4U folded before Flop (didn't bet)
Seat 6: RNixon'sHead (button) collected ($0.25)


*********** # 159 **************
PokerStars Hand #203587644744:  Hold'em No Limit ($0.05/$0.10 USD) - 2019/09/10 20:52:49 ET
Table 'Corvus' 6-max Seat #1 is the button
Seat 1: nando_abarca ($9.70 in chips)
Seat 2: PlayTheBlues4U ($13.26 in chips)
Seat 3: 123tiger711a ($13.96 in chips)
Seat 4: jmc926 ($8.01 in chips)
Seat 5: F3ign ($20.52 in chips)
Seat 6: BigBlue ($9.11 in chips)
PlayTheBlues4U: posts small blind $0.05
123tiger711a: posts big blind $0.10
*** HOLE CARDS ***
Dealt to PlayTheBlues4U [Tc 4h]
jmc926: calls $0.10
F3ign: folds
BigBlue: calls $0.10
nando_abarca: calls $0.10
PlayTheBlues4U: calls $0.05
123tiger711a: checks
*** FLOP *** [8c 4d 9s]
PlayTheBlues4U: checks
123tiger711a: checks
jmc926: checks
BigBlue: checks
nando_abarca: checks
*** TURN *** [8c 4d 9s] [3c]
PlayTheBlues4U: checks
123tiger711a: checks
jmc926: checks
BigBlue: bets $0.50
nando_abarca: folds
PlayTheBlues4U: folds
123tiger711a: folds
jmc926: folds
Uncalled bet ($0.50) returned to BigBlue
BigBlue collected $0.48 from pot
BigBlue: doesn't show hand
*** SUMMARY ***
Total pot $0.50 | Rake $0.02
Board [8c 4d 9s 3c]
Seat 1: nando_abarca (button) folded on the Turn
Seat 2: PlayTheBlues4U (small blind) folded on the Turn
Seat 3: 123tiger711a (big blind) folded on the Turn
Seat 4: jmc926 folded on the Turn
Seat 5: F3ign folded before Flop (didn't bet)
Seat 6: BigBlue collected ($0.48)


*********** # 160 **************
PokerStars Hand #203587529960:  Hold'em No Limit ($0.05/$0.10 USD) - 2019/09/10 20:52:25 ET
Table 'Iphigenia' 6-max Seat #5 is the button
Seat 2: nando_abarca ($10.14 in chips)
Seat 3: BigBlue ($3.40 in chips)
Seat 4: F3ign ($24.35 in chips)
Seat 5: PlayTheBlues4U ($11.29 in chips)
Seat 6: RNixon'sHead ($10.32 in chips)
RNixon'sHead: posts small blind $0.05
kid delaw731: is sitting out
nando_abarca: posts big blind $0.10
*** HOLE CARDS ***
Dealt to PlayTheBlues4U [Qh 6c]
BigBlue: folds
F3ign: folds
PlayTheBlues4U: folds
RNixon'sHead: raises $0.20 to $0.30
nando_abarca: calls $0.20
*** FLOP *** [2h Js Th]
RNixon'sHead: bets $0.30
nando_abarca: calls $0.30
*** TURN *** [2h Js Th] [9c]
RNixon'sHead: bets $0.59
nando_abarca: raises $1.16 to $1.75
RNixon'sHead: folds
Uncalled bet ($1.16) returned to nando_abarca
nando_abarca collected $2.26 from pot
nando_abarca: doesn't show hand
*** SUMMARY ***
Total pot $2.38 | Rake $0.12
Board [2h Js Th 9c]
Seat 2: nando_abarca (big blind) collected ($2.26)
Seat 3: BigBlue folded before Flop (didn't bet)
Seat 4: F3ign folded before Flop (didn't bet)
Seat 5: PlayTheBlues4U (button) folded before Flop (didn't bet)
Seat 6: RNixon'sHead (small blind) folded on the Turn


*********** # 161 **************
PokerStars Hand #203587529908:  Hold'em No Limit ($0.05/$0.10 USD) - 2019/09/10 20:52:10 ET
Table 'Iphigenia' 6-max Seat #4 is the button
Seat 1: kid delaw731 ($8.92 in chips)
Seat 2: nando_abarca ($10.14 in chips)
Seat 3: BigBlue ($3.40 in chips)
Seat 4: F3ign ($24.35 in chips)
Seat 5: PlayTheBlues4U ($11.34 in chips)
Seat 6: RNixon'sHead ($10.27 in chips)
PlayTheBlues4U: posts small blind $0.05
RNixon'sHead: posts big blind $0.10
*** HOLE CARDS ***
Dealt to PlayTheBlues4U [Kc 4d]
kid delaw731: folds
nando_abarca: folds
BigBlue: folds
F3ign: folds
PlayTheBlues4U: folds
Uncalled bet ($0.05) returned to RNixon'sHead
RNixon'sHead collected $0.10 from pot
RNixon'sHead: doesn't show hand
*** SUMMARY ***
Total pot $0.10 | Rake $0
Seat 1: kid delaw731 folded before Flop (didn't bet)
Seat 2: nando_abarca folded before Flop (didn't bet)
Seat 3: BigBlue folded before Flop (didn't bet)
Seat 4: F3ign (button) folded before Flop (didn't bet)
Seat 5: PlayTheBlues4U (small blind) folded before Flop
Seat 6: RNixon'sHead (big blind) collected ($0.10)


*********** # 162 **************
PokerStars Hand #203587529906:  Hold'em No Limit ($0.05/$0.10 USD) - 2019/09/10 20:52:10 ET
Table 'Corvus' 6-max Seat #6 is the button
Seat 1: nando_abarca ($9.75 in chips)
Seat 2: PlayTheBlues4U ($13.36 in chips)
Seat 3: 123tiger711a ($14.41 in chips)
Seat 4: jmc926 ($8.01 in chips)
Seat 5: F3ign ($20.52 in chips)
Seat 6: BigBlue ($8.56 in chips)
nando_abarca: posts small blind $0.05
PlayTheBlues4U: posts big blind $0.10
*** HOLE CARDS ***
Dealt to PlayTheBlues4U [7d Ts]
123tiger711a: calls $0.10
jmc926: folds
F3ign: folds
BigBlue: raises $0.35 to $0.45
nando_abarca: folds
PlayTheBlues4U: folds
123tiger711a: calls $0.35
*** FLOP *** [As Ah Jh]
123tiger711a: checks
BigBlue: checks
*** TURN *** [As Ah Jh] [Kc]
123tiger711a: checks
BigBlue: bets $0.70
123tiger711a: folds
Uncalled bet ($0.70) returned to BigBlue
BigBlue collected $1 from pot
BigBlue: doesn't show hand
*** SUMMARY ***
Total pot $1.05 | Rake $0.05
Board [As Ah Jh Kc]
Seat 1: nando_abarca (small blind) folded before Flop
Seat 2: PlayTheBlues4U (big blind) folded before Flop
Seat 3: 123tiger711a folded on the Turn
Seat 4: jmc926 folded before Flop (didn't bet)
Seat 5: F3ign folded before Flop (didn't bet)
Seat 6: BigBlue (button) collected ($1)


*********** # 163 **************
PokerStars Hand #203587529790:  Hold'em No Limit ($0.05/$0.10 USD) - 2019/09/10 20:51:39 ET
Table 'Iphigenia' 6-max Seat #3 is the button
Seat 1: kid delaw731 ($8.92 in chips)
Seat 2: nando_abarca ($10 in chips)
Seat 3: BigBlue ($3.40 in chips)
Seat 4: F3ign ($24.40 in chips)
Seat 5: PlayTheBlues4U ($11.44 in chips)
F3ign: posts small blind $0.05
PlayTheBlues4U: posts big blind $0.10
RNixon'sHead: sits out
*** HOLE CARDS ***
Dealt to PlayTheBlues4U [2d 2h]
kid delaw731: folds
nando_abarca: calls $0.10
BigBlue: folds
F3ign: folds
PlayTheBlues4U: checks
*** FLOP *** [7h 6s Th]
PlayTheBlues4U: checks
nando_abarca: bets $0.24
PlayTheBlues4U: folds
Uncalled bet ($0.24) returned to nando_abarca
nando_abarca collected $0.24 from pot
nando_abarca: doesn't show hand
*** SUMMARY ***
Total pot $0.25 | Rake $0.01
Board [7h 6s Th]
Seat 1: kid delaw731 folded before Flop (didn't bet)
Seat 2: nando_abarca collected ($0.24)
Seat 3: BigBlue (button) folded before Flop (didn't bet)
Seat 4: F3ign (small blind) folded before Flop
Seat 5: PlayTheBlues4U (big blind) folded on the Flop


*********** # 164 **************
PokerStars Hand #203587529692:  Hold'em No Limit ($0.05/$0.10 USD) - 2019/09/10 20:51:10 ET
Table 'Corvus' 6-max Seat #5 is the button
Seat 1: nando_abarca ($9.85 in chips)
Seat 2: PlayTheBlues4U ($11.75 in chips)
Seat 3: 123tiger711a ($14.41 in chips)
Seat 4: jmc926 ($9.64 in chips)
Seat 5: F3ign ($20.52 in chips)
Seat 6: BigBlue ($8.61 in chips)
BigBlue: posts small blind $0.05
nando_abarca: posts big blind $0.10
*** HOLE CARDS ***
Dealt to PlayTheBlues4U [Js Jh]
PlayTheBlues4U: raises $0.20 to $0.30
123tiger711a: folds
jmc926: calls $0.30
F3ign: folds
BigBlue: folds
nando_abarca: folds
*** FLOP *** [Tc 8d 6h]
PlayTheBlues4U: bets $0.50
jmc926: calls $0.50
*** TURN *** [Tc 8d 6h] [5c]
PlayTheBlues4U: checks
jmc926: bets $0.83
PlayTheBlues4U: calls $0.83
*** RIVER *** [Tc 8d 6h 5c] [3s]
PlayTheBlues4U: checks
jmc926: checks
*** SHOW DOWN ***
PlayTheBlues4U: shows [Js Jh] (a pair of Jacks)
jmc926: mucks hand
PlayTheBlues4U collected $3.24 from pot
*** SUMMARY ***
Total pot $3.41 | Rake $0.17
Board [Tc 8d 6h 5c 3s]
Seat 1: nando_abarca (big blind) folded before Flop
Seat 2: PlayTheBlues4U showed [Js Jh] and won ($3.24) with a pair of Jacks
Seat 3: 123tiger711a folded before Flop (didn't bet)
Seat 4: jmc926 mucked [Ts Ac]
Seat 5: F3ign (button) folded before Flop (didn't bet)
Seat 6: BigBlue (small blind) folded before Flop


*********** # 165 **************
PokerStars Hand #203587529577:  Hold'em No Limit ($0.05/$0.10 USD) - 2019/09/10 20:50:41 ET
Table 'Corvus' 6-max Seat #4 is the button
Seat 1: nando_abarca ($9.95 in chips)
Seat 2: PlayTheBlues4U ($11.50 in chips)
Seat 3: 123tiger711a ($14.41 in chips)
Seat 4: jmc926 ($9.64 in chips)
Seat 5: F3ign ($20.57 in chips)
Seat 6: BigBlue ($8.71 in chips)
F3ign: posts small blind $0.05
BigBlue: posts big blind $0.10
*** HOLE CARDS ***
Dealt to PlayTheBlues4U [Qs Qc]
nando_abarca: calls $0.10
PlayTheBlues4U: raises $0.30 to $0.40
123tiger711a: folds
jmc926: folds
F3ign: folds
BigBlue: folds
nando_abarca: folds
Uncalled bet ($0.30) returned to PlayTheBlues4U
PlayTheBlues4U collected $0.35 from pot
PlayTheBlues4U: doesn't show hand
*** SUMMARY ***
Total pot $0.35 | Rake $0
Seat 1: nando_abarca folded before Flop
Seat 2: PlayTheBlues4U collected ($0.35)
Seat 3: 123tiger711a folded before Flop (didn't bet)
Seat 4: jmc926 (button) folded before Flop (didn't bet)
Seat 5: F3ign (small blind) folded before Flop
Seat 6: BigBlue (big blind) folded before Flop


*********** # 166 **************
PokerStars Hand #203587529430:  Hold'em No Limit ($0.05/$0.10 USD) - 2019/09/10 20:49:57 ET
Table 'Iphigenia' 6-max Seat #2 is the button
Seat 1: kid delaw731 ($9.02 in chips)
Seat 2: nando_abarca ($6.61 in chips)
Seat 3: BigBlue ($3.45 in chips)
Seat 4: F3ign ($24.17 in chips)
Seat 5: PlayTheBlues4U ($11.44 in chips)
BigBlue: posts small blind $0.05
F3ign: posts big blind $0.10
RNixon'sHead: sits out
*** HOLE CARDS ***
Dealt to PlayTheBlues4U [6c As]
PlayTheBlues4U: folds
kid delaw731: calls $0.10
nando_abarca: calls $0.10
BigBlue: folds
F3ign: checks
*** FLOP *** [5d 9s 6s]
F3ign: checks
kid delaw731: checks
nando_abarca: checks
*** TURN *** [5d 9s 6s] [5h]
F3ign: checks
kid delaw731: checks
nando_abarca: checks
*** RIVER *** [5d 9s 6s 5h] [2s]
F3ign: checks
kid delaw731: checks
nando_abarca: checks
*** SHOW DOWN ***
F3ign: shows [Td 2c] (two pair, Fives and Deuces)
kid delaw731: mucks hand
nando_abarca: mucks hand
F3ign collected $0.33 from pot
*** SUMMARY ***
Total pot $0.35 | Rake $0.02
Board [5d 9s 6s 5h 2s]
Seat 1: kid delaw731 mucked [7h Ac]
Seat 2: nando_abarca (button) mucked [Ad 7s]
Seat 3: BigBlue (small blind) folded before Flop
Seat 4: F3ign (big blind) showed [Td 2c] and won ($0.33) with two pair, Fives and Deuces
Seat 5: PlayTheBlues4U folded before Flop (didn't bet)


*********** # 167 **************
PokerStars Hand #203587529370:  Hold'em No Limit ($0.05/$0.10 USD) - 2019/09/10 20:49:42 ET
Table 'Corvus' 6-max Seat #3 is the button
Seat 1: nando_abarca ($10.25 in chips)
Seat 2: PlayTheBlues4U ($11.50 in chips)
Seat 3: 123tiger711a ($14.41 in chips)
Seat 4: jmc926 ($9.08 in chips)
Seat 5: F3ign ($20.87 in chips)
Seat 6: BigBlue ($8.71 in chips)
jmc926: posts small blind $0.05
F3ign: posts big blind $0.10
*** HOLE CARDS ***
Dealt to PlayTheBlues4U [3c 8c]
BigBlue: folds
nando_abarca: calls $0.10
PlayTheBlues4U: folds
123tiger711a: folds
jmc926: calls $0.05
F3ign: raises $0.20 to $0.30
nando_abarca: calls $0.20
jmc926: calls $0.20
*** FLOP *** [5h 4c 8s]
jmc926: checks
F3ign: checks
nando_abarca: checks
*** TURN *** [5h 4c 8s] [7s]
jmc926: bets $0.43
F3ign: folds
nando_abarca: folds
Uncalled bet ($0.43) returned to jmc926
jmc926 collected $0.86 from pot
*** SUMMARY ***
Total pot $0.90 | Rake $0.04
Board [5h 4c 8s 7s]
Seat 1: nando_abarca folded on the Turn
Seat 2: PlayTheBlues4U folded before Flop (didn't bet)
Seat 3: 123tiger711a (button) folded before Flop (didn't bet)
Seat 4: jmc926 (small blind) collected ($0.86)
Seat 5: F3ign (big blind) folded on the Turn
Seat 6: BigBlue folded before Flop (didn't bet)


*********** # 168 **************
PokerStars Hand #203587529321:  Hold'em No Limit ($0.05/$0.10 USD) - 2019/09/10 20:49:31 ET
Table 'Iphigenia' 6-max Seat #1 is the button
Seat 1: kid delaw731 ($9.02 in chips)
Seat 2: nando_abarca ($6.71 in chips)
Seat 3: BigBlue ($3.36 in chips)
Seat 4: F3ign ($24.17 in chips)
Seat 5: PlayTheBlues4U ($11.44 in chips)
nando_abarca: posts small blind $0.05
BigBlue: posts big blind $0.10
*** HOLE CARDS ***
Dealt to PlayTheBlues4U [Qh 2s]
F3ign: folds
PlayTheBlues4U: folds
kid delaw731: folds
yn21 leaves the table
nando_abarca: calls $0.05
RNixon'sHead joins the table at seat #6
BigBlue: checks
*** FLOP *** [8c As 2d]
nando_abarca: checks
BigBlue: checks
*** TURN *** [8c As 2d] [Jd]
nando_abarca: checks
BigBlue: checks
*** RIVER *** [8c As 2d Jd] [Th]
nando_abarca: checks
BigBlue: checks
*** SHOW DOWN ***
nando_abarca: shows [Ks 3s] (high card Ace)
BigBlue: shows [Qd 2h] (a pair of Deuces)
BigBlue collected $0.19 from pot
*** SUMMARY ***
Total pot $0.20 | Rake $0.01
Board [8c As 2d Jd Th]
Seat 1: kid delaw731 (button) folded before Flop (didn't bet)
Seat 2: nando_abarca (small blind) showed [Ks 3s] and lost with high card Ace
Seat 3: BigBlue (big blind) showed [Qd 2h] and won ($0.19) with a pair of Deuces
Seat 4: F3ign folded before Flop (didn't bet)
Seat 5: PlayTheBlues4U folded before Flop (didn't bet)


*********** # 169 **************
PokerStars Hand #203587529264:  Hold'em No Limit ($0.05/$0.10 USD) - 2019/09/10 20:49:15 ET
Table 'Corvus' 6-max Seat #2 is the button
Seat 1: nando_abarca ($10.25 in chips)
Seat 2: PlayTheBlues4U ($11.50 in chips)
Seat 3: 123tiger711a ($14.32 in chips)
Seat 4: jmc926 ($9.18 in chips)
Seat 5: F3ign ($20.87 in chips)
Seat 6: BigBlue ($8.71 in chips)
123tiger711a: posts small blind $0.05
jmc926: posts big blind $0.10
*** HOLE CARDS ***
Dealt to PlayTheBlues4U [Qh 4d]
F3ign: folds
BigBlue: folds
nando_abarca: folds
PlayTheBlues4U: folds
123tiger711a: calls $0.05
jmc926: checks
*** FLOP *** [Jd Ac Ad]
123tiger711a: checks
jmc926: checks
*** TURN *** [Jd Ac Ad] [Qd]
123tiger711a: bets $0.10
jmc926: folds
Uncalled bet ($0.10) returned to 123tiger711a
123tiger711a collected $0.19 from pot
*** SUMMARY ***
Total pot $0.20 | Rake $0.01
Board [Jd Ac Ad Qd]
Seat 1: nando_abarca folded before Flop (didn't bet)
Seat 2: PlayTheBlues4U (button) folded before Flop (didn't bet)
Seat 3: 123tiger711a (small blind) collected ($0.19)
Seat 4: jmc926 (big blind) folded on the Turn
Seat 5: F3ign folded before Flop (didn't bet)
Seat 6: BigBlue folded before Flop (didn't bet)


*********** # 170 **************
PokerStars Hand #203587529125:  Hold'em No Limit ($0.05/$0.10 USD) - 2019/09/10 20:48:40 ET
Table 'Corvus' 6-max Seat #1 is the button
Seat 1: nando_abarca ($10.25 in chips)
Seat 2: PlayTheBlues4U ($11.55 in chips)
Seat 3: 123tiger711a ($14.62 in chips)
Seat 4: jmc926 ($9.18 in chips)
Seat 5: F3ign ($20.87 in chips)
Seat 6: BigBlue ($8.39 in chips)
PlayTheBlues4U: posts small blind $0.05
123tiger711a: posts big blind $0.10
*** HOLE CARDS ***
Dealt to PlayTheBlues4U [7c 5c]
jmc926: folds
F3ign: folds
BigBlue: raises $0.20 to $0.30
nando_abarca: folds
PlayTheBlues4U: folds
123tiger711a: calls $0.20
*** FLOP *** [9c 2d Qd]
123tiger711a: checks
BigBlue: checks
*** TURN *** [9c 2d Qd] [7h]
123tiger711a: checks
BigBlue: checks
*** RIVER *** [9c 2d Qd 7h] [8c]
123tiger711a: checks
BigBlue: bets $1
123tiger711a: folds
Uncalled bet ($1) returned to BigBlue
BigBlue collected $0.62 from pot
BigBlue: doesn't show hand
*** SUMMARY ***
Total pot $0.65 | Rake $0.03
Board [9c 2d Qd 7h 8c]
Seat 1: nando_abarca (button) folded before Flop (didn't bet)
Seat 2: PlayTheBlues4U (small blind) folded before Flop
Seat 3: 123tiger711a (big blind) folded on the River
Seat 4: jmc926 folded before Flop (didn't bet)
Seat 5: F3ign folded before Flop (didn't bet)
Seat 6: BigBlue collected ($0.62)


*********** # 171 **************
PokerStars Hand #203587528977:  Hold'em No Limit ($0.05/$0.10 USD) - 2019/09/10 20:48:00 ET
Table 'Corvus' 6-max Seat #6 is the button
Seat 1: nando_abarca ($10.30 in chips)
Seat 2: PlayTheBlues4U ($11.65 in chips)
Seat 3: 123tiger711a ($14.62 in chips)
Seat 4: jmc926 ($8.48 in chips)
Seat 5: F3ign ($21.17 in chips)
Seat 6: BigBlue ($8.69 in chips)
nando_abarca: posts small blind $0.05
PlayTheBlues4U: posts big blind $0.10
*** HOLE CARDS ***
Dealt to PlayTheBlues4U [Ah 4c]
123tiger711a: folds
jmc926: calls $0.10
F3ign: raises $0.20 to $0.30
BigBlue: calls $0.30
nando_abarca: folds
PlayTheBlues4U: folds
jmc926: calls $0.20
*** FLOP *** [7d 3c 6d]
jmc926: bets $0.50
F3ign: folds
BigBlue: folds
Uncalled bet ($0.50) returned to jmc926
jmc926 collected $1 from pot
*** SUMMARY ***
Total pot $1.05 | Rake $0.05
Board [7d 3c 6d]
Seat 1: nando_abarca (small blind) folded before Flop
Seat 2: PlayTheBlues4U (big blind) folded before Flop
Seat 3: 123tiger711a folded before Flop (didn't bet)
Seat 4: jmc926 collected ($1)
Seat 5: F3ign folded on the Flop
Seat 6: BigBlue (button) folded on the Flop


*********** # 172 **************
PokerStars Hand #203587528914:  Hold'em No Limit ($0.05/$0.10 USD) - 2019/09/10 20:47:45 ET
Table 'Corvus' 6-max Seat #5 is the button
Seat 1: nando_abarca ($10.40 in chips)
Seat 2: PlayTheBlues4U ($11.65 in chips)
Seat 3: 123tiger711a ($14.62 in chips)
Seat 4: jmc926 ($8.33 in chips)
Seat 5: F3ign ($21.17 in chips)
Seat 6: BigBlue ($8.74 in chips)
BigBlue: posts small blind $0.05
nando_abarca: posts big blind $0.10
*** HOLE CARDS ***
Dealt to PlayTheBlues4U [Kc 6c]
PlayTheBlues4U: folds
123tiger711a: folds
jmc926: raises $0.25 to $0.35
F3ign: folds
BigBlue: folds
nando_abarca: folds
Uncalled bet ($0.25) returned to jmc926
jmc926 collected $0.25 from pot
*** SUMMARY ***
Total pot $0.25 | Rake $0
Seat 1: nando_abarca (big blind) folded before Flop
Seat 2: PlayTheBlues4U folded before Flop (didn't bet)
Seat 3: 123tiger711a folded before Flop (didn't bet)
Seat 4: jmc926 collected ($0.25)
Seat 5: F3ign (button) folded before Flop (didn't bet)
Seat 6: BigBlue (small blind) folded before Flop


*********** # 173 **************
PokerStars Hand #203587528874:  Hold'em No Limit ($0.05/$0.10 USD) - 2019/09/10 20:47:35 ET
Table 'Iphigenia' 6-max Seat #5 is the button
Seat 1: kid delaw731 ($9.12 in chips)
Seat 2: nando_abarca ($6.81 in chips)
Seat 3: BigBlue ($3.36 in chips)
Seat 4: F3ign ($19.81 in chips)
Seat 5: PlayTheBlues4U ($12.14 in chips)
Seat 6: yn21 ($3.90 in chips)
yn21: posts small blind $0.05
kid delaw731: posts big blind $0.10
*** HOLE CARDS ***
Dealt to PlayTheBlues4U [5s 4s]
nando_abarca: calls $0.10
BigBlue: folds
F3ign: raises $0.20 to $0.30
PlayTheBlues4U: raises $0.40 to $0.70
yn21: calls $0.65
kid delaw731: folds
nando_abarca: folds
F3ign: calls $0.40
*** FLOP *** [9d Th Tc]
yn21: bets $1.09
F3ign: calls $1.09
PlayTheBlues4U: folds
*** TURN *** [9d Th Tc] [4d]
yn21: checks
F3ign: checks
*** RIVER *** [9d Th Tc 4d] [3d]
yn21: bets $2.11 and is all-in
F3ign: calls $2.11
*** SHOW DOWN ***
yn21: shows [Qc Qd] (two pair, Queens and Tens)
F3ign: shows [Td Kd] (a flush, King high)
F3ign collected $8.26 from pot
*** SUMMARY ***
Total pot $8.70 | Rake $0.44
Board [9d Th Tc 4d 3d]
Seat 1: kid delaw731 (big blind) folded before Flop
Seat 2: nando_abarca folded before Flop
Seat 3: BigBlue folded before Flop (didn't bet)
Seat 4: F3ign showed [Td Kd] and won ($8.26) with a flush, King high
Seat 5: PlayTheBlues4U (button) folded on the Flop
Seat 6: yn21 (small blind) showed [Qc Qd] and lost with two pair, Queens and Tens


*********** # 174 **************
PokerStars Hand #203587528638:  Hold'em No Limit ($0.05/$0.10 USD) - 2019/09/10 20:46:37 ET
Table 'Corvus' 6-max Seat #4 is the button
Seat 1: nando_abarca ($10.70 in chips)
Seat 2: PlayTheBlues4U ($11.65 in chips)
Seat 3: 123tiger711a ($14.62 in chips)
Seat 4: jmc926 ($7.92 in chips)
Seat 5: F3ign ($21.22 in chips)
Seat 6: BigBlue ($8.84 in chips)
F3ign: posts small blind $0.05
BigBlue: posts big blind $0.10
*** HOLE CARDS ***
Dealt to PlayTheBlues4U [5h 8s]
nando_abarca: calls $0.10
PlayTheBlues4U: folds
123tiger711a: folds
jmc926: calls $0.10
F3ign: folds
BigBlue: checks
*** FLOP *** [4c 8c 7d]
BigBlue: checks
nando_abarca: checks
jmc926: checks
*** TURN *** [4c 8c 7d] [6h]
BigBlue: checks
nando_abarca: checks
jmc926: checks
*** RIVER *** [4c 8c 7d 6h] [Th]
BigBlue: checks
nando_abarca: checks
jmc926: bets $0.20
BigBlue: folds
nando_abarca: calls $0.20
*** SHOW DOWN ***
jmc926: shows [Kd 9h] (a straight, Six to Ten)
nando_abarca: mucks hand
jmc926 collected $0.71 from pot
*** SUMMARY ***
Total pot $0.75 | Rake $0.04
Board [4c 8c 7d 6h Th]
Seat 1: nando_abarca mucked [Td Qd]
Seat 2: PlayTheBlues4U folded before Flop (didn't bet)
Seat 3: 123tiger711a folded before Flop (didn't bet)
Seat 4: jmc926 (button) showed [Kd 9h] and won ($0.71) with a straight, Six to Ten
Seat 5: F3ign (small blind) folded before Flop
Seat 6: BigBlue (big blind) folded on the River


*********** # 175 **************
PokerStars Hand #203587528614:  Hold'em No Limit ($0.05/$0.10 USD) - 2019/09/10 20:46:32 ET
Table 'Iphigenia' 6-max Seat #4 is the button
Seat 1: kid delaw731 ($9.12 in chips)
Seat 2: nando_abarca ($6.63 in chips)
Seat 3: BigBlue ($3.36 in chips)
Seat 4: F3ign ($19.81 in chips)
Seat 5: PlayTheBlues4U ($12.24 in chips)
Seat 6: yn21 ($4 in chips)
PlayTheBlues4U: posts small blind $0.05
yn21: posts big blind $0.10
*** HOLE CARDS ***
Dealt to PlayTheBlues4U [Th 7d]
kid delaw731: folds
nando_abarca: calls $0.10
BigBlue: folds
F3ign: folds
PlayTheBlues4U: calls $0.05
yn21: checks
*** FLOP *** [3s 6h Jc]
PlayTheBlues4U: checks
yn21: checks
nando_abarca: checks
*** TURN *** [3s 6h Jc] [Qh]
PlayTheBlues4U: checks
yn21: checks
nando_abarca: checks
*** RIVER *** [3s 6h Jc Qh] [2h]
PlayTheBlues4U: checks
yn21: checks
nando_abarca: checks
*** SHOW DOWN ***
PlayTheBlues4U: shows [Th 7d] (high card Queen)
yn21: shows [3d 5s] (a pair of Threes)
nando_abarca: shows [7h 7c] (a pair of Sevens)
nando_abarca collected $0.28 from pot
*** SUMMARY ***
Total pot $0.30 | Rake $0.02
Board [3s 6h Jc Qh 2h]
Seat 1: kid delaw731 folded before Flop (didn't bet)
Seat 2: nando_abarca showed [7h 7c] and won ($0.28) with a pair of Sevens
Seat 3: BigBlue folded before Flop (didn't bet)
Seat 4: F3ign (button) folded before Flop (didn't bet)
Seat 5: PlayTheBlues4U (small blind) showed [Th 7d] and lost with high card Queen
Seat 6: yn21 (big blind) showed [3d 5s] and lost with a pair of Threes


*********** # 176 **************
PokerStars Hand #203587528508:  Hold'em No Limit ($0.05/$0.10 USD) - 2019/09/10 20:46:02 ET
Table 'Corvus' 6-max Seat #3 is the button
Seat 1: nando_abarca ($10.70 in chips)
Seat 2: PlayTheBlues4U ($11.65 in chips)
Seat 3: 123tiger711a ($14.62 in chips)
Seat 4: jmc926 ($7.83 in chips)
Seat 5: F3ign ($21.32 in chips)
Seat 6: BigBlue ($8.84 in chips)
jmc926: posts small blind $0.05
F3ign: posts big blind $0.10
*** HOLE CARDS ***
Dealt to PlayTheBlues4U [Qh Ts]
BigBlue: folds
nando_abarca: folds
PlayTheBlues4U: folds
123tiger711a: folds
jmc926: calls $0.05
F3ign: checks
*** FLOP *** [Js 4h 6s]
jmc926: bets $0.20
F3ign: folds
Uncalled bet ($0.20) returned to jmc926
jmc926 collected $0.19 from pot
*** SUMMARY ***
Total pot $0.20 | Rake $0.01
Board [Js 4h 6s]
Seat 1: nando_abarca folded before Flop (didn't bet)
Seat 2: PlayTheBlues4U folded before Flop (didn't bet)
Seat 3: 123tiger711a (button) folded before Flop (didn't bet)
Seat 4: jmc926 (small blind) collected ($0.19)
Seat 5: F3ign (big blind) folded on the Flop
Seat 6: BigBlue folded before Flop (didn't bet)


*********** # 177 **************
PokerStars Hand #203587528471:  Hold'em No Limit ($0.05/$0.10 USD) - 2019/09/10 20:45:53 ET
Table 'Iphigenia' 6-max Seat #3 is the button
Seat 1: kid delaw731 ($9.12 in chips)
Seat 2: nando_abarca ($7.08 in chips)
Seat 3: BigBlue ($2.81 in chips)
Seat 4: F3ign ($19.86 in chips)
Seat 5: PlayTheBlues4U ($12.34 in chips)
F3ign: posts small blind $0.05
PlayTheBlues4U: posts big blind $0.10
yn21: sits out
*** HOLE CARDS ***
Dealt to PlayTheBlues4U [7c Qh]
kid delaw731: folds
nando_abarca: calls $0.10
BigBlue: raises $0.35 to $0.45
F3ign: folds
PlayTheBlues4U: folds
nando_abarca: calls $0.35
*** FLOP *** [2d 9d Td]
nando_abarca: checks
BigBlue: checks
*** TURN *** [2d 9d Td] [Ah]
nando_abarca: checks
BigBlue: bets $0.60
nando_abarca: folds
Uncalled bet ($0.60) returned to BigBlue
BigBlue collected $1 from pot
BigBlue: doesn't show hand
*** SUMMARY ***
Total pot $1.05 | Rake $0.05
Board [2d 9d Td Ah]
Seat 1: kid delaw731 folded before Flop (didn't bet)
Seat 2: nando_abarca folded on the Turn
Seat 3: BigBlue (button) collected ($1)
Seat 4: F3ign (small blind) folded before Flop
Seat 5: PlayTheBlues4U (big blind) folded before Flop


*********** # 178 **************
PokerStars Hand #203586999885:  Hold'em No Limit ($0.05/$0.10 USD) - 2019/09/10 20:45:04 ET
Table 'Corvus' 6-max Seat #2 is the button
Seat 1: nando_abarca ($10.70 in chips)
Seat 2: PlayTheBlues4U ($11.65 in chips)
Seat 3: 123tiger711a ($14.06 in chips)
Seat 4: jmc926 ($8.13 in chips)
Seat 5: F3ign ($21.62 in chips)
Seat 6: BigBlue ($8.84 in chips)
123tiger711a: posts small blind $0.05
jmc926: posts big blind $0.10
*** HOLE CARDS ***
Dealt to PlayTheBlues4U [Jh 8s]
F3ign: raises $0.20 to $0.30
BigBlue: folds
nando_abarca: folds
PlayTheBlues4U: folds
123tiger711a: calls $0.25
jmc926: calls $0.20
*** FLOP *** [6h 2h 6s]
123tiger711a: checks
jmc926: checks
F3ign: checks
*** TURN *** [6h 2h 6s] [3d]
123tiger711a: bets $0.86
jmc926: folds
F3ign: folds
Uncalled bet ($0.86) returned to 123tiger711a
123tiger711a collected $0.86 from pot
*** SUMMARY ***
Total pot $0.90 | Rake $0.04
Board [6h 2h 6s 3d]
Seat 1: nando_abarca folded before Flop (didn't bet)
Seat 2: PlayTheBlues4U (button) folded before Flop (didn't bet)
Seat 3: 123tiger711a (small blind) collected ($0.86)
Seat 4: jmc926 (big blind) folded on the Turn
Seat 5: F3ign folded on the Turn
Seat 6: BigBlue folded before Flop (didn't bet)


*********** # 179 **************
PokerStars Hand #203586999812:  Hold'em No Limit ($0.05/$0.10 USD) - 2019/09/10 20:44:42 ET
Table 'Iphigenia' 6-max Seat #2 is the button
Seat 1: kid delaw731 ($6.89 in chips)
Seat 2: nando_abarca ($9.40 in chips)
Seat 3: BigBlue ($2.86 in chips)
Seat 4: F3ign ($19.96 in chips)
Seat 5: PlayTheBlues4U ($12.34 in chips)
BigBlue: posts small blind $0.05
F3ign: posts big blind $0.10
yn21: sits out
*** HOLE CARDS ***
Dealt to PlayTheBlues4U [8s 4s]
PlayTheBlues4U: folds
kid delaw731: calls $0.10
nando_abarca: calls $0.10
BigBlue: folds
F3ign: checks
*** FLOP *** [2d Ks 3c]
F3ign: checks
kid delaw731: checks
nando_abarca: bets $0.20
F3ign: folds
kid delaw731: calls $0.20
*** TURN *** [2d Ks 3c] [5c]
kid delaw731: checks
nando_abarca: bets $0.45
kid delaw731: calls $0.45
*** RIVER *** [2d Ks 3c 5c] [Jh]
kid delaw731: bets $1.57
nando_abarca: calls $1.57
*** SHOW DOWN ***
kid delaw731: shows [2c 2s] (three of a kind, Deuces)
nando_abarca: mucks hand
kid delaw731 collected $4.55 from pot
*** SUMMARY ***
Total pot $4.79 | Rake $0.24
Board [2d Ks 3c 5c Jh]
Seat 1: kid delaw731 showed [2c 2s] and won ($4.55) with three of a kind, Deuces
Seat 2: nando_abarca (button) mucked [Jd Kh]
Seat 3: BigBlue (small blind) folded before Flop
Seat 4: F3ign (big blind) folded on the Flop
Seat 5: PlayTheBlues4U folded before Flop (didn't bet)


*********** # 180 **************
PokerStars Hand #203586999759:  Hold'em No Limit ($0.05/$0.10 USD) - 2019/09/10 20:44:25 ET
Table 'Corvus' 6-max Seat #1 is the button
Seat 1: nando_abarca ($9.96 in chips)
Seat 2: PlayTheBlues4U ($11.70 in chips)
Seat 3: 123tiger711a ($14.16 in chips)
Seat 4: jmc926 ($8.79 in chips)
Seat 5: F3ign ($21.62 in chips)
Seat 6: BigBlue ($8.84 in chips)
PlayTheBlues4U: posts small blind $0.05
123tiger711a: posts big blind $0.10
*** HOLE CARDS ***
Dealt to PlayTheBlues4U [Ks 4s]
jmc926: raises $0.20 to $0.30
F3ign: folds
BigBlue: folds
nando_abarca: calls $0.30
PlayTheBlues4U: folds
123tiger711a: folds
*** FLOP *** [3d Qh 9d]
jmc926: bets $0.36
nando_abarca: calls $0.36
*** TURN *** [3d Qh 9d] [9h]
jmc926: checks
nando_abarca: bets $1
jmc926: folds
Uncalled bet ($1) returned to nando_abarca
nando_abarca collected $1.40 from pot
nando_abarca: doesn't show hand
*** SUMMARY ***
Total pot $1.47 | Rake $0.07
Board [3d Qh 9d 9h]
Seat 1: nando_abarca (button) collected ($1.40)
Seat 2: PlayTheBlues4U (small blind) folded before Flop
Seat 3: 123tiger711a (big blind) folded before Flop
Seat 4: jmc926 folded on the Turn
Seat 5: F3ign folded before Flop (didn't bet)
Seat 6: BigBlue folded before Flop (didn't bet)


*********** # 181 **************
PokerStars Hand #203586999654:  Hold'em No Limit ($0.05/$0.10 USD) - 2019/09/10 20:43:56 ET
Table 'Iphigenia' 6-max Seat #1 is the button
Seat 1: kid delaw731 ($6.89 in chips)
Seat 2: nando_abarca ($9.50 in chips)
Seat 3: BigBlue ($3.16 in chips)
Seat 4: F3ign ($19.96 in chips)
Seat 5: PlayTheBlues4U ($11.98 in chips)
nando_abarca: posts small blind $0.05
BigBlue: posts big blind $0.10
*** HOLE CARDS ***
Dealt to PlayTheBlues4U [7c 7s]
F3ign: folds
PlayTheBlues4U: calls $0.10
kid delaw731: folds
nando_abarca: calls $0.05
BigBlue: checks
*** FLOP *** [Kh 6s 9c]
nando_abarca: checks
yn21 joins the table at seat #6
BigBlue: bets $0.20
PlayTheBlues4U: calls $0.20
nando_abarca: folds
*** TURN *** [Kh 6s 9c] [8s]
BigBlue: checks
PlayTheBlues4U: bets $0.40
BigBlue: folds
Uncalled bet ($0.40) returned to PlayTheBlues4U
PlayTheBlues4U collected $0.66 from pot
PlayTheBlues4U: doesn't show hand
*** SUMMARY ***
Total pot $0.70 | Rake $0.04
Board [Kh 6s 9c 8s]
Seat 1: kid delaw731 (button) folded before Flop (didn't bet)
Seat 2: nando_abarca (small blind) folded on the Flop
Seat 3: BigBlue (big blind) folded on the Turn
Seat 4: F3ign folded before Flop (didn't bet)
Seat 5: PlayTheBlues4U collected ($0.66)


*********** # 182 **************
PokerStars Hand #203586999596:  Hold'em No Limit ($0.05/$0.10 USD) - 2019/09/10 20:43:38 ET
Table 'Corvus' 6-max Seat #6 is the button
Seat 1: nando_abarca ($10.01 in chips)
Seat 2: PlayTheBlues4U ($12.15 in chips)
Seat 3: 123tiger711a ($14.61 in chips)
Seat 4: jmc926 ($8.79 in chips)
Seat 5: F3ign ($21.62 in chips)
Seat 6: BigBlue ($7.96 in chips)
nando_abarca: posts small blind $0.05
PlayTheBlues4U: posts big blind $0.10
*** HOLE CARDS ***
Dealt to PlayTheBlues4U [Kc Qh]
123tiger711a: calls $0.10
jmc926: folds
F3ign: folds
BigBlue: raises $0.35 to $0.45
nando_abarca: folds
PlayTheBlues4U: calls $0.35
123tiger711a: calls $0.35
*** FLOP *** [8d Jh 7h]
PlayTheBlues4U: checks
123tiger711a: checks
BigBlue: bets $0.80
PlayTheBlues4U: folds
123tiger711a: folds
Uncalled bet ($0.80) returned to BigBlue
BigBlue collected $1.33 from pot
BigBlue: doesn't show hand
*** SUMMARY ***
Total pot $1.40 | Rake $0.07
Board [8d Jh 7h]
Seat 1: nando_abarca (small blind) folded before Flop
Seat 2: PlayTheBlues4U (big blind) folded on the Flop
Seat 3: 123tiger711a folded on the Flop
Seat 4: jmc926 folded before Flop (didn't bet)
Seat 5: F3ign folded before Flop (didn't bet)
Seat 6: BigBlue (button) collected ($1.33)


*********** # 183 **************
PokerStars Hand #203586999542:  Hold'em No Limit ($0.05/$0.10 USD) - 2019/09/10 20:43:21 ET
Table 'Iphigenia' 6-max Seat #5 is the button
Seat 1: kid delaw731 ($6.94 in chips)
Seat 2: nando_abarca ($9.60 in chips)
Seat 3: BigBlue ($3.16 in chips)
Seat 4: F3ign ($19.96 in chips)
Seat 5: PlayTheBlues4U ($11.83 in chips)
kid delaw731: posts small blind $0.05
nando_abarca: posts big blind $0.10
*** HOLE CARDS ***
Dealt to PlayTheBlues4U [Jc 9c]
BigBlue: folds
F3ign: folds
PlayTheBlues4U: raises $0.10 to $0.20
kid delaw731: folds
nando_abarca: folds
Uncalled bet ($0.10) returned to PlayTheBlues4U
PlayTheBlues4U collected $0.25 from pot
PlayTheBlues4U: doesn't show hand
*** SUMMARY ***
Total pot $0.25 | Rake $0
Seat 1: kid delaw731 (small blind) folded before Flop
Seat 2: nando_abarca (big blind) folded before Flop
Seat 3: BigBlue folded before Flop (didn't bet)
Seat 4: F3ign folded before Flop (didn't bet)
Seat 5: PlayTheBlues4U (button) collected ($0.25)


*********** # 184 **************
PokerStars Hand #203586999448:  Hold'em No Limit ($0.05/$0.10 USD) - 2019/09/10 20:42:58 ET
Table 'Corvus' 6-max Seat #5 is the button
Seat 1: nando_abarca ($9.87 in chips)
Seat 2: PlayTheBlues4U ($12.15 in chips)
Seat 3: 123tiger711a ($14.61 in chips)
Seat 4: jmc926 ($8.89 in chips)
Seat 5: F3ign ($21.62 in chips)
Seat 6: BigBlue ($8.01 in chips)
BigBlue: posts small blind $0.05
nando_abarca: posts big blind $0.10
*** HOLE CARDS ***
Dealt to PlayTheBlues4U [7s 8h]
PlayTheBlues4U: folds
123tiger711a: folds
jmc926: calls $0.10
F3ign: folds
BigBlue: folds
nando_abarca: checks
*** FLOP *** [4s 6s 4h]
nando_abarca: checks
jmc926: checks
*** TURN *** [4s 6s 4h] [Kh]
nando_abarca: checks
jmc926: checks
*** RIVER *** [4s 6s 4h Kh] [Jh]
nando_abarca: checks
jmc926: checks
*** SHOW DOWN ***
nando_abarca: shows [8c 8s] (two pair, Eights and Fours)
jmc926: mucks hand
nando_abarca collected $0.24 from pot
*** SUMMARY ***
Total pot $0.25 | Rake $0.01
Board [4s 6s 4h Kh Jh]
Seat 1: nando_abarca (big blind) showed [8c 8s] and won ($0.24) with two pair, Eights and Fours
Seat 2: PlayTheBlues4U folded before Flop (didn't bet)
Seat 3: 123tiger711a folded before Flop (didn't bet)
Seat 4: jmc926 mucked [Qd 8d]
Seat 5: F3ign (button) folded before Flop (didn't bet)
Seat 6: BigBlue (small blind) folded before Flop


*********** # 185 **************
PokerStars Hand #203586999396:  Hold'em No Limit ($0.05/$0.10 USD) - 2019/09/10 20:42:44 ET
Table 'Corvus' 6-max Seat #4 is the button
Seat 1: nando_abarca ($9.87 in chips)
Seat 2: PlayTheBlues4U ($12.15 in chips)
Seat 3: 123tiger711a ($14.61 in chips)
Seat 4: jmc926 ($8.89 in chips)
Seat 5: F3ign ($21.67 in chips)
Seat 6: BigBlue ($7.96 in chips)
F3ign: posts small blind $0.05
BigBlue: posts big blind $0.10
*** HOLE CARDS ***
Dealt to PlayTheBlues4U [Qh 5c]
nando_abarca: folds
PlayTheBlues4U: folds
123tiger711a: folds
jmc926: folds
F3ign: folds
Uncalled bet ($0.05) returned to BigBlue
BigBlue collected $0.10 from pot
BigBlue: doesn't show hand
*** SUMMARY ***
Total pot $0.10 | Rake $0
Seat 1: nando_abarca folded before Flop (didn't bet)
Seat 2: PlayTheBlues4U folded before Flop (didn't bet)
Seat 3: 123tiger711a folded before Flop (didn't bet)
Seat 4: jmc926 (button) folded before Flop (didn't bet)
Seat 5: F3ign (small blind) folded before Flop
Seat 6: BigBlue (big blind) collected ($0.10)


*********** # 186 **************
PokerStars Hand #203586999334:  Hold'em No Limit ($0.05/$0.10 USD) - 2019/09/10 20:42:28 ET
Table 'Iphigenia' 6-max Seat #4 is the button
Seat 1: kid delaw731 ($6.53 in chips)
Seat 2: nando_abarca ($9.60 in chips)
Seat 3: BigBlue ($3.46 in chips)
Seat 4: F3ign ($19.96 in chips)
Seat 5: PlayTheBlues4U ($11.88 in chips)
Seat 6: mikimax2.1 ($9.70 in chips)
PlayTheBlues4U: posts small blind $0.05
mikimax2.1: posts big blind $0.10
*** HOLE CARDS ***
Dealt to PlayTheBlues4U [4c Qd]
kid delaw731: raises $0.20 to $0.30
nando_abarca: folds
BigBlue: calls $0.30
F3ign: folds
PlayTheBlues4U: folds
mikimax2.1: folds
*** FLOP *** [7s 8h Ah]
mikimax2.1 leaves the table
kid delaw731: bets $0.38
BigBlue: folds
Uncalled bet ($0.38) returned to kid delaw731
kid delaw731 collected $0.71 from pot
kid delaw731: doesn't show hand
*** SUMMARY ***
Total pot $0.75 | Rake $0.04
Board [7s 8h Ah]
Seat 1: kid delaw731 collected ($0.71)
Seat 2: nando_abarca folded before Flop (didn't bet)
Seat 3: BigBlue folded on the Flop
Seat 4: F3ign (button) folded before Flop (didn't bet)
Seat 5: PlayTheBlues4U (small blind) folded before Flop
Seat 6: mikimax2.1 (big blind) folded before Flop


*********** # 187 **************
PokerStars Hand #203586999207:  Hold'em No Limit ($0.05/$0.10 USD) - 2019/09/10 20:41:50 ET
Table 'Corvus' 6-max Seat #3 is the button
Seat 1: nando_abarca ($9.87 in chips)
Seat 2: PlayTheBlues4U ($12.15 in chips)
Seat 3: 123tiger711a ($15.11 in chips)
Seat 4: jmc926 ($7.87 in chips)
Seat 5: F3ign ($22.17 in chips)
Seat 6: BigBlue ($8.06 in chips)
jmc926: posts small blind $0.05
F3ign: posts big blind $0.10
*** HOLE CARDS ***
Dealt to PlayTheBlues4U [Qd 9d]
BigBlue: calls $0.10
nando_abarca: folds
PlayTheBlues4U: folds
123tiger711a: calls $0.10
jmc926: calls $0.05
F3ign: raises $0.40 to $0.50
BigBlue: folds
123tiger711a: calls $0.40
jmc926: calls $0.40
*** FLOP *** [5h 6c Th]
jmc926: bets $0.76
F3ign: folds
123tiger711a: folds
Uncalled bet ($0.76) returned to jmc926
jmc926 collected $1.52 from pot
*** SUMMARY ***
Total pot $1.60 | Rake $0.08
Board [5h 6c Th]
Seat 1: nando_abarca folded before Flop (didn't bet)
Seat 2: PlayTheBlues4U folded before Flop (didn't bet)
Seat 3: 123tiger711a (button) folded on the Flop
Seat 4: jmc926 (small blind) collected ($1.52)
Seat 5: F3ign (big blind) folded on the Flop
Seat 6: BigBlue folded before Flop


*********** # 188 **************
PokerStars Hand #203586999144:  Hold'em No Limit ($0.05/$0.10 USD) - 2019/09/10 20:41:32 ET
Table 'Corvus' 6-max Seat #2 is the button
Seat 1: nando_abarca ($9.87 in chips)
Seat 2: PlayTheBlues4U ($12 in chips)
Seat 3: 123tiger711a ($15.16 in chips)
Seat 4: jmc926 ($7.97 in chips)
Seat 6: BigBlue ($8.06 in chips)
123tiger711a: posts small blind $0.05
jmc926: posts big blind $0.10
F3ign: sits out
*** HOLE CARDS ***
Dealt to PlayTheBlues4U [Kh Ks]
BigBlue: folds
nando_abarca: folds
PlayTheBlues4U: raises $0.20 to $0.30
123tiger711a: folds
jmc926: folds
Uncalled bet ($0.20) returned to PlayTheBlues4U
PlayTheBlues4U collected $0.25 from pot
PlayTheBlues4U: doesn't show hand
*** SUMMARY ***
Total pot $0.25 | Rake $0
Seat 1: nando_abarca folded before Flop (didn't bet)
Seat 2: PlayTheBlues4U (button) collected ($0.25)
Seat 3: 123tiger711a (small blind) folded before Flop
Seat 4: jmc926 (big blind) folded before Flop
Seat 6: BigBlue folded before Flop (didn't bet)


*********** # 189 **************
PokerStars Hand #203586999128:  Hold'em No Limit ($0.05/$0.10 USD) - 2019/09/10 20:41:27 ET
Table 'Iphigenia' 6-max Seat #3 is the button
Seat 1: kid delaw731 ($6.53 in chips)
Seat 2: nando_abarca ($9.70 in chips)
Seat 3: BigBlue ($3.46 in chips)
Seat 4: F3ign ($20.01 in chips)
Seat 5: PlayTheBlues4U ($11.47 in chips)
Seat 6: mikimax2.1 ($10 in chips)
F3ign: posts small blind $0.05
PlayTheBlues4U: posts big blind $0.10
*** HOLE CARDS ***
Dealt to PlayTheBlues4U [5s Kh]
mikimax2.1: calls $0.10
kid delaw731: folds
nando_abarca: calls $0.10
BigBlue: folds
F3ign: folds
PlayTheBlues4U: checks
*** FLOP *** [Ts 5c Jd]
PlayTheBlues4U: checks
mikimax2.1: checks
nando_abarca: checks
*** TURN *** [Ts 5c Jd] [3h]
PlayTheBlues4U: bets $0.20
mikimax2.1: calls $0.20
nando_abarca: folds
*** RIVER *** [Ts 5c Jd 3h] [2c]
PlayTheBlues4U: checks
mikimax2.1: checks
*** SHOW DOWN ***
PlayTheBlues4U: shows [5s Kh] (a pair of Fives)
mikimax2.1: mucks hand
PlayTheBlues4U collected $0.71 from pot
*** SUMMARY ***
Total pot $0.75 | Rake $0.04
Board [Ts 5c Jd 3h 2c]
Seat 1: kid delaw731 folded before Flop (didn't bet)
Seat 2: nando_abarca folded on the Turn
Seat 3: BigBlue (button) folded before Flop (didn't bet)
Seat 4: F3ign (small blind) folded before Flop
Seat 5: PlayTheBlues4U (big blind) showed [5s Kh] and won ($0.71) with a pair of Fives
Seat 6: mikimax2.1 mucked [Ks Qs]


*********** # 190 **************
PokerStars Hand #203586999011:  Hold'em No Limit ($0.05/$0.10 USD) - 2019/09/10 20:40:52 ET
Table 'Corvus' 6-max Seat #1 is the button
Seat 1: nando_abarca ($9.87 in chips)
Seat 2: PlayTheBlues4U ($12.05 in chips)
Seat 3: 123tiger711a ($11.46 in chips)
Seat 4: jmc926 ($8.07 in chips)
Seat 6: BigBlue ($12.01 in chips)
PlayTheBlues4U: posts small blind $0.05
123tiger711a: posts big blind $0.10
F3ign: sits out
*** HOLE CARDS ***
Dealt to PlayTheBlues4U [Jd 8d]
jmc926: calls $0.10
BigBlue: raises $0.35 to $0.45
nando_abarca: folds
PlayTheBlues4U: folds
123tiger711a: calls $0.35
jmc926: folds
*** FLOP *** [8s 7s 7c]
123tiger711a: checks
BigBlue: checks
*** TURN *** [8s 7s 7c] [Kd]
123tiger711a: bets $0.50
BigBlue: raises $1 to $1.50
123tiger711a: calls $1
*** RIVER *** [8s 7s 7c Kd] [4d]
123tiger711a: checks
BigBlue: bets $2
123tiger711a: calls $2
*** SHOW DOWN ***
BigBlue: shows [3c 5c] (a pair of Sevens)
123tiger711a: shows [Kc Ah] (two pair, Kings and Sevens)
123tiger711a collected $7.65 from pot
*** SUMMARY ***
Total pot $8.05 | Rake $0.40
Board [8s 7s 7c Kd 4d]
Seat 1: nando_abarca (button) folded before Flop (didn't bet)
Seat 2: PlayTheBlues4U (small blind) folded before Flop
Seat 3: 123tiger711a (big blind) showed [Kc Ah] and won ($7.65) with two pair, Kings and Sevens
Seat 4: jmc926 folded before Flop
Seat 6: BigBlue showed [3c 5c] and lost with a pair of Sevens


*********** # 191 **************
PokerStars Hand #203586998965:  Hold'em No Limit ($0.05/$0.10 USD) - 2019/09/10 20:40:39 ET
Table 'Iphigenia' 6-max Seat #2 is the button
Seat 1: kid delaw731 ($6.53 in chips)
Seat 2: nando_abarca ($9.80 in chips)
Seat 3: BigBlue ($3.51 in chips)
Seat 4: F3ign ($20.11 in chips)
Seat 5: PlayTheBlues4U ($11.47 in chips)
Seat 6: mikimax2.1 ($9.77 in chips)
BigBlue: posts small blind $0.05
F3ign: posts big blind $0.10
mikimax2.1: posts small & big blinds $0.15
*** HOLE CARDS ***
Dealt to PlayTheBlues4U [7c 4h]
PlayTheBlues4U: folds
mikimax2.1: checks
kid delaw731: folds
nando_abarca: calls $0.10
BigBlue: folds
F3ign: checks
*** FLOP *** [3s 6d 2h]
F3ign: checks
mikimax2.1: bets $0.40
nando_abarca: folds
F3ign: folds
Uncalled bet ($0.40) returned to mikimax2.1
mikimax2.1 collected $0.38 from pot
mikimax2.1: doesn't show hand
*** SUMMARY ***
Total pot $0.40 | Rake $0.02
Board [3s 6d 2h]
Seat 1: kid delaw731 folded before Flop (didn't bet)
Seat 2: nando_abarca (button) folded on the Flop
Seat 3: BigBlue (small blind) folded before Flop
Seat 4: F3ign (big blind) folded on the Flop
Seat 5: PlayTheBlues4U folded before Flop (didn't bet)
Seat 6: mikimax2.1 collected ($0.38)


*********** # 192 **************
PokerStars Hand #203586998816:  Hold'em No Limit ($0.05/$0.10 USD) - 2019/09/10 20:39:58 ET
Table 'Iphigenia' 6-max Seat #1 is the button
Seat 1: kid delaw731 ($6.53 in chips)
Seat 2: nando_abarca ($9.90 in chips)
Seat 3: BigBlue ($3.42 in chips)
Seat 5: PlayTheBlues4U ($11.47 in chips)
nando_abarca: posts small blind $0.05
BigBlue: posts big blind $0.10
F3ign: sits out
mikimax2.1 has timed out
mikimax2.1: is sitting out
*** HOLE CARDS ***
Dealt to PlayTheBlues4U [Qd 7d]
PlayTheBlues4U: folds
kid delaw731: folds
nando_abarca: calls $0.05
BigBlue: checks
*** FLOP *** [2c Kd 6d]
nando_abarca: checks
BigBlue: bets $0.10
nando_abarca: folds
Uncalled bet ($0.10) returned to BigBlue
BigBlue collected $0.19 from pot
BigBlue: doesn't show hand
*** SUMMARY ***
Total pot $0.20 | Rake $0.01
Board [2c Kd 6d]
Seat 1: kid delaw731 (button) folded before Flop (didn't bet)
Seat 2: nando_abarca (small blind) folded on the Flop
Seat 3: BigBlue (big blind) collected ($0.19)
Seat 5: PlayTheBlues4U folded before Flop (didn't bet)


*********** # 193 **************
PokerStars Hand #203586998813:  Hold'em No Limit ($0.05/$0.10 USD) - 2019/09/10 20:39:57 ET
Table 'Corvus' 6-max Seat #6 is the button
Seat 1: nando_abarca ($9.92 in chips)
Seat 2: PlayTheBlues4U ($10.49 in chips)
Seat 3: 123tiger711a ($11.46 in chips)
Seat 4: jmc926 ($9.75 in chips)
Seat 6: BigBlue ($12.01 in chips)
nando_abarca: posts small blind $0.05
PlayTheBlues4U: posts big blind $0.10
F3ign: sits out
*** HOLE CARDS ***
Dealt to PlayTheBlues4U [Kc 2c]
123tiger711a: folds
jmc926: raises $0.10 to $0.20
BigBlue: folds
nando_abarca: folds
PlayTheBlues4U: calls $0.10
*** FLOP *** [2s Ts Kh]
PlayTheBlues4U: checks
jmc926: bets $0.22
PlayTheBlues4U: calls $0.22
*** TURN *** [2s Ts Kh] [5h]
PlayTheBlues4U: checks
jmc926: bets $0.43
PlayTheBlues4U: raises $0.83 to $1.26
jmc926: calls $0.83
*** RIVER *** [2s Ts Kh 5h] [8d]
PlayTheBlues4U: checks
jmc926: checks
*** SHOW DOWN ***
PlayTheBlues4U: shows [Kc 2c] (two pair, Kings and Deuces)
jmc926: mucks hand
PlayTheBlues4U collected $3.24 from pot
*** SUMMARY ***
Total pot $3.41 | Rake $0.17
Board [2s Ts Kh 5h 8d]
Seat 1: nando_abarca (small blind) folded before Flop
Seat 2: PlayTheBlues4U (big blind) showed [Kc 2c] and won ($3.24) with two pair, Kings and Deuces
Seat 3: 123tiger711a folded before Flop (didn't bet)
Seat 4: jmc926 mucked [Th Qs]
Seat 6: BigBlue (button) folded before Flop (didn't bet)


*********** # 194 **************
PokerStars Hand #203586998747:  Hold'em No Limit ($0.05/$0.10 USD) - 2019/09/10 20:39:38 ET
Table 'Iphigenia' 6-max Seat #5 is the button
Seat 1: kid delaw731 ($6.44 in chips)
Seat 2: nando_abarca ($10 in chips)
Seat 3: BigBlue ($3.42 in chips)
Seat 5: PlayTheBlues4U ($11.47 in chips)
mikimax2.1 will be allowed to play after the button
kid delaw731: posts small blind $0.05
nando_abarca: posts big blind $0.10
F3ign: sits out
*** HOLE CARDS ***
Dealt to PlayTheBlues4U [4s Kd]
BigBlue: folds
PlayTheBlues4U: folds
kid delaw731: calls $0.05
nando_abarca: checks
*** FLOP *** [5c Ah 3d]
kid delaw731: bets $0.14
nando_abarca: folds
Uncalled bet ($0.14) returned to kid delaw731
kid delaw731 collected $0.19 from pot
kid delaw731: doesn't show hand
*** SUMMARY ***
Total pot $0.20 | Rake $0.01
Board [5c Ah 3d]
Seat 1: kid delaw731 (small blind) collected ($0.19)
Seat 2: nando_abarca (big blind) folded on the Flop
Seat 3: BigBlue folded before Flop (didn't bet)
Seat 5: PlayTheBlues4U (button) folded before Flop (didn't bet)


*********** # 195 **************
PokerStars Hand #203586998657:  Hold'em No Limit ($0.05/$0.10 USD) - 2019/09/10 20:39:13 ET
Table 'Corvus' 6-max Seat #4 is the button
Seat 1: nando_abarca ($9.78 in chips)
Seat 2: PlayTheBlues4U ($10.49 in chips)
Seat 3: 123tiger711a ($11.46 in chips)
Seat 4: jmc926 ($9.85 in chips)
Seat 6: BigBlue ($12.06 in chips)
BigBlue: posts small blind $0.05
nando_abarca: posts big blind $0.10
*** HOLE CARDS ***
Dealt to PlayTheBlues4U [Td 7c]
PlayTheBlues4U: folds
123tiger711a: folds
jmc926: calls $0.10
BigBlue: folds
nando_abarca: checks
*** FLOP *** [9s Ts 8h]
nando_abarca: checks
jmc926: checks
*** TURN *** [9s Ts 8h] [8d]
nando_abarca: checks
jmc926: checks
*** RIVER *** [9s Ts 8h 8d] [Js]
nando_abarca: checks
jmc926: checks
*** SHOW DOWN ***
nando_abarca: shows [4c 7s] (a straight, Seven to Jack)
jmc926: mucks hand
nando_abarca collected $0.24 from pot
*** SUMMARY ***
Total pot $0.25 | Rake $0.01
Board [9s Ts 8h 8d Js]
Seat 1: nando_abarca (big blind) showed [4c 7s] and won ($0.24) with a straight, Seven to Jack
Seat 2: PlayTheBlues4U folded before Flop (didn't bet)
Seat 3: 123tiger711a folded before Flop (didn't bet)
Seat 4: jmc926 (button) mucked [8s 6h]
Seat 6: BigBlue (small blind) folded before Flop


*********** # 196 **************
PokerStars Hand #203586998525:  Hold'em No Limit ($0.05/$0.10 USD) - 2019/09/10 20:38:36 ET
Table 'Iphigenia' 6-max Seat #3 is the button
Seat 1: kid delaw731 ($7.14 in chips)
Seat 2: walttm ($10.73 in chips)
Seat 3: BigBlue ($3.42 in chips)
Seat 5: PlayTheBlues4U ($10.84 in chips)
PlayTheBlues4U: posts small blind $0.05
mikimax2.1 is disconnected
mikimax2.1 has timed out
mikimax2.1: is sitting out
kid delaw731: posts big blind $0.10
*** HOLE CARDS ***
Dealt to PlayTheBlues4U [Ah Ks]
walttm: folds
BigBlue: folds
PlayTheBlues4U: raises $0.20 to $0.30
kid delaw731: calls $0.20
*** FLOP *** [Kd Kc 6s]
walttm leaves the table
nando_abarca joins the table at seat #2
PlayTheBlues4U: bets $0.40
kid delaw731: calls $0.40
*** TURN *** [Kd Kc 6s] [Ac]
PlayTheBlues4U: bets $1
kid delaw731: folds
Uncalled bet ($1) returned to PlayTheBlues4U
PlayTheBlues4U collected $1.33 from pot
PlayTheBlues4U: doesn't show hand
*** SUMMARY ***
Total pot $1.40 | Rake $0.07
Board [Kd Kc 6s Ac]
Seat 1: kid delaw731 (big blind) folded on the Turn
Seat 2: walttm folded before Flop (didn't bet)
Seat 3: BigBlue (button) folded before Flop (didn't bet)
Seat 5: PlayTheBlues4U (small blind) collected ($1.33)


*********** # 197 **************
PokerStars Hand #203586998403:  Hold'em No Limit ($0.05/$0.10 USD) - 2019/09/10 20:37:59 ET
Table 'Corvus' 6-max Seat #3 is the button
Seat 1: nando_abarca ($10.08 in chips)
Seat 2: PlayTheBlues4U ($9.35 in chips)
Seat 3: 123tiger711a ($11.46 in chips)
Seat 4: jmc926 ($9.90 in chips)
Seat 6: BigBlue ($12.96 in chips)
jmc926: posts small blind $0.05
BigBlue: posts big blind $0.10
*** HOLE CARDS ***
Dealt to PlayTheBlues4U [Ah Qc]
nando_abarca: calls $0.10
PlayTheBlues4U: raises $0.20 to $0.30
123tiger711a: folds
jmc926: folds
BigBlue: calls $0.20
nando_abarca: calls $0.20
*** FLOP *** [Jd 6h 9s]
BigBlue: checks
nando_abarca: checks
PlayTheBlues4U: bets $0.60
BigBlue: calls $0.60
nando_abarca: folds
*** TURN *** [Jd 6h 9s] [5d]
BigBlue: checks
PlayTheBlues4U: checks
*** RIVER *** [Jd 6h 9s 5d] [Kc]
BigBlue: checks
PlayTheBlues4U: bets $1.30
BigBlue: folds
Uncalled bet ($1.30) returned to PlayTheBlues4U
PlayTheBlues4U collected $2.04 from pot
PlayTheBlues4U: doesn't show hand
*** SUMMARY ***
Total pot $2.15 | Rake $0.11
Board [Jd 6h 9s 5d Kc]
Seat 1: nando_abarca folded on the Flop
Seat 2: PlayTheBlues4U collected ($2.04)
Seat 3: 123tiger711a (button) folded before Flop (didn't bet)
Seat 4: jmc926 (small blind) folded before Flop
Seat 6: BigBlue (big blind) folded on the River


*********** # 198 **************
PokerStars Hand #203586998332:  Hold'em No Limit ($0.05/$0.10 USD) - 2019/09/10 20:37:36 ET
Table 'Corvus' 6-max Seat #2 is the button
Seat 1: nando_abarca ($10.08 in chips)
Seat 2: PlayTheBlues4U ($9.20 in chips)
Seat 3: 123tiger711a ($11.51 in chips)
Seat 4: jmc926 ($10 in chips)
Seat 6: BigBlue ($12.96 in chips)
123tiger711a: posts small blind $0.05
jmc926: posts big blind $0.10
*** HOLE CARDS ***
Dealt to PlayTheBlues4U [8s 8c]
BigBlue: folds
nando_abarca: folds
PlayTheBlues4U: raises $0.20 to $0.30
123tiger711a: folds
jmc926: folds
Uncalled bet ($0.20) returned to PlayTheBlues4U
PlayTheBlues4U collected $0.25 from pot
PlayTheBlues4U: doesn't show hand
*** SUMMARY ***
Total pot $0.25 | Rake $0
Seat 1: nando_abarca folded before Flop (didn't bet)
Seat 2: PlayTheBlues4U (button) collected ($0.25)
Seat 3: 123tiger711a (small blind) folded before Flop
Seat 4: jmc926 (big blind) folded before Flop
Seat 6: BigBlue folded before Flop (didn't bet)


*********** # 199 **************
PokerStars Hand #203586998243:  Hold'em No Limit ($0.05/$0.10 USD) - 2019/09/10 20:37:11 ET
Table 'Corvus' 6-max Seat #1 is the button
Seat 1: nando_abarca ($10.08 in chips)
Seat 2: PlayTheBlues4U ($9.30 in chips)
Seat 3: 123tiger711a ($11.33 in chips)
Seat 6: BigBlue ($13.06 in chips)
PlayTheBlues4U: posts small blind $0.05
123tiger711a: posts big blind $0.10
jmc926: sits out
*** HOLE CARDS ***
Dealt to PlayTheBlues4U [3h 5d]
BigBlue: calls $0.10
nando_abarca: folds
PlayTheBlues4U: calls $0.05
123tiger711a: checks
*** FLOP *** [Ac 9c 6c]
PlayTheBlues4U: checks
123tiger711a: bets $0.14
BigBlue: folds
PlayTheBlues4U: folds
Uncalled bet ($0.14) returned to 123tiger711a
123tiger711a collected $0.28 from pot
*** SUMMARY ***
Total pot $0.30 | Rake $0.02
Board [Ac 9c 6c]
Seat 1: nando_abarca (button) folded before Flop (didn't bet)
Seat 2: PlayTheBlues4U (small blind) folded on the Flop
Seat 3: 123tiger711a (big blind) collected ($0.28)
Seat 6: BigBlue folded on the Flop


*********** # 200 **************
PokerStars Hand #203586998075:  Hold'em No Limit ($0.05/$0.10 USD) - 2019/09/10 20:36:24 ET
Table 'Corvus' 6-max Seat #6 is the button
Seat 1: nando_abarca ($9.90 in chips)
Seat 2: PlayTheBlues4U ($9.50 in chips)
Seat 3: 123tiger711a ($11.33 in chips)
Seat 6: BigBlue ($13.06 in chips)
nando_abarca: posts small blind $0.05
PlayTheBlues4U: posts big blind $0.10
*** HOLE CARDS ***
Dealt to PlayTheBlues4U [2s 6d]
jmc926 joins the table at seat #4
123tiger711a: folds
BigBlue: folds
nando_abarca: calls $0.05
PlayTheBlues4U: checks
*** FLOP *** [2c 7d 8h]
nando_abarca: checks
PlayTheBlues4U: checks
*** TURN *** [2c 7d 8h] [5c]
nando_abarca: checks
PlayTheBlues4U: bets $0.10
nando_abarca: calls $0.10
*** RIVER *** [2c 7d 8h 5c] [3c]
nando_abarca: bets $0.19
PlayTheBlues4U: folds
Uncalled bet ($0.19) returned to nando_abarca
nando_abarca collected $0.38 from pot
nando_abarca: doesn't show hand
*** SUMMARY ***
Total pot $0.40 | Rake $0.02
Board [2c 7d 8h 5c 3c]
Seat 1: nando_abarca (small blind) collected ($0.38)
Seat 2: PlayTheBlues4U (big blind) folded on the River
Seat 3: 123tiger711a folded before Flop (didn't bet)
Seat 6: BigBlue (button) folded before Flop (didn't bet)
