*********** # 1 **************
PokerStars Hand #204146578609:  Hold'em No Limit ($0.05/$0.10 USD) - 2019/10/01 22:54:19 ET
Table 'Klytia' 6-max Seat #2 is the button
Seat 1: OliveXC ($16.31 in chips) 
Seat 2: Pezant ($12.63 in chips) 
Seat 3: ng2414 ($9.90 in chips) 
Seat 4: prettybigtuna ($8.51 in chips) 
Seat 5: PlayTheBlues4U ($11.95 in chips) 
Seat 6: efreay11 ($27.80 in chips) 
ng2414: posts small blind $0.05
prettybigtuna: posts big blind $0.10
*** HOLE CARDS ***
Dealt to PlayTheBlues4U [As 2d]
PlayTheBlues4U: folds 
PlayTheBlues4U said, "ggs nite"
efreay11: calls $0.10
OliveXC: folds 
Pezant: folds 
PlayTheBlues4U leaves the table
ng2414: calls $0.05
prettybigtuna: checks 
*** FLOP *** [4s Kd Tc]
ng2414: checks 
prettybigtuna: checks 
efreay11: bets $0.30
ng2414: calls $0.30
prettybigtuna: folds 
*** TURN *** [4s Kd Tc] [6s]
ng2414: checks 
efreay11: checks 
*** RIVER *** [4s Kd Tc 6s] [8h]
ng2414: checks 
efreay11: checks 
*** SHOW DOWN ***
ng2414: shows [9d Ks] (a pair of Kings)
efreay11: mucks hand 
ng2414 collected $0.86 from pot
*** SUMMARY ***
Total pot $0.90 | Rake $0.04 
Board [4s Kd Tc 6s 8h]
Seat 1: OliveXC folded before Flop (didn't bet)
Seat 2: Pezant (button) folded before Flop (didn't bet)
Seat 3: ng2414 (small blind) showed [9d Ks] and won ($0.86) with a pair of Kings
Seat 4: prettybigtuna (big blind) folded on the Flop
Seat 5: PlayTheBlues4U folded before Flop (didn't bet)
Seat 6: efreay11 mucked [Qh Jh]


*********** # 2 **************
PokerStars Hand #204146578482:  Hold'em No Limit ($0.05/$0.10 USD) - 2019/10/01 22:53:35 ET
Table 'Klytia' 6-max Seat #1 is the button
Seat 1: OliveXC ($17.11 in chips) 
Seat 2: Pezant ($12.68 in chips) 
Seat 3: ng2414 ($10 in chips) 
Seat 4: prettybigtuna ($6.89 in chips) 
Seat 5: PlayTheBlues4U ($11.95 in chips) 
Seat 6: efreay11 ($28.60 in chips) 
Pezant: posts small blind $0.05
ng2414: posts big blind $0.10
*** HOLE CARDS ***
Dealt to PlayTheBlues4U [7c Td]
prettybigtuna: raises $0.10 to $0.20
PlayTheBlues4U: folds 
efreay11: calls $0.20
OliveXC: raises $0.60 to $0.80
Pezant: folds 
ng2414: folds 
prettybigtuna: calls $0.60
efreay11: calls $0.60
*** FLOP *** [6s 8h Ks]
prettybigtuna: bets $1.20
efreay11: folds 
OliveXC: folds 
Uncalled bet ($1.20) returned to prettybigtuna
prettybigtuna collected $2.42 from pot
prettybigtuna: doesn't show hand 
*** SUMMARY ***
Total pot $2.55 | Rake $0.13 
Board [6s 8h Ks]
Seat 1: OliveXC (button) folded on the Flop
Seat 2: Pezant (small blind) folded before Flop
Seat 3: ng2414 (big blind) folded before Flop
Seat 4: prettybigtuna collected ($2.42)
Seat 5: PlayTheBlues4U folded before Flop (didn't bet)
Seat 6: efreay11 folded on the Flop


*********** # 3 **************
PokerStars Hand #204146578378:  Hold'em No Limit ($0.05/$0.10 USD) - 2019/10/01 22:52:59 ET
Table 'Klytia' 6-max Seat #6 is the button
Seat 1: OliveXC ($17.16 in chips) 
Seat 2: Pezant ($12.78 in chips) 
Seat 3: ng2414 ($10 in chips) 
Seat 4: prettybigtuna ($6.66 in chips) 
Seat 5: PlayTheBlues4U ($11.95 in chips) 
Seat 6: efreay11 ($28.70 in chips) 
OliveXC: posts small blind $0.05
Pezant: posts big blind $0.10
*** HOLE CARDS ***
Dealt to PlayTheBlues4U [5s 8d]
ng2414: folds 
prettybigtuna: calls $0.10
PlayTheBlues4U: folds 
efreay11: calls $0.10
OliveXC: folds 
Pezant: checks 
*** FLOP *** [5d 3d 5c]
Pezant: checks 
prettybigtuna: bets $0.20
efreay11: folds 
Pezant: folds 
Uncalled bet ($0.20) returned to prettybigtuna
prettybigtuna collected $0.33 from pot
prettybigtuna: doesn't show hand 
*** SUMMARY ***
Total pot $0.35 | Rake $0.02 
Board [5d 3d 5c]
Seat 1: OliveXC (small blind) folded before Flop
Seat 2: Pezant (big blind) folded on the Flop
Seat 3: ng2414 folded before Flop (didn't bet)
Seat 4: prettybigtuna collected ($0.33)
Seat 5: PlayTheBlues4U folded before Flop (didn't bet)
Seat 6: efreay11 (button) folded on the Flop


*********** # 4 **************
PokerStars Hand #204146578239:  Hold'em No Limit ($0.05/$0.10 USD) - 2019/10/01 22:52:11 ET
Table 'Klytia' 6-max Seat #5 is the button
Seat 1: OliveXC ($17.26 in chips) 
Seat 2: Pezant ($12.78 in chips) 
Seat 3: ng2414 ($10 in chips) 
Seat 4: prettybigtuna ($6.66 in chips) 
Seat 5: PlayTheBlues4U ($11.95 in chips) 
Seat 6: efreay11 ($28.61 in chips) 
efreay11: posts small blind $0.05
OliveXC: posts big blind $0.10
*** HOLE CARDS ***
Dealt to PlayTheBlues4U [8c 3s]
Pezant: folds 
ng2414: folds 
prettybigtuna: folds 
PlayTheBlues4U: folds 
efreay11: calls $0.05
OliveXC: checks 
*** FLOP *** [Ah Kc Js]
efreay11: checks 
OliveXC: checks 
*** TURN *** [Ah Kc Js] [5d]
efreay11: checks 
OliveXC: checks 
*** RIVER *** [Ah Kc Js 5d] [3d]
efreay11: checks 
OliveXC: checks 
*** SHOW DOWN ***
efreay11: shows [7c Qd] (high card Ace)
OliveXC: mucks hand 
efreay11 collected $0.19 from pot
*** SUMMARY ***
Total pot $0.20 | Rake $0.01 
Board [Ah Kc Js 5d 3d]
Seat 1: OliveXC (big blind) mucked [9s 7d]
Seat 2: Pezant folded before Flop (didn't bet)
Seat 3: ng2414 folded before Flop (didn't bet)
Seat 4: prettybigtuna folded before Flop (didn't bet)
Seat 5: PlayTheBlues4U (button) folded before Flop (didn't bet)
Seat 6: efreay11 (small blind) showed [7c Qd] and won ($0.19) with high card Ace


*********** # 5 **************
PokerStars Hand #204146578165:  Hold'em No Limit ($0.05/$0.10 USD) - 2019/10/01 22:51:44 ET
Table 'Klytia' 6-max Seat #4 is the button
Seat 1: OliveXC ($17.26 in chips) 
Seat 2: Pezant ($12.78 in chips) 
Seat 3: ng2414 ($10 in chips) 
Seat 4: prettybigtuna ($6.66 in chips) 
Seat 5: PlayTheBlues4U ($12 in chips) 
Seat 6: efreay11 ($28.56 in chips) 
PlayTheBlues4U: posts small blind $0.05
efreay11: posts big blind $0.10
*** HOLE CARDS ***
Dealt to PlayTheBlues4U [Ts 4d]
OliveXC: folds 
Pezant: folds 
ng2414: folds 
prettybigtuna: folds 
PlayTheBlues4U: folds 
Uncalled bet ($0.05) returned to efreay11
efreay11 collected $0.10 from pot
efreay11: doesn't show hand 
*** SUMMARY ***
Total pot $0.10 | Rake $0 
Seat 1: OliveXC folded before Flop (didn't bet)
Seat 2: Pezant folded before Flop (didn't bet)
Seat 3: ng2414 folded before Flop (didn't bet)
Seat 4: prettybigtuna (button) folded before Flop (didn't bet)
Seat 5: PlayTheBlues4U (small blind) folded before Flop
Seat 6: efreay11 (big blind) collected ($0.10)


*********** # 6 **************
PokerStars Hand #204146578145:  Hold'em No Limit ($0.02/$0.05 USD) - 2019/10/01 22:51:37 ET
Table 'Corvus' 6-max Seat #2 is the button
Seat 1: Trratata ($5.03 in chips) 
Seat 2: REDRUM192 ($2.60 in chips) 
Seat 3: hbw28 ($1.76 in chips) 
Seat 5: luckydeigs ($5.12 in chips) 
Seat 6: PlayTheBlues4U ($9.48 in chips) 
hbw28: posts small blind $0.02
luckydeigs: posts big blind $0.05
*** HOLE CARDS ***
Dealt to PlayTheBlues4U [3h 5s]
PlayTheBlues4U: folds 
Trratata: folds 
REDRUM192: raises $0.25 to $0.30
hbw28: folds 
luckydeigs: folds 
Uncalled bet ($0.25) returned to REDRUM192
REDRUM192 collected $0.12 from pot
REDRUM192: doesn't show hand 
*** SUMMARY ***
Total pot $0.12 | Rake $0 
Seat 1: Trratata folded before Flop (didn't bet)
Seat 2: REDRUM192 (button) collected ($0.12)
Seat 3: hbw28 (small blind) folded before Flop
Seat 5: luckydeigs (big blind) folded before Flop
Seat 6: PlayTheBlues4U folded before Flop (didn't bet)


*********** # 7 **************
PokerStars Hand #204146578031:  Hold'em No Limit ($0.02/$0.05 USD) - 2019/10/01 22:50:59 ET
Table 'Corvus' 6-max Seat #1 is the button
Seat 1: Trratata ($5.03 in chips) 
Seat 2: REDRUM192 ($2.62 in chips) 
Seat 3: hbw28 ($1.70 in chips) 
Seat 4: artbone30 ($1.44 in chips) 
Seat 5: luckydeigs ($5.12 in chips) 
Seat 6: PlayTheBlues4U ($9.48 in chips) 
REDRUM192: posts small blind $0.02
hbw28: posts big blind $0.05
*** HOLE CARDS ***
Dealt to PlayTheBlues4U [Kc 6d]
artbone30: calls $0.05
luckydeigs: folds 
PlayTheBlues4U: folds 
Trratata: folds 
REDRUM192: folds 
hbw28: checks 
*** FLOP *** [7c 8h 3s]
hbw28: bets $0.10
artbone30 has timed out
artbone30: folds 
Uncalled bet ($0.10) returned to hbw28
hbw28 collected $0.11 from pot
hbw28: doesn't show hand 
*** SUMMARY ***
Total pot $0.12 | Rake $0.01 
Board [7c 8h 3s]
Seat 1: Trratata (button) folded before Flop (didn't bet)
Seat 2: REDRUM192 (small blind) folded before Flop
Seat 3: hbw28 (big blind) collected ($0.11)
Seat 4: artbone30 folded on the Flop
Seat 5: luckydeigs folded before Flop (didn't bet)
Seat 6: PlayTheBlues4U folded before Flop (didn't bet)


*********** # 8 **************
PokerStars Hand #204146577997:  Hold'em No Limit ($0.05/$0.10 USD) - 2019/10/01 22:50:46 ET
Table 'Klytia' 6-max Seat #3 is the button
Seat 1: OliveXC ($17.26 in chips) 
Seat 2: Pezant ($12.78 in chips) 
Seat 3: ng2414 ($10 in chips) 
Seat 4: prettybigtuna ($6.76 in chips) 
Seat 5: PlayTheBlues4U ($12.10 in chips) 
Seat 6: efreay11 ($28.38 in chips) 
prettybigtuna: posts small blind $0.05
PlayTheBlues4U: posts big blind $0.10
*** HOLE CARDS ***
Dealt to PlayTheBlues4U [7c Th]
efreay11: calls $0.10
OliveXC: folds 
Pezant: folds 
ng2414: folds 
prettybigtuna: calls $0.05
PlayTheBlues4U: checks 
*** FLOP *** [4c Jc Kd]
prettybigtuna: checks 
PlayTheBlues4U: checks 
efreay11: checks 
*** TURN *** [4c Jc Kd] [3c]
prettybigtuna: checks 
PlayTheBlues4U: checks 
efreay11: checks 
*** RIVER *** [4c Jc Kd 3c] [6h]
prettybigtuna: checks 
PlayTheBlues4U: checks 
efreay11: checks 
*** SHOW DOWN ***
prettybigtuna: shows [9h 2c] (high card King)
PlayTheBlues4U: shows [7c Th] (high card King - Jack+Ten kicker)
efreay11: shows [Ts Tc] (a pair of Tens)
efreay11 collected $0.28 from pot
*** SUMMARY ***
Total pot $0.30 | Rake $0.02 
Board [4c Jc Kd 3c 6h]
Seat 1: OliveXC folded before Flop (didn't bet)
Seat 2: Pezant folded before Flop (didn't bet)
Seat 3: ng2414 (button) folded before Flop (didn't bet)
Seat 4: prettybigtuna (small blind) showed [9h 2c] and lost with high card King
Seat 5: PlayTheBlues4U (big blind) showed [7c Th] and lost with high card King
Seat 6: efreay11 showed [Ts Tc] and won ($0.28) with a pair of Tens


*********** # 9 **************
PokerStars Hand #204146577900:  Hold'em No Limit ($0.02/$0.05 USD) - 2019/10/01 22:50:11 ET
Table 'Corvus' 6-max Seat #6 is the button
Seat 1: Trratata ($5.05 in chips) 
Seat 2: REDRUM192 ($3.37 in chips) 
Seat 3: hbw28 ($1.70 in chips) 
Seat 5: luckydeigs ($5.12 in chips) 
Seat 6: PlayTheBlues4U ($8.79 in chips) 
Trratata: posts small blind $0.02
REDRUM192: posts big blind $0.05
*** HOLE CARDS ***
Dealt to PlayTheBlues4U [7c Qd]
hbw28: folds 
luckydeigs: folds 
PlayTheBlues4U: raises $0.10 to $0.15
Trratata: folds 
REDRUM192: calls $0.10
*** FLOP *** [2c 3c Qc]
REDRUM192: checks 
PlayTheBlues4U: bets $0.20
REDRUM192: calls $0.20
*** TURN *** [2c 3c Qc] [3h]
REDRUM192: checks 
PlayTheBlues4U: bets $0.40
REDRUM192: calls $0.40
*** RIVER *** [2c 3c Qc 3h] [4c]
REDRUM192: checks 
PlayTheBlues4U: checks 
*** SHOW DOWN ***
REDRUM192: shows [Qh Th] (two pair, Queens and Threes)
PlayTheBlues4U: shows [7c Qd] (a flush, Queen high)
PlayTheBlues4U collected $1.44 from pot
*** SUMMARY ***
Total pot $1.52 | Rake $0.08 
Board [2c 3c Qc 3h 4c]
Seat 1: Trratata (small blind) folded before Flop
Seat 2: REDRUM192 (big blind) showed [Qh Th] and lost with two pair, Queens and Threes
Seat 3: hbw28 folded before Flop (didn't bet)
Seat 5: luckydeigs folded before Flop (didn't bet)
Seat 6: PlayTheBlues4U (button) showed [7c Qd] and won ($1.44) with a flush, Queen high


*********** # 10 **************
PokerStars Hand #204146577856:  Hold'em No Limit ($0.02/$0.05 USD) - 2019/10/01 22:49:56 ET
Table 'Corvus' 6-max Seat #5 is the button
Seat 1: Trratata ($5.03 in chips) 
Seat 2: REDRUM192 ($3.37 in chips) 
Seat 3: hbw28 ($1.70 in chips) 
Seat 5: luckydeigs ($5.12 in chips) 
Seat 6: PlayTheBlues4U ($8.81 in chips) 
PlayTheBlues4U: posts small blind $0.02
Trratata: posts big blind $0.05
*** HOLE CARDS ***
Dealt to PlayTheBlues4U [Kh 2d]
REDRUM192: folds 
hbw28: folds 
luckydeigs: folds 
PlayTheBlues4U: folds 
Uncalled bet ($0.03) returned to Trratata
Trratata collected $0.04 from pot
Trratata: doesn't show hand 
*** SUMMARY ***
Total pot $0.04 | Rake $0 
Seat 1: Trratata (big blind) collected ($0.04)
Seat 2: REDRUM192 folded before Flop (didn't bet)
Seat 3: hbw28 folded before Flop (didn't bet)
Seat 5: luckydeigs (button) folded before Flop (didn't bet)
Seat 6: PlayTheBlues4U (small blind) folded before Flop


*********** # 11 **************
PokerStars Hand #204146577814:  Hold'em No Limit ($0.05/$0.10 USD) - 2019/10/01 22:49:43 ET
Table 'Klytia' 6-max Seat #2 is the button
Seat 1: OliveXC ($17.26 in chips) 
Seat 2: Pezant ($11.14 in chips) 
Seat 3: ng2414 ($2.73 in chips) 
Seat 4: prettybigtuna ($8 in chips) 
Seat 5: PlayTheBlues4U ($12.10 in chips) 
Seat 6: efreay11 ($28.88 in chips) 
ng2414: posts small blind $0.05
prettybigtuna: posts big blind $0.10
*** HOLE CARDS ***
Dealt to PlayTheBlues4U [7c 4d]
PlayTheBlues4U: folds 
efreay11: calls $0.10
OliveXC: folds 
Pezant: raises $0.40 to $0.50
ng2414: folds 
prettybigtuna: calls $0.40
efreay11: calls $0.40
*** FLOP *** [Ks Ts 5s]
prettybigtuna: checks 
efreay11: checks 
Pezant: bets $0.74
prettybigtuna: calls $0.74
efreay11: folds 
*** TURN *** [Ks Ts 5s] [3d]
prettybigtuna: checks 
Pezant: bets $1.44
prettybigtuna: folds 
Uncalled bet ($1.44) returned to Pezant
Pezant collected $2.88 from pot
Pezant: doesn't show hand 
*** SUMMARY ***
Total pot $3.03 | Rake $0.15 
Board [Ks Ts 5s 3d]
Seat 1: OliveXC folded before Flop (didn't bet)
Seat 2: Pezant (button) collected ($2.88)
Seat 3: ng2414 (small blind) folded before Flop
Seat 4: prettybigtuna (big blind) folded on the Turn
Seat 5: PlayTheBlues4U folded before Flop (didn't bet)
Seat 6: efreay11 folded on the Flop


*********** # 12 **************
PokerStars Hand #204146577690:  Hold'em No Limit ($0.02/$0.05 USD) - 2019/10/01 22:49:02 ET
Table 'Corvus' 6-max Seat #4 is the button
Seat 1: Trratata ($5.03 in chips) 
Seat 2: REDRUM192 ($3.37 in chips) 
Seat 3: hbw28 ($1.70 in chips) 
Seat 4: artbone30 ($1.49 in chips) 
Seat 5: luckydeigs ($5.14 in chips) 
Seat 6: PlayTheBlues4U ($8.74 in chips) 
luckydeigs: posts small blind $0.02
PlayTheBlues4U: posts big blind $0.05
*** HOLE CARDS ***
Dealt to PlayTheBlues4U [9c 9s]
Trratata: folds 
REDRUM192: folds 
hbw28: folds 
artbone30: calls $0.05
luckydeigs: folds 
PlayTheBlues4U: raises $0.10 to $0.15
artbone30 has timed out
artbone30: folds 
Uncalled bet ($0.10) returned to PlayTheBlues4U
PlayTheBlues4U collected $0.12 from pot
PlayTheBlues4U: doesn't show hand 
*** SUMMARY ***
Total pot $0.12 | Rake $0 
Seat 1: Trratata folded before Flop (didn't bet)
Seat 2: REDRUM192 folded before Flop (didn't bet)
Seat 3: hbw28 folded before Flop (didn't bet)
Seat 4: artbone30 (button) folded before Flop
Seat 5: luckydeigs (small blind) folded before Flop
Seat 6: PlayTheBlues4U (big blind) collected ($0.12)


*********** # 13 **************
PokerStars Hand #204146577592:  Hold'em No Limit ($0.05/$0.10 USD) - 2019/10/01 22:48:29 ET
Table 'Klytia' 6-max Seat #1 is the button
Seat 1: OliveXC ($17.26 in chips) 
Seat 2: Pezant ($11.10 in chips) 
Seat 3: ng2414 ($2.83 in chips) 
Seat 5: PlayTheBlues4U ($12.10 in chips) 
Seat 6: efreay11 ($28.84 in chips) 
Pezant: posts small blind $0.05
ng2414: posts big blind $0.10
prettybigtuna: sits out 
*** HOLE CARDS ***
Dealt to PlayTheBlues4U [As 7c]
PlayTheBlues4U: folds 
efreay11: calls $0.10
OliveXC: folds 
Pezant: calls $0.05
PlayTheBlues4U said, "close enough"
ng2414: checks 
*** FLOP *** [9d Kh Ts]
Pezant: checks 
ng2414: checks 
PlayTheBlues4U said, "I probably call there too"
PlayTheBlues4U said, "lots of draws miss"
efreay11: bets $0.10
Pezant: calls $0.10
ng2414: folds 
*** TURN *** [9d Kh Ts] [8s]
Pezant: checks 
efreay11: checks 
*** RIVER *** [9d Kh Ts 8s] [8h]
Pezant: checks 
efreay11: checks 
*** SHOW DOWN ***
Pezant: shows [Td Jh] (two pair, Tens and Eights)
efreay11: shows [Tc 7s] (two pair, Tens and Eights)
Pezant collected $0.24 from pot
efreay11 collected $0.24 from pot
*** SUMMARY ***
Total pot $0.50 | Rake $0.02 
Board [9d Kh Ts 8s 8h]
Seat 1: OliveXC (button) folded before Flop (didn't bet)
Seat 2: Pezant (small blind) showed [Td Jh] and won ($0.24) with two pair, Tens and Eights
Seat 3: ng2414 (big blind) folded on the Flop
Seat 5: PlayTheBlues4U folded before Flop (didn't bet)
Seat 6: efreay11 showed [Tc 7s] and won ($0.24) with two pair, Tens and Eights


*********** # 14 **************
PokerStars Hand #204146577583:  Hold'em No Limit ($0.02/$0.05 USD) - 2019/10/01 22:48:27 ET
Table 'Corvus' 6-max Seat #3 is the button
Seat 1: Trratata ($5.03 in chips) 
Seat 2: REDRUM192 ($3.37 in chips) 
Seat 3: hbw28 ($1.80 in chips) 
Seat 4: artbone30 ($1.54 in chips) 
Seat 5: luckydeigs ($5 in chips) 
Seat 6: PlayTheBlues4U ($8.74 in chips) 
artbone30: posts small blind $0.02
luckydeigs: posts big blind $0.05
*** HOLE CARDS ***
Dealt to PlayTheBlues4U [Qs 8c]
PlayTheBlues4U: folds 
Trratata: folds 
REDRUM192: folds 
hbw28: calls $0.05
artbone30: calls $0.03
luckydeigs: checks 
*** FLOP *** [9h Ts 6d]
artbone30: checks 
luckydeigs: checks 
hbw28: checks 
*** TURN *** [9h Ts 6d] [Th]
artbone30: checks 
luckydeigs: checks 
hbw28: bets $0.05
artbone30: folds 
luckydeigs: calls $0.05
*** RIVER *** [9h Ts 6d Th] [Ad]
luckydeigs: bets $0.12
hbw28: folds 
Uncalled bet ($0.12) returned to luckydeigs
luckydeigs collected $0.24 from pot
luckydeigs: doesn't show hand 
*** SUMMARY ***
Total pot $0.25 | Rake $0.01 
Board [9h Ts 6d Th Ad]
Seat 1: Trratata folded before Flop (didn't bet)
Seat 2: REDRUM192 folded before Flop (didn't bet)
Seat 3: hbw28 (button) folded on the River
Seat 4: artbone30 (small blind) folded on the Turn
Seat 5: luckydeigs (big blind) collected ($0.24)
Seat 6: PlayTheBlues4U folded before Flop (didn't bet)


*********** # 15 **************
PokerStars Hand #204146577460:  Hold'em No Limit ($0.02/$0.05 USD) - 2019/10/01 22:47:52 ET
Table 'Corvus' 6-max Seat #2 is the button
Seat 1: Trratata ($5.03 in chips) 
Seat 2: REDRUM192 ($3.37 in chips) 
Seat 3: hbw28 ($1.75 in chips) 
Seat 4: artbone30 ($1.59 in chips) 
Seat 5: luckydeigs ($5 in chips) 
Seat 6: PlayTheBlues4U ($8.74 in chips) 
hbw28: posts small blind $0.02
artbone30: posts big blind $0.05
*** HOLE CARDS ***
Dealt to PlayTheBlues4U [Qc 7s]
luckydeigs: folds 
PlayTheBlues4U: folds 
Trratata: folds 
REDRUM192: folds 
hbw28: calls $0.03
artbone30: checks 
*** FLOP *** [9c 2h Jh]
hbw28: checks 
artbone30: checks 
*** TURN *** [9c 2h Jh] [Jd]
hbw28: checks 
artbone30: checks 
*** RIVER *** [9c 2h Jh Jd] [2c]
hbw28: checks 
artbone30: checks 
*** SHOW DOWN ***
hbw28: shows [3d Kd] (two pair, Jacks and Deuces)
artbone30: mucks hand 
hbw28 collected $0.10 from pot
*** SUMMARY ***
Total pot $0.10 | Rake $0 
Board [9c 2h Jh Jd 2c]
Seat 1: Trratata folded before Flop (didn't bet)
Seat 2: REDRUM192 (button) folded before Flop (didn't bet)
Seat 3: hbw28 (small blind) showed [3d Kd] and won ($0.10) with two pair, Jacks and Deuces
Seat 4: artbone30 (big blind) mucked [5h Ts]
Seat 5: luckydeigs folded before Flop (didn't bet)
Seat 6: PlayTheBlues4U folded before Flop (didn't bet)


*********** # 16 **************
PokerStars Hand #204146577416:  Hold'em No Limit ($0.02/$0.05 USD) - 2019/10/01 22:47:37 ET
Table 'Corvus' 6-max Seat #1 is the button
Seat 1: Trratata ($5.03 in chips) 
Seat 2: REDRUM192 ($3.39 in chips) 
Seat 3: hbw28 ($1.80 in chips) 
Seat 4: artbone30 ($1.59 in chips) 
Seat 5: luckydeigs ($4.93 in chips) 
Seat 6: PlayTheBlues4U ($8.74 in chips) 
REDRUM192: posts small blind $0.02
hbw28: posts big blind $0.05
*** HOLE CARDS ***
Dealt to PlayTheBlues4U [Kd 5d]
artbone30: folds 
luckydeigs: raises $0.10 to $0.15
PlayTheBlues4U: folds 
Trratata: folds 
REDRUM192: folds 
hbw28: folds 
Uncalled bet ($0.10) returned to luckydeigs
luckydeigs collected $0.12 from pot
luckydeigs: doesn't show hand 
*** SUMMARY ***
Total pot $0.12 | Rake $0 
Seat 1: Trratata (button) folded before Flop (didn't bet)
Seat 2: REDRUM192 (small blind) folded before Flop
Seat 3: hbw28 (big blind) folded before Flop
Seat 4: artbone30 folded before Flop (didn't bet)
Seat 5: luckydeigs collected ($0.12)
Seat 6: PlayTheBlues4U folded before Flop (didn't bet)


*********** # 17 **************
PokerStars Hand #204146577310:  Hold'em No Limit ($0.02/$0.05 USD) - 2019/10/01 22:47:01 ET
Table 'Corvus' 6-max Seat #6 is the button
Seat 1: Trratata ($4.80 in chips) 
Seat 2: REDRUM192 ($3.44 in chips) 
Seat 3: hbw28 ($1.95 in chips) 
Seat 4: artbone30 ($1.64 in chips) 
Seat 5: luckydeigs ($4.93 in chips) 
Seat 6: PlayTheBlues4U ($8.74 in chips) 
Trratata: posts small blind $0.02
REDRUM192: posts big blind $0.05
*** HOLE CARDS ***
Dealt to PlayTheBlues4U [2c 7s]
hbw28: calls $0.05
artbone30: calls $0.05
luckydeigs: folds 
PlayTheBlues4U: folds 
Trratata: calls $0.03
REDRUM192: checks 
*** FLOP *** [8h Jd Ad]
Trratata: bets $0.10
REDRUM192: folds 
hbw28: calls $0.10
artbone30: folds 
*** TURN *** [8h Jd Ad] [As]
Trratata: bets $0.15
hbw28: folds 
Uncalled bet ($0.15) returned to Trratata
Trratata collected $0.38 from pot
Trratata: doesn't show hand 
*** SUMMARY ***
Total pot $0.40 | Rake $0.02 
Board [8h Jd Ad As]
Seat 1: Trratata (small blind) collected ($0.38)
Seat 2: REDRUM192 (big blind) folded on the Flop
Seat 3: hbw28 folded on the Turn
Seat 4: artbone30 folded on the Flop
Seat 5: luckydeigs folded before Flop (didn't bet)
Seat 6: PlayTheBlues4U (button) folded before Flop (didn't bet)


*********** # 18 **************
PokerStars Hand #204146577272:  Hold'em No Limit ($0.02/$0.05 USD) - 2019/10/01 22:46:45 ET
Table 'Corvus' 6-max Seat #5 is the button
Seat 1: Trratata ($4.85 in chips) 
Seat 2: REDRUM192 ($3.44 in chips) 
Seat 3: hbw28 ($1.95 in chips) 
Seat 4: artbone30 ($1.57 in chips) 
Seat 5: luckydeigs ($4.93 in chips) 
Seat 6: PlayTheBlues4U ($8.76 in chips) 
PlayTheBlues4U: posts small blind $0.02
Trratata: posts big blind $0.05
*** HOLE CARDS ***
Dealt to PlayTheBlues4U [Kd 5h]
REDRUM192: folds 
hbw28: folds 
artbone30: raises $1.52 to $1.57 and is all-in
luckydeigs: folds 
PlayTheBlues4U: folds 
Trratata: folds 
Uncalled bet ($1.52) returned to artbone30
artbone30 collected $0.12 from pot
artbone30: doesn't show hand 
*** SUMMARY ***
Total pot $0.12 | Rake $0 
Seat 1: Trratata (big blind) folded before Flop
Seat 2: REDRUM192 folded before Flop (didn't bet)
Seat 3: hbw28 folded before Flop (didn't bet)
Seat 4: artbone30 collected ($0.12)
Seat 5: luckydeigs (button) folded before Flop (didn't bet)
Seat 6: PlayTheBlues4U (small blind) folded before Flop


*********** # 19 **************
PokerStars Hand #204146577206:  Hold'em No Limit ($0.02/$0.05 USD) - 2019/10/01 22:46:24 ET
Table 'Corvus' 6-max Seat #4 is the button
Seat 1: Trratata ($4.85 in chips) 
Seat 2: REDRUM192 ($3.44 in chips) 
Seat 3: hbw28 ($2 in chips) 
Seat 4: artbone30 ($1.45 in chips) 
Seat 5: luckydeigs ($4.95 in chips) 
Seat 6: PlayTheBlues4U ($8.81 in chips) 
luckydeigs: posts small blind $0.02
PlayTheBlues4U: posts big blind $0.05
hbw28: posts big blind $0.05
*** HOLE CARDS ***
Dealt to PlayTheBlues4U [As 4c]
Trratata: folds 
REDRUM192: folds 
hbw28: checks 
artbone30: raises $0.05 to $0.10
luckydeigs: folds 
PlayTheBlues4U: folds 
hbw28: folds 
Uncalled bet ($0.05) returned to artbone30
artbone30 collected $0.17 from pot
artbone30: doesn't show hand 
*** SUMMARY ***
Total pot $0.17 | Rake $0 
Seat 1: Trratata folded before Flop (didn't bet)
Seat 2: REDRUM192 folded before Flop (didn't bet)
Seat 3: hbw28 folded before Flop (didn't bet)
Seat 4: artbone30 (button) collected ($0.17)
Seat 5: luckydeigs (small blind) folded before Flop
Seat 6: PlayTheBlues4U (big blind) folded before Flop


*********** # 20 **************
PokerStars Hand #204146577121:  Hold'em No Limit ($0.02/$0.05 USD) - 2019/10/01 22:45:55 ET
Table 'Corvus' 6-max Seat #2 is the button
Seat 1: Trratata ($4.65 in chips) 
Seat 2: REDRUM192 ($3.44 in chips) 
Seat 4: artbone30 ($1.62 in chips) 
Seat 5: luckydeigs ($5 in chips) 
Seat 6: PlayTheBlues4U ($8.81 in chips) 
hbw28 will be allowed to play after the button
artbone30: posts small blind $0.02
luckydeigs: posts big blind $0.05
*** HOLE CARDS ***
Dealt to PlayTheBlues4U [3h Qh]
PlayTheBlues4U: folds 
Trratata: raises $0.12 to $0.17
REDRUM192: folds 
artbone30: calls $0.15
luckydeigs: folds 
*** FLOP *** [3s Jd 5s]
artbone30: checks 
Trratata: bets $0.19
artbone30: folds 
Uncalled bet ($0.19) returned to Trratata
Trratata collected $0.37 from pot
Trratata: doesn't show hand 
*** SUMMARY ***
Total pot $0.39 | Rake $0.02 
Board [3s Jd 5s]
Seat 1: Trratata collected ($0.37)
Seat 2: REDRUM192 (button) folded before Flop (didn't bet)
Seat 4: artbone30 (small blind) folded on the Flop
Seat 5: luckydeigs (big blind) folded before Flop
Seat 6: PlayTheBlues4U folded before Flop (didn't bet)


*********** # 21 **************
PokerStars Hand #204146577098:  Hold'em No Limit ($0.05/$0.10 USD) - 2019/10/01 22:45:47 ET
Table 'Klytia' 6-max Seat #6 is the button
Seat 1: OliveXC ($17.31 in chips) 
Seat 2: Pezant ($11.20 in chips) 
Seat 3: ng2414 ($7.91 in chips) 
Seat 5: PlayTheBlues4U ($7.39 in chips) 
Seat 6: efreay11 ($28.84 in chips) 
OliveXC: posts small blind $0.05
Pezant: posts big blind $0.10
*** HOLE CARDS ***
Dealt to PlayTheBlues4U [8c 8s]
ng2414: raises $0.20 to $0.30
PlayTheBlues4U: calls $0.30
efreay11: folds 
OliveXC: folds 
Pezant: folds 
*** FLOP *** [5d Th 3h]
ng2414: checks 
PlayTheBlues4U: bets $0.40
ng2414: calls $0.40
*** TURN *** [5d Th 3h] [8d]
ng2414: bets $0.74
PlayTheBlues4U: raises $1.24 to $1.98
ng2414: calls $1.24
*** RIVER *** [5d Th 3h 8d] [6s]
prettybigtuna joins the table at seat #4 
ng2414: checks 
PlayTheBlues4U: bets $2.40
ng2414 said, "U have 55?"
ng2414 said, "meh"
ng2414: calls $2.40
*** SHOW DOWN ***
PlayTheBlues4U: shows [8c 8s] (three of a kind, Eights)
ng2414: mucks hand 
PlayTheBlues4U collected $9.79 from pot
*** SUMMARY ***
Total pot $10.31 | Rake $0.52 
Board [5d Th 3h 8d 6s]
Seat 1: OliveXC (small blind) folded before Flop
Seat 2: Pezant (big blind) folded before Flop
Seat 3: ng2414 mucked [Jc Jh]
Seat 5: PlayTheBlues4U showed [8c 8s] and won ($9.79) with three of a kind, Eights
Seat 6: efreay11 (button) folded before Flop (didn't bet)


*********** # 22 **************
PokerStars Hand #204146577066:  Hold'em No Limit ($0.02/$0.05 USD) - 2019/10/01 22:45:37 ET
Table 'Corvus' 6-max Seat #1 is the button
Seat 1: Trratata ($4.65 in chips) 
Seat 2: REDRUM192 ($3.46 in chips) 
Seat 4: artbone30 ($1.67 in chips) 
Seat 5: luckydeigs ($4.93 in chips) 
Seat 6: PlayTheBlues4U ($8.81 in chips) 
REDRUM192: posts small blind $0.02
artbone30: posts big blind $0.05
*** HOLE CARDS ***
Dealt to PlayTheBlues4U [5c 4s]
hbw28 joins the table at seat #3 
luckydeigs: raises $0.10 to $0.15
PlayTheBlues4U: folds 
Trratata: folds 
REDRUM192: folds 
artbone30: folds 
Uncalled bet ($0.10) returned to luckydeigs
luckydeigs collected $0.12 from pot
luckydeigs: doesn't show hand 
*** SUMMARY ***
Total pot $0.12 | Rake $0 
Seat 1: Trratata (button) folded before Flop (didn't bet)
Seat 2: REDRUM192 (small blind) folded before Flop
Seat 4: artbone30 (big blind) folded before Flop
Seat 5: luckydeigs collected ($0.12)
Seat 6: PlayTheBlues4U folded before Flop (didn't bet)


*********** # 23 **************
PokerStars Hand #204146576912:  Hold'em No Limit ($0.05/$0.10 USD) - 2019/10/01 22:44:40 ET
Table 'Klytia' 6-max Seat #5 is the button
Seat 1: OliveXC ($16.45 in chips) 
Seat 2: Pezant ($11.20 in chips) 
Seat 3: ng2414 ($7.91 in chips) 
Seat 5: PlayTheBlues4U ($8.29 in chips) 
Seat 6: efreay11 ($28.89 in chips) 
efreay11: posts small blind $0.05
OliveXC: posts big blind $0.10
*** HOLE CARDS ***
Dealt to PlayTheBlues4U [Kh Ah]
Pezant: folds 
ng2414: folds 
PlayTheBlues4U: raises $0.20 to $0.30
efreay11: folds 
OliveXC: calls $0.20
*** FLOP *** [2d Js 5h]
OliveXC: checks 
PlayTheBlues4U: bets $0.30
OliveXC: calls $0.30
*** TURN *** [2d Js 5h] [3d]
OliveXC: checks 
PlayTheBlues4U: checks 
*** RIVER *** [2d Js 5h 3d] [5s]
OliveXC: bets $0.30
BaldEagleStar leaves the table
PlayTheBlues4U: calls $0.30
*** SHOW DOWN ***
OliveXC: shows [Ks Jc] (two pair, Jacks and Fives)
PlayTheBlues4U: mucks hand 
OliveXC collected $1.76 from pot
*** SUMMARY ***
Total pot $1.85 | Rake $0.09 
Board [2d Js 5h 3d 5s]
Seat 1: OliveXC (big blind) showed [Ks Jc] and won ($1.76) with two pair, Jacks and Fives
Seat 2: Pezant folded before Flop (didn't bet)
Seat 3: ng2414 folded before Flop (didn't bet)
Seat 5: PlayTheBlues4U (button) mucked [Kh Ah]
Seat 6: efreay11 (small blind) folded before Flop


*********** # 24 **************
PokerStars Hand #204146576873:  Hold'em No Limit ($0.05/$0.10 USD) - 2019/10/01 22:44:23 ET
Table 'Klytia' 6-max Seat #3 is the button
Seat 1: OliveXC ($16.30 in chips) 
Seat 2: Pezant ($11.20 in chips) 
Seat 3: ng2414 ($7.91 in chips) 
Seat 5: PlayTheBlues4U ($8.34 in chips) 
Seat 6: efreay11 ($28.99 in chips) 
PlayTheBlues4U: posts small blind $0.05
efreay11: posts big blind $0.10
*** HOLE CARDS ***
Dealt to PlayTheBlues4U [4s 7h]
OliveXC: raises $0.20 to $0.30
Pezant: folds 
ng2414: folds 
PlayTheBlues4U: folds 
efreay11: folds 
Uncalled bet ($0.20) returned to OliveXC
OliveXC collected $0.25 from pot
OliveXC: doesn't show hand 
*** SUMMARY ***
Total pot $0.25 | Rake $0 
Seat 1: OliveXC collected ($0.25)
Seat 2: Pezant folded before Flop (didn't bet)
Seat 3: ng2414 (button) folded before Flop (didn't bet)
Seat 5: PlayTheBlues4U (small blind) folded before Flop
Seat 6: efreay11 (big blind) folded before Flop


*********** # 25 **************
PokerStars Hand #204146576748:  Hold'em No Limit ($0.05/$0.10 USD) - 2019/10/01 22:43:38 ET
Table 'Klytia' 6-max Seat #2 is the button
Seat 1: OliveXC ($16.30 in chips) 
Seat 2: Pezant ($10.61 in chips) 
Seat 3: ng2414 ($7.96 in chips) 
Seat 5: PlayTheBlues4U ($8.44 in chips) 
Seat 6: efreay11 ($29.49 in chips) 
ng2414: posts small blind $0.05
PlayTheBlues4U: posts big blind $0.10
*** HOLE CARDS ***
Dealt to PlayTheBlues4U [9c 7h]
efreay11: calls $0.10
OliveXC: folds 
Pezant: raises $0.40 to $0.50
ng2414: folds 
PlayTheBlues4U: folds 
efreay11: calls $0.40
*** FLOP *** [Ks Qh 2d]
efreay11: checks 
Pezant: bets $0.55
efreay11: folds 
Uncalled bet ($0.55) returned to Pezant
Pezant collected $1.09 from pot
Pezant: doesn't show hand 
*** SUMMARY ***
Total pot $1.15 | Rake $0.06 
Board [Ks Qh 2d]
Seat 1: OliveXC folded before Flop (didn't bet)
Seat 2: Pezant (button) collected ($1.09)
Seat 3: ng2414 (small blind) folded before Flop
Seat 5: PlayTheBlues4U (big blind) folded before Flop
Seat 6: efreay11 folded on the Flop


*********** # 26 **************
PokerStars Hand #204146576687:  Hold'em No Limit ($0.02/$0.05 USD) - 2019/10/01 22:43:14 ET
Table 'Corvus' 6-max Seat #6 is the button
Seat 1: Trratata ($5.10 in chips) 
Seat 2: REDRUM192 ($2.96 in chips) 
Seat 3: IvanMakeBasket ($1.14 in chips) 
Seat 4: artbone30 ($1.72 in chips) 
Seat 5: luckydeigs ($4.93 in chips) 
Seat 6: PlayTheBlues4U ($8.81 in chips) 
Trratata: posts small blind $0.02
REDRUM192: posts big blind $0.05
*** HOLE CARDS ***
Dealt to PlayTheBlues4U [4s 2s]
IvanMakeBasket: calls $0.05
artbone30: calls $0.05
luckydeigs: folds 
PlayTheBlues4U: folds 
Trratata: calls $0.03
REDRUM192: checks 
*** FLOP *** [4d 3d 3s]
Trratata: checks 
REDRUM192: checks 
IvanMakeBasket: checks 
artbone30 has timed out
artbone30: checks 
*** TURN *** [4d 3d 3s] [5d]
Trratata: bets $0.10
REDRUM192: raises $0.30 to $0.40
IvanMakeBasket: folds 
artbone30: folds 
Trratata: calls $0.30
*** RIVER *** [4d 3d 3s 5d] [7s]
Trratata: checks 
IvanMakeBasket leaves the table
REDRUM192: bets $0.55
Trratata: folds 
Uncalled bet ($0.55) returned to REDRUM192
REDRUM192 collected $0.95 from pot
REDRUM192: doesn't show hand 
*** SUMMARY ***
Total pot $1 | Rake $0.05 
Board [4d 3d 3s 5d 7s]
Seat 1: Trratata (small blind) folded on the River
Seat 2: REDRUM192 (big blind) collected ($0.95)
Seat 3: IvanMakeBasket folded on the Turn
Seat 4: artbone30 folded on the Turn
Seat 5: luckydeigs folded before Flop (didn't bet)
Seat 6: PlayTheBlues4U (button) folded before Flop (didn't bet)


*********** # 27 **************
PokerStars Hand #204146576615:  Hold'em No Limit ($0.05/$0.10 USD) - 2019/10/01 22:42:48 ET
Table 'Klytia' 6-max Seat #1 is the button
Seat 1: OliveXC ($16.30 in chips) 
Seat 2: Pezant ($10.66 in chips) 
Seat 3: ng2414 ($8.06 in chips) 
Seat 5: PlayTheBlues4U ($8.44 in chips) 
Seat 6: efreay11 ($29.35 in chips) 
Pezant: posts small blind $0.05
ng2414: posts big blind $0.10
*** HOLE CARDS ***
Dealt to PlayTheBlues4U [5s 2s]
BaldEagleStar is disconnected 
PlayTheBlues4U has timed out
PlayTheBlues4U: folds 
efreay11: calls $0.10
OliveXC: folds 
Pezant: folds 
ng2414: checks 
*** FLOP *** [7s 8d 4s]
ng2414: checks 
efreay11: checks 
*** TURN *** [7s 8d 4s] [Qs]
ng2414: checks 
efreay11: checks 
*** RIVER *** [7s 8d 4s Qs] [6c]
ng2414: checks 
efreay11: checks 
*** SHOW DOWN ***
ng2414: shows [2c 9h] (high card Queen)
efreay11: shows [9s Kd] (high card King)
efreay11 collected $0.24 from pot
*** SUMMARY ***
Total pot $0.25 | Rake $0.01 
Board [7s 8d 4s Qs 6c]
Seat 1: OliveXC (button) folded before Flop (didn't bet)
Seat 2: Pezant (small blind) folded before Flop
Seat 3: ng2414 (big blind) showed [2c 9h] and lost with high card Queen
Seat 5: PlayTheBlues4U folded before Flop (didn't bet)
Seat 6: efreay11 showed [9s Kd] and won ($0.24) with high card King


*********** # 28 **************
PokerStars Hand #204146576566:  Hold'em No Limit ($0.05/$0.10 USD) - 2019/10/01 22:42:33 ET
Table 'Klytia' 6-max Seat #6 is the button
Seat 1: OliveXC ($16.35 in chips) 
Seat 2: Pezant ($10.76 in chips) 
Seat 3: ng2414 ($8.06 in chips) 
Seat 5: PlayTheBlues4U ($8.29 in chips) 
Seat 6: efreay11 ($29.35 in chips) 
OliveXC: posts small blind $0.05
Pezant: posts big blind $0.10
*** HOLE CARDS ***
Dealt to PlayTheBlues4U [Kh Kd]
ng2414: folds 
PlayTheBlues4U: raises $0.20 to $0.30
efreay11: folds 
OliveXC: folds 
Pezant: folds 
Uncalled bet ($0.20) returned to PlayTheBlues4U
PlayTheBlues4U collected $0.25 from pot
PlayTheBlues4U: doesn't show hand 
*** SUMMARY ***
Total pot $0.25 | Rake $0 
Seat 1: OliveXC (small blind) folded before Flop
Seat 2: Pezant (big blind) folded before Flop
Seat 3: ng2414 folded before Flop (didn't bet)
Seat 5: PlayTheBlues4U collected ($0.25)
Seat 6: efreay11 (button) folded before Flop (didn't bet)


*********** # 29 **************
PokerStars Hand #204146576452:  Hold'em No Limit ($0.05/$0.10 USD) - 2019/10/01 22:41:55 ET
Table 'Klytia' 6-max Seat #5 is the button
Seat 1: OliveXC ($16.45 in chips) 
Seat 2: Pezant ($10.76 in chips) 
Seat 3: ng2414 ($8.06 in chips) 
Seat 5: PlayTheBlues4U ($8.29 in chips) 
Seat 6: efreay11 ($29.26 in chips) 
efreay11: posts small blind $0.05
OliveXC: posts big blind $0.10
*** HOLE CARDS ***
Dealt to PlayTheBlues4U [8h 9c]
Pezant: folds 
ng2414: folds 
PlayTheBlues4U: folds 
efreay11: calls $0.05
OliveXC: checks 
*** FLOP *** [7d 7c Ah]
efreay11: bets $0.10
OliveXC: folds 
Uncalled bet ($0.10) returned to efreay11
efreay11 collected $0.19 from pot
efreay11: doesn't show hand 
*** SUMMARY ***
Total pot $0.20 | Rake $0.01 
Board [7d 7c Ah]
Seat 1: OliveXC (big blind) folded on the Flop
Seat 2: Pezant folded before Flop (didn't bet)
Seat 3: ng2414 folded before Flop (didn't bet)
Seat 5: PlayTheBlues4U (button) folded before Flop (didn't bet)
Seat 6: efreay11 (small blind) collected ($0.19)


*********** # 30 **************
PokerStars Hand #204146576415:  Hold'em No Limit ($0.02/$0.05 USD) - 2019/10/01 22:41:45 ET
Table 'Corvus' 6-max Seat #5 is the button
Seat 1: Trratata ($5.15 in chips) 
Seat 2: REDRUM192 ($2.96 in chips) 
Seat 3: IvanMakeBasket ($4.26 in chips) 
Seat 4: artbone30 ($1.72 in chips) 
Seat 5: luckydeigs ($4.93 in chips) 
Seat 6: PlayTheBlues4U ($5.95 in chips) 
PlayTheBlues4U: posts small blind $0.02
Trratata: posts big blind $0.05
*** HOLE CARDS ***
Dealt to PlayTheBlues4U [Tc Td]
REDRUM192: folds 
IvanMakeBasket: raises $0.05 to $0.10
artbone30: folds 
luckydeigs: folds 
PlayTheBlues4U: raises $0.05 to $0.15
Trratata: folds 
IvanMakeBasket: calls $0.05
*** FLOP *** [9d Jd 7h]
PlayTheBlues4U: bets $0.20
IvanMakeBasket: calls $0.20
*** TURN *** [9d Jd 7h] [5s]
PlayTheBlues4U: checks 
IvanMakeBasket: bets $0.71
PlayTheBlues4U: calls $0.71
*** RIVER *** [9d Jd 7h 5s] [3h]
PlayTheBlues4U: checks 
IvanMakeBasket: bets $2.06
PlayTheBlues4U: calls $2.06
*** SHOW DOWN ***
IvanMakeBasket: shows [Th Qd] (high card Queen)
PlayTheBlues4U: shows [Tc Td] (a pair of Tens)
PlayTheBlues4U collected $5.98 from pot
*** SUMMARY ***
Total pot $6.29 | Rake $0.31 
Board [9d Jd 7h 5s 3h]
Seat 1: Trratata (big blind) folded before Flop
Seat 2: REDRUM192 folded before Flop (didn't bet)
Seat 3: IvanMakeBasket showed [Th Qd] and lost with high card Queen
Seat 4: artbone30 folded before Flop (didn't bet)
Seat 5: luckydeigs (button) folded before Flop (didn't bet)
Seat 6: PlayTheBlues4U (small blind) showed [Tc Td] and won ($5.98) with a pair of Tens


*********** # 31 **************
PokerStars Hand #204146576332:  Hold'em No Limit ($0.02/$0.05 USD) - 2019/10/01 22:41:20 ET
Table 'Corvus' 6-max Seat #4 is the button
Seat 1: Trratata ($5.15 in chips) 
Seat 2: REDRUM192 ($2.89 in chips) 
Seat 3: IvanMakeBasket ($4.26 in chips) 
Seat 4: artbone30 ($1.72 in chips) 
Seat 5: luckydeigs ($4.95 in chips) 
Seat 6: PlayTheBlues4U ($6 in chips) 
luckydeigs: posts small blind $0.02
PlayTheBlues4U: posts big blind $0.05
*** HOLE CARDS ***
Dealt to PlayTheBlues4U [2s 7h]
Trratata: folds 
REDRUM192: raises $0.25 to $0.30
IvanMakeBasket: folds 
artbone30: folds 
luckydeigs: folds 
PlayTheBlues4U: folds 
Uncalled bet ($0.25) returned to REDRUM192
REDRUM192 collected $0.12 from pot
REDRUM192: doesn't show hand 
*** SUMMARY ***
Total pot $0.12 | Rake $0 
Seat 1: Trratata folded before Flop (didn't bet)
Seat 2: REDRUM192 collected ($0.12)
Seat 3: IvanMakeBasket folded before Flop (didn't bet)
Seat 4: artbone30 (button) folded before Flop (didn't bet)
Seat 5: luckydeigs (small blind) folded before Flop
Seat 6: PlayTheBlues4U (big blind) folded before Flop


*********** # 32 **************
PokerStars Hand #204146576291:  Hold'em No Limit ($0.05/$0.10 USD) - 2019/10/01 22:41:05 ET
Table 'Klytia' 6-max Seat #3 is the button
Seat 1: OliveXC ($15.04 in chips) 
Seat 2: Pezant ($10.76 in chips) 
Seat 3: ng2414 ($8.06 in chips) 
Seat 4: BaldEagleStar ($1.35 in chips) 
Seat 5: PlayTheBlues4U ($8.39 in chips) 
Seat 6: efreay11 ($29.36 in chips) 
BaldEagleStar: posts small blind $0.05
PlayTheBlues4U: posts big blind $0.10
*** HOLE CARDS ***
Dealt to PlayTheBlues4U [6d 8s]
PlayTheBlues4U said, "king high good?"
efreay11: calls $0.10
OliveXC: raises $0.50 to $0.60
Pezant: folds 
ng2414: folds 
BaldEagleStar: raises $0.50 to $1.10
PlayTheBlues4U: folds 
BaldEagleStar said, "pair"
efreay11: folds 
OliveXC: raises $0.50 to $1.60
BaldEagleStar: calls $0.25 and is all-in
Uncalled bet ($0.25) returned to OliveXC
*** FLOP *** [3h Qc 4d]
*** TURN *** [3h Qc 4d] [6h]
*** RIVER *** [3h Qc 4d 6h] [Ah]
*** SHOW DOWN ***
BaldEagleStar: shows [8h 8d] (a pair of Eights)
OliveXC: shows [Jd Js] (a pair of Jacks)
OliveXC collected $2.76 from pot
*** SUMMARY ***
Total pot $2.90 | Rake $0.14 
Board [3h Qc 4d 6h Ah]
Seat 1: OliveXC showed [Jd Js] and won ($2.76) with a pair of Jacks
Seat 2: Pezant folded before Flop (didn't bet)
Seat 3: ng2414 (button) folded before Flop (didn't bet)
Seat 4: BaldEagleStar (small blind) showed [8h 8d] and lost with a pair of Eights
Seat 5: PlayTheBlues4U (big blind) folded before Flop
Seat 6: efreay11 folded before Flop


*********** # 33 **************
PokerStars Hand #204146576178:  Hold'em No Limit ($0.02/$0.05 USD) - 2019/10/01 22:40:23 ET
Table 'Corvus' 6-max Seat #3 is the button
Seat 1: Trratata ($5.15 in chips) 
Seat 2: REDRUM192 ($2.64 in chips) 
Seat 3: IvanMakeBasket ($4.46 in chips) 
Seat 4: artbone30 ($1.74 in chips) 
Seat 5: luckydeigs ($5 in chips) 
Seat 6: PlayTheBlues4U ($6 in chips) 
artbone30: posts small blind $0.02
luckydeigs: posts big blind $0.05
*** HOLE CARDS ***
Dealt to PlayTheBlues4U [8h 3c]
PlayTheBlues4U: folds 
Trratata: folds 
REDRUM192: calls $0.05
IvanMakeBasket: calls $0.05
artbone30: folds 
luckydeigs: checks 
*** FLOP *** [8c Jd 7c]
luckydeigs: checks 
REDRUM192: bets $0.15
IvanMakeBasket: calls $0.15
luckydeigs: folds 
*** TURN *** [8c Jd 7c] [9c]
REDRUM192: bets $0.23
IvanMakeBasket: folds 
Uncalled bet ($0.23) returned to REDRUM192
REDRUM192 collected $0.45 from pot
REDRUM192: doesn't show hand 
*** SUMMARY ***
Total pot $0.47 | Rake $0.02 
Board [8c Jd 7c 9c]
Seat 1: Trratata folded before Flop (didn't bet)
Seat 2: REDRUM192 collected ($0.45)
Seat 3: IvanMakeBasket (button) folded on the Turn
Seat 4: artbone30 (small blind) folded before Flop
Seat 5: luckydeigs (big blind) folded on the Flop
Seat 6: PlayTheBlues4U folded before Flop (didn't bet)


*********** # 34 **************
PokerStars Hand #204146576113:  Hold'em No Limit ($0.05/$0.10 USD) - 2019/10/01 22:40:00 ET
Table 'Klytia' 6-max Seat #2 is the button
Seat 1: OliveXC ($15.04 in chips) 
Seat 2: Pezant ($10.76 in chips) 
Seat 3: ng2414 ($8.11 in chips) 
Seat 4: BaldEagleStar ($1.03 in chips) 
Seat 5: PlayTheBlues4U ($8.69 in chips) 
Seat 6: efreay11 ($29.36 in chips) 
ng2414: posts small blind $0.05
BaldEagleStar: posts big blind $0.10
*** HOLE CARDS ***
Dealt to PlayTheBlues4U [Kd Jh]
PlayTheBlues4U: raises $0.20 to $0.30
efreay11: folds 
OliveXC: folds 
Pezant: folds 
ng2414: folds 
BaldEagleStar: calls $0.20
*** FLOP *** [9h 8h 6h]
BaldEagleStar: checks 
PlayTheBlues4U: checks 
*** TURN *** [9h 8h 6h] [5s]
BaldEagleStar: checks 
PlayTheBlues4U: checks 
*** RIVER *** [9h 8h 6h 5s] [2c]
BaldEagleStar: bets $0.10
PlayTheBlues4U: folds 
Uncalled bet ($0.10) returned to BaldEagleStar
BaldEagleStar collected $0.62 from pot
BaldEagleStar: doesn't show hand 
*** SUMMARY ***
Total pot $0.65 | Rake $0.03 
Board [9h 8h 6h 5s 2c]
Seat 1: OliveXC folded before Flop (didn't bet)
Seat 2: Pezant (button) folded before Flop (didn't bet)
Seat 3: ng2414 (small blind) folded before Flop
Seat 4: BaldEagleStar (big blind) collected ($0.62)
Seat 5: PlayTheBlues4U folded on the River
Seat 6: efreay11 folded before Flop (didn't bet)


*********** # 35 **************
PokerStars Hand #204146576025:  Hold'em No Limit ($0.02/$0.05 USD) - 2019/10/01 22:39:31 ET
Table 'Corvus' 6-max Seat #2 is the button
Seat 1: Trratata ($5 in chips) 
Seat 2: REDRUM192 ($2.64 in chips) 
Seat 3: IvanMakeBasket ($4.48 in chips) 
Seat 4: artbone30 ($1.89 in chips) 
Seat 6: PlayTheBlues4U ($6 in chips) 
IvanMakeBasket: posts small blind $0.02
artbone30: posts big blind $0.05
luckydeigs: sits out 
*** HOLE CARDS ***
Dealt to PlayTheBlues4U [2h 4d]
PlayTheBlues4U: folds 
Trratata: raises $0.10 to $0.15
REDRUM192: folds 
IvanMakeBasket: folds 
artbone30: calls $0.10
*** FLOP *** [6s 9s Ah]
artbone30: checks 
Trratata: bets $0.15
artbone30: folds 
Uncalled bet ($0.15) returned to Trratata
Trratata collected $0.30 from pot
Trratata: doesn't show hand 
*** SUMMARY ***
Total pot $0.32 | Rake $0.02 
Board [6s 9s Ah]
Seat 1: Trratata collected ($0.30)
Seat 2: REDRUM192 (button) folded before Flop (didn't bet)
Seat 3: IvanMakeBasket (small blind) folded before Flop
Seat 4: artbone30 (big blind) folded on the Flop
Seat 6: PlayTheBlues4U folded before Flop (didn't bet)


*********** # 36 **************
PokerStars Hand #204146575955:  Hold'em No Limit ($0.05/$0.10 USD) - 2019/10/01 22:39:06 ET
Table 'Klytia' 6-max Seat #1 is the button
Seat 1: OliveXC ($16.14 in chips) 
Seat 2: Pezant ($10.81 in chips) 
Seat 3: ng2414 ($8.21 in chips) 
Seat 4: BaldEagleStar ($1.03 in chips) 
Seat 5: PlayTheBlues4U ($8.69 in chips) 
Seat 6: efreay11 ($28.23 in chips) 
Pezant: posts small blind $0.05
ng2414: posts big blind $0.10
*** HOLE CARDS ***
Dealt to PlayTheBlues4U [Qc 4h]
BaldEagleStar: folds 
PlayTheBlues4U: folds 
efreay11: calls $0.10
OliveXC: raises $0.40 to $0.50
Pezant: folds 
ng2414: folds 
efreay11: calls $0.40
*** FLOP *** [8s 9s 2s]
efreay11: checks 
OliveXC: bets $0.60
efreay11: calls $0.60
*** TURN *** [8s 9s 2s] [Js]
efreay11: checks 
OliveXC: checks 
*** RIVER *** [8s 9s 2s Js] [3h]
efreay11: checks 
OliveXC: checks 
*** SHOW DOWN ***
efreay11: shows [Jd Qd] (a pair of Jacks)
OliveXC: mucks hand 
efreay11 collected $2.23 from pot
*** SUMMARY ***
Total pot $2.35 | Rake $0.12 
Board [8s 9s 2s Js 3h]
Seat 1: OliveXC (button) mucked [Kh Ad]
Seat 2: Pezant (small blind) folded before Flop
Seat 3: ng2414 (big blind) folded before Flop
Seat 4: BaldEagleStar folded before Flop (didn't bet)
Seat 5: PlayTheBlues4U folded before Flop (didn't bet)
Seat 6: efreay11 showed [Jd Qd] and won ($2.23) with a pair of Jacks


*********** # 37 **************
PokerStars Hand #204146575830:  Hold'em No Limit ($0.02/$0.05 USD) - 2019/10/01 22:38:25 ET
Table 'Corvus' 6-max Seat #1 is the button
Seat 1: Trratata ($4.02 in chips) 
Seat 2: REDRUM192 ($2.66 in chips) 
Seat 3: IvanMakeBasket ($4.53 in chips) 
Seat 4: artbone30 ($1.83 in chips) 
Seat 6: PlayTheBlues4U ($6 in chips) 
REDRUM192: posts small blind $0.02
IvanMakeBasket: posts big blind $0.05
luckydeigs: sits out 
*** HOLE CARDS ***
Dealt to PlayTheBlues4U [6d 5c]
artbone30: calls $0.05
PlayTheBlues4U: folds 
Trratata: folds 
REDRUM192: folds 
IvanMakeBasket: checks 
*** FLOP *** [8c Qc 7s]
IvanMakeBasket: checks 
artbone30: checks 
*** TURN *** [8c Qc 7s] [2d]
IvanMakeBasket: checks 
artbone30: checks 
*** RIVER *** [8c Qc 7s 2d] [Ac]
IvanMakeBasket: checks 
artbone30: checks 
*** SHOW DOWN ***
IvanMakeBasket: shows [2c 9h] (a pair of Deuces)
artbone30: shows [7h 5h] (a pair of Sevens)
artbone30 collected $0.11 from pot
*** SUMMARY ***
Total pot $0.12 | Rake $0.01 
Board [8c Qc 7s 2d Ac]
Seat 1: Trratata (button) folded before Flop (didn't bet)
Seat 2: REDRUM192 (small blind) folded before Flop
Seat 3: IvanMakeBasket (big blind) showed [2c 9h] and lost with a pair of Deuces
Seat 4: artbone30 showed [7h 5h] and won ($0.11) with a pair of Sevens
Seat 6: PlayTheBlues4U folded before Flop (didn't bet)


*********** # 38 **************
PokerStars Hand #204146575703:  Hold'em No Limit ($0.05/$0.10 USD) - 2019/10/01 22:37:42 ET
Table 'Klytia' 6-max Seat #6 is the button
Seat 1: OliveXC ($16.24 in chips) 
Seat 2: Pezant ($10.53 in chips) 
Seat 3: ng2414 ($8.21 in chips) 
Seat 4: BaldEagleStar ($1.13 in chips) 
Seat 5: PlayTheBlues4U ($8.69 in chips) 
Seat 6: efreay11 ($28.33 in chips) 
OliveXC: posts small blind $0.05
Pezant: posts big blind $0.10
*** HOLE CARDS ***
Dealt to PlayTheBlues4U [4d 6d]
ng2414: folds 
BaldEagleStar: calls $0.10
PlayTheBlues4U: folds 
efreay11: calls $0.10
OliveXC: calls $0.05
Pezant: checks 
*** FLOP *** [5s 8c Ts]
OliveXC: checks 
Pezant: checks 
BaldEagleStar: checks 
efreay11: checks 
*** TURN *** [5s 8c Ts] [5c]
OliveXC: checks 
Pezant: checks 
BaldEagleStar: checks 
efreay11: checks 
*** RIVER *** [5s 8c Ts 5c] [7d]
OliveXC: checks 
Pezant: checks 
BaldEagleStar: checks 
efreay11: checks 
*** SHOW DOWN ***
OliveXC: shows [Jh 6h] (a pair of Fives)
Pezant: shows [2s 7h] (two pair, Sevens and Fives)
BaldEagleStar: mucks hand 
efreay11: mucks hand 
Pezant collected $0.38 from pot
*** SUMMARY ***
Total pot $0.40 | Rake $0.02 
Board [5s 8c Ts 5c 7d]
Seat 1: OliveXC (small blind) showed [Jh 6h] and lost with a pair of Fives
Seat 2: Pezant (big blind) showed [2s 7h] and won ($0.38) with two pair, Sevens and Fives
Seat 3: ng2414 folded before Flop (didn't bet)
Seat 4: BaldEagleStar mucked [9s Qs]
Seat 5: PlayTheBlues4U folded before Flop (didn't bet)
Seat 6: efreay11 (button) mucked [6c Jc]


*********** # 39 **************
PokerStars Hand #204146575641:  Hold'em No Limit ($0.02/$0.05 USD) - 2019/10/01 22:37:20 ET
Table 'Corvus' 6-max Seat #6 is the button
Seat 1: Trratata ($4.62 in chips) 
Seat 2: REDRUM192 ($2.71 in chips) 
Seat 3: IvanMakeBasket ($4.53 in chips) 
Seat 4: artbone30 ($1.83 in chips) 
Seat 6: PlayTheBlues4U ($5.41 in chips) 
Trratata: posts small blind $0.02
REDRUM192: posts big blind $0.05
luckydeigs: sits out 
*** HOLE CARDS ***
Dealt to PlayTheBlues4U [8d 8h]
IvanMakeBasket: folds 
artbone30: folds 
PlayTheBlues4U: raises $0.10 to $0.15
Trratata: calls $0.13
REDRUM192: folds 
*** FLOP *** [5h Qc 3h]
Trratata: checks 
PlayTheBlues4U: bets $0.15
Trratata: calls $0.15
*** TURN *** [5h Qc 3h] [Ah]
Trratata: checks 
PlayTheBlues4U: checks 
*** RIVER *** [5h Qc 3h Ah] [Qd]
Trratata: bets $0.30
PlayTheBlues4U: calls $0.30
*** SHOW DOWN ***
Trratata: shows [Kd Js] (a pair of Queens)
PlayTheBlues4U: shows [8d 8h] (two pair, Queens and Eights)
PlayTheBlues4U collected $1.19 from pot
*** SUMMARY ***
Total pot $1.25 | Rake $0.06 
Board [5h Qc 3h Ah Qd]
Seat 1: Trratata (small blind) showed [Kd Js] and lost with a pair of Queens
Seat 2: REDRUM192 (big blind) folded before Flop
Seat 3: IvanMakeBasket folded before Flop (didn't bet)
Seat 4: artbone30 folded before Flop (didn't bet)
Seat 6: PlayTheBlues4U (button) showed [8d 8h] and won ($1.19) with two pair, Queens and Eights


*********** # 40 **************
PokerStars Hand #204146575566:  Hold'em No Limit ($0.02/$0.05 USD) - 2019/10/01 22:36:51 ET
Table 'Corvus' 6-max Seat #5 is the button
Seat 1: Trratata ($4.67 in chips) 
Seat 2: REDRUM192 ($2.71 in chips) 
Seat 3: IvanMakeBasket ($4.53 in chips) 
Seat 4: artbone30 ($1.83 in chips) 
Seat 5: 7noodles ($6.32 in chips) 
Seat 6: PlayTheBlues4U ($5.36 in chips) 
PlayTheBlues4U: posts small blind $0.02
Trratata: posts big blind $0.05
*** HOLE CARDS ***
Dealt to PlayTheBlues4U [4h 5h]
REDRUM192: folds 
IvanMakeBasket: folds 
artbone30: folds 
7noodles: folds 
7noodles leaves the table
PlayTheBlues4U: raises $0.07 to $0.12
luckydeigs joins the table at seat #5 
Trratata: folds [Th 3d]
Uncalled bet ($0.07) returned to PlayTheBlues4U
PlayTheBlues4U collected $0.10 from pot
PlayTheBlues4U: doesn't show hand 
*** SUMMARY ***
Total pot $0.10 | Rake $0 
Seat 1: Trratata (big blind) folded before Flop
Seat 2: REDRUM192 folded before Flop (didn't bet)
Seat 3: IvanMakeBasket folded before Flop (didn't bet)
Seat 4: artbone30 folded before Flop (didn't bet)
Seat 5: 7noodles (button) folded before Flop (didn't bet)
Seat 6: PlayTheBlues4U (small blind) collected ($0.10)


*********** # 41 **************
PokerStars Hand #204146575497:  Hold'em No Limit ($0.02/$0.05 USD) - 2019/10/01 22:36:26 ET
Table 'Corvus' 6-max Seat #4 is the button
Seat 1: Trratata ($4.67 in chips) 
Seat 2: REDRUM192 ($2.71 in chips) 
Seat 3: IvanMakeBasket ($4.53 in chips) 
Seat 4: artbone30 ($1.83 in chips) 
Seat 5: 7noodles ($6.27 in chips) 
Seat 6: PlayTheBlues4U ($5.41 in chips) 
7noodles: posts small blind $0.02
PlayTheBlues4U: posts big blind $0.05
*** HOLE CARDS ***
Dealt to PlayTheBlues4U [Jd 2c]
Trratata: folds 
REDRUM192: folds 
IvanMakeBasket: folds 
artbone30: folds 
7noodles: raises $0.07 to $0.12
PlayTheBlues4U: folds 
Uncalled bet ($0.07) returned to 7noodles
7noodles collected $0.10 from pot
7noodles: doesn't show hand 
*** SUMMARY ***
Total pot $0.10 | Rake $0 
Seat 1: Trratata folded before Flop (didn't bet)
Seat 2: REDRUM192 folded before Flop (didn't bet)
Seat 3: IvanMakeBasket folded before Flop (didn't bet)
Seat 4: artbone30 (button) folded before Flop (didn't bet)
Seat 5: 7noodles (small blind) collected ($0.10)
Seat 6: PlayTheBlues4U (big blind) folded before Flop


*********** # 42 **************
PokerStars Hand #204146575487:  Hold'em No Limit ($0.05/$0.10 USD) - 2019/10/01 22:36:19 ET
Table 'Klytia' 6-max Seat #5 is the button
Seat 1: OliveXC ($15.64 in chips) 
Seat 2: Pezant ($10.53 in chips) 
Seat 3: ng2414 ($8.51 in chips) 
Seat 4: BaldEagleStar ($1.13 in chips) 
Seat 5: PlayTheBlues4U ($8.99 in chips) 
Seat 6: efreay11 ($28.38 in chips) 
efreay11: posts small blind $0.05
OliveXC: posts big blind $0.10
*** HOLE CARDS ***
Dealt to PlayTheBlues4U [As Td]
Pezant: folds 
ng2414: raises $0.20 to $0.30
BaldEagleStar: folds 
PlayTheBlues4U: calls $0.30
efreay11: folds 
OliveXC: calls $0.20
*** FLOP *** [Kd 2s Th]
OliveXC: checks 
ng2414: checks 
PlayTheBlues4U: checks 
*** TURN *** [Kd 2s Th] [Jh]
OliveXC: bets $0.60
ng2414: folds 
PlayTheBlues4U: folds 
Uncalled bet ($0.60) returned to OliveXC
OliveXC collected $0.90 from pot
OliveXC: doesn't show hand 
*** SUMMARY ***
Total pot $0.95 | Rake $0.05 
Board [Kd 2s Th Jh]
Seat 1: OliveXC (big blind) collected ($0.90)
Seat 2: Pezant folded before Flop (didn't bet)
Seat 3: ng2414 folded on the Turn
Seat 4: BaldEagleStar folded before Flop (didn't bet)
Seat 5: PlayTheBlues4U (button) folded on the Turn
Seat 6: efreay11 (small blind) folded before Flop


*********** # 43 **************
PokerStars Hand #204146575432:  Hold'em No Limit ($0.02/$0.05 USD) - 2019/10/01 22:35:59 ET
Table 'Corvus' 6-max Seat #3 is the button
Seat 1: Trratata ($4.67 in chips) 
Seat 2: REDRUM192 ($2.71 in chips) 
Seat 3: IvanMakeBasket ($4.63 in chips) 
Seat 4: artbone30 ($1.85 in chips) 
Seat 5: 7noodles ($6.15 in chips) 
Seat 6: PlayTheBlues4U ($5.41 in chips) 
artbone30: posts small blind $0.02
7noodles: posts big blind $0.05
*** HOLE CARDS ***
Dealt to PlayTheBlues4U [Js 2c]
PlayTheBlues4U: folds 
Trratata: folds 
REDRUM192: folds 
IvanMakeBasket: raises $0.05 to $0.10
artbone30: folds 
7noodles: raises $0.30 to $0.40
IvanMakeBasket: folds 
Uncalled bet ($0.30) returned to 7noodles
7noodles collected $0.22 from pot
7noodles: doesn't show hand 
*** SUMMARY ***
Total pot $0.22 | Rake $0 
Seat 1: Trratata folded before Flop (didn't bet)
Seat 2: REDRUM192 folded before Flop (didn't bet)
Seat 3: IvanMakeBasket (button) folded before Flop
Seat 4: artbone30 (small blind) folded before Flop
Seat 5: 7noodles (big blind) collected ($0.22)
Seat 6: PlayTheBlues4U folded before Flop (didn't bet)


*********** # 44 **************
PokerStars Hand #204146575376:  Hold'em No Limit ($0.05/$0.10 USD) - 2019/10/01 22:35:39 ET
Table 'Klytia' 6-max Seat #4 is the button
Seat 1: OliveXC ($15.64 in chips) 
Seat 2: Pezant ($10.53 in chips) 
Seat 3: ng2414 ($8.51 in chips) 
Seat 4: BaldEagleStar ($1.43 in chips) 
Seat 5: PlayTheBlues4U ($8.43 in chips) 
Seat 6: efreay11 ($28.68 in chips) 
PlayTheBlues4U: posts small blind $0.05
efreay11: posts big blind $0.10
*** HOLE CARDS ***
Dealt to PlayTheBlues4U [8d Ah]
OliveXC: folds 
Pezant: folds 
ng2414: folds 
BaldEagleStar: calls $0.10
PlayTheBlues4U: raises $0.20 to $0.30
efreay11: calls $0.20
BaldEagleStar: calls $0.20
*** FLOP *** [9s Ac 8c]
PlayTheBlues4U: bets $0.60
efreay11: folds 
BaldEagleStar: folds 
Uncalled bet ($0.60) returned to PlayTheBlues4U
PlayTheBlues4U collected $0.86 from pot
PlayTheBlues4U: doesn't show hand 
*** SUMMARY ***
Total pot $0.90 | Rake $0.04 
Board [9s Ac 8c]
Seat 1: OliveXC folded before Flop (didn't bet)
Seat 2: Pezant folded before Flop (didn't bet)
Seat 3: ng2414 folded before Flop (didn't bet)
Seat 4: BaldEagleStar (button) folded on the Flop
Seat 5: PlayTheBlues4U (small blind) collected ($0.86)
Seat 6: efreay11 (big blind) folded on the Flop


*********** # 45 **************
PokerStars Hand #204146575316:  Hold'em No Limit ($0.05/$0.10 USD) - 2019/10/01 22:35:18 ET
Table 'Klytia' 6-max Seat #3 is the button
Seat 1: OliveXC ($15.64 in chips) 
Seat 2: Pezant ($10.53 in chips) 
Seat 3: ng2414 ($8.51 in chips) 
Seat 4: BaldEagleStar ($1.23 in chips) 
Seat 5: PlayTheBlues4U ($8.53 in chips) 
Seat 6: efreay11 ($28.78 in chips) 
BaldEagleStar: posts small blind $0.05
PlayTheBlues4U: posts big blind $0.10
*** HOLE CARDS ***
Dealt to PlayTheBlues4U [8d Jh]
efreay11: calls $0.10
OliveXC: folds 
Pezant: folds 
ng2414: folds 
BaldEagleStar: raises $0.60 to $0.70
PlayTheBlues4U: folds 
efreay11: folds 
Uncalled bet ($0.60) returned to BaldEagleStar
BaldEagleStar collected $0.30 from pot
BaldEagleStar: doesn't show hand 
*** SUMMARY ***
Total pot $0.30 | Rake $0 
Seat 1: OliveXC folded before Flop (didn't bet)
Seat 2: Pezant folded before Flop (didn't bet)
Seat 3: ng2414 (button) folded before Flop (didn't bet)
Seat 4: BaldEagleStar (small blind) collected ($0.30)
Seat 5: PlayTheBlues4U (big blind) folded before Flop
Seat 6: efreay11 folded before Flop


*********** # 46 **************
PokerStars Hand #204146575307:  Hold'em No Limit ($0.02/$0.05 USD) - 2019/10/01 22:35:13 ET
Table 'Corvus' 6-max Seat #2 is the button
Seat 1: Trratata ($4.67 in chips) 
Seat 2: REDRUM192 ($2.71 in chips) 
Seat 3: IvanMakeBasket ($4.50 in chips) 
Seat 4: artbone30 ($2 in chips) 
Seat 5: 7noodles ($6.15 in chips) 
Seat 6: PlayTheBlues4U ($5.41 in chips) 
IvanMakeBasket: posts small blind $0.02
artbone30: posts big blind $0.05
*** HOLE CARDS ***
Dealt to PlayTheBlues4U [6c 7s]
7noodles: folds 
PlayTheBlues4U: folds 
Trratata: folds 
REDRUM192: folds 
IvanMakeBasket: calls $0.03
artbone30: raises $0.05 to $0.10
IvanMakeBasket: calls $0.05
*** FLOP *** [8h Ac Th]
IvanMakeBasket: checks 
artbone30: bets $0.05
IvanMakeBasket: calls $0.05
*** TURN *** [8h Ac Th] [2h]
IvanMakeBasket: checks 
artbone30: checks 
*** RIVER *** [8h Ac Th 2h] [Ah]
IvanMakeBasket: bets $0.05
artbone30: folds 
Uncalled bet ($0.05) returned to IvanMakeBasket
IvanMakeBasket collected $0.28 from pot
IvanMakeBasket: doesn't show hand 
*** SUMMARY ***
Total pot $0.30 | Rake $0.02 
Board [8h Ac Th 2h Ah]
Seat 1: Trratata folded before Flop (didn't bet)
Seat 2: REDRUM192 (button) folded before Flop (didn't bet)
Seat 3: IvanMakeBasket (small blind) collected ($0.28)
Seat 4: artbone30 (big blind) folded on the River
Seat 5: 7noodles folded before Flop (didn't bet)
Seat 6: PlayTheBlues4U folded before Flop (didn't bet)


*********** # 47 **************
PokerStars Hand #204146575255:  Hold'em No Limit ($0.02/$0.05 USD) - 2019/10/01 22:34:59 ET
Table 'Corvus' 6-max Seat #1 is the button
Seat 1: Trratata ($4.67 in chips) 
Seat 2: REDRUM192 ($2.66 in chips) 
Seat 3: IvanMakeBasket ($4.55 in chips) 
Seat 5: 7noodles ($6.15 in chips) 
Seat 6: PlayTheBlues4U ($5.41 in chips) 
REDRUM192: posts small blind $0.02
IvanMakeBasket: posts big blind $0.05
artbone30: sits out 
*** HOLE CARDS ***
Dealt to PlayTheBlues4U [7h Qs]
7noodles: folds 
PlayTheBlues4U: folds 
Trratata: folds 
REDRUM192: raises $0.15 to $0.20
IvanMakeBasket: folds 
Uncalled bet ($0.15) returned to REDRUM192
REDRUM192 collected $0.10 from pot
REDRUM192: doesn't show hand 
*** SUMMARY ***
Total pot $0.10 | Rake $0 
Seat 1: Trratata (button) folded before Flop (didn't bet)
Seat 2: REDRUM192 (small blind) collected ($0.10)
Seat 3: IvanMakeBasket (big blind) folded before Flop
Seat 5: 7noodles folded before Flop (didn't bet)
Seat 6: PlayTheBlues4U folded before Flop (didn't bet)


*********** # 48 **************
PokerStars Hand #204146575133:  Hold'em No Limit ($0.05/$0.10 USD) - 2019/10/01 22:34:23 ET
Table 'Klytia' 6-max Seat #2 is the button
Seat 1: OliveXC ($15.64 in chips) 
Seat 2: Pezant ($10.53 in chips) 
Seat 3: ng2414 ($8.61 in chips) 
Seat 4: BaldEagleStar ($1.14 in chips) 
Seat 5: PlayTheBlues4U ($8.53 in chips) 
Seat 6: efreay11 ($28.78 in chips) 
ng2414: posts small blind $0.05
BaldEagleStar: posts big blind $0.10
*** HOLE CARDS ***
Dealt to PlayTheBlues4U [5d 2c]
PlayTheBlues4U: folds 
efreay11 has timed out
efreay11: folds 
OliveXC: folds 
Pezant: folds 
ng2414: calls $0.05
BaldEagleStar: checks 
*** FLOP *** [2d 3s 5s]
ng2414: checks 
BaldEagleStar: bets $0.20
ng2414: folds 
Uncalled bet ($0.20) returned to BaldEagleStar
BaldEagleStar collected $0.19 from pot
BaldEagleStar: doesn't show hand 
*** SUMMARY ***
Total pot $0.20 | Rake $0.01 
Board [2d 3s 5s]
Seat 1: OliveXC folded before Flop (didn't bet)
Seat 2: Pezant (button) folded before Flop (didn't bet)
Seat 3: ng2414 (small blind) folded on the Flop
Seat 4: BaldEagleStar (big blind) collected ($0.19)
Seat 5: PlayTheBlues4U folded before Flop (didn't bet)
Seat 6: efreay11 folded before Flop (didn't bet)


*********** # 49 **************
PokerStars Hand #204146574949:  Hold'em No Limit ($0.02/$0.05 USD) - 2019/10/01 22:33:28 ET
Table 'Corvus' 6-max Seat #6 is the button
Seat 1: Trratata ($4.97 in chips) 
Seat 2: REDRUM192 ($3.41 in chips) 
Seat 3: IvanMakeBasket ($4.55 in chips) 
Seat 5: 7noodles ($5.19 in chips) 
Seat 6: PlayTheBlues4U ($5.41 in chips) 
Trratata: posts small blind $0.02
REDRUM192: posts big blind $0.05
*** HOLE CARDS ***
Dealt to PlayTheBlues4U [3s 5c]
IvanMakeBasket: folds 
7noodles: raises $0.07 to $0.12
PlayTheBlues4U: folds 
Trratata: raises $0.18 to $0.30
REDRUM192: calls $0.25
7noodles: raises $0.45 to $0.75
Trratata: folds 
REDRUM192: calls $0.45
*** FLOP *** [4c 9d Tc]
REDRUM192: checks 
artbone30 joins the table at seat #4 
7noodles: checks 
*** TURN *** [4c 9d Tc] [7d]
REDRUM192: checks 
7noodles: bets $0.86
REDRUM192: folds 
Uncalled bet ($0.86) returned to 7noodles
7noodles collected $1.71 from pot
7noodles: doesn't show hand 
*** SUMMARY ***
Total pot $1.80 | Rake $0.09 
Board [4c 9d Tc 7d]
Seat 1: Trratata (small blind) folded before Flop
Seat 2: REDRUM192 (big blind) folded on the Turn
Seat 3: IvanMakeBasket folded before Flop (didn't bet)
Seat 5: 7noodles collected ($1.71)
Seat 6: PlayTheBlues4U (button) folded before Flop (didn't bet)


*********** # 50 **************
PokerStars Hand #204146574919:  Hold'em No Limit ($0.05/$0.10 USD) - 2019/10/01 22:33:20 ET
Table 'Klytia' 6-max Seat #1 is the button
Seat 1: OliveXC ($15.64 in chips) 
Seat 2: Pezant ($10.83 in chips) 
Seat 3: ng2414 ($8.34 in chips) 
Seat 4: BaldEagleStar ($1.14 in chips) 
Seat 5: PlayTheBlues4U ($8.53 in chips) 
Seat 6: efreay11 ($28.78 in chips) 
Pezant: posts small blind $0.05
ng2414: posts big blind $0.10
*** HOLE CARDS ***
Dealt to PlayTheBlues4U [5c Kh]
BaldEagleStar: folds 
PlayTheBlues4U: folds 
efreay11 has timed out
efreay11: folds 
OliveXC: folds 
Pezant: raises $0.20 to $0.30
ng2414: calls $0.20
*** FLOP *** [Jh 6h Kc]
Pezant: checks 
ng2414: checks 
*** TURN *** [Jh 6h Kc] [5s]
Pezant: checks 
ng2414: bets $0.40
Pezant: folds 
Uncalled bet ($0.40) returned to ng2414
ng2414 collected $0.57 from pot
*** SUMMARY ***
Total pot $0.60 | Rake $0.03 
Board [Jh 6h Kc 5s]
Seat 1: OliveXC (button) folded before Flop (didn't bet)
Seat 2: Pezant (small blind) folded on the Turn
Seat 3: ng2414 (big blind) collected ($0.57)
Seat 4: BaldEagleStar folded before Flop (didn't bet)
Seat 5: PlayTheBlues4U folded before Flop (didn't bet)
Seat 6: efreay11 folded before Flop (didn't bet)


*********** # 51 **************
PokerStars Hand #204146574917:  Hold'em No Limit ($0.02/$0.05 USD) - 2019/10/01 22:33:19 ET
Table 'Corvus' 6-max Seat #5 is the button
Seat 1: Trratata ($4.95 in chips) 
Seat 2: REDRUM192 ($3.41 in chips) 
Seat 3: IvanMakeBasket ($4.55 in chips) 
Seat 5: 7noodles ($5.19 in chips) 
Seat 6: PlayTheBlues4U ($5.43 in chips) 
PlayTheBlues4U: posts small blind $0.02
Trratata: posts big blind $0.05
*** HOLE CARDS ***
Dealt to PlayTheBlues4U [3d Ks]
REDRUM192: folds 
IvanMakeBasket: folds 
7noodles: folds 
PlayTheBlues4U: folds 
Uncalled bet ($0.03) returned to Trratata
Trratata collected $0.04 from pot
Trratata: doesn't show hand 
*** SUMMARY ***
Total pot $0.04 | Rake $0 
Seat 1: Trratata (big blind) collected ($0.04)
Seat 2: REDRUM192 folded before Flop (didn't bet)
Seat 3: IvanMakeBasket folded before Flop (didn't bet)
Seat 5: 7noodles (button) folded before Flop (didn't bet)
Seat 6: PlayTheBlues4U (small blind) folded before Flop


*********** # 52 **************
PokerStars Hand #204146574852:  Hold'em No Limit ($0.02/$0.05 USD) - 2019/10/01 22:33:01 ET
Table 'Corvus' 6-max Seat #3 is the button
Seat 1: Trratata ($4.95 in chips) 
Seat 2: REDRUM192 ($3.34 in chips) 
Seat 3: IvanMakeBasket ($4.55 in chips) 
Seat 5: 7noodles ($5.21 in chips) 
Seat 6: PlayTheBlues4U ($5.48 in chips) 
7noodles: posts small blind $0.02
PlayTheBlues4U: posts big blind $0.05
*** HOLE CARDS ***
Dealt to PlayTheBlues4U [9d 4c]
Trratata: folds 
REDRUM192: raises $0.10 to $0.15
IvanMakeBasket: folds 
7noodles: folds 
PlayTheBlues4U: folds 
Uncalled bet ($0.10) returned to REDRUM192
REDRUM192 collected $0.12 from pot
REDRUM192: doesn't show hand 
*** SUMMARY ***
Total pot $0.12 | Rake $0 
Seat 1: Trratata folded before Flop (didn't bet)
Seat 2: REDRUM192 collected ($0.12)
Seat 3: IvanMakeBasket (button) folded before Flop (didn't bet)
Seat 5: 7noodles (small blind) folded before Flop
Seat 6: PlayTheBlues4U (big blind) folded before Flop


*********** # 53 **************
PokerStars Hand #204146574833:  Hold'em No Limit ($0.05/$0.10 USD) - 2019/10/01 22:32:54 ET
Table 'Klytia' 6-max Seat #6 is the button
Seat 1: OliveXC ($15.69 in chips) 
Seat 2: Pezant ($10.93 in chips) 
Seat 3: ng2414 ($7.93 in chips) 
Seat 4: BaldEagleStar ($1.14 in chips) 
Seat 5: PlayTheBlues4U ($8.53 in chips) 
Seat 6: efreay11 ($29.08 in chips) 
OliveXC: posts small blind $0.05
Pezant: posts big blind $0.10
*** HOLE CARDS ***
Dealt to PlayTheBlues4U [7d 9c]
ng2414: raises $0.20 to $0.30
BaldEagleStar: folds 
PlayTheBlues4U: folds 
efreay11: calls $0.30
OliveXC: folds 
Pezant: folds 
*** FLOP *** [9d 4h 7h]
ng2414: bets $0.30
efreay11: folds 
Uncalled bet ($0.30) returned to ng2414
ng2414 collected $0.71 from pot
*** SUMMARY ***
Total pot $0.75 | Rake $0.04 
Board [9d 4h 7h]
Seat 1: OliveXC (small blind) folded before Flop
Seat 2: Pezant (big blind) folded before Flop
Seat 3: ng2414 collected ($0.71)
Seat 4: BaldEagleStar folded before Flop (didn't bet)
Seat 5: PlayTheBlues4U folded before Flop (didn't bet)
Seat 6: efreay11 (button) folded on the Flop


*********** # 54 **************
PokerStars Hand #204146574800:  Hold'em No Limit ($0.02/$0.05 USD) - 2019/10/01 22:32:46 ET
Table 'Corvus' 6-max Seat #2 is the button
Seat 1: Trratata ($4.95 in chips) 
Seat 2: REDRUM192 ($3.34 in chips) 
Seat 3: IvanMakeBasket ($4.57 in chips) 
Seat 5: 7noodles ($5.19 in chips) 
Seat 6: PlayTheBlues4U ($5.48 in chips) 
IvanMakeBasket: posts small blind $0.02
7noodles: posts big blind $0.05
*** HOLE CARDS ***
Dealt to PlayTheBlues4U [7d Td]
PlayTheBlues4U: folds 
Trratata: folds 
REDRUM192: folds 
IvanMakeBasket: folds 
Uncalled bet ($0.03) returned to 7noodles
7noodles collected $0.04 from pot
MozenMo was removed from the table for failing to post
MozenMo leaves the table
*** SUMMARY ***
Total pot $0.04 | Rake $0 
Seat 1: Trratata folded before Flop (didn't bet)
Seat 2: REDRUM192 (button) folded before Flop (didn't bet)
Seat 3: IvanMakeBasket (small blind) folded before Flop
Seat 5: 7noodles (big blind) collected ($0.04)
Seat 6: PlayTheBlues4U folded before Flop (didn't bet)


*********** # 55 **************
PokerStars Hand #204146574770:  Hold'em No Limit ($0.02/$0.05 USD) - 2019/10/01 22:32:36 ET
Table 'Corvus' 6-max Seat #1 is the button
Seat 1: Trratata ($4.95 in chips) 
Seat 2: REDRUM192 ($3.36 in chips) 
Seat 3: IvanMakeBasket ($4.55 in chips) 
Seat 5: 7noodles ($5.19 in chips) 
Seat 6: PlayTheBlues4U ($5.48 in chips) 
REDRUM192: posts small blind $0.02
IvanMakeBasket: posts big blind $0.05
*** HOLE CARDS ***
Dealt to PlayTheBlues4U [3h 5d]
7noodles: folds 
PlayTheBlues4U: folds 
Trratata: folds 
REDRUM192: folds 
Uncalled bet ($0.03) returned to IvanMakeBasket
IvanMakeBasket collected $0.04 from pot
IvanMakeBasket: doesn't show hand 
*** SUMMARY ***
Total pot $0.04 | Rake $0 
Seat 1: Trratata (button) folded before Flop (didn't bet)
Seat 2: REDRUM192 (small blind) folded before Flop
Seat 3: IvanMakeBasket (big blind) collected ($0.04)
Seat 5: 7noodles folded before Flop (didn't bet)
Seat 6: PlayTheBlues4U folded before Flop (didn't bet)


*********** # 56 **************
PokerStars Hand #204146574722:  Hold'em No Limit ($0.02/$0.05 USD) - 2019/10/01 22:32:20 ET
Table 'Corvus' 6-max Seat #6 is the button
Seat 1: Trratata ($4.97 in chips) 
Seat 2: REDRUM192 ($3.41 in chips) 
Seat 3: IvanMakeBasket ($4.48 in chips) 
Seat 5: 7noodles ($5.19 in chips) 
Seat 6: PlayTheBlues4U ($5.48 in chips) 
Trratata: posts small blind $0.02
REDRUM192: posts big blind $0.05
*** HOLE CARDS ***
Dealt to PlayTheBlues4U [6s Ad]
IvanMakeBasket: raises $0.05 to $0.10
7noodles: folds 
PlayTheBlues4U: folds 
Trratata: folds 
REDRUM192: folds 
Uncalled bet ($0.05) returned to IvanMakeBasket
IvanMakeBasket collected $0.12 from pot
IvanMakeBasket: doesn't show hand 
*** SUMMARY ***
Total pot $0.12 | Rake $0 
Seat 1: Trratata (small blind) folded before Flop
Seat 2: REDRUM192 (big blind) folded before Flop
Seat 3: IvanMakeBasket collected ($0.12)
Seat 5: 7noodles folded before Flop (didn't bet)
Seat 6: PlayTheBlues4U (button) folded before Flop (didn't bet)


*********** # 57 **************
PokerStars Hand #204146574553:  Hold'em No Limit ($0.02/$0.05 USD) - 2019/10/01 22:31:27 ET
Table 'Corvus' 6-max Seat #5 is the button
Seat 1: Trratata ($5.22 in chips) 
Seat 2: REDRUM192 ($3.41 in chips) 
Seat 3: IvanMakeBasket ($4.48 in chips) 
Seat 5: 7noodles ($4.95 in chips) 
Seat 6: PlayTheBlues4U ($5.50 in chips) 
PlayTheBlues4U: posts small blind $0.02
Trratata: posts big blind $0.05
*** HOLE CARDS ***
Dealt to PlayTheBlues4U [3c 2s]
REDRUM192: folds 
IvanMakeBasket: folds 
7noodles: raises $0.07 to $0.12
PlayTheBlues4U: folds 
Trratata: calls $0.07
*** FLOP *** [Qh Qs Kd]
Trratata: checks 
7noodles: checks 
*** TURN *** [Qh Qs Kd] [Jd]
Trratata: checks 
7noodles: bets $0.13
Trratata: calls $0.13
*** RIVER *** [Qh Qs Kd Jd] [6d]
Trratata: checks 
7noodles: checks 
*** SHOW DOWN ***
Trratata: shows [9h Ad] (a pair of Queens)
7noodles: shows [Ks 8c] (two pair, Kings and Queens)
7noodles collected $0.49 from pot
*** SUMMARY ***
Total pot $0.52 | Rake $0.03 
Board [Qh Qs Kd Jd 6d]
Seat 1: Trratata (big blind) showed [9h Ad] and lost with a pair of Queens
Seat 2: REDRUM192 folded before Flop (didn't bet)
Seat 3: IvanMakeBasket folded before Flop (didn't bet)
Seat 5: 7noodles (button) showed [Ks 8c] and won ($0.49) with two pair, Kings and Queens
Seat 6: PlayTheBlues4U (small blind) folded before Flop


*********** # 58 **************
PokerStars Hand #204146574503:  Hold'em No Limit ($0.05/$0.10 USD) - 2019/10/01 22:31:15 ET
Table 'Klytia' 6-max Seat #5 is the button
Seat 1: OliveXC ($16.53 in chips) 
Seat 2: Pezant ($13.27 in chips) 
Seat 3: ng2414 ($8.20 in chips) 
Seat 4: BaldEagleStar ($1.41 in chips) 
Seat 5: PlayTheBlues4U ($8.53 in chips) 
Seat 6: efreay11 ($25.66 in chips) 
efreay11: posts small blind $0.05
OliveXC: posts big blind $0.10
*** HOLE CARDS ***
Dealt to PlayTheBlues4U [8c 2c]
Pezant: raises $0.17 to $0.27
ng2414: calls $0.27
BaldEagleStar: calls $0.27
PlayTheBlues4U: folds 
efreay11: calls $0.22
OliveXC: calls $0.17
*** FLOP *** [Kh Jc Td]
efreay11: checks 
OliveXC: checks 
Pezant: bets $0.57
ng2414: folds 
BaldEagleStar: folds 
efreay11: calls $0.57
OliveXC: calls $0.57
*** TURN *** [Kh Jc Td] [Jh]
efreay11: checks 
OliveXC: checks 
Pezant: checks 
*** RIVER *** [Kh Jc Td Jh] [6h]
efreay11: bets $1.50
OliveXC: folds 
Pezant: calls $1.50
*** SHOW DOWN ***
efreay11: shows [7h 8h] (a flush, King high)
Pezant: mucks hand 
efreay11 collected $5.76 from pot
*** SUMMARY ***
Total pot $6.06 | Rake $0.30 
Board [Kh Jc Td Jh 6h]
Seat 1: OliveXC (big blind) folded on the River
Seat 2: Pezant mucked [Qc Ad]
Seat 3: ng2414 folded on the Flop
Seat 4: BaldEagleStar folded on the Flop
Seat 5: PlayTheBlues4U (button) folded before Flop (didn't bet)
Seat 6: efreay11 (small blind) showed [7h 8h] and won ($5.76) with a flush, King high


*********** # 59 **************
PokerStars Hand #204146574442:  Hold'em No Limit ($0.02/$0.05 USD) - 2019/10/01 22:30:56 ET
Table 'Corvus' 6-max Seat #3 is the button
Seat 1: Trratata ($5.22 in chips) 
Seat 2: REDRUM192 ($3.41 in chips) 
Seat 3: IvanMakeBasket ($4.48 in chips) 
Seat 5: 7noodles ($4.97 in chips) 
Seat 6: PlayTheBlues4U ($5.48 in chips) 
7noodles: posts small blind $0.02
PlayTheBlues4U: posts big blind $0.05
*** HOLE CARDS ***
Dealt to PlayTheBlues4U [8h Jc]
Trratata: folds 
REDRUM192: folds 
IvanMakeBasket: folds 
7noodles: folds 
Uncalled bet ($0.03) returned to PlayTheBlues4U
PlayTheBlues4U collected $0.04 from pot
PlayTheBlues4U: doesn't show hand 
*** SUMMARY ***
Total pot $0.04 | Rake $0 
Seat 1: Trratata folded before Flop (didn't bet)
Seat 2: REDRUM192 folded before Flop (didn't bet)
Seat 3: IvanMakeBasket (button) folded before Flop (didn't bet)
Seat 5: 7noodles (small blind) folded before Flop
Seat 6: PlayTheBlues4U (big blind) collected ($0.04)


*********** # 60 **************
PokerStars Hand #204146574414:  Hold'em No Limit ($0.05/$0.10 USD) - 2019/10/01 22:30:47 ET
Table 'Klytia' 6-max Seat #4 is the button
Seat 1: OliveXC ($16.53 in chips) 
Seat 2: Pezant ($13.27 in chips) 
Seat 3: ng2414 ($8.20 in chips) 
Seat 4: BaldEagleStar ($1.71 in chips) 
Seat 5: PlayTheBlues4U ($8.58 in chips) 
Seat 6: efreay11 ($25.34 in chips) 
PlayTheBlues4U: posts small blind $0.05
efreay11: posts big blind $0.10
*** HOLE CARDS ***
Dealt to PlayTheBlues4U [2d 4h]
OliveXC: folds 
Pezant: folds 
ng2414: folds 
BaldEagleStar: calls $0.10
PlayTheBlues4U: folds 
efreay11: raises $0.20 to $0.30
BaldEagleStar: calls $0.20
*** FLOP *** [Tc 3h 6s]
efreay11: checks 
BaldEagleStar: checks 
*** TURN *** [Tc 3h 6s] [Jd]
efreay11: bets $0.30
BaldEagleStar: folds 
Uncalled bet ($0.30) returned to efreay11
efreay11 collected $0.62 from pot
efreay11: doesn't show hand 
*** SUMMARY ***
Total pot $0.65 | Rake $0.03 
Board [Tc 3h 6s Jd]
Seat 1: OliveXC folded before Flop (didn't bet)
Seat 2: Pezant folded before Flop (didn't bet)
Seat 3: ng2414 folded before Flop (didn't bet)
Seat 4: BaldEagleStar (button) folded on the Turn
Seat 5: PlayTheBlues4U (small blind) folded before Flop
Seat 6: efreay11 (big blind) collected ($0.62)


*********** # 61 **************
PokerStars Hand #204146574368:  Hold'em No Limit ($0.02/$0.05 USD) - 2019/10/01 22:30:34 ET
Table 'Corvus' 6-max Seat #2 is the button
Seat 1: Trratata ($5.22 in chips) 
Seat 2: REDRUM192 ($3.41 in chips) 
Seat 3: IvanMakeBasket ($4.50 in chips) 
Seat 5: 7noodles ($5.02 in chips) 
Seat 6: PlayTheBlues4U ($5.41 in chips) 
IvanMakeBasket: posts small blind $0.02
7noodles: posts big blind $0.05
*** HOLE CARDS ***
Dealt to PlayTheBlues4U [4s 4c]
PlayTheBlues4U: raises $0.10 to $0.15
Trratata: folds 
REDRUM192: folds 
IvanMakeBasket: folds 
7noodles: folds 
Uncalled bet ($0.10) returned to PlayTheBlues4U
PlayTheBlues4U collected $0.12 from pot
PlayTheBlues4U: doesn't show hand 
*** SUMMARY ***
Total pot $0.12 | Rake $0 
Seat 1: Trratata folded before Flop (didn't bet)
Seat 2: REDRUM192 (button) folded before Flop (didn't bet)
Seat 3: IvanMakeBasket (small blind) folded before Flop
Seat 5: 7noodles (big blind) folded before Flop
Seat 6: PlayTheBlues4U collected ($0.12)


*********** # 62 **************
PokerStars Hand #204146574318:  Hold'em No Limit ($0.02/$0.05 USD) - 2019/10/01 22:30:19 ET
Table 'Corvus' 6-max Seat #1 is the button
Seat 1: Trratata ($5.22 in chips) 
Seat 2: REDRUM192 ($3.43 in chips) 
Seat 3: IvanMakeBasket ($4.48 in chips) 
Seat 5: 7noodles ($5.02 in chips) 
Seat 6: PlayTheBlues4U ($5.41 in chips) 
REDRUM192: posts small blind $0.02
IvanMakeBasket: posts big blind $0.05
*** HOLE CARDS ***
Dealt to PlayTheBlues4U [5c 6s]
7noodles: folds 
PlayTheBlues4U: folds 
Trratata: folds 
REDRUM192: folds 
Uncalled bet ($0.03) returned to IvanMakeBasket
IvanMakeBasket collected $0.04 from pot
IvanMakeBasket: doesn't show hand 
*** SUMMARY ***
Total pot $0.04 | Rake $0 
Seat 1: Trratata (button) folded before Flop (didn't bet)
Seat 2: REDRUM192 (small blind) folded before Flop
Seat 3: IvanMakeBasket (big blind) collected ($0.04)
Seat 5: 7noodles folded before Flop (didn't bet)
Seat 6: PlayTheBlues4U folded before Flop (didn't bet)


*********** # 63 **************
PokerStars Hand #204146574231:  Hold'em No Limit ($0.05/$0.10 USD) - 2019/10/01 22:29:56 ET
Table 'Klytia' 6-max Seat #3 is the button
Seat 1: OliveXC ($16.53 in chips) 
Seat 2: Pezant ($13.27 in chips) 
Seat 3: ng2414 ($8.30 in chips) 
Seat 4: BaldEagleStar ($1.81 in chips) 
Seat 5: PlayTheBlues4U ($8.68 in chips) 
Seat 6: efreay11 ($25.06 in chips) 
BaldEagleStar: posts small blind $0.05
PlayTheBlues4U: posts big blind $0.10
*** HOLE CARDS ***
Dealt to PlayTheBlues4U [9s 2s]
efreay11: calls $0.10
OliveXC: folds 
Pezant: folds 
ng2414: calls $0.10
BaldEagleStar: calls $0.05
PlayTheBlues4U: checks 
*** FLOP *** [7c Ah As]
BaldEagleStar: checks 
PlayTheBlues4U: checks 
efreay11: checks 
ng2414: checks 
*** TURN *** [7c Ah As] [5c]
BaldEagleStar: checks 
PlayTheBlues4U: checks 
efreay11: bets $0.40
ng2414: folds 
BaldEagleStar: folds 
PlayTheBlues4U: folds 
Uncalled bet ($0.40) returned to efreay11
efreay11 collected $0.38 from pot
efreay11: doesn't show hand 
*** SUMMARY ***
Total pot $0.40 | Rake $0.02 
Board [7c Ah As 5c]
Seat 1: OliveXC folded before Flop (didn't bet)
Seat 2: Pezant folded before Flop (didn't bet)
Seat 3: ng2414 (button) folded on the Turn
Seat 4: BaldEagleStar (small blind) folded on the Turn
Seat 5: PlayTheBlues4U (big blind) folded on the Turn
Seat 6: efreay11 collected ($0.38)


*********** # 64 **************
PokerStars Hand #204146574193:  Hold'em No Limit ($0.02/$0.05 USD) - 2019/10/01 22:29:45 ET
Table 'Corvus' 6-max Seat #6 is the button
Seat 1: Trratata ($4.95 in chips) 
Seat 2: REDRUM192 ($3.73 in chips) 
Seat 3: IvanMakeBasket ($4.48 in chips) 
Seat 5: 7noodles ($5.02 in chips) 
Seat 6: PlayTheBlues4U ($5.41 in chips) 
Trratata: posts small blind $0.02
REDRUM192: posts big blind $0.05
*** HOLE CARDS ***
Dealt to PlayTheBlues4U [Kc 2s]
IvanMakeBasket: folds 
7noodles: folds 
PlayTheBlues4U: folds 
Trratata: raises $0.10 to $0.15
REDRUM192: calls $0.10
*** FLOP *** [2c 2d Jd]
Trratata: bets $0.15
REDRUM192: calls $0.15
*** TURN *** [2c 2d Jd] [Ks]
Trratata: bets $0.25
REDRUM192: folds 
Uncalled bet ($0.25) returned to Trratata
Trratata collected $0.57 from pot
Trratata: doesn't show hand 
*** SUMMARY ***
Total pot $0.60 | Rake $0.03 
Board [2c 2d Jd Ks]
Seat 1: Trratata (small blind) collected ($0.57)
Seat 2: REDRUM192 (big blind) folded on the Turn
Seat 3: IvanMakeBasket folded before Flop (didn't bet)
Seat 5: 7noodles folded before Flop (didn't bet)
Seat 6: PlayTheBlues4U (button) folded before Flop (didn't bet)


*********** # 65 **************
PokerStars Hand #204146574162:  Hold'em No Limit ($0.05/$0.10 USD) - 2019/10/01 22:29:36 ET
Table 'Klytia' 6-max Seat #2 is the button
Seat 1: OliveXC ($16.53 in chips) 
Seat 2: Pezant ($13.27 in chips) 
Seat 3: ng2414 ($8 in chips) 
Seat 4: BaldEagleStar ($1.91 in chips) 
Seat 5: PlayTheBlues4U ($8.68 in chips) 
Seat 6: efreay11 ($25.26 in chips) 
ng2414: posts small blind $0.05
BaldEagleStar: posts big blind $0.10
*** HOLE CARDS ***
Dealt to PlayTheBlues4U [6d 9h]
PlayTheBlues4U: folds 
efreay11: raises $0.10 to $0.20
OliveXC: folds 
Pezant: folds 
ng2414: raises $0.50 to $0.70
BaldEagleStar: folds 
efreay11: folds 
Uncalled bet ($0.50) returned to ng2414
ng2414 collected $0.50 from pot
*** SUMMARY ***
Total pot $0.50 | Rake $0 
Seat 1: OliveXC folded before Flop (didn't bet)
Seat 2: Pezant (button) folded before Flop (didn't bet)
Seat 3: ng2414 (small blind) collected ($0.50)
Seat 4: BaldEagleStar (big blind) folded before Flop
Seat 5: PlayTheBlues4U folded before Flop (didn't bet)
Seat 6: efreay11 folded before Flop


*********** # 66 **************
PokerStars Hand #204146574160:  Hold'em No Limit ($0.02/$0.05 USD) - 2019/10/01 22:29:35 ET
Table 'Corvus' 6-max Seat #5 is the button
Seat 1: Trratata ($4.93 in chips) 
Seat 2: REDRUM192 ($3.73 in chips) 
Seat 3: IvanMakeBasket ($4.48 in chips) 
Seat 5: 7noodles ($5.02 in chips) 
Seat 6: PlayTheBlues4U ($5.43 in chips) 
PlayTheBlues4U: posts small blind $0.02
Trratata: posts big blind $0.05
*** HOLE CARDS ***
Dealt to PlayTheBlues4U [4s 9h]
REDRUM192: folds 
IvanMakeBasket: folds 
7noodles: folds 
PlayTheBlues4U: folds 
Uncalled bet ($0.03) returned to Trratata
Trratata collected $0.04 from pot
Trratata: doesn't show hand 
*** SUMMARY ***
Total pot $0.04 | Rake $0 
Seat 1: Trratata (big blind) collected ($0.04)
Seat 2: REDRUM192 folded before Flop (didn't bet)
Seat 3: IvanMakeBasket folded before Flop (didn't bet)
Seat 5: 7noodles (button) folded before Flop (didn't bet)
Seat 6: PlayTheBlues4U (small blind) folded before Flop


*********** # 67 **************
PokerStars Hand #204146574092:  Hold'em No Limit ($0.02/$0.05 USD) - 2019/10/01 22:29:18 ET
Table 'Corvus' 6-max Seat #3 is the button
Seat 1: Trratata ($4.93 in chips) 
Seat 2: REDRUM192 ($3.73 in chips) 
Seat 3: IvanMakeBasket ($4.48 in chips) 
Seat 5: 7noodles ($5.04 in chips) 
Seat 6: PlayTheBlues4U ($5.41 in chips) 
7noodles: posts small blind $0.02
PlayTheBlues4U: posts big blind $0.05
*** HOLE CARDS ***
Dealt to PlayTheBlues4U [9c 3d]
Trratata: folds 
REDRUM192: folds 
IvanMakeBasket: folds 
7noodles: folds 
Uncalled bet ($0.03) returned to PlayTheBlues4U
PlayTheBlues4U collected $0.04 from pot
PlayTheBlues4U: doesn't show hand 
*** SUMMARY ***
Total pot $0.04 | Rake $0 
Seat 1: Trratata folded before Flop (didn't bet)
Seat 2: REDRUM192 folded before Flop (didn't bet)
Seat 3: IvanMakeBasket (button) folded before Flop (didn't bet)
Seat 5: 7noodles (small blind) folded before Flop
Seat 6: PlayTheBlues4U (big blind) collected ($0.04)


*********** # 68 **************
PokerStars Hand #204146574091:  Hold'em No Limit ($0.05/$0.10 USD) - 2019/10/01 22:29:18 ET
Table 'Klytia' 6-max Seat #1 is the button
Seat 1: OliveXC ($16.53 in chips) 
Seat 2: Pezant ($13.32 in chips) 
Seat 3: ng2414 ($8.10 in chips) 
Seat 4: BaldEagleStar ($1.91 in chips) 
Seat 5: PlayTheBlues4U ($8.68 in chips) 
Seat 6: efreay11 ($25.11 in chips) 
Pezant: posts small blind $0.05
ng2414: posts big blind $0.10
*** HOLE CARDS ***
Dealt to PlayTheBlues4U [9h 2c]
BaldEagleStar: folds 
PlayTheBlues4U: folds 
efreay11: raises $0.20 to $0.30
OliveXC: folds 
Pezant: folds 
ng2414: folds 
Uncalled bet ($0.20) returned to efreay11
efreay11 collected $0.25 from pot
efreay11: doesn't show hand 
*** SUMMARY ***
Total pot $0.25 | Rake $0 
Seat 1: OliveXC (button) folded before Flop (didn't bet)
Seat 2: Pezant (small blind) folded before Flop
Seat 3: ng2414 (big blind) folded before Flop
Seat 4: BaldEagleStar folded before Flop (didn't bet)
Seat 5: PlayTheBlues4U folded before Flop (didn't bet)
Seat 6: efreay11 collected ($0.25)


*********** # 69 **************
PokerStars Hand #204146574045:  Hold'em No Limit ($0.02/$0.05 USD) - 2019/10/01 22:29:05 ET
Table 'Corvus' 6-max Seat #2 is the button
Seat 1: Trratata ($4.93 in chips) 
Seat 2: REDRUM192 ($3.73 in chips) 
Seat 3: IvanMakeBasket ($4.50 in chips) 
Seat 5: 7noodles ($5.02 in chips) 
Seat 6: PlayTheBlues4U ($5.41 in chips) 
IvanMakeBasket: posts small blind $0.02
7noodles: posts big blind $0.05
*** HOLE CARDS ***
Dealt to PlayTheBlues4U [6h 2d]
PlayTheBlues4U: folds 
Trratata: folds 
REDRUM192: folds 
IvanMakeBasket: folds 
Uncalled bet ($0.03) returned to 7noodles
7noodles collected $0.04 from pot
7noodles: doesn't show hand 
*** SUMMARY ***
Total pot $0.04 | Rake $0 
Seat 1: Trratata folded before Flop (didn't bet)
Seat 2: REDRUM192 (button) folded before Flop (didn't bet)
Seat 3: IvanMakeBasket (small blind) folded before Flop
Seat 5: 7noodles (big blind) collected ($0.04)
Seat 6: PlayTheBlues4U folded before Flop (didn't bet)


*********** # 70 **************
PokerStars Hand #204146574017:  Hold'em No Limit ($0.02/$0.05 USD) - 2019/10/01 22:28:54 ET
Table 'Corvus' 6-max Seat #1 is the button
Seat 1: Trratata ($4.93 in chips) 
Seat 2: REDRUM192 ($3.75 in chips) 
Seat 3: IvanMakeBasket ($4.48 in chips) 
Seat 6: PlayTheBlues4U ($5.41 in chips) 
REDRUM192: posts small blind $0.02
IvanMakeBasket: posts big blind $0.05
7noodles: sits out 
*** HOLE CARDS ***
Dealt to PlayTheBlues4U [4s Ad]
PlayTheBlues4U: folds 
Trratata: folds 
REDRUM192: folds 
Uncalled bet ($0.03) returned to IvanMakeBasket
IvanMakeBasket collected $0.04 from pot
IvanMakeBasket: doesn't show hand 
*** SUMMARY ***
Total pot $0.04 | Rake $0 
Seat 1: Trratata (button) folded before Flop (didn't bet)
Seat 2: REDRUM192 (small blind) folded before Flop
Seat 3: IvanMakeBasket (big blind) collected ($0.04)
Seat 6: PlayTheBlues4U folded before Flop (didn't bet)


*********** # 71 **************
PokerStars Hand #204146573952:  Hold'em No Limit ($0.02/$0.05 USD) - 2019/10/01 22:28:38 ET
Table 'Corvus' 6-max Seat #6 is the button
Seat 1: Trratata ($4.95 in chips) 
Seat 2: REDRUM192 ($3.80 in chips) 
Seat 3: IvanMakeBasket ($4.41 in chips) 
Seat 6: PlayTheBlues4U ($5.41 in chips) 
Trratata: posts small blind $0.02
REDRUM192: posts big blind $0.05
7noodles: sits out 
*** HOLE CARDS ***
Dealt to PlayTheBlues4U [4h 3d]
IvanMakeBasket: raises $0.05 to $0.10
PlayTheBlues4U: folds 
Trratata: folds 
REDRUM192: folds 
Uncalled bet ($0.05) returned to IvanMakeBasket
IvanMakeBasket collected $0.12 from pot
IvanMakeBasket: doesn't show hand 
*** SUMMARY ***
Total pot $0.12 | Rake $0 
Seat 1: Trratata (small blind) folded before Flop
Seat 2: REDRUM192 (big blind) folded before Flop
Seat 3: IvanMakeBasket collected ($0.12)
Seat 6: PlayTheBlues4U (button) folded before Flop (didn't bet)


*********** # 72 **************
PokerStars Hand #204146573885:  Hold'em No Limit ($0.02/$0.05 USD) - 2019/10/01 22:28:20 ET
Table 'Corvus' 6-max Seat #3 is the button
Seat 1: Trratata ($5 in chips) 
Seat 2: REDRUM192 ($3.80 in chips) 
Seat 3: IvanMakeBasket ($4.34 in chips) 
Seat 6: PlayTheBlues4U ($5.43 in chips) 
7noodles will be allowed to play after the button
PlayTheBlues4U: posts small blind $0.02
Trratata: posts big blind $0.05
*** HOLE CARDS ***
Dealt to PlayTheBlues4U [Ts Kh]
REDRUM192: folds 
IvanMakeBasket: raises $0.05 to $0.10
PlayTheBlues4U: folds 
Trratata: folds 
Uncalled bet ($0.05) returned to IvanMakeBasket
IvanMakeBasket collected $0.12 from pot
IvanMakeBasket: doesn't show hand 
*** SUMMARY ***
Total pot $0.12 | Rake $0 
Seat 1: Trratata (big blind) folded before Flop
Seat 2: REDRUM192 folded before Flop (didn't bet)
Seat 3: IvanMakeBasket (button) collected ($0.12)
Seat 6: PlayTheBlues4U (small blind) folded before Flop


*********** # 73 **************
PokerStars Hand #204146573737:  Hold'em No Limit ($0.05/$0.10 USD) - 2019/10/01 22:27:36 ET
Table 'Klytia' 6-max Seat #6 is the button
Seat 1: OliveXC ($16.58 in chips) 
Seat 2: Pezant ($13.42 in chips) 
Seat 3: ng2414 ($9.40 in chips) 
Seat 4: BaldEagleStar ($1.91 in chips) 
Seat 5: PlayTheBlues4U ($9.18 in chips) 
Seat 6: efreay11 ($23.32 in chips) 
OliveXC: posts small blind $0.05
Pezant: posts big blind $0.10
*** HOLE CARDS ***
Dealt to PlayTheBlues4U [Jd Qh]
ng2414: raises $0.20 to $0.30
BaldEagleStar: folds 
PlayTheBlues4U: calls $0.30
efreay11: raises $0.20 to $0.50
OliveXC: folds 
Pezant: folds 
ng2414: calls $0.20
PlayTheBlues4U: calls $0.20
*** FLOP *** [7h 6c 4c]
ng2414: checks 
PlayTheBlues4U: checks 
efreay11: bets $0.80
ng2414: calls $0.80
PlayTheBlues4U: folds 
*** TURN *** [7h 6c 4c] [Qs]
ng2414: checks 
efreay11: checks 
*** RIVER *** [7h 6c 4c Qs] [9h]
ng2414: checks 
efreay11: checks 
*** SHOW DOWN ***
ng2414: shows [Jc Kc] (high card King)
efreay11: shows [Ad 7d] (a pair of Sevens)
efreay11 collected $3.09 from pot
*** SUMMARY ***
Total pot $3.25 | Rake $0.16 
Board [7h 6c 4c Qs 9h]
Seat 1: OliveXC (small blind) folded before Flop
Seat 2: Pezant (big blind) folded before Flop
Seat 3: ng2414 showed [Jc Kc] and lost with high card King
Seat 4: BaldEagleStar folded before Flop (didn't bet)
Seat 5: PlayTheBlues4U folded on the Flop
Seat 6: efreay11 (button) showed [Ad 7d] and won ($3.09) with a pair of Sevens


*********** # 74 **************
PokerStars Hand #204146573687:  Hold'em No Limit ($0.02/$0.05 USD) - 2019/10/01 22:27:18 ET
Table 'Corvus' 6-max Seat #2 is the button
Seat 2: REDRUM192 ($3.80 in chips) 
Seat 3: IvanMakeBasket ($4.79 in chips) 
Seat 6: PlayTheBlues4U ($5.02 in chips) 
IvanMakeBasket: posts small blind $0.02
PlayTheBlues4U: posts big blind $0.05
Trratata: sits out 
*** HOLE CARDS ***
Dealt to PlayTheBlues4U [8d Th]
REDRUM192: folds 
IvanMakeBasket: raises $0.10 to $0.15
PlayTheBlues4U: calls $0.10
*** FLOP *** [Ks Ah Ts]
IvanMakeBasket: bets $0.10
PlayTheBlues4U: calls $0.10
*** TURN *** [Ks Ah Ts] [7s]
IvanMakeBasket: bets $0.20
PlayTheBlues4U: calls $0.20
*** RIVER *** [Ks Ah Ts 7s] [Js]
IvanMakeBasket: checks 
PlayTheBlues4U: bets $0.60
IvanMakeBasket: folds 
Uncalled bet ($0.60) returned to PlayTheBlues4U
PlayTheBlues4U collected $0.86 from pot
PlayTheBlues4U: doesn't show hand 
*** SUMMARY ***
Total pot $0.90 | Rake $0.04 
Board [Ks Ah Ts 7s Js]
Seat 2: REDRUM192 (button) folded before Flop (didn't bet)
Seat 3: IvanMakeBasket (small blind) folded on the River
Seat 6: PlayTheBlues4U (big blind) collected ($0.86)


*********** # 75 **************
PokerStars Hand #204146573611:  Hold'em No Limit ($0.05/$0.10 USD) - 2019/10/01 22:26:53 ET
Table 'Klytia' 6-max Seat #5 is the button
Seat 1: OliveXC ($16.18 in chips) 
Seat 2: Pezant ($13.42 in chips) 
Seat 3: ng2414 ($9.40 in chips) 
Seat 4: BaldEagleStar ($2.11 in chips) 
Seat 5: PlayTheBlues4U ($9.18 in chips) 
Seat 6: efreay11 ($23.52 in chips) 
efreay11: posts small blind $0.05
OliveXC: posts big blind $0.10
*** HOLE CARDS ***
Dealt to PlayTheBlues4U [Qc 6h]
Pezant: folds 
ng2414: folds 
BaldEagleStar: raises $0.10 to $0.20
PlayTheBlues4U: folds 
efreay11: calls $0.15
OliveXC: raises $0.90 to $1.10
BaldEagleStar: folds 
efreay11: folds 
Uncalled bet ($0.90) returned to OliveXC
OliveXC collected $0.60 from pot
OliveXC: doesn't show hand 
*** SUMMARY ***
Total pot $0.60 | Rake $0 
Seat 1: OliveXC (big blind) collected ($0.60)
Seat 2: Pezant folded before Flop (didn't bet)
Seat 3: ng2414 folded before Flop (didn't bet)
Seat 4: BaldEagleStar folded before Flop
Seat 5: PlayTheBlues4U (button) folded before Flop (didn't bet)
Seat 6: efreay11 (small blind) folded before Flop


*********** # 76 **************
PokerStars Hand #204146573516:  Hold'em No Limit ($0.02/$0.05 USD) - 2019/10/01 22:26:22 ET
Table 'Corvus' 6-max Seat #6 is the button
Seat 2: REDRUM192 ($3.95 in chips) 
Seat 3: IvanMakeBasket ($4.31 in chips) 
Seat 6: PlayTheBlues4U ($5.39 in chips) 
REDRUM192: posts small blind $0.02
Trratata joins the table at seat #1 
IvanMakeBasket: posts big blind $0.05
*** HOLE CARDS ***
Dealt to PlayTheBlues4U [Kd Jc]
PlayTheBlues4U: raises $0.10 to $0.15
REDRUM192: calls $0.13
IvanMakeBasket: calls $0.10
*** FLOP *** [6s 8c 3c]
REDRUM192: checks 
IvanMakeBasket: bets $0.22
PlayTheBlues4U: calls $0.22
REDRUM192: folds 
*** TURN *** [6s 8c 3c] [2d]
IvanMakeBasket: bets $1.25
PlayTheBlues4U: folds 
Uncalled bet ($1.25) returned to IvanMakeBasket
IvanMakeBasket collected $0.85 from pot
IvanMakeBasket: doesn't show hand 
*** SUMMARY ***
Total pot $0.89 | Rake $0.04 
Board [6s 8c 3c 2d]
Seat 2: REDRUM192 (small blind) folded on the Flop
Seat 3: IvanMakeBasket (big blind) collected ($0.85)
Seat 6: PlayTheBlues4U (button) folded on the Turn


*********** # 77 **************
PokerStars Hand #204146573466:  Hold'em No Limit ($0.02/$0.05 USD) - 2019/10/01 22:26:09 ET
Table 'Corvus' 6-max Seat #5 is the button
Seat 2: REDRUM192 ($4 in chips) 
Seat 3: IvanMakeBasket ($4.24 in chips) 
Seat 5: 7noodles ($5.02 in chips) 
Seat 6: PlayTheBlues4U ($5.41 in chips) 
PlayTheBlues4U: posts small blind $0.02
REDRUM192: posts big blind $0.05
*** HOLE CARDS ***
Dealt to PlayTheBlues4U [Js 6h]
IvanMakeBasket: raises $0.05 to $0.10
7noodles: folds 
PlayTheBlues4U: folds 
REDRUM192: folds 
Uncalled bet ($0.05) returned to IvanMakeBasket
IvanMakeBasket collected $0.12 from pot
IvanMakeBasket: doesn't show hand 
*** SUMMARY ***
Total pot $0.12 | Rake $0 
Seat 2: REDRUM192 (big blind) folded before Flop
Seat 3: IvanMakeBasket collected ($0.12)
Seat 5: 7noodles (button) folded before Flop (didn't bet)
Seat 6: PlayTheBlues4U (small blind) folded before Flop


*********** # 78 **************
PokerStars Hand #204146573450:  Hold'em No Limit ($0.05/$0.10 USD) - 2019/10/01 22:26:04 ET
Table 'Klytia' 6-max Seat #4 is the button
Seat 1: OliveXC ($16.18 in chips) 
Seat 2: Pezant ($13.42 in chips) 
Seat 3: ng2414 ($9.40 in chips) 
Seat 4: BaldEagleStar ($2.61 in chips) 
Seat 5: PlayTheBlues4U ($9.38 in chips) 
Seat 6: efreay11 ($22.88 in chips) 
PlayTheBlues4U: posts small blind $0.05
efreay11: posts big blind $0.10
*** HOLE CARDS ***
Dealt to PlayTheBlues4U [6h 6d]
OliveXC: folds 
Pezant: folds 
ng2414: folds 
BaldEagleStar: calls $0.10
PlayTheBlues4U: calls $0.05
efreay11: raises $0.10 to $0.20
BaldEagleStar: calls $0.10
PlayTheBlues4U: calls $0.10
*** FLOP *** [5d 4h Ac]
PlayTheBlues4U: checks 
efreay11: bets $0.30
BaldEagleStar: calls $0.30
PlayTheBlues4U: folds 
*** TURN *** [5d 4h Ac] [Jh]
efreay11: bets $0.60
BaldEagleStar: folds 
Uncalled bet ($0.60) returned to efreay11
efreay11 collected $1.14 from pot
efreay11: doesn't show hand 
*** SUMMARY ***
Total pot $1.20 | Rake $0.06 
Board [5d 4h Ac Jh]
Seat 1: OliveXC folded before Flop (didn't bet)
Seat 2: Pezant folded before Flop (didn't bet)
Seat 3: ng2414 folded before Flop (didn't bet)
Seat 4: BaldEagleStar (button) folded on the Turn
Seat 5: PlayTheBlues4U (small blind) folded on the Flop
Seat 6: efreay11 (big blind) collected ($1.14)


*********** # 79 **************
PokerStars Hand #204146573417:  Hold'em No Limit ($0.02/$0.05 USD) - 2019/10/01 22:25:57 ET
Table 'Corvus' 6-max Seat #3 is the button
Seat 2: REDRUM192 ($4 in chips) 
Seat 3: IvanMakeBasket ($4.24 in chips) 
Seat 5: 7noodles ($5.04 in chips) 
Seat 6: PlayTheBlues4U ($5.39 in chips) 
7noodles: posts small blind $0.02
PlayTheBlues4U: posts big blind $0.05
*** HOLE CARDS ***
Dealt to PlayTheBlues4U [Qs 3s]
REDRUM192: folds 
IvanMakeBasket: folds 
7noodles: folds 
Uncalled bet ($0.03) returned to PlayTheBlues4U
TyPeters13nj leaves the table
PlayTheBlues4U collected $0.04 from pot
PlayTheBlues4U: doesn't show hand 
*** SUMMARY ***
Total pot $0.04 | Rake $0 
Seat 2: REDRUM192 folded before Flop (didn't bet)
Seat 3: IvanMakeBasket (button) folded before Flop (didn't bet)
Seat 5: 7noodles (small blind) folded before Flop
Seat 6: PlayTheBlues4U (big blind) collected ($0.04)


*********** # 80 **************
PokerStars Hand #204146573346:  Hold'em No Limit ($0.02/$0.05 USD) - 2019/10/01 22:25:36 ET
Table 'Corvus' 6-max Seat #2 is the button
Seat 2: REDRUM192 ($3.93 in chips) 
Seat 3: IvanMakeBasket ($4.26 in chips) 
Seat 5: 7noodles ($5.09 in chips) 
Seat 6: PlayTheBlues4U ($5.39 in chips) 
IvanMakeBasket: posts small blind $0.02
7noodles: posts big blind $0.05
*** HOLE CARDS ***
Dealt to PlayTheBlues4U [Kc 4s]
PlayTheBlues4U: folds 
REDRUM192: raises $0.15 to $0.20
IvanMakeBasket: folds 
7noodles: folds 
Uncalled bet ($0.15) returned to REDRUM192
REDRUM192 collected $0.12 from pot
REDRUM192: doesn't show hand 
*** SUMMARY ***
Total pot $0.12 | Rake $0 
Seat 2: REDRUM192 (button) collected ($0.12)
Seat 3: IvanMakeBasket (small blind) folded before Flop
Seat 5: 7noodles (big blind) folded before Flop
Seat 6: PlayTheBlues4U folded before Flop (didn't bet)


*********** # 81 **************
PokerStars Hand #204146573296:  Hold'em No Limit ($0.05/$0.10 USD) - 2019/10/01 22:25:25 ET
Table 'Klytia' 6-max Seat #3 is the button
Seat 1: OliveXC ($16.18 in chips) 
Seat 2: Pezant ($13.42 in chips) 
Seat 3: ng2414 ($9.40 in chips) 
Seat 4: BaldEagleStar ($3.21 in chips) 
Seat 5: PlayTheBlues4U ($9.48 in chips) 
Seat 6: efreay11 ($22.24 in chips) 
BaldEagleStar: posts small blind $0.05
PlayTheBlues4U: posts big blind $0.10
*** HOLE CARDS ***
Dealt to PlayTheBlues4U [3c 8h]
efreay11: raises $0.20 to $0.30
OliveXC: folds 
Pezant: folds 
ng2414: folds 
BaldEagleStar: calls $0.25
PlayTheBlues4U: folds 
*** FLOP *** [Jh 9s 9c]
BaldEagleStar: checks 
efreay11: bets $0.30
BaldEagleStar: calls $0.30
*** TURN *** [Jh 9s 9c] [Ad]
BaldEagleStar: checks 
efreay11: bets $0.60
BaldEagleStar: folds 
Uncalled bet ($0.60) returned to efreay11
efreay11 collected $1.24 from pot
efreay11: doesn't show hand 
*** SUMMARY ***
Total pot $1.30 | Rake $0.06 
Board [Jh 9s 9c Ad]
Seat 1: OliveXC folded before Flop (didn't bet)
Seat 2: Pezant folded before Flop (didn't bet)
Seat 3: ng2414 (button) folded before Flop (didn't bet)
Seat 4: BaldEagleStar (small blind) folded on the Turn
Seat 5: PlayTheBlues4U (big blind) folded before Flop
Seat 6: efreay11 collected ($1.24)


*********** # 82 **************
PokerStars Hand #204146573290:  Hold'em No Limit ($0.02/$0.05 USD) - 2019/10/01 22:25:23 ET
Table 'Corvus' 6-max Seat #6 is the button
Seat 2: REDRUM192 ($3.95 in chips) 
Seat 3: IvanMakeBasket ($4.31 in chips) 
Seat 5: 7noodles ($5.09 in chips) 
Seat 6: PlayTheBlues4U ($5.32 in chips) 
REDRUM192: posts small blind $0.02
IvanMakeBasket: posts big blind $0.05
*** HOLE CARDS ***
Dealt to PlayTheBlues4U [Th Qd]
7noodles: folds 
PlayTheBlues4U: raises $0.10 to $0.15
REDRUM192: folds 
IvanMakeBasket: folds 
Uncalled bet ($0.10) returned to PlayTheBlues4U
PlayTheBlues4U collected $0.12 from pot
PlayTheBlues4U: doesn't show hand 
*** SUMMARY ***
Total pot $0.12 | Rake $0 
Seat 2: REDRUM192 (small blind) folded before Flop
Seat 3: IvanMakeBasket (big blind) folded before Flop
Seat 5: 7noodles folded before Flop (didn't bet)
Seat 6: PlayTheBlues4U (button) collected ($0.12)


*********** # 83 **************
PokerStars Hand #204146573245:  Hold'em No Limit ($0.05/$0.10 USD) - 2019/10/01 22:25:13 ET
Table 'Klytia' 6-max Seat #2 is the button
Seat 1: OliveXC ($16.18 in chips) 
Seat 2: Pezant ($13.27 in chips) 
Seat 3: ng2414 ($9.45 in chips) 
Seat 4: BaldEagleStar ($3.31 in chips) 
Seat 5: PlayTheBlues4U ($9.48 in chips) 
Seat 6: efreay11 ($22.24 in chips) 
ng2414: posts small blind $0.05
BaldEagleStar: posts big blind $0.10
*** HOLE CARDS ***
Dealt to PlayTheBlues4U [7c 6c]
PlayTheBlues4U: folds 
efreay11: folds 
OliveXC: folds 
Pezant: raises $0.13 to $0.23
ng2414: folds 
BaldEagleStar: folds 
Uncalled bet ($0.13) returned to Pezant
Pezant collected $0.25 from pot
Pezant: doesn't show hand 
*** SUMMARY ***
Total pot $0.25 | Rake $0 
Seat 1: OliveXC folded before Flop (didn't bet)
Seat 2: Pezant (button) collected ($0.25)
Seat 3: ng2414 (small blind) folded before Flop
Seat 4: BaldEagleStar (big blind) folded before Flop
Seat 5: PlayTheBlues4U folded before Flop (didn't bet)
Seat 6: efreay11 folded before Flop (didn't bet)


*********** # 84 **************
PokerStars Hand #204146573197:  Hold'em No Limit ($0.02/$0.05 USD) - 2019/10/01 22:25:01 ET
Table 'Corvus' 6-max Seat #5 is the button
Seat 2: REDRUM192 ($4 in chips) 
Seat 3: IvanMakeBasket ($4.31 in chips) 
Seat 5: 7noodles ($5.02 in chips) 
Seat 6: PlayTheBlues4U ($5.34 in chips) 
PlayTheBlues4U: posts small blind $0.02
REDRUM192: posts big blind $0.05
*** HOLE CARDS ***
Dealt to PlayTheBlues4U [Ts 7c]
IvanMakeBasket: folds 
7noodles: raises $0.07 to $0.12
TyPeters13nj is disconnected 
PlayTheBlues4U: folds 
REDRUM192: folds 
Uncalled bet ($0.07) returned to 7noodles
7noodles collected $0.12 from pot
*** SUMMARY ***
Total pot $0.12 | Rake $0 
Seat 2: REDRUM192 (big blind) folded before Flop
Seat 3: IvanMakeBasket folded before Flop (didn't bet)
Seat 5: 7noodles (button) collected ($0.12)
Seat 6: PlayTheBlues4U (small blind) folded before Flop


*********** # 85 **************
PokerStars Hand #204146573127:  Hold'em No Limit ($0.05/$0.10 USD) - 2019/10/01 22:24:35 ET
Table 'Klytia' 6-max Seat #1 is the button
Seat 1: OliveXC ($16.18 in chips) 
Seat 2: Pezant ($13.32 in chips) 
Seat 3: ng2414 ($9.55 in chips) 
Seat 4: BaldEagleStar ($1.64 in chips) 
Seat 5: PlayTheBlues4U ($9.48 in chips) 
Seat 6: efreay11 ($23.93 in chips) 
Pezant: posts small blind $0.05
ng2414: posts big blind $0.10
efreay11: posts small & big blinds $0.15
*** HOLE CARDS ***
Dealt to PlayTheBlues4U [7s Qc]
BaldEagleStar: calls $0.10
PlayTheBlues4U: folds 
efreay11: raises $0.20 to $0.30
OliveXC: folds 
Pezant: folds 
ng2414: folds 
BaldEagleStar: raises $0.40 to $0.70
efreay11: calls $0.40
*** FLOP *** [7h 2h 9c]
BaldEagleStar: bets $0.94 and is all-in
efreay11: calls $0.94
*** TURN *** [7h 2h 9c] [As]
*** RIVER *** [7h 2h 9c As] [5c]
*** SHOW DOWN ***
BaldEagleStar: shows [Ac Ad] (three of a kind, Aces)
efreay11: shows [Ah 8h] (a pair of Aces)
BaldEagleStar collected $3.31 from pot
*** SUMMARY ***
Total pot $3.48 | Rake $0.17 
Board [7h 2h 9c As 5c]
Seat 1: OliveXC (button) folded before Flop (didn't bet)
Seat 2: Pezant (small blind) folded before Flop
Seat 3: ng2414 (big blind) folded before Flop
Seat 4: BaldEagleStar showed [Ac Ad] and won ($3.31) with three of a kind, Aces
Seat 5: PlayTheBlues4U folded before Flop (didn't bet)
Seat 6: efreay11 showed [Ah 8h] and lost with a pair of Aces


*********** # 86 **************
PokerStars Hand #204146573077:  Hold'em No Limit ($0.02/$0.05 USD) - 2019/10/01 22:24:19 ET
Table 'Corvus' 6-max Seat #3 is the button
Seat 3: IvanMakeBasket ($4.31 in chips) 
Seat 5: 7noodles ($5.22 in chips) 
Seat 6: PlayTheBlues4U ($5.16 in chips) 
7noodles: posts small blind $0.02
PlayTheBlues4U: posts big blind $0.05
REDRUM192: sits out 
*** HOLE CARDS ***
Dealt to PlayTheBlues4U [Kh Qh]
IvanMakeBasket: folds 
7noodles: raises $0.07 to $0.12
PlayTheBlues4U: calls $0.07
*** FLOP *** [Kc Jc 3s]
7noodles: bets $0.08
PlayTheBlues4U: raises $0.23 to $0.31
7noodles: folds 
Uncalled bet ($0.23) returned to PlayTheBlues4U
PlayTheBlues4U collected $0.38 from pot
PlayTheBlues4U: doesn't show hand 
*** SUMMARY ***
Total pot $0.40 | Rake $0.02 
Board [Kc Jc 3s]
Seat 3: IvanMakeBasket (button) folded before Flop (didn't bet)
Seat 5: 7noodles (small blind) folded on the Flop
Seat 6: PlayTheBlues4U (big blind) collected ($0.38)


*********** # 87 **************
PokerStars Hand #204146573046:  Hold'em No Limit ($0.05/$0.10 USD) - 2019/10/01 22:24:10 ET
Table 'Klytia' 6-max Seat #5 is the button
Seat 1: OliveXC ($16.08 in chips) 
Seat 2: Pezant ($13.42 in chips) 
Seat 3: ng2414 ($9.55 in chips) 
Seat 4: BaldEagleStar ($1.64 in chips) 
Seat 5: PlayTheBlues4U ($9.48 in chips) 
efreay11 will be allowed to play after the button
OliveXC: posts small blind $0.05
Pezant: posts big blind $0.10
*** HOLE CARDS ***
Dealt to PlayTheBlues4U [6c 9s]
ng2414: folds 
BaldEagleStar: folds 
PlayTheBlues4U: folds 
OliveXC: raises $0.20 to $0.30
Pezant: folds 
Uncalled bet ($0.20) returned to OliveXC
OliveXC collected $0.20 from pot
OliveXC: doesn't show hand 
*** SUMMARY ***
Total pot $0.20 | Rake $0 
Seat 1: OliveXC (small blind) collected ($0.20)
Seat 2: Pezant (big blind) folded before Flop
Seat 3: ng2414 folded before Flop (didn't bet)
Seat 4: BaldEagleStar folded before Flop (didn't bet)
Seat 5: PlayTheBlues4U (button) folded before Flop (didn't bet)


*********** # 88 **************
PokerStars Hand #204146572997:  Hold'em No Limit ($0.02/$0.05 USD) - 2019/10/01 22:23:53 ET
Table 'Corvus' 6-max Seat #1 is the button
Seat 1: TyPeters13nj ($4.01 in chips) 
Seat 3: IvanMakeBasket ($4.26 in chips) 
Seat 4: MozenMo ($2.71 in chips) 
Seat 5: 7noodles ($5.22 in chips) 
Seat 6: PlayTheBlues4U ($5.16 in chips) 
REDRUM192 will be allowed to play after the button
IvanMakeBasket: posts small blind $0.02
MozenMo: posts big blind $0.05
*** HOLE CARDS ***
Dealt to PlayTheBlues4U [9d Jh]
7noodles: folds 
PlayTheBlues4U: folds 
TyPeters13nj: folds 
IvanMakeBasket: raises $0.10 to $0.15
MozenMo: folds 
Uncalled bet ($0.10) returned to IvanMakeBasket
IvanMakeBasket collected $0.10 from pot
IvanMakeBasket: doesn't show hand 
*** SUMMARY ***
Total pot $0.10 | Rake $0 
Seat 1: TyPeters13nj (button) folded before Flop (didn't bet)
Seat 3: IvanMakeBasket (small blind) collected ($0.10)
Seat 4: MozenMo (big blind) folded before Flop
Seat 5: 7noodles folded before Flop (didn't bet)
Seat 6: PlayTheBlues4U folded before Flop (didn't bet)


*********** # 89 **************
PokerStars Hand #204146572857:  Hold'em No Limit ($0.05/$0.10 USD) - 2019/10/01 22:23:04 ET
Table 'Klytia' 6-max Seat #4 is the button
Seat 1: OliveXC ($16.18 in chips) 
Seat 2: Pezant ($13.42 in chips) 
Seat 3: ng2414 ($9.55 in chips) 
Seat 4: BaldEagleStar ($1.64 in chips) 
Seat 5: PlayTheBlues4U ($9.39 in chips) 
PlayTheBlues4U: posts small blind $0.05
efreay11 has timed out
efreay11: is sitting out 
OliveXC: posts big blind $0.10
*** HOLE CARDS ***
Dealt to PlayTheBlues4U [5d 7d]
Pezant has timed out
Pezant: folds 
ng2414: folds 
BaldEagleStar: folds 
PlayTheBlues4U: calls $0.05
OliveXC: checks 
*** FLOP *** [Qd Ks 9s]
PlayTheBlues4U: checks 
OliveXC: checks 
*** TURN *** [Qd Ks 9s] [9c]
PlayTheBlues4U: bets $0.10
OliveXC: folds 
Uncalled bet ($0.10) returned to PlayTheBlues4U
PlayTheBlues4U collected $0.19 from pot
PlayTheBlues4U: doesn't show hand 
*** SUMMARY ***
Total pot $0.20 | Rake $0.01 
Board [Qd Ks 9s 9c]
Seat 1: OliveXC (big blind) folded on the Turn
Seat 2: Pezant folded before Flop (didn't bet)
Seat 3: ng2414 folded before Flop (didn't bet)
Seat 4: BaldEagleStar (button) folded before Flop (didn't bet)
Seat 5: PlayTheBlues4U (small blind) collected ($0.19)


*********** # 90 **************
PokerStars Hand #204146572801:  Hold'em No Limit ($0.02/$0.05 USD) - 2019/10/01 22:22:49 ET
Table 'Corvus' 6-max Seat #6 is the button
Seat 1: TyPeters13nj ($3.42 in chips) 
Seat 3: IvanMakeBasket ($4.31 in chips) 
Seat 4: MozenMo ($3.31 in chips) 
Seat 5: 7noodles ($5.22 in chips) 
Seat 6: PlayTheBlues4U ($5.16 in chips) 
TyPeters13nj: posts small blind $0.02
maxplans323: is sitting out 
IvanMakeBasket: posts big blind $0.05
*** HOLE CARDS ***
Dealt to PlayTheBlues4U [4d 8d]
PlayTheBlues4U said, "nh"
maxplans323 leaves the table
MozenMo: calls $0.05
7noodles: folds 
PlayTheBlues4U: folds 
TyPeters13nj: calls $0.03
REDRUM192 joins the table at seat #2 
IvanMakeBasket: checks 
*** FLOP *** [2c 6d 6c]
TyPeters13nj: bets $0.05
IvanMakeBasket: folds 
MozenMo: raises $0.25 to $0.30
TyPeters13nj: raises $0.25 to $0.55
MozenMo: calls $0.25
*** TURN *** [2c 6d 6c] [5h]
TyPeters13nj: bets $0.95
MozenMo: folds 
Uncalled bet ($0.95) returned to TyPeters13nj
TyPeters13nj collected $1.19 from pot
TyPeters13nj: doesn't show hand 
*** SUMMARY ***
Total pot $1.25 | Rake $0.06 
Board [2c 6d 6c 5h]
Seat 1: TyPeters13nj (small blind) collected ($1.19)
Seat 3: IvanMakeBasket (big blind) folded on the Flop
Seat 4: MozenMo folded on the Turn
Seat 5: 7noodles folded before Flop (didn't bet)
Seat 6: PlayTheBlues4U (button) folded before Flop (didn't bet)


*********** # 91 **************
PokerStars Hand #204144609915:  Hold'em No Limit ($0.02/$0.05 USD) - 2019/10/01 22:21:52 ET
Table 'Corvus' 6-max Seat #5 is the button
Seat 1: TyPeters13nj ($3.47 in chips) 
Seat 2: maxplans323 ($2.73 in chips) 
Seat 3: IvanMakeBasket ($4.31 in chips) 
Seat 4: MozenMo ($3.31 in chips) 
Seat 5: 7noodles ($5.21 in chips) 
Seat 6: PlayTheBlues4U ($5.15 in chips) 
PlayTheBlues4U: posts small blind $0.02
TyPeters13nj: posts big blind $0.05
*** HOLE CARDS ***
Dealt to PlayTheBlues4U [Ts Kc]
maxplans323: folds 
IvanMakeBasket: folds 
MozenMo: folds 
7noodles: raises $0.07 to $0.12
PlayTheBlues4U: calls $0.10
TyPeters13nj: folds 
*** FLOP *** [9d Kd 8h]
PlayTheBlues4U: checks 
7noodles: bets $0.19
PlayTheBlues4U: calls $0.19
*** TURN *** [9d Kd 8h] [8c]
PlayTheBlues4U: checks 
7noodles: checks 
*** RIVER *** [9d Kd 8h 8c] [Qd]
PlayTheBlues4U: checks 
7noodles: checks 
*** SHOW DOWN ***
PlayTheBlues4U: shows [Ts Kc] (two pair, Kings and Eights)
7noodles: shows [Th Ks] (two pair, Kings and Eights)
PlayTheBlues4U collected $0.32 from pot
7noodles collected $0.32 from pot
*** SUMMARY ***
Total pot $0.67 | Rake $0.03 
Board [9d Kd 8h 8c Qd]
Seat 1: TyPeters13nj (big blind) folded before Flop
Seat 2: maxplans323 folded before Flop (didn't bet)
Seat 3: IvanMakeBasket folded before Flop (didn't bet)
Seat 4: MozenMo folded before Flop (didn't bet)
Seat 5: 7noodles (button) showed [Th Ks] and won ($0.32) with two pair, Kings and Eights
Seat 6: PlayTheBlues4U (small blind) showed [Ts Kc] and won ($0.32) with two pair, Kings and Eights


*********** # 92 **************
PokerStars Hand #204144609844:  Hold'em No Limit ($0.05/$0.10 USD) - 2019/10/01 22:21:29 ET
Table 'Klytia' 6-max Seat #3 is the button
Seat 1: OliveXC ($16.18 in chips) 
Seat 2: Pezant ($12.53 in chips) 
Seat 3: ng2414 ($9.85 in chips) 
Seat 4: BaldEagleStar ($1.69 in chips) 
Seat 5: PlayTheBlues4U ($9.69 in chips) 
Seat 6: efreay11 ($24.23 in chips) 
BaldEagleStar: posts small blind $0.05
PlayTheBlues4U: posts big blind $0.10
*** HOLE CARDS ***
Dealt to PlayTheBlues4U [6h 5h]
efreay11: raises $0.20 to $0.30
OliveXC: folds 
Pezant: calls $0.30
ng2414: calls $0.30
BaldEagleStar: folds 
PlayTheBlues4U: calls $0.20
*** FLOP *** [Js Ks Jd]
PlayTheBlues4U: checks 
efreay11: checks 
Pezant: checks 
ng2414: checks 
*** TURN *** [Js Ks Jd] [6s]
PlayTheBlues4U: checks 
efreay11: checks 
Pezant: checks 
ng2414: checks 
*** RIVER *** [Js Ks Jd 6s] [8s]
PlayTheBlues4U: checks 
efreay11: checks 
Pezant: checks 
ng2414: checks 
*** SHOW DOWN ***
PlayTheBlues4U: shows [6h 5h] (two pair, Jacks and Sixes)
efreay11: mucks hand 
Pezant: shows [Td Ts] (a flush, King high)
ng2414: mucks hand 
Pezant collected $1.19 from pot
*** SUMMARY ***
Total pot $1.25 | Rake $0.06 
Board [Js Ks Jd 6s 8s]
Seat 1: OliveXC folded before Flop (didn't bet)
Seat 2: Pezant showed [Td Ts] and won ($1.19) with a flush, King high
Seat 3: ng2414 (button) mucked [Ah 9h]
Seat 4: BaldEagleStar (small blind) folded before Flop
Seat 5: PlayTheBlues4U (big blind) showed [6h 5h] and lost with two pair, Jacks and Sixes
Seat 6: efreay11 mucked [Qc 7c]


*********** # 93 **************
PokerStars Hand #204144609794:  Hold'em No Limit ($0.05/$0.10 USD) - 2019/10/01 22:21:09 ET
Table 'Klytia' 6-max Seat #2 is the button
Seat 1: OliveXC ($16.18 in chips) 
Seat 2: Pezant ($12.53 in chips) 
Seat 3: ng2414 ($9.90 in chips) 
Seat 4: BaldEagleStar ($1.54 in chips) 
Seat 5: PlayTheBlues4U ($9.69 in chips) 
Seat 6: efreay11 ($24.33 in chips) 
ng2414: posts small blind $0.05
BaldEagleStar: posts big blind $0.10
*** HOLE CARDS ***
Dealt to PlayTheBlues4U [7c Ah]
PlayTheBlues4U: folds 
efreay11: calls $0.10
OliveXC: folds 
Pezant: folds 
ng2414: folds 
BaldEagleStar: raises $0.50 to $0.60
efreay11: folds 
Uncalled bet ($0.50) returned to BaldEagleStar
BaldEagleStar collected $0.25 from pot
BaldEagleStar: doesn't show hand 
*** SUMMARY ***
Total pot $0.25 | Rake $0 
Seat 1: OliveXC folded before Flop (didn't bet)
Seat 2: Pezant (button) folded before Flop (didn't bet)
Seat 3: ng2414 (small blind) folded before Flop
Seat 4: BaldEagleStar (big blind) collected ($0.25)
Seat 5: PlayTheBlues4U folded before Flop (didn't bet)
Seat 6: efreay11 folded before Flop


*********** # 94 **************
PokerStars Hand #204144609791:  Hold'em No Limit ($0.02/$0.05 USD) - 2019/10/01 22:21:08 ET
Table 'Corvus' 6-max Seat #4 is the button
Seat 1: TyPeters13nj ($3.52 in chips) 
Seat 2: maxplans323 ($2.73 in chips) 
Seat 3: IvanMakeBasket ($4.31 in chips) 
Seat 4: MozenMo ($3.36 in chips) 
Seat 5: 7noodles ($5.26 in chips) 
Seat 6: PlayTheBlues4U ($5 in chips) 
7noodles: posts small blind $0.02
PlayTheBlues4U: posts big blind $0.05
*** HOLE CARDS ***
Dealt to PlayTheBlues4U [Jh Jd]
TyPeters13nj: calls $0.05
maxplans323: folds 
IvanMakeBasket: folds 
MozenMo: calls $0.05
7noodles: calls $0.03
PlayTheBlues4U: raises $0.20 to $0.25
TyPeters13nj: folds 
MozenMo: folds 
7noodles: folds 
Uncalled bet ($0.20) returned to PlayTheBlues4U
PlayTheBlues4U collected $0.20 from pot
PlayTheBlues4U: doesn't show hand 
*** SUMMARY ***
Total pot $0.20 | Rake $0 
Seat 1: TyPeters13nj folded before Flop
Seat 2: maxplans323 folded before Flop (didn't bet)
Seat 3: IvanMakeBasket folded before Flop (didn't bet)
Seat 4: MozenMo (button) folded before Flop
Seat 5: 7noodles (small blind) folded before Flop
Seat 6: PlayTheBlues4U (big blind) collected ($0.20)


*********** # 95 **************
PokerStars Hand #204144609543:  Hold'em No Limit ($0.05/$0.10 USD) - 2019/10/01 22:19:48 ET
Table 'Klytia' 6-max Seat #1 is the button
Seat 1: OliveXC ($19.88 in chips) 
Seat 2: Pezant ($12.58 in chips) 
Seat 3: ng2414 ($10 in chips) 
Seat 4: BaldEagleStar ($1.54 in chips) 
Seat 5: PlayTheBlues4U ($9.99 in chips) 
Seat 6: efreay11 ($20.57 in chips) 
Pezant: posts small blind $0.05
ng2414: posts big blind $0.10
*** HOLE CARDS ***
Dealt to PlayTheBlues4U [7h 7c]
BaldEagleStar: folds 
PlayTheBlues4U: raises $0.20 to $0.30
efreay11: calls $0.30
OliveXC: calls $0.30
Pezant: folds 
ng2414: folds 
*** FLOP *** [Jd Jh Qh]
PlayTheBlues4U: checks 
efreay11: checks 
OliveXC: bets $0.80
PlayTheBlues4U: folds 
efreay11: calls $0.80
*** TURN *** [Jd Jh Qh] [9c]
efreay11: bets $1.30
OliveXC: raises $1.30 to $2.60
efreay11: calls $1.30
*** RIVER *** [Jd Jh Qh 9c] [9d]
efreay11: bets $3.70
OliveXC: folds 
Uncalled bet ($3.70) returned to efreay11
efreay11 collected $7.46 from pot
efreay11: doesn't show hand 
*** SUMMARY ***
Total pot $7.85 | Rake $0.39 
Board [Jd Jh Qh 9c 9d]
Seat 1: OliveXC (button) folded on the River
Seat 2: Pezant (small blind) folded before Flop
Seat 3: ng2414 (big blind) folded before Flop
Seat 4: BaldEagleStar folded before Flop (didn't bet)
Seat 5: PlayTheBlues4U folded on the Flop
Seat 6: efreay11 collected ($7.46)


*********** # 96 **************
PokerStars Hand #204144609330:  Hold'em No Limit ($0.05/$0.10 USD) - 2019/10/01 22:18:43 ET
Table 'Klytia' 6-max Seat #6 is the button
Seat 1: OliveXC ($19.33 in chips) 
Seat 2: Pezant ($12.68 in chips) 
Seat 3: ng2414 ($9.10 in chips) 
Seat 4: BaldEagleStar ($1.64 in chips) 
Seat 5: PlayTheBlues4U ($9.99 in chips) 
Seat 6: efreay11 ($20.97 in chips) 
OliveXC: posts small blind $0.05
Pezant: posts big blind $0.10
*** HOLE CARDS ***
Dealt to PlayTheBlues4U [6d Qc]
ng2414: folds 
BaldEagleStar: calls $0.10
PlayTheBlues4U: folds 
efreay11: calls $0.10
OliveXC: calls $0.05
Pezant: checks 
*** FLOP *** [4s 3h Kd]
OliveXC: checks 
Pezant: checks 
BaldEagleStar: checks 
efreay11: checks 
*** TURN *** [4s 3h Kd] [3d]
OliveXC: bets $0.30
Pezant: folds 
BaldEagleStar: folds 
efreay11: calls $0.30
*** RIVER *** [4s 3h Kd 3d] [8h]
OliveXC: checks 
efreay11: checks 
*** SHOW DOWN ***
OliveXC: shows [Qd 4d] (two pair, Fours and Threes)
efreay11: mucks hand 
OliveXC collected $0.95 from pot
*** SUMMARY ***
Total pot $1 | Rake $0.05 
Board [4s 3h Kd 3d 8h]
Seat 1: OliveXC (small blind) showed [Qd 4d] and won ($0.95) with two pair, Fours and Threes
Seat 2: Pezant (big blind) folded on the Turn
Seat 3: ng2414 folded before Flop (didn't bet)
Seat 4: BaldEagleStar folded on the Turn
Seat 5: PlayTheBlues4U folded before Flop (didn't bet)
Seat 6: efreay11 (button) mucked [9d Td]


*********** # 97 **************
PokerStars Hand #204144609091:  Hold'em No Limit ($0.05/$0.10 USD) - 2019/10/01 22:17:33 ET
Table 'Klytia' 6-max Seat #5 is the button
Seat 1: OliveXC ($19.63 in chips) 
Seat 2: Pezant ($12.68 in chips) 
Seat 3: ng2414 ($10 in chips) 
Seat 4: BaldEagleStar ($1.94 in chips) 
Seat 5: PlayTheBlues4U ($9.99 in chips) 
Seat 6: efreay11 ($19.59 in chips) 
efreay11: posts small blind $0.05
OliveXC: posts big blind $0.10
*** HOLE CARDS ***
Dealt to PlayTheBlues4U [7c 8d]
Pezant: folds 
ng2414: raises $0.20 to $0.30
BaldEagleStar: calls $0.30
PlayTheBlues4U: folds 
efreay11: calls $0.25
OliveXC: calls $0.20
*** FLOP *** [Kd 2d Ad]
efreay11: bets $0.60
OliveXC: folds 
ng2414: calls $0.60
BaldEagleStar: folds 
*** TURN *** [Kd 2d Ad] [5h]
efreay11: checks 
ng2414: checks 
*** RIVER *** [Kd 2d Ad 5h] [8c]
efreay11: checks 
ng2414: checks 
*** SHOW DOWN ***
efreay11: shows [Jd Ac] (a pair of Aces)
ng2414: mucks hand 
efreay11 collected $2.28 from pot
*** SUMMARY ***
Total pot $2.40 | Rake $0.12 
Board [Kd 2d Ad 5h 8c]
Seat 1: OliveXC (big blind) folded on the Flop
Seat 2: Pezant folded before Flop (didn't bet)
Seat 3: ng2414 mucked [Qh Qd]
Seat 4: BaldEagleStar folded on the Flop
Seat 5: PlayTheBlues4U (button) folded before Flop (didn't bet)
Seat 6: efreay11 (small blind) showed [Jd Ac] and won ($2.28) with a pair of Aces


*********** # 98 **************
PokerStars Hand #204144608937:  Hold'em No Limit ($0.05/$0.10 USD) - 2019/10/01 22:16:48 ET
Table 'Klytia' 6-max Seat #4 is the button
Seat 1: OliveXC ($19.63 in chips) 
Seat 2: Pezant ($12.68 in chips) 
Seat 3: ng2414 ($8.74 in chips) 
Seat 4: BaldEagleStar ($1.94 in chips) 
Seat 5: PlayTheBlues4U ($9.90 in chips) 
Seat 6: efreay11 ($19.69 in chips) 
PlayTheBlues4U: posts small blind $0.05
efreay11: posts big blind $0.10
*** HOLE CARDS ***
Dealt to PlayTheBlues4U [6d 7s]
OliveXC: folds 
Pezant: folds 
ng2414: folds 
BaldEagleStar: folds 
PlayTheBlues4U: calls $0.05
efreay11: checks 
*** FLOP *** [4s Kh 8s]
PlayTheBlues4U: checks 
efreay11: checks 
*** TURN *** [4s Kh 8s] [5s]
PlayTheBlues4U: bets $0.20
efreay11: folds 
Uncalled bet ($0.20) returned to PlayTheBlues4U
PlayTheBlues4U collected $0.19 from pot
PlayTheBlues4U: doesn't show hand 
*** SUMMARY ***
Total pot $0.20 | Rake $0.01 
Board [4s Kh 8s 5s]
Seat 1: OliveXC folded before Flop (didn't bet)
Seat 2: Pezant folded before Flop (didn't bet)
Seat 3: ng2414 folded before Flop (didn't bet)
Seat 4: BaldEagleStar (button) folded before Flop (didn't bet)
Seat 5: PlayTheBlues4U (small blind) collected ($0.19)
Seat 6: efreay11 (big blind) folded on the Turn


*********** # 99 **************
PokerStars Hand #204144608828:  Hold'em No Limit ($0.05/$0.10 USD) - 2019/10/01 22:16:10 ET
Table 'Klytia' 6-max Seat #3 is the button
Seat 1: OliveXC ($19.63 in chips) 
Seat 2: Pezant ($11.84 in chips) 
Seat 3: ng2414 ($8.74 in chips) 
Seat 4: BaldEagleStar ($2.34 in chips) 
Seat 5: PlayTheBlues4U ($10 in chips) 
Seat 6: efreay11 ($20.09 in chips) 
BaldEagleStar: posts small blind $0.05
PlayTheBlues4U: posts big blind $0.10
*** HOLE CARDS ***
Dealt to PlayTheBlues4U [Qd Tc]
efreay11: calls $0.10
OliveXC: folds 
Pezant: raises $0.30 to $0.40
ng2414: folds 
BaldEagleStar: calls $0.35
PlayTheBlues4U: folds 
efreay11: calls $0.30
*** FLOP *** [2h 5h 5c]
BaldEagleStar: checks 
efreay11: checks 
Pezant: bets $0.41
BaldEagleStar: folds 
efreay11: folds 
Uncalled bet ($0.41) returned to Pezant
Pezant collected $1.24 from pot
Pezant: doesn't show hand 
*** SUMMARY ***
Total pot $1.30 | Rake $0.06 
Board [2h 5h 5c]
Seat 1: OliveXC folded before Flop (didn't bet)
Seat 2: Pezant collected ($1.24)
Seat 3: ng2414 (button) folded before Flop (didn't bet)
Seat 4: BaldEagleStar (small blind) folded on the Flop
Seat 5: PlayTheBlues4U (big blind) folded before Flop
Seat 6: efreay11 folded on the Flop


*********** # 100 **************
PokerStars Hand #204132323263:  Hold'em No Limit ($0.05/$0.10 USD) - 2019/10/01 7:20:47 ET
Table 'Tabit' 6-max Seat #1 is the button
Seat 1: PlayTheBlues4U ($12.69 in chips) 
Seat 2: okwon ($7.59 in chips) 
Seat 5: hunteeer 05 ($14.14 in chips) 
Seat 6: chips1614 ($11.64 in chips) 
okwon: posts small blind $0.05
hunteeer 05: posts big blind $0.10
*** HOLE CARDS ***
Dealt to PlayTheBlues4U [8d Ks]
chips1614: folds 
PlayTheBlues4U: folds 
okwon: calls $0.05
hunteeer 05: raises $0.10 to $0.20
okwon: calls $0.10
*** FLOP *** [Kh 9h Qd]
okwon: bets $0.20
hunteeer 05: calls $0.20
*** TURN *** [Kh 9h Qd] [2s]
chips1614 leaves the table
okwon: bets $0.40
hunteeer 05: folds 
Uncalled bet ($0.40) returned to okwon
okwon collected $0.76 from pot
okwon: doesn't show hand 
*** SUMMARY ***
Total pot $0.80 | Rake $0.04 
Board [Kh 9h Qd 2s]
Seat 1: PlayTheBlues4U (button) folded before Flop (didn't bet)
Seat 2: okwon (small blind) collected ($0.76)
Seat 5: hunteeer 05 (big blind) folded on the Turn
Seat 6: chips1614 folded before Flop (didn't bet)


*********** # 101 **************
PokerStars Hand #204132323246:  Hold'em No Limit ($0.05/$0.10 USD) - 2019/10/01 7:20:05 ET
Table 'Tabit' 6-max Seat #6 is the button
Seat 1: PlayTheBlues4U ($12.74 in chips) 
Seat 2: okwon ($8.09 in chips) 
Seat 5: hunteeer 05 ($14.34 in chips) 
Seat 6: chips1614 ($10.95 in chips) 
PlayTheBlues4U: posts small blind $0.05
okwon: posts big blind $0.10
*** HOLE CARDS ***
Dealt to PlayTheBlues4U [Qs 6h]
hunteeer 05: raises $0.10 to $0.20
chips1614: calls $0.20
PlayTheBlues4U: folds 
okwon: calls $0.10
*** FLOP *** [Ac 3h Ad]
okwon: checks 
hunteeer 05: checks 
chips1614: checks 
*** TURN *** [Ac 3h Ad] [9s]
okwon: checks 
hunteeer 05: checks 
chips1614: checks 
*** RIVER *** [Ac 3h Ad 9s] [7d]
okwon: bets $0.30
hunteeer 05: folds 
chips1614: calls $0.30
*** SHOW DOWN ***
okwon: shows [5c Ts] (a pair of Aces)
chips1614: shows [Ks 3s] (two pair, Aces and Threes)
chips1614 collected $1.19 from pot
*** SUMMARY ***
Total pot $1.25 | Rake $0.06 
Board [Ac 3h Ad 9s 7d]
Seat 1: PlayTheBlues4U (small blind) folded before Flop
Seat 2: okwon (big blind) showed [5c Ts] and lost with a pair of Aces
Seat 5: hunteeer 05 folded on the River
Seat 6: chips1614 (button) showed [Ks 3s] and won ($1.19) with two pair, Aces and Threes


*********** # 102 **************
PokerStars Hand #204132323234:  Hold'em No Limit ($0.05/$0.10 USD) - 2019/10/01 7:19:25 ET
Table 'Tabit' 6-max Seat #5 is the button
Seat 1: PlayTheBlues4U ($11.10 in chips) 
Seat 2: okwon ($9.59 in chips) 
Seat 5: hunteeer 05 ($14.34 in chips) 
Seat 6: chips1614 ($11.25 in chips) 
chips1614: posts small blind $0.05
PlayTheBlues4U: posts big blind $0.10
*** HOLE CARDS ***
Dealt to PlayTheBlues4U [9d Ks]
okwon: raises $0.20 to $0.30
hunteeer 05: folds 
chips1614: calls $0.25
PlayTheBlues4U: calls $0.20
*** FLOP *** [Qh Kc 2c]
chips1614: checks 
PlayTheBlues4U: checks 
okwon: bets $0.40
chips1614: folds 
PlayTheBlues4U: calls $0.40
*** TURN *** [Qh Kc 2c] [Th]
PlayTheBlues4U: checks 
okwon: bets $0.80
PlayTheBlues4U: calls $0.80
*** RIVER *** [Qh Kc 2c Th] [Jh]
PlayTheBlues4U: checks 
okwon: checks 
*** SHOW DOWN ***
PlayTheBlues4U: shows [9d Ks] (a straight, Nine to King)
okwon: mucks hand 
PlayTheBlues4U collected $3.14 from pot
*** SUMMARY ***
Total pot $3.30 | Rake $0.16 
Board [Qh Kc 2c Th Jh]
Seat 1: PlayTheBlues4U (big blind) showed [9d Ks] and won ($3.14) with a straight, Nine to King
Seat 2: okwon mucked [5d Kh]
Seat 5: hunteeer 05 (button) folded before Flop (didn't bet)
Seat 6: chips1614 (small blind) folded on the Flop


*********** # 103 **************
PokerStars Hand #204132323230:  Hold'em No Limit ($0.05/$0.10 USD) - 2019/10/01 7:19:12 ET
Table 'Tabit' 6-max Seat #2 is the button
Seat 1: PlayTheBlues4U ($11.10 in chips) 
Seat 2: okwon ($9.89 in chips) 
Seat 5: hunteeer 05 ($14.39 in chips) 
Seat 6: chips1614 ($10.90 in chips) 
hunteeer 05: posts small blind $0.05
chips1614: posts big blind $0.10
*** HOLE CARDS ***
Dealt to PlayTheBlues4U [8c 2d]
PlayTheBlues4U: folds 
okwon: raises $0.20 to $0.30
hunteeer 05: folds 
chips1614: raises $10.60 to $10.90 and is all-in
okwon: folds 
Uncalled bet ($10.60) returned to chips1614
chips1614 collected $0.65 from pot
chips1614: doesn't show hand 
*** SUMMARY ***
Total pot $0.65 | Rake $0 
Seat 1: PlayTheBlues4U folded before Flop (didn't bet)
Seat 2: okwon (button) folded before Flop
Seat 5: hunteeer 05 (small blind) folded before Flop
Seat 6: chips1614 (big blind) collected ($0.65)


*********** # 104 **************
PokerStars Hand #204132323226:  Hold'em No Limit ($0.05/$0.10 USD) - 2019/10/01 7:19:00 ET
Table 'Tabit' 6-max Seat #1 is the button
Seat 1: PlayTheBlues4U ($10.95 in chips) 
Seat 2: okwon ($9.94 in chips) 
Seat 5: hunteeer 05 ($14.49 in chips) 
Seat 6: chips1614 ($10.90 in chips) 
okwon: posts small blind $0.05
hunteeer 05: posts big blind $0.10
*** HOLE CARDS ***
Dealt to PlayTheBlues4U [2s Ad]
chips1614: folds 
PlayTheBlues4U: raises $0.20 to $0.30
okwon: folds 
hunteeer 05: folds 
Uncalled bet ($0.20) returned to PlayTheBlues4U
PlayTheBlues4U collected $0.25 from pot
PlayTheBlues4U: doesn't show hand 
*** SUMMARY ***
Total pot $0.25 | Rake $0 
Seat 1: PlayTheBlues4U (button) collected ($0.25)
Seat 2: okwon (small blind) folded before Flop
Seat 5: hunteeer 05 (big blind) folded before Flop
Seat 6: chips1614 folded before Flop (didn't bet)


*********** # 105 **************
PokerStars Hand #204132323217:  Hold'em No Limit ($0.05/$0.10 USD) - 2019/10/01 7:18:27 ET
Table 'Tabit' 6-max Seat #6 is the button
Seat 1: PlayTheBlues4U ($11.85 in chips) 
Seat 2: okwon ($10.04 in chips) 
Seat 5: hunteeer 05 ($14.49 in chips) 
Seat 6: chips1614 ($9.90 in chips) 
PlayTheBlues4U: posts small blind $0.05
okwon: posts big blind $0.10
*** HOLE CARDS ***
Dealt to PlayTheBlues4U [Ah 5h]
hunteeer 05: folds 
chips1614: raises $0.25 to $0.35
PlayTheBlues4U: raises $0.55 to $0.90
okwon: folds 
chips1614: raises $9 to $9.90 and is all-in
PlayTheBlues4U: folds 
Uncalled bet ($9) returned to chips1614
chips1614 collected $1.90 from pot
chips1614: doesn't show hand 
*** SUMMARY ***
Total pot $1.90 | Rake $0 
Seat 1: PlayTheBlues4U (small blind) folded before Flop
Seat 2: okwon (big blind) folded before Flop
Seat 5: hunteeer 05 folded before Flop (didn't bet)
Seat 6: chips1614 (button) collected ($1.90)


*********** # 106 **************
PokerStars Hand #204132323191:  Hold'em No Limit ($0.05/$0.10 USD) - 2019/10/01 7:17:27 ET
Table 'Tabit' 6-max Seat #5 is the button
Seat 1: PlayTheBlues4U ($11.76 in chips) 
Seat 2: okwon ($10.04 in chips) 
Seat 4: SuWasup ($10.50 in chips) 
Seat 5: hunteeer 05 ($14.49 in chips) 
Seat 6: chips1614 ($10 in chips) 
chips1614: posts small blind $0.05
PlayTheBlues4U: posts big blind $0.10
*** HOLE CARDS ***
Dealt to PlayTheBlues4U [3c 8s]
okwon: folds 
SuWasup: folds 
hunteeer 05: folds 
SuWasup leaves the table
chips1614: calls $0.05
PlayTheBlues4U: checks 
*** FLOP *** [9d 4h 6d]
chips1614: checks 
PlayTheBlues4U: checks 
*** TURN *** [9d 4h 6d] [5h]
chips1614: checks 
PlayTheBlues4U: bets $0.10
chips1614: folds 
Uncalled bet ($0.10) returned to PlayTheBlues4U
PlayTheBlues4U collected $0.19 from pot
PlayTheBlues4U: doesn't show hand 
*** SUMMARY ***
Total pot $0.20 | Rake $0.01 
Board [9d 4h 6d 5h]
Seat 1: PlayTheBlues4U (big blind) collected ($0.19)
Seat 2: okwon folded before Flop (didn't bet)
Seat 4: SuWasup folded before Flop (didn't bet)
Seat 5: hunteeer 05 (button) folded before Flop (didn't bet)
Seat 6: chips1614 (small blind) folded on the Turn


*********** # 107 **************
PokerStars Hand #204132323170:  Hold'em No Limit ($0.05/$0.10 USD) - 2019/10/01 7:16:29 ET
Table 'Tabit' 6-max Seat #4 is the button
Seat 1: PlayTheBlues4U ($11.76 in chips) 
Seat 2: okwon ($10.04 in chips) 
Seat 4: SuWasup ($11 in chips) 
Seat 5: hunteeer 05 ($13.95 in chips) 
Seat 6: chips1614 ($5.81 in chips) 
hunteeer 05: posts small blind $0.05
chips1614: posts big blind $0.10
*** HOLE CARDS ***
Dealt to PlayTheBlues4U [5c 2h]
PlayTheBlues4U: folds 
okwon: folds 
SuWasup: raises $0.20 to $0.30
hunteeer 05: raises $0.20 to $0.50
chips1614: folds 
SuWasup: calls $0.20
*** FLOP *** [7h 9h 8c]
hunteeer 05: checks 
SuWasup: checks 
*** TURN *** [7h 9h 8c] [2c]
hunteeer 05: checks 
SuWasup: checks 
*** RIVER *** [7h 9h 8c 2c] [5h]
hunteeer 05: checks 
SuWasup: checks 
*** SHOW DOWN ***
hunteeer 05: shows [As Qs] (high card Ace)
SuWasup: mucks hand 
hunteeer 05 collected $1.04 from pot
*** SUMMARY ***
Total pot $1.10 | Rake $0.06 
Board [7h 9h 8c 2c 5h]
Seat 1: PlayTheBlues4U folded before Flop (didn't bet)
Seat 2: okwon folded before Flop (didn't bet)
Seat 4: SuWasup (button) mucked [Td Qd]
Seat 5: hunteeer 05 (small blind) showed [As Qs] and won ($1.04) with high card Ace
Seat 6: chips1614 (big blind) folded before Flop


*********** # 108 **************
PokerStars Hand #204132323148:  Hold'em No Limit ($0.05/$0.10 USD) - 2019/10/01 7:15:53 ET
Table 'Tabit' 6-max Seat #2 is the button
Seat 1: PlayTheBlues4U ($9.40 in chips) 
Seat 2: okwon ($10.04 in chips) 
Seat 4: SuWasup ($11.05 in chips) 
Seat 5: hunteeer 05 ($14.05 in chips) 
Seat 6: chips1614 ($8.27 in chips) 
SuWasup: posts small blind $0.05
hunteeer 05: posts big blind $0.10
*** HOLE CARDS ***
Dealt to PlayTheBlues4U [8d Ac]
chips1614: raises $0.20 to $0.30
PlayTheBlues4U: calls $0.30
okwon: folds 
SuWasup: folds 
hunteeer 05: folds 
*** FLOP *** [8s 3s 6d]
chips1614: checks 
PlayTheBlues4U: bets $0.50
chips1614: calls $0.50
*** TURN *** [8s 3s 6d] [2c]
chips1614: checks 
PlayTheBlues4U: checks 
*** RIVER *** [8s 3s 6d 2c] [Ad]
chips1614: bets $1.66
PlayTheBlues4U: calls $1.66
*** SHOW DOWN ***
chips1614: shows [As 5c] (a pair of Aces)
PlayTheBlues4U: shows [8d Ac] (two pair, Aces and Eights)
PlayTheBlues4U collected $4.82 from pot
*** SUMMARY ***
Total pot $5.07 | Rake $0.25 
Board [8s 3s 6d 2c Ad]
Seat 1: PlayTheBlues4U showed [8d Ac] and won ($4.82) with two pair, Aces and Eights
Seat 2: okwon (button) folded before Flop (didn't bet)
Seat 4: SuWasup (small blind) folded before Flop
Seat 5: hunteeer 05 (big blind) folded before Flop
Seat 6: chips1614 showed [As 5c] and lost with a pair of Aces


*********** # 109 **************
PokerStars Hand #204132323135:  Hold'em No Limit ($0.05/$0.10 USD) - 2019/10/01 7:15:28 ET
Table 'Tabit' 6-max Seat #1 is the button
Seat 1: PlayTheBlues4U ($9.70 in chips) 
Seat 2: okwon ($9.39 in chips) 
Seat 4: SuWasup ($11.15 in chips) 
Seat 5: hunteeer 05 ($14.05 in chips) 
Seat 6: chips1614 ($4.57 in chips) 
okwon: posts small blind $0.05
SuWasup: posts big blind $0.10
*** HOLE CARDS ***
Dealt to PlayTheBlues4U [3d 4h]
hunteeer 05: folds 
chips1614: raises $0.10 to $0.20
PlayTheBlues4U: calls $0.20
okwon: raises $0.10 to $0.30
SuWasup: folds 
chips1614: calls $0.10
PlayTheBlues4U: calls $0.10
*** FLOP *** [Qs Jc 2c]
okwon: bets $0.50
chips1614: folds 
PlayTheBlues4U: folds 
Uncalled bet ($0.50) returned to okwon
okwon collected $0.95 from pot
okwon: doesn't show hand 
*** SUMMARY ***
Total pot $1 | Rake $0.05 
Board [Qs Jc 2c]
Seat 1: PlayTheBlues4U (button) folded on the Flop
Seat 2: okwon (small blind) collected ($0.95)
Seat 4: SuWasup (big blind) folded before Flop
Seat 5: hunteeer 05 folded before Flop (didn't bet)
Seat 6: chips1614 folded on the Flop


*********** # 110 **************
PokerStars Hand #204132323107:  Hold'em No Limit ($0.05/$0.10 USD) - 2019/10/01 7:14:43 ET
Table 'Tabit' 6-max Seat #6 is the button
Seat 1: PlayTheBlues4U ($9.75 in chips) 
Seat 2: okwon ($9.49 in chips) 
Seat 5: hunteeer 05 ($7.32 in chips) 
Seat 6: chips1614 ($11.89 in chips) 
PlayTheBlues4U: posts small blind $0.05
okwon: posts big blind $0.10
SuWasup: sits out 
*** HOLE CARDS ***
Dealt to PlayTheBlues4U [Kc Jc]
hunteeer 05: raises $0.20 to $0.30
chips1614: raises $0.40 to $0.70
PlayTheBlues4U: folds 
okwon: folds 
hunteeer 05: raises $6.62 to $7.32 and is all-in
chips1614: calls $6.62
*** FLOP *** [Jd Qc Ts]
*** TURN *** [Jd Qc Ts] [5s]
*** RIVER *** [Jd Qc Ts 5s] [2c]
*** SHOW DOWN ***
hunteeer 05: shows [Jh Ah] (a pair of Jacks)
chips1614: shows [6h 6d] (a pair of Sixes)
hunteeer 05 collected $14.05 from pot
*** SUMMARY ***
Total pot $14.79 | Rake $0.74 
Board [Jd Qc Ts 5s 2c]
Seat 1: PlayTheBlues4U (small blind) folded before Flop
Seat 2: okwon (big blind) folded before Flop
Seat 5: hunteeer 05 showed [Jh Ah] and won ($14.05) with a pair of Jacks
Seat 6: chips1614 (button) showed [6h 6d] and lost with a pair of Sixes


*********** # 111 **************
PokerStars Hand #204132323094:  Hold'em No Limit ($0.05/$0.10 USD) - 2019/10/01 7:14:27 ET
Table 'Tabit' 6-max Seat #5 is the button
Seat 1: PlayTheBlues4U ($9.85 in chips) 
Seat 2: okwon ($9.13 in chips) 
Seat 5: hunteeer 05 ($7.32 in chips) 
Seat 6: chips1614 ($12.19 in chips) 
chips1614: posts small blind $0.05
PlayTheBlues4U: posts big blind $0.10
SuWasup: sits out 
*** HOLE CARDS ***
Dealt to PlayTheBlues4U [Qd 5h]
okwon: raises $0.20 to $0.30
hunteeer 05: folds 
chips1614: calls $0.25
PlayTheBlues4U: folds 
*** FLOP *** [8c Td 4s]
chips1614: checks 
okwon: bets $0.30
chips1614: folds 
Uncalled bet ($0.30) returned to okwon
okwon collected $0.66 from pot
okwon: doesn't show hand 
*** SUMMARY ***
Total pot $0.70 | Rake $0.04 
Board [8c Td 4s]
Seat 1: PlayTheBlues4U (big blind) folded before Flop
Seat 2: okwon collected ($0.66)
Seat 5: hunteeer 05 (button) folded before Flop (didn't bet)
Seat 6: chips1614 (small blind) folded on the Flop


*********** # 112 **************
PokerStars Hand #204132323076:  Hold'em No Limit ($0.05/$0.10 USD) - 2019/10/01 7:13:52 ET
Table 'Tabit' 6-max Seat #2 is the button
Seat 1: PlayTheBlues4U ($9.85 in chips) 
Seat 2: okwon ($10.23 in chips) 
Seat 5: hunteeer 05 ($7.37 in chips) 
Seat 6: chips1614 ($11.15 in chips) 
hunteeer 05: posts small blind $0.05
chips1614: posts big blind $0.10
*** HOLE CARDS ***
Dealt to PlayTheBlues4U [Jc 2h]
PlayTheBlues4U: folds 
okwon: raises $0.20 to $0.30
hunteeer 05: folds 
chips1614: calls $0.20
*** FLOP *** [2c 7h 5h]
chips1614: checks 
okwon: bets $0.40
chips1614: raises $0.40 to $0.80
okwon: calls $0.40
*** TURN *** [2c 7h 5h] [8h]
chips1614: bets $2.14
okwon: folds 
Uncalled bet ($2.14) returned to chips1614
chips1614 collected $2.14 from pot
chips1614: doesn't show hand 
*** SUMMARY ***
Total pot $2.25 | Rake $0.11 
Board [2c 7h 5h 8h]
Seat 1: PlayTheBlues4U folded before Flop (didn't bet)
Seat 2: okwon (button) folded on the Turn
Seat 5: hunteeer 05 (small blind) folded before Flop
Seat 6: chips1614 (big blind) collected ($2.14)


*********** # 113 **************
PokerStars Hand #204132323059:  Hold'em No Limit ($0.05/$0.10 USD) - 2019/10/01 7:13:24 ET
Table 'Tabit' 6-max Seat #1 is the button
Seat 1: PlayTheBlues4U ($9.85 in chips) 
Seat 2: okwon ($10.13 in chips) 
Seat 3: iasillo1989 ($21.51 in chips) 
Seat 4: SuWasup ($11.15 in chips) 
Seat 5: hunteeer 05 ($7.37 in chips) 
Seat 6: chips1614 ($11.15 in chips) 
okwon: posts small blind $0.05
iasillo1989: posts big blind $0.10
*** HOLE CARDS ***
Dealt to PlayTheBlues4U [Td 4h]
SuWasup has timed out
SuWasup: folds 
hunteeer 05: folds 
chips1614: folds 
PlayTheBlues4U: folds 
okwon: calls $0.05
iasillo1989: folds 
iasillo1989 leaves the table
okwon collected $0.20 from pot
okwon: doesn't show hand 
*** SUMMARY ***
Total pot $0.20 | Rake $0 
Seat 1: PlayTheBlues4U (button) folded before Flop (didn't bet)
Seat 2: okwon (small blind) collected ($0.20)
Seat 3: iasillo1989 (big blind) folded before Flop
Seat 4: SuWasup folded before Flop (didn't bet)
Seat 5: hunteeer 05 folded before Flop (didn't bet)
Seat 6: chips1614 folded before Flop (didn't bet)


*********** # 114 **************
PokerStars Hand #204132323052:  Hold'em No Limit ($0.05/$0.10 USD) - 2019/10/01 7:13:08 ET
Table 'Tabit' 6-max Seat #6 is the button
Seat 1: PlayTheBlues4U ($9.90 in chips) 
Seat 2: okwon ($10.23 in chips) 
Seat 3: iasillo1989 ($21.36 in chips) 
Seat 4: SuWasup ($11.15 in chips) 
Seat 5: hunteeer 05 ($7.37 in chips) 
Seat 6: chips1614 ($11.15 in chips) 
PlayTheBlues4U: posts small blind $0.05
okwon: posts big blind $0.10
*** HOLE CARDS ***
Dealt to PlayTheBlues4U [9c 8s]
iasillo1989: raises $0.90 to $1
SuWasup: folds 
hunteeer 05: folds 
chips1614: folds 
PlayTheBlues4U: folds 
okwon: folds 
Uncalled bet ($0.90) returned to iasillo1989
iasillo1989 collected $0.25 from pot
iasillo1989: doesn't show hand 
*** SUMMARY ***
Total pot $0.25 | Rake $0 
Seat 1: PlayTheBlues4U (small blind) folded before Flop
Seat 2: okwon (big blind) folded before Flop
Seat 3: iasillo1989 collected ($0.25)
Seat 4: SuWasup folded before Flop (didn't bet)
Seat 5: hunteeer 05 folded before Flop (didn't bet)
Seat 6: chips1614 (button) folded before Flop (didn't bet)


*********** # 115 **************
PokerStars Hand #204132323031:  Hold'em No Limit ($0.05/$0.10 USD) - 2019/10/01 7:12:39 ET
Table 'Tabit' 6-max Seat #5 is the button
Seat 1: PlayTheBlues4U ($10 in chips) 
Seat 2: okwon ($10.23 in chips) 
Seat 3: iasillo1989 ($20.64 in chips) 
Seat 4: SuWasup ($11.15 in chips) 
Seat 5: hunteeer 05 ($3.37 in chips) 
Seat 6: chips1614 ($11.85 in chips) 
chips1614: posts small blind $0.05
PlayTheBlues4U: posts big blind $0.10
*** HOLE CARDS ***
Dealt to PlayTheBlues4U [2h 6s]
okwon: folds 
iasillo1989: calls $0.10
SuWasup: folds 
hunteeer 05: folds 
chips1614: raises $0.30 to $0.40
PlayTheBlues4U: folds 
iasillo1989: raises $0.30 to $0.70
chips1614: calls $0.30
*** FLOP *** [9h 4d 7d]
chips1614: checks 
iasillo1989: bets $2
chips1614: folds 
Uncalled bet ($2) returned to iasillo1989
iasillo1989 collected $1.42 from pot
iasillo1989: doesn't show hand 
*** SUMMARY ***
Total pot $1.50 | Rake $0.08 
Board [9h 4d 7d]
Seat 1: PlayTheBlues4U (big blind) folded before Flop
Seat 2: okwon folded before Flop (didn't bet)
Seat 3: iasillo1989 collected ($1.42)
Seat 4: SuWasup folded before Flop (didn't bet)
Seat 5: hunteeer 05 (button) folded before Flop (didn't bet)
Seat 6: chips1614 (small blind) folded on the Flop


*********** # 116 **************
PokerStars Hand #204119682675:  Hold'em No Limit ($0.05/$0.10 USD) - 2019/09/30 22:49:52 ET
Table 'Tabit' 6-max Seat #4 is the button
Seat 2: DaGoodz33 ($7.68 in chips) 
Seat 4: PlayTheBlues4U ($13.10 in chips) 
Seat 6: davetass ($13.47 in chips) 
davetass: posts small blind $0.05
DaGoodz33: posts big blind $0.10
*** HOLE CARDS ***
Dealt to PlayTheBlues4U [Qs 3c]
PlayTheBlues4U: folds 
davetass: calls $0.05
PlayTheBlues4U leaves the table
DaGoodz33: checks 
*** FLOP *** [5d 3d Ks]
davetass: checks 
DaGoodz33: bets $0.19
davetass: calls $0.19
*** TURN *** [5d 3d Ks] [7c]
davetass: checks 
DaGoodz33: checks 
*** RIVER *** [5d 3d Ks 7c] [9s]
davetass: bets $0.28
DaGoodz33: folds 
Uncalled bet ($0.28) returned to davetass
davetass collected $0.55 from pot
davetass: doesn't show hand 
*** SUMMARY ***
Total pot $0.58 | Rake $0.03 
Board [5d 3d Ks 7c 9s]
Seat 2: DaGoodz33 (big blind) folded on the River
Seat 4: PlayTheBlues4U (button) folded before Flop (didn't bet)
Seat 6: davetass (small blind) collected ($0.55)


*********** # 117 **************
PokerStars Hand #204119682600:  Hold'em No Limit ($0.05/$0.10 USD) - 2019/09/30 22:49:21 ET
Table 'Tabit' 6-max Seat #2 is the button
Seat 2: DaGoodz33 ($7.68 in chips) 
Seat 4: PlayTheBlues4U ($13.69 in chips) 
Seat 6: davetass ($12.94 in chips) 
PlayTheBlues4U: posts small blind $0.05
davetass: posts big blind $0.10
*** HOLE CARDS ***
Dealt to PlayTheBlues4U [Ac Kh]
DaGoodz33: folds 
PlayTheBlues4U: raises $0.20 to $0.30
davetass: calls $0.20
*** FLOP *** [5s 2d 8h]
PlayTheBlues4U: checks 
davetass: bets $0.29
PlayTheBlues4U: calls $0.29
*** TURN *** [5s 2d 8h] [7h]
PlayTheBlues4U: checks 
davetass: bets $0.56
PlayTheBlues4U: folds 
Uncalled bet ($0.56) returned to davetass
davetass collected $1.12 from pot
davetass: doesn't show hand 
*** SUMMARY ***
Total pot $1.18 | Rake $0.06 
Board [5s 2d 8h 7h]
Seat 2: DaGoodz33 (button) folded before Flop (didn't bet)
Seat 4: PlayTheBlues4U (small blind) folded on the Turn
Seat 6: davetass (big blind) collected ($1.12)


*********** # 118 **************
PokerStars Hand #204119682511:  Hold'em No Limit ($0.05/$0.10 USD) - 2019/09/30 22:48:46 ET
Table 'Tabit' 6-max Seat #6 is the button
Seat 2: DaGoodz33 ($7.78 in chips) 
Seat 4: PlayTheBlues4U ($13.60 in chips) 
Seat 5: KingBoy0519 ($7.44 in chips) 
Seat 6: davetass ($12.94 in chips) 
DaGoodz33: posts small blind $0.05
PlayTheBlues4U: posts big blind $0.10
*** HOLE CARDS ***
Dealt to PlayTheBlues4U [6s Td]
KingBoy0519: folds 
KingBoy0519 leaves the table
davetass: folds 
DaGoodz33: calls $0.05
PlayTheBlues4U: checks 
*** FLOP *** [2s As Ks]
DaGoodz33: checks 
PlayTheBlues4U: checks 
*** TURN *** [2s As Ks] [Qc]
DaGoodz33: checks 
PlayTheBlues4U: checks 
*** RIVER *** [2s As Ks Qc] [3h]
DaGoodz33: checks 
PlayTheBlues4U: checks 
*** SHOW DOWN ***
DaGoodz33: shows [Th 4h] (high card Ace)
PlayTheBlues4U: shows [6s Td] (high card Ace - King+Queen+Ten+Six kicker)
PlayTheBlues4U collected $0.19 from pot
*** SUMMARY ***
Total pot $0.20 | Rake $0.01 
Board [2s As Ks Qc 3h]
Seat 2: DaGoodz33 (small blind) showed [Th 4h] and lost with high card Ace
Seat 4: PlayTheBlues4U (big blind) showed [6s Td] and won ($0.19) with high card Ace
Seat 5: KingBoy0519 folded before Flop (didn't bet)
Seat 6: davetass (button) folded before Flop (didn't bet)


*********** # 119 **************
PokerStars Hand #204119682496:  Hold'em No Limit ($0.05/$0.10 USD) - 2019/09/30 22:48:39 ET
Table 'Tabit' 6-max Seat #5 is the button
Seat 2: DaGoodz33 ($7.73 in chips) 
Seat 4: PlayTheBlues4U ($13.60 in chips) 
Seat 5: KingBoy0519 ($7.44 in chips) 
Seat 6: davetass ($12.99 in chips) 
davetass: posts small blind $0.05
DaGoodz33: posts big blind $0.10
*** HOLE CARDS ***
Dealt to PlayTheBlues4U [3s 5s]
PlayTheBlues4U: folds 
KingBoy0519: folds 
davetass: folds 
Uncalled bet ($0.05) returned to DaGoodz33
DaGoodz33 collected $0.10 from pot
DaGoodz33: doesn't show hand 
*** SUMMARY ***
Total pot $0.10 | Rake $0 
Seat 2: DaGoodz33 (big blind) collected ($0.10)
Seat 4: PlayTheBlues4U folded before Flop (didn't bet)
Seat 5: KingBoy0519 (button) folded before Flop (didn't bet)
Seat 6: davetass (small blind) folded before Flop


*********** # 120 **************
PokerStars Hand #204119682375:  Hold'em No Limit ($0.05/$0.10 USD) - 2019/09/30 22:47:50 ET
Table 'Tabit' 6-max Seat #4 is the button
Seat 2: DaGoodz33 ($8.03 in chips) 
Seat 4: PlayTheBlues4U ($13.19 in chips) 
Seat 5: KingBoy0519 ($7.49 in chips) 
Seat 6: davetass ($13.09 in chips) 
KingBoy0519: posts small blind $0.05
davetass: posts big blind $0.10
*** HOLE CARDS ***
Dealt to PlayTheBlues4U [Th 9c]
slgu1201 leaves the table
DaGoodz33: calls $0.10
PlayTheBlues4U: raises $0.20 to $0.30
KingBoy0519: folds 
davetass: folds 
DaGoodz33: calls $0.20
*** FLOP *** [7h 5s 9d]
DaGoodz33: checks 
PlayTheBlues4U: bets $0.50
DaGoodz33: folds 
Uncalled bet ($0.50) returned to PlayTheBlues4U
PlayTheBlues4U collected $0.71 from pot
PlayTheBlues4U: doesn't show hand 
*** SUMMARY ***
Total pot $0.75 | Rake $0.04 
Board [7h 5s 9d]
Seat 2: DaGoodz33 folded on the Flop
Seat 4: PlayTheBlues4U (button) collected ($0.71)
Seat 5: KingBoy0519 (small blind) folded before Flop
Seat 6: davetass (big blind) folded before Flop


*********** # 121 **************
PokerStars Hand #204119682312:  Hold'em No Limit ($0.05/$0.10 USD) - 2019/09/30 22:47:24 ET
Table 'Tabit' 6-max Seat #2 is the button
Seat 1: slgu1201 ($12.28 in chips) 
Seat 2: DaGoodz33 ($8.03 in chips) 
Seat 4: PlayTheBlues4U ($13.24 in chips) 
Seat 5: KingBoy0519 ($7.17 in chips) 
Seat 6: davetass ($13.09 in chips) 
PlayTheBlues4U: posts small blind $0.05
KingBoy0519: posts big blind $0.10
*** HOLE CARDS ***
Dealt to PlayTheBlues4U [8s 5d]
davetass: folds 
slgu1201: calls $0.10
DaGoodz33: folds 
PlayTheBlues4U: folds 
KingBoy0519: raises $0.20 to $0.30
slgu1201: calls $0.20
*** FLOP *** [Ah Tc 7h]
KingBoy0519: bets $0.40
slgu1201: folds 
Uncalled bet ($0.40) returned to KingBoy0519
KingBoy0519 collected $0.62 from pot
KingBoy0519: doesn't show hand 
*** SUMMARY ***
Total pot $0.65 | Rake $0.03 
Board [Ah Tc 7h]
Seat 1: slgu1201 folded on the Flop
Seat 2: DaGoodz33 (button) folded before Flop (didn't bet)
Seat 4: PlayTheBlues4U (small blind) folded before Flop
Seat 5: KingBoy0519 (big blind) collected ($0.62)
Seat 6: davetass folded before Flop (didn't bet)


*********** # 122 **************
PokerStars Hand #204119682215:  Hold'em No Limit ($0.05/$0.10 USD) - 2019/09/30 22:46:49 ET
Table 'Tabit' 6-max Seat #1 is the button
Seat 1: slgu1201 ($11.51 in chips) 
Seat 2: DaGoodz33 ($8.08 in chips) 
Seat 4: PlayTheBlues4U ($14.04 in chips) 
Seat 5: KingBoy0519 ($7.17 in chips) 
Seat 6: davetass ($13.09 in chips) 
DaGoodz33: posts small blind $0.05
PlayTheBlues4U: posts big blind $0.10
*** HOLE CARDS ***
Dealt to PlayTheBlues4U [Ts Jc]
KingBoy0519: folds 
davetass: folds 
slgu1201: calls $0.10
DaGoodz33: folds 
PlayTheBlues4U: checks 
*** FLOP *** [5c 9d 2h]
PlayTheBlues4U: checks 
slgu1201: bets $0.10
PlayTheBlues4U: calls $0.10
*** TURN *** [5c 9d 2h] [Td]
PlayTheBlues4U: checks 
slgu1201: bets $0.20
PlayTheBlues4U: calls $0.20
*** RIVER *** [5c 9d 2h Td] [Kc]
PlayTheBlues4U: checks 
slgu1201: bets $0.40
PlayTheBlues4U: calls $0.40
*** SHOW DOWN ***
slgu1201: shows [9s Tc] (two pair, Tens and Nines)
PlayTheBlues4U: mucks hand 
slgu1201 collected $1.57 from pot
*** SUMMARY ***
Total pot $1.65 | Rake $0.08 
Board [5c 9d 2h Td Kc]
Seat 1: slgu1201 (button) showed [9s Tc] and won ($1.57) with two pair, Tens and Nines
Seat 2: DaGoodz33 (small blind) folded before Flop
Seat 4: PlayTheBlues4U (big blind) mucked [Ts Jc]
Seat 5: KingBoy0519 folded before Flop (didn't bet)
Seat 6: davetass folded before Flop (didn't bet)


*********** # 123 **************
PokerStars Hand #204119682086:  Hold'em No Limit ($0.05/$0.10 USD) - 2019/09/30 22:45:59 ET
Table 'Tabit' 6-max Seat #6 is the button
Seat 1: slgu1201 ($11.61 in chips) 
Seat 2: DaGoodz33 ($7.98 in chips) 
Seat 3: rkk7777 ($15.55 in chips) 
Seat 4: PlayTheBlues4U ($14.04 in chips) 
Seat 5: KingBoy0519 ($7.17 in chips) 
Seat 6: davetass ($13.09 in chips) 
slgu1201: posts small blind $0.05
DaGoodz33: posts big blind $0.10
*** HOLE CARDS ***
Dealt to PlayTheBlues4U [Js 6h]
rkk7777: folds 
PlayTheBlues4U: folds 
KingBoy0519: folds 
davetass: folds 
slgu1201: calls $0.05
rkk7777 leaves the table
DaGoodz33: raises $0.20 to $0.30
slgu1201: folds 
Uncalled bet ($0.20) returned to DaGoodz33
DaGoodz33 collected $0.20 from pot
DaGoodz33: doesn't show hand 
*** SUMMARY ***
Total pot $0.20 | Rake $0 
Seat 1: slgu1201 (small blind) folded before Flop
Seat 2: DaGoodz33 (big blind) collected ($0.20)
Seat 3: rkk7777 folded before Flop (didn't bet)
Seat 4: PlayTheBlues4U folded before Flop (didn't bet)
Seat 5: KingBoy0519 folded before Flop (didn't bet)
Seat 6: davetass (button) folded before Flop (didn't bet)


*********** # 124 **************
PokerStars Hand #204119681987:  Hold'em No Limit ($0.05/$0.10 USD) - 2019/09/30 22:45:22 ET
Table 'Tabit' 6-max Seat #5 is the button
Seat 1: slgu1201 ($11.71 in chips) 
Seat 2: DaGoodz33 ($7.98 in chips) 
Seat 3: rkk7777 ($15.55 in chips) 
Seat 4: PlayTheBlues4U ($14.04 in chips) 
Seat 5: KingBoy0519 ($7.03 in chips) 
Seat 6: davetass ($13.14 in chips) 
davetass: posts small blind $0.05
slgu1201: posts big blind $0.10
*** HOLE CARDS ***
Dealt to PlayTheBlues4U [4h 6h]
DaGoodz33: folds 
rkk7777: folds 
PlayTheBlues4U: folds 
KingBoy0519: calls $0.10
davetass: folds 
slgu1201: checks 
*** FLOP *** [Ac 6d 8d]
slgu1201: checks 
KingBoy0519: bets $0.20
slgu1201: folds 
Uncalled bet ($0.20) returned to KingBoy0519
KingBoy0519 collected $0.24 from pot
KingBoy0519: doesn't show hand 
*** SUMMARY ***
Total pot $0.25 | Rake $0.01 
Board [Ac 6d 8d]
Seat 1: slgu1201 (big blind) folded on the Flop
Seat 2: DaGoodz33 folded before Flop (didn't bet)
Seat 3: rkk7777 folded before Flop (didn't bet)
Seat 4: PlayTheBlues4U folded before Flop (didn't bet)
Seat 5: KingBoy0519 (button) collected ($0.24)
Seat 6: davetass (small blind) folded before Flop


*********** # 125 **************
PokerStars Hand #204119681895:  Hold'em No Limit ($0.05/$0.10 USD) - 2019/09/30 22:44:46 ET
Table 'Tabit' 6-max Seat #4 is the button
Seat 1: slgu1201 ($8.71 in chips) 
Seat 2: DaGoodz33 ($7.98 in chips) 
Seat 3: rkk7777 ($15.85 in chips) 
Seat 4: PlayTheBlues4U ($14.04 in chips) 
Seat 5: KingBoy0519 ($7.33 in chips) 
Seat 6: davetass ($15.84 in chips) 
KingBoy0519: posts small blind $0.05
davetass: posts big blind $0.10
*** HOLE CARDS ***
Dealt to PlayTheBlues4U [5s 8d]
slgu1201: raises $0.20 to $0.30
DaGoodz33: folds 
rkk7777: calls $0.30
PlayTheBlues4U: folds 
KingBoy0519: calls $0.25
davetass: raises $1.20 to $1.50
slgu1201: raises $1.20 to $2.70
rkk7777: folds 
KingBoy0519: folds 
davetass: calls $1.20
*** FLOP *** [7c 2s 6c]
davetass: checks 
slgu1201: bets $6.01 and is all-in
davetass: folds [Ad Kd]
Uncalled bet ($6.01) returned to slgu1201
slgu1201 collected $5.70 from pot
slgu1201: doesn't show hand 
*** SUMMARY ***
Total pot $6 | Rake $0.30 
Board [7c 2s 6c]
Seat 1: slgu1201 collected ($5.70)
Seat 2: DaGoodz33 folded before Flop (didn't bet)
Seat 3: rkk7777 folded before Flop
Seat 4: PlayTheBlues4U (button) folded before Flop (didn't bet)
Seat 5: KingBoy0519 (small blind) folded before Flop
Seat 6: davetass (big blind) folded on the Flop


*********** # 126 **************
PokerStars Hand #204119681736:  Hold'em No Limit ($0.05/$0.10 USD) - 2019/09/30 22:43:52 ET
Table 'Tabit' 6-max Seat #3 is the button
Seat 1: slgu1201 ($8.71 in chips) 
Seat 2: DaGoodz33 ($8.33 in chips) 
Seat 3: rkk7777 ($15.16 in chips) 
Seat 4: PlayTheBlues4U ($14.09 in chips) 
Seat 5: KingBoy0519 ($7.68 in chips) 
Seat 6: davetass ($15.84 in chips) 
PlayTheBlues4U: posts small blind $0.05
KingBoy0519: posts big blind $0.10
*** HOLE CARDS ***
Dealt to PlayTheBlues4U [4h Jc]
davetass: folds 
slgu1201: folds 
DaGoodz33: raises $0.25 to $0.35
rkk7777: calls $0.35
PlayTheBlues4U: folds 
KingBoy0519: calls $0.25
*** FLOP *** [8d 3h 8c]
KingBoy0519: checks 
DaGoodz33: checks 
rkk7777: checks 
*** TURN *** [8d 3h 8c] [7d]
KingBoy0519: checks 
DaGoodz33: checks 
rkk7777: checks 
*** RIVER *** [8d 3h 8c 7d] [9c]
KingBoy0519: checks 
DaGoodz33: checks 
rkk7777: bets $0.40
KingBoy0519: folds 
DaGoodz33: folds 
Uncalled bet ($0.40) returned to rkk7777
rkk7777 collected $1.04 from pot
*** SUMMARY ***
Total pot $1.10 | Rake $0.06 
Board [8d 3h 8c 7d 9c]
Seat 1: slgu1201 folded before Flop (didn't bet)
Seat 2: DaGoodz33 folded on the River
Seat 3: rkk7777 (button) collected ($1.04)
Seat 4: PlayTheBlues4U (small blind) folded before Flop
Seat 5: KingBoy0519 (big blind) folded on the River
Seat 6: davetass folded before Flop (didn't bet)


*********** # 127 **************
PokerStars Hand #204119681597:  Hold'em No Limit ($0.05/$0.10 USD) - 2019/09/30 22:43:04 ET
Table 'Tabit' 6-max Seat #2 is the button
Seat 1: slgu1201 ($8.71 in chips) 
Seat 2: DaGoodz33 ($8.33 in chips) 
Seat 3: rkk7777 ($15.26 in chips) 
Seat 4: PlayTheBlues4U ($13.73 in chips) 
Seat 5: KingBoy0519 ($7.98 in chips) 
Seat 6: davetass ($15.84 in chips) 
rkk7777: posts small blind $0.05
PlayTheBlues4U: posts big blind $0.10
*** HOLE CARDS ***
Dealt to PlayTheBlues4U [9h 8c]
davetass said, "nh"
KingBoy0519: calls $0.10
davetass: folds 
slgu1201: folds 
DaGoodz33: folds 
rkk7777: calls $0.05
PlayTheBlues4U: checks 
*** FLOP *** [As 8d Qc]
rkk7777: checks 
PlayTheBlues4U: checks 
rkk7777 said, "ty"
KingBoy0519: checks 
*** TURN *** [As 8d Qc] [9s]
rkk7777: checks 
PlayTheBlues4U: bets $0.20
KingBoy0519: calls $0.20
rkk7777: folds 
*** RIVER *** [As 8d Qc 9s] [2s]
PlayTheBlues4U: bets $0.40
KingBoy0519: folds 
Uncalled bet ($0.40) returned to PlayTheBlues4U
PlayTheBlues4U collected $0.66 from pot
PlayTheBlues4U: doesn't show hand 
*** SUMMARY ***
Total pot $0.70 | Rake $0.04 
Board [As 8d Qc 9s 2s]
Seat 1: slgu1201 folded before Flop (didn't bet)
Seat 2: DaGoodz33 (button) folded before Flop (didn't bet)
Seat 3: rkk7777 (small blind) folded on the Turn
Seat 4: PlayTheBlues4U (big blind) collected ($0.66)
Seat 5: KingBoy0519 folded on the River
Seat 6: davetass folded before Flop (didn't bet)


*********** # 128 **************
PokerStars Hand #204119681451:  Hold'em No Limit ($0.05/$0.10 USD) - 2019/09/30 22:42:12 ET
Table 'Tabit' 6-max Seat #1 is the button
Seat 1: slgu1201 ($9.01 in chips) 
Seat 2: DaGoodz33 ($8.38 in chips) 
Seat 3: rkk7777 ($14.12 in chips) 
Seat 4: PlayTheBlues4U ($13.73 in chips) 
Seat 5: KingBoy0519 ($7.98 in chips) 
Seat 6: davetass ($16.74 in chips) 
DaGoodz33: posts small blind $0.05
rkk7777: posts big blind $0.10
*** HOLE CARDS ***
Dealt to PlayTheBlues4U [8d 9d]
PlayTheBlues4U: folds 
KingBoy0519: folds 
davetass: raises $0.20 to $0.30
slgu1201: calls $0.30
DaGoodz33: folds 
rkk7777: calls $0.20
*** FLOP *** [9c Ks Jh]
rkk7777: checks 
davetass: checks 
slgu1201: checks 
*** TURN *** [9c Ks Jh] [5h]
rkk7777: bets $0.40
davetass: calls $0.40
slgu1201: folds 
*** RIVER *** [9c Ks Jh 5h] [3c]
rkk7777: bets $0.20
davetass: calls $0.20
*** SHOW DOWN ***
rkk7777: shows [Ts Kc] (a pair of Kings)
davetass: mucks hand 
rkk7777 collected $2.04 from pot
*** SUMMARY ***
Total pot $2.15 | Rake $0.11 
Board [9c Ks Jh 5h 3c]
Seat 1: slgu1201 (button) folded on the Turn
Seat 2: DaGoodz33 (small blind) folded before Flop
Seat 3: rkk7777 (big blind) showed [Ts Kc] and won ($2.04) with a pair of Kings
Seat 4: PlayTheBlues4U folded before Flop (didn't bet)
Seat 5: KingBoy0519 folded before Flop (didn't bet)
Seat 6: davetass mucked [Qc Ac]


*********** # 129 **************
PokerStars Hand #204119681333:  Hold'em No Limit ($0.05/$0.10 USD) - 2019/09/30 22:41:30 ET
Table 'Tabit' 6-max Seat #6 is the button
Seat 1: slgu1201 ($8.73 in chips) 
Seat 2: DaGoodz33 ($8.48 in chips) 
Seat 3: rkk7777 ($14.22 in chips) 
Seat 4: PlayTheBlues4U ($13.73 in chips) 
Seat 5: KingBoy0519 ($7.98 in chips) 
Seat 6: davetass ($16.84 in chips) 
slgu1201: posts small blind $0.05
DaGoodz33: posts big blind $0.10
*** HOLE CARDS ***
Dealt to PlayTheBlues4U [7d 5c]
rkk7777: calls $0.10
PlayTheBlues4U: folds 
KingBoy0519: folds 
davetass: calls $0.10
slgu1201: calls $0.05
DaGoodz33: checks 
*** FLOP *** [Th Jd Kh]
slgu1201: bets $0.20
DaGoodz33: folds 
rkk7777: folds 
davetass: folds 
Uncalled bet ($0.20) returned to slgu1201
slgu1201 collected $0.38 from pot
slgu1201: doesn't show hand 
*** SUMMARY ***
Total pot $0.40 | Rake $0.02 
Board [Th Jd Kh]
Seat 1: slgu1201 (small blind) collected ($0.38)
Seat 2: DaGoodz33 (big blind) folded on the Flop
Seat 3: rkk7777 folded on the Flop
Seat 4: PlayTheBlues4U folded before Flop (didn't bet)
Seat 5: KingBoy0519 folded before Flop (didn't bet)
Seat 6: davetass (button) folded on the Flop


*********** # 130 **************
PokerStars Hand #204119681243:  Hold'em No Limit ($0.05/$0.10 USD) - 2019/09/30 22:40:56 ET
Table 'Tabit' 6-max Seat #5 is the button
Seat 1: slgu1201 ($8.83 in chips) 
Seat 2: DaGoodz33 ($8.48 in chips) 
Seat 3: rkk7777 ($14.07 in chips) 
Seat 4: PlayTheBlues4U ($13.73 in chips) 
Seat 5: KingBoy0519 ($7.98 in chips) 
Seat 6: davetass ($16.89 in chips) 
davetass: posts small blind $0.05
slgu1201: posts big blind $0.10
*** HOLE CARDS ***
Dealt to PlayTheBlues4U [Ac 2h]
DaGoodz33: folds 
rkk7777: raises $0.20 to $0.30
PlayTheBlues4U: folds 
KingBoy0519: folds 
davetass: folds 
slgu1201: folds 
Uncalled bet ($0.20) returned to rkk7777
rkk7777 collected $0.25 from pot
*** SUMMARY ***
Total pot $0.25 | Rake $0 
Seat 1: slgu1201 (big blind) folded before Flop
Seat 2: DaGoodz33 folded before Flop (didn't bet)
Seat 3: rkk7777 collected ($0.25)
Seat 4: PlayTheBlues4U folded before Flop (didn't bet)
Seat 5: KingBoy0519 (button) folded before Flop (didn't bet)
Seat 6: davetass (small blind) folded before Flop


*********** # 131 **************
PokerStars Hand #204119681191:  Hold'em No Limit ($0.05/$0.10 USD) - 2019/09/30 22:40:37 ET
Table 'Tabit' 6-max Seat #4 is the button
Seat 1: slgu1201 ($8.83 in chips) 
Seat 2: DaGoodz33 ($8.48 in chips) 
Seat 3: rkk7777 ($14.07 in chips) 
Seat 4: PlayTheBlues4U ($13.73 in chips) 
Seat 5: KingBoy0519 ($7.88 in chips) 
Seat 6: davetass ($16.99 in chips) 
KingBoy0519: posts small blind $0.05
davetass: posts big blind $0.10
*** HOLE CARDS ***
Dealt to PlayTheBlues4U [8c 6d]
PlayTheBlues4U said, "last hand"
slgu1201: folds 
DaGoodz33: folds 
rkk7777: folds 
PlayTheBlues4U: folds 
KingBoy0519: raises $0.20 to $0.30
davetass: folds 
Uncalled bet ($0.20) returned to KingBoy0519
KingBoy0519 collected $0.20 from pot
KingBoy0519: doesn't show hand 
*** SUMMARY ***
Total pot $0.20 | Rake $0 
Seat 1: slgu1201 folded before Flop (didn't bet)
Seat 2: DaGoodz33 folded before Flop (didn't bet)
Seat 3: rkk7777 folded before Flop (didn't bet)
Seat 4: PlayTheBlues4U (button) folded before Flop (didn't bet)
Seat 5: KingBoy0519 (small blind) collected ($0.20)
Seat 6: davetass (big blind) folded before Flop


*********** # 132 **************
PokerStars Hand #204119681114:  Hold'em No Limit ($0.05/$0.10 USD) - 2019/09/30 22:40:09 ET
Table 'Tabit' 6-max Seat #3 is the button
Seat 1: slgu1201 ($8.83 in chips) 
Seat 2: DaGoodz33 ($8.48 in chips) 
Seat 3: rkk7777 ($14.27 in chips) 
Seat 4: PlayTheBlues4U ($13.78 in chips) 
Seat 5: KingBoy0519 ($7.65 in chips) 
Seat 6: davetass ($16.99 in chips) 
PlayTheBlues4U: posts small blind $0.05
KingBoy0519: posts big blind $0.10
*** HOLE CARDS ***
Dealt to PlayTheBlues4U [6h Kd]
davetass: folds 
slgu1201: folds 
DaGoodz33: folds 
rkk7777: calls $0.10
PlayTheBlues4U: folds 
KingBoy0519: checks 
*** FLOP *** [2s 4c Td]
KingBoy0519: checks 
rkk7777: bets $0.10
KingBoy0519: calls $0.10
*** TURN *** [2s 4c Td] [Ts]
KingBoy0519: checks 
rkk7777: checks 
*** RIVER *** [2s 4c Td Ts] [4s]
KingBoy0519: bets $0.40
PlayTheBlues4U said, "I folded the A5ss"
rkk7777: folds 
Uncalled bet ($0.40) returned to KingBoy0519
KingBoy0519 collected $0.43 from pot
KingBoy0519: doesn't show hand 
*** SUMMARY ***
Total pot $0.45 | Rake $0.02 
Board [2s 4c Td Ts 4s]
Seat 1: slgu1201 folded before Flop (didn't bet)
Seat 2: DaGoodz33 folded before Flop (didn't bet)
Seat 3: rkk7777 (button) folded on the River
Seat 4: PlayTheBlues4U (small blind) folded before Flop
Seat 5: KingBoy0519 (big blind) collected ($0.43)
Seat 6: davetass folded before Flop (didn't bet)


*********** # 133 **************
PokerStars Hand #204119681004:  Hold'em No Limit ($0.05/$0.10 USD) - 2019/09/30 22:39:30 ET
Table 'Tabit' 6-max Seat #2 is the button
Seat 1: slgu1201 ($9.13 in chips) 
Seat 2: DaGoodz33 ($11.91 in chips) 
Seat 3: rkk7777 ($10.80 in chips) 
Seat 4: PlayTheBlues4U ($13.88 in chips) 
Seat 5: KingBoy0519 ($7.65 in chips) 
Seat 6: davetass ($16.99 in chips) 
rkk7777: posts small blind $0.05
PlayTheBlues4U: posts big blind $0.10
*** HOLE CARDS ***
Dealt to PlayTheBlues4U [5s As]
KingBoy0519: folds 
davetass: folds 
slgu1201: raises $0.20 to $0.30
DaGoodz33: raises $0.75 to $1.05
rkk7777: calls $1
PlayTheBlues4U: folds 
slgu1201: folds 
*** FLOP *** [7s 8s 4c]
rkk7777: checks 
DaGoodz33: bets $2.38
rkk7777: raises $2.98 to $5.36
DaGoodz33: folds 
Uncalled bet ($2.98) returned to rkk7777
rkk7777 collected $6.90 from pot
*** SUMMARY ***
Total pot $7.26 | Rake $0.36 
Board [7s 8s 4c]
Seat 1: slgu1201 folded before Flop
Seat 2: DaGoodz33 (button) folded on the Flop
Seat 3: rkk7777 (small blind) collected ($6.90)
Seat 4: PlayTheBlues4U (big blind) folded before Flop
Seat 5: KingBoy0519 folded before Flop (didn't bet)
Seat 6: davetass folded before Flop (didn't bet)


*********** # 134 **************
PokerStars Hand #204119680901:  Hold'em No Limit ($0.05/$0.10 USD) - 2019/09/30 22:38:56 ET
Table 'Tabit' 6-max Seat #1 is the button
Seat 1: slgu1201 ($8 in chips) 
Seat 2: DaGoodz33 ($11.96 in chips) 
Seat 3: rkk7777 ($12 in chips) 
Seat 4: PlayTheBlues4U ($13.88 in chips) 
Seat 5: KingBoy0519 ($7.65 in chips) 
Seat 6: davetass ($16.99 in chips) 
DaGoodz33: posts small blind $0.05
rkk7777: posts big blind $0.10
*** HOLE CARDS ***
Dealt to PlayTheBlues4U [Td Jh]
PlayTheBlues4U: folds 
KingBoy0519: folds 
davetass: folds 
slgu1201: raises $0.20 to $0.30
DaGoodz33: folds 
rkk7777: calls $0.20
*** FLOP *** [9h 2s 8d]
rkk7777: checks 
slgu1201: bets $0.30
rkk7777: calls $0.30
*** TURN *** [9h 2s 8d] [3c]
rkk7777: checks 
slgu1201: bets $0.60
rkk7777: calls $0.60
*** RIVER *** [9h 2s 8d 3c] [6h]
rkk7777: checks 
slgu1201: bets $1.20
rkk7777: folds 
Uncalled bet ($1.20) returned to slgu1201
slgu1201 collected $2.33 from pot
slgu1201: doesn't show hand 
*** SUMMARY ***
Total pot $2.45 | Rake $0.12 
Board [9h 2s 8d 3c 6h]
Seat 1: slgu1201 (button) collected ($2.33)
Seat 2: DaGoodz33 (small blind) folded before Flop
Seat 3: rkk7777 (big blind) folded on the River
Seat 4: PlayTheBlues4U folded before Flop (didn't bet)
Seat 5: KingBoy0519 folded before Flop (didn't bet)
Seat 6: davetass folded before Flop (didn't bet)


*********** # 135 **************
PokerStars Hand #204114099978:  Hold'em No Limit ($0.05/$0.10 USD) - 2019/09/30 22:38:12 ET
Table 'Tabit' 6-max Seat #6 is the button
Seat 1: slgu1201 ($8.10 in chips) 
Seat 2: DaGoodz33 ($10.78 in chips) 
Seat 3: rkk7777 ($13.20 in chips) 
Seat 4: PlayTheBlues4U ($13.88 in chips) 
Seat 5: KingBoy0519 ($7.65 in chips) 
Seat 6: davetass ($16.99 in chips) 
slgu1201: posts small blind $0.05
DaGoodz33: posts big blind $0.10
*** HOLE CARDS ***
Dealt to PlayTheBlues4U [Ad 6s]
rkk7777: calls $0.10
PlayTheBlues4U: folds 
KingBoy0519: folds 
davetass: folds 
slgu1201: calls $0.05
DaGoodz33: checks 
*** FLOP *** [Tc 7d Qh]
slgu1201: checks 
DaGoodz33: bets $0.28
rkk7777: calls $0.28
slgu1201: folds 
*** TURN *** [Tc 7d Qh] [Qd]
DaGoodz33: bets $0.82
rkk7777: calls $0.82
*** RIVER *** [Tc 7d Qh Qd] [7c]
DaGoodz33: checks 
rkk7777: checks 
*** SHOW DOWN ***
DaGoodz33: shows [Qc Jh] (a full house, Queens full of Sevens)
rkk7777: mucks hand 
DaGoodz33 collected $2.38 from pot
*** SUMMARY ***
Total pot $2.50 | Rake $0.12 
Board [Tc 7d Qh Qd 7c]
Seat 1: slgu1201 (small blind) folded on the Flop
Seat 2: DaGoodz33 (big blind) showed [Qc Jh] and won ($2.38) with a full house, Queens full of Sevens
Seat 3: rkk7777 mucked [9d Td]
Seat 4: PlayTheBlues4U folded before Flop (didn't bet)
Seat 5: KingBoy0519 folded before Flop (didn't bet)
Seat 6: davetass (button) folded before Flop (didn't bet)


*********** # 136 **************
PokerStars Hand #204114099898:  Hold'em No Limit ($0.05/$0.10 USD) - 2019/09/30 22:37:47 ET
Table 'Tabit' 6-max Seat #5 is the button
Seat 1: slgu1201 ($8.20 in chips) 
Seat 2: DaGoodz33 ($10.78 in chips) 
Seat 3: rkk7777 ($13.20 in chips) 
Seat 4: PlayTheBlues4U ($13.88 in chips) 
Seat 5: KingBoy0519 ($8.09 in chips) 
Seat 6: davetass ($16.50 in chips) 
davetass: posts small blind $0.05
slgu1201: posts big blind $0.10
*** HOLE CARDS ***
Dealt to PlayTheBlues4U [2c 4c]
DaGoodz33: folds 
rkk7777: folds 
PlayTheBlues4U: folds 
KingBoy0519: raises $0.10 to $0.20
davetass: calls $0.15
slgu1201: folds 
*** FLOP *** [6c 4d 9s]
davetass: bets $0.24
KingBoy0519: calls $0.24
*** TURN *** [6c 4d 9s] [6d]
davetass: bets $0.47
KingBoy0519: folds 
Uncalled bet ($0.47) returned to davetass
davetass collected $0.93 from pot
davetass: doesn't show hand 
*** SUMMARY ***
Total pot $0.98 | Rake $0.05 
Board [6c 4d 9s 6d]
Seat 1: slgu1201 (big blind) folded before Flop
Seat 2: DaGoodz33 folded before Flop (didn't bet)
Seat 3: rkk7777 folded before Flop (didn't bet)
Seat 4: PlayTheBlues4U folded before Flop (didn't bet)
Seat 5: KingBoy0519 (button) folded on the Turn
Seat 6: davetass (small blind) collected ($0.93)


*********** # 137 **************
PokerStars Hand #204114099814:  Hold'em No Limit ($0.05/$0.10 USD) - 2019/09/30 22:37:17 ET
Table 'Tabit' 6-max Seat #4 is the button
Seat 1: slgu1201 ($8.90 in chips) 
Seat 2: DaGoodz33 ($10.78 in chips) 
Seat 3: rkk7777 ($12.43 in chips) 
Seat 4: PlayTheBlues4U ($13.88 in chips) 
Seat 5: KingBoy0519 ($8.14 in chips) 
Seat 6: davetass ($16.60 in chips) 
KingBoy0519: posts small blind $0.05
davetass: posts big blind $0.10
*** HOLE CARDS ***
Dealt to PlayTheBlues4U [4s 8c]
slgu1201: raises $0.20 to $0.30
DaGoodz33: folds 
rkk7777: calls $0.30
PlayTheBlues4U: folds 
KingBoy0519: folds 
davetass: folds 
*** FLOP *** [6d Jd Jh]
slgu1201: checks 
rkk7777: checks 
*** TURN *** [6d Jd Jh] [2d]
slgu1201: bets $0.40
rkk7777: calls $0.40
*** RIVER *** [6d Jd Jh 2d] [9d]
slgu1201: checks 
rkk7777: bets $1.80
slgu1201: folds 
Uncalled bet ($1.80) returned to rkk7777
rkk7777 collected $1.47 from pot
*** SUMMARY ***
Total pot $1.55 | Rake $0.08 
Board [6d Jd Jh 2d 9d]
Seat 1: slgu1201 folded on the River
Seat 2: DaGoodz33 folded before Flop (didn't bet)
Seat 3: rkk7777 collected ($1.47)
Seat 4: PlayTheBlues4U (button) folded before Flop (didn't bet)
Seat 5: KingBoy0519 (small blind) folded before Flop
Seat 6: davetass (big blind) folded before Flop


*********** # 138 **************
PokerStars Hand #204114099681:  Hold'em No Limit ($0.05/$0.10 USD) - 2019/09/30 22:36:31 ET
Table 'Tabit' 6-max Seat #3 is the button
Seat 1: slgu1201 ($9 in chips) 
Seat 2: DaGoodz33 ($10.40 in chips) 
Seat 3: rkk7777 ($12.53 in chips) 
Seat 4: PlayTheBlues4U ($13.98 in chips) 
Seat 5: KingBoy0519 ($8.24 in chips) 
Seat 6: davetass ($16.60 in chips) 
PlayTheBlues4U: posts small blind $0.05
KingBoy0519: posts big blind $0.10
*** HOLE CARDS ***
Dealt to PlayTheBlues4U [4c 4s]
davetass: folds 
slgu1201: calls $0.10
DaGoodz33: calls $0.10
rkk7777: calls $0.10
PlayTheBlues4U: calls $0.05
KingBoy0519: checks 
*** FLOP *** [3h 2h 2d]
PlayTheBlues4U: checks 
KingBoy0519: checks 
slgu1201: checks 
DaGoodz33: checks 
rkk7777: checks 
*** TURN *** [3h 2h 2d] [Kd]
PlayTheBlues4U: checks 
KingBoy0519: checks 
slgu1201: checks 
DaGoodz33: bets $0.48
rkk7777: folds 
PlayTheBlues4U: folds 
KingBoy0519: folds 
slgu1201: folds 
Uncalled bet ($0.48) returned to DaGoodz33
DaGoodz33 collected $0.48 from pot
DaGoodz33: doesn't show hand 
*** SUMMARY ***
Total pot $0.50 | Rake $0.02 
Board [3h 2h 2d Kd]
Seat 1: slgu1201 folded on the Turn
Seat 2: DaGoodz33 collected ($0.48)
Seat 3: rkk7777 (button) folded on the Turn
Seat 4: PlayTheBlues4U (small blind) folded on the Turn
Seat 5: KingBoy0519 (big blind) folded on the Turn
Seat 6: davetass folded before Flop (didn't bet)


*********** # 139 **************
PokerStars Hand #204114099581:  Hold'em No Limit ($0.05/$0.10 USD) - 2019/09/30 22:35:55 ET
Table 'Tabit' 6-max Seat #2 is the button
Seat 1: slgu1201 ($9 in chips) 
Seat 2: DaGoodz33 ($10.40 in chips) 
Seat 3: rkk7777 ($11.99 in chips) 
Seat 4: PlayTheBlues4U ($14.58 in chips) 
Seat 5: KingBoy0519 ($8.24 in chips) 
Seat 6: davetass ($16.60 in chips) 
rkk7777: posts small blind $0.05
PlayTheBlues4U: posts big blind $0.10
*** HOLE CARDS ***
Dealt to PlayTheBlues4U [6d Ac]
KingBoy0519: folds 
davetass: folds 
slgu1201: folds 
DaGoodz33: folds 
rkk7777: calls $0.05
PlayTheBlues4U: raises $0.20 to $0.30
rkk7777: calls $0.20
*** FLOP *** [Kd Kc 4c]
rkk7777: checks 
PlayTheBlues4U: checks 
*** TURN *** [Kd Kc 4c] [Qc]
rkk7777: checks 
PlayTheBlues4U: bets $0.30
rkk7777: calls $0.30
*** RIVER *** [Kd Kc 4c Qc] [Jd]
rkk7777: checks 
PlayTheBlues4U: checks 
*** SHOW DOWN ***
rkk7777: shows [Qs 5d] (two pair, Kings and Queens)
PlayTheBlues4U: mucks hand 
rkk7777 collected $1.14 from pot
*** SUMMARY ***
Total pot $1.20 | Rake $0.06 
Board [Kd Kc 4c Qc Jd]
Seat 1: slgu1201 folded before Flop (didn't bet)
Seat 2: DaGoodz33 (button) folded before Flop (didn't bet)
Seat 3: rkk7777 (small blind) showed [Qs 5d] and won ($1.14) with two pair, Kings and Queens
Seat 4: PlayTheBlues4U (big blind) mucked [6d Ac]
Seat 5: KingBoy0519 folded before Flop (didn't bet)
Seat 6: davetass folded before Flop (didn't bet)


*********** # 140 **************
PokerStars Hand #204114099501:  Hold'em No Limit ($0.05/$0.10 USD) - 2019/09/30 22:35:27 ET
Table 'Tabit' 6-max Seat #1 is the button
Seat 1: slgu1201 ($8.59 in chips) 
Seat 2: DaGoodz33 ($10.45 in chips) 
Seat 3: rkk7777 ($12.09 in chips) 
Seat 4: PlayTheBlues4U ($14.58 in chips) 
Seat 5: KingBoy0519 ($8.54 in chips) 
Seat 6: davetass ($16.60 in chips) 
DaGoodz33: posts small blind $0.05
rkk7777: posts big blind $0.10
*** HOLE CARDS ***
Dealt to PlayTheBlues4U [7s 4h]
PlayTheBlues4U: folds 
KingBoy0519: calls $0.10
davetass: folds 
slgu1201: raises $0.20 to $0.30
DaGoodz33: folds 
rkk7777: folds 
KingBoy0519: calls $0.20
*** FLOP *** [8d Ah 8h]
KingBoy0519: checks 
slgu1201: bets $0.40
KingBoy0519: folds 
Uncalled bet ($0.40) returned to slgu1201
slgu1201 collected $0.71 from pot
slgu1201: doesn't show hand 
*** SUMMARY ***
Total pot $0.75 | Rake $0.04 
Board [8d Ah 8h]
Seat 1: slgu1201 (button) collected ($0.71)
Seat 2: DaGoodz33 (small blind) folded before Flop
Seat 3: rkk7777 (big blind) folded before Flop
Seat 4: PlayTheBlues4U folded before Flop (didn't bet)
Seat 5: KingBoy0519 folded on the Flop
Seat 6: davetass folded before Flop (didn't bet)


*********** # 141 **************
PokerStars Hand #204114099406:  Hold'em No Limit ($0.05/$0.10 USD) - 2019/09/30 22:34:54 ET
Table 'Tabit' 6-max Seat #6 is the button
Seat 1: slgu1201 ($8.64 in chips) 
Seat 2: DaGoodz33 ($10 in chips) 
Seat 3: rkk7777 ($12.29 in chips) 
Seat 4: PlayTheBlues4U ($14.58 in chips) 
Seat 5: KingBoy0519 ($8.54 in chips) 
Seat 6: davetass ($16.80 in chips) 
slgu1201: posts small blind $0.05
DaGoodz33: posts big blind $0.10
*** HOLE CARDS ***
Dealt to PlayTheBlues4U [Ts 7s]
rkk7777: raises $0.10 to $0.20
PlayTheBlues4U: folds 
KingBoy0519: folds 
davetass: calls $0.20
slgu1201: folds 
DaGoodz33: raises $1.80 to $2
rkk7777: folds 
davetass: folds 
Uncalled bet ($1.80) returned to DaGoodz33
DaGoodz33 collected $0.65 from pot
DaGoodz33: doesn't show hand 
*** SUMMARY ***
Total pot $0.65 | Rake $0 
Seat 1: slgu1201 (small blind) folded before Flop
Seat 2: DaGoodz33 (big blind) collected ($0.65)
Seat 3: rkk7777 folded before Flop
Seat 4: PlayTheBlues4U folded before Flop (didn't bet)
Seat 5: KingBoy0519 folded before Flop (didn't bet)
Seat 6: davetass (button) folded before Flop


*********** # 142 **************
PokerStars Hand #204114099318:  Hold'em No Limit ($0.05/$0.10 USD) - 2019/09/30 22:34:24 ET
Table 'Tabit' 6-max Seat #5 is the button
Seat 1: slgu1201 ($8.41 in chips) 
Seat 3: rkk7777 ($12.29 in chips) 
Seat 4: PlayTheBlues4U ($14.58 in chips) 
Seat 5: KingBoy0519 ($8.74 in chips) 
Seat 6: davetass ($16.85 in chips) 
davetass: posts small blind $0.05
slgu1201: posts big blind $0.10
*** HOLE CARDS ***
Dealt to PlayTheBlues4U [6d 3h]
rkk7777: folds 
DaGoodz33 joins the table at seat #2 
PlayTheBlues4U: folds 
KingBoy0519: calls $0.10
davetass: folds 
slgu1201: checks 
*** FLOP *** [9c 4d 7d]
slgu1201: bets $0.10
KingBoy0519: calls $0.10
*** TURN *** [9c 4d 7d] [6c]
slgu1201: checks 
KingBoy0519: checks 
*** RIVER *** [9c 4d 7d 6c] [Qs]
slgu1201: checks 
KingBoy0519: checks 
*** SHOW DOWN ***
slgu1201: shows [Th 9d] (a pair of Nines)
KingBoy0519: mucks hand 
slgu1201 collected $0.43 from pot
*** SUMMARY ***
Total pot $0.45 | Rake $0.02 
Board [9c 4d 7d 6c Qs]
Seat 1: slgu1201 (big blind) showed [Th 9d] and won ($0.43) with a pair of Nines
Seat 3: rkk7777 folded before Flop (didn't bet)
Seat 4: PlayTheBlues4U folded before Flop (didn't bet)
Seat 5: KingBoy0519 (button) mucked [Tc Jd]
Seat 6: davetass (small blind) folded before Flop


*********** # 143 **************
PokerStars Hand #204114099264:  Hold'em No Limit ($0.05/$0.10 USD) - 2019/09/30 22:34:05 ET
Table 'Tabit' 6-max Seat #4 is the button
Seat 1: slgu1201 ($8.05 in chips) 
Seat 3: rkk7777 ($12.29 in chips) 
Seat 4: PlayTheBlues4U ($14.58 in chips) 
Seat 5: KingBoy0519 ($9.04 in chips) 
Seat 6: davetass ($16.95 in chips) 
KingBoy0519: posts small blind $0.05
davetass: posts big blind $0.10
*** HOLE CARDS ***
Dealt to PlayTheBlues4U [3c Th]
slgu1201: raises $0.20 to $0.30
rkk7777: folds 
PlayTheBlues4U: folds 
KingBoy0519: calls $0.25
davetass: folds 
*** FLOP *** [8c 4c 5d]
KingBoy0519: checks 
slgu1201: bets $0.70
KingBoy0519: folds 
Uncalled bet ($0.70) returned to slgu1201
slgu1201 collected $0.66 from pot
slgu1201: doesn't show hand 
*** SUMMARY ***
Total pot $0.70 | Rake $0.04 
Board [8c 4c 5d]
Seat 1: slgu1201 collected ($0.66)
Seat 3: rkk7777 folded before Flop (didn't bet)
Seat 4: PlayTheBlues4U (button) folded before Flop (didn't bet)
Seat 5: KingBoy0519 (small blind) folded on the Flop
Seat 6: davetass (big blind) folded before Flop


*********** # 144 **************
PokerStars Hand #204114099148:  Hold'em No Limit ($0.05/$0.10 USD) - 2019/09/30 22:33:25 ET
Table 'Tabit' 6-max Seat #3 is the button
Seat 1: slgu1201 ($8.05 in chips) 
Seat 3: rkk7777 ($13.39 in chips) 
Seat 4: PlayTheBlues4U ($14.63 in chips) 
Seat 5: KingBoy0519 ($8 in chips) 
Seat 6: davetass ($16.95 in chips) 
PlayTheBlues4U: posts small blind $0.05
KingBoy0519: posts big blind $0.10
*** HOLE CARDS ***
Dealt to PlayTheBlues4U [Ts 6d]
davetass: folds 
slgu1201: folds 
rkk7777: raises $0.20 to $0.30
PlayTheBlues4U: folds 
KingBoy0519: calls $0.20
*** FLOP *** [Ac 4s 3h]
KingBoy0519: checks 
rkk7777: bets $0.10
KingBoy0519: calls $0.10
*** TURN *** [Ac 4s 3h] [6c]
KingBoy0519: checks 
rkk7777: bets $0.30
KingBoy0519: raises $0.40 to $0.70
rkk7777: calls $0.40
*** RIVER *** [Ac 4s 3h 6c] [8c]
KingBoy0519: checks 
rkk7777: checks 
*** SHOW DOWN ***
KingBoy0519: shows [4d 4c] (three of a kind, Fours)
rkk7777: mucks hand 
KingBoy0519 collected $2.14 from pot
*** SUMMARY ***
Total pot $2.25 | Rake $0.11 
Board [Ac 4s 3h 6c 8c]
Seat 1: slgu1201 folded before Flop (didn't bet)
Seat 3: rkk7777 (button) mucked [Ah Kd]
Seat 4: PlayTheBlues4U (small blind) folded before Flop
Seat 5: KingBoy0519 (big blind) showed [4d 4c] and won ($2.14) with three of a kind, Fours
Seat 6: davetass folded before Flop (didn't bet)


*********** # 145 **************
PokerStars Hand #204114098958:  Hold'em No Limit ($0.05/$0.10 USD) - 2019/09/30 22:32:22 ET
Table 'Tabit' 6-max Seat #2 is the button
Seat 1: slgu1201 ($8.85 in chips) 
Seat 2: jerry71345 ($7.18 in chips) 
Seat 3: rkk7777 ($13.69 in chips) 
Seat 4: PlayTheBlues4U ($14.73 in chips) 
Seat 5: KingBoy0519 ($6.90 in chips) 
Seat 6: davetass ($16.95 in chips) 
rkk7777: posts small blind $0.05
PlayTheBlues4U: posts big blind $0.10
*** HOLE CARDS ***
Dealt to PlayTheBlues4U [4c 7c]
KingBoy0519: calls $0.10
davetass: folds 
slgu1201: calls $0.10
jerry71345: folds 
rkk7777: calls $0.05
PlayTheBlues4U: checks 
*** FLOP *** [3s 8h Ac]
rkk7777: checks 
PlayTheBlues4U: checks 
KingBoy0519: checks 
jerry71345 leaves the table
slgu1201: bets $0.20
rkk7777: calls $0.20
PlayTheBlues4U: folds 
KingBoy0519: calls $0.20
*** TURN *** [3s 8h Ac] [Qc]
rkk7777: checks 
KingBoy0519: checks 
slgu1201: bets $0.50
rkk7777: folds 
KingBoy0519: raises $1.10 to $1.60
slgu1201: folds 
Uncalled bet ($1.10) returned to KingBoy0519
KingBoy0519 collected $1.90 from pot
KingBoy0519: doesn't show hand 
*** SUMMARY ***
Total pot $2 | Rake $0.10 
Board [3s 8h Ac Qc]
Seat 1: slgu1201 folded on the Turn
Seat 2: jerry71345 (button) folded before Flop (didn't bet)
Seat 3: rkk7777 (small blind) folded on the Turn
Seat 4: PlayTheBlues4U (big blind) folded on the Flop
Seat 5: KingBoy0519 collected ($1.90)
Seat 6: davetass folded before Flop (didn't bet)


*********** # 146 **************
PokerStars Hand #204114098822:  Hold'em No Limit ($0.05/$0.10 USD) - 2019/09/30 22:31:34 ET
Table 'Tabit' 6-max Seat #1 is the button
Seat 1: slgu1201 ($7.75 in chips) 
Seat 2: jerry71345 ($7.48 in chips) 
Seat 3: rkk7777 ($13.79 in chips) 
Seat 4: PlayTheBlues4U ($15.53 in chips) 
Seat 5: KingBoy0519 ($6.90 in chips) 
Seat 6: davetass ($16.95 in chips) 
jerry71345: posts small blind $0.05
rkk7777: posts big blind $0.10
*** HOLE CARDS ***
Dealt to PlayTheBlues4U [Jd As]
PlayTheBlues4U: raises $0.20 to $0.30
KingBoy0519: folds 
davetass: folds 
slgu1201: calls $0.30
jerry71345: calls $0.25
rkk7777: folds 
*** FLOP *** [3s 6h 5c]
jerry71345: checks 
PlayTheBlues4U: bets $0.50
slgu1201: calls $0.50
jerry71345: folds 
*** TURN *** [3s 6h 5c] [7c]
PlayTheBlues4U: checks 
slgu1201: bets $0.90
PlayTheBlues4U: folds 
Uncalled bet ($0.90) returned to slgu1201
slgu1201 collected $1.90 from pot
slgu1201: doesn't show hand 
*** SUMMARY ***
Total pot $2 | Rake $0.10 
Board [3s 6h 5c 7c]
Seat 1: slgu1201 (button) collected ($1.90)
Seat 2: jerry71345 (small blind) folded on the Flop
Seat 3: rkk7777 (big blind) folded before Flop
Seat 4: PlayTheBlues4U folded on the Turn
Seat 5: KingBoy0519 folded before Flop (didn't bet)
Seat 6: davetass folded before Flop (didn't bet)


*********** # 147 **************
PokerStars Hand #204114098714:  Hold'em No Limit ($0.05/$0.10 USD) - 2019/09/30 22:30:59 ET
Table 'Tabit' 6-max Seat #6 is the button
Seat 1: slgu1201 ($7.80 in chips) 
Seat 2: jerry71345 ($7.58 in chips) 
Seat 3: rkk7777 ($13.11 in chips) 
Seat 4: PlayTheBlues4U ($15.53 in chips) 
Seat 5: KingBoy0519 ($7.50 in chips) 
Seat 6: davetass ($16.95 in chips) 
slgu1201: posts small blind $0.05
jerry71345: posts big blind $0.10
*** HOLE CARDS ***
Dealt to PlayTheBlues4U [8h Jd]
rkk7777: raises $0.20 to $0.30
PlayTheBlues4U: folds 
KingBoy0519: calls $0.30
davetass: folds 
slgu1201: folds 
jerry71345: folds 
*** FLOP *** [9s 3d Qc]
rkk7777: bets $0.20
KingBoy0519: calls $0.20
*** TURN *** [9s 3d Qc] [5d]
rkk7777: bets $0.10
KingBoy0519: calls $0.10
*** RIVER *** [9s 3d Qc 5d] [9d]
rkk7777: checks 
KingBoy0519: checks 
*** SHOW DOWN ***
rkk7777: shows [7s As] (a pair of Nines)
KingBoy0519: mucks hand 
rkk7777 collected $1.28 from pot
*** SUMMARY ***
Total pot $1.35 | Rake $0.07 
Board [9s 3d Qc 5d 9d]
Seat 1: slgu1201 (small blind) folded before Flop
Seat 2: jerry71345 (big blind) folded before Flop
Seat 3: rkk7777 showed [7s As] and won ($1.28) with a pair of Nines
Seat 4: PlayTheBlues4U folded before Flop (didn't bet)
Seat 5: KingBoy0519 mucked [2c Ac]
Seat 6: davetass (button) folded before Flop (didn't bet)


*********** # 148 **************
PokerStars Hand #204114098602:  Hold'em No Limit ($0.05/$0.10 USD) - 2019/09/30 22:30:21 ET
Table 'Tabit' 6-max Seat #5 is the button
Seat 1: slgu1201 ($8 in chips) 
Seat 2: jerry71345 ($5.66 in chips) 
Seat 3: rkk7777 ($13.31 in chips) 
Seat 4: PlayTheBlues4U ($15.53 in chips) 
Seat 5: KingBoy0519 ($7.50 in chips) 
Seat 6: davetass ($18.66 in chips) 
davetass: posts small blind $0.05
slgu1201: posts big blind $0.10
*** HOLE CARDS ***
Dealt to PlayTheBlues4U [2d As]
jerry71345: calls $0.10
rkk7777: calls $0.10
PlayTheBlues4U: folds 
KingBoy0519: folds 
davetass: calls $0.05
slgu1201: checks 
*** FLOP *** [3s Qh 7h]
davetass: checks 
slgu1201: checks 
jerry71345: bets $0.10
rkk7777: calls $0.10
davetass: calls $0.10
slgu1201: calls $0.10
*** TURN *** [3s Qh 7h] [Jd]
davetass: checks 
slgu1201: checks 
jerry71345: bets $0.10
rkk7777: folds 
davetass: raises $0.48 to $0.58
slgu1201: folds 
jerry71345: calls $0.48
*** RIVER *** [3s Qh 7h Jd] [Ac]
davetass: bets $0.93
jerry71345: calls $0.93
*** SHOW DOWN ***
davetass: shows [7d Td] (a pair of Sevens)
jerry71345: shows [Ts Qs] (a pair of Queens)
jerry71345 collected $3.63 from pot
*** SUMMARY ***
Total pot $3.82 | Rake $0.19 
Board [3s Qh 7h Jd Ac]
Seat 1: slgu1201 (big blind) folded on the Turn
Seat 2: jerry71345 showed [Ts Qs] and won ($3.63) with a pair of Queens
Seat 3: rkk7777 folded on the Turn
Seat 4: PlayTheBlues4U folded before Flop (didn't bet)
Seat 5: KingBoy0519 (button) folded before Flop (didn't bet)
Seat 6: davetass (small blind) showed [7d Td] and lost with a pair of Sevens


*********** # 149 **************
PokerStars Hand #204114098531:  Hold'em No Limit ($0.05/$0.10 USD) - 2019/09/30 22:29:58 ET
Table 'Tabit' 6-max Seat #4 is the button
Seat 2: jerry71345 ($5.66 in chips) 
Seat 3: rkk7777 ($13.31 in chips) 
Seat 4: PlayTheBlues4U ($15.53 in chips) 
Seat 5: KingBoy0519 ($7.41 in chips) 
Seat 6: davetass ($18.76 in chips) 
KingBoy0519: posts small blind $0.05
davetass: posts big blind $0.10
slgu1201: sits out 
*** HOLE CARDS ***
Dealt to PlayTheBlues4U [Kd 5c]
davetass said, "yea"
jerry71345: folds 
rkk7777: folds 
davetass said, "must be"
PlayTheBlues4U: folds 
KingBoy0519: calls $0.05
davetass: checks 
*** FLOP *** [4h 2h Ac]
KingBoy0519: bets $0.30
davetass: folds 
Uncalled bet ($0.30) returned to KingBoy0519
KingBoy0519 collected $0.19 from pot
KingBoy0519: doesn't show hand 
*** SUMMARY ***
Total pot $0.20 | Rake $0.01 
Board [4h 2h Ac]
Seat 2: jerry71345 folded before Flop (didn't bet)
Seat 3: rkk7777 folded before Flop (didn't bet)
Seat 4: PlayTheBlues4U (button) folded before Flop (didn't bet)
Seat 5: KingBoy0519 (small blind) collected ($0.19)
Seat 6: davetass (big blind) folded on the Flop


*********** # 150 **************
PokerStars Hand #204114098345:  Hold'em No Limit ($0.05/$0.10 USD) - 2019/09/30 22:28:56 ET
Table 'Tabit' 6-max Seat #3 is the button
Seat 2: jerry71345 ($5.24 in chips) 
Seat 3: rkk7777 ($13.51 in chips) 
Seat 4: PlayTheBlues4U ($15.58 in chips) 
Seat 5: KingBoy0519 ($7.61 in chips) 
Seat 6: davetass ($18.76 in chips) 
PlayTheBlues4U: posts small blind $0.05
KingBoy0519: posts big blind $0.10
*** HOLE CARDS ***
Dealt to PlayTheBlues4U [4h 7h]
davetass: folds 
jerry71345: calls $0.10
rkk7777: calls $0.10
PlayTheBlues4U: folds 
davetass said, "well played"
KingBoy0519: checks 
*** FLOP *** [6c 9c As]
KingBoy0519: checks 
PlayTheBlues4U said, "hmm"
PlayTheBlues4U said, "4.5%"
jerry71345: checks 
rkk7777: bets $0.10
davetass said, "if that"
KingBoy0519: calls $0.10
jerry71345: calls $0.10
*** TURN *** [6c 9c As] [4c]
davetass said, "well played"
slgu1201 joins the table at seat #1 
KingBoy0519: checks 
jerry71345: checks 
rkk7777: checks 
*** RIVER *** [6c 9c As 4c] [Jc]
PlayTheBlues4U said, "outskilled"
KingBoy0519: checks 
jerry71345: checks 
rkk7777: checks 
*** SHOW DOWN ***
KingBoy0519: shows [Kd 9d] (a pair of Nines)
jerry71345: shows [Js 8s] (a pair of Jacks)
rkk7777: mucks hand 
jerry71345 collected $0.62 from pot
*** SUMMARY ***
Total pot $0.65 | Rake $0.03 
Board [6c 9c As 4c Jc]
Seat 2: jerry71345 showed [Js 8s] and won ($0.62) with a pair of Jacks
Seat 3: rkk7777 (button) mucked [7d 6d]
Seat 4: PlayTheBlues4U (small blind) folded before Flop
Seat 5: KingBoy0519 (big blind) showed [Kd 9d] and lost with a pair of Nines
Seat 6: davetass folded before Flop (didn't bet)


*********** # 151 **************
PokerStars Hand #204114098156:  Hold'em No Limit ($0.05/$0.10 USD) - 2019/09/30 22:27:48 ET
Table 'Tabit' 6-max Seat #2 is the button
Seat 2: jerry71345 ($5.24 in chips) 
Seat 3: rkk7777 ($13.81 in chips) 
Seat 4: PlayTheBlues4U ($8.05 in chips) 
Seat 5: KingBoy0519 ($7.61 in chips) 
Seat 6: davetass ($26.81 in chips) 
rkk7777: posts small blind $0.05
PlayTheBlues4U: posts big blind $0.10
*** HOLE CARDS ***
Dealt to PlayTheBlues4U [Jd Js]
KingBoy0519: folds 
davetass: raises $0.20 to $0.30
jerry71345: folds 
rkk7777: calls $0.25
PlayTheBlues4U: raises $0.50 to $0.80
davetass: raises $1.90 to $2.70
rkk7777: folds 
PlayTheBlues4U: raises $2.10 to $4.80
davetass: raises $22.01 to $26.81 and is all-in
PlayTheBlues4U: calls $3.25 and is all-in
Uncalled bet ($18.76) returned to davetass
*** FLOP *** [2d 5h Ad]
*** TURN *** [2d 5h Ad] [9d]
*** RIVER *** [2d 5h Ad 9d] [Qd]
*** SHOW DOWN ***
PlayTheBlues4U: shows [Jd Js] (a flush, Ace high)
davetass: shows [As Ah] (three of a kind, Aces)
PlayTheBlues4U collected $15.58 from pot
*** SUMMARY ***
Total pot $16.40 | Rake $0.82 
Board [2d 5h Ad 9d Qd]
Seat 2: jerry71345 (button) folded before Flop (didn't bet)
Seat 3: rkk7777 (small blind) folded before Flop
Seat 4: PlayTheBlues4U (big blind) showed [Jd Js] and won ($15.58) with a flush, Ace high
Seat 5: KingBoy0519 folded before Flop (didn't bet)
Seat 6: davetass showed [As Ah] and lost with three of a kind, Aces


*********** # 152 **************
PokerStars Hand #204114098029:  Hold'em No Limit ($0.05/$0.10 USD) - 2019/09/30 22:27:02 ET
Table 'Tabit' 6-max Seat #6 is the button
Seat 1: axex6 ($8.36 in chips) 
Seat 2: jerry71345 ($5.74 in chips) 
Seat 3: rkk7777 ($13.81 in chips) 
Seat 4: PlayTheBlues4U ($8.05 in chips) 
Seat 5: KingBoy0519 ($8.01 in chips) 
Seat 6: davetass ($26.81 in chips) 
axex6: posts small blind $0.05
jerry71345: posts big blind $0.10
*** HOLE CARDS ***
Dealt to PlayTheBlues4U [Th 5h]
rkk7777: folds 
PlayTheBlues4U: folds 
KingBoy0519: calls $0.10
davetass: folds 
axex6: calls $0.05
jerry71345: checks 
*** FLOP *** [Qs Td 4s]
axex6: checks 
jerry71345: bets $0.10
KingBoy0519: calls $0.10
axex6: calls $0.10
*** TURN *** [Qs Td 4s] [7c]
axex6: checks 
jerry71345: bets $0.10
KingBoy0519: calls $0.10
axex6: raises $0.10 to $0.20
jerry71345: calls $0.10
KingBoy0519: calls $0.10
*** RIVER *** [Qs Td 4s 7c] [2s]
axex6: bets $0.10
jerry71345: calls $0.10
KingBoy0519: folds 
*** SHOW DOWN ***
axex6: shows [4c Qc] (two pair, Queens and Fours)
jerry71345: mucks hand 
axex6 collected $1.33 from pot
*** SUMMARY ***
Total pot $1.40 | Rake $0.07 
Board [Qs Td 4s 7c 2s]
Seat 1: axex6 (small blind) showed [4c Qc] and won ($1.33) with two pair, Queens and Fours
Seat 2: jerry71345 (big blind) mucked [Qd 6h]
Seat 3: rkk7777 folded before Flop (didn't bet)
Seat 4: PlayTheBlues4U folded before Flop (didn't bet)
Seat 5: KingBoy0519 folded on the River
Seat 6: davetass (button) folded before Flop (didn't bet)


*********** # 153 **************
PokerStars Hand #204114097758:  Hold'em No Limit ($0.05/$0.10 USD) - 2019/09/30 22:25:29 ET
Table 'Tabit' 6-max Seat #5 is the button
Seat 1: axex6 ($7.68 in chips) 
Seat 2: jerry71345 ($5.74 in chips) 
Seat 3: rkk7777 ($14.51 in chips) 
Seat 4: PlayTheBlues4U ($8.05 in chips) 
Seat 5: KingBoy0519 ($8.01 in chips) 
Seat 6: davetass ($26.86 in chips) 
davetass: posts small blind $0.05
axex6: posts big blind $0.10
*** HOLE CARDS ***
Dealt to PlayTheBlues4U [3d Ts]
jerry71345: folds 
rkk7777: raises $0.20 to $0.30
KingBoy0519 said, "bad bluff"
PlayTheBlues4U: folds 
KingBoy0519: folds 
davetass: folds 
davetass said, "i guess"
PlayTheBlues4U said, "what ever makes you happy"
davetass said, "no no different hand"
axex6: calls $0.20
*** FLOP *** [6s 6d 7s]
axex6: bets $0.10
rkk7777: raises $0.20 to $0.30
axex6: calls $0.20
*** TURN *** [6s 6d 7s] [Jd]
axex6: checks 
rkk7777: checks 
*** RIVER *** [6s 6d 7s Jd] [5s]
axex6: bets $0.10
rkk7777: calls $0.10
*** SHOW DOWN ***
axex6: shows [Tc 7c] (two pair, Sevens and Sixes)
rkk7777: mucks hand 
axex6 collected $1.38 from pot
*** SUMMARY ***
Total pot $1.45 | Rake $0.07 
Board [6s 6d 7s Jd 5s]
Seat 1: axex6 (big blind) showed [Tc 7c] and won ($1.38) with two pair, Sevens and Sixes
Seat 2: jerry71345 folded before Flop (didn't bet)
Seat 3: rkk7777 mucked [4c 4d]
Seat 4: PlayTheBlues4U folded before Flop (didn't bet)
Seat 5: KingBoy0519 (button) folded before Flop (didn't bet)
Seat 6: davetass (small blind) folded before Flop


*********** # 154 **************
PokerStars Hand #204114097601:  Hold'em No Limit ($0.05/$0.10 USD) - 2019/09/30 22:24:42 ET
Table 'Tabit' 6-max Seat #4 is the button
Seat 1: axex6 ($7.68 in chips) 
Seat 2: jerry71345 ($5.74 in chips) 
Seat 3: rkk7777 ($14.61 in chips) 
Seat 4: PlayTheBlues4U ($9.85 in chips) 
Seat 5: KingBoy0519 ($6.20 in chips) 
Seat 6: davetass ($26.96 in chips) 
KingBoy0519: posts small blind $0.05
davetass: posts big blind $0.10
*** HOLE CARDS ***
Dealt to PlayTheBlues4U [Kh 7c]
axex6: folds 
jerry71345: folds 
rkk7777: calls $0.10
PlayTheBlues4U: raises $0.20 to $0.30
KingBoy0519: calls $0.25
davetass: folds 
rkk7777: folds 
*** FLOP *** [2d Jh Tc]
KingBoy0519: checks 
PlayTheBlues4U: bets $0.40
KingBoy0519: calls $0.40
*** TURN *** [2d Jh Tc] [3c]
KingBoy0519: checks 
PlayTheBlues4U: checks 
*** RIVER *** [2d Jh Tc 3c] [Ah]
KingBoy0519: checks 
PlayTheBlues4U: bets $1.10
KingBoy0519: calls $1.10
*** SHOW DOWN ***
PlayTheBlues4U: shows [Kh 7c] (high card Ace)
KingBoy0519: shows [Qh Ac] (a pair of Aces)
KingBoy0519 collected $3.61 from pot
*** SUMMARY ***
Total pot $3.80 | Rake $0.19 
Board [2d Jh Tc 3c Ah]
Seat 1: axex6 folded before Flop (didn't bet)
Seat 2: jerry71345 folded before Flop (didn't bet)
Seat 3: rkk7777 folded before Flop
Seat 4: PlayTheBlues4U (button) showed [Kh 7c] and lost with high card Ace
Seat 5: KingBoy0519 (small blind) showed [Qh Ac] and won ($3.61) with a pair of Aces
Seat 6: davetass (big blind) folded before Flop


*********** # 155 **************
PokerStars Hand #204114097467:  Hold'em No Limit ($0.05/$0.10 USD) - 2019/09/30 22:24:02 ET
Table 'Tabit' 6-max Seat #3 is the button
Seat 1: axex6 ($7.68 in chips) 
Seat 2: jerry71345 ($5.84 in chips) 
Seat 3: rkk7777 ($14.81 in chips) 
Seat 4: PlayTheBlues4U ($9.90 in chips) 
Seat 5: KingBoy0519 ($5.88 in chips) 
Seat 6: davetass ($26.96 in chips) 
PlayTheBlues4U: posts small blind $0.05
KingBoy0519: posts big blind $0.10
*** HOLE CARDS ***
Dealt to PlayTheBlues4U [4h Qd]
davetass: folds 
axex6: folds 
jerry71345: calls $0.10
rkk7777: calls $0.10
PlayTheBlues4U: folds 
KingBoy0519: checks 
*** FLOP *** [7s Jc 8c]
KingBoy0519: checks 
jerry71345: checks 
rkk7777: bets $0.10
KingBoy0519: calls $0.10
jerry71345: folds 
*** TURN *** [7s Jc 8c] [6c]
KingBoy0519: checks 
rkk7777: checks 
*** RIVER *** [7s Jc 8c 6c] [3s]
KingBoy0519: checks 
rkk7777: checks 
*** SHOW DOWN ***
KingBoy0519: shows [5h 8s] (a pair of Eights)
rkk7777: mucks hand 
KingBoy0519 collected $0.52 from pot
*** SUMMARY ***
Total pot $0.55 | Rake $0.03 
Board [7s Jc 8c 6c 3s]
Seat 1: axex6 folded before Flop (didn't bet)
Seat 2: jerry71345 folded on the Flop
Seat 3: rkk7777 (button) mucked [7h 2d]
Seat 4: PlayTheBlues4U (small blind) folded before Flop
Seat 5: KingBoy0519 (big blind) showed [5h 8s] and won ($0.52) with a pair of Eights
Seat 6: davetass folded before Flop (didn't bet)


*********** # 156 **************
PokerStars Hand #204114097314:  Hold'em No Limit ($0.05/$0.10 USD) - 2019/09/30 22:23:16 ET
Table 'Tabit' 6-max Seat #2 is the button
Seat 1: axex6 ($3.94 in chips) 
Seat 2: jerry71345 ($9.78 in chips) 
Seat 3: rkk7777 ($14.91 in chips) 
Seat 4: PlayTheBlues4U ($10 in chips) 
Seat 5: KingBoy0519 ($5.88 in chips) 
Seat 6: davetass ($26.96 in chips) 
rkk7777: posts small blind $0.05
PlayTheBlues4U: posts big blind $0.10
*** HOLE CARDS ***
Dealt to PlayTheBlues4U [2d 7d]
KingBoy0519: folds 
davetass: folds 
axex6: calls $0.10
jerry71345: calls $0.10
rkk7777: calls $0.05
PlayTheBlues4U: checks 
*** FLOP *** [9h Ad 9s]
rkk7777: checks 
PlayTheBlues4U: checks 
axex6: bets $0.10
jerry71345: raises $0.10 to $0.20
rkk7777: folds 
PlayTheBlues4U: folds 
axex6: calls $0.10
*** TURN *** [9h Ad 9s] [4c]
axex6: checks 
jerry71345: bets $0.20
axex6: raises $1.16 to $1.36
jerry71345: calls $1.16
*** RIVER *** [9h Ad 9s 4c] [4d]
axex6: bets $2.28 and is all-in
jerry71345: calls $2.28
*** SHOW DOWN ***
axex6: shows [9c Kh] (a full house, Nines full of Fours)
jerry71345: shows [6d 6h] (two pair, Nines and Sixes)
axex6 collected $7.68 from pot
*** SUMMARY ***
Total pot $8.08 | Rake $0.40 
Board [9h Ad 9s 4c 4d]
Seat 1: axex6 showed [9c Kh] and won ($7.68) with a full house, Nines full of Fours
Seat 2: jerry71345 (button) showed [6d 6h] and lost with two pair, Nines and Sixes
Seat 3: rkk7777 (small blind) folded on the Flop
Seat 4: PlayTheBlues4U (big blind) folded on the Flop
Seat 5: KingBoy0519 folded before Flop (didn't bet)
Seat 6: davetass folded before Flop (didn't bet)


*********** # 157 **************
PokerStars Hand #204079943179: Tournament #2091309004, Freeroll  Hold'em No Limit - Level VII (50/100) - 2019/09/29 18:39:13 ET
Table '2091309004 9' 9-max Seat #5 is the button
Seat 1: goldenchild0225 (730 in chips) is sitting out
Seat 2: CaptACFD (435 in chips) is sitting out
Seat 4: dmastran (3015 in chips) is sitting out
Seat 5: mikew035 (8340 in chips) 
Seat 7: PlayTheBlues4U (55 in chips) is sitting out
Seat 8: Alepoliti (41620 in chips) 
Seat 9: harrismj7 (5 in chips) is sitting out
goldenchild0225: posts the ante 10
CaptACFD: posts the ante 10
dmastran: posts the ante 10
mikew035: posts the ante 10
PlayTheBlues4U: posts the ante 10
Alepoliti: posts the ante 10
harrismj7: posts the ante 5 and is all-in
PlayTheBlues4U: posts small blind 45 and is all-in
Alepoliti: posts big blind 100
*** HOLE CARDS ***
Dealt to PlayTheBlues4U [5c Kh]
harrismj7: folds 
goldenchild0225: folds 
CaptACFD: folds 
dmastran: folds 
mikew035: calls 100
PlayTheBlues4U: folds 
Alepoliti: checks 
*** FLOP *** [3c 8h Ac]
Alepoliti: checks 
mikew035: checks 
*** TURN *** [3c 8h Ac] [7d]
Alepoliti: bets 200
mikew035: folds 
Uncalled bet (200) returned to Alepoliti
Alepoliti collected 310 from pot
PlayTheBlues4U finished the tournament in 73rd place
harrismj7 finished the tournament in 74th place
Alepoliti: doesn't show hand 
*** SUMMARY ***
Total pot 310 | Rake 0 
Board [3c 8h Ac 7d]
Seat 1: goldenchild0225 folded before Flop (didn't bet)
Seat 2: CaptACFD folded before Flop (didn't bet)
Seat 4: dmastran folded before Flop (didn't bet)
Seat 5: mikew035 (button) folded on the Turn
Seat 7: PlayTheBlues4U (small blind) folded before Flop
Seat 8: Alepoliti (big blind) collected (310)
Seat 9: harrismj7 folded before Flop (didn't bet)


*********** # 158 **************
PokerStars Hand #204079943136: Tournament #2091309004, Freeroll  Hold'em No Limit - Level VII (50/100) - 2019/09/29 18:39:00 ET
Table '2091309004 9' 9-max Seat #2 is the button
Seat 1: goldenchild0225 (740 in chips) is sitting out
Seat 2: CaptACFD (445 in chips) is sitting out
Seat 3: rtr536 (50 in chips) is sitting out
Seat 4: Bsangi (30 in chips) is sitting out
Seat 5: mikew035 (8110 in chips) 
Seat 7: PlayTheBlues4U (65 in chips) is sitting out
Seat 8: Alepoliti (41730 in chips) 
Seat 9: harrismj7 (15 in chips) is sitting out
goldenchild0225: posts the ante 10
CaptACFD: posts the ante 10
rtr536: posts the ante 10
Bsangi: posts the ante 10
mikew035: posts the ante 10
PlayTheBlues4U: posts the ante 10
Alepoliti: posts the ante 10
harrismj7: posts the ante 10
rtr536: posts small blind 40 and is all-in
Bsangi: posts big blind 20 and is all-in
*** HOLE CARDS ***
Dealt to PlayTheBlues4U [2s Qh]
mikew035: calls 100
PlayTheBlues4U: folds 
Alepoliti: calls 100
harrismj7: folds 
goldenchild0225: folds 
CaptACFD: folds 
rtr536: folds 
Bsangi: folds 
*** FLOP *** [As Th 6h]
mikew035: bets 100
Alepoliti: folds 
Uncalled bet (100) returned to mikew035
mikew035 collected 340 from pot
rtr536 finished the tournament in 75th place
Bsangi finished the tournament in 76th place
mikew035: doesn't show hand 
*** SUMMARY ***
Total pot 340 | Rake 0 
Board [As Th 6h]
Seat 1: goldenchild0225 folded before Flop (didn't bet)
Seat 2: CaptACFD (button) folded before Flop (didn't bet)
Seat 3: rtr536 (small blind) folded before Flop
Seat 4: Bsangi (big blind) folded before Flop
Seat 5: mikew035 collected (340)
Seat 7: PlayTheBlues4U folded before Flop (didn't bet)
Seat 8: Alepoliti folded on the Flop
Seat 9: harrismj7 folded before Flop (didn't bet)


*********** # 159 **************
PokerStars Hand #204079943104: Tournament #2091309004, Freeroll  Hold'em No Limit - Level VII (50/100) - 2019/09/29 18:38:51 ET
Table '2091309004 9' 9-max Seat #9 is the button
Seat 1: edgarcrespo973 (15 in chips) is sitting out
Seat 2: CaptACFD (555 in chips) is sitting out
Seat 3: rtr536 (60 in chips) is sitting out
Seat 4: Bsangi (40 in chips) is sitting out
Seat 5: mikew035 (7935 in chips) 
Seat 7: PlayTheBlues4U (75 in chips) is sitting out
Seat 8: Alepoliti (41740 in chips) 
Seat 9: harrismj7 (25 in chips) is sitting out
edgarcrespo973: posts the ante 10
CaptACFD: posts the ante 10
rtr536: posts the ante 10
Bsangi: posts the ante 10
mikew035: posts the ante 10
PlayTheBlues4U: posts the ante 10
Alepoliti: posts the ante 10
harrismj7: posts the ante 10
edgarcrespo973: posts small blind 5 and is all-in
CaptACFD: posts big blind 100
*** HOLE CARDS ***
Dealt to PlayTheBlues4U [9d Kc]
rtr536: folds 
Bsangi: folds 
mikew035: raises 100 to 200
PlayTheBlues4U: folds 
Alepoliti: folds 
harrismj7: folds 
CaptACFD: folds 
edgarcrespo973: folds 
Uncalled bet (100) returned to mikew035
mikew035 collected 285 from pot
edgarcrespo973 finished the tournament in 78th place
mikew035: doesn't show hand 
*** SUMMARY ***
Total pot 285 | Rake 0 
Seat 1: edgarcrespo973 (small blind) folded before Flop
Seat 2: CaptACFD (big blind) folded before Flop
Seat 3: rtr536 folded before Flop (didn't bet)
Seat 4: Bsangi folded before Flop (didn't bet)
Seat 5: mikew035 collected (285)
Seat 7: PlayTheBlues4U folded before Flop (didn't bet)
Seat 8: Alepoliti folded before Flop (didn't bet)
Seat 9: harrismj7 (button) folded before Flop (didn't bet)


*********** # 160 **************
PokerStars Hand #204079829987: Tournament #2091309004, Freeroll  Hold'em No Limit - Level VII (50/100) - 2019/09/29 18:38:45 ET
Table '2091309004 9' 9-max Seat #8 is the button
Seat 1: edgarcrespo973 (125 in chips) is sitting out
Seat 2: CaptACFD (565 in chips) is sitting out
Seat 3: rtr536 (70 in chips) is sitting out
Seat 4: Bsangi (50 in chips) is sitting out
Seat 5: mikew035 (7715 in chips) 
Seat 7: PlayTheBlues4U (85 in chips) is sitting out
Seat 8: Alepoliti (41750 in chips) 
Seat 9: harrismj7 (85 in chips) is sitting out
edgarcrespo973: posts the ante 10
CaptACFD: posts the ante 10
rtr536: posts the ante 10
Bsangi: posts the ante 10
mikew035: posts the ante 10
PlayTheBlues4U: posts the ante 10
Alepoliti: posts the ante 10
harrismj7: posts the ante 10
harrismj7: posts small blind 50
edgarcrespo973: posts big blind 100
*** HOLE CARDS ***
Dealt to PlayTheBlues4U [4s Kh]
CaptACFD: folds 
rtr536: folds 
Bsangi: folds 
mikew035: raises 100 to 200
PlayTheBlues4U: folds 
Alepoliti: folds 
harrismj7: folds 
edgarcrespo973: folds 
Uncalled bet (100) returned to mikew035
mikew035 collected 330 from pot
mikew035: doesn't show hand 
*** SUMMARY ***
Total pot 330 | Rake 0 
Seat 1: edgarcrespo973 (big blind) folded before Flop
Seat 2: CaptACFD folded before Flop (didn't bet)
Seat 3: rtr536 folded before Flop (didn't bet)
Seat 4: Bsangi folded before Flop (didn't bet)
Seat 5: mikew035 collected (330)
Seat 7: PlayTheBlues4U folded before Flop (didn't bet)
Seat 8: Alepoliti (button) folded before Flop (didn't bet)
Seat 9: harrismj7 (small blind) folded before Flop


*********** # 161 **************
PokerStars Hand #204079829960: Tournament #2091309004, Freeroll  Hold'em No Limit - Level VII (50/100) - 2019/09/29 18:38:39 ET
Table '2091309004 9' 9-max Seat #7 is the button
Seat 1: edgarcrespo973 (135 in chips) is sitting out
Seat 2: CaptACFD (575 in chips) is sitting out
Seat 3: rtr536 (80 in chips) is sitting out
Seat 4: Bsangi (60 in chips) is sitting out
Seat 5: mikew035 (7725 in chips) 
Seat 7: PlayTheBlues4U (95 in chips) is sitting out
Seat 8: Alepoliti (41580 in chips) 
Seat 9: harrismj7 (195 in chips) is sitting out
edgarcrespo973: posts the ante 10
CaptACFD: posts the ante 10
rtr536: posts the ante 10
Bsangi: posts the ante 10
mikew035: posts the ante 10
PlayTheBlues4U: posts the ante 10
Alepoliti: posts the ante 10
harrismj7: posts the ante 10
Alepoliti: posts small blind 50
harrismj7: posts big blind 100
*** HOLE CARDS ***
Dealt to PlayTheBlues4U [As 2d]
edgarcrespo973: folds 
CaptACFD: folds 
rtr536: folds 
Bsangi: folds 
mikew035: folds 
PlayTheBlues4U: folds 
Alepoliti: raises 100 to 200
harrismj7: folds 
Uncalled bet (100) returned to Alepoliti
Alepoliti collected 280 from pot
Alepoliti: doesn't show hand 
*** SUMMARY ***
Total pot 280 | Rake 0 
Seat 1: edgarcrespo973 folded before Flop (didn't bet)
Seat 2: CaptACFD folded before Flop (didn't bet)
Seat 3: rtr536 folded before Flop (didn't bet)
Seat 4: Bsangi folded before Flop (didn't bet)
Seat 5: mikew035 folded before Flop (didn't bet)
Seat 7: PlayTheBlues4U (button) folded before Flop (didn't bet)
Seat 8: Alepoliti (small blind) collected (280)
Seat 9: harrismj7 (big blind) folded before Flop


*********** # 162 **************
PokerStars Hand #204079829937: Tournament #2091309004, Freeroll  Hold'em No Limit - Level VII (50/100) - 2019/09/29 18:38:33 ET
Table '2091309004 9' 9-max Seat #5 is the button
Seat 1: edgarcrespo973 (145 in chips) is sitting out
Seat 2: CaptACFD (585 in chips) is sitting out
Seat 3: rtr536 (90 in chips) is sitting out
Seat 4: Bsangi (70 in chips) is sitting out
Seat 5: mikew035 (7495 in chips) 
Seat 6: bnxcole (60 in chips) is sitting out
Seat 7: PlayTheBlues4U (205 in chips) is sitting out
Seat 8: Alepoliti (41590 in chips) 
Seat 9: harrismj7 (205 in chips) is sitting out
edgarcrespo973: posts the ante 10
CaptACFD: posts the ante 10
rtr536: posts the ante 10
Bsangi: posts the ante 10
mikew035: posts the ante 10
bnxcole: posts the ante 10
PlayTheBlues4U: posts the ante 10
Alepoliti: posts the ante 10
harrismj7: posts the ante 10
bnxcole: posts small blind 50 and is all-in
PlayTheBlues4U: posts big blind 100
*** HOLE CARDS ***
Dealt to PlayTheBlues4U [8s Qd]
Alepoliti: folds 
harrismj7: folds 
edgarcrespo973: folds 
CaptACFD: folds 
rtr536: folds 
Bsangi: folds 
mikew035: calls 100
bnxcole: folds 
PlayTheBlues4U: folds 
mikew035 collected 340 from pot
bnxcole finished the tournament in 79th place
mikew035: doesn't show hand 
*** SUMMARY ***
Total pot 340 | Rake 0 
Seat 1: edgarcrespo973 folded before Flop (didn't bet)
Seat 2: CaptACFD folded before Flop (didn't bet)
Seat 3: rtr536 folded before Flop (didn't bet)
Seat 4: Bsangi folded before Flop (didn't bet)
Seat 5: mikew035 (button) collected (340)
Seat 6: bnxcole (small blind) folded before Flop
Seat 7: PlayTheBlues4U (big blind) folded before Flop
Seat 8: Alepoliti folded before Flop (didn't bet)
Seat 9: harrismj7 folded before Flop (didn't bet)


*********** # 163 **************
PokerStars Hand #204079829908: Tournament #2091309004, Freeroll  Hold'em No Limit - Level VII (50/100) - 2019/09/29 18:38:27 ET
Table '2091309004 9' 9-max Seat #4 is the button
Seat 1: edgarcrespo973 (155 in chips) is sitting out
Seat 2: CaptACFD (595 in chips) is sitting out
Seat 3: rtr536 (100 in chips) is sitting out
Seat 4: Bsangi (80 in chips) is sitting out
Seat 5: mikew035 (7555 in chips) 
Seat 6: bnxcole (170 in chips) is sitting out
Seat 7: PlayTheBlues4U (215 in chips) is sitting out
Seat 8: Alepoliti (41360 in chips) 
Seat 9: harrismj7 (215 in chips) is sitting out
edgarcrespo973: posts the ante 10
CaptACFD: posts the ante 10
rtr536: posts the ante 10
Bsangi: posts the ante 10
mikew035: posts the ante 10
bnxcole: posts the ante 10
PlayTheBlues4U: posts the ante 10
Alepoliti: posts the ante 10
harrismj7: posts the ante 10
mikew035: posts small blind 50
bnxcole: posts big blind 100
*** HOLE CARDS ***
Dealt to PlayTheBlues4U [Kd 3d]
PlayTheBlues4U: folds 
Alepoliti: raises 200 to 300
harrismj7: folds 
edgarcrespo973: folds 
CaptACFD: folds 
rtr536: folds 
Bsangi: folds 
mikew035: folds 
bnxcole: folds 
Uncalled bet (200) returned to Alepoliti
Alepoliti collected 340 from pot
Alepoliti: doesn't show hand 
*** SUMMARY ***
Total pot 340 | Rake 0 
Seat 1: edgarcrespo973 folded before Flop (didn't bet)
Seat 2: CaptACFD folded before Flop (didn't bet)
Seat 3: rtr536 folded before Flop (didn't bet)
Seat 4: Bsangi (button) folded before Flop (didn't bet)
Seat 5: mikew035 (small blind) folded before Flop
Seat 6: bnxcole (big blind) folded before Flop
Seat 7: PlayTheBlues4U folded before Flop (didn't bet)
Seat 8: Alepoliti collected (340)
Seat 9: harrismj7 folded before Flop (didn't bet)


*********** # 164 **************
PokerStars Hand #204079829890: Tournament #2091309004, Freeroll  Hold'em No Limit - Level VII (50/100) - 2019/09/29 18:38:21 ET
Table '2091309004 9' 9-max Seat #3 is the button
Seat 1: edgarcrespo973 (165 in chips) is sitting out
Seat 2: CaptACFD (605 in chips) is sitting out
Seat 3: rtr536 (110 in chips) is sitting out
Seat 4: Bsangi (140 in chips) is sitting out
Seat 5: mikew035 (7665 in chips) 
Seat 6: bnxcole (180 in chips) is sitting out
Seat 7: PlayTheBlues4U (225 in chips) is sitting out
Seat 8: Alepoliti (41130 in chips) 
Seat 9: harrismj7 (225 in chips) is sitting out
edgarcrespo973: posts the ante 10
CaptACFD: posts the ante 10
rtr536: posts the ante 10
Bsangi: posts the ante 10
mikew035: posts the ante 10
bnxcole: posts the ante 10
PlayTheBlues4U: posts the ante 10
Alepoliti: posts the ante 10
harrismj7: posts the ante 10
Bsangi: posts small blind 50
mikew035: posts big blind 100
*** HOLE CARDS ***
Dealt to PlayTheBlues4U [5c 5h]
bnxcole: folds 
PlayTheBlues4U: folds 
Alepoliti: raises 100 to 200
harrismj7: folds 
edgarcrespo973: folds 
CaptACFD: folds 
rtr536: folds 
Bsangi: folds 
mikew035: folds 
Uncalled bet (100) returned to Alepoliti
Alepoliti collected 340 from pot
Alepoliti: doesn't show hand 
*** SUMMARY ***
Total pot 340 | Rake 0 
Seat 1: edgarcrespo973 folded before Flop (didn't bet)
Seat 2: CaptACFD folded before Flop (didn't bet)
Seat 3: rtr536 (button) folded before Flop (didn't bet)
Seat 4: Bsangi (small blind) folded before Flop
Seat 5: mikew035 (big blind) folded before Flop
Seat 6: bnxcole folded before Flop (didn't bet)
Seat 7: PlayTheBlues4U folded before Flop (didn't bet)
Seat 8: Alepoliti collected (340)
Seat 9: harrismj7 folded before Flop (didn't bet)


*********** # 165 **************
PokerStars Hand #204079829862: Tournament #2091309004, Freeroll  Hold'em No Limit - Level VII (50/100) - 2019/09/29 18:38:14 ET
Table '2091309004 9' 9-max Seat #2 is the button
Seat 1: edgarcrespo973 (175 in chips) is sitting out
Seat 2: CaptACFD (615 in chips) is sitting out
Seat 3: rtr536 (170 in chips) is sitting out
Seat 4: Bsangi (250 in chips) is sitting out
Seat 5: mikew035 (7675 in chips) 
Seat 6: bnxcole (190 in chips) is sitting out
Seat 7: PlayTheBlues4U (235 in chips) is sitting out
Seat 8: Alepoliti (40900 in chips) 
Seat 9: harrismj7 (235 in chips) is sitting out
edgarcrespo973: posts the ante 10
CaptACFD: posts the ante 10
rtr536: posts the ante 10
Bsangi: posts the ante 10
mikew035: posts the ante 10
bnxcole: posts the ante 10
PlayTheBlues4U: posts the ante 10
Alepoliti: posts the ante 10
harrismj7: posts the ante 10
rtr536: posts small blind 50
Bsangi: posts big blind 100
*** HOLE CARDS ***
Dealt to PlayTheBlues4U [7d Kh]
mikew035: folds 
bnxcole: folds 
PlayTheBlues4U: folds 
Alepoliti: raises 200 to 300
harrismj7: folds 
edgarcrespo973: folds 
CaptACFD: folds 
rtr536: folds 
Bsangi: folds 
Uncalled bet (200) returned to Alepoliti
Alepoliti collected 340 from pot
Alepoliti: doesn't show hand 
*** SUMMARY ***
Total pot 340 | Rake 0 
Seat 1: edgarcrespo973 folded before Flop (didn't bet)
Seat 2: CaptACFD (button) folded before Flop (didn't bet)
Seat 3: rtr536 (small blind) folded before Flop
Seat 4: Bsangi (big blind) folded before Flop
Seat 5: mikew035 folded before Flop (didn't bet)
Seat 6: bnxcole folded before Flop (didn't bet)
Seat 7: PlayTheBlues4U folded before Flop (didn't bet)
Seat 8: Alepoliti collected (340)
Seat 9: harrismj7 folded before Flop (didn't bet)


*********** # 166 **************
PokerStars Hand #204079829835: Tournament #2091309004, Freeroll  Hold'em No Limit - Level VII (50/100) - 2019/09/29 18:38:08 ET
Table '2091309004 9' 9-max Seat #1 is the button
Seat 1: edgarcrespo973 (185 in chips) is sitting out
Seat 2: CaptACFD (675 in chips) is sitting out
Seat 3: rtr536 (280 in chips) is sitting out
Seat 4: Bsangi (260 in chips) is sitting out
Seat 5: mikew035 (7445 in chips) 
Seat 6: bnxcole (200 in chips) is sitting out
Seat 7: PlayTheBlues4U (245 in chips) is sitting out
Seat 8: Alepoliti (40910 in chips) 
Seat 9: harrismj7 (245 in chips) is sitting out
edgarcrespo973: posts the ante 10
CaptACFD: posts the ante 10
rtr536: posts the ante 10
Bsangi: posts the ante 10
mikew035: posts the ante 10
bnxcole: posts the ante 10
PlayTheBlues4U: posts the ante 10
Alepoliti: posts the ante 10
harrismj7: posts the ante 10
CaptACFD: posts small blind 50
rtr536: posts big blind 100
*** HOLE CARDS ***
Dealt to PlayTheBlues4U [6c Ks]
Bsangi: folds 
mikew035: raises 100 to 200
bnxcole: folds 
PlayTheBlues4U: folds 
Alepoliti: folds 
harrismj7: folds 
edgarcrespo973: folds 
CaptACFD: folds 
rtr536: folds 
Uncalled bet (100) returned to mikew035
mikew035 collected 340 from pot
mikew035: doesn't show hand 
*** SUMMARY ***
Total pot 340 | Rake 0 
Seat 1: edgarcrespo973 (button) folded before Flop (didn't bet)
Seat 2: CaptACFD (small blind) folded before Flop
Seat 3: rtr536 (big blind) folded before Flop
Seat 4: Bsangi folded before Flop (didn't bet)
Seat 5: mikew035 collected (340)
Seat 6: bnxcole folded before Flop (didn't bet)
Seat 7: PlayTheBlues4U folded before Flop (didn't bet)
Seat 8: Alepoliti folded before Flop (didn't bet)
Seat 9: harrismj7 folded before Flop (didn't bet)


*********** # 167 **************
PokerStars Hand #204079829805: Tournament #2091309004, Freeroll  Hold'em No Limit - Level VII (50/100) - 2019/09/29 18:37:59 ET
Table '2091309004 9' 9-max Seat #9 is the button
Seat 1: edgarcrespo973 (245 in chips) is sitting out
Seat 2: CaptACFD (785 in chips) is sitting out
Seat 3: rtr536 (290 in chips) is sitting out
Seat 4: Bsangi (270 in chips) is sitting out
Seat 5: mikew035 (7455 in chips) 
Seat 6: bnxcole (210 in chips) is sitting out
Seat 7: PlayTheBlues4U (255 in chips) is sitting out
Seat 8: Alepoliti (40680 in chips) 
Seat 9: harrismj7 (255 in chips) is sitting out
edgarcrespo973: posts the ante 10
CaptACFD: posts the ante 10
rtr536: posts the ante 10
Bsangi: posts the ante 10
mikew035: posts the ante 10
bnxcole: posts the ante 10
PlayTheBlues4U: posts the ante 10
Alepoliti: posts the ante 10
harrismj7: posts the ante 10
edgarcrespo973: posts small blind 50
CaptACFD: posts big blind 100
*** HOLE CARDS ***
Dealt to PlayTheBlues4U [Jc 3c]
rtr536: folds 
Bsangi: folds 
mikew035: folds 
bnxcole: folds 
PlayTheBlues4U: folds 
Alepoliti: raises 100 to 200
harrismj7: folds 
edgarcrespo973: folds 
CaptACFD: folds 
Uncalled bet (100) returned to Alepoliti
Alepoliti collected 340 from pot
Alepoliti: doesn't show hand 
*** SUMMARY ***
Total pot 340 | Rake 0 
Seat 1: edgarcrespo973 (small blind) folded before Flop
Seat 2: CaptACFD (big blind) folded before Flop
Seat 3: rtr536 folded before Flop (didn't bet)
Seat 4: Bsangi folded before Flop (didn't bet)
Seat 5: mikew035 folded before Flop (didn't bet)
Seat 6: bnxcole folded before Flop (didn't bet)
Seat 7: PlayTheBlues4U folded before Flop (didn't bet)
Seat 8: Alepoliti collected (340)
Seat 9: harrismj7 (button) folded before Flop (didn't bet)


*********** # 168 **************
PokerStars Hand #204079829778: Tournament #2091309004, Freeroll  Hold'em No Limit - Level VII (50/100) - 2019/09/29 18:37:52 ET
Table '2091309004 9' 9-max Seat #8 is the button
Seat 1: edgarcrespo973 (355 in chips) is sitting out
Seat 2: CaptACFD (795 in chips) is sitting out
Seat 3: rtr536 (300 in chips) is sitting out
Seat 4: Bsangi (280 in chips) is sitting out
Seat 5: mikew035 (7465 in chips) 
Seat 6: bnxcole (220 in chips) is sitting out
Seat 7: PlayTheBlues4U (265 in chips) is sitting out
Seat 8: Alepoliti (40450 in chips) 
Seat 9: harrismj7 (315 in chips) is sitting out
edgarcrespo973: posts the ante 10
CaptACFD: posts the ante 10
rtr536: posts the ante 10
Bsangi: posts the ante 10
mikew035: posts the ante 10
bnxcole: posts the ante 10
PlayTheBlues4U: posts the ante 10
Alepoliti: posts the ante 10
harrismj7: posts the ante 10
harrismj7: posts small blind 50
edgarcrespo973: posts big blind 100
*** HOLE CARDS ***
Dealt to PlayTheBlues4U [Ad Qs]
CaptACFD: folds 
rtr536: folds 
Bsangi: folds 
mikew035: folds 
bnxcole: folds 
PlayTheBlues4U: folds 
Alepoliti: raises 100 to 200
harrismj7: folds 
edgarcrespo973: folds 
Uncalled bet (100) returned to Alepoliti
Alepoliti collected 340 from pot
Alepoliti: doesn't show hand 
*** SUMMARY ***
Total pot 340 | Rake 0 
Seat 1: edgarcrespo973 (big blind) folded before Flop
Seat 2: CaptACFD folded before Flop (didn't bet)
Seat 3: rtr536 folded before Flop (didn't bet)
Seat 4: Bsangi folded before Flop (didn't bet)
Seat 5: mikew035 folded before Flop (didn't bet)
Seat 6: bnxcole folded before Flop (didn't bet)
Seat 7: PlayTheBlues4U folded before Flop (didn't bet)
Seat 8: Alepoliti (button) collected (340)
Seat 9: harrismj7 (small blind) folded before Flop


*********** # 169 **************
PokerStars Hand #204079829749: Tournament #2091309004, Freeroll  Hold'em No Limit - Level VII (50/100) - 2019/09/29 18:37:45 ET
Table '2091309004 9' 9-max Seat #7 is the button
Seat 1: edgarcrespo973 (365 in chips) is sitting out
Seat 2: CaptACFD (805 in chips) is sitting out
Seat 3: rtr536 (310 in chips) is sitting out
Seat 4: Bsangi (290 in chips) is sitting out
Seat 5: mikew035 (7475 in chips) 
Seat 6: bnxcole (230 in chips) is sitting out
Seat 7: PlayTheBlues4U (275 in chips) is sitting out
Seat 8: Alepoliti (40270 in chips) 
Seat 9: harrismj7 (425 in chips) is sitting out
edgarcrespo973: posts the ante 10
CaptACFD: posts the ante 10
rtr536: posts the ante 10
Bsangi: posts the ante 10
mikew035: posts the ante 10
bnxcole: posts the ante 10
PlayTheBlues4U: posts the ante 10
Alepoliti: posts the ante 10
harrismj7: posts the ante 10
Alepoliti: posts small blind 50
harrismj7: posts big blind 100
*** HOLE CARDS ***
Dealt to PlayTheBlues4U [6d Ad]
edgarcrespo973: folds 
CaptACFD: folds 
rtr536: folds 
Bsangi: folds 
mikew035: folds 
bnxcole: folds 
PlayTheBlues4U: folds 
Alepoliti: calls 50
harrismj7: folds 
Alepoliti collected 290 from pot
Alepoliti: doesn't show hand 
*** SUMMARY ***
Total pot 290 | Rake 0 
Seat 1: edgarcrespo973 folded before Flop (didn't bet)
Seat 2: CaptACFD folded before Flop (didn't bet)
Seat 3: rtr536 folded before Flop (didn't bet)
Seat 4: Bsangi folded before Flop (didn't bet)
Seat 5: mikew035 folded before Flop (didn't bet)
Seat 6: bnxcole folded before Flop (didn't bet)
Seat 7: PlayTheBlues4U (button) folded before Flop (didn't bet)
Seat 8: Alepoliti (small blind) collected (290)
Seat 9: harrismj7 (big blind) folded before Flop


*********** # 170 **************
PokerStars Hand #204079829729: Tournament #2091309004, Freeroll  Hold'em No Limit - Level VII (50/100) - 2019/09/29 18:37:40 ET
Table '2091309004 9' 9-max Seat #6 is the button
Seat 1: edgarcrespo973 (375 in chips) is sitting out
Seat 2: CaptACFD (815 in chips) is sitting out
Seat 3: rtr536 (320 in chips) is sitting out
Seat 4: Bsangi (300 in chips) is sitting out
Seat 5: mikew035 (7485 in chips) 
Seat 6: bnxcole (240 in chips) is sitting out
Seat 7: PlayTheBlues4U (335 in chips) is sitting out
Seat 8: Alepoliti (40140 in chips) 
Seat 9: harrismj7 (435 in chips) is sitting out
edgarcrespo973: posts the ante 10
CaptACFD: posts the ante 10
rtr536: posts the ante 10
Bsangi: posts the ante 10
mikew035: posts the ante 10
bnxcole: posts the ante 10
PlayTheBlues4U: posts the ante 10
Alepoliti: posts the ante 10
harrismj7: posts the ante 10
PlayTheBlues4U: posts small blind 50
Alepoliti: posts big blind 100
*** HOLE CARDS ***
Dealt to PlayTheBlues4U [8d 9c]
harrismj7: folds 
edgarcrespo973: folds 
CaptACFD: folds 
rtr536: folds 
Bsangi: folds 
mikew035: folds 
bnxcole: folds 
PlayTheBlues4U: folds 
Uncalled bet (50) returned to Alepoliti
Alepoliti collected 190 from pot
Alepoliti: doesn't show hand 
*** SUMMARY ***
Total pot 190 | Rake 0 
Seat 1: edgarcrespo973 folded before Flop (didn't bet)
Seat 2: CaptACFD folded before Flop (didn't bet)
Seat 3: rtr536 folded before Flop (didn't bet)
Seat 4: Bsangi folded before Flop (didn't bet)
Seat 5: mikew035 folded before Flop (didn't bet)
Seat 6: bnxcole (button) folded before Flop (didn't bet)
Seat 7: PlayTheBlues4U (small blind) folded before Flop
Seat 8: Alepoliti (big blind) collected (190)
Seat 9: harrismj7 folded before Flop (didn't bet)


*********** # 171 **************
PokerStars Hand #204079829700: Tournament #2091309004, Freeroll  Hold'em No Limit - Level VII (50/100) - 2019/09/29 18:37:33 ET
Table '2091309004 9' 9-max Seat #5 is the button
Seat 1: edgarcrespo973 (385 in chips) is sitting out
Seat 2: CaptACFD (825 in chips) is sitting out
Seat 3: rtr536 (330 in chips) is sitting out
Seat 4: Bsangi (310 in chips) is sitting out
Seat 5: mikew035 (7495 in chips) 
Seat 6: bnxcole (300 in chips) is sitting out
Seat 7: PlayTheBlues4U (445 in chips) is sitting out
Seat 8: Alepoliti (39910 in chips) 
Seat 9: harrismj7 (445 in chips) is sitting out
edgarcrespo973: posts the ante 10
CaptACFD: posts the ante 10
rtr536: posts the ante 10
Bsangi: posts the ante 10
mikew035: posts the ante 10
bnxcole: posts the ante 10
PlayTheBlues4U: posts the ante 10
Alepoliti: posts the ante 10
harrismj7: posts the ante 10
bnxcole: posts small blind 50
PlayTheBlues4U: posts big blind 100
*** HOLE CARDS ***
Dealt to PlayTheBlues4U [Kd Kh]
Alepoliti: raises 300 to 400
harrismj7: folds 
edgarcrespo973: folds 
CaptACFD: folds 
rtr536: folds 
Bsangi: folds 
mikew035: folds 
bnxcole: folds 
PlayTheBlues4U: folds 
Uncalled bet (300) returned to Alepoliti
Alepoliti collected 340 from pot
Alepoliti: doesn't show hand 
*** SUMMARY ***
Total pot 340 | Rake 0 
Seat 1: edgarcrespo973 folded before Flop (didn't bet)
Seat 2: CaptACFD folded before Flop (didn't bet)
Seat 3: rtr536 folded before Flop (didn't bet)
Seat 4: Bsangi folded before Flop (didn't bet)
Seat 5: mikew035 (button) folded before Flop (didn't bet)
Seat 6: bnxcole (small blind) folded before Flop
Seat 7: PlayTheBlues4U (big blind) folded before Flop
Seat 8: Alepoliti collected (340)
Seat 9: harrismj7 folded before Flop (didn't bet)


*********** # 172 **************
PokerStars Hand #204079829681: Tournament #2091309004, Freeroll  Hold'em No Limit - Level VII (50/100) - 2019/09/29 18:37:27 ET
Table '2091309004 9' 9-max Seat #4 is the button
Seat 1: edgarcrespo973 (395 in chips) is sitting out
Seat 2: CaptACFD (835 in chips) is sitting out
Seat 3: rtr536 (340 in chips) is sitting out
Seat 4: Bsangi (320 in chips) is sitting out
Seat 5: mikew035 (7315 in chips) 
Seat 6: bnxcole (410 in chips) is sitting out
Seat 7: PlayTheBlues4U (455 in chips) is sitting out
Seat 8: Alepoliti (39920 in chips) 
Seat 9: harrismj7 (455 in chips) is sitting out
edgarcrespo973: posts the ante 10
CaptACFD: posts the ante 10
rtr536: posts the ante 10
Bsangi: posts the ante 10
mikew035: posts the ante 10
bnxcole: posts the ante 10
PlayTheBlues4U: posts the ante 10
Alepoliti: posts the ante 10
harrismj7: posts the ante 10
mikew035: posts small blind 50
bnxcole: posts big blind 100
*** HOLE CARDS ***
Dealt to PlayTheBlues4U [6c 8c]
PlayTheBlues4U: folds 
Alepoliti: folds 
harrismj7: folds 
edgarcrespo973: folds 
CaptACFD: folds 
rtr536: folds 
Bsangi: folds 
mikew035: calls 50
bnxcole: folds 
mikew035 collected 290 from pot
mikew035: doesn't show hand 
*** SUMMARY ***
Total pot 290 | Rake 0 
Seat 1: edgarcrespo973 folded before Flop (didn't bet)
Seat 2: CaptACFD folded before Flop (didn't bet)
Seat 3: rtr536 folded before Flop (didn't bet)
Seat 4: Bsangi (button) folded before Flop (didn't bet)
Seat 5: mikew035 (small blind) collected (290)
Seat 6: bnxcole (big blind) folded before Flop
Seat 7: PlayTheBlues4U folded before Flop (didn't bet)
Seat 8: Alepoliti folded before Flop (didn't bet)
Seat 9: harrismj7 folded before Flop (didn't bet)


*********** # 173 **************
PokerStars Hand #204079829562: Tournament #2091309004, Freeroll  Hold'em No Limit - Level VII (50/100) - 2019/09/29 18:37:00 ET
Table '2091309004 9' 9-max Seat #3 is the button
Seat 1: edgarcrespo973 (405 in chips) is sitting out
Seat 2: CaptACFD (845 in chips) is sitting out
Seat 3: rtr536 (350 in chips) is sitting out
Seat 4: Bsangi (380 in chips) is sitting out
Seat 5: mikew035 (5085 in chips) 
Seat 6: bnxcole (420 in chips) is sitting out
Seat 7: PlayTheBlues4U (465 in chips) is sitting out
Seat 8: Alepoliti (42030 in chips) 
Seat 9: harrismj7 (465 in chips) is sitting out
edgarcrespo973: posts the ante 10
CaptACFD: posts the ante 10
rtr536: posts the ante 10
Bsangi: posts the ante 10
mikew035: posts the ante 10
bnxcole: posts the ante 10
PlayTheBlues4U: posts the ante 10
Alepoliti: posts the ante 10
harrismj7: posts the ante 10
Bsangi: posts small blind 50
mikew035: posts big blind 100
*** HOLE CARDS ***
Dealt to PlayTheBlues4U [4h Jd]
bnxcole: folds 
PlayTheBlues4U: folds 
Alepoliti: raises 300 to 400
harrismj7: folds 
edgarcrespo973: folds 
CaptACFD: folds 
rtr536: folds 
Bsangi: folds 
mikew035: calls 300
*** FLOP *** [8s 6s Qh]
mikew035: checks 
Alepoliti: checks 
*** TURN *** [8s 6s Qh] [8c]
mikew035: bets 500
Alepoliti: calls 500
*** RIVER *** [8s 6s Qh 8c] [8d]
mikew035: bets 1200
Alepoliti: calls 1200
*** SHOW DOWN ***
mikew035: shows [Kc Kh] (a full house, Eights full of Kings)
Alepoliti: mucks hand 
mikew035 collected 4340 from pot
*** SUMMARY ***
Total pot 4340 | Rake 0 
Board [8s 6s Qh 8c 8d]
Seat 1: edgarcrespo973 folded before Flop (didn't bet)
Seat 2: CaptACFD folded before Flop (didn't bet)
Seat 3: rtr536 (button) folded before Flop (didn't bet)
Seat 4: Bsangi (small blind) folded before Flop
Seat 5: mikew035 (big blind) showed [Kc Kh] and won (4340) with a full house, Eights full of Kings
Seat 6: bnxcole folded before Flop (didn't bet)
Seat 7: PlayTheBlues4U folded before Flop (didn't bet)
Seat 8: Alepoliti mucked [2s 2d]
Seat 9: harrismj7 folded before Flop (didn't bet)


*********** # 174 **************
PokerStars Hand #204079829539: Tournament #2091309004, Freeroll  Hold'em No Limit - Level VII (50/100) - 2019/09/29 18:36:53 ET
Table '2091309004 9' 9-max Seat #2 is the button
Seat 1: edgarcrespo973 (415 in chips) is sitting out
Seat 2: CaptACFD (855 in chips) is sitting out
Seat 3: rtr536 (410 in chips) is sitting out
Seat 4: Bsangi (490 in chips) is sitting out
Seat 5: mikew035 (5095 in chips) 
Seat 6: bnxcole (430 in chips) is sitting out
Seat 7: PlayTheBlues4U (475 in chips) is sitting out
Seat 8: Alepoliti (41800 in chips) 
Seat 9: harrismj7 (475 in chips) is sitting out
edgarcrespo973: posts the ante 10
CaptACFD: posts the ante 10
rtr536: posts the ante 10
Bsangi: posts the ante 10
mikew035: posts the ante 10
bnxcole: posts the ante 10
PlayTheBlues4U: posts the ante 10
Alepoliti: posts the ante 10
harrismj7: posts the ante 10
rtr536: posts small blind 50
Bsangi: posts big blind 100
*** HOLE CARDS ***
Dealt to PlayTheBlues4U [Jc As]
mikew035: folds 
bnxcole: folds 
PlayTheBlues4U: folds 
Alepoliti: raises 100 to 200
harrismj7: folds 
edgarcrespo973: folds 
CaptACFD: folds 
rtr536: folds 
Bsangi: folds 
Uncalled bet (100) returned to Alepoliti
Alepoliti collected 340 from pot
Alepoliti: doesn't show hand 
*** SUMMARY ***
Total pot 340 | Rake 0 
Seat 1: edgarcrespo973 folded before Flop (didn't bet)
Seat 2: CaptACFD (button) folded before Flop (didn't bet)
Seat 3: rtr536 (small blind) folded before Flop
Seat 4: Bsangi (big blind) folded before Flop
Seat 5: mikew035 folded before Flop (didn't bet)
Seat 6: bnxcole folded before Flop (didn't bet)
Seat 7: PlayTheBlues4U folded before Flop (didn't bet)
Seat 8: Alepoliti collected (340)
Seat 9: harrismj7 folded before Flop (didn't bet)


*********** # 175 **************
PokerStars Hand #204079829511: Tournament #2091309004, Freeroll  Hold'em No Limit - Level VII (50/100) - 2019/09/29 18:36:47 ET
Table '2091309004 9' 9-max Seat #1 is the button
Seat 1: edgarcrespo973 (425 in chips) is sitting out
Seat 2: CaptACFD (915 in chips) is sitting out
Seat 3: rtr536 (520 in chips) is sitting out
Seat 4: Bsangi (500 in chips) is sitting out
Seat 5: mikew035 (4865 in chips) 
Seat 6: bnxcole (440 in chips) is sitting out
Seat 7: PlayTheBlues4U (485 in chips) is sitting out
Seat 8: Alepoliti (41810 in chips) 
Seat 9: harrismj7 (485 in chips) is sitting out
edgarcrespo973: posts the ante 10
CaptACFD: posts the ante 10
rtr536: posts the ante 10
Bsangi: posts the ante 10
mikew035: posts the ante 10
bnxcole: posts the ante 10
PlayTheBlues4U: posts the ante 10
Alepoliti: posts the ante 10
harrismj7: posts the ante 10
CaptACFD: posts small blind 50
rtr536: posts big blind 100
*** HOLE CARDS ***
Dealt to PlayTheBlues4U [Qc 5d]
Bsangi: folds 
mikew035: calls 100
bnxcole: folds 
PlayTheBlues4U: folds 
Alepoliti: folds 
harrismj7: folds 
edgarcrespo973: folds 
CaptACFD: folds 
rtr536: folds 
mikew035 collected 340 from pot
mikew035: doesn't show hand 
*** SUMMARY ***
Total pot 340 | Rake 0 
Seat 1: edgarcrespo973 (button) folded before Flop (didn't bet)
Seat 2: CaptACFD (small blind) folded before Flop
Seat 3: rtr536 (big blind) folded before Flop
Seat 4: Bsangi folded before Flop (didn't bet)
Seat 5: mikew035 collected (340)
Seat 6: bnxcole folded before Flop (didn't bet)
Seat 7: PlayTheBlues4U folded before Flop (didn't bet)
Seat 8: Alepoliti folded before Flop (didn't bet)
Seat 9: harrismj7 folded before Flop (didn't bet)


*********** # 176 **************
PokerStars Hand #204079829465: Tournament #2091309004, Freeroll  Hold'em No Limit - Level VII (50/100) - 2019/09/29 18:36:37 ET
Table '2091309004 9' 9-max Seat #9 is the button
Seat 1: edgarcrespo973 (485 in chips) is sitting out
Seat 2: CaptACFD (1025 in chips) is sitting out
Seat 3: rtr536 (530 in chips) is sitting out
Seat 4: Bsangi (510 in chips) is sitting out
Seat 5: mikew035 (4635 in chips) 
Seat 6: bnxcole (450 in chips) is sitting out
Seat 7: PlayTheBlues4U (495 in chips) is sitting out
Seat 8: Alepoliti (41820 in chips) 
Seat 9: harrismj7 (495 in chips) is sitting out
edgarcrespo973: posts the ante 10
CaptACFD: posts the ante 10
rtr536: posts the ante 10
Bsangi: posts the ante 10
mikew035: posts the ante 10
bnxcole: posts the ante 10
PlayTheBlues4U: posts the ante 10
Alepoliti: posts the ante 10
harrismj7: posts the ante 10
edgarcrespo973: posts small blind 50
CaptACFD: posts big blind 100
*** HOLE CARDS ***
Dealt to PlayTheBlues4U [7c Jh]
rtr536: folds 
Bsangi: folds 
mikew035: calls 100
bnxcole: folds 
PlayTheBlues4U: folds 
Alepoliti: folds 
harrismj7: folds 
edgarcrespo973: folds 
CaptACFD: folds 
mikew035 collected 340 from pot
mikew035: doesn't show hand 
*** SUMMARY ***
Total pot 340 | Rake 0 
Seat 1: edgarcrespo973 (small blind) folded before Flop
Seat 2: CaptACFD (big blind) folded before Flop
Seat 3: rtr536 folded before Flop (didn't bet)
Seat 4: Bsangi folded before Flop (didn't bet)
Seat 5: mikew035 collected (340)
Seat 6: bnxcole folded before Flop (didn't bet)
Seat 7: PlayTheBlues4U folded before Flop (didn't bet)
Seat 8: Alepoliti folded before Flop (didn't bet)
Seat 9: harrismj7 (button) folded before Flop (didn't bet)


*********** # 177 **************
PokerStars Hand #204079829340: Tournament #2091309004, Freeroll  Hold'em No Limit - Level VI (40/80) - 2019/09/29 18:36:05 ET
Table '2091309004 9' 9-max Seat #8 is the button
Seat 1: edgarcrespo973 (565 in chips) is sitting out
Seat 2: CaptACFD (1025 in chips) is sitting out
Seat 3: rtr536 (530 in chips) is sitting out
Seat 4: Bsangi (510 in chips) is sitting out
Seat 5: mikew035 (4115 in chips) 
Seat 6: bnxcole (450 in chips) is sitting out
Seat 7: PlayTheBlues4U (495 in chips) is sitting out
Seat 8: Alepoliti (42220 in chips) 
Seat 9: harrismj7 (535 in chips) is sitting out
harrismj7: posts small blind 40
edgarcrespo973: posts big blind 80
*** HOLE CARDS ***
Dealt to PlayTheBlues4U [Jd 6h]
CaptACFD: folds 
rtr536: folds 
Bsangi: folds 
mikew035: raises 80 to 160
bnxcole: folds 
PlayTheBlues4U: folds 
Alepoliti: calls 160
harrismj7: folds 
edgarcrespo973: folds 
*** FLOP *** [Qs 8s Qh]
mikew035: bets 80
Alepoliti: calls 80
*** TURN *** [Qs 8s Qh] [2c]
mikew035: bets 160
Alepoliti: calls 160
*** RIVER *** [Qs 8s Qh 2c] [5h]
mikew035: bets 240
Alepoliti: folds 
Uncalled bet (240) returned to mikew035
mikew035 collected 920 from pot
mikew035: doesn't show hand 
*** SUMMARY ***
Total pot 920 | Rake 0 
Board [Qs 8s Qh 2c 5h]
Seat 1: edgarcrespo973 (big blind) folded before Flop
Seat 2: CaptACFD folded before Flop (didn't bet)
Seat 3: rtr536 folded before Flop (didn't bet)
Seat 4: Bsangi folded before Flop (didn't bet)
Seat 5: mikew035 collected (920)
Seat 6: bnxcole folded before Flop (didn't bet)
Seat 7: PlayTheBlues4U folded before Flop (didn't bet)
Seat 8: Alepoliti (button) folded on the River
Seat 9: harrismj7 (small blind) folded before Flop


*********** # 178 **************
PokerStars Hand #204079829268: Tournament #2091309004, Freeroll  Hold'em No Limit - Level VI (40/80) - 2019/09/29 18:35:48 ET
Table '2091309004 9' 9-max Seat #7 is the button
Seat 1: edgarcrespo973 (565 in chips) is sitting out
Seat 2: CaptACFD (1025 in chips) is sitting out
Seat 3: rtr536 (530 in chips) is sitting out
Seat 4: Bsangi (510 in chips) is sitting out
Seat 5: mikew035 (3955 in chips) 
Seat 6: bnxcole (450 in chips) is sitting out
Seat 7: PlayTheBlues4U (495 in chips) is sitting out
Seat 8: Alepoliti (42300 in chips) 
Seat 9: harrismj7 (615 in chips) is sitting out
Alepoliti: posts small blind 40
harrismj7: posts big blind 80
*** HOLE CARDS ***
Dealt to PlayTheBlues4U [Kc 8c]
edgarcrespo973: folds 
CaptACFD: folds 
rtr536: folds 
Bsangi: folds 
mikew035: calls 80
bnxcole: folds 
PlayTheBlues4U: folds 
Alepoliti: calls 40
harrismj7: folds 
*** FLOP *** [2s 5s 2c]
Alepoliti: checks 
mikew035: checks 
*** TURN *** [2s 5s 2c] [6s]
Alepoliti: checks 
mikew035: bets 80
Alepoliti: folds 
Uncalled bet (80) returned to mikew035
mikew035 collected 240 from pot
mikew035: doesn't show hand 
*** SUMMARY ***
Total pot 240 | Rake 0 
Board [2s 5s 2c 6s]
Seat 1: edgarcrespo973 folded before Flop (didn't bet)
Seat 2: CaptACFD folded before Flop (didn't bet)
Seat 3: rtr536 folded before Flop (didn't bet)
Seat 4: Bsangi folded before Flop (didn't bet)
Seat 5: mikew035 collected (240)
Seat 6: bnxcole folded before Flop (didn't bet)
Seat 7: PlayTheBlues4U (button) folded before Flop (didn't bet)
Seat 8: Alepoliti (small blind) folded on the Turn
Seat 9: harrismj7 (big blind) folded before Flop


*********** # 179 **************
PokerStars Hand #204079829250: Tournament #2091309004, Freeroll  Hold'em No Limit - Level VI (40/80) - 2019/09/29 18:35:44 ET
Table '2091309004 9' 9-max Seat #6 is the button
Seat 1: edgarcrespo973 (565 in chips) is sitting out
Seat 2: CaptACFD (1025 in chips) is sitting out
Seat 3: rtr536 (530 in chips) is sitting out
Seat 4: Bsangi (510 in chips) is sitting out
Seat 5: mikew035 (3955 in chips) 
Seat 6: bnxcole (450 in chips) is sitting out
Seat 7: PlayTheBlues4U (535 in chips) is sitting out
Seat 8: Alepoliti (42260 in chips) 
Seat 9: harrismj7 (615 in chips) is sitting out
PlayTheBlues4U: posts small blind 40
Alepoliti: posts big blind 80
*** HOLE CARDS ***
Dealt to PlayTheBlues4U [3d 5d]
harrismj7: folds 
edgarcrespo973: folds 
CaptACFD: folds 
rtr536: folds 
Bsangi: folds 
mikew035: folds 
bnxcole: folds 
PlayTheBlues4U: folds 
Uncalled bet (40) returned to Alepoliti
Alepoliti collected 80 from pot
Alepoliti: doesn't show hand 
*** SUMMARY ***
Total pot 80 | Rake 0 
Seat 1: edgarcrespo973 folded before Flop (didn't bet)
Seat 2: CaptACFD folded before Flop (didn't bet)
Seat 3: rtr536 folded before Flop (didn't bet)
Seat 4: Bsangi folded before Flop (didn't bet)
Seat 5: mikew035 folded before Flop (didn't bet)
Seat 6: bnxcole (button) folded before Flop (didn't bet)
Seat 7: PlayTheBlues4U (small blind) folded before Flop
Seat 8: Alepoliti (big blind) collected (80)
Seat 9: harrismj7 folded before Flop (didn't bet)


*********** # 180 **************
PokerStars Hand #204079829088: Tournament #2091309004, Freeroll  Hold'em No Limit - Level VI (40/80) - 2019/09/29 18:35:06 ET
Table '2091309004 9' 9-max Seat #5 is the button
Seat 1: edgarcrespo973 (565 in chips) is sitting out
Seat 2: CaptACFD (1025 in chips) is sitting out
Seat 3: rtr536 (530 in chips) is sitting out
Seat 4: Bsangi (510 in chips) is sitting out
Seat 5: mikew035 (25025 in chips) is sitting out
Seat 6: bnxcole (490 in chips) is sitting out
Seat 7: PlayTheBlues4U (615 in chips) is sitting out
Seat 8: Alepoliti (21070 in chips) 
Seat 9: harrismj7 (615 in chips) is sitting out
bnxcole: posts small blind 40
PlayTheBlues4U: posts big blind 80
*** HOLE CARDS ***
Dealt to PlayTheBlues4U [Js Tc]
mikew035 has returned
Alepoliti: raises 80 to 160
harrismj7: folds 
edgarcrespo973: folds 
CaptACFD: folds 
rtr536: folds 
Bsangi: folds 
mikew035: raises 80 to 240
bnxcole: folds 
PlayTheBlues4U: folds 
Alepoliti: raises 480 to 720
mikew035: calls 480
*** FLOP *** [4c 9h 2d]
Alepoliti: bets 1360
mikew035: calls 1360
*** TURN *** [4c 9h 2d] [Td]
Alepoliti: bets 2880
mikew035: raises 20065 to 22945 and is all-in
Alepoliti: calls 16110 and is all-in
Uncalled bet (3955) returned to mikew035
*** RIVER *** [4c 9h 2d Td] [5c]
*** SHOW DOWN ***
Alepoliti: shows [Kd Ks] (a pair of Kings)
mikew035: shows [9s Qh] (a pair of Nines)
Alepoliti collected 42260 from pot
*** SUMMARY ***
Total pot 42260 | Rake 0 
Board [4c 9h 2d Td 5c]
Seat 1: edgarcrespo973 folded before Flop (didn't bet)
Seat 2: CaptACFD folded before Flop (didn't bet)
Seat 3: rtr536 folded before Flop (didn't bet)
Seat 4: Bsangi folded before Flop (didn't bet)
Seat 5: mikew035 (button) showed [9s Qh] and lost with a pair of Nines
Seat 6: bnxcole (small blind) folded before Flop
Seat 7: PlayTheBlues4U (big blind) folded before Flop
Seat 8: Alepoliti showed [Kd Ks] and won (42260) with a pair of Kings
Seat 9: harrismj7 folded before Flop (didn't bet)


*********** # 181 **************
PokerStars Hand #204079829048: Tournament #2091309004, Freeroll  Hold'em No Limit - Level VI (40/80) - 2019/09/29 18:34:58 ET
Table '2091309004 9' 9-max Seat #4 is the button
Seat 1: edgarcrespo973 (565 in chips) is sitting out
Seat 2: CaptACFD (1025 in chips) is sitting out
Seat 3: rtr536 (530 in chips) is sitting out
Seat 4: Bsangi (510 in chips) is sitting out
Seat 5: mikew035 (25065 in chips) is sitting out
Seat 6: bnxcole (570 in chips) is sitting out
Seat 7: PlayTheBlues4U (615 in chips) is sitting out
Seat 8: Alepoliti (20950 in chips) 
Seat 9: harrismj7 (615 in chips) is sitting out
mikew035: posts small blind 40
bnxcole: posts big blind 80
*** HOLE CARDS ***
Dealt to PlayTheBlues4U [3c 3h]
PlayTheBlues4U: folds 
Alepoliti: raises 80 to 160
harrismj7: folds 
edgarcrespo973: folds 
CaptACFD: folds 
rtr536: folds 
Bsangi: folds 
mikew035: folds 
bnxcole: folds 
Uncalled bet (80) returned to Alepoliti
Alepoliti collected 200 from pot
Alepoliti: doesn't show hand 
*** SUMMARY ***
Total pot 200 | Rake 0 
Seat 1: edgarcrespo973 folded before Flop (didn't bet)
Seat 2: CaptACFD folded before Flop (didn't bet)
Seat 3: rtr536 folded before Flop (didn't bet)
Seat 4: Bsangi (button) folded before Flop (didn't bet)
Seat 5: mikew035 (small blind) folded before Flop
Seat 6: bnxcole (big blind) folded before Flop
Seat 7: PlayTheBlues4U folded before Flop (didn't bet)
Seat 8: Alepoliti collected (200)
Seat 9: harrismj7 folded before Flop (didn't bet)


*********** # 182 **************
PokerStars Hand #204079829035: Tournament #2091309004, Freeroll  Hold'em No Limit - Level VI (40/80) - 2019/09/29 18:34:55 ET
Table '2091309004 9' 9-max Seat #3 is the button
Seat 1: edgarcrespo973 (565 in chips) is sitting out
Seat 2: CaptACFD (1025 in chips) is sitting out
Seat 3: rtr536 (530 in chips) is sitting out
Seat 4: Bsangi (550 in chips) is sitting out
Seat 5: mikew035 (25145 in chips) is sitting out
Seat 6: bnxcole (570 in chips) is sitting out
Seat 7: PlayTheBlues4U (615 in chips) is sitting out
Seat 8: Alepoliti (20830 in chips) 
Seat 9: harrismj7 (615 in chips) is sitting out
Bsangi: posts small blind 40
mikew035: posts big blind 80
*** HOLE CARDS ***
Dealt to PlayTheBlues4U [Ts 3d]
bnxcole: folds 
PlayTheBlues4U: folds 
Alepoliti: raises 80 to 160
harrismj7: folds 
edgarcrespo973: folds 
CaptACFD: folds 
rtr536: folds 
Bsangi: folds 
mikew035: folds 
Uncalled bet (80) returned to Alepoliti
Alepoliti collected 200 from pot
Alepoliti: doesn't show hand 
*** SUMMARY ***
Total pot 200 | Rake 0 
Seat 1: edgarcrespo973 folded before Flop (didn't bet)
Seat 2: CaptACFD folded before Flop (didn't bet)
Seat 3: rtr536 (button) folded before Flop (didn't bet)
Seat 4: Bsangi (small blind) folded before Flop
Seat 5: mikew035 (big blind) folded before Flop
Seat 6: bnxcole folded before Flop (didn't bet)
Seat 7: PlayTheBlues4U folded before Flop (didn't bet)
Seat 8: Alepoliti collected (200)
Seat 9: harrismj7 folded before Flop (didn't bet)


*********** # 183 **************
PokerStars Hand #204079829008: Tournament #2091309004, Freeroll  Hold'em No Limit - Level VI (40/80) - 2019/09/29 18:34:49 ET
Table '2091309004 9' 9-max Seat #2 is the button
Seat 1: edgarcrespo973 (565 in chips) is sitting out
Seat 2: CaptACFD (1025 in chips) is sitting out
Seat 3: rtr536 (570 in chips) is sitting out
Seat 4: Bsangi (630 in chips) is sitting out
Seat 5: mikew035 (25145 in chips) is sitting out
Seat 6: bnxcole (570 in chips) is sitting out
Seat 7: PlayTheBlues4U (615 in chips) is sitting out
Seat 8: Alepoliti (20710 in chips) 
Seat 9: harrismj7 (615 in chips) is sitting out
rtr536: posts small blind 40
Bsangi: posts big blind 80
*** HOLE CARDS ***
Dealt to PlayTheBlues4U [4h 3s]
mikew035: folds 
bnxcole: folds 
PlayTheBlues4U: folds 
Alepoliti: raises 80 to 160
harrismj7: folds 
edgarcrespo973: folds 
CaptACFD: folds 
rtr536: folds 
Bsangi: folds 
Uncalled bet (80) returned to Alepoliti
Alepoliti collected 200 from pot
Alepoliti: doesn't show hand 
*** SUMMARY ***
Total pot 200 | Rake 0 
Seat 1: edgarcrespo973 folded before Flop (didn't bet)
Seat 2: CaptACFD (button) folded before Flop (didn't bet)
Seat 3: rtr536 (small blind) folded before Flop
Seat 4: Bsangi (big blind) folded before Flop
Seat 5: mikew035 folded before Flop (didn't bet)
Seat 6: bnxcole folded before Flop (didn't bet)
Seat 7: PlayTheBlues4U folded before Flop (didn't bet)
Seat 8: Alepoliti collected (200)
Seat 9: harrismj7 folded before Flop (didn't bet)


*********** # 184 **************
PokerStars Hand #204079828887: Tournament #2091309004, Freeroll  Hold'em No Limit - Level VI (40/80) - 2019/09/29 18:34:24 ET
Table '2091309004 9' 9-max Seat #1 is the button
Seat 1: edgarcrespo973 (565 in chips) is sitting out
Seat 2: CaptACFD (1065 in chips) is sitting out
Seat 3: rtr536 (650 in chips) is sitting out
Seat 4: Bsangi (630 in chips) is sitting out
Seat 5: mikew035 (25145 in chips) 
Seat 6: bnxcole (570 in chips) is sitting out
Seat 7: PlayTheBlues4U (615 in chips) is sitting out
Seat 8: Alepoliti (20590 in chips) 
Seat 9: harrismj7 (615 in chips) is sitting out
CaptACFD: posts small blind 40
rtr536: posts big blind 80
*** HOLE CARDS ***
Dealt to PlayTheBlues4U [Ad Kc]
Bsangi: folds 
mikew035 has timed out
mikew035: folds 
mikew035 is sitting out
bnxcole: folds 
PlayTheBlues4U: folds 
Alepoliti: raises 80 to 160
harrismj7: folds 
edgarcrespo973: folds 
CaptACFD: folds 
rtr536: folds 
Uncalled bet (80) returned to Alepoliti
Alepoliti collected 200 from pot
Alepoliti: doesn't show hand 
*** SUMMARY ***
Total pot 200 | Rake 0 
Seat 1: edgarcrespo973 (button) folded before Flop (didn't bet)
Seat 2: CaptACFD (small blind) folded before Flop
Seat 3: rtr536 (big blind) folded before Flop
Seat 4: Bsangi folded before Flop (didn't bet)
Seat 5: mikew035 folded before Flop (didn't bet)
Seat 6: bnxcole folded before Flop (didn't bet)
Seat 7: PlayTheBlues4U folded before Flop (didn't bet)
Seat 8: Alepoliti collected (200)
Seat 9: harrismj7 folded before Flop (didn't bet)


*********** # 185 **************
PokerStars Hand #204079828845: Tournament #2091309004, Freeroll  Hold'em No Limit - Level VI (40/80) - 2019/09/29 18:34:15 ET
Table '2091309004 9' 9-max Seat #9 is the button
Seat 1: edgarcrespo973 (605 in chips) is sitting out
Seat 2: CaptACFD (1145 in chips) is sitting out
Seat 3: rtr536 (650 in chips) is sitting out
Seat 4: Bsangi (630 in chips) is sitting out
Seat 5: mikew035 (25225 in chips) 
Seat 6: bnxcole (570 in chips) is sitting out
Seat 7: PlayTheBlues4U (615 in chips) is sitting out
Seat 8: Alepoliti (20390 in chips) 
Seat 9: harrismj7 (615 in chips) is sitting out
edgarcrespo973: posts small blind 40
CaptACFD: posts big blind 80
*** HOLE CARDS ***
Dealt to PlayTheBlues4U [7h 2c]
rtr536: folds 
Bsangi: folds 
mikew035: calls 80
bnxcole: folds 
PlayTheBlues4U: folds 
Alepoliti: raises 240 to 320
harrismj7: folds 
edgarcrespo973: folds 
CaptACFD: folds 
mikew035: folds 
Uncalled bet (240) returned to Alepoliti
Alepoliti collected 280 from pot
Alepoliti: doesn't show hand 
*** SUMMARY ***
Total pot 280 | Rake 0 
Seat 1: edgarcrespo973 (small blind) folded before Flop
Seat 2: CaptACFD (big blind) folded before Flop
Seat 3: rtr536 folded before Flop (didn't bet)
Seat 4: Bsangi folded before Flop (didn't bet)
Seat 5: mikew035 folded before Flop
Seat 6: bnxcole folded before Flop (didn't bet)
Seat 7: PlayTheBlues4U folded before Flop (didn't bet)
Seat 8: Alepoliti collected (280)
Seat 9: harrismj7 (button) folded before Flop (didn't bet)


*********** # 186 **************
PokerStars Hand #204079828818: Tournament #2091309004, Freeroll  Hold'em No Limit - Level VI (40/80) - 2019/09/29 18:34:08 ET
Table '2091309004 9' 9-max Seat #8 is the button
Seat 1: edgarcrespo973 (685 in chips) is sitting out
Seat 2: CaptACFD (1145 in chips) is sitting out
Seat 3: rtr536 (650 in chips) is sitting out
Seat 4: Bsangi (630 in chips) is sitting out
Seat 5: mikew035 (25225 in chips) 
Seat 6: bnxcole (570 in chips) is sitting out
Seat 7: PlayTheBlues4U (615 in chips) is sitting out
Seat 8: Alepoliti (20270 in chips) 
Seat 9: harrismj7 (655 in chips) is sitting out
harrismj7: posts small blind 40
edgarcrespo973: posts big blind 80
*** HOLE CARDS ***
Dealt to PlayTheBlues4U [2d 7c]
CaptACFD: folds 
rtr536: folds 
Bsangi: folds 
mikew035: folds 
bnxcole: folds 
PlayTheBlues4U: folds 
Alepoliti: raises 160 to 240
harrismj7: folds 
edgarcrespo973: folds 
Uncalled bet (160) returned to Alepoliti
Alepoliti collected 200 from pot
Alepoliti: doesn't show hand 
*** SUMMARY ***
Total pot 200 | Rake 0 
Seat 1: edgarcrespo973 (big blind) folded before Flop
Seat 2: CaptACFD folded before Flop (didn't bet)
Seat 3: rtr536 folded before Flop (didn't bet)
Seat 4: Bsangi folded before Flop (didn't bet)
Seat 5: mikew035 folded before Flop (didn't bet)
Seat 6: bnxcole folded before Flop (didn't bet)
Seat 7: PlayTheBlues4U folded before Flop (didn't bet)
Seat 8: Alepoliti (button) collected (200)
Seat 9: harrismj7 (small blind) folded before Flop


*********** # 187 **************
PokerStars Hand #204079828752: Tournament #2091309004, Freeroll  Hold'em No Limit - Level VI (40/80) - 2019/09/29 18:33:54 ET
Table '2091309004 9' 9-max Seat #7 is the button
Seat 1: edgarcrespo973 (685 in chips) is sitting out
Seat 2: CaptACFD (1145 in chips) is sitting out
Seat 3: rtr536 (650 in chips) is sitting out
Seat 4: Bsangi (630 in chips) is sitting out
Seat 5: mikew035 (25305 in chips) 
Seat 6: bnxcole (570 in chips) is sitting out
Seat 7: PlayTheBlues4U (615 in chips) is sitting out
Seat 8: Alepoliti (20110 in chips) 
Seat 9: harrismj7 (735 in chips) is sitting out
Alepoliti: posts small blind 40
harrismj7: posts big blind 80
*** HOLE CARDS ***
Dealt to PlayTheBlues4U [7d 2c]
edgarcrespo973: folds 
CaptACFD: folds 
rtr536: folds 
Bsangi: folds 
mikew035: calls 80
bnxcole: folds 
PlayTheBlues4U: folds 
Alepoliti: calls 40
harrismj7: folds 
*** FLOP *** [Qh Jd 4h]
Alepoliti: checks 
mikew035: checks 
*** TURN *** [Qh Jd 4h] [Jc]
Alepoliti: bets 80
mikew035: folds 
Uncalled bet (80) returned to Alepoliti
Alepoliti collected 240 from pot
Alepoliti: doesn't show hand 
*** SUMMARY ***
Total pot 240 | Rake 0 
Board [Qh Jd 4h Jc]
Seat 1: edgarcrespo973 folded before Flop (didn't bet)
Seat 2: CaptACFD folded before Flop (didn't bet)
Seat 3: rtr536 folded before Flop (didn't bet)
Seat 4: Bsangi folded before Flop (didn't bet)
Seat 5: mikew035 folded on the Turn
Seat 6: bnxcole folded before Flop (didn't bet)
Seat 7: PlayTheBlues4U (button) folded before Flop (didn't bet)
Seat 8: Alepoliti (small blind) collected (240)
Seat 9: harrismj7 (big blind) folded before Flop


*********** # 188 **************
PokerStars Hand #204079828732: Tournament #2091309004, Freeroll  Hold'em No Limit - Level VI (40/80) - 2019/09/29 18:33:49 ET
Table '2091309004 9' 9-max Seat #6 is the button
Seat 1: edgarcrespo973 (685 in chips) is sitting out
Seat 2: CaptACFD (1145 in chips) is sitting out
Seat 3: rtr536 (650 in chips) is sitting out
Seat 4: Bsangi (630 in chips) is sitting out
Seat 5: mikew035 (25305 in chips) 
Seat 6: bnxcole (570 in chips) is sitting out
Seat 7: PlayTheBlues4U (655 in chips) is sitting out
Seat 8: Alepoliti (20070 in chips) 
Seat 9: harrismj7 (735 in chips) is sitting out
PlayTheBlues4U: posts small blind 40
Alepoliti: posts big blind 80
*** HOLE CARDS ***
Dealt to PlayTheBlues4U [7h 7d]
harrismj7: folds 
edgarcrespo973: folds 
CaptACFD: folds 
rtr536: folds 
Bsangi: folds 
mikew035: folds 
bnxcole: folds 
PlayTheBlues4U: folds 
Uncalled bet (40) returned to Alepoliti
Alepoliti collected 80 from pot
Alepoliti: doesn't show hand 
*** SUMMARY ***
Total pot 80 | Rake 0 
Seat 1: edgarcrespo973 folded before Flop (didn't bet)
Seat 2: CaptACFD folded before Flop (didn't bet)
Seat 3: rtr536 folded before Flop (didn't bet)
Seat 4: Bsangi folded before Flop (didn't bet)
Seat 5: mikew035 folded before Flop (didn't bet)
Seat 6: bnxcole (button) folded before Flop (didn't bet)
Seat 7: PlayTheBlues4U (small blind) folded before Flop
Seat 8: Alepoliti (big blind) collected (80)
Seat 9: harrismj7 folded before Flop (didn't bet)


*********** # 189 **************
PokerStars Hand #204079828696: Tournament #2091309004, Freeroll  Hold'em No Limit - Level VI (40/80) - 2019/09/29 18:33:41 ET
Table '2091309004 9' 9-max Seat #5 is the button
Seat 1: edgarcrespo973 (685 in chips) is sitting out
Seat 2: CaptACFD (1145 in chips) is sitting out
Seat 3: rtr536 (650 in chips) is sitting out
Seat 4: Bsangi (630 in chips) is sitting out
Seat 5: mikew035 (25185 in chips) 
Seat 6: bnxcole (610 in chips) is sitting out
Seat 7: PlayTheBlues4U (735 in chips) is sitting out
Seat 8: Alepoliti (20070 in chips) 
Seat 9: harrismj7 (735 in chips) is sitting out
bnxcole: posts small blind 40
PlayTheBlues4U: posts big blind 80
*** HOLE CARDS ***
Dealt to PlayTheBlues4U [Td Ah]
Alepoliti: folds 
harrismj7: folds 
edgarcrespo973: folds 
CaptACFD: folds 
rtr536: folds 
Bsangi: folds 
mikew035: raises 80 to 160
bnxcole: folds 
PlayTheBlues4U: folds 
Uncalled bet (80) returned to mikew035
mikew035 collected 200 from pot
mikew035: doesn't show hand 
*** SUMMARY ***
Total pot 200 | Rake 0 
Seat 1: edgarcrespo973 folded before Flop (didn't bet)
Seat 2: CaptACFD folded before Flop (didn't bet)
Seat 3: rtr536 folded before Flop (didn't bet)
Seat 4: Bsangi folded before Flop (didn't bet)
Seat 5: mikew035 (button) collected (200)
Seat 6: bnxcole (small blind) folded before Flop
Seat 7: PlayTheBlues4U (big blind) folded before Flop
Seat 8: Alepoliti folded before Flop (didn't bet)
Seat 9: harrismj7 folded before Flop (didn't bet)


*********** # 190 **************
PokerStars Hand #204079828665: Tournament #2091309004, Freeroll  Hold'em No Limit - Level VI (40/80) - 2019/09/29 18:33:35 ET
Table '2091309004 9' 9-max Seat #4 is the button
Seat 1: edgarcrespo973 (685 in chips) is sitting out
Seat 2: CaptACFD (1145 in chips) is sitting out
Seat 3: rtr536 (650 in chips) is sitting out
Seat 4: Bsangi (630 in chips) is sitting out
Seat 5: mikew035 (25105 in chips) 
Seat 6: bnxcole (690 in chips) is sitting out
Seat 7: PlayTheBlues4U (735 in chips) is sitting out
Seat 8: Alepoliti (20070 in chips) 
Seat 9: harrismj7 (735 in chips) is sitting out
mikew035: posts small blind 40
bnxcole: posts big blind 80
*** HOLE CARDS ***
Dealt to PlayTheBlues4U [Jd 4d]
PlayTheBlues4U: folds 
Alepoliti: folds 
harrismj7: folds 
edgarcrespo973: folds 
CaptACFD: folds 
rtr536: folds 
Bsangi: folds 
mikew035: raises 80 to 160
bnxcole: folds 
Uncalled bet (80) returned to mikew035
mikew035 collected 160 from pot
mikew035: doesn't show hand 
*** SUMMARY ***
Total pot 160 | Rake 0 
Seat 1: edgarcrespo973 folded before Flop (didn't bet)
Seat 2: CaptACFD folded before Flop (didn't bet)
Seat 3: rtr536 folded before Flop (didn't bet)
Seat 4: Bsangi (button) folded before Flop (didn't bet)
Seat 5: mikew035 (small blind) collected (160)
Seat 6: bnxcole (big blind) folded before Flop
Seat 7: PlayTheBlues4U folded before Flop (didn't bet)
Seat 8: Alepoliti folded before Flop (didn't bet)
Seat 9: harrismj7 folded before Flop (didn't bet)


*********** # 191 **************
PokerStars Hand #204079828575: Tournament #2091309004, Freeroll  Hold'em No Limit - Level VI (40/80) - 2019/09/29 18:33:14 ET
Table '2091309004 9' 9-max Seat #3 is the button
Seat 1: edgarcrespo973 (685 in chips) is sitting out
Seat 2: CaptACFD (1145 in chips) is sitting out
Seat 3: rtr536 (650 in chips) is sitting out
Seat 4: Bsangi (670 in chips) is sitting out
Seat 5: mikew035 (24745 in chips) 
Seat 6: bnxcole (690 in chips) is sitting out
Seat 7: PlayTheBlues4U (735 in chips) is sitting out
Seat 8: Alepoliti (20390 in chips) 
Seat 9: harrismj7 (735 in chips) is sitting out
Bsangi: posts small blind 40
mikew035: posts big blind 80
*** HOLE CARDS ***
Dealt to PlayTheBlues4U [7d Ad]
bnxcole: folds 
PlayTheBlues4U: folds 
Alepoliti: calls 80
harrismj7: folds 
edgarcrespo973: folds 
CaptACFD: folds 
rtr536: folds 
Bsangi: folds 
mikew035: checks 
*** FLOP *** [8c 6c Kd]
mikew035: checks 
Alepoliti: bets 80
mikew035: calls 80
*** TURN *** [8c 6c Kd] [6h]
mikew035: checks 
Alepoliti: bets 80
mikew035: calls 80
*** RIVER *** [8c 6c Kd 6h] [5c]
mikew035: bets 80
Alepoliti: calls 80
*** SHOW DOWN ***
mikew035: shows [7h Ks] (two pair, Kings and Sixes)
Alepoliti: mucks hand 
mikew035 collected 680 from pot
*** SUMMARY ***
Total pot 680 | Rake 0 
Board [8c 6c Kd 6h 5c]
Seat 1: edgarcrespo973 folded before Flop (didn't bet)
Seat 2: CaptACFD folded before Flop (didn't bet)
Seat 3: rtr536 (button) folded before Flop (didn't bet)
Seat 4: Bsangi (small blind) folded before Flop
Seat 5: mikew035 (big blind) showed [7h Ks] and won (680) with two pair, Kings and Sixes
Seat 6: bnxcole folded before Flop (didn't bet)
Seat 7: PlayTheBlues4U folded before Flop (didn't bet)
Seat 8: Alepoliti mucked [Qs 8s]
Seat 9: harrismj7 folded before Flop (didn't bet)


*********** # 192 **************
PokerStars Hand #204079828551: Tournament #2091309004, Freeroll  Hold'em No Limit - Level VI (40/80) - 2019/09/29 18:33:09 ET
Table '2091309004 9' 9-max Seat #2 is the button
Seat 1: edgarcrespo973 (685 in chips) is sitting out
Seat 2: CaptACFD (1145 in chips) is sitting out
Seat 3: rtr536 (690 in chips) is sitting out
Seat 4: Bsangi (750 in chips) is sitting out
Seat 5: mikew035 (24745 in chips) 
Seat 6: bnxcole (690 in chips) is sitting out
Seat 7: PlayTheBlues4U (735 in chips) is sitting out
Seat 8: Alepoliti (20270 in chips) 
Seat 9: harrismj7 (735 in chips) is sitting out
rtr536: posts small blind 40
Bsangi: posts big blind 80
*** HOLE CARDS ***
Dealt to PlayTheBlues4U [5d 8h]
mikew035: folds 
bnxcole: folds 
PlayTheBlues4U: folds 
Alepoliti: raises 80 to 160
harrismj7: folds 
edgarcrespo973: folds 
CaptACFD: folds 
rtr536: folds 
Bsangi: folds 
Uncalled bet (80) returned to Alepoliti
Alepoliti collected 200 from pot
Alepoliti: doesn't show hand 
*** SUMMARY ***
Total pot 200 | Rake 0 
Seat 1: edgarcrespo973 folded before Flop (didn't bet)
Seat 2: CaptACFD (button) folded before Flop (didn't bet)
Seat 3: rtr536 (small blind) folded before Flop
Seat 4: Bsangi (big blind) folded before Flop
Seat 5: mikew035 folded before Flop (didn't bet)
Seat 6: bnxcole folded before Flop (didn't bet)
Seat 7: PlayTheBlues4U folded before Flop (didn't bet)
Seat 8: Alepoliti collected (200)
Seat 9: harrismj7 folded before Flop (didn't bet)


*********** # 193 **************
PokerStars Hand #204079828502: Tournament #2091309004, Freeroll  Hold'em No Limit - Level VI (40/80) - 2019/09/29 18:32:56 ET
Table '2091309004 9' 9-max Seat #1 is the button
Seat 1: edgarcrespo973 (685 in chips) is sitting out
Seat 2: CaptACFD (1185 in chips) is sitting out
Seat 3: rtr536 (770 in chips) is sitting out
Seat 4: Bsangi (750 in chips) is sitting out
Seat 5: mikew035 (24825 in chips) 
Seat 6: bnxcole (690 in chips) is sitting out
Seat 7: PlayTheBlues4U (735 in chips) is sitting out
Seat 8: Alepoliti (20070 in chips) 
Seat 9: harrismj7 (735 in chips) is sitting out
CaptACFD: posts small blind 40
rtr536: posts big blind 80
*** HOLE CARDS ***
Dealt to PlayTheBlues4U [8d Qs]
Bsangi: folds 
mikew035: calls 80
bnxcole: folds 
PlayTheBlues4U: folds 
Alepoliti: raises 240 to 320
harrismj7: folds 
edgarcrespo973: folds 
CaptACFD: folds 
rtr536: folds 
mikew035: folds 
Uncalled bet (240) returned to Alepoliti
Alepoliti collected 280 from pot
Alepoliti: doesn't show hand 
*** SUMMARY ***
Total pot 280 | Rake 0 
Seat 1: edgarcrespo973 (button) folded before Flop (didn't bet)
Seat 2: CaptACFD (small blind) folded before Flop
Seat 3: rtr536 (big blind) folded before Flop
Seat 4: Bsangi folded before Flop (didn't bet)
Seat 5: mikew035 folded before Flop
Seat 6: bnxcole folded before Flop (didn't bet)
Seat 7: PlayTheBlues4U folded before Flop (didn't bet)
Seat 8: Alepoliti collected (280)
Seat 9: harrismj7 folded before Flop (didn't bet)


*********** # 194 **************
PokerStars Hand #204079828474: Tournament #2091309004, Freeroll  Hold'em No Limit - Level VI (40/80) - 2019/09/29 18:32:50 ET
Table '2091309004 9' 9-max Seat #9 is the button
Seat 1: edgarcrespo973 (725 in chips) is sitting out
Seat 2: CaptACFD (1265 in chips) is sitting out
Seat 3: rtr536 (770 in chips) is sitting out
Seat 4: Bsangi (750 in chips) is sitting out
Seat 5: mikew035 (24825 in chips) 
Seat 6: bnxcole (690 in chips) is sitting out
Seat 7: PlayTheBlues4U (735 in chips) is sitting out
Seat 8: Alepoliti (19950 in chips) 
Seat 9: harrismj7 (735 in chips) is sitting out
edgarcrespo973: posts small blind 40
CaptACFD: posts big blind 80
*** HOLE CARDS ***
Dealt to PlayTheBlues4U [Ts Jc]
rtr536: folds 
Bsangi: folds 
mikew035: folds 
bnxcole: folds 
PlayTheBlues4U: folds 
Alepoliti: raises 80 to 160
harrismj7: folds 
edgarcrespo973: folds 
CaptACFD: folds 
Uncalled bet (80) returned to Alepoliti
Alepoliti collected 200 from pot
Alepoliti: doesn't show hand 
*** SUMMARY ***
Total pot 200 | Rake 0 
Seat 1: edgarcrespo973 (small blind) folded before Flop
Seat 2: CaptACFD (big blind) folded before Flop
Seat 3: rtr536 folded before Flop (didn't bet)
Seat 4: Bsangi folded before Flop (didn't bet)
Seat 5: mikew035 folded before Flop (didn't bet)
Seat 6: bnxcole folded before Flop (didn't bet)
Seat 7: PlayTheBlues4U folded before Flop (didn't bet)
Seat 8: Alepoliti collected (200)
Seat 9: harrismj7 (button) folded before Flop (didn't bet)


*********** # 195 **************
PokerStars Hand #204079828449: Tournament #2091309004, Freeroll  Hold'em No Limit - Level VI (40/80) - 2019/09/29 18:32:45 ET
Table '2091309004 9' 9-max Seat #8 is the button
Seat 1: edgarcrespo973 (805 in chips) is sitting out
Seat 2: CaptACFD (1265 in chips) is sitting out
Seat 3: rtr536 (770 in chips) is sitting out
Seat 4: Bsangi (750 in chips) is sitting out
Seat 5: mikew035 (24705 in chips) 
Seat 6: bnxcole (690 in chips) is sitting out
Seat 7: PlayTheBlues4U (735 in chips) is sitting out
Seat 8: Alepoliti (19950 in chips) 
Seat 9: harrismj7 (775 in chips) is sitting out
harrismj7: posts small blind 40
edgarcrespo973: posts big blind 80
*** HOLE CARDS ***
Dealt to PlayTheBlues4U [3s 3h]
CaptACFD: folds 
rtr536: folds 
Bsangi: folds 
mikew035: calls 80
bnxcole: folds 
PlayTheBlues4U: folds 
Alepoliti: folds 
harrismj7: folds 
edgarcrespo973: folds 
mikew035 collected 200 from pot
mikew035: doesn't show hand 
*** SUMMARY ***
Total pot 200 | Rake 0 
Seat 1: edgarcrespo973 (big blind) folded before Flop
Seat 2: CaptACFD folded before Flop (didn't bet)
Seat 3: rtr536 folded before Flop (didn't bet)
Seat 4: Bsangi folded before Flop (didn't bet)
Seat 5: mikew035 collected (200)
Seat 6: bnxcole folded before Flop (didn't bet)
Seat 7: PlayTheBlues4U folded before Flop (didn't bet)
Seat 8: Alepoliti (button) folded before Flop (didn't bet)
Seat 9: harrismj7 (small blind) folded before Flop


*********** # 196 **************
PokerStars Hand #204079349962: Tournament #2091309004, Freeroll  Hold'em No Limit - Level VI (40/80) - 2019/09/29 18:32:25 ET
Table '2091309004 9' 9-max Seat #7 is the button
Seat 1: edgarcrespo973 (805 in chips) is sitting out
Seat 2: CaptACFD (1265 in chips) is sitting out
Seat 3: rtr536 (770 in chips) is sitting out
Seat 4: Bsangi (750 in chips) is sitting out
Seat 5: mikew035 (24545 in chips) 
Seat 6: bnxcole (690 in chips) is sitting out
Seat 7: PlayTheBlues4U (735 in chips) is sitting out
Seat 8: Alepoliti (20030 in chips) 
Seat 9: harrismj7 (855 in chips) is sitting out
Alepoliti: posts small blind 40
harrismj7: posts big blind 80
*** HOLE CARDS ***
Dealt to PlayTheBlues4U [3c Kd]
edgarcrespo973: folds 
CaptACFD: folds 
rtr536: folds 
Bsangi: folds 
mikew035: calls 80
bnxcole: folds 
PlayTheBlues4U: folds 
Alepoliti: calls 40
harrismj7: folds 
*** FLOP *** [Jc 4h 7d]
Alepoliti: checks 
mikew035: checks 
*** TURN *** [Jc 4h 7d] [2d]
Alepoliti: checks 
mikew035: checks 
*** RIVER *** [Jc 4h 7d 2d] [2c]
Alepoliti: checks 
mikew035: checks 
*** SHOW DOWN ***
Alepoliti: shows [6c 5c] (a pair of Deuces)
mikew035: shows [Qh Th] (a pair of Deuces - Queen kicker)
mikew035 collected 240 from pot
*** SUMMARY ***
Total pot 240 | Rake 0 
Board [Jc 4h 7d 2d 2c]
Seat 1: edgarcrespo973 folded before Flop (didn't bet)
Seat 2: CaptACFD folded before Flop (didn't bet)
Seat 3: rtr536 folded before Flop (didn't bet)
Seat 4: Bsangi folded before Flop (didn't bet)
Seat 5: mikew035 showed [Qh Th] and won (240) with a pair of Deuces
Seat 6: bnxcole folded before Flop (didn't bet)
Seat 7: PlayTheBlues4U (button) folded before Flop (didn't bet)
Seat 8: Alepoliti (small blind) showed [6c 5c] and lost with a pair of Deuces
Seat 9: harrismj7 (big blind) folded before Flop


*********** # 197 **************
PokerStars Hand #204079349742: Tournament #2091309004, Freeroll  Hold'em No Limit - Level VI (40/80) - 2019/09/29 18:31:33 ET
Table '2091309004 9' 9-max Seat #6 is the button
Seat 1: edgarcrespo973 (805 in chips) is sitting out
Seat 2: CaptACFD (1265 in chips) is sitting out
Seat 3: rtr536 (770 in chips) is sitting out
Seat 4: Bsangi (750 in chips) is sitting out
Seat 5: mikew035 (24425 in chips) 
Seat 6: bnxcole (690 in chips) is sitting out
Seat 7: PlayTheBlues4U (775 in chips) is sitting out
Seat 8: Alepoliti (20110 in chips) 
Seat 9: harrismj7 (855 in chips) is sitting out
PlayTheBlues4U: posts small blind 40
Alepoliti: posts big blind 80
*** HOLE CARDS ***
Dealt to PlayTheBlues4U [8h 2c]
harrismj7: folds 
edgarcrespo973: folds 
CaptACFD: folds 
rtr536: folds 
Bsangi: folds 
mikew035: calls 80
bnxcole: folds 
PlayTheBlues4U: folds 
Alepoliti: checks 
*** FLOP *** [9s Jd Qs]
Alepoliti: checks 
mikew035: bets 80
Alepoliti: folds 
Uncalled bet (80) returned to mikew035
mikew035 collected 200 from pot
mikew035: doesn't show hand 
*** SUMMARY ***
Total pot 200 | Rake 0 
Board [9s Jd Qs]
Seat 1: edgarcrespo973 folded before Flop (didn't bet)
Seat 2: CaptACFD folded before Flop (didn't bet)
Seat 3: rtr536 folded before Flop (didn't bet)
Seat 4: Bsangi folded before Flop (didn't bet)
Seat 5: mikew035 collected (200)
Seat 6: bnxcole (button) folded before Flop (didn't bet)
Seat 7: PlayTheBlues4U (small blind) folded before Flop
Seat 8: Alepoliti (big blind) folded on the Flop
Seat 9: harrismj7 folded before Flop (didn't bet)


*********** # 198 **************
PokerStars Hand #204079349717: Tournament #2091309004, Freeroll  Hold'em No Limit - Level VI (40/80) - 2019/09/29 18:31:25 ET
Table '2091309004 9' 9-max Seat #5 is the button
Seat 1: edgarcrespo973 (805 in chips) is sitting out
Seat 2: CaptACFD (1265 in chips) is sitting out
Seat 3: rtr536 (770 in chips) is sitting out
Seat 4: Bsangi (750 in chips) is sitting out
Seat 5: mikew035 (24305 in chips) 
Seat 6: bnxcole (730 in chips) is sitting out
Seat 7: PlayTheBlues4U (855 in chips) is sitting out
Seat 8: Alepoliti (20110 in chips) 
Seat 9: harrismj7 (855 in chips) is sitting out
bnxcole: posts small blind 40
PlayTheBlues4U: posts big blind 80
*** HOLE CARDS ***
Dealt to PlayTheBlues4U [3c Qs]
Alepoliti: folds 
harrismj7: folds 
edgarcrespo973: folds 
CaptACFD: folds 
rtr536: folds 
Bsangi: folds 
mikew035: calls 80
bnxcole: folds 
PlayTheBlues4U: folds 
mikew035 collected 200 from pot
mikew035: doesn't show hand 
*** SUMMARY ***
Total pot 200 | Rake 0 
Seat 1: edgarcrespo973 folded before Flop (didn't bet)
Seat 2: CaptACFD folded before Flop (didn't bet)
Seat 3: rtr536 folded before Flop (didn't bet)
Seat 4: Bsangi folded before Flop (didn't bet)
Seat 5: mikew035 (button) collected (200)
Seat 6: bnxcole (small blind) folded before Flop
Seat 7: PlayTheBlues4U (big blind) folded before Flop
Seat 8: Alepoliti folded before Flop (didn't bet)
Seat 9: harrismj7 folded before Flop (didn't bet)


*********** # 199 **************
PokerStars Hand #204079349609: Tournament #2091309004, Freeroll  Hold'em No Limit - Level VI (40/80) - 2019/09/29 18:30:57 ET
Table '2091309004 9' 9-max Seat #4 is the button
Seat 1: edgarcrespo973 (805 in chips) is sitting out
Seat 2: CaptACFD (1265 in chips) is sitting out
Seat 3: rtr536 (770 in chips) is sitting out
Seat 4: Bsangi (750 in chips) is sitting out
Seat 5: mikew035 (24385 in chips) 
Seat 6: bnxcole (810 in chips) is sitting out
Seat 7: PlayTheBlues4U (855 in chips) is sitting out
Seat 8: Alepoliti (19950 in chips) 
Seat 9: harrismj7 (855 in chips) is sitting out
mikew035: posts small blind 40
bnxcole: posts big blind 80
*** HOLE CARDS ***
Dealt to PlayTheBlues4U [3d Jh]
PlayTheBlues4U: folds 
Alepoliti: calls 80
harrismj7: folds 
edgarcrespo973: folds 
CaptACFD: folds 
rtr536: folds 
Bsangi: folds 
mikew035: calls 40
bnxcole: folds 
*** FLOP *** [9c Kc 4c]
mikew035: checks 
Alepoliti: checks 
*** TURN *** [9c Kc 4c] [9d]
mikew035: checks 
Alepoliti: checks 
*** RIVER *** [9c Kc 4c 9d] [2d]
mikew035: checks 
Alepoliti: checks 
*** SHOW DOWN ***
mikew035: shows [Th 3c] (a pair of Nines)
Alepoliti: shows [Jd 8s] (a pair of Nines - King+Jack kicker)
Alepoliti collected 240 from pot
*** SUMMARY ***
Total pot 240 | Rake 0 
Board [9c Kc 4c 9d 2d]
Seat 1: edgarcrespo973 folded before Flop (didn't bet)
Seat 2: CaptACFD folded before Flop (didn't bet)
Seat 3: rtr536 folded before Flop (didn't bet)
Seat 4: Bsangi (button) folded before Flop (didn't bet)
Seat 5: mikew035 (small blind) showed [Th 3c] and lost with a pair of Nines
Seat 6: bnxcole (big blind) folded before Flop
Seat 7: PlayTheBlues4U folded before Flop (didn't bet)
Seat 8: Alepoliti showed [Jd 8s] and won (240) with a pair of Nines
Seat 9: harrismj7 folded before Flop (didn't bet)


*********** # 200 **************
PokerStars Hand #204079349571: Tournament #2091309004, Freeroll  Hold'em No Limit - Level VI (40/80) - 2019/09/29 18:30:49 ET
Table '2091309004 9' 9-max Seat #3 is the button
Seat 1: edgarcrespo973 (805 in chips) is sitting out
Seat 2: CaptACFD (1265 in chips) is sitting out
Seat 3: rtr536 (770 in chips) is sitting out
Seat 4: Bsangi (790 in chips) is sitting out
Seat 5: mikew035 (24465 in chips) 
Seat 6: bnxcole (810 in chips) is sitting out
Seat 7: PlayTheBlues4U (855 in chips) is sitting out
Seat 8: Alepoliti (19830 in chips) 
Seat 9: harrismj7 (855 in chips) is sitting out
Bsangi: posts small blind 40
mikew035: posts big blind 80
*** HOLE CARDS ***
Dealt to PlayTheBlues4U [5s Kd]
bnxcole: folds 
PlayTheBlues4U: folds 
Alepoliti: raises 160 to 240
harrismj7: folds 
edgarcrespo973: folds 
CaptACFD: folds 
rtr536: folds 
Bsangi: folds 
mikew035: folds 
Uncalled bet (160) returned to Alepoliti
Alepoliti collected 200 from pot
Alepoliti: doesn't show hand 
*** SUMMARY ***
Total pot 200 | Rake 0 
Seat 1: edgarcrespo973 folded before Flop (didn't bet)
Seat 2: CaptACFD folded before Flop (didn't bet)
Seat 3: rtr536 (button) folded before Flop (didn't bet)
Seat 4: Bsangi (small blind) folded before Flop
Seat 5: mikew035 (big blind) folded before Flop
Seat 6: bnxcole folded before Flop (didn't bet)
Seat 7: PlayTheBlues4U folded before Flop (didn't bet)
Seat 8: Alepoliti collected (200)
Seat 9: harrismj7 folded before Flop (didn't bet)
