*********** # 1 **************
PokerStars Hand #204330103607:  Hold'em No Limit ($0.02/$0.05 USD) - 2019/10/07 20:32:46 ET
Table 'Sculptor' 6-max Seat #4 is the button
Seat 1: cladams73 ($3.22 in chips)
Seat 3: skillzplumber ($7.34 in chips)
Seat 4: PlayTheBlues4U ($5 in chips)
Seat 5: Wooly510 ($7.82 in chips)
Seat 6: DemolishIT ($9 in chips)
Wooly510: posts small blind $0.02
DemolishIT: posts big blind $0.05
DaGoodz33: sits out
*** HOLE CARDS ***
Dealt to PlayTheBlues4U [8c 8d]
cladams73: calls $0.05
skillzplumber: folds
PlayTheBlues4U: raises $0.10 to $0.15
Wooly510: raises $0.40 to $0.55
DemolishIT: folds
cladams73: calls $0.50
PlayTheBlues4U: calls $0.40
*** FLOP *** [3h Kc 2h]
Wooly510: bets $1.22
cladams73: raises $1.22 to $2.44
PlayTheBlues4U: folds
PlayTheBlues4U leaves the table
Wooly510: raises $1.22 to $3.66
cladams73: calls $0.23 and is all-in
Uncalled bet ($0.99) returned to Wooly510
*** TURN *** [3h Kc 2h] [4h]
*** RIVER *** [3h Kc 2h 4h] [9s]
*** SHOW DOWN ***
Wooly510: shows [Kd Kh] (three of a kind, Kings)
cladams73: shows [Jh 6h] (a flush, Jack high)
cladams73 collected $6.69 from pot
*** SUMMARY ***
Total pot $7.04 | Rake $0.35
Board [3h Kc 2h 4h 9s]
Seat 1: cladams73 showed [Jh 6h] and won ($6.69) with a flush, Jack high
Seat 3: skillzplumber folded before Flop (didn't bet)
Seat 4: PlayTheBlues4U (button) folded on the Flop
Seat 5: Wooly510 (small blind) showed [Kd Kh] and lost with three of a kind, Kings
Seat 6: DemolishIT (big blind) folded before Flop


*********** # 2 **************
PokerStars Hand #204330103480:  Hold'em No Limit ($0.02/$0.05 USD) - 2019/10/07 20:32:06 ET
Table 'Fides' 6-max Seat #5 is the button
Seat 1: KooKballs ($7.79 in chips)
Seat 2: Wooly510 ($4.83 in chips)
Seat 3: dcami_nj ($10.06 in chips)
Seat 4: DaGoodz33 ($6.53 in chips)
Seat 5: stock501402 ($8.49 in chips)
Seat 6: PlayTheBlues4U ($5.96 in chips)
PlayTheBlues4U: posts small blind $0.02
KooKballs: posts big blind $0.05
*** HOLE CARDS ***
Dealt to PlayTheBlues4U [9d 6c]
Wooly510: folds
dcami_nj: folds
DaGoodz33: folds
stock501402: calls $0.05
PlayTheBlues4U: folds
PlayTheBlues4U is disconnected
KooKballs: checks
*** FLOP *** [Js Qh Tc]
PlayTheBlues4U leaves the table
KooKballs: bets $0.10
stock501402: folds
Uncalled bet ($0.10) returned to KooKballs
KooKballs collected $0.11 from pot
KooKballs: doesn't show hand
*** SUMMARY ***
Total pot $0.12 | Rake $0.01
Board [Js Qh Tc]
Seat 1: KooKballs (big blind) collected ($0.11)
Seat 2: Wooly510 folded before Flop (didn't bet)
Seat 3: dcami_nj folded before Flop (didn't bet)
Seat 4: DaGoodz33 folded before Flop (didn't bet)
Seat 5: stock501402 (button) folded on the Flop
Seat 6: PlayTheBlues4U (small blind) folded before Flop


*********** # 3 **************
PokerStars Hand #204330103412:  Hold'em No Limit ($0.02/$0.05 USD) - 2019/10/07 20:31:43 ET
Table 'Sculptor' 6-max Seat #3 is the button
Seat 1: cladams73 ($3.87 in chips)
Seat 3: skillzplumber ($7.34 in chips)
Seat 4: PlayTheBlues4U ($1.54 in chips)
Seat 5: Wooly510 ($7.87 in chips)
Seat 6: DemolishIT ($9.15 in chips)
PlayTheBlues4U: posts small blind $0.02
Wooly510: posts big blind $0.05
*** HOLE CARDS ***
Dealt to PlayTheBlues4U [9c Kc]
DemolishIT: calls $0.05
skillzplumber said, "nh"
cladams73: raises $0.10 to $0.15
R@ngers94 leaves the table
skillzplumber: folds
DemolishIT said, "ty"
DaGoodz33 joins the table at seat #2
PlayTheBlues4U: calls $0.13
Wooly510: folds
DemolishIT: calls $0.10
*** FLOP *** [3s 2c 3c]
PlayTheBlues4U: checks
DemolishIT: checks
cladams73: bets $0.50
PlayTheBlues4U: raises $0.89 to $1.39 and is all-in
DemolishIT: folds
cladams73: folds
Uncalled bet ($0.89) returned to PlayTheBlues4U
PlayTheBlues4U collected $1.42 from pot
PlayTheBlues4U: doesn't show hand
*** SUMMARY ***
Total pot $1.50 | Rake $0.08
Board [3s 2c 3c]
Seat 1: cladams73 folded on the Flop
Seat 3: skillzplumber (button) folded before Flop (didn't bet)
Seat 4: PlayTheBlues4U (small blind) collected ($1.42)
Seat 5: Wooly510 (big blind) folded before Flop
Seat 6: DemolishIT folded on the Flop


*********** # 4 **************
PokerStars Hand #204330103400:  Hold'em No Limit ($0.01/$0.02 USD) - 2019/10/07 20:31:39 ET
Table 'Ara' 6-max Seat #5 is the button
Seat 2: Wooly510 ($2.01 in chips)
Seat 5: kevkevmoney ($3.09 in chips)
Seat 6: PlayTheBlues4U ($1.98 in chips)
PlayTheBlues4U: posts small blind $0.01
Wooly510: posts big blind $0.02
delm44: sits out
*** HOLE CARDS ***
Dealt to PlayTheBlues4U [8c 4d]
kevkevmoney: calls $0.02
PlayTheBlues4U: folds
Wooly510: checks
*** FLOP *** [5h 7h 3d]
PlayTheBlues4U leaves the table
Wooly510: bets $0.03
kevkevmoney: raises $0.03 to $0.06
DaGoodz33 joins the table at seat #6
Wooly510: calls $0.03
*** TURN *** [5h 7h 3d] [2c]
Wooly510: bets $0.02
kevkevmoney: calls $0.02
*** RIVER *** [5h 7h 3d 2c] [6s]
Wooly510: checks
kevkevmoney: checks
*** SHOW DOWN ***
Wooly510: shows [7d Kc] (a pair of Sevens)
kevkevmoney: mucks hand
Wooly510 collected $0.20 from pot
*** SUMMARY ***
Total pot $0.21 | Rake $0.01
Board [5h 7h 3d 2c 6s]
Seat 2: Wooly510 (big blind) showed [7d Kc] and won ($0.20) with a pair of Sevens
Seat 5: kevkevmoney (button) mucked [5c Ts]
Seat 6: PlayTheBlues4U (small blind) folded before Flop


*********** # 5 **************
PokerStars Hand #204330103262:  Hold'em No Limit ($0.02/$0.05 USD) - 2019/10/07 20:30:53 ET
Table 'Fides' 6-max Seat #4 is the button
Seat 1: KooKballs ($7.99 in chips)
Seat 2: Wooly510 ($4.83 in chips)
Seat 3: dcami_nj ($10.06 in chips)
Seat 4: DaGoodz33 ($6.68 in chips)
Seat 5: stock501402 ($8.03 in chips)
Seat 6: PlayTheBlues4U ($6.11 in chips)
stock501402: posts small blind $0.02
PlayTheBlues4U: posts big blind $0.05
*** HOLE CARDS ***
Dealt to PlayTheBlues4U [Th Ac]
KooKballs: raises $0.10 to $0.15
Wooly510: folds
dcami_nj: folds
DaGoodz33: calls $0.15
stock501402: calls $0.13
PlayTheBlues4U: calls $0.10
*** FLOP *** [Jc Jh Qh]
stock501402: bets $0.05
PlayTheBlues4U: folds
KooKballs: calls $0.05
DaGoodz33: folds
*** TURN *** [Jc Jh Qh] [4c]
stock501402: checks
KooKballs: checks
*** RIVER *** [Jc Jh Qh 4c] [Qc]
stock501402: checks
KooKballs: checks
*** SHOW DOWN ***
stock501402: shows [Js 4h] (a full house, Jacks full of Queens)
KooKballs: mucks hand
stock501402 collected $0.66 from pot
*** SUMMARY ***
Total pot $0.70 | Rake $0.04
Board [Jc Jh Qh 4c Qc]
Seat 1: KooKballs mucked [7d 7s]
Seat 2: Wooly510 folded before Flop (didn't bet)
Seat 3: dcami_nj folded before Flop (didn't bet)
Seat 4: DaGoodz33 (button) folded on the Flop
Seat 5: stock501402 (small blind) showed [Js 4h] and won ($0.66) with a full house, Jacks full of Queens
Seat 6: PlayTheBlues4U (big blind) folded on the Flop


*********** # 6 **************
PokerStars Hand #204330103254:  Hold'em No Limit ($0.02/$0.05 USD) - 2019/10/07 20:30:50 ET
Table 'Sculptor' 6-max Seat #1 is the button
Seat 1: cladams73 ($3.87 in chips)
Seat 2: R@ngers94 ($1.40 in chips)
Seat 3: skillzplumber ($7.39 in chips)
Seat 4: PlayTheBlues4U ($5.52 in chips)
Seat 5: Wooly510 ($8.07 in chips)
Seat 6: DemolishIT ($4 in chips)
R@ngers94: posts small blind $0.02
skillzplumber: posts big blind $0.05
DemolishIT: posts small blind $0.02
*** HOLE CARDS ***
Dealt to PlayTheBlues4U [Jd Jh]
PlayTheBlues4U: raises $0.15 to $0.20
Wooly510: calls $0.20
DemolishIT: raises $0.85 to $1.05
cladams73: folds
R@ngers94: raises $0.35 to $1.40 and is all-in
skillzplumber: folds
PlayTheBlues4U: raises $4.12 to $5.52 and is all-in
Wooly510: folds
DemolishIT: calls $2.93 and is all-in
Uncalled bet ($1.54) returned to PlayTheBlues4U
*** FLOP *** [5h Kd 7d]
*** TURN *** [5h Kd 7d] [Th]
*** RIVER *** [5h Kd 7d Th] [2h]
*** SHOW DOWN ***
PlayTheBlues4U: shows [Jd Jh] (a pair of Jacks)
DemolishIT: shows [Kh Ah] (a flush, Ace high)
DemolishIT collected $4.90 from side pot
R@ngers94: shows [7h 7c] (three of a kind, Sevens)
DemolishIT collected $4.25 from main pot
*** SUMMARY ***
Total pot $9.63 Main pot $4.25. Side pot $4.90. | Rake $0.48
Board [5h Kd 7d Th 2h]
Seat 1: cladams73 (button) folded before Flop (didn't bet)
Seat 2: R@ngers94 (small blind) showed [7h 7c] and lost with three of a kind, Sevens
Seat 3: skillzplumber (big blind) folded before Flop
Seat 4: PlayTheBlues4U showed [Jd Jh] and lost with a pair of Jacks
Seat 5: Wooly510 folded before Flop
Seat 6: DemolishIT showed [Kh Ah] and won ($9.15) with a flush, Ace high


*********** # 7 **************
PokerStars Hand #204330103251:  Hold'em No Limit ($0.01/$0.02 USD) - 2019/10/07 20:30:48 ET
Table 'Ara' 6-max Seat #4 is the button
Seat 2: Wooly510 ($2.01 in chips)
Seat 4: GTMuldoon ($1.29 in chips)
Seat 5: kevkevmoney ($3.07 in chips)
Seat 6: PlayTheBlues4U ($2 in chips)
kevkevmoney: posts small blind $0.01
PlayTheBlues4U: posts big blind $0.02
*** HOLE CARDS ***
Dealt to PlayTheBlues4U [Ks 5h]
Wooly510: folds
GTMuldoon: folds
kevkevmoney: calls $0.01
PlayTheBlues4U: checks
*** FLOP *** [Jh 5s 2c]
kevkevmoney: bets $0.05
GTMuldoon leaves the table
delm44 joins the table at seat #4
PlayTheBlues4U: folds
Uncalled bet ($0.05) returned to kevkevmoney
kevkevmoney collected $0.04 from pot
kevkevmoney: doesn't show hand
*** SUMMARY ***
Total pot $0.04 | Rake $0
Board [Jh 5s 2c]
Seat 2: Wooly510 folded before Flop (didn't bet)
Seat 4: GTMuldoon (button) folded before Flop (didn't bet)
Seat 5: kevkevmoney (small blind) collected ($0.04)
Seat 6: PlayTheBlues4U (big blind) folded on the Flop


*********** # 8 **************
PokerStars Hand #204330103168:  Hold'em No Limit ($0.02/$0.05 USD) - 2019/10/07 20:30:19 ET
Table 'Sculptor' 6-max Seat #5 is the button
Seat 1: cladams73 ($4.17 in chips)
Seat 2: R@ngers94 ($1.13 in chips)
Seat 3: skillzplumber ($7.39 in chips)
Seat 4: PlayTheBlues4U ($5.52 in chips)
Seat 5: Wooly510 ($8.07 in chips)
cladams73: posts small blind $0.02
R@ngers94: posts big blind $0.05
*** HOLE CARDS ***
Dealt to PlayTheBlues4U [5d 8s]
skillzplumber: folds
PlayTheBlues4U: folds
Wooly510: folds
cladams73: calls $0.03
R@ngers94: raises $0.10 to $0.15
cladams73: calls $0.10
*** FLOP *** [Ts 8h Ac]
cladams73: checks
R@ngers94: bets $0.15
cladams73: calls $0.15
*** TURN *** [Ts 8h Ac] [9d]
cladams73: checks
R@ngers94: bets $0.83 and is all-in
cladams73: folds
Uncalled bet ($0.83) returned to R@ngers94
R@ngers94 collected $0.57 from pot
R@ngers94: doesn't show hand
*** SUMMARY ***
Total pot $0.60 | Rake $0.03
Board [Ts 8h Ac 9d]
Seat 1: cladams73 (small blind) folded on the Turn
Seat 2: R@ngers94 (big blind) collected ($0.57)
Seat 3: skillzplumber folded before Flop (didn't bet)
Seat 4: PlayTheBlues4U folded before Flop (didn't bet)
Seat 5: Wooly510 (button) folded before Flop (didn't bet)


*********** # 9 **************
PokerStars Hand #204330103109:  Hold'em No Limit ($0.02/$0.05 USD) - 2019/10/07 20:29:59 ET
Table 'Sculptor' 6-max Seat #4 is the button
Seat 1: cladams73 ($4.17 in chips)
Seat 2: R@ngers94 ($1.18 in chips)
Seat 3: skillzplumber ($5.91 in chips)
Seat 4: PlayTheBlues4U ($5.52 in chips)
Seat 5: Wooly510 ($8.09 in chips)
Seat 6: DemolishIT ($1.57 in chips)
Wooly510: posts small blind $0.02
DemolishIT: posts big blind $0.05
*** HOLE CARDS ***
Dealt to PlayTheBlues4U [5s 9h]
cladams73: folds
R@ngers94: calls $0.05
skillzplumber: raises $5.86 to $5.91 and is all-in
PlayTheBlues4U: folds
Wooly510: folds
DemolishIT: calls $1.52 and is all-in
R@ngers94: folds
Uncalled bet ($4.34) returned to skillzplumber
*** FLOP *** [3c 6c 4h]
*** TURN *** [3c 6c 4h] [2s]
*** RIVER *** [3c 6c 4h 2s] [Jc]
*** SHOW DOWN ***
DemolishIT: shows [9d Ad] (high card Ace)
skillzplumber: shows [Td Th] (a pair of Tens)
skillzplumber collected $3.05 from pot
*** SUMMARY ***
Total pot $3.21 | Rake $0.16
Board [3c 6c 4h 2s Jc]
Seat 1: cladams73 folded before Flop (didn't bet)
Seat 2: R@ngers94 folded before Flop
Seat 3: skillzplumber showed [Td Th] and won ($3.05) with a pair of Tens
Seat 4: PlayTheBlues4U (button) folded before Flop (didn't bet)
Seat 5: Wooly510 (small blind) folded before Flop
Seat 6: DemolishIT (big blind) showed [9d Ad] and lost with high card Ace


*********** # 10 **************
PokerStars Hand #204330103102:  Hold'em No Limit ($0.02/$0.05 USD) - 2019/10/07 20:29:57 ET
Table 'Fides' 6-max Seat #3 is the button
Seat 1: KooKballs ($8.74 in chips)
Seat 2: Wooly510 ($4.83 in chips)
Seat 3: dcami_nj ($9.32 in chips)
Seat 4: DaGoodz33 ($6.70 in chips)
Seat 5: stock501402 ($8.08 in chips)
Seat 6: PlayTheBlues4U ($6.11 in chips)
DaGoodz33: posts small blind $0.02
stock501402: posts big blind $0.05
*** HOLE CARDS ***
Dealt to PlayTheBlues4U [4h Jd]
PlayTheBlues4U: folds
KooKballs: raises $0.10 to $0.15
Wooly510: folds
dcami_nj: calls $0.15
DaGoodz33: folds
stock501402: folds
*** FLOP *** [5d 7c 5c]
KooKballs: bets $0.20
dcami_nj: calls $0.20
*** TURN *** [5d 7c 5c] [Qs]
KooKballs: checks
dcami_nj: bets $0.40
KooKballs: calls $0.40
*** RIVER *** [5d 7c 5c Qs] [8s]
KooKballs: checks
dcami_nj: bets $0.75
KooKballs: folds
Uncalled bet ($0.75) returned to dcami_nj
dcami_nj collected $1.49 from pot
dcami_nj: doesn't show hand
*** SUMMARY ***
Total pot $1.57 | Rake $0.08
Board [5d 7c 5c Qs 8s]
Seat 1: KooKballs folded on the River
Seat 2: Wooly510 folded before Flop (didn't bet)
Seat 3: dcami_nj (button) collected ($1.49)
Seat 4: DaGoodz33 (small blind) folded before Flop
Seat 5: stock501402 (big blind) folded before Flop
Seat 6: PlayTheBlues4U folded before Flop (didn't bet)


*********** # 11 **************
PokerStars Hand #204330103042:  Hold'em No Limit ($0.02/$0.05 USD) - 2019/10/07 20:29:36 ET
Table 'Fides' 6-max Seat #2 is the button
Seat 1: KooKballs ($8.74 in chips)
Seat 2: Wooly510 ($4.76 in chips)
Seat 3: dcami_nj ($9.34 in chips)
Seat 4: DaGoodz33 ($6.75 in chips)
Seat 6: PlayTheBlues4U ($6.11 in chips)
dcami_nj: posts small blind $0.02
DaGoodz33: posts big blind $0.05
*** HOLE CARDS ***
Dealt to PlayTheBlues4U [7h 8h]
PlayTheBlues4U: folds
KooKballs: folds
Wooly510: raises $0.10 to $0.15
dcami_nj: folds
DaGoodz33: folds
Uncalled bet ($0.10) returned to Wooly510
Wooly510 collected $0.12 from pot
Wooly510: doesn't show hand
*** SUMMARY ***
Total pot $0.12 | Rake $0
Seat 1: KooKballs folded before Flop (didn't bet)
Seat 2: Wooly510 (button) collected ($0.12)
Seat 3: dcami_nj (small blind) folded before Flop
Seat 4: DaGoodz33 (big blind) folded before Flop
Seat 6: PlayTheBlues4U folded before Flop (didn't bet)


*********** # 12 **************
PokerStars Hand #204330102974:  Hold'em No Limit ($0.02/$0.05 USD) - 2019/10/07 20:29:10 ET
Table 'Sculptor' 6-max Seat #3 is the button
Seat 1: cladams73 ($4.03 in chips)
Seat 2: R@ngers94 ($1.18 in chips)
Seat 3: skillzplumber ($5.96 in chips)
Seat 4: PlayTheBlues4U ($5.57 in chips)
Seat 5: Wooly510 ($8.14 in chips)
Seat 6: DemolishIT ($1.57 in chips)
PlayTheBlues4U: posts small blind $0.02
Wooly510: posts big blind $0.05
*** HOLE CARDS ***
Dealt to PlayTheBlues4U [6d 9d]
DemolishIT: folds
cladams73: calls $0.05
R@ngers94: folds
skillzplumber: calls $0.05
PlayTheBlues4U: calls $0.03
Wooly510: checks
*** FLOP *** [Ac 5c Td]
PlayTheBlues4U: checks
Wooly510: checks
cladams73: checks
skillzplumber: checks
*** TURN *** [Ac 5c Td] [Ah]
PlayTheBlues4U: checks
Wooly510: checks
cladams73: bets $0.20
skillzplumber: folds
PlayTheBlues4U: folds
Wooly510: folds
Uncalled bet ($0.20) returned to cladams73
cladams73 collected $0.19 from pot
*** SUMMARY ***
Total pot $0.20 | Rake $0.01
Board [Ac 5c Td Ah]
Seat 1: cladams73 collected ($0.19)
Seat 2: R@ngers94 folded before Flop (didn't bet)
Seat 3: skillzplumber (button) folded on the Turn
Seat 4: PlayTheBlues4U (small blind) folded on the Turn
Seat 5: Wooly510 (big blind) folded on the Turn
Seat 6: DemolishIT folded before Flop (didn't bet)


*********** # 13 **************
PokerStars Hand #204330102900:  Hold'em No Limit ($0.02/$0.05 USD) - 2019/10/07 20:28:45 ET
Table 'Sculptor' 6-max Seat #2 is the button
Seat 1: cladams73 ($4.03 in chips)
Seat 2: R@ngers94 ($1.18 in chips)
Seat 3: skillzplumber ($5.98 in chips)
Seat 4: PlayTheBlues4U ($5.51 in chips)
Seat 5: Wooly510 ($8.14 in chips)
Seat 6: DemolishIT ($1.62 in chips)
skillzplumber: posts small blind $0.02
PlayTheBlues4U: posts big blind $0.05
*** HOLE CARDS ***
Dealt to PlayTheBlues4U [5h Ac]
Wooly510: folds
DemolishIT: calls $0.05
cladams73: folds
R@ngers94: folds
skillzplumber: folds
PlayTheBlues4U: checks
*** FLOP *** [Kh 2s 7d]
PlayTheBlues4U: checks
DemolishIT: checks
*** TURN *** [Kh 2s 7d] [Kc]
PlayTheBlues4U: checks
DemolishIT: checks
*** RIVER *** [Kh 2s 7d Kc] [9c]
PlayTheBlues4U: checks
skillzplumber said, "these fuc. king str8s"
DemolishIT: checks
*** SHOW DOWN ***
PlayTheBlues4U: shows [5h Ac] (a pair of Kings)
DemolishIT: mucks hand
PlayTheBlues4U collected $0.11 from pot
*** SUMMARY ***
Total pot $0.12 | Rake $0.01
Board [Kh 2s 7d Kc 9c]
Seat 1: cladams73 folded before Flop (didn't bet)
Seat 2: R@ngers94 (button) folded before Flop (didn't bet)
Seat 3: skillzplumber (small blind) folded before Flop
Seat 4: PlayTheBlues4U (big blind) showed [5h Ac] and won ($0.11) with a pair of Kings
Seat 5: Wooly510 folded before Flop (didn't bet)
Seat 6: DemolishIT mucked [Tc Qh]


*********** # 14 **************
PokerStars Hand #204330102819:  Hold'em No Limit ($0.02/$0.05 USD) - 2019/10/07 20:28:18 ET
Table 'Fides' 6-max Seat #1 is the button
Seat 1: KooKballs ($9.04 in chips)
Seat 2: Wooly510 ($4.78 in chips)
Seat 3: dcami_nj ($9.05 in chips)
Seat 5: stock501402 ($8.08 in chips)
Seat 6: PlayTheBlues4U ($6.11 in chips)
Wooly510: posts small blind $0.02
dcami_nj: posts big blind $0.05
*** HOLE CARDS ***
Dealt to PlayTheBlues4U [9c 3c]
DaGoodz33 joins the table at seat #4
stock501402 has timed out while being disconnected
stock501402: folds
PlayTheBlues4U: folds
stock501402 is disconnected
KooKballs: raises $0.10 to $0.15
Wooly510: folds
dcami_nj: calls $0.10
*** FLOP *** [9h 8c Qh]
dcami_nj: checks
KooKballs: checks
*** TURN *** [9h 8c Qh] [8h]
dcami_nj: bets $0.15
KooKballs: calls $0.15
*** RIVER *** [9h 8c Qh 8h] [5d]
dcami_nj: bets $0.40
KooKballs: folds
Uncalled bet ($0.40) returned to dcami_nj
dcami_nj collected $0.59 from pot
dcami_nj: doesn't show hand
*** SUMMARY ***
Total pot $0.62 | Rake $0.03
Board [9h 8c Qh 8h 5d]
Seat 1: KooKballs (button) folded on the River
Seat 2: Wooly510 (small blind) folded before Flop
Seat 3: dcami_nj (big blind) collected ($0.59)
Seat 5: stock501402 folded before Flop (didn't bet)
Seat 6: PlayTheBlues4U folded before Flop (didn't bet)


*********** # 15 **************
PokerStars Hand #204330102784:  Hold'em No Limit ($0.02/$0.05 USD) - 2019/10/07 20:28:07 ET
Table 'Fides' 6-max Seat #6 is the button
Seat 1: KooKballs ($8.99 in chips)
Seat 2: Wooly510 ($4.83 in chips)
Seat 3: dcami_nj ($9.05 in chips)
Seat 5: stock501402 ($8.08 in chips)
Seat 6: PlayTheBlues4U ($6.11 in chips)
KooKballs: posts small blind $0.02
Wooly510: posts big blind $0.05
*** HOLE CARDS ***
Dealt to PlayTheBlues4U [4s 5d]
dcami_nj: folds
stock501402: folds
PlayTheBlues4U: folds
KooKballs: raises $0.10 to $0.15
Wooly510: folds
Uncalled bet ($0.10) returned to KooKballs
KooKballs collected $0.10 from pot
KooKballs: doesn't show hand
*** SUMMARY ***
Total pot $0.10 | Rake $0
Seat 1: KooKballs (small blind) collected ($0.10)
Seat 2: Wooly510 (big blind) folded before Flop
Seat 3: dcami_nj folded before Flop (didn't bet)
Seat 5: stock501402 folded before Flop (didn't bet)
Seat 6: PlayTheBlues4U (button) folded before Flop (didn't bet)


*********** # 16 **************
PokerStars Hand #204330102738:  Hold'em No Limit ($0.02/$0.05 USD) - 2019/10/07 20:27:51 ET
Table 'Sculptor' 6-max Seat #1 is the button
Seat 1: cladams73 ($3.57 in chips)
Seat 2: R@ngers94 ($1.28 in chips)
Seat 3: skillzplumber ($6.38 in chips)
Seat 4: PlayTheBlues4U ($5.51 in chips)
Seat 5: Wooly510 ($8.14 in chips)
Seat 6: DemolishIT ($1.62 in chips)
R@ngers94: posts small blind $0.02
skillzplumber: posts big blind $0.05
*** HOLE CARDS ***
Dealt to PlayTheBlues4U [Js Td]
PlayTheBlues4U: folds
Wooly510: folds
DemolishIT: folds
cladams73: calls $0.05
R@ngers94: calls $0.03
skillzplumber: checks
*** FLOP *** [Ks Jh 9h]
R@ngers94: bets $0.05
skillzplumber: calls $0.05
cladams73: calls $0.05
*** TURN *** [Ks Jh 9h] [Tc]
R@ngers94: checks
skillzplumber: checks
cladams73: bets $0.30
R@ngers94: folds
skillzplumber: calls $0.30
*** RIVER *** [Ks Jh 9h Tc] [4h]
skillzplumber: checks
cladams73: checks
*** SHOW DOWN ***
skillzplumber: shows [Kc 8s] (a pair of Kings)
cladams73: shows [Qh Jd] (a straight, Nine to King)
cladams73 collected $0.86 from pot
*** SUMMARY ***
Total pot $0.90 | Rake $0.04
Board [Ks Jh 9h Tc 4h]
Seat 1: cladams73 (button) showed [Qh Jd] and won ($0.86) with a straight, Nine to King
Seat 2: R@ngers94 (small blind) folded on the Turn
Seat 3: skillzplumber (big blind) showed [Kc 8s] and lost with a pair of Kings
Seat 4: PlayTheBlues4U folded before Flop (didn't bet)
Seat 5: Wooly510 folded before Flop (didn't bet)
Seat 6: DemolishIT folded before Flop (didn't bet)


*********** # 17 **************
PokerStars Hand #204330102661:  Hold'em No Limit ($0.02/$0.05 USD) - 2019/10/07 20:27:26 ET
Table 'Sculptor' 6-max Seat #6 is the button
Seat 1: cladams73 ($3.72 in chips)
Seat 2: R@ngers94 ($1.33 in chips)
Seat 3: skillzplumber ($6.38 in chips)
Seat 4: PlayTheBlues4U ($5.51 in chips)
Seat 5: Wooly510 ($8.14 in chips)
Seat 6: DemolishIT ($1.44 in chips)
cladams73: posts small blind $0.02
R@ngers94: posts big blind $0.05
*** HOLE CARDS ***
Dealt to PlayTheBlues4U [5c 9s]
skillzplumber: folds
PlayTheBlues4U: folds
Wooly510: folds
DemolishIT: raises $0.10 to $0.15
cladams73: calls $0.13
R@ngers94: folds
*** FLOP *** [Qd 6d 4s]
cladams73: checks
DemolishIT: checks
*** TURN *** [Qd 6d 4s] [6s]
cladams73: checks
DemolishIT: bets $0.33
cladams73: folds
Uncalled bet ($0.33) returned to DemolishIT
DemolishIT collected $0.33 from pot
DemolishIT: doesn't show hand
*** SUMMARY ***
Total pot $0.35 | Rake $0.02
Board [Qd 6d 4s 6s]
Seat 1: cladams73 (small blind) folded on the Turn
Seat 2: R@ngers94 (big blind) folded before Flop
Seat 3: skillzplumber folded before Flop (didn't bet)
Seat 4: PlayTheBlues4U folded before Flop (didn't bet)
Seat 5: Wooly510 folded before Flop (didn't bet)
Seat 6: DemolishIT (button) collected ($0.33)


*********** # 18 **************
PokerStars Hand #204330102643:  Hold'em No Limit ($0.02/$0.05 USD) - 2019/10/07 20:27:19 ET
Table 'Fides' 6-max Seat #5 is the button
Seat 1: KooKballs ($9.14 in chips)
Seat 2: Wooly510 ($4.83 in chips)
Seat 3: dcami_nj ($7.45 in chips)
Seat 5: stock501402 ($9.68 in chips)
Seat 6: PlayTheBlues4U ($6.13 in chips)
PlayTheBlues4U: posts small blind $0.02
KooKballs: posts big blind $0.05
*** HOLE CARDS ***
Dealt to PlayTheBlues4U [8h Kc]
Wooly510: folds
dcami_nj: raises $0.10 to $0.15
stock501402: calls $0.15
PlayTheBlues4U: folds
KooKballs: calls $0.10
*** FLOP *** [8s 7h 7s]
KooKballs: checks
dcami_nj: bets $0.35
stock501402: calls $0.35
KooKballs: folds
*** TURN *** [8s 7h 7s] [Ad]
dcami_nj: bets $0.55
stock501402: raises $0.55 to $1.10
dcami_nj: calls $0.55
*** RIVER *** [8s 7h 7s Ad] [2c]
dcami_nj: checks
stock501402: checks
*** SHOW DOWN ***
dcami_nj: shows [9s Ac] (two pair, Aces and Sevens)
stock501402: mucks hand
dcami_nj collected $3.20 from pot
*** SUMMARY ***
Total pot $3.37 | Rake $0.17
Board [8s 7h 7s Ad 2c]
Seat 1: KooKballs (big blind) folded on the Flop
Seat 2: Wooly510 folded before Flop (didn't bet)
Seat 3: dcami_nj showed [9s Ac] and won ($3.20) with two pair, Aces and Sevens
Seat 5: stock501402 (button) mucked [Ts 6s]
Seat 6: PlayTheBlues4U (small blind) folded before Flop


*********** # 19 **************
PokerStars Hand #204330102533:  Hold'em No Limit ($0.02/$0.05 USD) - 2019/10/07 20:26:41 ET
Table 'Fides' 6-max Seat #4 is the button
Seat 1: KooKballs ($9.14 in chips)
Seat 2: Wooly510 ($4.83 in chips)
Seat 3: dcami_nj ($7.30 in chips)
Seat 4: richy5742 ($4.03 in chips)
Seat 5: stock501402 ($9.70 in chips)
Seat 6: PlayTheBlues4U ($6.28 in chips)
stock501402: posts small blind $0.02
PlayTheBlues4U: posts big blind $0.05
*** HOLE CARDS ***
Dealt to PlayTheBlues4U [2h 5h]
KooKballs: folds
Wooly510: folds
dcami_nj: raises $0.10 to $0.15
richy5742: folds
stock501402: folds
richy5742 leaves the table
PlayTheBlues4U: calls $0.10
*** FLOP *** [Jc Ah 3c]
PlayTheBlues4U: checks
dcami_nj: bets $0.20
PlayTheBlues4U: folds
Uncalled bet ($0.20) returned to dcami_nj
dcami_nj collected $0.30 from pot
dcami_nj: doesn't show hand
*** SUMMARY ***
Total pot $0.32 | Rake $0.02
Board [Jc Ah 3c]
Seat 1: KooKballs folded before Flop (didn't bet)
Seat 2: Wooly510 folded before Flop (didn't bet)
Seat 3: dcami_nj collected ($0.30)
Seat 4: richy5742 (button) folded before Flop (didn't bet)
Seat 5: stock501402 (small blind) folded before Flop
Seat 6: PlayTheBlues4U (big blind) folded on the Flop


*********** # 20 **************
PokerStars Hand #204330102513:  Hold'em No Limit ($0.02/$0.05 USD) - 2019/10/07 20:26:34 ET
Table 'Sculptor' 6-max Seat #5 is the button
Seat 1: cladams73 ($3.89 in chips)
Seat 2: R@ngers94 ($1.50 in chips)
Seat 3: skillzplumber ($6.38 in chips)
Seat 4: PlayTheBlues4U ($5.51 in chips)
Seat 5: Wooly510 ($7.37 in chips)
Seat 6: DemolishIT ($1.94 in chips)
DemolishIT: posts small blind $0.02
cladams73: posts big blind $0.05
*** HOLE CARDS ***
Dealt to PlayTheBlues4U [9h 7h]
R@ngers94: raises $0.12 to $0.17
skillzplumber: folds
PlayTheBlues4U: folds
Wooly510: calls $0.17
DemolishIT: calls $0.15
cladams73: calls $0.12
*** FLOP *** [Jc 5s Qh]
DemolishIT: checks
cladams73: checks
R@ngers94: checks
Wooly510: checks
*** TURN *** [Jc 5s Qh] [8s]
DemolishIT: checks
cladams73: checks
R@ngers94: checks
Wooly510: bets $0.33
DemolishIT: calls $0.33
cladams73: folds
R@ngers94: folds
*** RIVER *** [Jc 5s Qh 8s] [2c]
DemolishIT: checks
Wooly510: checks
*** SHOW DOWN ***
DemolishIT: shows [9c 8d] (a pair of Eights)
Wooly510: shows [Ac Jh] (a pair of Jacks)
Wooly510 collected $1.27 from pot
*** SUMMARY ***
Total pot $1.34 | Rake $0.07
Board [Jc 5s Qh 8s 2c]
Seat 1: cladams73 (big blind) folded on the Turn
Seat 2: R@ngers94 folded on the Turn
Seat 3: skillzplumber folded before Flop (didn't bet)
Seat 4: PlayTheBlues4U folded before Flop (didn't bet)
Seat 5: Wooly510 (button) showed [Ac Jh] and won ($1.27) with a pair of Jacks
Seat 6: DemolishIT (small blind) showed [9c 8d] and lost with a pair of Eights


*********** # 21 **************
PokerStars Hand #204330102454:  Hold'em No Limit ($0.02/$0.05 USD) - 2019/10/07 20:26:08 ET
Table 'Sculptor' 6-max Seat #4 is the button
Seat 1: cladams73 ($3.94 in chips)
Seat 2: R@ngers94 ($4.80 in chips)
Seat 3: skillzplumber ($3.30 in chips)
Seat 4: PlayTheBlues4U ($5.51 in chips)
Seat 5: Wooly510 ($7.39 in chips)
Seat 6: DemolishIT ($1.99 in chips)
Wooly510: posts small blind $0.02
DemolishIT: posts big blind $0.05
*** HOLE CARDS ***
Dealt to PlayTheBlues4U [Jd 7c]
cladams73: calls $0.05
R@ngers94: raises $0.10 to $0.15
skillzplumber: raises $3.15 to $3.30 and is all-in
PlayTheBlues4U: folds
Wooly510: folds
DemolishIT: folds
skillzplumber said, "legoo"
cladams73: folds
R@ngers94: calls $3.15
*** FLOP *** [Ks 5d 3s]
*** TURN *** [Ks 5d 3s] [9d]
*** RIVER *** [Ks 5d 3s 9d] [4h]
*** SHOW DOWN ***
R@ngers94: shows [Jh Ah] (high card Ace)
skillzplumber: shows [7d 7h] (a pair of Sevens)
skillzplumber collected $6.38 from pot
*** SUMMARY ***
Total pot $6.72 | Rake $0.34
Board [Ks 5d 3s 9d 4h]
Seat 1: cladams73 folded before Flop
Seat 2: R@ngers94 showed [Jh Ah] and lost with high card Ace
Seat 3: skillzplumber showed [7d 7h] and won ($6.38) with a pair of Sevens
Seat 4: PlayTheBlues4U (button) folded before Flop (didn't bet)
Seat 5: Wooly510 (small blind) folded before Flop
Seat 6: DemolishIT (big blind) folded before Flop


*********** # 22 **************
PokerStars Hand #204330102399:  Hold'em No Limit ($0.02/$0.05 USD) - 2019/10/07 20:25:43 ET
Table 'Sculptor' 6-max Seat #3 is the button
Seat 1: cladams73 ($3.94 in chips)
Seat 2: R@ngers94 ($4.80 in chips)
Seat 3: skillzplumber ($3.94 in chips)
Seat 4: PlayTheBlues4U ($5.53 in chips)
Seat 5: Wooly510 ($7.44 in chips)
Seat 6: DemolishIT ($1.01 in chips)
PlayTheBlues4U: posts small blind $0.02
Wooly510: posts big blind $0.05
*** HOLE CARDS ***
Dealt to PlayTheBlues4U [Qs 8d]
DemolishIT: raises $0.20 to $0.25
cladams73: folds
R@ngers94: folds
skillzplumber: raises $3.69 to $3.94 and is all-in
PlayTheBlues4U: folds
Wooly510: folds
DemolishIT: calls $0.76 and is all-in
Uncalled bet ($2.93) returned to skillzplumber
*** FLOP *** [Jd 7d Tc]
*** TURN *** [Jd 7d Tc] [Ks]
*** RIVER *** [Jd 7d Tc Ks] [9d]
*** SHOW DOWN ***
DemolishIT: shows [Qc Ad] (a straight, Ten to Ace)
skillzplumber: shows [5c 5d] (a pair of Fives)
DemolishIT collected $1.99 from pot
*** SUMMARY ***
Total pot $2.09 | Rake $0.10
Board [Jd 7d Tc Ks 9d]
Seat 1: cladams73 folded before Flop (didn't bet)
Seat 2: R@ngers94 folded before Flop (didn't bet)
Seat 3: skillzplumber (button) showed [5c 5d] and lost with a pair of Fives
Seat 4: PlayTheBlues4U (small blind) folded before Flop
Seat 5: Wooly510 (big blind) folded before Flop
Seat 6: DemolishIT showed [Qc Ad] and won ($1.99) with a straight, Ten to Ace


*********** # 23 **************
PokerStars Hand #204330102344:  Hold'em No Limit ($0.02/$0.05 USD) - 2019/10/07 20:25:20 ET
Table 'Sculptor' 6-max Seat #2 is the button
Seat 1: cladams73 ($3.80 in chips)
Seat 2: R@ngers94 ($4.85 in chips)
Seat 3: skillzplumber ($3.99 in chips)
Seat 4: PlayTheBlues4U ($5.58 in chips)
Seat 5: Wooly510 ($7.44 in chips)
Seat 6: DemolishIT ($1.01 in chips)
skillzplumber: posts small blind $0.02
PlayTheBlues4U: posts big blind $0.05
*** HOLE CARDS ***
Dealt to PlayTheBlues4U [Qs 2s]
Wooly510: folds
DemolishIT: folds
PlayTheBlues4U said, "always nice to flop the straight"
cladams73: calls $0.05
R@ngers94: calls $0.05
skillzplumber: calls $0.03
PlayTheBlues4U: checks
*** FLOP *** [3s 8c Jh]
skillzplumber: checks
PlayTheBlues4U: checks
cladams73: bets $0.20
R@ngers94: folds
skillzplumber: folds
PlayTheBlues4U: folds
Uncalled bet ($0.20) returned to cladams73
cladams73 collected $0.19 from pot
*** SUMMARY ***
Total pot $0.20 | Rake $0.01
Board [3s 8c Jh]
Seat 1: cladams73 collected ($0.19)
Seat 2: R@ngers94 (button) folded on the Flop
Seat 3: skillzplumber (small blind) folded on the Flop
Seat 4: PlayTheBlues4U (big blind) folded on the Flop
Seat 5: Wooly510 folded before Flop (didn't bet)
Seat 6: DemolishIT folded before Flop (didn't bet)


*********** # 24 **************
PokerStars Hand #204330102302:  Hold'em No Limit ($0.02/$0.05 USD) - 2019/10/07 20:25:03 ET
Table 'Sculptor' 6-max Seat #1 is the button
Seat 1: cladams73 ($3.85 in chips)
Seat 2: R@ngers94 ($4.90 in chips)
Seat 3: skillzplumber ($3.89 in chips)
Seat 4: PlayTheBlues4U ($5.58 in chips)
Seat 5: Wooly510 ($7.44 in chips)
Seat 6: DemolishIT ($1.01 in chips)
R@ngers94: posts small blind $0.02
skillzplumber: posts big blind $0.05
*** HOLE CARDS ***
Dealt to PlayTheBlues4U [2d Ac]
PlayTheBlues4U: folds
Wooly510: folds
DemolishIT: folds
cladams73: calls $0.05
R@ngers94: calls $0.03
skillzplumber: raises $3.84 to $3.89 and is all-in
cladams73: folds
R@ngers94: folds
Uncalled bet ($3.84) returned to skillzplumber
skillzplumber collected $0.15 from pot
skillzplumber: doesn't show hand
*** SUMMARY ***
Total pot $0.15 | Rake $0
Seat 1: cladams73 (button) folded before Flop
Seat 2: R@ngers94 (small blind) folded before Flop
Seat 3: skillzplumber (big blind) collected ($0.15)
Seat 4: PlayTheBlues4U folded before Flop (didn't bet)
Seat 5: Wooly510 folded before Flop (didn't bet)
Seat 6: DemolishIT folded before Flop (didn't bet)


*********** # 25 **************
PokerStars Hand #204330102295:  Hold'em No Limit ($0.02/$0.05 USD) - 2019/10/07 20:25:01 ET
Table 'Fides' 6-max Seat #3 is the button
Seat 1: KooKballs ($9.14 in chips)
Seat 2: Wooly510 ($4.83 in chips)
Seat 3: dcami_nj ($6.39 in chips)
Seat 4: richy5742 ($4.23 in chips)
Seat 5: stock501402 ($10.50 in chips)
Seat 6: PlayTheBlues4U ($6.28 in chips)
richy5742: posts small blind $0.02
stock501402: posts big blind $0.05
*** HOLE CARDS ***
Dealt to PlayTheBlues4U [4s Js]
PlayTheBlues4U: folds
KooKballs: folds
Wooly510: folds
dcami_nj: raises $0.10 to $0.15
richy5742: calls $0.13
stock501402: calls $0.10
*** FLOP *** [Ad 6s Jd]
richy5742: checks
stock501402: bets $0.05
dcami_nj: calls $0.05
richy5742: calls $0.05
*** TURN *** [Ad 6s Jd] [Ks]
richy5742: checks
stock501402: checks
dcami_nj: bets $0.55
richy5742: folds
stock501402: calls $0.55
*** RIVER *** [Ad 6s Jd Ks] [Qs]
stock501402: bets $0.05
dcami_nj: calls $0.05
*** SHOW DOWN ***
stock501402: shows [Kh 8s] (a pair of Kings)
dcami_nj: shows [Kd Jc] (two pair, Kings and Jacks)
dcami_nj collected $1.71 from pot
*** SUMMARY ***
Total pot $1.80 | Rake $0.09
Board [Ad 6s Jd Ks Qs]
Seat 1: KooKballs folded before Flop (didn't bet)
Seat 2: Wooly510 folded before Flop (didn't bet)
Seat 3: dcami_nj (button) showed [Kd Jc] and won ($1.71) with two pair, Kings and Jacks
Seat 4: richy5742 (small blind) folded on the Turn
Seat 5: stock501402 (big blind) showed [Kh 8s] and lost with a pair of Kings
Seat 6: PlayTheBlues4U folded before Flop (didn't bet)


*********** # 26 **************
PokerStars Hand #204330102226:  Hold'em No Limit ($0.02/$0.05 USD) - 2019/10/07 20:24:35 ET
Table 'Sculptor' 6-max Seat #6 is the button
Seat 1: cladams73 ($2 in chips)
Seat 2: R@ngers94 ($4.95 in chips)
Seat 3: skillzplumber ($5.89 in chips)
Seat 4: PlayTheBlues4U ($5.58 in chips)
Seat 5: Wooly510 ($7.44 in chips)
Seat 6: DemolishIT ($1.01 in chips)
cladams73: posts small blind $0.02
R@ngers94: posts big blind $0.05
*** HOLE CARDS ***
Dealt to PlayTheBlues4U [Th Kd]
skillzplumber: raises $0.20 to $0.25
PlayTheBlues4U: folds
Wooly510: folds
DemolishIT: folds
cladams73: calls $0.23
R@ngers94: folds
*** FLOP *** [5c 4d 6d]
cladams73: bets $1.75 and is all-in
skillzplumber: calls $1.75
*** TURN *** [5c 4d 6d] [9s]
*** RIVER *** [5c 4d 6d 9s] [Ah]
*** SHOW DOWN ***
cladams73: shows [2d 3s] (a straight, Deuce to Six)
skillzplumber: shows [8c 8d] (a pair of Eights)
cladams73 collected $3.85 from pot
*** SUMMARY ***
Total pot $4.05 | Rake $0.20
Board [5c 4d 6d 9s Ah]
Seat 1: cladams73 (small blind) showed [2d 3s] and won ($3.85) with a straight, Deuce to Six
Seat 2: R@ngers94 (big blind) folded before Flop
Seat 3: skillzplumber showed [8c 8d] and lost with a pair of Eights
Seat 4: PlayTheBlues4U folded before Flop (didn't bet)
Seat 5: Wooly510 folded before Flop (didn't bet)
Seat 6: DemolishIT (button) folded before Flop (didn't bet)


*********** # 27 **************
PokerStars Hand #204330102128:  Hold'em No Limit ($0.02/$0.05 USD) - 2019/10/07 20:23:59 ET
Table 'Fides' 6-max Seat #2 is the button
Seat 1: KooKballs ($9.14 in chips)
Seat 2: Wooly510 ($4.83 in chips)
Seat 3: dcami_nj ($4.99 in chips)
Seat 4: richy5742 ($4.28 in chips)
Seat 5: stock501402 ($12 in chips)
Seat 6: PlayTheBlues4U ($6.28 in chips)
dcami_nj: posts small blind $0.02
richy5742: posts big blind $0.05
*** HOLE CARDS ***
Dealt to PlayTheBlues4U [3c Qc]
stock501402: calls $0.05
PlayTheBlues4U: folds
KooKballs: folds
Wooly510: folds
dcami_nj: calls $0.03
richy5742: checks
*** FLOP *** [3d 4c 3h]
dcami_nj: checks
richy5742: checks
stock501402: bets $0.05
dcami_nj: calls $0.05
richy5742: folds
*** TURN *** [3d 4c 3h] [9d]
dcami_nj: checks
stock501402: bets $0.10
dcami_nj: raises $0.30 to $0.40
stock501402: calls $0.30
*** RIVER *** [3d 4c 3h 9d] [Kc]
dcami_nj: bets $1
stock501402: calls $1
*** SHOW DOWN ***
dcami_nj: shows [3s 6d] (three of a kind, Threes)
stock501402: mucks hand
dcami_nj collected $2.90 from pot
*** SUMMARY ***
Total pot $3.05 | Rake $0.15
Board [3d 4c 3h 9d Kc]
Seat 1: KooKballs folded before Flop (didn't bet)
Seat 2: Wooly510 (button) folded before Flop (didn't bet)
Seat 3: dcami_nj (small blind) showed [3s 6d] and won ($2.90) with three of a kind, Threes
Seat 4: richy5742 (big blind) folded on the Flop
Seat 5: stock501402 mucked [Tc Th]
Seat 6: PlayTheBlues4U folded before Flop (didn't bet)


*********** # 28 **************
PokerStars Hand #204330102095:  Hold'em No Limit ($0.02/$0.05 USD) - 2019/10/07 20:23:46 ET
Table 'Sculptor' 6-max Seat #5 is the button
Seat 1: cladams73 ($2.15 in chips)
Seat 2: R@ngers94 ($5 in chips)
Seat 3: skillzplumber ($5.89 in chips)
Seat 4: PlayTheBlues4U ($4.55 in chips)
Seat 5: Wooly510 ($7.59 in chips)
Seat 6: DemolishIT ($1.78 in chips)
DemolishIT: posts small blind $0.02
cladams73: posts big blind $0.05
R@ngers94: posts big blind $0.05
*** HOLE CARDS ***
Dealt to PlayTheBlues4U [Td Th]
R@ngers94: checks
skillzplumber: folds
PlayTheBlues4U: raises $0.10 to $0.15
Wooly510: calls $0.15
DemolishIT: calls $0.13
cladams73: calls $0.10
R@ngers94: folds
*** FLOP *** [4s 6h 8c]
DemolishIT: bets $0.62
cladams73: folds
PlayTheBlues4U: calls $0.62
Wooly510: folds
*** TURN *** [4s 6h 8c] [2d]
DemolishIT: checks
PlayTheBlues4U: bets $1.80
DemolishIT: folds
Uncalled bet ($1.80) returned to PlayTheBlues4U
PlayTheBlues4U collected $1.80 from pot
PlayTheBlues4U: doesn't show hand
*** SUMMARY ***
Total pot $1.89 | Rake $0.09
Board [4s 6h 8c 2d]
Seat 1: cladams73 (big blind) folded on the Flop
Seat 2: R@ngers94 folded before Flop (didn't bet)
Seat 3: skillzplumber folded before Flop (didn't bet)
Seat 4: PlayTheBlues4U collected ($1.80)
Seat 5: Wooly510 (button) folded on the Flop
Seat 6: DemolishIT (small blind) folded on the Turn


*********** # 29 **************
PokerStars Hand #204330102040:  Hold'em No Limit ($0.02/$0.05 USD) - 2019/10/07 20:23:22 ET
Table 'Sculptor' 6-max Seat #4 is the button
Seat 1: cladams73 ($2.15 in chips)
Seat 3: skillzplumber ($5.89 in chips)
Seat 4: PlayTheBlues4U ($4.70 in chips)
Seat 5: Wooly510 ($7.61 in chips)
Seat 6: DemolishIT ($1.63 in chips)
Wooly510: posts small blind $0.02
DemolishIT: posts big blind $0.05
*** HOLE CARDS ***
Dealt to PlayTheBlues4U [Ad 4c]
cladams73: folds
skillzplumber: folds
R@ngers94 joins the table at seat #2
PlayTheBlues4U: raises $0.10 to $0.15
Wooly510: folds
DemolishIT: calls $0.10
*** FLOP *** [Kd Qc Th]
DemolishIT: checks
PlayTheBlues4U: checks
*** TURN *** [Kd Qc Th] [Td]
DemolishIT: checks
PlayTheBlues4U: checks
*** RIVER *** [Kd Qc Th Td] [5c]
DemolishIT: checks
PlayTheBlues4U: checks
*** SHOW DOWN ***
DemolishIT: shows [Qd 7d] (two pair, Queens and Tens)
PlayTheBlues4U: mucks hand
DemolishIT collected $0.30 from pot
*** SUMMARY ***
Total pot $0.32 | Rake $0.02
Board [Kd Qc Th Td 5c]
Seat 1: cladams73 folded before Flop (didn't bet)
Seat 3: skillzplumber folded before Flop (didn't bet)
Seat 4: PlayTheBlues4U (button) mucked [Ad 4c]
Seat 5: Wooly510 (small blind) folded before Flop
Seat 6: DemolishIT (big blind) showed [Qd 7d] and won ($0.30) with two pair, Queens and Tens


*********** # 30 **************
PokerStars Hand #204330101962:  Hold'em No Limit ($0.02/$0.05 USD) - 2019/10/07 20:22:51 ET
Table 'Fides' 6-max Seat #1 is the button
Seat 1: KooKballs ($8.82 in chips)
Seat 2: Wooly510 ($4.88 in chips)
Seat 3: dcami_nj ($5.09 in chips)
Seat 4: richy5742 ($4.28 in chips)
Seat 5: stock501402 ($12.20 in chips)
Seat 6: PlayTheBlues4U ($6.28 in chips)
Wooly510: posts small blind $0.02
dcami_nj: posts big blind $0.05
*** HOLE CARDS ***
Dealt to PlayTheBlues4U [7c Jd]
richy5742: folds
stock501402: calls $0.05
PlayTheBlues4U: folds
KooKballs: calls $0.05
Wooly510: calls $0.03
dcami_nj: checks
*** FLOP *** [2s 3d Jc]
Wooly510: checks
dcami_nj: checks
stock501402: checks
KooKballs: bets $0.05
Wooly510: folds
dcami_nj: calls $0.05
stock501402: calls $0.05
*** TURN *** [2s 3d Jc] [Jh]
dcami_nj: checks
stock501402: checks
KooKballs: bets $0.10
dcami_nj: folds
stock501402: calls $0.10
*** RIVER *** [2s 3d Jc Jh] [Kd]
stock501402: checks
KooKballs: checks
*** SHOW DOWN ***
stock501402: shows [5c 7d] (a pair of Jacks)
KooKballs: shows [3s Ah] (two pair, Jacks and Threes)
KooKballs collected $0.52 from pot
*** SUMMARY ***
Total pot $0.55 | Rake $0.03
Board [2s 3d Jc Jh Kd]
Seat 1: KooKballs (button) showed [3s Ah] and won ($0.52) with two pair, Jacks and Threes
Seat 2: Wooly510 (small blind) folded on the Flop
Seat 3: dcami_nj (big blind) folded on the Turn
Seat 4: richy5742 folded before Flop (didn't bet)
Seat 5: stock501402 showed [5c 7d] and lost with a pair of Jacks
Seat 6: PlayTheBlues4U folded before Flop (didn't bet)


*********** # 31 **************
PokerStars Hand #204330101931:  Hold'em No Limit ($0.02/$0.05 USD) - 2019/10/07 20:22:38 ET
Table 'Sculptor' 6-max Seat #3 is the button
Seat 1: cladams73 ($2.15 in chips)
Seat 3: skillzplumber ($5.89 in chips)
Seat 4: PlayTheBlues4U ($4.72 in chips)
Seat 5: Wooly510 ($7.71 in chips)
Seat 6: DemolishIT ($1.52 in chips)
PlayTheBlues4U: posts small blind $0.02
Wooly510: posts big blind $0.05
*** HOLE CARDS ***
Dealt to PlayTheBlues4U [2c 4d]
DemolishIT: calls $0.05
cladams73: folds
skillzplumber: folds
PlayTheBlues4U: folds
Wooly510: checks
*** FLOP *** [Ac Qs 3d]
Wooly510: checks
DemolishIT: checks
*** TURN *** [Ac Qs 3d] [Ad]
Wooly510: checks
DemolishIT: checks
*** RIVER *** [Ac Qs 3d Ad] [As]
Wooly510: bets $0.05
DemolishIT: raises $0.10 to $0.15
Wooly510: folds
Uncalled bet ($0.10) returned to DemolishIT
DemolishIT collected $0.21 from pot
DemolishIT: doesn't show hand
*** SUMMARY ***
Total pot $0.22 | Rake $0.01
Board [Ac Qs 3d Ad As]
Seat 1: cladams73 folded before Flop (didn't bet)
Seat 3: skillzplumber (button) folded before Flop (didn't bet)
Seat 4: PlayTheBlues4U (small blind) folded before Flop
Seat 5: Wooly510 (big blind) folded on the River
Seat 6: DemolishIT collected ($0.21)


*********** # 32 **************
PokerStars Hand #204330101839:  Hold'em No Limit ($0.02/$0.05 USD) - 2019/10/07 20:22:02 ET
Table 'Sculptor' 6-max Seat #1 is the button
Seat 1: cladams73 ($2.15 in chips)
Seat 3: skillzplumber ($6.04 in chips)
Seat 4: PlayTheBlues4U ($4.77 in chips)
Seat 5: Wooly510 ($7.38 in chips)
Seat 6: DemolishIT ($1.67 in chips)
skillzplumber: posts small blind $0.02
PlayTheBlues4U: posts big blind $0.05
*** HOLE CARDS ***
Dealt to PlayTheBlues4U [Ks Ad]
Wooly510: raises $0.10 to $0.15
DemolishIT: calls $0.15
cladams73: folds
skillzplumber: calls $0.13
PlayTheBlues4U: folds
*** FLOP *** [9s 6c Qs]
skillzplumber: checks
Wooly510: bets $0.36
DemolishIT: folds
skillzplumber: folds
Uncalled bet ($0.36) returned to Wooly510
Wooly510 collected $0.48 from pot
Wooly510: doesn't show hand
*** SUMMARY ***
Total pot $0.50 | Rake $0.02
Board [9s 6c Qs]
Seat 1: cladams73 (button) folded before Flop (didn't bet)
Seat 3: skillzplumber (small blind) folded on the Flop
Seat 4: PlayTheBlues4U (big blind) folded before Flop
Seat 5: Wooly510 collected ($0.48)
Seat 6: DemolishIT folded on the Flop


*********** # 33 **************
PokerStars Hand #204330101818:  Hold'em No Limit ($0.02/$0.05 USD) - 2019/10/07 20:21:55 ET
Table 'Sculptor' 6-max Seat #6 is the button
Seat 1: cladams73 ($2.17 in chips)
Seat 3: skillzplumber ($6.02 in chips)
Seat 4: PlayTheBlues4U ($4.77 in chips)
Seat 5: Wooly510 ($7.38 in chips)
Seat 6: DemolishIT ($1.67 in chips)
cladams73: posts small blind $0.02
skillzplumber: posts big blind $0.05
*** HOLE CARDS ***
Dealt to PlayTheBlues4U [6s 2h]
PlayTheBlues4U: folds
Wooly510: folds
DemolishIT: folds
cladams73: folds
Uncalled bet ($0.03) returned to skillzplumber
skillzplumber collected $0.04 from pot
*** SUMMARY ***
Total pot $0.04 | Rake $0
Seat 1: cladams73 (small blind) folded before Flop
Seat 3: skillzplumber (big blind) collected ($0.04)
Seat 4: PlayTheBlues4U folded before Flop (didn't bet)
Seat 5: Wooly510 folded before Flop (didn't bet)
Seat 6: DemolishIT (button) folded before Flop (didn't bet)


*********** # 34 **************
PokerStars Hand #204330101781:  Hold'em No Limit ($0.02/$0.05 USD) - 2019/10/07 20:21:41 ET
Table 'Fides' 6-max Seat #6 is the button
Seat 1: KooKballs ($8.59 in chips)
Seat 2: Wooly510 ($4.93 in chips)
Seat 3: dcami_nj ($5.09 in chips)
Seat 4: richy5742 ($4.28 in chips)
Seat 5: stock501402 ($12.35 in chips)
Seat 6: PlayTheBlues4U ($6.33 in chips)
KooKballs: posts small blind $0.02
Wooly510: posts big blind $0.05
*** HOLE CARDS ***
Dealt to PlayTheBlues4U [Kh 8h]
dcami_nj: folds
richy5742: folds
stock501402: calls $0.05
PlayTheBlues4U: calls $0.05
KooKballs: calls $0.03
Wooly510: checks
*** FLOP *** [Td 6c Tc]
KooKballs: checks
Wooly510: checks
stock501402: checks
PlayTheBlues4U: checks
*** TURN *** [Td 6c Tc] [Qh]
KooKballs: bets $0.05
Wooly510: folds
stock501402: calls $0.05
PlayTheBlues4U: folds
*** RIVER *** [Td 6c Tc Qh] [9c]
KooKballs: bets $0.05
stock501402: calls $0.05
*** SHOW DOWN ***
KooKballs: shows [Qs Kd] (two pair, Queens and Tens)
stock501402: mucks hand
KooKballs collected $0.38 from pot
*** SUMMARY ***
Total pot $0.40 | Rake $0.02
Board [Td 6c Tc Qh 9c]
Seat 1: KooKballs (small blind) showed [Qs Kd] and won ($0.38) with two pair, Queens and Tens
Seat 2: Wooly510 (big blind) folded on the Turn
Seat 3: dcami_nj folded before Flop (didn't bet)
Seat 4: richy5742 folded before Flop (didn't bet)
Seat 5: stock501402 mucked [5h 2h]
Seat 6: PlayTheBlues4U (button) folded on the Turn


*********** # 35 **************
PokerStars Hand #204330101676:  Hold'em No Limit ($0.02/$0.05 USD) - 2019/10/07 20:21:03 ET
Table 'Sculptor' 6-max Seat #5 is the button
Seat 1: cladams73 ($2.22 in chips)
Seat 3: skillzplumber ($6.17 in chips)
Seat 4: PlayTheBlues4U ($4.77 in chips)
Seat 5: Wooly510 ($5.95 in chips)
Seat 6: DemolishIT ($3.05 in chips)
DemolishIT: posts small blind $0.02
cladams73: posts big blind $0.05
*** HOLE CARDS ***
Dealt to PlayTheBlues4U [Td Ac]
skillzplumber: raises $0.10 to $0.15
PlayTheBlues4U: folds
Wooly510: calls $0.15
DemolishIT: calls $0.13
cladams73: folds
*** FLOP *** [Jh As Kc]
DemolishIT: checks
skillzplumber: checks
Wooly510: bets $0.36
DemolishIT: calls $0.36
skillzplumber: folds
*** TURN *** [Jh As Kc] [6c]
DemolishIT: checks
Wooly510: bets $0.87
DemolishIT: calls $0.87
*** RIVER *** [Jh As Kc 6c] [5d]
DemolishIT: checks
Wooly510: bets $1.41
DemolishIT: folds
Uncalled bet ($1.41) returned to Wooly510
Wooly510 collected $2.81 from pot
Wooly510: doesn't show hand
*** SUMMARY ***
Total pot $2.96 | Rake $0.15
Board [Jh As Kc 6c 5d]
Seat 1: cladams73 (big blind) folded before Flop
Seat 3: skillzplumber folded on the Flop
Seat 4: PlayTheBlues4U folded before Flop (didn't bet)
Seat 5: Wooly510 (button) collected ($2.81)
Seat 6: DemolishIT (small blind) folded on the River


*********** # 36 **************
PokerStars Hand #204330101626:  Hold'em No Limit ($0.02/$0.05 USD) - 2019/10/07 20:20:46 ET
Table 'Fides' 6-max Seat #5 is the button
Seat 1: KooKballs ($8 in chips)
Seat 3: dcami_nj ($5.09 in chips)
Seat 4: richy5742 ($4.28 in chips)
Seat 5: stock501402 ($12.35 in chips)
Seat 6: PlayTheBlues4U ($6.98 in chips)
PlayTheBlues4U: posts small blind $0.02
KooKballs: posts big blind $0.05
Wooly510: sits out
*** HOLE CARDS ***
Dealt to PlayTheBlues4U [7s Ac]
dcami_nj: folds
richy5742: folds
stock501402: folds
PlayTheBlues4U: raises $0.10 to $0.15
KooKballs: calls $0.10
*** FLOP *** [3c Ts Jc]
PlayTheBlues4U: checks
KooKballs: bets $0.15
PlayTheBlues4U: calls $0.15
*** TURN *** [3c Ts Jc] [5s]
PlayTheBlues4U: checks
KooKballs: checks
*** RIVER *** [3c Ts Jc 5s] [Js]
PlayTheBlues4U: bets $0.35
KooKballs: calls $0.35
*** SHOW DOWN ***
PlayTheBlues4U: shows [7s Ac] (a pair of Jacks)
KooKballs: shows [2h 3d] (two pair, Jacks and Threes)
KooKballs collected $1.24 from pot
*** SUMMARY ***
Total pot $1.30 | Rake $0.06
Board [3c Ts Jc 5s Js]
Seat 1: KooKballs (big blind) showed [2h 3d] and won ($1.24) with two pair, Jacks and Threes
Seat 3: dcami_nj folded before Flop (didn't bet)
Seat 4: richy5742 folded before Flop (didn't bet)
Seat 5: stock501402 (button) folded before Flop (didn't bet)
Seat 6: PlayTheBlues4U (small blind) showed [7s Ac] and lost with a pair of Jacks


*********** # 37 **************
PokerStars Hand #204330101581:  Hold'em No Limit ($0.02/$0.05 USD) - 2019/10/07 20:20:29 ET
Table 'Sculptor' 6-max Seat #4 is the button
Seat 1: cladams73 ($1.93 in chips)
Seat 3: skillzplumber ($6.17 in chips)
Seat 4: PlayTheBlues4U ($5.02 in chips)
Seat 5: Wooly510 ($5.97 in chips)
Seat 6: DemolishIT ($3.10 in chips)
Wooly510: posts small blind $0.02
DemolishIT: posts big blind $0.05
*** HOLE CARDS ***
Dealt to PlayTheBlues4U [Qh Ah]
cladams73: calls $0.05
skillzplumber: folds
PlayTheBlues4U: raises $0.15 to $0.20
Wooly510: folds
DemolishIT: folds
cladams73: calls $0.15
*** FLOP *** [4s 5c 6c]
cladams73: bets $0.05
PlayTheBlues4U: calls $0.05
*** TURN *** [4s 5c 6c] [Js]
cladams73: bets $0.15
PlayTheBlues4U: folds
Uncalled bet ($0.15) returned to cladams73
cladams73 collected $0.54 from pot
cladams73: doesn't show hand
*** SUMMARY ***
Total pot $0.57 | Rake $0.03
Board [4s 5c 6c Js]
Seat 1: cladams73 collected ($0.54)
Seat 3: skillzplumber folded before Flop (didn't bet)
Seat 4: PlayTheBlues4U (button) folded on the Turn
Seat 5: Wooly510 (small blind) folded before Flop
Seat 6: DemolishIT (big blind) folded before Flop


*********** # 38 **************
PokerStars Hand #204330101539:  Hold'em No Limit ($0.02/$0.05 USD) - 2019/10/07 20:20:13 ET
Table 'Sculptor' 6-max Seat #3 is the button
Seat 1: cladams73 ($1.86 in chips)
Seat 2: Star6543 ($4.52 in chips)
Seat 3: skillzplumber ($6.17 in chips)
Seat 4: PlayTheBlues4U ($5.04 in chips)
Seat 5: Wooly510 ($6.02 in chips)
Seat 6: DemolishIT ($3.10 in chips)
PlayTheBlues4U: posts small blind $0.02
Wooly510: posts big blind $0.05
*** HOLE CARDS ***
Dealt to PlayTheBlues4U [7s 3c]
DemolishIT: folds
cladams73: raises $0.10 to $0.15
Star6543: folds
Star6543 leaves the table
skillzplumber: folds
PlayTheBlues4U: folds
Wooly510: folds
Uncalled bet ($0.10) returned to cladams73
cladams73 collected $0.12 from pot
*** SUMMARY ***
Total pot $0.12 | Rake $0
Seat 1: cladams73 collected ($0.12)
Seat 2: Star6543 folded before Flop (didn't bet)
Seat 3: skillzplumber (button) folded before Flop (didn't bet)
Seat 4: PlayTheBlues4U (small blind) folded before Flop
Seat 5: Wooly510 (big blind) folded before Flop
Seat 6: DemolishIT folded before Flop (didn't bet)


*********** # 39 **************
PokerStars Hand #204330101460:  Hold'em No Limit ($0.02/$0.05 USD) - 2019/10/07 20:19:44 ET
Table 'Fides' 6-max Seat #4 is the button
Seat 1: KooKballs ($8 in chips)
Seat 3: dcami_nj ($5.09 in chips)
Seat 4: richy5742 ($4.43 in chips)
Seat 5: stock501402 ($12.37 in chips)
Seat 6: PlayTheBlues4U ($6.83 in chips)
stock501402: posts small blind $0.02
PlayTheBlues4U: posts big blind $0.05
*** HOLE CARDS ***
Dealt to PlayTheBlues4U [Qs Jh]
KooKballs: folds
dcami_nj has timed out
dcami_nj: folds
richy5742: calls $0.05
stock501402: folds
PlayTheBlues4U: checks
*** FLOP *** [9d Td Ac]
PlayTheBlues4U: checks
richy5742: bets $0.10
PlayTheBlues4U: calls $0.10
*** TURN *** [9d Td Ac] [4c]
PlayTheBlues4U: checks
richy5742: checks
*** RIVER *** [9d Td Ac 4c] [Js]
PlayTheBlues4U: checks
richy5742: checks
*** SHOW DOWN ***
PlayTheBlues4U: shows [Qs Jh] (a pair of Jacks)
richy5742: mucks hand
PlayTheBlues4U collected $0.30 from pot
*** SUMMARY ***
Total pot $0.32 | Rake $0.02
Board [9d Td Ac 4c Js]
Seat 1: KooKballs folded before Flop (didn't bet)
Seat 3: dcami_nj folded before Flop (didn't bet)
Seat 4: richy5742 (button) mucked [7h 4h]
Seat 5: stock501402 (small blind) folded before Flop
Seat 6: PlayTheBlues4U (big blind) showed [Qs Jh] and won ($0.30) with a pair of Jacks


*********** # 40 **************
PokerStars Hand #204330101451:  Hold'em No Limit ($0.02/$0.05 USD) - 2019/10/07 20:19:40 ET
Table 'Sculptor' 6-max Seat #2 is the button
Seat 1: cladams73 ($1.86 in chips)
Seat 2: Star6543 ($4.19 in chips)
Seat 3: skillzplumber ($6.19 in chips)
Seat 4: PlayTheBlues4U ($5.39 in chips)
Seat 6: DemolishIT ($3.10 in chips)
skillzplumber: posts small blind $0.02
PlayTheBlues4U: posts big blind $0.05
*** HOLE CARDS ***
Dealt to PlayTheBlues4U [8h 6c]
DemolishIT: folds
cladams73: folds
Star6543: calls $0.05
skillzplumber: folds
PlayTheBlues4U: checks
*** FLOP *** [9s 9c 3h]
PlayTheBlues4U: bets $0.10
Star6543: calls $0.10
*** TURN *** [9s 9c 3h] [Qd]
PlayTheBlues4U: bets $0.20
Star6543: raises $0.20 to $0.40
PlayTheBlues4U: folds
Uncalled bet ($0.20) returned to Star6543
Star6543 collected $0.68 from pot
Star6543: doesn't show hand
*** SUMMARY ***
Total pot $0.72 | Rake $0.04
Board [9s 9c 3h Qd]
Seat 1: cladams73 folded before Flop (didn't bet)
Seat 2: Star6543 (button) collected ($0.68)
Seat 3: skillzplumber (small blind) folded before Flop
Seat 4: PlayTheBlues4U (big blind) folded on the Turn
Seat 6: DemolishIT folded before Flop (didn't bet)


*********** # 41 **************
PokerStars Hand #204330101413:  Hold'em No Limit ($0.02/$0.05 USD) - 2019/10/07 20:19:26 ET
Table 'Sculptor' 6-max Seat #1 is the button
Seat 1: cladams73 ($1.86 in chips)
Seat 2: Star6543 ($4.14 in chips)
Seat 3: skillzplumber ($6.24 in chips)
Seat 4: PlayTheBlues4U ($5.39 in chips)
Seat 6: DemolishIT ($3.10 in chips)
Star6543: posts small blind $0.02
skillzplumber: posts big blind $0.05
*** HOLE CARDS ***
Dealt to PlayTheBlues4U [5h Kd]
PlayTheBlues4U: folds
DemolishIT: folds
cladams73: folds
Star6543: calls $0.03
skillzplumber: checks
*** FLOP *** [9s 2h Qs]
Star6543: bets $0.05
skillzplumber: folds
Uncalled bet ($0.05) returned to Star6543
Star6543 collected $0.10 from pot
Star6543: doesn't show hand
*** SUMMARY ***
Total pot $0.10 | Rake $0
Board [9s 2h Qs]
Seat 1: cladams73 (button) folded before Flop (didn't bet)
Seat 2: Star6543 (small blind) collected ($0.10)
Seat 3: skillzplumber (big blind) folded on the Flop
Seat 4: PlayTheBlues4U folded before Flop (didn't bet)
Seat 6: DemolishIT folded before Flop (didn't bet)


*********** # 42 **************
PokerStars Hand #204330101397:  Hold'em No Limit ($0.02/$0.05 USD) - 2019/10/07 20:19:19 ET
Table 'Fides' 6-max Seat #3 is the button
Seat 1: KooKballs ($8 in chips)
Seat 3: dcami_nj ($5.09 in chips)
Seat 4: richy5742 ($4.48 in chips)
Seat 5: stock501402 ($12.32 in chips)
Seat 6: PlayTheBlues4U ($6.83 in chips)
richy5742: posts small blind $0.02
stock501402: posts big blind $0.05
*** HOLE CARDS ***
Dealt to PlayTheBlues4U [7s Qd]
PlayTheBlues4U: folds
KooKballs: folds
dcami_nj: folds
richy5742: calls $0.03
stock501402: checks
*** FLOP *** [5s Qc 5d]
richy5742: checks
stock501402: bets $0.05
richy5742: folds
Uncalled bet ($0.05) returned to stock501402
stock501402 collected $0.10 from pot
stock501402: doesn't show hand
*** SUMMARY ***
Total pot $0.10 | Rake $0
Board [5s Qc 5d]
Seat 1: KooKballs folded before Flop (didn't bet)
Seat 3: dcami_nj (button) folded before Flop (didn't bet)
Seat 4: richy5742 (small blind) folded on the Flop
Seat 5: stock501402 (big blind) collected ($0.10)
Seat 6: PlayTheBlues4U folded before Flop (didn't bet)


*********** # 43 **************
PokerStars Hand #204330101387:  Hold'em No Limit ($0.02/$0.05 USD) - 2019/10/07 20:19:16 ET
Table 'Sculptor' 6-max Seat #6 is the button
Seat 1: cladams73 ($1.81 in chips)
Seat 2: Star6543 ($4.19 in chips)
Seat 3: skillzplumber ($6.24 in chips)
Seat 4: PlayTheBlues4U ($5.39 in chips)
Seat 6: DemolishIT ($3.10 in chips)
cladams73: posts small blind $0.02
Star6543: posts big blind $0.05
*** HOLE CARDS ***
Dealt to PlayTheBlues4U [5h 3s]
skillzplumber: folds
PlayTheBlues4U: folds
DemolishIT: folds
cladams73: raises $0.10 to $0.15
Star6543: folds
Uncalled bet ($0.10) returned to cladams73
cladams73 collected $0.10 from pot
*** SUMMARY ***
Total pot $0.10 | Rake $0
Seat 1: cladams73 (small blind) collected ($0.10)
Seat 2: Star6543 (big blind) folded before Flop
Seat 3: skillzplumber folded before Flop (didn't bet)
Seat 4: PlayTheBlues4U folded before Flop (didn't bet)
Seat 6: DemolishIT (button) folded before Flop (didn't bet)


*********** # 44 **************
PokerStars Hand #204330101312:  Hold'em No Limit ($0.02/$0.05 USD) - 2019/10/07 20:18:43 ET
Table 'Fides' 6-max Seat #1 is the button
Seat 1: KooKballs ($7.93 in chips)
Seat 3: dcami_nj ($5.11 in chips)
Seat 4: richy5742 ($4.53 in chips)
Seat 5: stock501402 ($12.32 in chips)
Seat 6: PlayTheBlues4U ($6.83 in chips)
dcami_nj: posts small blind $0.02
richy5742: posts big blind $0.05
*** HOLE CARDS ***
Dealt to PlayTheBlues4U [9h 3s]
stock501402 has timed out
stock501402: folds
PlayTheBlues4U: folds
KooKballs: raises $0.10 to $0.15
dcami_nj: folds
richy5742: folds
Uncalled bet ($0.10) returned to KooKballs
KooKballs collected $0.12 from pot
KooKballs: doesn't show hand
*** SUMMARY ***
Total pot $0.12 | Rake $0
Seat 1: KooKballs (button) collected ($0.12)
Seat 3: dcami_nj (small blind) folded before Flop
Seat 4: richy5742 (big blind) folded before Flop
Seat 5: stock501402 folded before Flop (didn't bet)
Seat 6: PlayTheBlues4U folded before Flop (didn't bet)


*********** # 45 **************
PokerStars Hand #204330101230:  Hold'em No Limit ($0.02/$0.05 USD) - 2019/10/07 20:18:14 ET
Table 'Sculptor' 6-max Seat #4 is the button
Seat 1: cladams73 ($2.16 in chips)
Seat 2: Star6543 ($4.24 in chips)
Seat 3: skillzplumber ($6.94 in chips)
Seat 4: PlayTheBlues4U ($5.74 in chips)
Seat 6: DemolishIT ($1.76 in chips)
DemolishIT: posts small blind $0.02
cladams73: posts big blind $0.05
*** HOLE CARDS ***
Dealt to PlayTheBlues4U [Ac 5c]
Star6543: calls $0.05
skillzplumber: raises $0.10 to $0.15
PlayTheBlues4U: calls $0.15
DemolishIT: calls $0.13
cladams73: raises $0.20 to $0.35
Star6543: folds
skillzplumber: calls $0.20
PlayTheBlues4U: calls $0.20
DemolishIT: calls $0.20
*** FLOP *** [8h 7h 2h]
DemolishIT: checks
cladams73: checks
skillzplumber: checks
PlayTheBlues4U: checks
*** TURN *** [8h 7h 2h] [4c]
DemolishIT: checks
cladams73: checks
skillzplumber: bets $0.35
PlayTheBlues4U: folds
DemolishIT: calls $0.35
cladams73: folds
*** RIVER *** [8h 7h 2h 4c] [5h]
DemolishIT: checks
skillzplumber: checks
*** SHOW DOWN ***
DemolishIT: shows [Kh 9d] (a flush, King high)
skillzplumber: mucks hand
DemolishIT collected $2.04 from pot
*** SUMMARY ***
Total pot $2.15 | Rake $0.11
Board [8h 7h 2h 4c 5h]
Seat 1: cladams73 (big blind) folded on the Turn
Seat 2: Star6543 folded before Flop
Seat 3: skillzplumber mucked [3s 3d]
Seat 4: PlayTheBlues4U (button) folded on the Turn
Seat 6: DemolishIT (small blind) showed [Kh 9d] and won ($2.04) with a flush, King high


*********** # 46 **************
PokerStars Hand #204330101222:  Hold'em No Limit ($0.02/$0.05 USD) - 2019/10/07 20:18:10 ET
Table 'Fides' 6-max Seat #6 is the button
Seat 1: KooKballs ($7.95 in chips)
Seat 3: dcami_nj ($5 in chips)
Seat 4: richy5742 ($4.63 in chips)
Seat 5: stock501402 ($12.32 in chips)
Seat 6: PlayTheBlues4U ($6.83 in chips)
KooKballs: posts small blind $0.02
dcami_nj: posts big blind $0.05
*** HOLE CARDS ***
Dealt to PlayTheBlues4U [2s 3d]
richy5742: raises $0.05 to $0.10
stock501402: folds
PlayTheBlues4U: folds
KooKballs: folds
dcami_nj: calls $0.05
*** FLOP *** [6s Td 2h]
dcami_nj: checks
richy5742: checks
*** TURN *** [6s Td 2h] [Th]
dcami_nj: bets $0.20
richy5742: folds
Uncalled bet ($0.20) returned to dcami_nj
dcami_nj collected $0.21 from pot
dcami_nj: doesn't show hand
*** SUMMARY ***
Total pot $0.22 | Rake $0.01
Board [6s Td 2h Th]
Seat 1: KooKballs (small blind) folded before Flop
Seat 3: dcami_nj (big blind) collected ($0.21)
Seat 4: richy5742 folded on the Turn
Seat 5: stock501402 folded before Flop (didn't bet)
Seat 6: PlayTheBlues4U (button) folded before Flop (didn't bet)


*********** # 47 **************
PokerStars Hand #204330101173:  Hold'em No Limit ($0.02/$0.05 USD) - 2019/10/07 20:17:50 ET
Table 'Fides' 6-max Seat #5 is the button
Seat 1: KooKballs ($7.93 in chips)
Seat 3: dcami_nj ($1.41 in chips)
Seat 4: richy5742 ($4.63 in chips)
Seat 5: stock501402 ($12.32 in chips)
Seat 6: PlayTheBlues4U ($6.85 in chips)
PlayTheBlues4U: posts small blind $0.02
KooKballs: posts big blind $0.05
*** HOLE CARDS ***
Dealt to PlayTheBlues4U [6d 8h]
dcami_nj: folds
richy5742: folds
stock501402: folds
PlayTheBlues4U: folds
Uncalled bet ($0.03) returned to KooKballs
KooKballs collected $0.04 from pot
KooKballs: doesn't show hand
*** SUMMARY ***
Total pot $0.04 | Rake $0
Seat 1: KooKballs (big blind) collected ($0.04)
Seat 3: dcami_nj folded before Flop (didn't bet)
Seat 4: richy5742 folded before Flop (didn't bet)
Seat 5: stock501402 (button) folded before Flop (didn't bet)
Seat 6: PlayTheBlues4U (small blind) folded before Flop


*********** # 48 **************
PokerStars Hand #204330101148:  Hold'em No Limit ($0.02/$0.05 USD) - 2019/10/07 20:17:40 ET
Table 'Sculptor' 6-max Seat #3 is the button
Seat 1: cladams73 ($2.41 in chips)
Seat 2: Star6543 ($4.49 in chips)
Seat 3: skillzplumber ($6.94 in chips)
Seat 4: PlayTheBlues4U ($5.23 in chips)
Seat 6: DemolishIT ($1.81 in chips)
PlayTheBlues4U: posts small blind $0.02
DemolishIT: posts big blind $0.05
*** HOLE CARDS ***
Dealt to PlayTheBlues4U [Jd Jh]
cladams73: calls $0.05
Star6543: raises $0.05 to $0.10
skillzplumber: folds
PlayTheBlues4U: raises $0.15 to $0.25
DemolishIT: folds
cladams73: calls $0.20
Star6543: calls $0.15
*** FLOP *** [3d Th 8c]
PlayTheBlues4U: bets $0.60
cladams73: folds
Star6543: folds
Uncalled bet ($0.60) returned to PlayTheBlues4U
PlayTheBlues4U collected $0.76 from pot
PlayTheBlues4U: doesn't show hand
*** SUMMARY ***
Total pot $0.80 | Rake $0.04
Board [3d Th 8c]
Seat 1: cladams73 folded on the Flop
Seat 2: Star6543 folded on the Flop
Seat 3: skillzplumber (button) folded before Flop (didn't bet)
Seat 4: PlayTheBlues4U (small blind) collected ($0.76)
Seat 6: DemolishIT (big blind) folded before Flop


*********** # 49 **************
PokerStars Hand #204330101124:  Hold'em No Limit ($0.02/$0.05 USD) - 2019/10/07 20:17:26 ET
Table 'Sculptor' 6-max Seat #2 is the button
Seat 1: cladams73 ($2.61 in chips)
Seat 2: Star6543 ($4.49 in chips)
Seat 3: skillzplumber ($6.71 in chips)
Seat 4: PlayTheBlues4U ($5.28 in chips)
Seat 6: DemolishIT ($1.81 in chips)
skillzplumber: posts small blind $0.02
PlayTheBlues4U: posts big blind $0.05
*** HOLE CARDS ***
Dealt to PlayTheBlues4U [Th Jc]
DemolishIT: folds
cladams73: calls $0.05
Star6543: folds
skillzplumber: raises $0.15 to $0.20
PlayTheBlues4U: folds
cladams73: calls $0.15
*** FLOP *** [Ts 4d As]
skillzplumber: bets $0.35
cladams73: folds
Uncalled bet ($0.35) returned to skillzplumber
skillzplumber collected $0.43 from pot
skillzplumber: doesn't show hand
*** SUMMARY ***
Total pot $0.45 | Rake $0.02
Board [Ts 4d As]
Seat 1: cladams73 folded on the Flop
Seat 2: Star6543 (button) folded before Flop (didn't bet)
Seat 3: skillzplumber (small blind) collected ($0.43)
Seat 4: PlayTheBlues4U (big blind) folded before Flop
Seat 6: DemolishIT folded before Flop (didn't bet)


*********** # 50 **************
PokerStars Hand #204330101099:  Hold'em No Limit ($0.02/$0.05 USD) - 2019/10/07 20:17:17 ET
Table 'Sculptor' 6-max Seat #1 is the button
Seat 1: cladams73 ($2.61 in chips)
Seat 2: Star6543 ($4.54 in chips)
Seat 3: skillzplumber ($6.66 in chips)
Seat 4: PlayTheBlues4U ($5.28 in chips)
Seat 6: DemolishIT ($1.81 in chips)
Star6543: posts small blind $0.02
skillzplumber: posts big blind $0.05
*** HOLE CARDS ***
Dealt to PlayTheBlues4U [6c 2d]
PlayTheBlues4U: folds
DemolishIT: folds
cladams73: folds
Star6543: calls $0.03
skillzplumber: raises $6.61 to $6.66 and is all-in
Star6543: folds
Uncalled bet ($6.61) returned to skillzplumber
skillzplumber collected $0.10 from pot
skillzplumber: doesn't show hand
*** SUMMARY ***
Total pot $0.10 | Rake $0
Seat 1: cladams73 (button) folded before Flop (didn't bet)
Seat 2: Star6543 (small blind) folded before Flop
Seat 3: skillzplumber (big blind) collected ($0.10)
Seat 4: PlayTheBlues4U folded before Flop (didn't bet)
Seat 6: DemolishIT folded before Flop (didn't bet)


*********** # 51 **************
PokerStars Hand #204330101012:  Hold'em No Limit ($0.02/$0.05 USD) - 2019/10/07 20:16:38 ET
Table 'Sculptor' 6-max Seat #6 is the button
Seat 1: cladams73 ($2.91 in chips)
Seat 2: Star6543 ($4.84 in chips)
Seat 3: skillzplumber ($6.66 in chips)
Seat 4: PlayTheBlues4U ($5.28 in chips)
Seat 6: DemolishIT ($1.25 in chips)
cladams73: posts small blind $0.02
Star6543: posts big blind $0.05
*** HOLE CARDS ***
Dealt to PlayTheBlues4U [Ks 4d]
skillzplumber: folds
PlayTheBlues4U: folds
DemolishIT: raises $0.15 to $0.20
cladams73: calls $0.18
Star6543: calls $0.15
*** FLOP *** [6c 5s 5c]
cladams73: checks
Star6543: bets $0.10
DemolishIT: calls $0.10
cladams73: calls $0.10
*** TURN *** [6c 5s 5c] [8h]
cladams73: checks
Star6543: checks
DemolishIT: bets $0.86
cladams73: folds
Star6543: folds [Tc Ac]
Uncalled bet ($0.86) returned to DemolishIT
DemolishIT collected $0.86 from pot
*** SUMMARY ***
Total pot $0.90 | Rake $0.04
Board [6c 5s 5c 8h]
Seat 1: cladams73 (small blind) folded on the Turn
Seat 2: Star6543 (big blind) folded on the Turn
Seat 3: skillzplumber folded before Flop (didn't bet)
Seat 4: PlayTheBlues4U folded before Flop (didn't bet)
Seat 6: DemolishIT (button) collected ($0.86)


*********** # 52 **************
PokerStars Hand #204330101009:  Hold'em No Limit ($0.02/$0.05 USD) - 2019/10/07 20:16:37 ET
Table 'Fides' 6-max Seat #4 is the button
Seat 1: KooKballs ($3.95 in chips)
Seat 3: dcami_nj ($5.36 in chips)
Seat 4: richy5742 ($4.63 in chips)
Seat 5: stock501402 ($12.72 in chips)
Seat 6: PlayTheBlues4U ($6.90 in chips)
stock501402: posts small blind $0.02
PlayTheBlues4U: posts big blind $0.05
*** HOLE CARDS ***
Dealt to PlayTheBlues4U [5c Td]
KooKballs: raises $0.10 to $0.15
dcami_nj: raises $0.25 to $0.40
richy5742: folds
stock501402: calls $0.38
PlayTheBlues4U: folds
KooKballs: calls $0.25
*** FLOP *** [3h 2c Qd]
stock501402: checks
KooKballs: bets $0.75
dcami_nj: calls $0.75
stock501402: folds
*** TURN *** [3h 2c Qd] [Kd]
KooKballs: bets $2.60
dcami_nj: calls $2.60
*** RIVER *** [3h 2c Qd Kd] [5h]
KooKballs: bets $0.20 and is all-in
dcami_nj: calls $0.20
*** SHOW DOWN ***
KooKballs: shows [Qs Ks] (two pair, Kings and Queens)
dcami_nj: shows [Qh Ah] (a pair of Queens)
KooKballs collected $7.93 from pot
*** SUMMARY ***
Total pot $8.35 | Rake $0.42
Board [3h 2c Qd Kd 5h]
Seat 1: KooKballs showed [Qs Ks] and won ($7.93) with two pair, Kings and Queens
Seat 3: dcami_nj showed [Qh Ah] and lost with a pair of Queens
Seat 4: richy5742 (button) folded before Flop (didn't bet)
Seat 5: stock501402 (small blind) folded on the Flop
Seat 6: PlayTheBlues4U (big blind) folded before Flop


*********** # 53 **************
PokerStars Hand #204330100958:  Hold'em No Limit ($0.02/$0.05 USD) - 2019/10/07 20:16:15 ET
Table 'Sculptor' 6-max Seat #4 is the button
Seat 1: cladams73 ($2.96 in chips)
Seat 2: Star6543 ($4.84 in chips)
Seat 3: skillzplumber ($6.81 in chips)
Seat 4: PlayTheBlues4U ($5.08 in chips)
Seat 6: DemolishIT ($1.27 in chips)
DemolishIT: posts small blind $0.02
cladams73: posts big blind $0.05
*** HOLE CARDS ***
Dealt to PlayTheBlues4U [9d Jd]
Star6543: folds
skillzplumber: calls $0.05
PlayTheBlues4U: raises $0.10 to $0.15
DemolishIT: folds
cladams73: folds
skillzplumber: calls $0.10
*** FLOP *** [7d Ks 2c]
skillzplumber: checks
PlayTheBlues4U: bets $0.25
skillzplumber: folds
Uncalled bet ($0.25) returned to PlayTheBlues4U
PlayTheBlues4U collected $0.35 from pot
PlayTheBlues4U: doesn't show hand
*** SUMMARY ***
Total pot $0.37 | Rake $0.02
Board [7d Ks 2c]
Seat 1: cladams73 (big blind) folded before Flop
Seat 2: Star6543 folded before Flop (didn't bet)
Seat 3: skillzplumber folded on the Flop
Seat 4: PlayTheBlues4U (button) collected ($0.35)
Seat 6: DemolishIT (small blind) folded before Flop


*********** # 54 **************
PokerStars Hand #204330100927:  Hold'em No Limit ($0.02/$0.05 USD) - 2019/10/07 20:16:02 ET
Table 'Fides' 6-max Seat #3 is the button
Seat 1: KooKballs ($4 in chips)
Seat 3: dcami_nj ($5.36 in chips)
Seat 4: richy5742 ($4.68 in chips)
Seat 5: stock501402 ($12.62 in chips)
Seat 6: PlayTheBlues4U ($6.90 in chips)
richy5742: posts small blind $0.02
stock501402: posts big blind $0.05
KooKballs: posts big blind $0.05
*** HOLE CARDS ***
Dealt to PlayTheBlues4U [7c 9c]
PlayTheBlues4U: folds
KooKballs: checks
dcami_nj: folds
richy5742: calls $0.03
stock501402: raises $0.10 to $0.15
KooKballs: folds
richy5742: folds
Uncalled bet ($0.10) returned to stock501402
stock501402 collected $0.15 from pot
stock501402: doesn't show hand
*** SUMMARY ***
Total pot $0.15 | Rake $0
Seat 1: KooKballs folded before Flop (didn't bet)
Seat 3: dcami_nj (button) folded before Flop (didn't bet)
Seat 4: richy5742 (small blind) folded before Flop
Seat 5: stock501402 (big blind) collected ($0.15)
Seat 6: PlayTheBlues4U folded before Flop (didn't bet)


*********** # 55 **************
PokerStars Hand #204330100873:  Hold'em No Limit ($0.02/$0.05 USD) - 2019/10/07 20:15:37 ET
Table 'Fides' 6-max Seat #6 is the button
Seat 2: Wooly510 ($4.95 in chips)
Seat 3: dcami_nj ($5.41 in chips)
Seat 4: richy5742 ($4.68 in chips)
Seat 5: stock501402 ($12.62 in chips)
Seat 6: PlayTheBlues4U ($6.83 in chips)
KooKballs will be allowed to play after the button
Wooly510: posts small blind $0.02
dcami_nj: posts big blind $0.05
*** HOLE CARDS ***
Dealt to PlayTheBlues4U [8s 5s]
richy5742: folds
stock501402: folds
PlayTheBlues4U: raises $0.10 to $0.15
Wooly510: folds
dcami_nj: folds
Uncalled bet ($0.10) returned to PlayTheBlues4U
PlayTheBlues4U collected $0.12 from pot
PlayTheBlues4U: doesn't show hand
*** SUMMARY ***
Total pot $0.12 | Rake $0
Seat 2: Wooly510 (small blind) folded before Flop
Seat 3: dcami_nj (big blind) folded before Flop
Seat 4: richy5742 folded before Flop (didn't bet)
Seat 5: stock501402 folded before Flop (didn't bet)
Seat 6: PlayTheBlues4U (button) collected ($0.12)


*********** # 56 **************
PokerStars Hand #204330100826:  Hold'em No Limit ($0.02/$0.05 USD) - 2019/10/07 20:15:20 ET
Table 'Sculptor' 6-max Seat #3 is the button
Seat 1: cladams73 ($2.96 in chips)
Seat 2: Star6543 ($5.77 in chips)
Seat 3: skillzplumber ($5.67 in chips)
Seat 4: PlayTheBlues4U ($5.10 in chips)
Seat 5: Wooly510 ($6.07 in chips)
Seat 6: DemolishIT ($1.52 in chips)
PlayTheBlues4U: posts small blind $0.02
Wooly510: posts big blind $0.05
*** HOLE CARDS ***
Dealt to PlayTheBlues4U [7h 4s]
DemolishIT: calls $0.05
cladams73: folds
Star6543: calls $0.05
skillzplumber: raises $0.20 to $0.25
PlayTheBlues4U: folds
Wooly510: folds
DemolishIT: calls $0.20
Star6543: calls $0.20
*** FLOP *** [6d 5s 9c]
DemolishIT: checks
Star6543: bets $0.05
skillzplumber: calls $0.05
DemolishIT: folds
*** TURN *** [6d 5s 9c] [Tc]
Star6543: bets $0.10
skillzplumber: calls $0.10
*** RIVER *** [6d 5s 9c Tc] [Ad]
Star6543: bets $0.53
skillzplumber: calls $0.53
*** SHOW DOWN ***
Star6543: shows [Jd Ks] (high card Ace)
skillzplumber: shows [Jc Ac] (a pair of Aces)
skillzplumber collected $2.07 from pot
*** SUMMARY ***
Total pot $2.18 | Rake $0.11
Board [6d 5s 9c Tc Ad]
Seat 1: cladams73 folded before Flop (didn't bet)
Seat 2: Star6543 showed [Jd Ks] and lost with high card Ace
Seat 3: skillzplumber (button) showed [Jc Ac] and won ($2.07) with a pair of Aces
Seat 4: PlayTheBlues4U (small blind) folded before Flop
Seat 5: Wooly510 (big blind) folded before Flop
Seat 6: DemolishIT folded on the Flop


*********** # 57 **************
PokerStars Hand #204330100762:  Hold'em No Limit ($0.02/$0.05 USD) - 2019/10/07 20:14:52 ET
Table 'Sculptor' 6-max Seat #2 is the button
Seat 1: cladams73 ($3.11 in chips)
Seat 2: Star6543 ($5.57 in chips)
Seat 3: skillzplumber ($5.69 in chips)
Seat 4: PlayTheBlues4U ($5.15 in chips)
Seat 5: Wooly510 ($6.07 in chips)
Seat 6: DemolishIT ($1.52 in chips)
skillzplumber: posts small blind $0.02
PlayTheBlues4U: posts big blind $0.05
*** HOLE CARDS ***
Dealt to PlayTheBlues4U [Kc Tc]
Wooly510: folds
DemolishIT: folds
cladams73: calls $0.05
Star6543: calls $0.05
skillzplumber: folds
PlayTheBlues4U: checks
*** FLOP *** [3d 7s 5d]
PlayTheBlues4U: checks
cladams73: bets $0.10
Star6543: calls $0.10
PlayTheBlues4U: folds
*** TURN *** [3d 7s 5d] [4c]
cladams73: checks
Star6543: checks
*** RIVER *** [3d 7s 5d 4c] [8s]
cladams73: checks
Star6543: checks
*** SHOW DOWN ***
cladams73: shows [3s Ac] (a pair of Threes)
Star6543: shows [9s 4s] (a pair of Fours)
Star6543 collected $0.35 from pot
*** SUMMARY ***
Total pot $0.37 | Rake $0.02
Board [3d 7s 5d 4c 8s]
Seat 1: cladams73 showed [3s Ac] and lost with a pair of Threes
Seat 2: Star6543 (button) showed [9s 4s] and won ($0.35) with a pair of Fours
Seat 3: skillzplumber (small blind) folded before Flop
Seat 4: PlayTheBlues4U (big blind) folded on the Flop
Seat 5: Wooly510 folded before Flop (didn't bet)
Seat 6: DemolishIT folded before Flop (didn't bet)


*********** # 58 **************
PokerStars Hand #204330100718:  Hold'em No Limit ($0.02/$0.05 USD) - 2019/10/07 20:14:33 ET
Table 'Fides' 6-max Seat #5 is the button
Seat 2: Wooly510 ($5 in chips)
Seat 3: dcami_nj ($5.41 in chips)
Seat 4: richy5742 ($4.27 in chips)
Seat 5: stock501402 ($12.77 in chips)
Seat 6: PlayTheBlues4U ($7.08 in chips)
PlayTheBlues4U: posts small blind $0.02
Wooly510: posts big blind $0.05
*** HOLE CARDS ***
Dealt to PlayTheBlues4U [6d 6h]
dcami_nj: folds
richy5742: raises $0.05 to $0.10
stock501402: calls $0.10
PlayTheBlues4U: calls $0.08
Wooly510: folds
*** FLOP *** [3h As 4d]
PlayTheBlues4U: checks
richy5742: checks
stock501402: bets $0.05
PlayTheBlues4U: calls $0.05
richy5742: calls $0.05
*** TURN *** [3h As 4d] [3d]
KooKballs joins the table at seat #1
PlayTheBlues4U: checks
richy5742: checks
stock501402: checks
*** RIVER *** [3h As 4d 3d] [8s]
PlayTheBlues4U: checks
richy5742: bets $0.10
stock501402: folds
PlayTheBlues4U: calls $0.10
*** SHOW DOWN ***
richy5742: shows [Ad 5c] (two pair, Aces and Threes)
PlayTheBlues4U: mucks hand
richy5742 collected $0.66 from pot
*** SUMMARY ***
Total pot $0.70 | Rake $0.04
Board [3h As 4d 3d 8s]
Seat 2: Wooly510 (big blind) folded before Flop
Seat 3: dcami_nj folded before Flop (didn't bet)
Seat 4: richy5742 showed [Ad 5c] and won ($0.66) with two pair, Aces and Threes
Seat 5: stock501402 (button) folded on the River
Seat 6: PlayTheBlues4U (small blind) mucked [6d 6h]


*********** # 59 **************
PokerStars Hand #204330100710:  Hold'em No Limit ($0.02/$0.05 USD) - 2019/10/07 20:14:30 ET
Table 'Sculptor' 6-max Seat #1 is the button
Seat 1: cladams73 ($3.26 in chips)
Seat 2: Star6543 ($5.77 in chips)
Seat 3: skillzplumber ($5.74 in chips)
Seat 4: PlayTheBlues4U ($4.78 in chips)
Seat 5: Wooly510 ($6.07 in chips)
Seat 6: DemolishIT ($1.52 in chips)
Star6543: posts small blind $0.02
skillzplumber: posts big blind $0.05
*** HOLE CARDS ***
Dealt to PlayTheBlues4U [Kd Jd]
PlayTheBlues4U: raises $0.10 to $0.15
Wooly510: folds
DemolishIT: folds
cladams73: calls $0.15
Star6543: calls $0.13
skillzplumber: folds
*** FLOP *** [Ks 5c 7s]
Star6543: bets $0.05
skillzplumber said, "whatever  tht means"
PlayTheBlues4U: raises $0.35 to $0.40
cladams73: folds
Star6543: folds
Uncalled bet ($0.35) returned to PlayTheBlues4U
PlayTheBlues4U collected $0.57 from pot
PlayTheBlues4U: doesn't show hand
*** SUMMARY ***
Total pot $0.60 | Rake $0.03
Board [Ks 5c 7s]
Seat 1: cladams73 (button) folded on the Flop
Seat 2: Star6543 (small blind) folded on the Flop
Seat 3: skillzplumber (big blind) folded before Flop
Seat 4: PlayTheBlues4U collected ($0.57)
Seat 5: Wooly510 folded before Flop (didn't bet)
Seat 6: DemolishIT folded before Flop (didn't bet)


*********** # 60 **************
PokerStars Hand #204330100619:  Hold'em No Limit ($0.02/$0.05 USD) - 2019/10/07 20:13:51 ET
Table 'Sculptor' 6-max Seat #6 is the button
Seat 1: cladams73 ($3.61 in chips)
Seat 2: Star6543 ($6.22 in chips)
Seat 3: skillzplumber ($5 in chips)
Seat 4: PlayTheBlues4U ($4.78 in chips)
Seat 5: Wooly510 ($6.07 in chips)
Seat 6: DemolishIT ($1.52 in chips)
cladams73: posts small blind $0.02
Star6543: posts big blind $0.05
*** HOLE CARDS ***
Dealt to PlayTheBlues4U [Qs 4d]
Star6543 said, "trying suckout it hurts"
skillzplumber: calls $0.05
PlayTheBlues4U: folds
Wooly510: folds
DemolishIT: folds
cladams73: raises $0.10 to $0.15
Star6543: calls $0.10
skillzplumber: calls $0.10
*** FLOP *** [3h 8s Ts]
cladams73: bets $0.20
Star6543: calls $0.20
skillzplumber: calls $0.20
*** TURN *** [3h 8s Ts] [Qh]
cladams73: checks
Star6543: bets $0.10
skillzplumber: raises $0.50 to $0.60
cladams73: folds
Star6543: folds [8d]
Uncalled bet ($0.50) returned to skillzplumber
skillzplumber collected $1.19 from pot
skillzplumber: doesn't show hand
*** SUMMARY ***
Total pot $1.25 | Rake $0.06
Board [3h 8s Ts Qh]
Seat 1: cladams73 (small blind) folded on the Turn
Seat 2: Star6543 (big blind) folded on the Turn
Seat 3: skillzplumber collected ($1.19)
Seat 4: PlayTheBlues4U folded before Flop (didn't bet)
Seat 5: Wooly510 folded before Flop (didn't bet)
Seat 6: DemolishIT (button) folded before Flop (didn't bet)


*********** # 61 **************
PokerStars Hand #204330100580:  Hold'em No Limit ($0.02/$0.05 USD) - 2019/10/07 20:13:33 ET
Table 'Sculptor' 6-max Seat #5 is the button
Seat 1: cladams73 ($3.66 in chips)
Seat 2: Star6543 ($6.22 in chips)
Seat 3: skillzplumber ($5 in chips)
Seat 4: PlayTheBlues4U ($4.78 in chips)
Seat 5: Wooly510 ($6.07 in chips)
Seat 6: DemolishIT ($1.47 in chips)
DemolishIT: posts small blind $0.02
cladams73: posts big blind $0.05
*** HOLE CARDS ***
Dealt to PlayTheBlues4U [3d 5h]
Star6543: folds
skillzplumber: folds
PlayTheBlues4U: folds
Wooly510: folds
DemolishIT: raises $0.15 to $0.20
cladams73: folds
Uncalled bet ($0.15) returned to DemolishIT
DemolishIT collected $0.10 from pot
*** SUMMARY ***
Total pot $0.10 | Rake $0
Seat 1: cladams73 (big blind) folded before Flop
Seat 2: Star6543 folded before Flop (didn't bet)
Seat 3: skillzplumber folded before Flop (didn't bet)
Seat 4: PlayTheBlues4U folded before Flop (didn't bet)
Seat 5: Wooly510 (button) folded before Flop (didn't bet)
Seat 6: DemolishIT (small blind) collected ($0.10)


*********** # 62 **************
PokerStars Hand #204330100498:  Hold'em No Limit ($0.02/$0.05 USD) - 2019/10/07 20:13:00 ET
Table 'Sculptor' 6-max Seat #4 is the button
Seat 1: cladams73 ($3.41 in chips)
Seat 2: Star6543 ($6.42 in chips)
Seat 3: skillzplumber ($5 in chips)
Seat 4: PlayTheBlues4U ($4.78 in chips)
Seat 5: Wooly510 ($6.09 in chips)
Seat 6: DemolishIT ($1.52 in chips)
Wooly510: posts small blind $0.02
DemolishIT: posts big blind $0.05
*** HOLE CARDS ***
Dealt to PlayTheBlues4U [Ks 4d]
Star6543 said, "why did you check at turn"
cladams73: raises $0.15 to $0.20
Star6543 said, "go allin with strtaght"
Star6543: calls $0.20
skillzplumber: folds
PlayTheBlues4U: folds
skillzplumber is disconnected
Wooly510: folds
DemolishIT: folds
*** FLOP *** [2s 7d 3c]
cladams73: checks
Star6543: checks
*** TURN *** [2s 7d 3c] [7c]
cladams73: checks
Star6543: checks
*** RIVER *** [2s 7d 3c 7c] [3s]
skillzplumber said, "lol thanks"
cladams73: bets $0.25
Star6543: folds
Uncalled bet ($0.25) returned to cladams73
cladams73 collected $0.45 from pot
cladams73: doesn't show hand
*** SUMMARY ***
Total pot $0.47 | Rake $0.02
Board [2s 7d 3c 7c 3s]
Seat 1: cladams73 collected ($0.45)
Seat 2: Star6543 folded on the River
Seat 3: skillzplumber folded before Flop (didn't bet)
Seat 4: PlayTheBlues4U (button) folded before Flop (didn't bet)
Seat 5: Wooly510 (small blind) folded before Flop
Seat 6: DemolishIT (big blind) folded before Flop


*********** # 63 **************
PokerStars Hand #204330100441:  Hold'em No Limit ($0.02/$0.05 USD) - 2019/10/07 20:12:37 ET
Table 'Fides' 6-max Seat #4 is the button
Seat 3: dcami_nj ($5.41 in chips)
Seat 4: richy5742 ($4.37 in chips)
Seat 5: stock501402 ($14.97 in chips)
Seat 6: PlayTheBlues4U ($5 in chips)
stock501402: posts small blind $0.02
PlayTheBlues4U: posts big blind $0.05
Wooly510: sits out
*** HOLE CARDS ***
Dealt to PlayTheBlues4U [Qh Kh]
dcami_nj has timed out
dcami_nj: folds
richy5742: raises $0.05 to $0.10
stock501402: calls $0.08
PlayTheBlues4U: raises $0.30 to $0.40
richy5742: folds
stock501402: calls $0.30
*** FLOP *** [7c 3c 8s]
stock501402: checks
PlayTheBlues4U: bets $0.60
stock501402: calls $0.60
*** TURN *** [7c 3c 8s] [Ks]
stock501402: bets $0.05
PlayTheBlues4U: raises $1.10 to $1.15
stock501402: calls $1.10
*** RIVER *** [7c 3c 8s Ks] [4s]
stock501402: bets $0.05
PlayTheBlues4U: calls $0.05
*** SHOW DOWN ***
stock501402: shows [Js 9c] (high card King)
PlayTheBlues4U: shows [Qh Kh] (a pair of Kings)
PlayTheBlues4U collected $4.28 from pot
*** SUMMARY ***
Total pot $4.50 | Rake $0.22
Board [7c 3c 8s Ks 4s]
Seat 3: dcami_nj folded before Flop (didn't bet)
Seat 4: richy5742 (button) folded before Flop
Seat 5: stock501402 (small blind) showed [Js 9c] and lost with high card King
Seat 6: PlayTheBlues4U (big blind) showed [Qh Kh] and won ($4.28) with a pair of Kings


*********** # 64 **************
PokerStars Hand #204329939977:  Hold'em No Limit ($0.02/$0.05 USD) - 2019/10/07 20:12:13 ET
Table 'Sculptor' 6-max Seat #3 is the button
Seat 1: cladams73 ($4.39 in chips)
Seat 2: Star6543 ($6.62 in chips)
Seat 3: skillzplumber ($2.26 in chips)
Seat 4: PlayTheBlues4U ($4.80 in chips)
Seat 5: Wooly510 ($5 in chips)
Seat 6: DemolishIT ($1.52 in chips)
PlayTheBlues4U: posts small blind $0.02
Wooly510: posts big blind $0.05
*** HOLE CARDS ***
Dealt to PlayTheBlues4U [5c 3h]
DemolishIT: folds
PlayTheBlues4U said, "oof"
cladams73: raises $0.15 to $0.20
Star6543: calls $0.20
skillzplumber: folds
PlayTheBlues4U: folds
Wooly510: calls $0.15
*** FLOP *** [Ts Th 2c]
skillzplumber said, "i knew it too"
Wooly510: checks
cladams73: bets $0.25
Star6543: folds
Wooly510: calls $0.25
*** TURN *** [Ts Th 2c] [5s]
Wooly510: bets $0.53
cladams73: calls $0.53
*** RIVER *** [Ts Th 2c 5s] [7h]
Wooly510: bets $1.04
cladams73: folds
Uncalled bet ($1.04) returned to Wooly510
Wooly510 collected $2.07 from pot
Wooly510: doesn't show hand
*** SUMMARY ***
Total pot $2.18 | Rake $0.11
Board [Ts Th 2c 5s 7h]
Seat 1: cladams73 folded on the River
Seat 2: Star6543 folded on the Flop
Seat 3: skillzplumber (button) folded before Flop (didn't bet)
Seat 4: PlayTheBlues4U (small blind) folded before Flop
Seat 5: Wooly510 (big blind) collected ($2.07)
Seat 6: DemolishIT folded before Flop (didn't bet)


*********** # 65 **************
PokerStars Hand #204329939790:  Hold'em No Limit ($0.02/$0.05 USD) - 2019/10/07 20:11:01 ET
Table 'Sculptor' 6-max Seat #2 is the button
Seat 1: cladams73 ($4.39 in chips)
Seat 2: Star6543 ($2.83 in chips)
Seat 3: skillzplumber ($5.09 in chips)
Seat 4: PlayTheBlues4U ($5 in chips)
Seat 6: DemolishIT ($2.63 in chips)
skillzplumber: posts small blind $0.02
PlayTheBlues4U: posts big blind $0.05
Wooly510: sits out
*** HOLE CARDS ***
Dealt to PlayTheBlues4U [8s 8h]
DemolishIT: calls $0.05
cladams73: folds
Star6543: calls $0.05
skillzplumber: raises $0.15 to $0.20
PlayTheBlues4U: calls $0.15
DemolishIT: calls $0.15
Star6543: calls $0.15
*** FLOP *** [3s Th Jh]
skillzplumber: checks
PlayTheBlues4U: checks
DemolishIT: bets $0.76
Star6543: calls $0.76
skillzplumber: calls $0.76
PlayTheBlues4U: folds
*** TURN *** [3s Th Jh] [Ac]
skillzplumber: checks
DemolishIT: checks
Star6543: checks
*** RIVER *** [3s Th Jh Ac] [2h]
skillzplumber: bets $0.15
DemolishIT: calls $0.15
Star6543: raises $1.72 to $1.87 and is all-in
skillzplumber: calls $1.72
DemolishIT: folds
*** SHOW DOWN ***
Star6543: shows [Qh 4h] (a flush, Queen high)
skillzplumber: shows [Kd Qs] (a straight, Ten to Ace)
Star6543 collected $6.62 from pot
*** SUMMARY ***
Total pot $6.97 | Rake $0.35
Board [3s Th Jh Ac 2h]
Seat 1: cladams73 folded before Flop (didn't bet)
Seat 2: Star6543 (button) showed [Qh 4h] and won ($6.62) with a flush, Queen high
Seat 3: skillzplumber (small blind) showed [Kd Qs] and lost with a straight, Ten to Ace
Seat 4: PlayTheBlues4U (big blind) folded on the Flop
Seat 6: DemolishIT folded on the River


*********** # 66 **************
PokerStars Hand #204209812319:  Hold'em No Limit ($0.02/$0.05 USD) - 2019/10/03 23:32:29 ET
Table 'Phoenix' 6-max Seat #2 is the button
Seat 1: smokestackinggg ($3.18 in chips)
Seat 2: 921zhaopeng ($4.19 in chips)
Seat 4: DnDManiac ($4.75 in chips)
Seat 5: 2sukar7 ($4.85 in chips)
Seat 6: PlayTheBlues4U ($12.18 in chips)
DnDManiac: posts small blind $0.02
2sukar7: posts big blind $0.05
*** HOLE CARDS ***
Dealt to PlayTheBlues4U [Qs Kd]
PlayTheBlues4U: raises $0.10 to $0.15
smokestackinggg: raises $0.10 to $0.25
921zhaopeng: folds
DnDManiac: folds
2sukar7: folds
PlayTheBlues4U: calls $0.10
*** FLOP *** [9s Ts Js]
PlayTheBlues4U: bets $0.50
smokestackinggg: calls $0.50
*** TURN *** [9s Ts Js] [6h]
PlayTheBlues4U: bets $11.43 and is all-in
smokestackinggg: calls $2.43 and is all-in
Uncalled bet ($9) returned to PlayTheBlues4U
*** RIVER *** [9s Ts Js 6h] [3s]
*** SHOW DOWN ***
PlayTheBlues4U: shows [Qs Kd] (a flush, Queen high)
smokestackinggg: shows [Qh Qc] (a pair of Queens)
PlayTheBlues4U collected $6.11 from pot
*** SUMMARY ***
Total pot $6.43 | Rake $0.32
Board [9s Ts Js 6h 3s]
Seat 1: smokestackinggg showed [Qh Qc] and lost with a pair of Queens
Seat 2: 921zhaopeng (button) folded before Flop (didn't bet)
Seat 4: DnDManiac (small blind) folded before Flop
Seat 5: 2sukar7 (big blind) folded before Flop
Seat 6: PlayTheBlues4U showed [Qs Kd] and won ($6.11) with a flush, Queen high


*********** # 67 **************
PokerStars Hand #204209812268:  Hold'em No Limit ($0.02/$0.05 USD) - 2019/10/03 23:32:00 ET
Table 'Phoenix' 6-max Seat #1 is the button
Seat 1: smokestackinggg ($3.23 in chips)
Seat 2: 921zhaopeng ($3.96 in chips)
Seat 4: DnDManiac ($4.95 in chips)
Seat 5: 2sukar7 ($4.85 in chips)
Seat 6: PlayTheBlues4U ($12.18 in chips)
921zhaopeng: posts small blind $0.02
DnDManiac: posts big blind $0.05
*** HOLE CARDS ***
Dealt to PlayTheBlues4U [4c Qs]
2sukar7: folds
PlayTheBlues4U: folds
smokestackinggg: calls $0.05
921zhaopeng: raises $0.15 to $0.20
DnDManiac: calls $0.15
smokestackinggg: folds
*** FLOP *** [7c 8h 7h]
921zhaopeng: bets $0.25
DnDManiac: folds
Uncalled bet ($0.25) returned to 921zhaopeng
921zhaopeng collected $0.43 from pot
921zhaopeng: doesn't show hand
*** SUMMARY ***
Total pot $0.45 | Rake $0.02
Board [7c 8h 7h]
Seat 1: smokestackinggg (button) folded before Flop
Seat 2: 921zhaopeng (small blind) collected ($0.43)
Seat 4: DnDManiac (big blind) folded on the Flop
Seat 5: 2sukar7 folded before Flop (didn't bet)
Seat 6: PlayTheBlues4U folded before Flop (didn't bet)


*********** # 68 **************
PokerStars Hand #204209812207:  Hold'em No Limit ($0.02/$0.05 USD) - 2019/10/03 23:31:23 ET
Table 'Phoenix' 6-max Seat #6 is the button
Seat 1: smokestackinggg ($3.28 in chips)
Seat 2: 921zhaopeng ($3.73 in chips)
Seat 4: DnDManiac ($5 in chips)
Seat 5: 2sukar7 ($5 in chips)
Seat 6: PlayTheBlues4U ($12.18 in chips)
smokestackinggg: posts small blind $0.02
921zhaopeng: posts big blind $0.05
DnDManiac: posts big blind $0.05
2sukar7: posts big blind $0.05
*** HOLE CARDS ***
Dealt to PlayTheBlues4U [8h 2d]
DnDManiac: checks
2sukar7: checks
PlayTheBlues4U: folds
smokestackinggg: calls $0.03
921zhaopeng: checks
*** FLOP *** [8c 9h 6c]
smokestackinggg: checks
921zhaopeng: bets $0.10
DnDManiac: folds
2sukar7: calls $0.10
smokestackinggg: folds
*** TURN *** [8c 9h 6c] [3c]
921zhaopeng: bets $0.20
2sukar7: folds
Uncalled bet ($0.20) returned to 921zhaopeng
921zhaopeng collected $0.38 from pot
921zhaopeng: doesn't show hand
*** SUMMARY ***
Total pot $0.40 | Rake $0.02
Board [8c 9h 6c 3c]
Seat 1: smokestackinggg (small blind) folded on the Flop
Seat 2: 921zhaopeng (big blind) collected ($0.38)
Seat 4: DnDManiac folded on the Flop (didn't bet)
Seat 5: 2sukar7 folded on the Turn
Seat 6: PlayTheBlues4U (button) folded before Flop (didn't bet)


*********** # 69 **************
PokerStars Hand #204209812188:  Hold'em No Limit ($0.02/$0.05 USD) - 2019/10/03 23:31:13 ET
Table 'Phoenix' 6-max Seat #2 is the button
Seat 1: smokestackinggg ($3.33 in chips)
Seat 2: 921zhaopeng ($3.73 in chips)
Seat 6: PlayTheBlues4U ($12.13 in chips)
DnDManiac will be allowed to play after the button
2sukar7 will be allowed to play after the button
PlayTheBlues4U: posts small blind $0.02
smokestackinggg: posts big blind $0.05
*** HOLE CARDS ***
Dealt to PlayTheBlues4U [Kc Qd]
921zhaopeng: folds
PlayTheBlues4U: raises $0.10 to $0.15
smokestackinggg: folds
Uncalled bet ($0.10) returned to PlayTheBlues4U
PlayTheBlues4U collected $0.10 from pot
PlayTheBlues4U: doesn't show hand
*** SUMMARY ***
Total pot $0.10 | Rake $0
Seat 1: smokestackinggg (big blind) folded before Flop
Seat 2: 921zhaopeng (button) folded before Flop (didn't bet)
Seat 6: PlayTheBlues4U (small blind) collected ($0.10)


*********** # 70 **************
PokerStars Hand #204209812114:  Hold'em No Limit ($0.02/$0.05 USD) - 2019/10/03 23:30:30 ET
Table 'Phoenix' 6-max Seat #1 is the button
Seat 1: smokestackinggg ($3.08 in chips)
Seat 2: 921zhaopeng ($3.95 in chips)
Seat 6: PlayTheBlues4U ($12.18 in chips)
921zhaopeng: posts small blind $0.02
PlayTheBlues4U: posts big blind $0.05
*** HOLE CARDS ***
Dealt to PlayTheBlues4U [As 3c]
DnDManiac joins the table at seat #4
smokestackinggg: calls $0.05
921zhaopeng: calls $0.03
PlayTheBlues4U: checks
*** FLOP *** [7s 4c Qc]
921zhaopeng: checks
PlayTheBlues4U: checks
smokestackinggg: checks
*** TURN *** [7s 4c Qc] [3s]
921zhaopeng: bets $0.05
PlayTheBlues4U: folds
smokestackinggg: raises $0.12 to $0.17
921zhaopeng: calls $0.12
*** RIVER *** [7s 4c Qc 3s] [5c]
921zhaopeng: checks
smokestackinggg: bets $0.24
2sukar7 joins the table at seat #5
921zhaopeng: folds
Uncalled bet ($0.24) returned to smokestackinggg
smokestackinggg collected $0.47 from pot
smokestackinggg: doesn't show hand
*** SUMMARY ***
Total pot $0.49 | Rake $0.02
Board [7s 4c Qc 3s 5c]
Seat 1: smokestackinggg (button) collected ($0.47)
Seat 2: 921zhaopeng (small blind) folded on the River
Seat 6: PlayTheBlues4U (big blind) folded on the Turn


*********** # 71 **************
PokerStars Hand #204209812072:  Hold'em No Limit ($0.02/$0.05 USD) - 2019/10/03 23:30:13 ET
Table 'Phoenix' 6-max Seat #6 is the button
Seat 1: smokestackinggg ($3.13 in chips)
Seat 2: 921zhaopeng ($3.90 in chips)
Seat 6: PlayTheBlues4U ($12.18 in chips)
smokestackinggg: posts small blind $0.02
921zhaopeng: posts big blind $0.05
*** HOLE CARDS ***
Dealt to PlayTheBlues4U [2s Jd]
PlayTheBlues4U: folds
smokestackinggg: calls $0.03
921zhaopeng: checks
*** FLOP *** [8s Qc Ks]
smokestackinggg: checks
921zhaopeng: bets $0.15
smokestackinggg: folds
Uncalled bet ($0.15) returned to 921zhaopeng
kysinjer leaves the table
921zhaopeng collected $0.10 from pot
921zhaopeng: doesn't show hand
*** SUMMARY ***
Total pot $0.10 | Rake $0
Board [8s Qc Ks]
Seat 1: smokestackinggg (small blind) folded on the Flop
Seat 2: 921zhaopeng (big blind) collected ($0.10)
Seat 6: PlayTheBlues4U (button) folded before Flop (didn't bet)


*********** # 72 **************
PokerStars Hand #204209812034:  Hold'em No Limit ($0.02/$0.05 USD) - 2019/10/03 23:29:50 ET
Table 'Phoenix' 6-max Seat #1 is the button
Seat 1: smokestackinggg ($3.18 in chips)
Seat 5: kysinjer ($2.85 in chips)
Seat 6: PlayTheBlues4U ($9.57 in chips)
921zhaopeng will be allowed to play after the button
kysinjer: posts small blind $0.02
PlayTheBlues4U: posts big blind $0.05
*** HOLE CARDS ***
Dealt to PlayTheBlues4U [Ac Ad]
smokestackinggg: calls $0.05
kysinjer: raises $2.80 to $2.85 and is all-in
PlayTheBlues4U: raises $6.72 to $9.57 and is all-in
smokestackinggg: folds
Uncalled bet ($6.72) returned to PlayTheBlues4U
*** FLOP *** [Kd 4c 9h]
kysinjer said, "LOL"
*** TURN *** [Kd 4c 9h] [4h]
*** RIVER *** [Kd 4c 9h 4h] [Kc]
*** SHOW DOWN ***
kysinjer: shows [Qs Qd] (two pair, Kings and Queens)
PlayTheBlues4U: shows [Ac Ad] (two pair, Aces and Kings)
PlayTheBlues4U collected $5.46 from pot
*** SUMMARY ***
Total pot $5.75 | Rake $0.29
Board [Kd 4c 9h 4h Kc]
Seat 1: smokestackinggg (button) folded before Flop
Seat 5: kysinjer (small blind) showed [Qs Qd] and lost with two pair, Kings and Queens
Seat 6: PlayTheBlues4U (big blind) showed [Ac Ad] and won ($5.46) with two pair, Aces and Kings


*********** # 73 **************
PokerStars Hand #204209812014:  Hold'em No Limit ($0.05/$0.10 USD) - 2019/10/03 23:29:38 ET
Table 'Pollux' 6-max Seat #2 is the button
Seat 1: mellneazy ($8.36 in chips)
Seat 2: Masonstone3 ($41.88 in chips)
Seat 3: Onannio ($10.66 in chips)
Seat 4: hand shuffle ($9.40 in chips)
Seat 5: PlayTheBlues4U ($11.50 in chips)
Seat 6: bbkid44 ($13.84 in chips)
Onannio: posts small blind $0.05
hand shuffle: posts big blind $0.10
*** HOLE CARDS ***
Dealt to PlayTheBlues4U [5s Qh]
PlayTheBlues4U has timed out
PlayTheBlues4U: folds
bbkid44: calls $0.10
mellneazy: folds
Masonstone3: folds
Onannio: calls $0.05
hand shuffle: checks
*** FLOP *** [3s As 5d]
Onannio: checks
hand shuffle: bets $0.10
bbkid44: folds
Onannio: folds
Uncalled bet ($0.10) returned to hand shuffle
hand shuffle collected $0.28 from pot
hand shuffle: doesn't show hand
*** SUMMARY ***
Total pot $0.30 | Rake $0.02
Board [3s As 5d]
Seat 1: mellneazy folded before Flop (didn't bet)
Seat 2: Masonstone3 (button) folded before Flop (didn't bet)
Seat 3: Onannio (small blind) folded on the Flop
Seat 4: hand shuffle (big blind) collected ($0.28)
Seat 5: PlayTheBlues4U folded before Flop (didn't bet)
Seat 6: bbkid44 folded on the Flop


*********** # 74 **************
PokerStars Hand #204209811915:  Hold'em No Limit ($0.05/$0.10 USD) - 2019/10/03 23:28:49 ET
Table 'Pollux' 6-max Seat #1 is the button
Seat 1: mellneazy ($8.81 in chips)
Seat 2: Masonstone3 ($41.93 in chips)
Seat 3: Onannio ($11.91 in chips)
Seat 4: hand shuffle ($9.40 in chips)
Seat 5: PlayTheBlues4U ($11.50 in chips)
Seat 6: bbkid44 ($12.24 in chips)
Masonstone3: posts small blind $0.05
Onannio: posts big blind $0.10
*** HOLE CARDS ***
Dealt to PlayTheBlues4U [7h 4h]
hand shuffle: folds
PlayTheBlues4U: folds
bbkid44: calls $0.10
mellneazy: raises $0.35 to $0.45
Masonstone3: folds
Onannio: calls $0.35
bbkid44: calls $0.35
*** FLOP *** [Js 4d Jd]
Onannio: checks
bbkid44: bets $0.80
mellneazy: folds
Onannio: calls $0.80
*** TURN *** [Js 4d Jd] [8s]
Onannio: checks
bbkid44: bets $1.43
Onannio: folds
Uncalled bet ($1.43) returned to bbkid44
bbkid44 collected $2.85 from pot
bbkid44: doesn't show hand
*** SUMMARY ***
Total pot $3 | Rake $0.15
Board [Js 4d Jd 8s]
Seat 1: mellneazy (button) folded on the Flop
Seat 2: Masonstone3 (small blind) folded before Flop
Seat 3: Onannio (big blind) folded on the Turn
Seat 4: hand shuffle folded before Flop (didn't bet)
Seat 5: PlayTheBlues4U folded before Flop (didn't bet)
Seat 6: bbkid44 collected ($2.85)


*********** # 75 **************
PokerStars Hand #204209811830:  Hold'em No Limit ($0.05/$0.10 USD) - 2019/10/03 23:28:09 ET
Table 'Pollux' 6-max Seat #6 is the button
Seat 1: mellneazy ($9.11 in chips)
Seat 2: Masonstone3 ($42.83 in chips)
Seat 3: Onannio ($10.81 in chips)
Seat 4: hand shuffle ($9.40 in chips)
Seat 5: PlayTheBlues4U ($11.50 in chips)
Seat 6: bbkid44 ($12.24 in chips)
mellneazy: posts small blind $0.05
Masonstone3: posts big blind $0.10
*** HOLE CARDS ***
Dealt to PlayTheBlues4U [4s 7c]
Onannio: calls $0.10
hand shuffle: folds
PlayTheBlues4U: folds
bbkid44: folds
mellneazy: calls $0.05
Masonstone3: checks
*** FLOP *** [8s Jc 9h]
mellneazy: checks
Masonstone3: checks
Onannio: checks
*** TURN *** [8s Jc 9h] [8h]
mellneazy: bets $0.20
Masonstone3: calls $0.20
Onannio: calls $0.20
*** RIVER *** [8s Jc 9h 8h] [Tc]
mellneazy: checks
Masonstone3: checks
Onannio: bets $0.60
mellneazy: folds
Masonstone3: calls $0.60
*** SHOW DOWN ***
Onannio: shows [Kc Qs] (a straight, Nine to King)
Masonstone3: mucks hand
Onannio collected $2 from pot
*** SUMMARY ***
Total pot $2.10 | Rake $0.10
Board [8s Jc 9h 8h Tc]
Seat 1: mellneazy (small blind) folded on the River
Seat 2: Masonstone3 (big blind) mucked [7d 9c]
Seat 3: Onannio showed [Kc Qs] and won ($2) with a straight, Nine to King
Seat 4: hand shuffle folded before Flop (didn't bet)
Seat 5: PlayTheBlues4U folded before Flop (didn't bet)
Seat 6: bbkid44 (button) folded before Flop (didn't bet)


*********** # 76 **************
PokerStars Hand #204209811777:  Hold'em No Limit ($0.05/$0.10 USD) - 2019/10/03 23:27:50 ET
Table 'Pollux' 6-max Seat #5 is the button
Seat 1: mellneazy ($9.21 in chips)
Seat 2: Masonstone3 ($42.83 in chips)
Seat 3: Onannio ($10.81 in chips)
Seat 4: hand shuffle ($9.40 in chips)
Seat 5: PlayTheBlues4U ($11.35 in chips)
Seat 6: bbkid44 ($12.29 in chips)
bbkid44: posts small blind $0.05
mellneazy: posts big blind $0.10
*** HOLE CARDS ***
Dealt to PlayTheBlues4U [2d Ad]
Masonstone3: folds
Onannio: folds
hand shuffle: folds
PlayTheBlues4U: raises $0.20 to $0.30
bbkid44: folds
mellneazy: folds
Uncalled bet ($0.20) returned to PlayTheBlues4U
PlayTheBlues4U collected $0.25 from pot
PlayTheBlues4U: doesn't show hand
*** SUMMARY ***
Total pot $0.25 | Rake $0
Seat 1: mellneazy (big blind) folded before Flop
Seat 2: Masonstone3 folded before Flop (didn't bet)
Seat 3: Onannio folded before Flop (didn't bet)
Seat 4: hand shuffle folded before Flop (didn't bet)
Seat 5: PlayTheBlues4U (button) collected ($0.25)
Seat 6: bbkid44 (small blind) folded before Flop


*********** # 77 **************
PokerStars Hand #204209811740:  Hold'em No Limit ($0.02/$0.05 USD) - 2019/10/03 23:27:26 ET
Table 'Phoenix' 6-max Seat #6 is the button
Seat 1: smokestackinggg ($3.20 in chips)
Seat 3: Smuggler1991 ($5.78 in chips)
Seat 4: trocchia79 ($4.44 in chips)
Seat 5: kysinjer ($7.85 in chips)
Seat 6: PlayTheBlues4U ($5 in chips)
smokestackinggg: posts small blind $0.02
rellerz: is sitting out
Smuggler1991: posts big blind $0.05
*** HOLE CARDS ***
Dealt to PlayTheBlues4U [Ah Ks]
trocchia79: folds
rellerz leaves the table
kysinjer: calls $0.05
921zhaopeng joins the table at seat #2
PlayTheBlues4U: raises $0.15 to $0.20
smokestackinggg: folds
Smuggler1991 has timed out
Smuggler1991: folds
kysinjer: raises $0.80 to $1
trocchia79 leaves the table
PlayTheBlues4U: calls $0.80
*** FLOP *** [Kh 6s Ts]
kysinjer: bets $6.85 and is all-in
PlayTheBlues4U: calls $4 and is all-in
Uncalled bet ($2.85) returned to kysinjer
*** TURN *** [Kh 6s Ts] [7h]
*** RIVER *** [Kh 6s Ts 7h] [9s]
*** SHOW DOWN ***
kysinjer: shows [4c 4s] (a pair of Fours)
PlayTheBlues4U: shows [Ah Ks] (a pair of Kings)
PlayTheBlues4U collected $9.57 from pot
*** SUMMARY ***
Total pot $10.07 | Rake $0.50
Board [Kh 6s Ts 7h 9s]
Seat 1: smokestackinggg (small blind) folded before Flop
Seat 3: Smuggler1991 (big blind) folded before Flop
Seat 4: trocchia79 folded before Flop (didn't bet)
Seat 5: kysinjer showed [4c 4s] and lost with a pair of Fours
Seat 6: PlayTheBlues4U (button) showed [Ah Ks] and won ($9.57) with a pair of Kings


*********** # 78 **************
PokerStars Hand #204209811706:  Hold'em No Limit ($0.05/$0.10 USD) - 2019/10/03 23:27:09 ET
Table 'Pollux' 6-max Seat #4 is the button
Seat 1: mellneazy ($9.21 in chips)
Seat 2: Masonstone3 ($43.33 in chips)
Seat 3: Onannio ($10.81 in chips)
Seat 4: hand shuffle ($9.40 in chips)
Seat 5: PlayTheBlues4U ($11.40 in chips)
Seat 6: bbkid44 ($11.79 in chips)
PlayTheBlues4U: posts small blind $0.05
bbkid44: posts big blind $0.10
*** HOLE CARDS ***
Dealt to PlayTheBlues4U [3c Qh]
mellneazy: folds
Masonstone3: raises $0.20 to $0.30
Onannio: folds
hand shuffle: folds
PlayTheBlues4U: folds
bbkid44: raises $0.20 to $0.50
Masonstone3: calls $0.20
*** FLOP *** [Jh Kh 8c]
bbkid44: bets $1.40
Masonstone3: folds
Uncalled bet ($1.40) returned to bbkid44
bbkid44 collected $1 from pot
bbkid44: doesn't show hand
*** SUMMARY ***
Total pot $1.05 | Rake $0.05
Board [Jh Kh 8c]
Seat 1: mellneazy folded before Flop (didn't bet)
Seat 2: Masonstone3 folded on the Flop
Seat 3: Onannio folded before Flop (didn't bet)
Seat 4: hand shuffle (button) folded before Flop (didn't bet)
Seat 5: PlayTheBlues4U (small blind) folded before Flop
Seat 6: bbkid44 (big blind) collected ($1)


*********** # 79 **************
PokerStars Hand #204209811607:  Hold'em No Limit ($0.02/$0.05 USD) - 2019/10/03 23:26:28 ET
Table 'Phoenix' 6-max Seat #5 is the button
Seat 1: smokestackinggg ($3.25 in chips)
Seat 2: rellerz ($3.61 in chips)
Seat 3: Smuggler1991 ($5.78 in chips)
Seat 4: trocchia79 ($5.09 in chips)
Seat 5: kysinjer ($7.85 in chips)
Seat 6: PlayTheBlues4U ($2.76 in chips)
PlayTheBlues4U: posts small blind $0.02
smokestackinggg: posts big blind $0.05
*** HOLE CARDS ***
Dealt to PlayTheBlues4U [7h Ts]
rellerz: calls $0.05
Smuggler1991: folds
trocchia79: calls $0.05
kysinjer: folds
PlayTheBlues4U: folds
smokestackinggg: checks
*** FLOP *** [4c 9d Kd]
smokestackinggg: checks
rellerz: bets $0.15
trocchia79: calls $0.15
smokestackinggg: folds
*** TURN *** [4c 9d Kd] [8c]
rellerz: bets $0.45
trocchia79: calls $0.45
*** RIVER *** [4c 9d Kd 8c] [3c]
rellerz: bets $1.30
trocchia79: folds
Uncalled bet ($1.30) returned to rellerz
rellerz collected $1.30 from pot
rellerz: doesn't show hand
*** SUMMARY ***
Total pot $1.37 | Rake $0.07
Board [4c 9d Kd 8c 3c]
Seat 1: smokestackinggg (big blind) folded on the Flop
Seat 2: rellerz collected ($1.30)
Seat 3: Smuggler1991 folded before Flop (didn't bet)
Seat 4: trocchia79 folded on the River
Seat 5: kysinjer (button) folded before Flop (didn't bet)
Seat 6: PlayTheBlues4U (small blind) folded before Flop


*********** # 80 **************
PokerStars Hand #204209811557:  Hold'em No Limit ($0.05/$0.10 USD) - 2019/10/03 23:25:59 ET
Table 'Pollux' 6-max Seat #3 is the button
Seat 1: mellneazy ($9.21 in chips)
Seat 2: Masonstone3 ($43.33 in chips)
Seat 3: Onannio ($10.81 in chips)
Seat 4: hand shuffle ($9.70 in chips)
Seat 5: PlayTheBlues4U ($10.48 in chips)
Seat 6: bbkid44 ($12.49 in chips)
hand shuffle: posts small blind $0.05
PlayTheBlues4U: posts big blind $0.10
*** HOLE CARDS ***
Dealt to PlayTheBlues4U [4c 6c]
bbkid44: raises $0.10 to $0.20
mellneazy: folds
Masonstone3: folds
Onannio: folds
hand shuffle: calls $0.15
PlayTheBlues4U: calls $0.10
*** FLOP *** [4d Ts 9s]
hand shuffle: bets $0.10
PlayTheBlues4U: raises $0.40 to $0.50
bbkid44: calls $0.50
hand shuffle: folds
*** TURN *** [4d Ts 9s] [6h]
PlayTheBlues4U: bets $1.10
bbkid44: folds
Uncalled bet ($1.10) returned to PlayTheBlues4U
PlayTheBlues4U collected $1.62 from pot
PlayTheBlues4U: doesn't show hand
*** SUMMARY ***
Total pot $1.70 | Rake $0.08
Board [4d Ts 9s 6h]
Seat 1: mellneazy folded before Flop (didn't bet)
Seat 2: Masonstone3 folded before Flop (didn't bet)
Seat 3: Onannio (button) folded before Flop (didn't bet)
Seat 4: hand shuffle (small blind) folded on the Flop
Seat 5: PlayTheBlues4U (big blind) collected ($1.62)
Seat 6: bbkid44 folded on the Turn


*********** # 81 **************
PokerStars Hand #204209811427:  Hold'em No Limit ($0.05/$0.10 USD) - 2019/10/03 23:24:57 ET
Table 'Pollux' 6-max Seat #2 is the button
Seat 1: mellneazy ($9.21 in chips)
Seat 2: Masonstone3 ($43.33 in chips)
Seat 3: Onannio ($10.91 in chips)
Seat 4: hand shuffle ($9.90 in chips)
Seat 5: PlayTheBlues4U ($10.48 in chips)
Seat 6: bbkid44 ($12.21 in chips)
Onannio: posts small blind $0.05
hand shuffle: posts big blind $0.10
*** HOLE CARDS ***
Dealt to PlayTheBlues4U [6s Kd]
PlayTheBlues4U: folds
bbkid44: calls $0.10
mellneazy: folds
Masonstone3: folds
Onannio: calls $0.05
hand shuffle: checks
*** FLOP *** [Js 2h 9h]
Onannio: checks
hand shuffle: bets $0.10
bbkid44: calls $0.10
Onannio: folds
*** TURN *** [Js 2h 9h] [2c]
hand shuffle: checks
bbkid44: checks
*** RIVER *** [Js 2h 9h 2c] [Ks]
hand shuffle: checks
bbkid44: bets $1
hand shuffle: folds
Uncalled bet ($1) returned to bbkid44
bbkid44 collected $0.48 from pot
bbkid44: doesn't show hand
*** SUMMARY ***
Total pot $0.50 | Rake $0.02
Board [Js 2h 9h 2c Ks]
Seat 1: mellneazy folded before Flop (didn't bet)
Seat 2: Masonstone3 (button) folded before Flop (didn't bet)
Seat 3: Onannio (small blind) folded on the Flop
Seat 4: hand shuffle (big blind) folded on the River
Seat 5: PlayTheBlues4U folded before Flop (didn't bet)
Seat 6: bbkid44 collected ($0.48)


*********** # 82 **************
PokerStars Hand #204209811321:  Hold'em No Limit ($0.02/$0.05 USD) - 2019/10/03 23:24:12 ET
Table 'Phoenix' 6-max Seat #4 is the button
Seat 1: smokestackinggg ($3.10 in chips)
Seat 2: rellerz ($3.61 in chips)
Seat 3: Smuggler1991 ($5.78 in chips)
Seat 4: trocchia79 ($5.88 in chips)
Seat 5: kysinjer ($5.13 in chips)
Seat 6: PlayTheBlues4U ($4.95 in chips)
kysinjer: posts small blind $0.02
PlayTheBlues4U: posts big blind $0.05
*** HOLE CARDS ***
Dealt to PlayTheBlues4U [Ts Qc]
smokestackinggg: folds
rellerz: folds
Smuggler1991: folds
trocchia79: calls $0.05
kysinjer: raises $0.10 to $0.15
PlayTheBlues4U: calls $0.10
trocchia79: calls $0.10
*** FLOP *** [5c Jd 9d]
kysinjer: bets $0.22
PlayTheBlues4U: raises $0.42 to $0.64
trocchia79: calls $0.64
kysinjer: calls $0.42
*** TURN *** [5c Jd 9d] [Qh]
kysinjer: checks
PlayTheBlues4U: bets $1.40
trocchia79: folds
kysinjer: calls $1.40
*** RIVER *** [5c Jd 9d Qh] [Th]
kysinjer: bets $2.94 and is all-in
PlayTheBlues4U: folds
Uncalled bet ($2.94) returned to kysinjer
kysinjer collected $4.91 from pot
kysinjer: doesn't show hand
*** SUMMARY ***
Total pot $5.17 | Rake $0.26
Board [5c Jd 9d Qh Th]
Seat 1: smokestackinggg folded before Flop (didn't bet)
Seat 2: rellerz folded before Flop (didn't bet)
Seat 3: Smuggler1991 folded before Flop (didn't bet)
Seat 4: trocchia79 (button) folded on the Turn
Seat 5: kysinjer (small blind) collected ($4.91)
Seat 6: PlayTheBlues4U (big blind) folded on the River


*********** # 83 **************
PokerStars Hand #204209811301:  Hold'em No Limit ($0.05/$0.10 USD) - 2019/10/03 23:24:01 ET
Table 'Pollux' 6-max Seat #1 is the button
Seat 1: mellneazy ($9.31 in chips)
Seat 2: Masonstone3 ($42.24 in chips)
Seat 3: Onannio ($11.01 in chips)
Seat 4: hand shuffle ($9.90 in chips)
Seat 5: PlayTheBlues4U ($10.48 in chips)
Seat 6: bbkid44 ($13.21 in chips)
Masonstone3: posts small blind $0.05
Onannio: posts big blind $0.10
*** HOLE CARDS ***
Dealt to PlayTheBlues4U [7h 3h]
hand shuffle: folds
PlayTheBlues4U: folds
bbkid44: calls $0.10
mellneazy: calls $0.10
Masonstone3: raises $0.40 to $0.50
Onannio: folds
bbkid44: calls $0.40
mellneazy: folds
*** FLOP *** [Qh 7s 3c]
Masonstone3: bets $0.50
bbkid44: calls $0.50
*** TURN *** [Qh 7s 3c] [2d]
Masonstone3: bets $1.90
bbkid44: folds
Uncalled bet ($1.90) returned to Masonstone3
Masonstone3 collected $2.09 from pot
Masonstone3: doesn't show hand
*** SUMMARY ***
Total pot $2.20 | Rake $0.11
Board [Qh 7s 3c 2d]
Seat 1: mellneazy (button) folded before Flop
Seat 2: Masonstone3 (small blind) collected ($2.09)
Seat 3: Onannio (big blind) folded before Flop
Seat 4: hand shuffle folded before Flop (didn't bet)
Seat 5: PlayTheBlues4U folded before Flop (didn't bet)
Seat 6: bbkid44 folded on the Turn


*********** # 84 **************
PokerStars Hand #204209811194:  Hold'em No Limit ($0.05/$0.10 USD) - 2019/10/03 23:23:15 ET
Table 'Pollux' 6-max Seat #6 is the button
Seat 1: mellneazy ($9.36 in chips)
Seat 2: Masonstone3 ($42.54 in chips)
Seat 3: Onannio ($11.51 in chips)
Seat 4: hand shuffle ($9.90 in chips)
Seat 5: PlayTheBlues4U ($9.70 in chips)
Seat 6: bbkid44 ($13.21 in chips)
mellneazy: posts small blind $0.05
Masonstone3: posts big blind $0.10
*** HOLE CARDS ***
Dealt to PlayTheBlues4U [9d 9c]
Onannio: calls $0.10
hand shuffle: folds
PlayTheBlues4U: raises $0.20 to $0.30
bbkid44: folds
mellneazy: folds
Masonstone3: calls $0.20
Onannio: calls $0.20
*** FLOP *** [2h 9h Kc]
Masonstone3: checks
Onannio: bets $0.20
PlayTheBlues4U: raises $0.50 to $0.70
Masonstone3: folds
Onannio: folds
Uncalled bet ($0.50) returned to PlayTheBlues4U
PlayTheBlues4U collected $1.28 from pot
PlayTheBlues4U: doesn't show hand
*** SUMMARY ***
Total pot $1.35 | Rake $0.07
Board [2h 9h Kc]
Seat 1: mellneazy (small blind) folded before Flop
Seat 2: Masonstone3 (big blind) folded on the Flop
Seat 3: Onannio folded on the Flop
Seat 4: hand shuffle folded before Flop (didn't bet)
Seat 5: PlayTheBlues4U collected ($1.28)
Seat 6: bbkid44 (button) folded before Flop (didn't bet)


*********** # 85 **************
PokerStars Hand #204209811185:  Hold'em No Limit ($0.02/$0.05 USD) - 2019/10/03 23:23:13 ET
Table 'Phoenix' 6-max Seat #3 is the button
Seat 1: smokestackinggg ($3.10 in chips)
Seat 2: rellerz ($3.61 in chips)
Seat 3: Smuggler1991 ($5.78 in chips)
Seat 4: trocchia79 ($6.03 in chips)
Seat 5: kysinjer ($5 in chips)
Seat 6: PlayTheBlues4U ($4.95 in chips)
trocchia79: posts small blind $0.02
kysinjer: posts big blind $0.05
*** HOLE CARDS ***
Dealt to PlayTheBlues4U [6d 8c]
PlayTheBlues4U: folds
smokestackinggg: folds
rellerz: folds
Smuggler1991: folds
trocchia79: calls $0.03
kysinjer: checks
*** FLOP *** [Jh 9s 8d]
trocchia79: bets $0.10
kysinjer: calls $0.10
*** TURN *** [Jh 9s 8d] [Jc]
trocchia79: checks
kysinjer: bets $0.28
trocchia79: folds
Uncalled bet ($0.28) returned to kysinjer
kysinjer collected $0.28 from pot
kysinjer: doesn't show hand
*** SUMMARY ***
Total pot $0.30 | Rake $0.02
Board [Jh 9s 8d Jc]
Seat 1: smokestackinggg folded before Flop (didn't bet)
Seat 2: rellerz folded before Flop (didn't bet)
Seat 3: Smuggler1991 (button) folded before Flop (didn't bet)
Seat 4: trocchia79 (small blind) folded on the Turn
Seat 5: kysinjer (big blind) collected ($0.28)
Seat 6: PlayTheBlues4U folded before Flop (didn't bet)


*********** # 86 **************
PokerStars Hand #204209811168:  Hold'em No Limit ($0.02/$0.05 USD) - 2019/10/03 23:23:05 ET
Table 'Phoenix' 6-max Seat #2 is the button
Seat 1: smokestackinggg ($3.10 in chips)
Seat 2: rellerz ($3.61 in chips)
Seat 3: Smuggler1991 ($5.80 in chips)
Seat 4: trocchia79 ($6.01 in chips)
Seat 6: PlayTheBlues4U ($4.95 in chips)
Smuggler1991: posts small blind $0.02
trocchia79: posts big blind $0.05
kysinjer: sits out
*** HOLE CARDS ***
Dealt to PlayTheBlues4U [8c As]
PlayTheBlues4U: folds
smokestackinggg: folds
rellerz: folds
Smuggler1991: folds
Uncalled bet ($0.03) returned to trocchia79
trocchia79 collected $0.04 from pot
trocchia79: doesn't show hand
*** SUMMARY ***
Total pot $0.04 | Rake $0
Seat 1: smokestackinggg folded before Flop (didn't bet)
Seat 2: rellerz (button) folded before Flop (didn't bet)
Seat 3: Smuggler1991 (small blind) folded before Flop
Seat 4: trocchia79 (big blind) collected ($0.04)
Seat 6: PlayTheBlues4U folded before Flop (didn't bet)


*********** # 87 **************
PokerStars Hand #204209811103:  Hold'em No Limit ($0.02/$0.05 USD) - 2019/10/03 23:22:39 ET
Table 'Phoenix' 6-max Seat #1 is the button
Seat 1: smokestackinggg ($3.20 in chips)
Seat 2: rellerz ($3.63 in chips)
Seat 3: Smuggler1991 ($5.63 in chips)
Seat 4: trocchia79 ($6.06 in chips)
Seat 6: PlayTheBlues4U ($4.95 in chips)
rellerz: posts small blind $0.02
Smuggler1991: posts big blind $0.05
kysinjer: sits out
*** HOLE CARDS ***
Dealt to PlayTheBlues4U [3s Qh]
trocchia79: calls $0.05
PlayTheBlues4U: folds
smokestackinggg: raises $0.05 to $0.10
rellerz: folds
Smuggler1991: raises $0.27 to $0.37
trocchia79: folds
smokestackinggg: folds
Uncalled bet ($0.27) returned to Smuggler1991
Smuggler1991 collected $0.27 from pot
Smuggler1991: doesn't show hand
*** SUMMARY ***
Total pot $0.27 | Rake $0
Seat 1: smokestackinggg (button) folded before Flop
Seat 2: rellerz (small blind) folded before Flop
Seat 3: Smuggler1991 (big blind) collected ($0.27)
Seat 4: trocchia79 folded before Flop
Seat 6: PlayTheBlues4U folded before Flop (didn't bet)


*********** # 88 **************
PokerStars Hand #204209811082:  Hold'em No Limit ($0.05/$0.10 USD) - 2019/10/03 23:22:29 ET
Table 'Pollux' 6-max Seat #5 is the button
Seat 1: mellneazy ($9.66 in chips)
Seat 2: Masonstone3 ($41.89 in chips)
Seat 3: Onannio ($11.51 in chips)
Seat 4: hand shuffle ($10 in chips)
Seat 5: PlayTheBlues4U ($9.70 in chips)
Seat 6: bbkid44 ($13.51 in chips)
bbkid44: posts small blind $0.05
mellneazy: posts big blind $0.10
hand shuffle: posts big blind $0.10
*** HOLE CARDS ***
Dealt to PlayTheBlues4U [8s Qs]
Masonstone3: raises $0.20 to $0.30
Onannio: folds
hand shuffle: folds
PlayTheBlues4U: folds
bbkid44: calls $0.25
mellneazy: calls $0.20
*** FLOP *** [9d 2s 2h]
bbkid44: checks
mellneazy: checks
Masonstone3: bets $0.70
bbkid44: folds
mellneazy: folds
Uncalled bet ($0.70) returned to Masonstone3
Masonstone3 collected $0.95 from pot
Masonstone3: doesn't show hand
*** SUMMARY ***
Total pot $1 | Rake $0.05
Board [9d 2s 2h]
Seat 1: mellneazy (big blind) folded on the Flop
Seat 2: Masonstone3 collected ($0.95)
Seat 3: Onannio folded before Flop (didn't bet)
Seat 4: hand shuffle folded before Flop (didn't bet)
Seat 5: PlayTheBlues4U (button) folded before Flop (didn't bet)
Seat 6: bbkid44 (small blind) folded on the Flop


*********** # 89 **************
PokerStars Hand #204209811041:  Hold'em No Limit ($0.02/$0.05 USD) - 2019/10/03 23:22:12 ET
Table 'Phoenix' 6-max Seat #6 is the button
Seat 1: smokestackinggg ($3.22 in chips)
Seat 2: rellerz ($3.68 in chips)
Seat 3: Smuggler1991 ($5.63 in chips)
Seat 4: trocchia79 ($6.06 in chips)
Seat 6: PlayTheBlues4U ($4.88 in chips)
smokestackinggg: posts small blind $0.02
rellerz: posts big blind $0.05
kysinjer: sits out
*** HOLE CARDS ***
Dealt to PlayTheBlues4U [6c 9d]
Smuggler1991: folds
trocchia79: folds
PlayTheBlues4U: raises $0.10 to $0.15
smokestackinggg: folds
rellerz: folds
Uncalled bet ($0.10) returned to PlayTheBlues4U
PlayTheBlues4U collected $0.12 from pot
PlayTheBlues4U: doesn't show hand
*** SUMMARY ***
Total pot $0.12 | Rake $0
Seat 1: smokestackinggg (small blind) folded before Flop
Seat 2: rellerz (big blind) folded before Flop
Seat 3: Smuggler1991 folded before Flop (didn't bet)
Seat 4: trocchia79 folded before Flop (didn't bet)
Seat 6: PlayTheBlues4U (button) collected ($0.12)


*********** # 90 **************
PokerStars Hand #204208139965:  Hold'em No Limit ($0.05/$0.10 USD) - 2019/10/03 23:21:43 ET
Table 'Pollux' 6-max Seat #3 is the button
Seat 1: mellneazy ($9.66 in chips)
Seat 2: Masonstone3 ($42.59 in chips)
Seat 3: Onannio ($11.51 in chips)
Seat 5: PlayTheBlues4U ($9.75 in chips)
Seat 6: bbkid44 ($12.83 in chips)
PlayTheBlues4U: posts small blind $0.05
bbkid44: posts big blind $0.10
*** HOLE CARDS ***
Dealt to PlayTheBlues4U [Qh 5s]
mellneazy: folds
Masonstone3: raises $0.20 to $0.30
joncruise leaves the table
Onannio: folds
PlayTheBlues4U: folds
bbkid44: calls $0.20
*** FLOP *** [Jh Kc 7d]
bbkid44: checks
Masonstone3: bets $0.40
bbkid44: calls $0.40
*** TURN *** [Jh Kc 7d] [9s]
hand shuffle joins the table at seat #4
bbkid44: checks
Masonstone3: checks
*** RIVER *** [Jh Kc 7d 9s] [9h]
bbkid44: bets $0.80
Masonstone3: folds
Uncalled bet ($0.80) returned to bbkid44
bbkid44 collected $1.38 from pot
bbkid44: doesn't show hand
*** SUMMARY ***
Total pot $1.45 | Rake $0.07
Board [Jh Kc 7d 9s 9h]
Seat 1: mellneazy folded before Flop (didn't bet)
Seat 2: Masonstone3 folded on the River
Seat 3: Onannio (button) folded before Flop (didn't bet)
Seat 5: PlayTheBlues4U (small blind) folded before Flop
Seat 6: bbkid44 (big blind) collected ($1.38)


*********** # 91 **************
PokerStars Hand #204208139873:  Hold'em No Limit ($0.05/$0.10 USD) - 2019/10/03 23:21:06 ET
Table 'Pollux' 6-max Seat #2 is the button
Seat 1: mellneazy ($9.66 in chips)
Seat 2: Masonstone3 ($42.59 in chips)
Seat 3: Onannio ($11.56 in chips)
Seat 5: PlayTheBlues4U ($9.85 in chips)
Seat 6: bbkid44 ($12.69 in chips)
Onannio: posts small blind $0.05
PlayTheBlues4U: posts big blind $0.10
*** HOLE CARDS ***
Dealt to PlayTheBlues4U [3c 7s]
bbkid44: calls $0.10
PlayTheBlues4U said, "whoa"
mellneazy: folds
Masonstone3: folds
Onannio: folds
PlayTheBlues4U: checks
*** FLOP *** [6c 8c Th]
PlayTheBlues4U: checks
joncruise said, "figures lol"
bbkid44: bets $0.24
PlayTheBlues4U: folds [3c 7s]
Uncalled bet ($0.24) returned to bbkid44
bbkid44 collected $0.24 from pot
bbkid44: doesn't show hand
*** SUMMARY ***
Total pot $0.25 | Rake $0.01
Board [6c 8c Th]
Seat 1: mellneazy folded before Flop (didn't bet)
Seat 2: Masonstone3 (button) folded before Flop (didn't bet)
Seat 3: Onannio (small blind) folded before Flop
Seat 5: PlayTheBlues4U (big blind) folded on the Flop
Seat 6: bbkid44 collected ($0.24)


*********** # 92 **************
PokerStars Hand #204208139833:  Hold'em No Limit ($0.02/$0.05 USD) - 2019/10/03 23:20:52 ET
Table 'Phoenix' 6-max Seat #4 is the button
Seat 1: smokestackinggg ($3.88 in chips)
Seat 2: rellerz ($3.73 in chips)
Seat 3: Smuggler1991 ($4.97 in chips)
Seat 4: trocchia79 ($6.06 in chips)
Seat 6: PlayTheBlues4U ($4.90 in chips)
kysinjer will be allowed to play after the button
PlayTheBlues4U: posts small blind $0.02
smokestackinggg: posts big blind $0.05
*** HOLE CARDS ***
Dealt to PlayTheBlues4U [Jd 3s]
rellerz: calls $0.05
Smuggler1991: calls $0.05
trocchia79: folds
PlayTheBlues4U: folds
smokestackinggg: checks
*** FLOP *** [Jh 8s 8c]
smokestackinggg: checks
rellerz: checks
Smuggler1991: checks
*** TURN *** [Jh 8s 8c] [9d]
smokestackinggg: bets $0.15
rellerz: folds
Smuggler1991: calls $0.15
*** RIVER *** [Jh 8s 8c 9d] [Kh]
smokestackinggg: bets $0.23
Smuggler1991: raises $0.23 to $0.46
smokestackinggg: calls $0.23
*** SHOW DOWN ***
Smuggler1991: shows [8h Ad] (three of a kind, Eights)
smokestackinggg: mucks hand
Smuggler1991 collected $1.32 from pot
*** SUMMARY ***
Total pot $1.39 | Rake $0.07
Board [Jh 8s 8c 9d Kh]
Seat 1: smokestackinggg (big blind) mucked [Qd 8d]
Seat 2: rellerz folded on the Turn
Seat 3: Smuggler1991 showed [8h Ad] and won ($1.32) with three of a kind, Eights
Seat 4: trocchia79 (button) folded before Flop (didn't bet)
Seat 6: PlayTheBlues4U (small blind) folded before Flop


*********** # 93 **************
PokerStars Hand #204208139708:  Hold'em No Limit ($0.02/$0.05 USD) - 2019/10/03 23:20:06 ET
Table 'Phoenix' 6-max Seat #3 is the button
Seat 1: smokestackinggg ($3.88 in chips)
Seat 2: rellerz ($3.78 in chips)
Seat 3: Smuggler1991 ($4.97 in chips)
Seat 4: trocchia79 ($6.21 in chips)
Seat 6: PlayTheBlues4U ($4.72 in chips)
trocchia79: posts small blind $0.02
PlayTheBlues4U: posts big blind $0.05
*** HOLE CARDS ***
Dealt to PlayTheBlues4U [6c 7s]
smokestackinggg: folds
rellerz: calls $0.05
kysinjer joins the table at seat #5
Smuggler1991: folds
trocchia79: calls $0.03
PlayTheBlues4U: checks
*** FLOP *** [8d 2c 9d]
trocchia79: checks
PlayTheBlues4U: bets $0.10
rellerz: folds
trocchia79: calls $0.10
*** TURN *** [8d 2c 9d] [Ah]
trocchia79: checks
PlayTheBlues4U: bets $0.20
trocchia79: folds
Uncalled bet ($0.20) returned to PlayTheBlues4U
PlayTheBlues4U collected $0.33 from pot
PlayTheBlues4U: doesn't show hand
*** SUMMARY ***
Total pot $0.35 | Rake $0.02
Board [8d 2c 9d Ah]
Seat 1: smokestackinggg folded before Flop (didn't bet)
Seat 2: rellerz folded on the Flop
Seat 3: Smuggler1991 (button) folded before Flop (didn't bet)
Seat 4: trocchia79 (small blind) folded on the Turn
Seat 6: PlayTheBlues4U (big blind) collected ($0.33)


*********** # 94 **************
PokerStars Hand #204208139660:  Hold'em No Limit ($0.05/$0.10 USD) - 2019/10/03 23:19:49 ET
Table 'Pollux' 6-max Seat #1 is the button
Seat 1: mellneazy ($9.76 in chips)
Seat 2: Masonstone3 ($30.98 in chips)
Seat 3: Onannio ($11.86 in chips)
Seat 4: joncruise ($12.48 in chips)
Seat 5: PlayTheBlues4U ($9.85 in chips)
Seat 6: bbkid44 ($12.69 in chips)
Masonstone3: posts small blind $0.05
Onannio: posts big blind $0.10
*** HOLE CARDS ***
Dealt to PlayTheBlues4U [6h 4d]
joncruise: calls $0.10
PlayTheBlues4U: folds
bbkid44: folds
mellneazy: calls $0.10
Masonstone3: calls $0.05
Onannio: checks
*** FLOP *** [Th Qc Qd]
Masonstone3: checks
Onannio: bets $0.20
joncruise: calls $0.20
mellneazy: folds
Masonstone3: calls $0.20
*** TURN *** [Th Qc Qd] [2h]
Masonstone3: checks
Onannio: checks
joncruise: bets $0.90
Masonstone3: calls $0.90
Onannio: folds
*** RIVER *** [Th Qc Qd 2h] [4c]
Masonstone3: bets $3.20
joncruise: raises $8.08 to $11.28 and is all-in
Masonstone3: calls $8.08
*** SHOW DOWN ***
joncruise: shows [Ks Qs] (three of a kind, Queens)
Masonstone3: shows [4s Qh] (a full house, Queens full of Fours)
Masonstone3 collected $24.09 from pot
*** SUMMARY ***
Total pot $25.36 | Rake $1.27
Board [Th Qc Qd 2h 4c]
Seat 1: mellneazy (button) folded on the Flop
Seat 2: Masonstone3 (small blind) showed [4s Qh] and won ($24.09) with a full house, Queens full of Fours
Seat 3: Onannio (big blind) folded on the Turn
Seat 4: joncruise showed [Ks Qs] and lost with three of a kind, Queens
Seat 5: PlayTheBlues4U folded before Flop (didn't bet)
Seat 6: bbkid44 folded before Flop (didn't bet)


*********** # 95 **************
PokerStars Hand #204208139619:  Hold'em No Limit ($0.02/$0.05 USD) - 2019/10/03 23:19:34 ET
Table 'Phoenix' 6-max Seat #2 is the button
Seat 1: smokestackinggg ($3.88 in chips)
Seat 2: rellerz ($3.78 in chips)
Seat 3: Smuggler1991 ($4.99 in chips)
Seat 4: trocchia79 ($6.26 in chips)
Seat 5: DemolishIT ($19.59 in chips)
Seat 6: PlayTheBlues4U ($4.65 in chips)
Smuggler1991: posts small blind $0.02
trocchia79: posts big blind $0.05
*** HOLE CARDS ***
Dealt to PlayTheBlues4U [Qs Qd]
DemolishIT: folds
PlayTheBlues4U: raises $0.10 to $0.15
smokestackinggg: folds
rellerz: folds
DemolishIT leaves the table
Smuggler1991: folds
trocchia79: folds
Uncalled bet ($0.10) returned to PlayTheBlues4U
PlayTheBlues4U collected $0.12 from pot
PlayTheBlues4U: doesn't show hand
*** SUMMARY ***
Total pot $0.12 | Rake $0
Seat 1: smokestackinggg folded before Flop (didn't bet)
Seat 2: rellerz (button) folded before Flop (didn't bet)
Seat 3: Smuggler1991 (small blind) folded before Flop
Seat 4: trocchia79 (big blind) folded before Flop
Seat 5: DemolishIT folded before Flop (didn't bet)
Seat 6: PlayTheBlues4U collected ($0.12)


*********** # 96 **************
PokerStars Hand #204208139602:  Hold'em No Limit ($0.05/$0.10 USD) - 2019/10/03 23:19:28 ET
Table 'Pollux' 6-max Seat #6 is the button
Seat 1: mellneazy ($9.86 in chips)
Seat 2: Masonstone3 ($31.08 in chips)
Seat 3: Onannio ($11.86 in chips)
Seat 4: joncruise ($12.48 in chips)
Seat 5: PlayTheBlues4U ($9.85 in chips)
Seat 6: bbkid44 ($12.51 in chips)
mellneazy: posts small blind $0.05
Masonstone3: posts big blind $0.10
*** HOLE CARDS ***
Dealt to PlayTheBlues4U [9h Qs]
Onannio: folds
joncruise: folds
PlayTheBlues4U: folds
bbkid44: calls $0.10
mellneazy: calls $0.05
Masonstone3: checks
*** FLOP *** [4c 3s 8c]
mellneazy: checks
Masonstone3: checks
bbkid44: bets $0.50
mellneazy: folds
Masonstone3: folds
Uncalled bet ($0.50) returned to bbkid44
bbkid44 collected $0.28 from pot
bbkid44: doesn't show hand
*** SUMMARY ***
Total pot $0.30 | Rake $0.02
Board [4c 3s 8c]
Seat 1: mellneazy (small blind) folded on the Flop
Seat 2: Masonstone3 (big blind) folded on the Flop
Seat 3: Onannio folded before Flop (didn't bet)
Seat 4: joncruise folded before Flop (didn't bet)
Seat 5: PlayTheBlues4U folded before Flop (didn't bet)
Seat 6: bbkid44 (button) collected ($0.28)


*********** # 97 **************
PokerStars Hand #204208139444:  Hold'em No Limit ($0.05/$0.10 USD) - 2019/10/03 23:18:28 ET
Table 'Pollux' 6-max Seat #5 is the button
Seat 1: mellneazy ($10.46 in chips)
Seat 2: Masonstone3 ($30.16 in chips)
Seat 3: Onannio ($11.86 in chips)
Seat 4: joncruise ($12.68 in chips)
Seat 5: PlayTheBlues4U ($9.85 in chips)
Seat 6: bbkid44 ($12.71 in chips)
bbkid44: posts small blind $0.05
mellneazy: posts big blind $0.10
*** HOLE CARDS ***
Dealt to PlayTheBlues4U [5h Ts]
Masonstone3: raises $0.10 to $0.20
Onannio: folds
joncruise: calls $0.20
PlayTheBlues4U: folds
bbkid44: calls $0.15
mellneazy: calls $0.10
*** FLOP *** [Qd 4h 6s]
bbkid44: checks
mellneazy: checks
Masonstone3: bets $0.40
joncruise: folds
bbkid44: folds
mellneazy: calls $0.40
*** TURN *** [Qd 4h 6s] [9h]
mellneazy: checks
Masonstone3: bets $1.30
mellneazy: folds
Uncalled bet ($1.30) returned to Masonstone3
Masonstone3 collected $1.52 from pot
Masonstone3: doesn't show hand
*** SUMMARY ***
Total pot $1.60 | Rake $0.08
Board [Qd 4h 6s 9h]
Seat 1: mellneazy (big blind) folded on the Turn
Seat 2: Masonstone3 collected ($1.52)
Seat 3: Onannio folded before Flop (didn't bet)
Seat 4: joncruise folded on the Flop
Seat 5: PlayTheBlues4U (button) folded before Flop (didn't bet)
Seat 6: bbkid44 (small blind) folded on the Flop


*********** # 98 **************
PokerStars Hand #204208139442:  Hold'em No Limit ($0.02/$0.05 USD) - 2019/10/03 23:18:27 ET
Table 'Phoenix' 6-max Seat #1 is the button
Seat 1: smokestackinggg ($3.88 in chips)
Seat 2: rellerz ($3.83 in chips)
Seat 3: Smuggler1991 ($5.04 in chips)
Seat 4: trocchia79 ($6.17 in chips)
Seat 5: DemolishIT ($19.59 in chips)
Seat 6: PlayTheBlues4U ($4.65 in chips)
rellerz: posts small blind $0.02
Smuggler1991: posts big blind $0.05
*** HOLE CARDS ***
Dealt to PlayTheBlues4U [2h Td]
trocchia79: calls $0.05
DemolishIT: folds
PlayTheBlues4U: folds
smokestackinggg: folds
rellerz: calls $0.03
Smuggler1991: checks
*** FLOP *** [5c Ad 5h]
rellerz: checks
Smuggler1991: checks
trocchia79: checks
*** TURN *** [5c Ad 5h] [9s]
rellerz: checks
Smuggler1991: checks
trocchia79: checks
*** RIVER *** [5c Ad 5h 9s] [Jh]
rellerz: checks
Smuggler1991: checks
trocchia79: checks
*** SHOW DOWN ***
rellerz: shows [4s Tc] (a pair of Fives)
Smuggler1991: shows [6c Ts] (a pair of Fives)
trocchia79: shows [Kh Qd] (a pair of Fives - Ace+King kicker)
trocchia79 collected $0.14 from pot
*** SUMMARY ***
Total pot $0.15 | Rake $0.01
Board [5c Ad 5h 9s Jh]
Seat 1: smokestackinggg (button) folded before Flop (didn't bet)
Seat 2: rellerz (small blind) showed [4s Tc] and lost with a pair of Fives
Seat 3: Smuggler1991 (big blind) showed [6c Ts] and lost with a pair of Fives
Seat 4: trocchia79 showed [Kh Qd] and won ($0.14) with a pair of Fives
Seat 5: DemolishIT folded before Flop (didn't bet)
Seat 6: PlayTheBlues4U folded before Flop (didn't bet)


*********** # 99 **************
PokerStars Hand #204208139296:  Hold'em No Limit ($0.02/$0.05 USD) - 2019/10/03 23:17:40 ET
Table 'Phoenix' 6-max Seat #6 is the button
Seat 1: smokestackinggg ($3.90 in chips)
Seat 2: rellerz ($3.79 in chips)
Seat 3: Smuggler1991 ($5.01 in chips)
Seat 4: trocchia79 ($6.22 in chips)
Seat 5: DemolishIT ($19.64 in chips)
Seat 6: PlayTheBlues4U ($4.70 in chips)
smokestackinggg: posts small blind $0.02
rellerz: posts big blind $0.05
*** HOLE CARDS ***
Dealt to PlayTheBlues4U [9s Js]
Smuggler1991: calls $0.05
trocchia79: calls $0.05
DemolishIT: calls $0.05
PlayTheBlues4U: calls $0.05
smokestackinggg: folds
rellerz: checks
*** FLOP *** [Ac Jh 6s]
rellerz: bets $0.05
Smuggler1991: raises $0.35 to $0.40
trocchia79: folds
DemolishIT: folds
PlayTheBlues4U: folds
rellerz: calls $0.35
*** TURN *** [Ac Jh 6s] [9d]
rellerz: checks
Smuggler1991: checks
*** RIVER *** [Ac Jh 6s 9d] [4s]
rellerz: bets $0.50
Smuggler1991: calls $0.50
*** SHOW DOWN ***
rellerz: shows [Ad 3d] (a pair of Aces)
Smuggler1991: shows [Ah 2d] (a pair of Aces)
rellerz collected $0.99 from pot
Smuggler1991 collected $0.98 from pot
*** SUMMARY ***
Total pot $2.07 | Rake $0.10
Board [Ac Jh 6s 9d 4s]
Seat 1: smokestackinggg (small blind) folded before Flop
Seat 2: rellerz (big blind) showed [Ad 3d] and won ($0.99) with a pair of Aces
Seat 3: Smuggler1991 showed [Ah 2d] and won ($0.98) with a pair of Aces
Seat 4: trocchia79 folded on the Flop
Seat 5: DemolishIT folded on the Flop
Seat 6: PlayTheBlues4U (button) folded on the Flop


*********** # 100 **************
PokerStars Hand #204208139252:  Hold'em No Limit ($0.05/$0.10 USD) - 2019/10/03 23:17:18 ET
Table 'Pollux' 6-max Seat #4 is the button
Seat 1: mellneazy ($10.76 in chips)
Seat 2: Masonstone3 ($30.46 in chips)
Seat 3: Onannio ($11.86 in chips)
Seat 4: joncruise ($6.35 in chips)
Seat 5: PlayTheBlues4U ($9.90 in chips)
Seat 6: bbkid44 ($19.06 in chips)
PlayTheBlues4U: posts small blind $0.05
bbkid44: posts big blind $0.10
*** HOLE CARDS ***
Dealt to PlayTheBlues4U [Td 3c]
mellneazy: raises $0.20 to $0.30
Masonstone3: calls $0.30
Onannio: folds
joncruise: calls $0.30
PlayTheBlues4U: folds
bbkid44: calls $0.20
*** FLOP *** [Qs 4s 6c]
bbkid44: checks
mellneazy: checks
Masonstone3: checks
joncruise: bets $0.60
bbkid44: calls $0.60
mellneazy: folds
Masonstone3: folds
*** TURN *** [Qs 4s 6c] [7d]
bbkid44: bets $0.70
joncruise: raises $4.75 to $5.45 and is all-in
bbkid44: calls $4.75
*** RIVER *** [Qs 4s 6c 7d] [7h]
*** SHOW DOWN ***
bbkid44: shows [5d 6s] (two pair, Sevens and Sixes)
joncruise: shows [7c Qc] (a full house, Sevens full of Queens)
joncruise collected $12.68 from pot
*** SUMMARY ***
Total pot $13.35 | Rake $0.67
Board [Qs 4s 6c 7d 7h]
Seat 1: mellneazy folded on the Flop
Seat 2: Masonstone3 folded on the Flop
Seat 3: Onannio folded before Flop (didn't bet)
Seat 4: joncruise (button) showed [7c Qc] and won ($12.68) with a full house, Sevens full of Queens
Seat 5: PlayTheBlues4U (small blind) folded before Flop
Seat 6: bbkid44 (big blind) showed [5d 6s] and lost with two pair, Sevens and Sixes


*********** # 101 **************
PokerStars Hand #204208139169:  Hold'em No Limit ($0.05/$0.10 USD) - 2019/10/03 23:16:47 ET
Table 'Pollux' 6-max Seat #3 is the button
Seat 1: mellneazy ($10.96 in chips)
Seat 2: Masonstone3 ($30.46 in chips)
Seat 3: Onannio ($12.26 in chips)
Seat 4: joncruise ($6.40 in chips)
Seat 5: PlayTheBlues4U ($10 in chips)
Seat 6: bbkid44 ($18.37 in chips)
joncruise: posts small blind $0.05
PlayTheBlues4U: posts big blind $0.10
*** HOLE CARDS ***
Dealt to PlayTheBlues4U [Qs 2c]
bbkid44: raises $0.10 to $0.20
mellneazy: calls $0.20
Masonstone3: folds
Onannio: calls $0.20
joncruise: folds
PlayTheBlues4U: folds
*** FLOP *** [Qd 2s Js]
bbkid44: checks
mellneazy: checks
Onannio: checks
*** TURN *** [Qd 2s Js] [Jd]
bbkid44: checks
mellneazy: checks
Onannio: bets $0.20
bbkid44: calls $0.20
mellneazy: folds
*** RIVER *** [Qd 2s Js Jd] [Ac]
Masonstone3 said, "big fold."
bbkid44: checks
Onannio: checks
*** SHOW DOWN ***
bbkid44: shows [Th Td] (two pair, Jacks and Tens)
Onannio: mucks hand
bbkid44 collected $1.09 from pot
*** SUMMARY ***
Total pot $1.15 | Rake $0.06
Board [Qd 2s Js Jd Ac]
Seat 1: mellneazy folded on the Turn
Seat 2: Masonstone3 folded before Flop (didn't bet)
Seat 3: Onannio (button) mucked [4d 5d]
Seat 4: joncruise (small blind) folded before Flop
Seat 5: PlayTheBlues4U (big blind) folded before Flop
Seat 6: bbkid44 showed [Th Td] and won ($1.09) with two pair, Jacks and Tens


*********** # 102 **************
PokerStars Hand #204208139152:  Hold'em No Limit ($0.02/$0.05 USD) - 2019/10/03 23:16:40 ET
Table 'Phoenix' 6-max Seat #5 is the button
Seat 1: smokestackinggg ($3.95 in chips)
Seat 2: rellerz ($3.79 in chips)
Seat 3: Smuggler1991 ($5.01 in chips)
Seat 4: trocchia79 ($6.22 in chips)
Seat 5: DemolishIT ($19.37 in chips)
Seat 6: PlayTheBlues4U ($4.95 in chips)
PlayTheBlues4U: posts small blind $0.02
smokestackinggg: posts big blind $0.05
*** HOLE CARDS ***
Dealt to PlayTheBlues4U [9s Kc]
rellerz: folds
Smuggler1991: folds
trocchia79: folds
DemolishIT: raises $0.20 to $0.25
PlayTheBlues4U: calls $0.23
smokestackinggg: folds
*** FLOP *** [3c 3h Ac]
PlayTheBlues4U: checks
DemolishIT: bets $0.52
PlayTheBlues4U: folds
Uncalled bet ($0.52) returned to DemolishIT
DemolishIT collected $0.52 from pot
*** SUMMARY ***
Total pot $0.55 | Rake $0.03
Board [3c 3h Ac]
Seat 1: smokestackinggg (big blind) folded before Flop
Seat 2: rellerz folded before Flop (didn't bet)
Seat 3: Smuggler1991 folded before Flop (didn't bet)
Seat 4: trocchia79 folded before Flop (didn't bet)
Seat 5: DemolishIT (button) collected ($0.52)
Seat 6: PlayTheBlues4U (small blind) folded on the Flop


*********** # 103 **************
PokerStars Hand #204208139081:  Hold'em No Limit ($0.01/$0.02 USD) - 2019/10/03 23:16:12 ET
Table 'Auriga' 6-max Seat #2 is the button
Seat 1: Smuggler1991 ($4.75 in chips)
Seat 2: smoothdram18 ($3.52 in chips)
Seat 3: LilCardSmith ($1.98 in chips)
Seat 4: evanb004 ($3.47 in chips)
Seat 5: PlayTheBlues4U ($1.93 in chips)
Seat 6: andreybhr ($3.77 in chips)
LilCardSmith: posts small blind $0.01
evanb004: posts big blind $0.02
*** HOLE CARDS ***
Dealt to PlayTheBlues4U [Ks Ah]
PlayTheBlues4U: raises $0.06 to $0.08
andreybhr is connected
andreybhr has timed out while disconnected
andreybhr: folds
Smuggler1991: raises $0.19 to $0.27
smoothdram18: folds
LilCardSmith: folds
evanb004: calls $0.25
PlayTheBlues4U: calls $0.19
*** FLOP *** [4s 5c Kd]
evanb004: checks
PlayTheBlues4U: checks
Smuggler1991: checks
*** TURN *** [4s 5c Kd] [8d]
evanb004: checks
PlayTheBlues4U: bets $0.48
andreybhr is disconnected
Smuggler1991: folds
evanb004: calls $0.48
*** RIVER *** [4s 5c Kd 8d] [Jc]
evanb004: checks
PlayTheBlues4U: bets $1.18 and is all-in
evanb004: folds
Uncalled bet ($1.18) returned to PlayTheBlues4U
PlayTheBlues4U collected $1.70 from pot
PlayTheBlues4U: doesn't show hand
*** SUMMARY ***
Total pot $1.78 | Rake $0.08
Board [4s 5c Kd 8d Jc]
Seat 1: Smuggler1991 folded on the Turn
Seat 2: smoothdram18 (button) folded before Flop (didn't bet)
Seat 3: LilCardSmith (small blind) folded before Flop
Seat 4: evanb004 (big blind) folded on the River
Seat 5: PlayTheBlues4U collected ($1.70)
Seat 6: andreybhr folded before Flop (didn't bet)


*********** # 104 **************
PokerStars Hand #204208139016:  Hold'em No Limit ($0.01/$0.02 USD) - 2019/10/03 23:15:45 ET
Table 'Auriga' 6-max Seat #1 is the button
Seat 1: Smuggler1991 ($4.75 in chips)
Seat 2: smoothdram18 ($3.53 in chips)
Seat 3: LilCardSmith ($2 in chips)
Seat 4: evanb004 ($3.44 in chips)
Seat 5: PlayTheBlues4U ($1.93 in chips)
Seat 6: andreybhr ($3.77 in chips)
smoothdram18: posts small blind $0.01
LilCardSmith: posts big blind $0.02
*** HOLE CARDS ***
Dealt to PlayTheBlues4U [Kh Tc]
evanb004: raises $0.05 to $0.07
PlayTheBlues4U: folds
andreybhr: folds
Smuggler1991: folds
smoothdram18: folds
LilCardSmith: folds
Uncalled bet ($0.05) returned to evanb004
evanb004 collected $0.05 from pot
evanb004: doesn't show hand
*** SUMMARY ***
Total pot $0.05 | Rake $0
Seat 1: Smuggler1991 (button) folded before Flop (didn't bet)
Seat 2: smoothdram18 (small blind) folded before Flop
Seat 3: LilCardSmith (big blind) folded before Flop
Seat 4: evanb004 collected ($0.05)
Seat 5: PlayTheBlues4U folded before Flop (didn't bet)
Seat 6: andreybhr folded before Flop (didn't bet)


*********** # 105 **************
PokerStars Hand #204208139012:  Hold'em No Limit ($0.02/$0.05 USD) - 2019/10/03 23:15:44 ET
Table 'Phoenix' 6-max Seat #4 is the button
Seat 1: smokestackinggg ($3.95 in chips)
Seat 2: rellerz ($4.44 in chips)
Seat 3: Smuggler1991 ($5.01 in chips)
Seat 4: trocchia79 ($5.57 in chips)
Seat 5: DemolishIT ($19.39 in chips)
Seat 6: PlayTheBlues4U ($5 in chips)
DemolishIT: posts small blind $0.02
PlayTheBlues4U: posts big blind $0.05
*** HOLE CARDS ***
Dealt to PlayTheBlues4U [9h 3c]
smokestackinggg: folds
rellerz: calls $0.05
Smuggler1991: folds
trocchia79: calls $0.05
DemolishIT: folds
PlayTheBlues4U: checks
*** FLOP *** [4h 7c Kc]
PlayTheBlues4U: checks
rellerz: checks
trocchia79: checks
*** TURN *** [4h 7c Kc] [Qc]
PlayTheBlues4U: checks
rellerz: checks
trocchia79: bets $0.15
PlayTheBlues4U: folds
rellerz: calls $0.15
*** RIVER *** [4h 7c Kc Qc] [8h]
rellerz: checks
trocchia79: bets $0.45
rellerz: calls $0.45
*** SHOW DOWN ***
trocchia79: shows [Qs 8d] (two pair, Queens and Eights)
rellerz: mucks hand
trocchia79 collected $1.30 from pot
*** SUMMARY ***
Total pot $1.37 | Rake $0.07
Board [4h 7c Kc Qc 8h]
Seat 1: smokestackinggg folded before Flop (didn't bet)
Seat 2: rellerz mucked [Ts Qh]
Seat 3: Smuggler1991 folded before Flop (didn't bet)
Seat 4: trocchia79 (button) showed [Qs 8d] and won ($1.30) with two pair, Queens and Eights
Seat 5: DemolishIT (small blind) folded before Flop
Seat 6: PlayTheBlues4U (big blind) folded on the Turn


*********** # 106 **************
PokerStars Hand #204208138789:  Hold'em No Limit ($0.01/$0.02 USD) - 2019/10/03 23:14:32 ET
Table 'Auriga' 6-max Seat #6 is the button
Seat 1: Smuggler1991 ($4.83 in chips)
Seat 2: smoothdram18 ($3.55 in chips)
Seat 4: evanb004 ($3.35 in chips)
Seat 5: PlayTheBlues4U ($1.93 in chips)
Seat 6: andreybhr ($3.77 in chips)
Smuggler1991: posts small blind $0.01
smoothdram18: posts big blind $0.02
LilCardSmith: sits out
*** HOLE CARDS ***
Dealt to PlayTheBlues4U [6c Qh]
evanb004: raises $0.06 to $0.08
PlayTheBlues4U: folds
andreybhr: folds
Smuggler1991: calls $0.07
smoothdram18: folds
*** FLOP *** [As Jh 2h]
Smuggler1991: checks
evanb004: checks
*** TURN *** [As Jh 2h] [7d]
Smuggler1991: checks
evanb004: bets $0.17
andreybhr is disconnected
Smuggler1991: folds
Uncalled bet ($0.17) returned to evanb004
evanb004 collected $0.17 from pot
evanb004: doesn't show hand
*** SUMMARY ***
Total pot $0.18 | Rake $0.01
Board [As Jh 2h 7d]
Seat 1: Smuggler1991 (small blind) folded on the Turn
Seat 2: smoothdram18 (big blind) folded before Flop
Seat 4: evanb004 collected ($0.17)
Seat 5: PlayTheBlues4U folded before Flop (didn't bet)
Seat 6: andreybhr (button) folded before Flop (didn't bet)


*********** # 107 **************
PokerStars Hand #204208138751:  Hold'em No Limit ($0.02/$0.05 USD) - 2019/10/03 23:14:18 ET
Table 'Phoenix' 6-max Seat #3 is the button
Seat 1: smokestackinggg ($3.95 in chips)
Seat 2: rellerz ($4.66 in chips)
Seat 3: Smuggler1991 ($5.23 in chips)
Seat 4: trocchia79 ($4.95 in chips)
Seat 5: DemolishIT ($19.61 in chips)
Seat 6: PlayTheBlues4U ($5 in chips)
trocchia79: posts small blind $0.02
DemolishIT: posts big blind $0.05
*** HOLE CARDS ***
Dealt to PlayTheBlues4U [Tc 3c]
PlayTheBlues4U: folds
smokestackinggg has timed out
smokestackinggg: folds
rellerz: calls $0.05
Smuggler1991: raises $0.17 to $0.22
trocchia79: calls $0.20
DemolishIT: calls $0.17
rellerz: calls $0.17
*** FLOP *** [Td 2h 4c]
trocchia79: checks
DemolishIT: checks
rellerz: checks
Smuggler1991: checks
*** TURN *** [Td 2h 4c] [Qs]
trocchia79: checks
DemolishIT: checks
rellerz: checks
Smuggler1991: checks
*** RIVER *** [Td 2h 4c Qs] [Js]
trocchia79: checks
DemolishIT: checks
rellerz: checks
Smuggler1991: checks
*** SHOW DOWN ***
trocchia79: shows [5c 5h] (a pair of Fives)
DemolishIT: mucks hand
rellerz: mucks hand
Smuggler1991: mucks hand
trocchia79 collected $0.84 from pot
*** SUMMARY ***
Total pot $0.88 | Rake $0.04
Board [Td 2h 4c Qs Js]
Seat 1: smokestackinggg folded before Flop (didn't bet)
Seat 2: rellerz mucked [7h 4h]
Seat 3: Smuggler1991 (button) mucked [As 9h]
Seat 4: trocchia79 (small blind) showed [5c 5h] and won ($0.84) with a pair of Fives
Seat 5: DemolishIT (big blind) mucked [2d Ah]
Seat 6: PlayTheBlues4U folded before Flop (didn't bet)


*********** # 108 **************
PokerStars Hand #204208138709:  Hold'em No Limit ($0.01/$0.02 USD) - 2019/10/03 23:14:03 ET
Table 'Auriga' 6-max Seat #5 is the button
Seat 1: Smuggler1991 ($4.85 in chips)
Seat 2: smoothdram18 ($3.55 in chips)
Seat 4: evanb004 ($3.35 in chips)
Seat 5: PlayTheBlues4U ($1.93 in chips)
Seat 6: andreybhr ($3.75 in chips)
andreybhr: posts small blind $0.01
Smuggler1991: posts big blind $0.02
LilCardSmith: sits out
*** HOLE CARDS ***
Dealt to PlayTheBlues4U [4c 8h]
smoothdram18: folds
evanb004: folds
PlayTheBlues4U: folds
andreybhr: calls $0.01
Smuggler1991: checks
*** FLOP *** [Th Js Ts]
andreybhr: checks
Smuggler1991: checks
*** TURN *** [Th Js Ts] [4h]
andreybhr: checks
Smuggler1991: checks
*** RIVER *** [Th Js Ts 4h] [7c]
andreybhr: checks
Smuggler1991: checks
*** SHOW DOWN ***
andreybhr: shows [3s 3d] (two pair, Tens and Threes)
Smuggler1991: mucks hand
andreybhr collected $0.04 from pot
*** SUMMARY ***
Total pot $0.04 | Rake $0
Board [Th Js Ts 4h 7c]
Seat 1: Smuggler1991 (big blind) mucked [5h 6s]
Seat 2: smoothdram18 folded before Flop (didn't bet)
Seat 4: evanb004 folded before Flop (didn't bet)
Seat 5: PlayTheBlues4U (button) folded before Flop (didn't bet)
Seat 6: andreybhr (small blind) showed [3s 3d] and won ($0.04) with two pair, Tens and Threes


*********** # 109 **************
PokerStars Hand #204208138525:  Hold'em No Limit ($0.01/$0.02 USD) - 2019/10/03 23:12:59 ET
Table 'Auriga' 6-max Seat #4 is the button
Seat 1: Smuggler1991 ($4.85 in chips)
Seat 2: smoothdram18 ($3.55 in chips)
Seat 4: evanb004 ($3.32 in chips)
Seat 5: PlayTheBlues4U ($1.94 in chips)
Seat 6: andreybhr ($3.77 in chips)
PlayTheBlues4U: posts small blind $0.01
andreybhr: posts big blind $0.02
*** HOLE CARDS ***
Dealt to PlayTheBlues4U [3s 4d]
Smuggler1991: folds
smoothdram18: folds
evanb004: raises $0.05 to $0.07
PlayTheBlues4U: folds
LilCardSmith joins the table at seat #3
andreybhr is disconnected
andreybhr is connected
andreybhr: folds
Uncalled bet ($0.05) returned to evanb004
evanb004 collected $0.05 from pot
evanb004: doesn't show hand
*** SUMMARY ***
Total pot $0.05 | Rake $0
Seat 1: Smuggler1991 folded before Flop (didn't bet)
Seat 2: smoothdram18 folded before Flop (didn't bet)
Seat 4: evanb004 (button) collected ($0.05)
Seat 5: PlayTheBlues4U (small blind) folded before Flop
Seat 6: andreybhr (big blind) folded before Flop


*********** # 110 **************
PokerStars Hand #204208138465:  Hold'em No Limit ($0.01/$0.02 USD) - 2019/10/03 23:12:38 ET
Table 'Auriga' 6-max Seat #2 is the button
Seat 1: Smuggler1991 ($4.85 in chips)
Seat 2: smoothdram18 ($3.52 in chips)
Seat 4: evanb004 ($3.33 in chips)
Seat 5: PlayTheBlues4U ($1.96 in chips)
Seat 6: andreybhr ($3.77 in chips)
evanb004: posts small blind $0.01
PlayTheBlues4U: posts big blind $0.02
*** HOLE CARDS ***
Dealt to PlayTheBlues4U [5d 2h]
andreybhr: folds
Smuggler1991: folds
smoothdram18: raises $0.05 to $0.07
evanb004: folds
PlayTheBlues4U: folds
Uncalled bet ($0.05) returned to smoothdram18
smoothdram18 collected $0.05 from pot
smoothdram18: doesn't show hand
*** SUMMARY ***
Total pot $0.05 | Rake $0
Seat 1: Smuggler1991 folded before Flop (didn't bet)
Seat 2: smoothdram18 (button) collected ($0.05)
Seat 4: evanb004 (small blind) folded before Flop
Seat 5: PlayTheBlues4U (big blind) folded before Flop
Seat 6: andreybhr folded before Flop (didn't bet)


*********** # 111 **************
PokerStars Hand #204208138402:  Hold'em No Limit ($0.02/$0.05 USD) - 2019/10/03 23:12:17 ET
Table 'Phoenix' 6-max Seat #6 is the button
Seat 2: rellerz ($4.68 in chips)
Seat 3: Smuggler1991 ($7.27 in chips)
Seat 5: DemolishIT ($10.50 in chips)
Seat 6: PlayTheBlues4U ($7.46 in chips)
rellerz: posts small blind $0.02
Smuggler1991: posts big blind $0.05
*** HOLE CARDS ***
Dealt to PlayTheBlues4U [Ah Qc]
DemolishIT: raises $0.15 to $0.20
PlayTheBlues4U: calls $0.20
rellerz: folds
Smuggler1991: raises $0.62 to $0.82
DemolishIT: calls $0.62
smokestackinggg joins the table at seat #1
PlayTheBlues4U: calls $0.62
*** FLOP *** [Ac 2s 5d]
Smuggler1991: bets $1.20
DemolishIT: calls $1.20
PlayTheBlues4U: calls $1.20
*** TURN *** [Ac 2s 5d] [7s]
Smuggler1991: checks
trocchia79 joins the table at seat #4
DemolishIT: bets $5.78
PlayTheBlues4U: calls $5.44 and is all-in
Smuggler1991: folds
Uncalled bet ($0.34) returned to DemolishIT
*** RIVER *** [Ac 2s 5d 7s] [Th]
*** SHOW DOWN ***
DemolishIT: shows [5c 7c] (two pair, Sevens and Fives)
PlayTheBlues4U: shows [Ah Qc] (a pair of Aces)
DemolishIT collected $16.46 from pot
*** SUMMARY ***
Total pot $16.96 | Rake $0.50
Board [Ac 2s 5d 7s Th]
Seat 2: rellerz (small blind) folded before Flop
Seat 3: Smuggler1991 (big blind) folded on the Turn
Seat 5: DemolishIT showed [5c 7c] and won ($16.46) with two pair, Sevens and Fives
Seat 6: PlayTheBlues4U (button) showed [Ah Qc] and lost with a pair of Aces


*********** # 112 **************
PokerStars Hand #204208138372:  Hold'em No Limit ($0.01/$0.02 USD) - 2019/10/03 23:12:05 ET
Table 'Auriga' 6-max Seat #1 is the button
Seat 1: Smuggler1991 ($4.80 in chips)
Seat 2: smoothdram18 ($3.53 in chips)
Seat 4: evanb004 ($3.35 in chips)
Seat 5: PlayTheBlues4U ($1.96 in chips)
Seat 6: andreybhr ($3.79 in chips)
smoothdram18: posts small blind $0.01
evanb004: posts big blind $0.02
andreybhr: posts big blind $0.02
*** HOLE CARDS ***
Dealt to PlayTheBlues4U [6d Ks]
PlayTheBlues4U: folds
andreybhr: checks
Smuggler1991: raises $0.07 to $0.09
smoothdram18: folds
evanb004: folds
andreybhr: folds
Uncalled bet ($0.07) returned to Smuggler1991
Smuggler1991 collected $0.07 from pot
Smuggler1991: doesn't show hand
*** SUMMARY ***
Total pot $0.07 | Rake $0
Seat 1: Smuggler1991 (button) collected ($0.07)
Seat 2: smoothdram18 (small blind) folded before Flop
Seat 4: evanb004 (big blind) folded before Flop
Seat 5: PlayTheBlues4U folded before Flop (didn't bet)
Seat 6: andreybhr folded before Flop (didn't bet)


*********** # 113 **************
PokerStars Hand #204208138360:  Hold'em No Limit ($0.02/$0.05 USD) - 2019/10/03 23:12:00 ET
Table 'Phoenix' 6-max Seat #5 is the button
Seat 2: rellerz ($4.73 in chips)
Seat 3: Smuggler1991 ($7.20 in chips)
Seat 5: DemolishIT ($10.50 in chips)
Seat 6: PlayTheBlues4U ($7.48 in chips)
PlayTheBlues4U: posts small blind $0.02
rellerz: posts big blind $0.05
*** HOLE CARDS ***
Dealt to PlayTheBlues4U [8h Ts]
Smuggler1991: raises $0.12 to $0.17
DemolishIT: folds
PlayTheBlues4U: folds
rellerz: folds
Uncalled bet ($0.12) returned to Smuggler1991
Smuggler1991 collected $0.12 from pot
Smuggler1991: doesn't show hand
*** SUMMARY ***
Total pot $0.12 | Rake $0
Seat 2: rellerz (big blind) folded before Flop
Seat 3: Smuggler1991 collected ($0.12)
Seat 5: DemolishIT (button) folded before Flop (didn't bet)
Seat 6: PlayTheBlues4U (small blind) folded before Flop


*********** # 114 **************
PokerStars Hand #204208138343:  Hold'em No Limit ($0.01/$0.02 USD) - 2019/10/03 23:11:55 ET
Table 'Auriga' 6-max Seat #5 is the button
Seat 1: Smuggler1991 ($4.81 in chips)
Seat 2: smoothdram18 ($3.52 in chips)
Seat 4: evanb004 ($3.35 in chips)
Seat 5: PlayTheBlues4U ($1.96 in chips)
andreybhr will be allowed to play after the button
Smuggler1991: posts small blind $0.01
smoothdram18: posts big blind $0.02
*** HOLE CARDS ***
Dealt to PlayTheBlues4U [Js 2d]
evanb004: folds
PlayTheBlues4U: folds
Smuggler1991: folds
Uncalled bet ($0.01) returned to smoothdram18
smoothdram18 collected $0.02 from pot
smoothdram18: doesn't show hand
*** SUMMARY ***
Total pot $0.02 | Rake $0
Seat 1: Smuggler1991 (small blind) folded before Flop
Seat 2: smoothdram18 (big blind) collected ($0.02)
Seat 4: evanb004 folded before Flop (didn't bet)
Seat 5: PlayTheBlues4U (button) folded before Flop (didn't bet)


*********** # 115 **************
PokerStars Hand #204208138248:  Hold'em No Limit ($0.02/$0.05 USD) - 2019/10/03 23:11:20 ET
Table 'Phoenix' 6-max Seat #3 is the button
Seat 2: rellerz ($3.85 in chips)
Seat 3: Smuggler1991 ($7.20 in chips)
Seat 4: smokestackinggg ($3.68 in chips)
Seat 5: DemolishIT ($11.42 in chips)
Seat 6: PlayTheBlues4U ($7.48 in chips)
smokestackinggg: posts small blind $0.02
DemolishIT: posts big blind $0.05
*** HOLE CARDS ***
Dealt to PlayTheBlues4U [Qc 9s]
PlayTheBlues4U: folds
rellerz: calls $0.05
Smuggler1991: folds
smokestackinggg: calls $0.03
DemolishIT: raises $0.25 to $0.30
rellerz: calls $0.25
smokestackinggg: folds
*** FLOP *** [Jd Ks 2h]
DemolishIT: bets $0.62
rellerz: raises $0.62 to $1.24
DemolishIT: folds
Uncalled bet ($0.62) returned to rellerz
rellerz collected $1.80 from pot
smokestackinggg leaves the table
rellerz: doesn't show hand
*** SUMMARY ***
Total pot $1.89 | Rake $0.09
Board [Jd Ks 2h]
Seat 2: rellerz collected ($1.80)
Seat 3: Smuggler1991 (button) folded before Flop (didn't bet)
Seat 4: smokestackinggg (small blind) folded before Flop
Seat 5: DemolishIT (big blind) folded on the Flop
Seat 6: PlayTheBlues4U folded before Flop (didn't bet)


*********** # 116 **************
PokerStars Hand #204208138207:  Hold'em No Limit ($0.02/$0.05 USD) - 2019/10/03 23:11:06 ET
Table 'Phoenix' 6-max Seat #2 is the button
Seat 1: DaGoodz33 ($4.67 in chips)
Seat 2: rellerz ($3.85 in chips)
Seat 3: Smuggler1991 ($7.22 in chips)
Seat 4: smokestackinggg ($3.66 in chips)
Seat 5: DemolishIT ($11.42 in chips)
Seat 6: PlayTheBlues4U ($7.48 in chips)
Smuggler1991: posts small blind $0.02
smokestackinggg: posts big blind $0.05
*** HOLE CARDS ***
Dealt to PlayTheBlues4U [Qs 4h]
DemolishIT: folds
PlayTheBlues4U: folds
DaGoodz33: folds
rellerz: folds
Smuggler1991: folds
Uncalled bet ($0.03) returned to smokestackinggg
DaGoodz33 leaves the table
smokestackinggg collected $0.04 from pot
smokestackinggg: doesn't show hand
*** SUMMARY ***
Total pot $0.04 | Rake $0
Seat 1: DaGoodz33 folded before Flop (didn't bet)
Seat 2: rellerz (button) folded before Flop (didn't bet)
Seat 3: Smuggler1991 (small blind) folded before Flop
Seat 4: smokestackinggg (big blind) collected ($0.04)
Seat 5: DemolishIT folded before Flop (didn't bet)
Seat 6: PlayTheBlues4U folded before Flop (didn't bet)


*********** # 117 **************
PokerStars Hand #204208138162:  Hold'em No Limit ($0.02/$0.05 USD) - 2019/10/03 23:10:50 ET
Table 'Phoenix' 6-max Seat #1 is the button
Seat 1: DaGoodz33 ($4.67 in chips)
Seat 2: rellerz ($3.87 in chips)
Seat 3: Smuggler1991 ($7.27 in chips)
Seat 4: smokestackinggg ($3.66 in chips)
Seat 5: DemolishIT ($11.42 in chips)
Seat 6: PlayTheBlues4U ($7.41 in chips)
rellerz: posts small blind $0.02
Smuggler1991: posts big blind $0.05
*** HOLE CARDS ***
Dealt to PlayTheBlues4U [Qh Kd]
smokestackinggg: folds
DemolishIT: folds
PlayTheBlues4U: raises $0.10 to $0.15
DaGoodz33: folds
rellerz: folds
Smuggler1991: folds
Uncalled bet ($0.10) returned to PlayTheBlues4U
PlayTheBlues4U collected $0.12 from pot
PlayTheBlues4U: doesn't show hand
*** SUMMARY ***
Total pot $0.12 | Rake $0
Seat 1: DaGoodz33 (button) folded before Flop (didn't bet)
Seat 2: rellerz (small blind) folded before Flop
Seat 3: Smuggler1991 (big blind) folded before Flop
Seat 4: smokestackinggg folded before Flop (didn't bet)
Seat 5: DemolishIT folded before Flop (didn't bet)
Seat 6: PlayTheBlues4U collected ($0.12)


*********** # 118 **************
PokerStars Hand #204208138111:  Hold'em No Limit ($0.01/$0.02 USD) - 2019/10/03 23:10:31 ET
Table 'Auriga' 6-max Seat #4 is the button
Seat 1: Smuggler1991 ($4.89 in chips)
Seat 2: smoothdram18 ($3.43 in chips)
Seat 3: DaGoodz33 ($1.65 in chips)
Seat 4: evanb004 ($3.35 in chips)
Seat 5: PlayTheBlues4U ($1.98 in chips)
PlayTheBlues4U: posts small blind $0.01
Smuggler1991: posts big blind $0.02
*** HOLE CARDS ***
Dealt to PlayTheBlues4U [8c 8d]
smoothdram18: calls $0.02
DaGoodz33: folds
DaGoodz33 leaves the table
evanb004: folds
PlayTheBlues4U: calls $0.01
Smuggler1991: checks
*** FLOP *** [Th Jd 3d]
PlayTheBlues4U: checks
andreybhr joins the table at seat #6
Smuggler1991: bets $0.02
smoothdram18: calls $0.02
PlayTheBlues4U: folds
*** TURN *** [Th Jd 3d] [3h]
Smuggler1991: bets $0.04
smoothdram18: calls $0.04
*** RIVER *** [Th Jd 3d 3h] [Ks]
Smuggler1991: checks
smoothdram18: bets $0.14
Smuggler1991: folds
Uncalled bet ($0.14) returned to smoothdram18
smoothdram18 collected $0.17 from pot
smoothdram18: doesn't show hand
*** SUMMARY ***
Total pot $0.18 | Rake $0.01
Board [Th Jd 3d 3h Ks]
Seat 1: Smuggler1991 (big blind) folded on the River
Seat 2: smoothdram18 collected ($0.17)
Seat 3: DaGoodz33 folded before Flop (didn't bet)
Seat 4: evanb004 (button) folded before Flop (didn't bet)
Seat 5: PlayTheBlues4U (small blind) folded on the Flop


*********** # 119 **************
PokerStars Hand #204208138011:  Hold'em No Limit ($0.01/$0.02 USD) - 2019/10/03 23:09:55 ET
Table 'Auriga' 6-max Seat #3 is the button
Seat 1: Smuggler1991 ($4.89 in chips)
Seat 2: smoothdram18 ($3.50 in chips)
Seat 3: DaGoodz33 ($1.65 in chips)
Seat 4: evanb004 ($3.26 in chips)
Seat 5: PlayTheBlues4U ($2 in chips)
evanb004: posts small blind $0.01
PlayTheBlues4U: posts big blind $0.02
*** HOLE CARDS ***
Dealt to PlayTheBlues4U [9h As]
Smuggler1991: folds
smoothdram18: raises $0.05 to $0.07
DaGoodz33: folds
evanb004: raises $0.21 to $0.28
PlayTheBlues4U: folds
smoothdram18: folds
Uncalled bet ($0.21) returned to evanb004
evanb004 collected $0.16 from pot
evanb004: doesn't show hand
*** SUMMARY ***
Total pot $0.16 | Rake $0
Seat 1: Smuggler1991 folded before Flop (didn't bet)
Seat 2: smoothdram18 folded before Flop
Seat 3: DaGoodz33 (button) folded before Flop (didn't bet)
Seat 4: evanb004 (small blind) collected ($0.16)
Seat 5: PlayTheBlues4U (big blind) folded before Flop


*********** # 120 **************
PokerStars Hand #204208137997:  Hold'em No Limit ($0.02/$0.05 USD) - 2019/10/03 23:09:49 ET
Table 'Phoenix' 6-max Seat #6 is the button
Seat 1: DaGoodz33 ($4.69 in chips)
Seat 2: rellerz ($4.04 in chips)
Seat 3: Smuggler1991 ($7.10 in chips)
Seat 4: smokestackinggg ($3.66 in chips)
Seat 5: DemolishIT ($11.42 in chips)
Seat 6: PlayTheBlues4U ($7.41 in chips)
DaGoodz33: posts small blind $0.02
rellerz: posts big blind $0.05
*** HOLE CARDS ***
Dealt to PlayTheBlues4U [4h 2h]
Smuggler1991: raises $0.12 to $0.17
smokestackinggg: folds
DemolishIT: folds
PlayTheBlues4U: folds
DaGoodz33: folds
rellerz: calls $0.12
*** FLOP *** [Qd 6h 4s]
rellerz: checks
Smuggler1991: bets $0.15
rellerz: folds
Uncalled bet ($0.15) returned to Smuggler1991
Smuggler1991 collected $0.34 from pot
Smuggler1991: doesn't show hand
*** SUMMARY ***
Total pot $0.36 | Rake $0.02
Board [Qd 6h 4s]
Seat 1: DaGoodz33 (small blind) folded before Flop
Seat 2: rellerz (big blind) folded on the Flop
Seat 3: Smuggler1991 collected ($0.34)
Seat 4: smokestackinggg folded before Flop (didn't bet)
Seat 5: DemolishIT folded before Flop (didn't bet)
Seat 6: PlayTheBlues4U (button) folded before Flop (didn't bet)


*********** # 121 **************
PokerStars Hand #204208137817:  Hold'em No Limit ($0.02/$0.05 USD) - 2019/10/03 23:08:41 ET
Table 'Phoenix' 6-max Seat #5 is the button
Seat 1: DaGoodz33 ($5.67 in chips)
Seat 2: rellerz ($4.04 in chips)
Seat 3: Smuggler1991 ($7.10 in chips)
Seat 4: smokestackinggg ($3.91 in chips)
Seat 5: DemolishIT ($10.28 in chips)
Seat 6: PlayTheBlues4U ($7.43 in chips)
PlayTheBlues4U: posts small blind $0.02
DaGoodz33: posts big blind $0.05
*** HOLE CARDS ***
Dealt to PlayTheBlues4U [2c Td]
rellerz: folds
Smuggler1991: folds
smokestackinggg: calls $0.05
DemolishIT: raises $0.20 to $0.25
PlayTheBlues4U: folds
DaGoodz33: calls $0.20
smokestackinggg: calls $0.20
*** FLOP *** [7s 8d Ts]
DaGoodz33: checks
smokestackinggg: checks
DemolishIT: checks
*** TURN *** [7s 8d Ts] [9h]
DaGoodz33: bets $0.73
smokestackinggg: folds
DemolishIT: calls $0.73
*** RIVER *** [7s 8d Ts 9h] [Ks]
DaGoodz33: checks
DemolishIT: checks
*** SHOW DOWN ***
DaGoodz33: shows [Qc Kc] (a pair of Kings)
DemolishIT: shows [7c 6c] (a straight, Six to Ten)
DemolishIT collected $2.12 from pot
*** SUMMARY ***
Total pot $2.23 | Rake $0.11
Board [7s 8d Ts 9h Ks]
Seat 1: DaGoodz33 (big blind) showed [Qc Kc] and lost with a pair of Kings
Seat 2: rellerz folded before Flop (didn't bet)
Seat 3: Smuggler1991 folded before Flop (didn't bet)
Seat 4: smokestackinggg folded on the Turn
Seat 5: DemolishIT (button) showed [7c 6c] and won ($2.12) with a straight, Six to Ten
Seat 6: PlayTheBlues4U (small blind) folded before Flop


*********** # 122 **************
PokerStars Hand #204208137699:  Hold'em No Limit ($0.02/$0.05 USD) - 2019/10/03 23:08:01 ET
Table 'Phoenix' 6-max Seat #4 is the button
Seat 1: DaGoodz33 ($5.67 in chips)
Seat 2: rellerz ($4.04 in chips)
Seat 3: Smuggler1991 ($7.10 in chips)
Seat 4: smokestackinggg ($3.91 in chips)
Seat 5: DemolishIT ($10.19 in chips)
Seat 6: PlayTheBlues4U ($7.53 in chips)
DemolishIT: posts small blind $0.02
PlayTheBlues4U: posts big blind $0.05
*** HOLE CARDS ***
Dealt to PlayTheBlues4U [4h 5c]
DaGoodz33: folds
rellerz: folds
Smuggler1991: folds
smokestackinggg: folds
DemolishIT: calls $0.03
PlayTheBlues4U: checks
*** FLOP *** [Ts 8d Kc]
DemolishIT: checks
PlayTheBlues4U: bets $0.05
DemolishIT: calls $0.05
*** TURN *** [Ts 8d Kc] [2h]
DemolishIT: checks
PlayTheBlues4U: checks
*** RIVER *** [Ts 8d Kc 2h] [7h]
DemolishIT: bets $0.20
PlayTheBlues4U: folds
Uncalled bet ($0.20) returned to DemolishIT
DemolishIT collected $0.19 from pot
DemolishIT: doesn't show hand
*** SUMMARY ***
Total pot $0.20 | Rake $0.01
Board [Ts 8d Kc 2h 7h]
Seat 1: DaGoodz33 folded before Flop (didn't bet)
Seat 2: rellerz folded before Flop (didn't bet)
Seat 3: Smuggler1991 folded before Flop (didn't bet)
Seat 4: smokestackinggg (button) folded before Flop (didn't bet)
Seat 5: DemolishIT (small blind) collected ($0.19)
Seat 6: PlayTheBlues4U (big blind) folded on the River


*********** # 123 **************
PokerStars Hand #204208137547:  Hold'em No Limit ($0.02/$0.05 USD) - 2019/10/03 23:07:04 ET
Table 'Phoenix' 6-max Seat #3 is the button
Seat 1: DaGoodz33 ($5.84 in chips)
Seat 2: rellerz ($3.82 in chips)
Seat 3: Smuggler1991 ($7.10 in chips)
Seat 4: smokestackinggg ($3.93 in chips)
Seat 5: DemolishIT ($10.24 in chips)
Seat 6: PlayTheBlues4U ($7.53 in chips)
smokestackinggg: posts small blind $0.02
DemolishIT: posts big blind $0.05
*** HOLE CARDS ***
Dealt to PlayTheBlues4U [Kh 2h]
PlayTheBlues4U: folds
DaGoodz33: raises $0.12 to $0.17
rellerz: calls $0.17
Smuggler1991: folds
smokestackinggg: folds
DemolishIT: folds
*** FLOP *** [Ks 6h As]
DaGoodz33: checks
rellerz: checks
*** TURN *** [Ks 6h As] [Td]
DaGoodz33: checks
rellerz: bets $0.20
DaGoodz33: folds
Uncalled bet ($0.20) returned to rellerz
rellerz collected $0.39 from pot
rellerz: doesn't show hand
*** SUMMARY ***
Total pot $0.41 | Rake $0.02
Board [Ks 6h As Td]
Seat 1: DaGoodz33 folded on the Turn
Seat 2: rellerz collected ($0.39)
Seat 3: Smuggler1991 (button) folded before Flop (didn't bet)
Seat 4: smokestackinggg (small blind) folded before Flop
Seat 5: DemolishIT (big blind) folded before Flop
Seat 6: PlayTheBlues4U folded before Flop (didn't bet)


*********** # 124 **************
PokerStars Hand #204207709892:  Hold'em No Limit ($0.02/$0.05 USD) - 2019/10/03 23:06:11 ET
Table 'Phoenix' 6-max Seat #2 is the button
Seat 1: DaGoodz33 ($5.84 in chips)
Seat 2: rellerz ($3.97 in chips)
Seat 3: Smuggler1991 ($7.12 in chips)
Seat 4: smokestackinggg ($3.98 in chips)
Seat 5: DemolishIT ($9.90 in chips)
Seat 6: PlayTheBlues4U ($7.68 in chips)
Smuggler1991: posts small blind $0.02
smokestackinggg: posts big blind $0.05
*** HOLE CARDS ***
Dealt to PlayTheBlues4U [Qc Jd]
DemolishIT: calls $0.05
PlayTheBlues4U: raises $0.10 to $0.15
DaGoodz33: folds
rellerz: calls $0.15
Smuggler1991: folds
smokestackinggg: folds
DemolishIT: calls $0.10
*** FLOP *** [3h 5d 2d]
DemolishIT: checks
PlayTheBlues4U: checks
rellerz: checks
*** TURN *** [3h 5d 2d] [4d]
DemolishIT: bets $0.49
PlayTheBlues4U: folds
rellerz: folds
Uncalled bet ($0.49) returned to DemolishIT
DemolishIT collected $0.49 from pot
*** SUMMARY ***
Total pot $0.52 | Rake $0.03
Board [3h 5d 2d 4d]
Seat 1: DaGoodz33 folded before Flop (didn't bet)
Seat 2: rellerz (button) folded on the Turn
Seat 3: Smuggler1991 (small blind) folded before Flop
Seat 4: smokestackinggg (big blind) folded before Flop
Seat 5: DemolishIT collected ($0.49)
Seat 6: PlayTheBlues4U folded on the Turn


*********** # 125 **************
PokerStars Hand #204207709678:  Hold'em No Limit ($0.02/$0.05 USD) - 2019/10/03 23:05:01 ET
Table 'Phoenix' 6-max Seat #6 is the button
Seat 1: DaGoodz33 ($5.86 in chips)
Seat 2: rellerz ($3.90 in chips)
Seat 3: Smuggler1991 ($7.17 in chips)
Seat 4: smokestackinggg ($3.98 in chips)
Seat 5: DemolishIT ($9.90 in chips)
Seat 6: PlayTheBlues4U ($7.68 in chips)
DaGoodz33: posts small blind $0.02
rellerz: posts big blind $0.05
*** HOLE CARDS ***
Dealt to PlayTheBlues4U [Qh Ks]
Smuggler1991: folds
smokestackinggg: folds
DemolishIT: folds
PlayTheBlues4U has timed out
PlayTheBlues4U: folds
DaGoodz33: folds
Uncalled bet ($0.03) returned to rellerz
rellerz collected $0.04 from pot
rellerz: doesn't show hand
*** SUMMARY ***
Total pot $0.04 | Rake $0
Seat 1: DaGoodz33 (small blind) folded before Flop
Seat 2: rellerz (big blind) collected ($0.04)
Seat 3: Smuggler1991 folded before Flop (didn't bet)
Seat 4: smokestackinggg folded before Flop (didn't bet)
Seat 5: DemolishIT folded before Flop (didn't bet)
Seat 6: PlayTheBlues4U (button) folded before Flop (didn't bet)


*********** # 126 **************
PokerStars Hand #204207709438:  Hold'em No Limit ($0.02/$0.05 USD) - 2019/10/03 23:03:41 ET
Table 'Phoenix' 6-max Seat #5 is the button
Seat 1: DaGoodz33 ($6.08 in chips)
Seat 2: rellerz ($3.95 in chips)
Seat 3: Smuggler1991 ($6.51 in chips)
Seat 4: smokestackinggg ($3.98 in chips)
Seat 5: DemolishIT ($10.12 in chips)
Seat 6: PlayTheBlues4U ($7.90 in chips)
PlayTheBlues4U: posts small blind $0.02
DaGoodz33: posts big blind $0.05
*** HOLE CARDS ***
Dealt to PlayTheBlues4U [3h 5h]
rellerz: calls $0.05
Smuggler1991: raises $0.17 to $0.22
smokestackinggg: folds
DemolishIT: calls $0.22
PlayTheBlues4U: calls $0.20
DaGoodz33: calls $0.17
rellerz: folds
*** FLOP *** [Qs 3s 2d]
PlayTheBlues4U: checks
DaGoodz33: checks
Smuggler1991: bets $0.90
DemolishIT: folds
PlayTheBlues4U: folds
DaGoodz33: folds
Uncalled bet ($0.90) returned to Smuggler1991
Smuggler1991 collected $0.88 from pot
Smuggler1991: doesn't show hand
*** SUMMARY ***
Total pot $0.93 | Rake $0.05
Board [Qs 3s 2d]
Seat 1: DaGoodz33 (big blind) folded on the Flop
Seat 2: rellerz folded before Flop
Seat 3: Smuggler1991 collected ($0.88)
Seat 4: smokestackinggg folded before Flop (didn't bet)
Seat 5: DemolishIT (button) folded on the Flop
Seat 6: PlayTheBlues4U (small blind) folded on the Flop


*********** # 127 **************
PokerStars Hand #204207709275:  Hold'em No Limit ($0.02/$0.05 USD) - 2019/10/03 23:02:45 ET
Table 'Phoenix' 6-max Seat #4 is the button
Seat 2: rellerz ($4 in chips)
Seat 3: Smuggler1991 ($6.51 in chips)
Seat 4: smokestackinggg ($3.98 in chips)
Seat 5: DemolishIT ($10.03 in chips)
Seat 6: PlayTheBlues4U ($7.95 in chips)
DemolishIT: posts small blind $0.02
PlayTheBlues4U: posts big blind $0.05
DaGoodz33: sits out
rellerz: posts big blind $0.05
*** HOLE CARDS ***
Dealt to PlayTheBlues4U [2c Td]
rellerz: checks
Smuggler1991: folds
smokestackinggg: folds
DemolishIT: calls $0.03
PlayTheBlues4U: checks
*** FLOP *** [Qc 8c Tc]
DemolishIT: checks
PlayTheBlues4U: checks
rellerz: checks
*** TURN *** [Qc 8c Tc] [Jd]
DemolishIT: bets $0.14
PlayTheBlues4U: folds
rellerz: folds
Uncalled bet ($0.14) returned to DemolishIT
DemolishIT collected $0.14 from pot
*** SUMMARY ***
Total pot $0.15 | Rake $0.01
Board [Qc 8c Tc Jd]
Seat 2: rellerz folded on the Turn (didn't bet)
Seat 3: Smuggler1991 folded before Flop (didn't bet)
Seat 4: smokestackinggg (button) folded before Flop (didn't bet)
Seat 5: DemolishIT (small blind) collected ($0.14)
Seat 6: PlayTheBlues4U (big blind) folded on the Turn


*********** # 128 **************
PokerStars Hand #204207709135:  Hold'em No Limit ($0.02/$0.05 USD) - 2019/10/03 23:01:53 ET
Table 'Phoenix' 6-max Seat #3 is the button
Seat 2: swammer1997 ($6.19 in chips)
Seat 3: Smuggler1991 ($6.98 in chips)
Seat 4: smokestackinggg ($4 in chips)
Seat 5: DemolishIT ($9.59 in chips)
Seat 6: PlayTheBlues4U ($7.95 in chips)
smokestackinggg: posts small blind $0.02
DemolishIT: posts big blind $0.05
DaGoodz33: sits out
*** HOLE CARDS ***
Dealt to PlayTheBlues4U [7d 9s]
PlayTheBlues4U: folds
swammer1997: folds
swammer1997 leaves the table
Smuggler1991: raises $0.12 to $0.17
smokestackinggg: folds
DemolishIT: calls $0.12
*** FLOP *** [9c 8c Kc]
DemolishIT: checks
Smuggler1991: bets $0.15
DemolishIT: raises $0.15 to $0.30
Smuggler1991: calls $0.15
*** TURN *** [9c 8c Kc] [Ac]
DemolishIT: checks
Smuggler1991: checks
*** RIVER *** [9c 8c Kc Ac] [8h]
DemolishIT: bets $0.91
rellerz joins the table at seat #2
Smuggler1991: folds
Uncalled bet ($0.91) returned to DemolishIT
DemolishIT collected $0.91 from pot
*** SUMMARY ***
Total pot $0.96 | Rake $0.05
Board [9c 8c Kc Ac 8h]
Seat 2: swammer1997 folded before Flop (didn't bet)
Seat 3: Smuggler1991 (button) folded on the River
Seat 4: smokestackinggg (small blind) folded before Flop
Seat 5: DemolishIT (big blind) collected ($0.91)
Seat 6: PlayTheBlues4U folded before Flop (didn't bet)


*********** # 129 **************
PokerStars Hand #204207709000:  Hold'em No Limit ($0.02/$0.05 USD) - 2019/10/03 23:01:04 ET
Table 'Phoenix' 6-max Seat #2 is the button
Seat 2: swammer1997 ($5 in chips)
Seat 3: Smuggler1991 ($7 in chips)
Seat 4: smokestackinggg ($4.05 in chips)
Seat 5: DemolishIT ($10.84 in chips)
Seat 6: PlayTheBlues4U ($7.95 in chips)
Smuggler1991: posts small blind $0.02
smokestackinggg: posts big blind $0.05
*** HOLE CARDS ***
Dealt to PlayTheBlues4U [6h Kd]
DemolishIT: raises $0.20 to $0.25
PlayTheBlues4U: folds
swammer1997: raises $0.20 to $0.45
Smuggler1991: folds
smokestackinggg: folds
DemolishIT: calls $0.20
*** FLOP *** [6d Ad 3d]
DaGoodz33 joins the table at seat #1
DemolishIT: checks
swammer1997: bets $0.80
DemolishIT: calls $0.80
*** TURN *** [6d Ad 3d] [7h]
DemolishIT: checks
swammer1997: checks
*** RIVER *** [6d Ad 3d 7h] [9s]
DemolishIT: checks
swammer1997: bets $1.15
DemolishIT: folds
Uncalled bet ($1.15) returned to swammer1997
swammer1997 collected $2.44 from pot
swammer1997: doesn't show hand
*** SUMMARY ***
Total pot $2.57 | Rake $0.13
Board [6d Ad 3d 7h 9s]
Seat 2: swammer1997 (button) collected ($2.44)
Seat 3: Smuggler1991 (small blind) folded before Flop
Seat 4: smokestackinggg (big blind) folded before Flop
Seat 5: DemolishIT folded on the River
Seat 6: PlayTheBlues4U folded before Flop (didn't bet)


*********** # 130 **************
PokerStars Hand #204207708932:  Hold'em No Limit ($0.02/$0.05 USD) - 2019/10/03 23:00:31 ET
Table 'Phoenix' 6-max Seat #6 is the button
Seat 2: swammer1997 ($5.15 in chips)
Seat 3: Smuggler1991 ($7.05 in chips)
Seat 5: DemolishIT ($10.99 in chips)
Seat 6: PlayTheBlues4U ($7.62 in chips)
swammer1997: posts small blind $0.02
Smuggler1991: posts big blind $0.05
smokestackinggg: sits out
*** HOLE CARDS ***
Dealt to PlayTheBlues4U [Kc Tc]
DemolishIT: calls $0.05
PlayTheBlues4U: raises $0.10 to $0.15
swammer1997: calls $0.13
Smuggler1991: folds
DemolishIT: calls $0.10
*** FLOP *** [7h Qd 5d]
swammer1997: checks
DemolishIT: checks
PlayTheBlues4U: bets $0.30
swammer1997: folds
DemolishIT: folds
Uncalled bet ($0.30) returned to PlayTheBlues4U
PlayTheBlues4U collected $0.48 from pot
PlayTheBlues4U: doesn't show hand
*** SUMMARY ***
Total pot $0.50 | Rake $0.02
Board [7h Qd 5d]
Seat 2: swammer1997 (small blind) folded on the Flop
Seat 3: Smuggler1991 (big blind) folded before Flop
Seat 5: DemolishIT folded on the Flop
Seat 6: PlayTheBlues4U (button) collected ($0.48)


*********** # 131 **************
PokerStars Hand #204207708897:  Hold'em No Limit ($0.02/$0.05 USD) - 2019/10/03 23:00:20 ET
Table 'Phoenix' 6-max Seat #5 is the button
Seat 1: skillzplumber ($0.24 in chips)
Seat 2: swammer1997 ($5.15 in chips)
Seat 3: Smuggler1991 ($7.05 in chips)
Seat 5: DemolishIT ($10.92 in chips)
Seat 6: PlayTheBlues4U ($7.64 in chips)
PlayTheBlues4U: posts small blind $0.02
skillzplumber: posts big blind $0.05
*** HOLE CARDS ***
Dealt to PlayTheBlues4U [3d Td]
swammer1997: folds
Smuggler1991: folds
DemolishIT: calls $0.05
PlayTheBlues4U: folds
skillzplumber: folds
skillzplumber leaves the table
smokestackinggg joins the table at seat #4
DemolishIT collected $0.12 from pot
*** SUMMARY ***
Total pot $0.12 | Rake $0
Seat 1: skillzplumber (big blind) folded before Flop
Seat 2: swammer1997 folded before Flop (didn't bet)
Seat 3: Smuggler1991 folded before Flop (didn't bet)
Seat 5: DemolishIT (button) collected ($0.12)
Seat 6: PlayTheBlues4U (small blind) folded before Flop


*********** # 132 **************
PokerStars Hand #204207708793:  Hold'em No Limit ($0.02/$0.05 USD) - 2019/10/03 22:59:30 ET
Table 'Phoenix' 6-max Seat #3 is the button
Seat 1: skillzplumber ($5.96 in chips)
Seat 2: swammer1997 ($5.15 in chips)
Seat 3: Smuggler1991 ($7.05 in chips)
Seat 5: DemolishIT ($5.72 in chips)
Seat 6: PlayTheBlues4U ($7.69 in chips)
DemolishIT: posts small blind $0.02
PlayTheBlues4U: posts big blind $0.05
*** HOLE CARDS ***
Dealt to PlayTheBlues4U [3s 2c]
skillzplumber: raises $0.20 to $0.25
swammer1997: folds
Smuggler1991: folds
DemolishIT: raises $0.70 to $0.95
PlayTheBlues4U: folds
skillzplumber: calls $0.70
*** FLOP *** [Qs As Th]
DemolishIT: bets $1.85
skillzplumber: raises $3.16 to $5.01 and is all-in
DemolishIT: calls $2.92 and is all-in
Uncalled bet ($0.24) returned to skillzplumber
*** TURN *** [Qs As Th] [Qh]
*** RIVER *** [Qs As Th Qh] [Jc]
*** SHOW DOWN ***
DemolishIT: shows [Ac Kd] (a straight, Ten to Ace)
skillzplumber: shows [6d Ad] (two pair, Aces and Queens)
DemolishIT collected $10.92 from pot
*** SUMMARY ***
Total pot $11.49 | Rake $0.57
Board [Qs As Th Qh Jc]
Seat 1: skillzplumber showed [6d Ad] and lost with two pair, Aces and Queens
Seat 2: swammer1997 folded before Flop (didn't bet)
Seat 3: Smuggler1991 (button) folded before Flop (didn't bet)
Seat 5: DemolishIT (small blind) showed [Ac Kd] and won ($10.92) with a straight, Ten to Ace
Seat 6: PlayTheBlues4U (big blind) folded before Flop


*********** # 133 **************
PokerStars Hand #204207708737:  Hold'em No Limit ($0.02/$0.05 USD) - 2019/10/03 22:59:08 ET
Table 'Phoenix' 6-max Seat #2 is the button
Seat 1: skillzplumber ($5.96 in chips)
Seat 2: swammer1997 ($5.09 in chips)
Seat 3: Smuggler1991 ($7.07 in chips)
Seat 5: DemolishIT ($5.77 in chips)
Seat 6: PlayTheBlues4U ($7.69 in chips)
Smuggler1991: posts small blind $0.02
Cake_Horn_14: is sitting out
DemolishIT: posts big blind $0.05
*** HOLE CARDS ***
Dealt to PlayTheBlues4U [4h 3d]
Cake_Horn_14 leaves the table
PlayTheBlues4U: folds
skillzplumber: folds
swammer1997: calls $0.05
Smuggler1991: folds
DemolishIT: checks
*** FLOP *** [Ks 3c 3s]
DemolishIT: checks
swammer1997: bets $0.10
DemolishIT: folds
Uncalled bet ($0.10) returned to swammer1997
swammer1997 collected $0.11 from pot
swammer1997: doesn't show hand
*** SUMMARY ***
Total pot $0.12 | Rake $0.01
Board [Ks 3c 3s]
Seat 1: skillzplumber folded before Flop (didn't bet)
Seat 2: swammer1997 (button) collected ($0.11)
Seat 3: Smuggler1991 (small blind) folded before Flop
Seat 5: DemolishIT (big blind) folded on the Flop
Seat 6: PlayTheBlues4U folded before Flop (didn't bet)


*********** # 134 **************
PokerStars Hand #204207708679:  Hold'em No Limit ($0.02/$0.05 USD) - 2019/10/03 22:58:37 ET
Table 'Phoenix' 6-max Seat #1 is the button
Seat 1: skillzplumber ($6.06 in chips)
Seat 2: swammer1997 ($4.95 in chips)
Seat 3: Smuggler1991 ($7.12 in chips)
Seat 4: Cake_Horn_14 ($5.39 in chips)
Seat 5: DemolishIT ($5.77 in chips)
Seat 6: PlayTheBlues4U ($7.69 in chips)
swammer1997: posts small blind $0.02
Smuggler1991: posts big blind $0.05
*** HOLE CARDS ***
Dealt to PlayTheBlues4U [Jh 5c]
Cake_Horn_14: folds
DemolishIT: folds
PlayTheBlues4U: folds
skillzplumber: calls $0.05
swammer1997: raises $0.05 to $0.10
Smuggler1991: folds
skillzplumber: calls $0.05
*** FLOP *** [8c 2d Ad]
swammer1997: bets $0.10
skillzplumber: folds
Uncalled bet ($0.10) returned to swammer1997
swammer1997 collected $0.24 from pot
swammer1997: doesn't show hand
*** SUMMARY ***
Total pot $0.25 | Rake $0.01
Board [8c 2d Ad]
Seat 1: skillzplumber (button) folded on the Flop
Seat 2: swammer1997 (small blind) collected ($0.24)
Seat 3: Smuggler1991 (big blind) folded before Flop
Seat 4: Cake_Horn_14 folded before Flop (didn't bet)
Seat 5: DemolishIT folded before Flop (didn't bet)
Seat 6: PlayTheBlues4U folded before Flop (didn't bet)


*********** # 135 **************
PokerStars Hand #204207708596:  Hold'em No Limit ($0.02/$0.05 USD) - 2019/10/03 22:58:04 ET
Table 'Phoenix' 6-max Seat #6 is the button
Seat 1: skillzplumber ($6.08 in chips)
Seat 2: swammer1997 ($5 in chips)
Seat 3: Smuggler1991 ($10.12 in chips)
Seat 4: Cake_Horn_14 ($5.39 in chips)
Seat 5: DemolishIT ($3 in chips)
Seat 6: PlayTheBlues4U ($7.69 in chips)
skillzplumber: posts small blind $0.02
swammer1997: posts big blind $0.05
*** HOLE CARDS ***
Dealt to PlayTheBlues4U [8h 2d]
Smuggler1991: raises $10.07 to $10.12 and is all-in
Cake_Horn_14: folds
DemolishIT: calls $3 and is all-in
PlayTheBlues4U: folds
skillzplumber: folds
swammer1997: folds
Uncalled bet ($7.12) returned to Smuggler1991
*** FLOP *** [Tc 6h 2c]
*** TURN *** [Tc 6h 2c] [Ah]
*** RIVER *** [Tc 6h 2c Ah] [Ad]
*** SHOW DOWN ***
Smuggler1991: shows [Td Jc] (two pair, Aces and Tens)
DemolishIT: shows [Qc Ac] (three of a kind, Aces)
DemolishIT collected $5.77 from pot
*** SUMMARY ***
Total pot $6.07 | Rake $0.30
Board [Tc 6h 2c Ah Ad]
Seat 1: skillzplumber (small blind) folded before Flop
Seat 2: swammer1997 (big blind) folded before Flop
Seat 3: Smuggler1991 showed [Td Jc] and lost with two pair, Aces and Tens
Seat 4: Cake_Horn_14 folded before Flop (didn't bet)
Seat 5: DemolishIT showed [Qc Ac] and won ($5.77) with three of a kind, Aces
Seat 6: PlayTheBlues4U (button) folded before Flop (didn't bet)


*********** # 136 **************
PokerStars Hand #204207708515:  Hold'em No Limit ($0.02/$0.05 USD) - 2019/10/03 22:57:26 ET
Table 'Phoenix' 6-max Seat #5 is the button
Seat 1: skillzplumber ($6.23 in chips)
Seat 3: Smuggler1991 ($10.12 in chips)
Seat 4: Cake_Horn_14 ($5.24 in chips)
Seat 5: DemolishIT ($3 in chips)
Seat 6: PlayTheBlues4U ($7.71 in chips)
PlayTheBlues4U: posts small blind $0.02
skillzplumber: posts big blind $0.05
swammer1997: sits out
*** HOLE CARDS ***
Dealt to PlayTheBlues4U [Jc 5s]
Smuggler1991: folds
Cake_Horn_14: raises $0.10 to $0.15
DemolishIT: folds
PlayTheBlues4U: folds
skillzplumber: calls $0.10
*** FLOP *** [6h 2c 9c]
skillzplumber: checks
Cake_Horn_14: checks
*** TURN *** [6h 2c 9c] [3d]
skillzplumber: checks
Cake_Horn_14: checks
*** RIVER *** [6h 2c 9c 3d] [2s]
skillzplumber: checks
Cake_Horn_14: checks
*** SHOW DOWN ***
skillzplumber: shows [8s Qs] (a pair of Deuces)
Cake_Horn_14: shows [Qc Ks] (a pair of Deuces - King kicker)
Cake_Horn_14 collected $0.30 from pot
*** SUMMARY ***
Total pot $0.32 | Rake $0.02
Board [6h 2c 9c 3d 2s]
Seat 1: skillzplumber (big blind) showed [8s Qs] and lost with a pair of Deuces
Seat 3: Smuggler1991 folded before Flop (didn't bet)
Seat 4: Cake_Horn_14 showed [Qc Ks] and won ($0.30) with a pair of Deuces
Seat 5: DemolishIT (button) folded before Flop (didn't bet)
Seat 6: PlayTheBlues4U (small blind) folded before Flop


*********** # 137 **************
PokerStars Hand #204207708513:  Hold'em No Limit ($0.05/$0.10 USD) - 2019/10/03 22:57:25 ET
Table 'Corvus' 6-max Seat #5 is the button
Seat 2: xd33zzr ($9.75 in chips)
Seat 4: polonusik ($24.94 in chips)
Seat 5: PlayTheBlues4U ($10.22 in chips)
xd33zzr: posts small blind $0.05
kid delaw731: is sitting out
polonusik: posts big blind $0.10
*** HOLE CARDS ***
Dealt to PlayTheBlues4U [4d 8s]
PlayTheBlues4U: folds
xd33zzr: calls $0.05
kid delaw731 leaves the table
polonusik: checks
*** FLOP *** [Qh Td 6c]
xd33zzr: checks
polonusik: checks
*** TURN *** [Qh Td 6c] [7c]
xd33zzr: checks
polonusik: bets $0.19
xd33zzr: calls $0.19
*** RIVER *** [Qh Td 6c 7c] [5d]
xd33zzr: checks
polonusik: checks
*** SHOW DOWN ***
xd33zzr: shows [4s 7s] (a pair of Sevens)
polonusik: shows [7d 2c] (a pair of Sevens)
xd33zzr collected $0.28 from pot
polonusik collected $0.27 from pot
*** SUMMARY ***
Total pot $0.58 | Rake $0.03
Board [Qh Td 6c 7c 5d]
Seat 2: xd33zzr (small blind) showed [4s 7s] and won ($0.28) with a pair of Sevens
Seat 4: polonusik (big blind) showed [7d 2c] and won ($0.27) with a pair of Sevens
Seat 5: PlayTheBlues4U (button) folded before Flop (didn't bet)


*********** # 138 **************
PokerStars Hand #204207708480:  Hold'em No Limit ($0.02/$0.05 USD) - 2019/10/03 22:57:09 ET
Table 'Phoenix' 6-max Seat #4 is the button
Seat 1: skillzplumber ($6.23 in chips)
Seat 3: Smuggler1991 ($10.12 in chips)
Seat 4: Cake_Horn_14 ($5.24 in chips)
Seat 5: DemolishIT ($2.95 in chips)
Seat 6: PlayTheBlues4U ($7.76 in chips)
DemolishIT: posts small blind $0.02
PlayTheBlues4U: posts big blind $0.05
swammer1997: sits out
*** HOLE CARDS ***
Dealt to PlayTheBlues4U [5c 9s]
skillzplumber: folds
Smuggler1991: folds
Cake_Horn_14: folds
DemolishIT: raises $0.20 to $0.25
PlayTheBlues4U: folds
Uncalled bet ($0.20) returned to DemolishIT
DemolishIT collected $0.10 from pot
*** SUMMARY ***
Total pot $0.10 | Rake $0
Seat 1: skillzplumber folded before Flop (didn't bet)
Seat 3: Smuggler1991 folded before Flop (didn't bet)
Seat 4: Cake_Horn_14 (button) folded before Flop (didn't bet)
Seat 5: DemolishIT (small blind) collected ($0.10)
Seat 6: PlayTheBlues4U (big blind) folded before Flop


*********** # 139 **************
PokerStars Hand #204207708444:  Hold'em No Limit ($0.05/$0.10 USD) - 2019/10/03 22:56:50 ET
Table 'Corvus' 6-max Seat #4 is the button
Seat 2: xd33zzr ($10 in chips)
Seat 3: kid delaw731 ($9.91 in chips)
Seat 4: polonusik ($24.94 in chips)
Seat 5: PlayTheBlues4U ($9.90 in chips)
PlayTheBlues4U: posts small blind $0.05
xd33zzr: posts big blind $0.10
*** HOLE CARDS ***
Dealt to PlayTheBlues4U [7s 5s]
kid delaw731: calls $0.10
polonusik: folds
PlayTheBlues4U: raises $0.15 to $0.25
xd33zzr: calls $0.15
kid delaw731: folds
*** FLOP *** [Js 6h 4h]
PlayTheBlues4U: bets $0.30
xd33zzr: folds
Uncalled bet ($0.30) returned to PlayTheBlues4U
PlayTheBlues4U collected $0.57 from pot
PlayTheBlues4U: doesn't show hand
*** SUMMARY ***
Total pot $0.60 | Rake $0.03
Board [Js 6h 4h]
Seat 2: xd33zzr (big blind) folded on the Flop
Seat 3: kid delaw731 folded before Flop
Seat 4: polonusik (button) folded before Flop (didn't bet)
Seat 5: PlayTheBlues4U (small blind) collected ($0.57)


*********** # 140 **************
PokerStars Hand #204207708411:  Hold'em No Limit ($0.05/$0.10 USD) - 2019/10/03 22:56:36 ET
Table 'Corvus' 6-max Seat #3 is the button
Seat 1: ng2414 ($32.91 in chips)
Seat 3: kid delaw731 ($9.76 in chips)
Seat 4: polonusik ($24.99 in chips)
Seat 5: PlayTheBlues4U ($10 in chips)
polonusik: posts small blind $0.05
PlayTheBlues4U: posts big blind $0.10
xd33zzr: sits out
*** HOLE CARDS ***
Dealt to PlayTheBlues4U [Tc 8d]
ng2414: folds
kid delaw731: raises $0.20 to $0.30
polonusik: folds
ng2414 leaves the table
PlayTheBlues4U: folds
Uncalled bet ($0.20) returned to kid delaw731
kid delaw731 collected $0.25 from pot
kid delaw731: doesn't show hand
*** SUMMARY ***
Total pot $0.25 | Rake $0
Seat 1: ng2414 folded before Flop (didn't bet)
Seat 3: kid delaw731 (button) collected ($0.25)
Seat 4: polonusik (small blind) folded before Flop
Seat 5: PlayTheBlues4U (big blind) folded before Flop


*********** # 141 **************
PokerStars Hand #204207708408:  Hold'em No Limit ($0.02/$0.05 USD) - 2019/10/03 22:56:34 ET
Table 'Phoenix' 6-max Seat #3 is the button
Seat 1: skillzplumber ($6.28 in chips)
Seat 3: Smuggler1991 ($10.34 in chips)
Seat 4: Cake_Horn_14 ($5.26 in chips)
Seat 5: DemolishIT ($2.66 in chips)
Seat 6: PlayTheBlues4U ($7.76 in chips)
Cake_Horn_14: posts small blind $0.02
DemolishIT: posts big blind $0.05
*** HOLE CARDS ***
Dealt to PlayTheBlues4U [6d 4d]
PlayTheBlues4U: folds
skillzplumber: calls $0.05
pie3210 leaves the table
skillzplumber said, "nh"
Smuggler1991: raises $0.17 to $0.22
Cake_Horn_14: folds
DemolishIT: raises $2.44 to $2.66 and is all-in
skillzplumber: folds
Smuggler1991: folds
Uncalled bet ($2.44) returned to DemolishIT
swammer1997 joins the table at seat #2
DemolishIT collected $0.51 from pot
*** SUMMARY ***
Total pot $0.51 | Rake $0
Seat 1: skillzplumber folded before Flop
Seat 3: Smuggler1991 (button) folded before Flop
Seat 4: Cake_Horn_14 (small blind) folded before Flop
Seat 5: DemolishIT (big blind) collected ($0.51)
Seat 6: PlayTheBlues4U folded before Flop (didn't bet)


*********** # 142 **************
PokerStars Hand #204207708283:  Hold'em No Limit ($0.02/$0.05 USD) - 2019/10/03 22:55:31 ET
Table 'Phoenix' 6-max Seat #1 is the button
Seat 1: skillzplumber ($9.35 in chips)
Seat 2: pie3210 ($2.47 in chips)
Seat 3: Smuggler1991 ($2.72 in chips)
Seat 4: Cake_Horn_14 ($5.26 in chips)
Seat 5: DemolishIT ($3.07 in chips)
Seat 6: PlayTheBlues4U ($8.01 in chips)
pie3210: posts small blind $0.02
Smuggler1991: posts big blind $0.05
*** HOLE CARDS ***
Dealt to PlayTheBlues4U [3c 3h]
Cake_Horn_14: folds
DemolishIT: raises $0.20 to $0.25
PlayTheBlues4U: calls $0.25
skillzplumber: raises $0.45 to $0.70
pie3210: raises $1.77 to $2.47 and is all-in
Smuggler1991: raises $0.25 to $2.72 and is all-in
DemolishIT: calls $2.47
PlayTheBlues4U: folds
skillzplumber: calls $2.02
*** FLOP *** [2h 7c Qs]
DemolishIT: checks
skillzplumber: bets $0.40
DemolishIT: calls $0.35 and is all-in
Uncalled bet ($0.05) returned to skillzplumber
*** TURN *** [2h 7c Qs] [4h]
*** RIVER *** [2h 7c Qs 4h] [Th]
*** SHOW DOWN ***
DemolishIT: shows [6d 7d] (a pair of Sevens)
skillzplumber: shows [Ad Kd] (high card Ace)
DemolishIT collected $0.66 from side pot-2
Smuggler1991: shows [Ah Kh] (a flush, Ace high)
Smuggler1991 collected $0.72 from side pot-1
pie3210: shows [As Qh] (a pair of Queens)
Smuggler1991 collected $9.62 from main pot
*** SUMMARY ***
Total pot $11.58 Main pot $9.62. Side pot-1 $0.72. Side pot-2 $0.66. | Rake $0.58
Board [2h 7c Qs 4h Th]
Seat 1: skillzplumber (button) showed [Ad Kd] and lost with high card Ace
Seat 2: pie3210 (small blind) showed [As Qh] and lost with a pair of Queens
Seat 3: Smuggler1991 (big blind) showed [Ah Kh] and won ($10.34) with a flush, Ace high
Seat 4: Cake_Horn_14 folded before Flop (didn't bet)
Seat 5: DemolishIT showed [6d 7d] and won ($0.66) with a pair of Sevens
Seat 6: PlayTheBlues4U folded before Flop


*********** # 143 **************
PokerStars Hand #204207708147:  Hold'em No Limit ($0.02/$0.05 USD) - 2019/10/03 22:54:32 ET
Table 'Phoenix' 6-max Seat #6 is the button
Seat 1: skillzplumber ($9.37 in chips)
Seat 2: pie3210 ($2.52 in chips)
Seat 3: Smuggler1991 ($2.72 in chips)
Seat 4: Cake_Horn_14 ($5.26 in chips)
Seat 5: DemolishIT ($4.67 in chips)
Seat 6: PlayTheBlues4U ($6.50 in chips)
skillzplumber: posts small blind $0.02
pie3210: posts big blind $0.05
*** HOLE CARDS ***
Dealt to PlayTheBlues4U [6d Ad]
Smuggler1991: folds
Cake_Horn_14: folds
DemolishIT: raises $0.25 to $0.30
PlayTheBlues4U: raises $0.45 to $0.75
skillzplumber: folds
pie3210: folds
DemolishIT: calls $0.45
*** FLOP *** [Td Kc 2c]
DemolishIT: checks
PlayTheBlues4U: bets $0.85
DemolishIT: calls $0.85
*** TURN *** [Td Kc 2c] [4s]
DemolishIT: checks
PlayTheBlues4U: checks
*** RIVER *** [Td Kc 2c 4s] [4h]
DemolishIT: checks
PlayTheBlues4U: bets $1.70
DemolishIT: folds
Uncalled bet ($1.70) returned to PlayTheBlues4U
PlayTheBlues4U collected $3.11 from pot
PlayTheBlues4U: doesn't show hand
*** SUMMARY ***
Total pot $3.27 | Rake $0.16
Board [Td Kc 2c 4s 4h]
Seat 1: skillzplumber (small blind) folded before Flop
Seat 2: pie3210 (big blind) folded before Flop
Seat 3: Smuggler1991 folded before Flop (didn't bet)
Seat 4: Cake_Horn_14 folded before Flop (didn't bet)
Seat 5: DemolishIT folded on the River
Seat 6: PlayTheBlues4U (button) collected ($3.11)


*********** # 144 **************
PokerStars Hand #204207708064:  Hold'em No Limit ($0.02/$0.05 USD) - 2019/10/03 22:54:04 ET
Table 'Phoenix' 6-max Seat #5 is the button
Seat 1: skillzplumber ($9.42 in chips)
Seat 2: pie3210 ($2.57 in chips)
Seat 3: Smuggler1991 ($2.60 in chips)
Seat 4: Cake_Horn_14 ($5.26 in chips)
Seat 5: DemolishIT ($4.67 in chips)
Seat 6: PlayTheBlues4U ($6.52 in chips)
PlayTheBlues4U: posts small blind $0.02
skillzplumber: posts big blind $0.05
*** HOLE CARDS ***
Dealt to PlayTheBlues4U [3c Tc]
pie3210: calls $0.05
Smuggler1991: raises $0.17 to $0.22
Cake_Horn_14: folds
DemolishIT: folds
PlayTheBlues4U: folds
skillzplumber: folds
pie3210: folds
Uncalled bet ($0.17) returned to Smuggler1991
Smuggler1991 collected $0.17 from pot
Smuggler1991: doesn't show hand
*** SUMMARY ***
Total pot $0.17 | Rake $0
Seat 1: skillzplumber (big blind) folded before Flop
Seat 2: pie3210 folded before Flop
Seat 3: Smuggler1991 collected ($0.17)
Seat 4: Cake_Horn_14 folded before Flop (didn't bet)
Seat 5: DemolishIT (button) folded before Flop (didn't bet)
Seat 6: PlayTheBlues4U (small blind) folded before Flop


*********** # 145 **************
PokerStars Hand #204207707980:  Hold'em No Limit ($0.02/$0.05 USD) - 2019/10/03 22:53:36 ET
Table 'Phoenix' 6-max Seat #4 is the button
Seat 1: skillzplumber ($9.42 in chips)
Seat 2: pie3210 ($2.57 in chips)
Seat 3: Smuggler1991 ($2.77 in chips)
Seat 4: Cake_Horn_14 ($5.26 in chips)
Seat 5: DemolishIT ($4.45 in chips)
Seat 6: PlayTheBlues4U ($6.57 in chips)
DemolishIT: posts small blind $0.02
PlayTheBlues4U: posts big blind $0.05
*** HOLE CARDS ***
Dealt to PlayTheBlues4U [Kh 9c]
skillzplumber: folds
pie3210: folds
Smuggler1991: raises $0.12 to $0.17
Cake_Horn_14: folds
DemolishIT: raises $0.58 to $0.75
PlayTheBlues4U: folds
Smuggler1991: folds
Uncalled bet ($0.58) returned to DemolishIT
DemolishIT collected $0.39 from pot
DemolishIT: doesn't show hand
*** SUMMARY ***
Total pot $0.39 | Rake $0
Seat 1: skillzplumber folded before Flop (didn't bet)
Seat 2: pie3210 folded before Flop (didn't bet)
Seat 3: Smuggler1991 folded before Flop
Seat 4: Cake_Horn_14 (button) folded before Flop (didn't bet)
Seat 5: DemolishIT (small blind) collected ($0.39)
Seat 6: PlayTheBlues4U (big blind) folded before Flop


*********** # 146 **************
PokerStars Hand #204206679926:  Hold'em No Limit ($0.02/$0.05 USD) - 2019/10/03 22:52:38 ET
Table 'Phoenix' 6-max Seat #3 is the button
Seat 1: skillzplumber ($9.22 in chips)
Seat 2: pie3210 ($2.62 in chips)
Seat 3: Smuggler1991 ($2.77 in chips)
Seat 4: Cake_Horn_14 ($5.28 in chips)
Seat 5: DemolishIT ($4.60 in chips)
Seat 6: PlayTheBlues4U ($6.57 in chips)
Cake_Horn_14: posts small blind $0.02
DemolishIT: posts big blind $0.05
pie3210: posts big blind $0.05
*** HOLE CARDS ***
Dealt to PlayTheBlues4U [7h Kc]
PlayTheBlues4U: folds
skillzplumber: raises $0.10 to $0.15
pie3210: folds
Smuggler1991: folds
Cake_Horn_14: folds
DemolishIT: calls $0.10
*** FLOP *** [8c Qc 2d]
DemolishIT: checks
skillzplumber: checks
*** TURN *** [8c Qc 2d] [Ts]
DemolishIT: checks
skillzplumber: checks
*** RIVER *** [8c Qc 2d Ts] [Ad]
DemolishIT: checks
skillzplumber: bets $0.30
DemolishIT: folds
Uncalled bet ($0.30) returned to skillzplumber
skillzplumber collected $0.35 from pot
skillzplumber: doesn't show hand
*** SUMMARY ***
Total pot $0.37 | Rake $0.02
Board [8c Qc 2d Ts Ad]
Seat 1: skillzplumber collected ($0.35)
Seat 2: pie3210 folded before Flop (didn't bet)
Seat 3: Smuggler1991 (button) folded before Flop (didn't bet)
Seat 4: Cake_Horn_14 (small blind) folded before Flop
Seat 5: DemolishIT (big blind) folded on the River
Seat 6: PlayTheBlues4U folded before Flop (didn't bet)


*********** # 147 **************
PokerStars Hand #204206679819:  Hold'em No Limit ($0.02/$0.05 USD) - 2019/10/03 22:51:59 ET
Table 'Phoenix' 6-max Seat #1 is the button
Seat 1: skillzplumber ($9.22 in chips)
Seat 3: Smuggler1991 ($2.79 in chips)
Seat 4: Cake_Horn_14 ($5.22 in chips)
Seat 5: DemolishIT ($4.65 in chips)
Seat 6: PlayTheBlues4U ($6.57 in chips)
pie3210 will be allowed to play after the button
Smuggler1991: posts small blind $0.02
Cake_Horn_14: posts big blind $0.05
*** HOLE CARDS ***
Dealt to PlayTheBlues4U [7h 3s]
DemolishIT: calls $0.05
PlayTheBlues4U: folds
skillzplumber: folds
Smuggler1991: folds
Cake_Horn_14: checks
*** FLOP *** [As Kh 6s]
Cake_Horn_14: checks
DemolishIT: checks
*** TURN *** [As Kh 6s] [4c]
Cake_Horn_14: bets $0.08
DemolishIT: folds
Uncalled bet ($0.08) returned to Cake_Horn_14
Cake_Horn_14 collected $0.11 from pot
Cake_Horn_14: doesn't show hand
*** SUMMARY ***
Total pot $0.12 | Rake $0.01
Board [As Kh 6s 4c]
Seat 1: skillzplumber (button) folded before Flop (didn't bet)
Seat 3: Smuggler1991 (small blind) folded before Flop
Seat 4: Cake_Horn_14 (big blind) collected ($0.11)
Seat 5: DemolishIT folded on the Turn
Seat 6: PlayTheBlues4U folded before Flop (didn't bet)


*********** # 148 **************
PokerStars Hand #204206679775:  Hold'em No Limit ($0.02/$0.05 USD) - 2019/10/03 22:51:42 ET
Table 'Phoenix' 6-max Seat #6 is the button
Seat 1: skillzplumber ($9.24 in chips)
Seat 3: Smuggler1991 ($2.77 in chips)
Seat 4: Cake_Horn_14 ($5.22 in chips)
Seat 5: DemolishIT ($4.65 in chips)
Seat 6: PlayTheBlues4U ($6.57 in chips)
skillzplumber: posts small blind $0.02
Gould Rush: is sitting out
Smuggler1991: posts big blind $0.05
*** HOLE CARDS ***
Dealt to PlayTheBlues4U [6d Kc]
Gould Rush leaves the table
Cake_Horn_14: folds
DemolishIT: folds
PlayTheBlues4U: folds
pie3210 joins the table at seat #2
skillzplumber: folds
Uncalled bet ($0.03) returned to Smuggler1991
Smuggler1991 collected $0.04 from pot
Smuggler1991: doesn't show hand
*** SUMMARY ***
Total pot $0.04 | Rake $0
Seat 1: skillzplumber (small blind) folded before Flop
Seat 3: Smuggler1991 (big blind) collected ($0.04)
Seat 4: Cake_Horn_14 folded before Flop (didn't bet)
Seat 5: DemolishIT folded before Flop (didn't bet)
Seat 6: PlayTheBlues4U (button) folded before Flop (didn't bet)


*********** # 149 **************
PokerStars Hand #204206679661:  Hold'em No Limit ($0.02/$0.05 USD) - 2019/10/03 22:51:03 ET
Table 'Phoenix' 6-max Seat #5 is the button
Seat 1: skillzplumber ($9.29 in chips)
Seat 2: Gould Rush ($5.52 in chips)
Seat 3: Smuggler1991 ($2.77 in chips)
Seat 4: Cake_Horn_14 ($5.22 in chips)
Seat 5: DemolishIT ($4.65 in chips)
Seat 6: PlayTheBlues4U ($6.52 in chips)
PlayTheBlues4U: posts small blind $0.02
skillzplumber: posts big blind $0.05
*** HOLE CARDS ***
Dealt to PlayTheBlues4U [Kc 7c]
Gould Rush: folds
Smuggler1991: folds
Cake_Horn_14: folds
DemolishIT: folds
PlayTheBlues4U: raises $0.05 to $0.10
skillzplumber: folds
Uncalled bet ($0.05) returned to PlayTheBlues4U
PlayTheBlues4U collected $0.10 from pot
PlayTheBlues4U: doesn't show hand
*** SUMMARY ***
Total pot $0.10 | Rake $0
Seat 1: skillzplumber (big blind) folded before Flop
Seat 2: Gould Rush folded before Flop (didn't bet)
Seat 3: Smuggler1991 folded before Flop (didn't bet)
Seat 4: Cake_Horn_14 folded before Flop (didn't bet)
Seat 5: DemolishIT (button) folded before Flop (didn't bet)
Seat 6: PlayTheBlues4U (small blind) collected ($0.10)


*********** # 150 **************
PokerStars Hand #204206679599:  Hold'em No Limit ($0.05/$0.10 USD) - 2019/10/03 22:50:41 ET
Table 'Sculptor' 6-max Seat #4 is the button
Seat 2: Mo8791 ($10.65 in chips)
Seat 3: PlayTheBlues4U ($6.70 in chips)
Seat 4: Gould Rush ($21.97 in chips)
Seat 6: Smuggler1991 ($9.67 in chips)
Smuggler1991: posts small blind $0.05
Mo8791: posts big blind $0.10
*** HOLE CARDS ***
Dealt to PlayTheBlues4U [Ac 6s]
PlayTheBlues4U: raises $0.20 to $0.30
Gould Rush: folds
Smuggler1991: raises $0.70 to $1
Mo8791: folds
PlayTheBlues4U: folds
Uncalled bet ($0.70) returned to Smuggler1991
Smuggler1991 collected $0.70 from pot
Smuggler1991: doesn't show hand
*** SUMMARY ***
Total pot $0.70 | Rake $0
Seat 2: Mo8791 (big blind) folded before Flop
Seat 3: PlayTheBlues4U folded before Flop
Seat 4: Gould Rush (button) folded before Flop (didn't bet)
Seat 6: Smuggler1991 (small blind) collected ($0.70)


*********** # 151 **************
PokerStars Hand #204206679518:  Hold'em No Limit ($0.02/$0.05 USD) - 2019/10/03 22:50:14 ET
Table 'Phoenix' 6-max Seat #4 is the button
Seat 1: skillzplumber ($9.29 in chips)
Seat 2: Gould Rush ($5 in chips)
Seat 3: Smuggler1991 ($3.27 in chips)
Seat 4: Cake_Horn_14 ($5.22 in chips)
Seat 5: DemolishIT ($4.67 in chips)
Seat 6: PlayTheBlues4U ($6.57 in chips)
DemolishIT: posts small blind $0.02
PlayTheBlues4U: posts big blind $0.05
*** HOLE CARDS ***
Dealt to PlayTheBlues4U [6c 2c]
skillzplumber: folds
Gould Rush: raises $0.10 to $0.15
Smuggler1991: raises $0.10 to $0.25
Cake_Horn_14: folds
DemolishIT: folds
PlayTheBlues4U: folds
Gould Rush: calls $0.10
*** FLOP *** [2s Tc Td]
Gould Rush: checks
Smuggler1991: bets $0.25
Gould Rush: calls $0.25
*** TURN *** [2s Tc Td] [8s]
Gould Rush: checks
Smuggler1991: checks
*** RIVER *** [2s Tc Td 8s] [7c]
Gould Rush: bets $1.05
Smuggler1991: folds
Uncalled bet ($1.05) returned to Gould Rush
Gould Rush collected $1.02 from pot
Gould Rush: doesn't show hand
*** SUMMARY ***
Total pot $1.07 | Rake $0.05
Board [2s Tc Td 8s 7c]
Seat 1: skillzplumber folded before Flop (didn't bet)
Seat 2: Gould Rush collected ($1.02)
Seat 3: Smuggler1991 folded on the River
Seat 4: Cake_Horn_14 (button) folded before Flop (didn't bet)
Seat 5: DemolishIT (small blind) folded before Flop
Seat 6: PlayTheBlues4U (big blind) folded before Flop


*********** # 152 **************
PokerStars Hand #204206679464:  Hold'em No Limit ($0.05/$0.10 USD) - 2019/10/03 22:49:54 ET
Table 'Sculptor' 6-max Seat #3 is the button
Seat 2: Mo8791 ($10.47 in chips)
Seat 3: PlayTheBlues4U ($6.70 in chips)
Seat 4: Gould Rush ($22.07 in chips)
Seat 6: Smuggler1991 ($9.77 in chips)
Gould Rush: posts small blind $0.05
Smuggler1991: posts big blind $0.10
*** HOLE CARDS ***
Dealt to PlayTheBlues4U [5d 2h]
Mo8791: calls $0.10
PlayTheBlues4U: folds
Gould Rush: calls $0.05
Smuggler1991: checks
*** FLOP *** [Jh 9d Qs]
Gould Rush: checks
Smuggler1991: checks
Mo8791: checks
*** TURN *** [Jh 9d Qs] [Tc]
Gould Rush: checks
Smuggler1991: checks
Mo8791: bets $0.30
Gould Rush: folds
Smuggler1991: folds
Uncalled bet ($0.30) returned to Mo8791
Mo8791 collected $0.28 from pot
Mo8791: doesn't show hand
*** SUMMARY ***
Total pot $0.30 | Rake $0.02
Board [Jh 9d Qs Tc]
Seat 2: Mo8791 collected ($0.28)
Seat 3: PlayTheBlues4U (button) folded before Flop (didn't bet)
Seat 4: Gould Rush (small blind) folded on the Turn
Seat 6: Smuggler1991 (big blind) folded on the Turn


*********** # 153 **************
PokerStars Hand #204206679438:  Hold'em No Limit ($0.02/$0.05 USD) - 2019/10/03 22:49:45 ET
Table 'Phoenix' 6-max Seat #3 is the button
Seat 1: skillzplumber ($9.29 in chips)
Seat 2: Gould Rush ($3.20 in chips)
Seat 3: Smuggler1991 ($3.10 in chips)
Seat 4: Cake_Horn_14 ($5.24 in chips)
Seat 5: DemolishIT ($4.84 in chips)
Seat 6: PlayTheBlues4U ($6.57 in chips)
Cake_Horn_14: posts small blind $0.02
DemolishIT: posts big blind $0.05
*** HOLE CARDS ***
Dealt to PlayTheBlues4U [3h Js]
PlayTheBlues4U: folds
skillzplumber: folds
Gould Rush: folds
Smuggler1991: raises $0.12 to $0.17
Cake_Horn_14: folds
DemolishIT: calls $0.12
*** FLOP *** [8d 6c 6s]
DemolishIT: checks
Smuggler1991: bets $0.20
DemolishIT: folds
Uncalled bet ($0.20) returned to Smuggler1991
Smuggler1991 collected $0.34 from pot
Smuggler1991: doesn't show hand
*** SUMMARY ***
Total pot $0.36 | Rake $0.02
Board [8d 6c 6s]
Seat 1: skillzplumber folded before Flop (didn't bet)
Seat 2: Gould Rush folded before Flop (didn't bet)
Seat 3: Smuggler1991 (button) collected ($0.34)
Seat 4: Cake_Horn_14 (small blind) folded before Flop
Seat 5: DemolishIT (big blind) folded on the Flop
Seat 6: PlayTheBlues4U folded before Flop (didn't bet)


*********** # 154 **************
PokerStars Hand #204206679324:  Hold'em No Limit ($0.05/$0.10 USD) - 2019/10/03 22:49:02 ET
Table 'Sculptor' 6-max Seat #2 is the button
Seat 2: Mo8791 ($10.11 in chips)
Seat 3: PlayTheBlues4U ($7 in chips)
Seat 4: Gould Rush ($22.17 in chips)
Seat 6: Smuggler1991 ($9.77 in chips)
PlayTheBlues4U: posts small blind $0.05
Gould Rush: posts big blind $0.10
*** HOLE CARDS ***
Dealt to PlayTheBlues4U [Ac 2c]
Smuggler1991: folds
Mo8791: raises $0.20 to $0.30
PlayTheBlues4U: calls $0.25
Gould Rush: folds
*** FLOP *** [5d Js Tc]
PlayTheBlues4U: checks
Mo8791: bets $0.30
PlayTheBlues4U: folds
Uncalled bet ($0.30) returned to Mo8791
Mo8791 collected $0.66 from pot
Mo8791: doesn't show hand
*** SUMMARY ***
Total pot $0.70 | Rake $0.04
Board [5d Js Tc]
Seat 2: Mo8791 (button) collected ($0.66)
Seat 3: PlayTheBlues4U (small blind) folded on the Flop
Seat 4: Gould Rush (big blind) folded before Flop
Seat 6: Smuggler1991 folded before Flop (didn't bet)


*********** # 155 **************
PokerStars Hand #204206679241:  Hold'em No Limit ($0.02/$0.05 USD) - 2019/10/03 22:48:38 ET
Table 'Phoenix' 6-max Seat #2 is the button
Seat 1: skillzplumber ($9.29 in chips)
Seat 2: Gould Rush ($5 in chips)
Seat 3: Smuggler1991 ($3.12 in chips)
Seat 4: Cake_Horn_14 ($5.29 in chips)
Seat 5: DemolishIT ($5.54 in chips)
Seat 6: PlayTheBlues4U ($4.22 in chips)
Smuggler1991: posts small blind $0.02
Cake_Horn_14: posts big blind $0.05
*** HOLE CARDS ***
Dealt to PlayTheBlues4U [Ac Tc]
DemolishIT: raises $0.20 to $0.25
PlayTheBlues4U: calls $0.25
skillzplumber: folds
Gould Rush: raises $0.45 to $0.70
Smuggler1991: folds
Cake_Horn_14: folds
DemolishIT: calls $0.45
PlayTheBlues4U: calls $0.45
*** FLOP *** [Td Ah 8h]
DemolishIT: checks
PlayTheBlues4U: bets $1.10
Gould Rush: calls $1.10
DemolishIT: folds
*** TURN *** [Td Ah 8h] [Jd]
PlayTheBlues4U: bets $2.42 and is all-in
Gould Rush: folds
Uncalled bet ($2.42) returned to PlayTheBlues4U
PlayTheBlues4U collected $4.15 from pot
PlayTheBlues4U: doesn't show hand
*** SUMMARY ***
Total pot $4.37 | Rake $0.22
Board [Td Ah 8h Jd]
Seat 1: skillzplumber folded before Flop (didn't bet)
Seat 2: Gould Rush (button) folded on the Turn
Seat 3: Smuggler1991 (small blind) folded before Flop
Seat 4: Cake_Horn_14 (big blind) folded before Flop
Seat 5: DemolishIT folded on the Flop
Seat 6: PlayTheBlues4U collected ($4.15)


*********** # 156 **************
PokerStars Hand #204206679142:  Hold'em No Limit ($0.05/$0.10 USD) - 2019/10/03 22:47:58 ET
Table 'Sculptor' 6-max Seat #6 is the button
Seat 2: Mo8791 ($10.16 in chips)
Seat 3: PlayTheBlues4U ($10 in chips)
Seat 4: Gould Rush ($19.42 in chips)
Seat 6: Smuggler1991 ($9.77 in chips)
Mo8791: posts small blind $0.05
PlayTheBlues4U: posts big blind $0.10
*** HOLE CARDS ***
Dealt to PlayTheBlues4U [8c Td]
Gould Rush: raises $0.20 to $0.30
Smuggler1991: folds
Mo8791: folds
PlayTheBlues4U: calls $0.20
*** FLOP *** [Qh Tc Jd]
PlayTheBlues4U: checks
Gould Rush: bets $0.30
PlayTheBlues4U: calls $0.30
*** TURN *** [Qh Tc Jd] [7c]
PlayTheBlues4U: bets $0.70
Gould Rush: calls $0.70
*** RIVER *** [Qh Tc Jd 7c] [Js]
PlayTheBlues4U: bets $1.70
Gould Rush: calls $1.70
*** SHOW DOWN ***
PlayTheBlues4U: shows [8c Td] (two pair, Jacks and Tens)
Gould Rush: shows [As Qs] (two pair, Queens and Jacks)
Gould Rush collected $5.75 from pot
*** SUMMARY ***
Total pot $6.05 | Rake $0.30
Board [Qh Tc Jd 7c Js]
Seat 2: Mo8791 (small blind) folded before Flop
Seat 3: PlayTheBlues4U (big blind) showed [8c Td] and lost with two pair, Jacks and Tens
Seat 4: Gould Rush showed [As Qs] and won ($5.75) with two pair, Queens and Jacks
Seat 6: Smuggler1991 (button) folded before Flop (didn't bet)


*********** # 157 **************
PokerStars Hand #204206679124:  Hold'em No Limit ($0.02/$0.05 USD) - 2019/10/03 22:47:53 ET
Table 'Phoenix' 6-max Seat #1 is the button
Seat 1: skillzplumber ($9.29 in chips)
Seat 2: Gould Rush ($4.40 in chips)
Seat 3: Smuggler1991 ($3.22 in chips)
Seat 4: Cake_Horn_14 ($5.29 in chips)
Seat 5: DemolishIT ($5.54 in chips)
Seat 6: PlayTheBlues4U ($4.22 in chips)
Gould Rush: posts small blind $0.02
Smuggler1991: posts big blind $0.05
*** HOLE CARDS ***
Dealt to PlayTheBlues4U [Th 5s]
Cake_Horn_14: folds
DemolishIT: folds
PlayTheBlues4U: folds
skillzplumber: folds
Gould Rush: calls $0.03
Smuggler1991: checks
*** FLOP *** [2s 8s As]
Gould Rush: checks
Smuggler1991: bets $0.05
Gould Rush: calls $0.05
*** TURN *** [2s 8s As] [7d]
Gould Rush: checks
Smuggler1991: checks
*** RIVER *** [2s 8s As 7d] [2h]
Gould Rush: bets $0.20
Smuggler1991: folds
Uncalled bet ($0.20) returned to Gould Rush
Gould Rush collected $0.19 from pot
Gould Rush: doesn't show hand
*** SUMMARY ***
Total pot $0.20 | Rake $0.01
Board [2s 8s As 7d 2h]
Seat 1: skillzplumber (button) folded before Flop (didn't bet)
Seat 2: Gould Rush (small blind) collected ($0.19)
Seat 3: Smuggler1991 (big blind) folded on the River
Seat 4: Cake_Horn_14 folded before Flop (didn't bet)
Seat 5: DemolishIT folded before Flop (didn't bet)
Seat 6: PlayTheBlues4U folded before Flop (didn't bet)


*********** # 158 **************
PokerStars Hand #204206679112:  Hold'em No Limit ($0.05/$0.10 USD) - 2019/10/03 22:47:48 ET
Table 'Sculptor' 6-max Seat #4 is the button
Seat 2: Mo8791 ($10.11 in chips)
Seat 3: PlayTheBlues4U ($10 in chips)
Seat 4: Gould Rush ($19.42 in chips)
Seat 6: Smuggler1991 ($9.82 in chips)
Smuggler1991: posts small blind $0.05
Mo8791: posts big blind $0.10
*** HOLE CARDS ***
Dealt to PlayTheBlues4U [Th Qs]
PlayTheBlues4U: folds
Gould Rush: folds
Smuggler1991: folds
Uncalled bet ($0.05) returned to Mo8791
Mo8791 collected $0.10 from pot
Mo8791: doesn't show hand
*** SUMMARY ***
Total pot $0.10 | Rake $0
Seat 2: Mo8791 (big blind) collected ($0.10)
Seat 3: PlayTheBlues4U folded before Flop (didn't bet)
Seat 4: Gould Rush (button) folded before Flop (didn't bet)
Seat 6: Smuggler1991 (small blind) folded before Flop


*********** # 159 **************
PokerStars Hand #204206679020:  Hold'em No Limit ($0.02/$0.05 USD) - 2019/10/03 22:47:12 ET
Table 'Phoenix' 6-max Seat #6 is the button
Seat 1: skillzplumber ($8.27 in chips)
Seat 2: Gould Rush ($5 in chips)
Seat 3: Smuggler1991 ($3.22 in chips)
Seat 4: Cake_Horn_14 ($5.29 in chips)
Seat 5: DemolishIT ($6.04 in chips)
Seat 6: PlayTheBlues4U ($4.22 in chips)
skillzplumber: posts small blind $0.02
Gould Rush: posts big blind $0.05
*** HOLE CARDS ***
Dealt to PlayTheBlues4U [3d 2h]
Smuggler1991: folds
Cake_Horn_14: folds
DemolishIT: raises $0.15 to $0.20
PlayTheBlues4U: folds
skillzplumber: calls $0.18
Gould Rush: calls $0.15
*** FLOP *** [7c Td Ks]
skillzplumber: checks
Gould Rush: bets $0.30
DemolishIT: calls $0.30
skillzplumber: calls $0.30
*** TURN *** [7c Td Ks] [Tc]
skillzplumber: checks
Gould Rush: checks
DemolishIT: checks
*** RIVER *** [7c Td Ks Tc] [6c]
skillzplumber: bets $0.10
Gould Rush: calls $0.10
DemolishIT: folds
*** SHOW DOWN ***
skillzplumber: shows [Ah Th] (three of a kind, Tens)
Gould Rush: mucks hand
skillzplumber collected $1.62 from pot
*** SUMMARY ***
Total pot $1.70 | Rake $0.08
Board [7c Td Ks Tc 6c]
Seat 1: skillzplumber (small blind) showed [Ah Th] and won ($1.62) with three of a kind, Tens
Seat 2: Gould Rush (big blind) mucked [7d 8d]
Seat 3: Smuggler1991 folded before Flop (didn't bet)
Seat 4: Cake_Horn_14 folded before Flop (didn't bet)
Seat 5: DemolishIT folded on the River
Seat 6: PlayTheBlues4U (button) folded before Flop (didn't bet)


*********** # 160 **************
PokerStars Hand #204206678966:  Hold'em No Limit ($0.05/$0.10 USD) - 2019/10/03 22:46:51 ET
Table 'Sculptor' 6-max Seat #3 is the button
Seat 2: Mo8791 ($6.59 in chips)
Seat 3: PlayTheBlues4U ($6.65 in chips)
Seat 4: Gould Rush ($23.22 in chips)
Seat 6: Smuggler1991 ($9.92 in chips)
Gould Rush: posts small blind $0.05
Smuggler1991: posts big blind $0.10
*** HOLE CARDS ***
Dealt to PlayTheBlues4U [3h Ac]
Mo8791: raises $0.20 to $0.30
PlayTheBlues4U: folds
Gould Rush: calls $0.25
Smuggler1991: folds
*** FLOP *** [6s 5s 6c]
Gould Rush: bets $0.30
Mo8791: raises $1.20 to $1.50
Gould Rush: calls $1.20
*** TURN *** [6s 5s 6c] [Js]
Gould Rush: checks
Mo8791: bets $2
Gould Rush: calls $2
*** RIVER *** [6s 5s 6c Js] [3d]
Gould Rush: checks
Mo8791: checks
*** SHOW DOWN ***
Gould Rush: shows [4d As] (a pair of Sixes)
Mo8791: shows [2c 5c] (two pair, Sixes and Fives)
Mo8791 collected $7.32 from pot
*** SUMMARY ***
Total pot $7.70 | Rake $0.38
Board [6s 5s 6c Js 3d]
Seat 2: Mo8791 showed [2c 5c] and won ($7.32) with two pair, Sixes and Fives
Seat 3: PlayTheBlues4U (button) folded before Flop (didn't bet)
Seat 4: Gould Rush (small blind) showed [4d As] and lost with a pair of Sixes
Seat 6: Smuggler1991 (big blind) folded before Flop


*********** # 161 **************
PokerStars Hand #204206678909:  Hold'em No Limit ($0.02/$0.05 USD) - 2019/10/03 22:46:32 ET
Table 'Phoenix' 6-max Seat #5 is the button
Seat 1: skillzplumber ($8.93 in chips)
Seat 2: Gould Rush ($0.66 in chips)
Seat 3: Smuggler1991 ($3.22 in chips)
Seat 4: Cake_Horn_14 ($5.29 in chips)
Seat 5: DemolishIT ($6.04 in chips)
Seat 6: PlayTheBlues4U ($4.24 in chips)
PlayTheBlues4U: posts small blind $0.02
skillzplumber: posts big blind $0.05
*** HOLE CARDS ***
Dealt to PlayTheBlues4U [2c 7c]
Gould Rush: raises $0.61 to $0.66 and is all-in
Smuggler1991: folds
Cake_Horn_14: folds
DemolishIT: folds
PlayTheBlues4U: folds
skillzplumber: calls $0.61
*** FLOP *** [Ks 7s 4c]
*** TURN *** [Ks 7s 4c] [7h]
*** RIVER *** [Ks 7s 4c 7h] [Jc]
*** SHOW DOWN ***
skillzplumber: shows [Th Kh] (two pair, Kings and Sevens)
Gould Rush: shows [Kc Qd] (two pair, Kings and Sevens - Queen kicker)
Gould Rush collected $1.27 from pot
*** SUMMARY ***
Total pot $1.34 | Rake $0.07
Board [Ks 7s 4c 7h Jc]
Seat 1: skillzplumber (big blind) showed [Th Kh] and lost with two pair, Kings and Sevens
Seat 2: Gould Rush showed [Kc Qd] and won ($1.27) with two pair, Kings and Sevens
Seat 3: Smuggler1991 folded before Flop (didn't bet)
Seat 4: Cake_Horn_14 folded before Flop (didn't bet)
Seat 5: DemolishIT (button) folded before Flop (didn't bet)
Seat 6: PlayTheBlues4U (small blind) folded before Flop


*********** # 162 **************
PokerStars Hand #204206678775:  Hold'em No Limit ($0.05/$0.10 USD) - 2019/10/03 22:45:35 ET
Table 'Sculptor' 6-max Seat #2 is the button
Seat 2: Mo8791 ($6.59 in chips)
Seat 3: PlayTheBlues4U ($8.95 in chips)
Seat 4: Gould Rush ($21.15 in chips)
Seat 6: Smuggler1991 ($9.92 in chips)
PlayTheBlues4U: posts small blind $0.05
Gould Rush: posts big blind $0.10
*** HOLE CARDS ***
Dealt to PlayTheBlues4U [As Jc]
Smuggler1991: folds
Mo8791: folds
PlayTheBlues4U: raises $0.20 to $0.30
Gould Rush: calls $0.20
*** FLOP *** [5h 9d 2c]
PlayTheBlues4U: checks
Gould Rush: bets $0.50
PlayTheBlues4U: calls $0.50
*** TURN *** [5h 9d 2c] [5d]
PlayTheBlues4U: checks
Gould Rush: bets $1.50
PlayTheBlues4U: calls $1.50
*** RIVER *** [5h 9d 2c 5d] [Td]
PlayTheBlues4U: checks
Gould Rush: checks
*** SHOW DOWN ***
PlayTheBlues4U: shows [As Jc] (a pair of Fives)
Gould Rush: shows [Kh 9h] (two pair, Nines and Fives)
Gould Rush collected $4.37 from pot
*** SUMMARY ***
Total pot $4.60 | Rake $0.23
Board [5h 9d 2c 5d Td]
Seat 2: Mo8791 (button) folded before Flop (didn't bet)
Seat 3: PlayTheBlues4U (small blind) showed [As Jc] and lost with a pair of Fives
Seat 4: Gould Rush (big blind) showed [Kh 9h] and won ($4.37) with two pair, Nines and Fives
Seat 6: Smuggler1991 folded before Flop (didn't bet)


*********** # 163 **************
PokerStars Hand #204206678683:  Hold'em No Limit ($0.02/$0.05 USD) - 2019/10/03 22:45:03 ET
Table 'Phoenix' 6-max Seat #4 is the button
Seat 1: skillzplumber ($4.34 in chips)
Seat 2: Gould Rush ($5 in chips)
Seat 3: Smuggler1991 ($3.22 in chips)
Seat 4: Cake_Horn_14 ($5.29 in chips)
Seat 5: DemolishIT ($6.06 in chips)
Seat 6: PlayTheBlues4U ($4.94 in chips)
DemolishIT: posts small blind $0.02
PlayTheBlues4U: posts big blind $0.05
*** HOLE CARDS ***
Dealt to PlayTheBlues4U [Qd Kh]
skillzplumber: calls $0.05
Gould Rush: raises $0.10 to $0.15
Smuggler1991: folds
Cake_Horn_14: folds
DemolishIT: folds
PlayTheBlues4U: raises $0.10 to $0.25
skillzplumber: calls $0.20
Gould Rush: raises $0.45 to $0.70
PlayTheBlues4U: calls $0.45
skillzplumber: calls $0.45
*** FLOP *** [As Td Qs]
PlayTheBlues4U: checks
skillzplumber: checks
Gould Rush: bets $1
PlayTheBlues4U: folds
skillzplumber: raises $1.05 to $2.05
Gould Rush: raises $2.25 to $4.30 and is all-in
skillzplumber: calls $1.59 and is all-in
Uncalled bet ($0.66) returned to Gould Rush
*** TURN *** [As Td Qs] [5c]
*** RIVER *** [As Td Qs 5c] [2h]
*** SHOW DOWN ***
skillzplumber: shows [Ks Jd] (a straight, Ten to Ace)
Gould Rush: shows [Ad Ac] (three of a kind, Aces)
skillzplumber collected $8.93 from pot
*** SUMMARY ***
Total pot $9.40 | Rake $0.47
Board [As Td Qs 5c 2h]
Seat 1: skillzplumber showed [Ks Jd] and won ($8.93) with a straight, Ten to Ace
Seat 2: Gould Rush showed [Ad Ac] and lost with three of a kind, Aces
Seat 3: Smuggler1991 folded before Flop (didn't bet)
Seat 4: Cake_Horn_14 (button) folded before Flop (didn't bet)
Seat 5: DemolishIT (small blind) folded before Flop
Seat 6: PlayTheBlues4U (big blind) folded on the Flop


*********** # 164 **************
PokerStars Hand #204206678634:  Hold'em No Limit ($0.05/$0.10 USD) - 2019/10/03 22:44:42 ET
Table 'Sculptor' 6-max Seat #6 is the button
Seat 2: Mo8791 ($6.64 in chips)
Seat 3: PlayTheBlues4U ($9.70 in chips)
Seat 4: Gould Rush ($21.15 in chips)
Seat 6: Smuggler1991 ($9.20 in chips)
Mo8791: posts small blind $0.05
PlayTheBlues4U: posts big blind $0.10
*** HOLE CARDS ***
Dealt to PlayTheBlues4U [7c Ac]
Gould Rush: folds
Smuggler1991: raises $0.25 to $0.35
Mo8791: folds
PlayTheBlues4U: calls $0.25
*** FLOP *** [6d 2s Qd]
PlayTheBlues4U: checks
Smuggler1991: bets $0.40
PlayTheBlues4U: calls $0.40
*** TURN *** [6d 2s Qd] [Jc]
PlayTheBlues4U: checks
Smuggler1991: bets $1.50
PlayTheBlues4U: folds
Uncalled bet ($1.50) returned to Smuggler1991
Smuggler1991 collected $1.47 from pot
Smuggler1991: doesn't show hand
*** SUMMARY ***
Total pot $1.55 | Rake $0.08
Board [6d 2s Qd Jc]
Seat 2: Mo8791 (small blind) folded before Flop
Seat 3: PlayTheBlues4U (big blind) folded on the Turn
Seat 4: Gould Rush folded before Flop (didn't bet)
Seat 6: Smuggler1991 (button) collected ($1.47)


*********** # 165 **************
PokerStars Hand #204206678557:  Hold'em No Limit ($0.05/$0.10 USD) - 2019/10/03 22:44:17 ET
Table 'Sculptor' 6-max Seat #4 is the button
Seat 2: Mo8791 ($6.54 in chips)
Seat 3: PlayTheBlues4U ($9.70 in chips)
Seat 4: Gould Rush ($21.15 in chips)
Seat 6: Smuggler1991 ($9.30 in chips)
Smuggler1991: posts small blind $0.05
Mo8791: posts big blind $0.10
*** HOLE CARDS ***
Dealt to PlayTheBlues4U [5c Jc]
PlayTheBlues4U: folds
Gould Rush: folds
Smuggler1991: calls $0.05
Mo8791: raises $0.20 to $0.30
Smuggler1991: folds
Uncalled bet ($0.20) returned to Mo8791
Mo8791 collected $0.20 from pot
Mo8791: doesn't show hand
*** SUMMARY ***
Total pot $0.20 | Rake $0
Seat 2: Mo8791 (big blind) collected ($0.20)
Seat 3: PlayTheBlues4U folded before Flop (didn't bet)
Seat 4: Gould Rush (button) folded before Flop (didn't bet)
Seat 6: Smuggler1991 (small blind) folded before Flop


*********** # 166 **************
PokerStars Hand #204206678524:  Hold'em No Limit ($0.02/$0.05 USD) - 2019/10/03 22:44:05 ET
Table 'Phoenix' 6-max Seat #3 is the button
Seat 1: skillzplumber ($3.91 in chips)
Seat 2: Gould Rush ($5 in chips)
Seat 3: Smuggler1991 ($3.32 in chips)
Seat 4: Cake_Horn_14 ($5.31 in chips)
Seat 5: DemolishIT ($6.11 in chips)
Seat 6: PlayTheBlues4U ($5.24 in chips)
Cake_Horn_14: posts small blind $0.02
DemolishIT: posts big blind $0.05
*** HOLE CARDS ***
Dealt to PlayTheBlues4U [Ad Js]
PlayTheBlues4U: raises $0.05 to $0.10
skillzplumber: calls $0.10
Gould Rush: folds
Smuggler1991: calls $0.10
Cake_Horn_14: folds
DemolishIT: folds
*** FLOP *** [9d Kc Jh]
PlayTheBlues4U: bets $0.20
skillzplumber: calls $0.20
Smuggler1991: folds
*** TURN *** [9d Kc Jh] [2d]
PlayTheBlues4U: checks
skillzplumber: bets $0.55
PlayTheBlues4U: folds
Uncalled bet ($0.55) returned to skillzplumber
skillzplumber collected $0.73 from pot
skillzplumber: doesn't show hand
*** SUMMARY ***
Total pot $0.77 | Rake $0.04
Board [9d Kc Jh 2d]
Seat 1: skillzplumber collected ($0.73)
Seat 2: Gould Rush folded before Flop (didn't bet)
Seat 3: Smuggler1991 (button) folded on the Flop
Seat 4: Cake_Horn_14 (small blind) folded before Flop
Seat 5: DemolishIT (big blind) folded before Flop
Seat 6: PlayTheBlues4U folded on the Turn


*********** # 167 **************
PokerStars Hand #204206678400:  Hold'em No Limit ($0.05/$0.10 USD) - 2019/10/03 22:43:20 ET
Table 'Sculptor' 6-max Seat #3 is the button
Seat 2: Mo8791 ($6.54 in chips)
Seat 3: PlayTheBlues4U ($9.40 in chips)
Seat 4: Gould Rush ($20.85 in chips)
Seat 6: Smuggler1991 ($10 in chips)
Gould Rush: posts small blind $0.05
Smuggler1991: posts big blind $0.10
*** HOLE CARDS ***
Dealt to PlayTheBlues4U [Qc 9c]
Mo8791: folds
PlayTheBlues4U: raises $0.20 to $0.30
Gould Rush: calls $0.25
Smuggler1991: calls $0.20
*** FLOP *** [3s Js Jd]
Gould Rush: checks
Smuggler1991: checks
PlayTheBlues4U: checks
*** TURN *** [3s Js Jd] [3h]
Gould Rush: checks
Smuggler1991: checks
PlayTheBlues4U: checks
*** RIVER *** [3s Js Jd 3h] [9d]
Gould Rush: bets $0.40
Smuggler1991: calls $0.40
PlayTheBlues4U: calls $0.40
*** SHOW DOWN ***
Gould Rush: shows [Qd 9h] (two pair, Jacks and Nines)
Smuggler1991: mucks hand
PlayTheBlues4U: shows [Qc 9c] (two pair, Jacks and Nines)
Gould Rush collected $1 from pot
PlayTheBlues4U collected $1 from pot
*** SUMMARY ***
Total pot $2.10 | Rake $0.10
Board [3s Js Jd 3h 9d]
Seat 2: Mo8791 folded before Flop (didn't bet)
Seat 3: PlayTheBlues4U (button) showed [Qc 9c] and won ($1) with two pair, Jacks and Nines
Seat 4: Gould Rush (small blind) showed [Qd 9h] and won ($1) with two pair, Jacks and Nines
Seat 6: Smuggler1991 (big blind) mucked [9s Th]


*********** # 168 **************
PokerStars Hand #204206678386:  Hold'em No Limit ($0.02/$0.05 USD) - 2019/10/03 22:43:15 ET
Table 'Phoenix' 6-max Seat #2 is the button
Seat 1: skillzplumber ($3.91 in chips)
Seat 2: Gould Rush ($3.56 in chips)
Seat 3: Smuggler1991 ($3.82 in chips)
Seat 4: Cake_Horn_14 ($5.36 in chips)
Seat 5: DemolishIT ($6.11 in chips)
Seat 6: PlayTheBlues4U ($4.74 in chips)
Smuggler1991: posts small blind $0.02
Cake_Horn_14: posts big blind $0.05
*** HOLE CARDS ***
Dealt to PlayTheBlues4U [3h 3d]
DemolishIT: folds
PlayTheBlues4U: raises $0.10 to $0.15
skillzplumber: folds
Gould Rush: folds
Smuggler1991: raises $0.35 to $0.50
Cake_Horn_14: folds
PlayTheBlues4U: calls $0.35
*** FLOP *** [4s 9h Qh]
Smuggler1991: checks
PlayTheBlues4U: checks
*** TURN *** [4s 9h Qh] [Jh]
Smuggler1991: checks
PlayTheBlues4U: bets $0.50
Smuggler1991: folds
Uncalled bet ($0.50) returned to PlayTheBlues4U
PlayTheBlues4U collected $1 from pot
PlayTheBlues4U: doesn't show hand
*** SUMMARY ***
Total pot $1.05 | Rake $0.05
Board [4s 9h Qh Jh]
Seat 1: skillzplumber folded before Flop (didn't bet)
Seat 2: Gould Rush (button) folded before Flop (didn't bet)
Seat 3: Smuggler1991 (small blind) folded on the Turn
Seat 4: Cake_Horn_14 (big blind) folded before Flop
Seat 5: DemolishIT folded before Flop (didn't bet)
Seat 6: PlayTheBlues4U collected ($1)


*********** # 169 **************
PokerStars Hand #204206678359:  Hold'em No Limit ($0.05/$0.10 USD) - 2019/10/03 22:43:06 ET
Table 'Sculptor' 6-max Seat #2 is the button
Seat 2: Mo8791 ($6.54 in chips)
Seat 3: PlayTheBlues4U ($9.30 in chips)
Seat 4: Gould Rush ($20.95 in chips)
PlayTheBlues4U: posts small blind $0.05
Gould Rush: posts big blind $0.10
*** HOLE CARDS ***
Dealt to PlayTheBlues4U [Js Td]
Mo8791: folds
PlayTheBlues4U: raises $0.20 to $0.30
Gould Rush: folds
Uncalled bet ($0.20) returned to PlayTheBlues4U
PlayTheBlues4U collected $0.20 from pot
PlayTheBlues4U: doesn't show hand
*** SUMMARY ***
Total pot $0.20 | Rake $0
Seat 2: Mo8791 (button) folded before Flop (didn't bet)
Seat 3: PlayTheBlues4U (small blind) collected ($0.20)
Seat 4: Gould Rush (big blind) folded before Flop


*********** # 170 **************
PokerStars Hand #204206678334:  Hold'em No Limit ($0.05/$0.10 USD) - 2019/10/03 22:43:00 ET
Table 'Sculptor' 6-max Seat #4 is the button
Seat 2: Mo8791 ($6.59 in chips)
Seat 3: PlayTheBlues4U ($9.25 in chips)
Seat 4: Gould Rush ($20.95 in chips)
Mo8791: posts small blind $0.05
PlayTheBlues4U: posts big blind $0.10
*** HOLE CARDS ***
Dealt to PlayTheBlues4U [Td Qd]
Gould Rush: folds
Mo8791: folds
Uncalled bet ($0.05) returned to PlayTheBlues4U
PlayTheBlues4U collected $0.10 from pot
PlayTheBlues4U: doesn't show hand
*** SUMMARY ***
Total pot $0.10 | Rake $0
Seat 2: Mo8791 (small blind) folded before Flop
Seat 3: PlayTheBlues4U (big blind) collected ($0.10)
Seat 4: Gould Rush (button) folded before Flop (didn't bet)


*********** # 171 **************
PokerStars Hand #204206678217:  Hold'em No Limit ($0.02/$0.05 USD) - 2019/10/03 22:42:17 ET
Table 'Phoenix' 6-max Seat #1 is the button
Seat 1: skillzplumber ($3.91 in chips)
Seat 2: Gould Rush ($5.46 in chips)
Seat 3: Smuggler1991 ($3.87 in chips)
Seat 4: Cake_Horn_14 ($5.48 in chips)
Seat 5: DemolishIT ($4.12 in chips)
Seat 6: PlayTheBlues4U ($4.86 in chips)
Gould Rush: posts small blind $0.02
Smuggler1991: posts big blind $0.05
*** HOLE CARDS ***
Dealt to PlayTheBlues4U [5h 5d]
Cake_Horn_14: raises $0.07 to $0.12
DemolishIT: calls $0.12
PlayTheBlues4U: calls $0.12
skillzplumber: folds
Gould Rush: raises $0.78 to $0.90
Smuggler1991: folds
Cake_Horn_14: folds
DemolishIT: calls $0.78
PlayTheBlues4U: folds
*** FLOP *** [Qh 8d Jd]
Gould Rush: bets $1
DemolishIT: calls $1
*** TURN *** [Qh 8d Jd] [5s]
Gould Rush: checks
DemolishIT: bets $1.90
Gould Rush: folds
Uncalled bet ($1.90) returned to DemolishIT
DemolishIT collected $3.89 from pot
DemolishIT: doesn't show hand
*** SUMMARY ***
Total pot $4.09 | Rake $0.20
Board [Qh 8d Jd 5s]
Seat 1: skillzplumber (button) folded before Flop (didn't bet)
Seat 2: Gould Rush (small blind) folded on the Turn
Seat 3: Smuggler1991 (big blind) folded before Flop
Seat 4: Cake_Horn_14 folded before Flop
Seat 5: DemolishIT collected ($3.89)
Seat 6: PlayTheBlues4U folded before Flop


*********** # 172 **************
PokerStars Hand #204206678203:  Hold'em No Limit ($0.05/$0.10 USD) - 2019/10/03 22:42:12 ET
Table 'Sculptor' 6-max Seat #3 is the button
Seat 2: Mo8791 ($6.59 in chips)
Seat 3: PlayTheBlues4U ($9.25 in chips)
Seat 4: Gould Rush ($13.98 in chips)
Seat 6: Smuggler1991 ($7.75 in chips)
Gould Rush: posts small blind $0.05
Smuggler1991: posts big blind $0.10
*** HOLE CARDS ***
Dealt to PlayTheBlues4U [8c 2s]
Mo8791: folds
PlayTheBlues4U: folds
Gould Rush: raises $0.20 to $0.30
Smuggler1991: raises $0.60 to $0.90
Gould Rush: calls $0.60
*** FLOP *** [Qs 5s 6d]
Gould Rush: checks
Smuggler1991: bets $0.90
Gould Rush: calls $0.90
*** TURN *** [Qs 5s 6d] [4d]
Gould Rush: checks
Smuggler1991: bets $1.70
Gould Rush: calls $1.70
*** RIVER *** [Qs 5s 6d 4d] [8s]
Gould Rush: bets $10.48 and is all-in
Smuggler1991: calls $4.25 and is all-in
Uncalled bet ($6.23) returned to Gould Rush
*** SHOW DOWN ***
Gould Rush: shows [Ks 4s] (a flush, King high)
Smuggler1991: shows [9h 9d] (a pair of Nines)
Gould Rush collected $14.72 from pot
*** SUMMARY ***
Total pot $15.50 | Rake $0.78
Board [Qs 5s 6d 4d 8s]
Seat 2: Mo8791 folded before Flop (didn't bet)
Seat 3: PlayTheBlues4U (button) folded before Flop (didn't bet)
Seat 4: Gould Rush (small blind) showed [Ks 4s] and won ($14.72) with a flush, King high
Seat 6: Smuggler1991 (big blind) showed [9h 9d] and lost with a pair of Nines


*********** # 173 **************
PokerStars Hand #204206678088:  Hold'em No Limit ($0.05/$0.10 USD) - 2019/10/03 22:41:35 ET
Table 'Sculptor' 6-max Seat #2 is the button
Seat 2: Mo8791 ($6.59 in chips)
Seat 3: PlayTheBlues4U ($9.30 in chips)
Seat 4: Gould Rush ($13.62 in chips)
Seat 6: Smuggler1991 ($8.10 in chips)
PlayTheBlues4U: posts small blind $0.05
Gould Rush: posts big blind $0.10
*** HOLE CARDS ***
Dealt to PlayTheBlues4U [5h 7s]
Smuggler1991: raises $0.25 to $0.35
Mo8791: folds
PlayTheBlues4U: folds
Gould Rush: calls $0.25
*** FLOP *** [2c 7h Kh]
Gould Rush: checks
Smuggler1991: checks
*** TURN *** [2c 7h Kh] [8c]
Gould Rush: checks
Smuggler1991: checks
*** RIVER *** [2c 7h Kh 8c] [Th]
Gould Rush: checks
Smuggler1991: checks
*** SHOW DOWN ***
Gould Rush: shows [Tc 9s] (a pair of Tens)
Smuggler1991: mucks hand
Gould Rush collected $0.71 from pot
*** SUMMARY ***
Total pot $0.75 | Rake $0.04
Board [2c 7h Kh 8c Th]
Seat 2: Mo8791 (button) folded before Flop (didn't bet)
Seat 3: PlayTheBlues4U (small blind) folded before Flop
Seat 4: Gould Rush (big blind) showed [Tc 9s] and won ($0.71) with a pair of Tens
Seat 6: Smuggler1991 mucked [6c Ah]


*********** # 174 **************
PokerStars Hand #204206678055:  Hold'em No Limit ($0.02/$0.05 USD) - 2019/10/03 22:41:23 ET
Table 'Phoenix' 6-max Seat #6 is the button
Seat 1: skillzplumber ($4.06 in chips)
Seat 2: Gould Rush ($5 in chips)
Seat 3: Smuggler1991 ($3.87 in chips)
Seat 4: Cake_Horn_14 ($5.48 in chips)
Seat 5: DemolishIT ($4.12 in chips)
Seat 6: PlayTheBlues4U ($5.21 in chips)
skillzplumber: posts small blind $0.02
Gould Rush: posts big blind $0.05
*** HOLE CARDS ***
Dealt to PlayTheBlues4U [Kd 2d]
Gould Rush said, "lol"
Smuggler1991: folds
Cake_Horn_14: folds
DemolishIT: folds
PlayTheBlues4U: raises $0.10 to $0.15
skillzplumber: calls $0.13
Gould Rush: calls $0.10
*** FLOP *** [Kh As Qc]
skillzplumber: checks
Gould Rush: checks
PlayTheBlues4U: bets $0.20
skillzplumber: folds
Gould Rush: calls $0.20
*** TURN *** [Kh As Qc] [Qs]
Gould Rush: checks
PlayTheBlues4U: checks
*** RIVER *** [Kh As Qc Qs] [4h]
Gould Rush: bets $0.80
PlayTheBlues4U: folds
Uncalled bet ($0.80) returned to Gould Rush
Gould Rush collected $0.81 from pot
Gould Rush: doesn't show hand
*** SUMMARY ***
Total pot $0.85 | Rake $0.04
Board [Kh As Qc Qs 4h]
Seat 1: skillzplumber (small blind) folded on the Flop
Seat 2: Gould Rush (big blind) collected ($0.81)
Seat 3: Smuggler1991 folded before Flop (didn't bet)
Seat 4: Cake_Horn_14 folded before Flop (didn't bet)
Seat 5: DemolishIT folded before Flop (didn't bet)
Seat 6: PlayTheBlues4U (button) folded on the River


*********** # 175 **************
PokerStars Hand #204206678049:  Hold'em No Limit ($0.05/$0.10 USD) - 2019/10/03 22:41:19 ET
Table 'Sculptor' 6-max Seat #6 is the button
Seat 2: Mo8791 ($6.64 in chips)
Seat 3: PlayTheBlues4U ($9.40 in chips)
Seat 4: Gould Rush ($13.47 in chips)
Seat 6: Smuggler1991 ($8.10 in chips)
Mo8791: posts small blind $0.05
PlayTheBlues4U: posts big blind $0.10
*** HOLE CARDS ***
Dealt to PlayTheBlues4U [2d Qc]
Gould Rush: raises $0.20 to $0.30
Smuggler1991: folds
Mo8791: folds
PlayTheBlues4U: folds
Uncalled bet ($0.20) returned to Gould Rush
Gould Rush collected $0.25 from pot
Gould Rush: doesn't show hand
*** SUMMARY ***
Total pot $0.25 | Rake $0
Seat 2: Mo8791 (small blind) folded before Flop
Seat 3: PlayTheBlues4U (big blind) folded before Flop
Seat 4: Gould Rush collected ($0.25)
Seat 6: Smuggler1991 (button) folded before Flop (didn't bet)


*********** # 176 **************
PokerStars Hand #204206677930:  Hold'em No Limit ($0.02/$0.05 USD) - 2019/10/03 22:40:38 ET
Table 'Phoenix' 6-max Seat #5 is the button
Seat 1: skillzplumber ($4.11 in chips)
Seat 2: Gould Rush ($5.35 in chips)
Seat 3: Smuggler1991 ($3.49 in chips)
Seat 4: Cake_Horn_14 ($5.48 in chips)
Seat 5: DemolishIT ($4.12 in chips)
Seat 6: PlayTheBlues4U ($5.23 in chips)
PlayTheBlues4U: posts small blind $0.02
skillzplumber: posts big blind $0.05
*** HOLE CARDS ***
Dealt to PlayTheBlues4U [9s Ad]
Gould Rush: raises $0.10 to $0.15
Smuggler1991: calls $0.15
Cake_Horn_14: folds
DemolishIT: folds
PlayTheBlues4U: folds
skillzplumber: folds
*** FLOP *** [Qd 6s 6d]
Gould Rush: checks
Smuggler1991: checks
*** TURN *** [Qd 6s 6d] [8s]
Gould Rush: checks
Smuggler1991: bets $0.20
Gould Rush: calls $0.20
*** RIVER *** [Qd 6s 6d 8s] [8c]
Gould Rush: checks
Smuggler1991: checks
*** SHOW DOWN ***
Gould Rush: shows [4h 4s] (two pair, Eights and Sixes)
Smuggler1991: shows [As 4d] (two pair, Eights and Sixes - Ace kicker)
Smuggler1991 collected $0.73 from pot
*** SUMMARY ***
Total pot $0.77 | Rake $0.04
Board [Qd 6s 6d 8s 8c]
Seat 1: skillzplumber (big blind) folded before Flop
Seat 2: Gould Rush showed [4h 4s] and lost with two pair, Eights and Sixes
Seat 3: Smuggler1991 showed [As 4d] and won ($0.73) with two pair, Eights and Sixes
Seat 4: Cake_Horn_14 folded before Flop (didn't bet)
Seat 5: DemolishIT (button) folded before Flop (didn't bet)
Seat 6: PlayTheBlues4U (small blind) folded before Flop


*********** # 177 **************
PokerStars Hand #204206677902:  Hold'em No Limit ($0.05/$0.10 USD) - 2019/10/03 22:40:25 ET
Table 'Sculptor' 6-max Seat #4 is the button
Seat 2: Mo8791 ($6.05 in chips)
Seat 3: PlayTheBlues4U ($10 in chips)
Seat 4: Gould Rush ($13.47 in chips)
Seat 6: Smuggler1991 ($8.15 in chips)
Smuggler1991: posts small blind $0.05
Mo8791: posts big blind $0.10
*** HOLE CARDS ***
Dealt to PlayTheBlues4U [Js Qc]
PlayTheBlues4U: raises $0.20 to $0.30
Gould Rush: folds
Smuggler1991: folds
Mo8791: calls $0.20
*** FLOP *** [6c 6d 4h]
Mo8791: checks
PlayTheBlues4U: checks
*** TURN *** [6c 6d 4h] [Ad]
Mo8791: checks
PlayTheBlues4U: bets $0.30
Mo8791: calls $0.30
*** RIVER *** [6c 6d 4h Ad] [4s]
Mo8791: checks
PlayTheBlues4U: checks
*** SHOW DOWN ***
Mo8791: shows [8s Ac] (two pair, Aces and Sixes)
PlayTheBlues4U: mucks hand
Mo8791 collected $1.19 from pot
*** SUMMARY ***
Total pot $1.25 | Rake $0.06
Board [6c 6d 4h Ad 4s]
Seat 2: Mo8791 (big blind) showed [8s Ac] and won ($1.19) with two pair, Aces and Sixes
Seat 3: PlayTheBlues4U mucked [Js Qc]
Seat 4: Gould Rush (button) folded before Flop (didn't bet)
Seat 6: Smuggler1991 (small blind) folded before Flop


*********** # 178 **************
PokerStars Hand #204206677842:  Hold'em No Limit ($0.02/$0.05 USD) - 2019/10/03 22:40:05 ET
Table 'Phoenix' 6-max Seat #4 is the button
Seat 1: skillzplumber ($4.04 in chips)
Seat 2: Gould Rush ($5.35 in chips)
Seat 3: Smuggler1991 ($3.49 in chips)
Seat 4: Cake_Horn_14 ($5.48 in chips)
Seat 5: DemolishIT ($4.14 in chips)
Seat 6: PlayTheBlues4U ($5.28 in chips)
DemolishIT: posts small blind $0.02
PlayTheBlues4U: posts big blind $0.05
*** HOLE CARDS ***
Dealt to PlayTheBlues4U [Kh 9c]
skillzplumber: raises $0.15 to $0.20
Gould Rush: folds
Smuggler1991: folds
Cake_Horn_14: folds
DemolishIT: folds
PlayTheBlues4U: folds
Uncalled bet ($0.15) returned to skillzplumber
skillzplumber collected $0.12 from pot
skillzplumber: doesn't show hand
*** SUMMARY ***
Total pot $0.12 | Rake $0
Seat 1: skillzplumber collected ($0.12)
Seat 2: Gould Rush folded before Flop (didn't bet)
Seat 3: Smuggler1991 folded before Flop (didn't bet)
Seat 4: Cake_Horn_14 (button) folded before Flop (didn't bet)
Seat 5: DemolishIT (small blind) folded before Flop
Seat 6: PlayTheBlues4U (big blind) folded before Flop


*********** # 179 **************
PokerStars Hand #204206677796:  Hold'em No Limit ($0.02/$0.05 USD) - 2019/10/03 22:39:50 ET
Table 'Phoenix' 6-max Seat #3 is the button
Seat 1: skillzplumber ($4.04 in chips)
Seat 2: Gould Rush ($5.28 in chips)
Seat 3: Smuggler1991 ($3.49 in chips)
Seat 4: Cake_Horn_14 ($5.50 in chips)
Seat 5: DemolishIT ($4.19 in chips)
Seat 6: PlayTheBlues4U ($5.28 in chips)
Cake_Horn_14: posts small blind $0.02
DemolishIT: posts big blind $0.05
*** HOLE CARDS ***
Dealt to PlayTheBlues4U [Js 5h]
PlayTheBlues4U: folds
skillzplumber: folds
Gould Rush: raises $0.10 to $0.15
Smuggler1991: folds
Cake_Horn_14: folds
DemolishIT: folds
Uncalled bet ($0.10) returned to Gould Rush
Gould Rush collected $0.12 from pot
Gould Rush: doesn't show hand
*** SUMMARY ***
Total pot $0.12 | Rake $0
Seat 1: skillzplumber folded before Flop (didn't bet)
Seat 2: Gould Rush collected ($0.12)
Seat 3: Smuggler1991 (button) folded before Flop (didn't bet)
Seat 4: Cake_Horn_14 (small blind) folded before Flop
Seat 5: DemolishIT (big blind) folded before Flop
Seat 6: PlayTheBlues4U folded before Flop (didn't bet)


*********** # 180 **************
PokerStars Hand #204206677732:  Hold'em No Limit ($0.05/$0.10 USD) - 2019/10/03 22:39:27 ET
Table 'Sculptor' 6-max Seat #3 is the button
Seat 2: Mo8791 ($6.05 in chips)
Seat 3: PlayTheBlues4U ($7.46 in chips)
Seat 4: Gould Rush ($15.07 in chips)
Seat 6: Smuggler1991 ($8.25 in chips)
Gould Rush: posts small blind $0.05
Smuggler1991: posts big blind $0.10
*** HOLE CARDS ***
Dealt to PlayTheBlues4U [Ad Jc]
Mo8791: folds
PlayTheBlues4U: raises $0.20 to $0.30
Gould Rush: calls $0.25
Smuggler1991: folds
*** FLOP *** [4h Js 9c]
Gould Rush: checks
PlayTheBlues4U: bets $0.40
Gould Rush: calls $0.40
*** TURN *** [4h Js 9c] [3d]
Gould Rush: checks
PlayTheBlues4U: checks
*** RIVER *** [4h Js 9c 3d] [Ts]
Gould Rush: checks
PlayTheBlues4U: bets $0.90
Gould Rush: calls $0.90
*** SHOW DOWN ***
PlayTheBlues4U: shows [Ad Jc] (a pair of Jacks)
Gould Rush: mucks hand
PlayTheBlues4U collected $3.14 from pot
*** SUMMARY ***
Total pot $3.30 | Rake $0.16
Board [4h Js 9c 3d Ts]
Seat 2: Mo8791 folded before Flop (didn't bet)
Seat 3: PlayTheBlues4U (button) showed [Ad Jc] and won ($3.14) with a pair of Jacks
Seat 4: Gould Rush (small blind) mucked [7s 7c]
Seat 6: Smuggler1991 (big blind) folded before Flop


*********** # 181 **************
PokerStars Hand #204206677677:  Hold'em No Limit ($0.02/$0.05 USD) - 2019/10/03 22:39:08 ET
Table 'Phoenix' 6-max Seat #2 is the button
Seat 1: skillzplumber ($4.04 in chips)
Seat 2: Gould Rush ($5.13 in chips)
Seat 3: Smuggler1991 ($3.51 in chips)
Seat 4: Cake_Horn_14 ($5.65 in chips)
Seat 5: DemolishIT ($4.19 in chips)
Seat 6: PlayTheBlues4U ($5.28 in chips)
Smuggler1991: posts small blind $0.02
Cake_Horn_14: posts big blind $0.05
*** HOLE CARDS ***
Dealt to PlayTheBlues4U [Jh 9s]
DemolishIT: folds
PlayTheBlues4U: folds
skillzplumber: folds
Gould Rush: raises $0.10 to $0.15
Smuggler1991: folds
Cake_Horn_14: calls $0.10
*** FLOP *** [7s 6s 2d]
Cake_Horn_14: checks
Gould Rush: bets $0.30
Cake_Horn_14: folds
Uncalled bet ($0.30) returned to Gould Rush
Gould Rush collected $0.30 from pot
Gould Rush: doesn't show hand
*** SUMMARY ***
Total pot $0.32 | Rake $0.02
Board [7s 6s 2d]
Seat 1: skillzplumber folded before Flop (didn't bet)
Seat 2: Gould Rush (button) collected ($0.30)
Seat 3: Smuggler1991 (small blind) folded before Flop
Seat 4: Cake_Horn_14 (big blind) folded on the Flop
Seat 5: DemolishIT folded before Flop (didn't bet)
Seat 6: PlayTheBlues4U folded before Flop (didn't bet)


*********** # 182 **************
PokerStars Hand #204206677582:  Hold'em No Limit ($0.05/$0.10 USD) - 2019/10/03 22:38:35 ET
Table 'Sculptor' 6-max Seat #2 is the button
Seat 2: Mo8791 ($7.90 in chips)
Seat 3: PlayTheBlues4U ($7.81 in chips)
Seat 4: Gould Rush ($15.17 in chips)
Seat 6: Smuggler1991 ($6.16 in chips)
PlayTheBlues4U: posts small blind $0.05
Gould Rush: posts big blind $0.10
*** HOLE CARDS ***
Dealt to PlayTheBlues4U [Ad 7h]
Smuggler1991: raises $0.25 to $0.35
Mo8791: calls $0.35
PlayTheBlues4U: calls $0.30
Gould Rush: folds
*** FLOP *** [3h 6c Ks]
PlayTheBlues4U: checks
Smuggler1991: bets $0.50
Mo8791: calls $0.50
PlayTheBlues4U: folds
*** TURN *** [3h 6c Ks] [8h]
Smuggler1991: checks
Mo8791: checks
*** RIVER *** [3h 6c Ks 8h] [3d]
Smuggler1991: bets $1
Mo8791: calls $1
*** SHOW DOWN ***
Smuggler1991: shows [3c As] (three of a kind, Threes)
Mo8791: mucks hand
Smuggler1991 collected $3.94 from pot
*** SUMMARY ***
Total pot $4.15 | Rake $0.21
Board [3h 6c Ks 8h 3d]
Seat 2: Mo8791 (button) mucked [Js Kd]
Seat 3: PlayTheBlues4U (small blind) folded on the Flop
Seat 4: Gould Rush (big blind) folded before Flop
Seat 6: Smuggler1991 showed [3c As] and won ($3.94) with three of a kind, Threes


*********** # 183 **************
PokerStars Hand #204206677560:  Hold'em No Limit ($0.02/$0.05 USD) - 2019/10/03 22:38:29 ET
Table 'Phoenix' 6-max Seat #1 is the button
Seat 1: skillzplumber ($4.04 in chips)
Seat 2: Gould Rush ($5.40 in chips)
Seat 3: Smuggler1991 ($3.15 in chips)
Seat 4: Cake_Horn_14 ($5.77 in chips)
Seat 5: DemolishIT ($4.19 in chips)
Seat 6: PlayTheBlues4U ($5.28 in chips)
Gould Rush: posts small blind $0.02
Smuggler1991: posts big blind $0.05
*** HOLE CARDS ***
Dealt to PlayTheBlues4U [Tc 6c]
Cake_Horn_14: raises $0.07 to $0.12
DemolishIT: folds
PlayTheBlues4U: folds
skillzplumber: folds
Gould Rush: calls $0.10
Smuggler1991: calls $0.07
*** FLOP *** [2s Jd Ac]
Gould Rush: checks
Smuggler1991: bets $0.15
Cake_Horn_14: folds
Gould Rush: calls $0.15
*** TURN *** [2s Jd Ac] [4c]
Gould Rush: checks
Smuggler1991: bets $0.30
Gould Rush: folds
Uncalled bet ($0.30) returned to Smuggler1991
Smuggler1991 collected $0.63 from pot
Smuggler1991: doesn't show hand
*** SUMMARY ***
Total pot $0.66 | Rake $0.03
Board [2s Jd Ac 4c]
Seat 1: skillzplumber (button) folded before Flop (didn't bet)
Seat 2: Gould Rush (small blind) folded on the Turn
Seat 3: Smuggler1991 (big blind) collected ($0.63)
Seat 4: Cake_Horn_14 folded on the Flop
Seat 5: DemolishIT folded before Flop (didn't bet)
Seat 6: PlayTheBlues4U folded before Flop (didn't bet)


*********** # 184 **************
PokerStars Hand #204206677548:  Hold'em No Limit ($0.05/$0.10 USD) - 2019/10/03 22:38:26 ET
Table 'Sculptor' 6-max Seat #6 is the button
Seat 2: Mo8791 ($7.95 in chips)
Seat 3: PlayTheBlues4U ($7.76 in chips)
Seat 4: Gould Rush ($15.17 in chips)
Seat 6: Smuggler1991 ($6.16 in chips)
Mo8791: posts small blind $0.05
PlayTheBlues4U: posts big blind $0.10
*** HOLE CARDS ***
Dealt to PlayTheBlues4U [4d 4s]
Gould Rush: folds
Smuggler1991: folds
Mo8791: folds
Uncalled bet ($0.05) returned to PlayTheBlues4U
PlayTheBlues4U collected $0.10 from pot
PlayTheBlues4U: doesn't show hand
*** SUMMARY ***
Total pot $0.10 | Rake $0
Seat 2: Mo8791 (small blind) folded before Flop
Seat 3: PlayTheBlues4U (big blind) collected ($0.10)
Seat 4: Gould Rush folded before Flop (didn't bet)
Seat 6: Smuggler1991 (button) folded before Flop (didn't bet)


*********** # 185 **************
PokerStars Hand #204206677524:  Hold'em No Limit ($0.05/$0.10 USD) - 2019/10/03 22:38:17 ET
Table 'Sculptor' 6-max Seat #4 is the button
Seat 2: Mo8791 ($7.90 in chips)
Seat 3: PlayTheBlues4U ($7.76 in chips)
Seat 4: Gould Rush ($15.17 in chips)
Seat 6: Smuggler1991 ($6.21 in chips)
Smuggler1991: posts small blind $0.05
Mo8791: posts big blind $0.10
*** HOLE CARDS ***
Dealt to PlayTheBlues4U [Kd 7c]
PlayTheBlues4U: folds
Gould Rush: folds
Smuggler1991: folds
Uncalled bet ($0.05) returned to Mo8791
Mo8791 collected $0.10 from pot
Mo8791: doesn't show hand
*** SUMMARY ***
Total pot $0.10 | Rake $0
Seat 2: Mo8791 (big blind) collected ($0.10)
Seat 3: PlayTheBlues4U folded before Flop (didn't bet)
Seat 4: Gould Rush (button) folded before Flop (didn't bet)
Seat 6: Smuggler1991 (small blind) folded before Flop


*********** # 186 **************
PokerStars Hand #204206677481:  Hold'em No Limit ($0.02/$0.05 USD) - 2019/10/03 22:38:00 ET
Table 'Phoenix' 6-max Seat #6 is the button
Seat 1: skillzplumber ($4.06 in chips)
Seat 2: Gould Rush ($5.55 in chips)
Seat 3: Smuggler1991 ($3.15 in chips)
Seat 4: Cake_Horn_14 ($5.77 in chips)
Seat 5: DemolishIT ($4.19 in chips)
Seat 6: PlayTheBlues4U ($5.13 in chips)
skillzplumber: posts small blind $0.02
Gould Rush: posts big blind $0.05
*** HOLE CARDS ***
Dealt to PlayTheBlues4U [4d 8c]
Smuggler1991: folds
Cake_Horn_14: folds
DemolishIT: folds
PlayTheBlues4U: raises $0.10 to $0.15
skillzplumber: folds
Gould Rush: calls $0.10
*** FLOP *** [6s Ks Td]
Gould Rush: checks
PlayTheBlues4U: bets $0.15
Gould Rush: folds
Uncalled bet ($0.15) returned to PlayTheBlues4U
PlayTheBlues4U collected $0.30 from pot
PlayTheBlues4U: doesn't show hand
*** SUMMARY ***
Total pot $0.32 | Rake $0.02
Board [6s Ks Td]
Seat 1: skillzplumber (small blind) folded before Flop
Seat 2: Gould Rush (big blind) folded on the Flop
Seat 3: Smuggler1991 folded before Flop (didn't bet)
Seat 4: Cake_Horn_14 folded before Flop (didn't bet)
Seat 5: DemolishIT folded before Flop (didn't bet)
Seat 6: PlayTheBlues4U (button) collected ($0.30)


*********** # 187 **************
PokerStars Hand #204206677479:  Hold'em No Limit ($0.05/$0.10 USD) - 2019/10/03 22:38:00 ET
Table 'Sculptor' 6-max Seat #3 is the button
Seat 2: Mo8791 ($8 in chips)
Seat 3: PlayTheBlues4U ($7.76 in chips)
Seat 4: Gould Rush ($14.97 in chips)
Seat 6: Smuggler1991 ($6.31 in chips)
Gould Rush: posts small blind $0.05
Smuggler1991: posts big blind $0.10
Mo8791: posts big blind $0.10
*** HOLE CARDS ***
Dealt to PlayTheBlues4U [9h 4h]
Mo8791: checks
PlayTheBlues4U: folds
Gould Rush: raises $0.40 to $0.50
Smuggler1991: folds
Mo8791: folds
Uncalled bet ($0.40) returned to Gould Rush
Gould Rush collected $0.30 from pot
Gould Rush: doesn't show hand
*** SUMMARY ***
Total pot $0.30 | Rake $0
Seat 2: Mo8791 folded before Flop (didn't bet)
Seat 3: PlayTheBlues4U (button) folded before Flop (didn't bet)
Seat 4: Gould Rush (small blind) collected ($0.30)
Seat 6: Smuggler1991 (big blind) folded before Flop


*********** # 188 **************
PokerStars Hand #204206677437:  Hold'em No Limit ($0.02/$0.05 USD) - 2019/10/03 22:37:46 ET
Table 'Phoenix' 6-max Seat #5 is the button
Seat 1: skillzplumber ($4.11 in chips)
Seat 2: Gould Rush ($5.55 in chips)
Seat 3: Smuggler1991 ($3.08 in chips)
Seat 4: Cake_Horn_14 ($5.77 in chips)
Seat 5: DemolishIT ($4.19 in chips)
Seat 6: PlayTheBlues4U ($5.15 in chips)
PlayTheBlues4U: posts small blind $0.02
skillzplumber: posts big blind $0.05
*** HOLE CARDS ***
Dealt to PlayTheBlues4U [4c Th]
Gould Rush: folds
Smuggler1991: raises $0.12 to $0.17
Cake_Horn_14: folds
DemolishIT: folds
PlayTheBlues4U: folds
skillzplumber: folds
Uncalled bet ($0.12) returned to Smuggler1991
Smuggler1991 collected $0.12 from pot
Smuggler1991: doesn't show hand
*** SUMMARY ***
Total pot $0.12 | Rake $0
Seat 1: skillzplumber (big blind) folded before Flop
Seat 2: Gould Rush folded before Flop (didn't bet)
Seat 3: Smuggler1991 collected ($0.12)
Seat 4: Cake_Horn_14 folded before Flop (didn't bet)
Seat 5: DemolishIT (button) folded before Flop (didn't bet)
Seat 6: PlayTheBlues4U (small blind) folded before Flop


*********** # 189 **************
PokerStars Hand #204206677304:  Hold'em No Limit ($0.05/$0.10 USD) - 2019/10/03 22:37:00 ET
Table 'Sculptor' 6-max Seat #6 is the button
Seat 3: PlayTheBlues4U ($7.22 in chips)
Seat 4: Gould Rush ($15.57 in chips)
Seat 6: Smuggler1991 ($6.31 in chips)
PlayTheBlues4U: posts small blind $0.05
Gould Rush: posts big blind $0.10
*** HOLE CARDS ***
Dealt to PlayTheBlues4U [8c Th]
Smuggler1991: folds
PlayTheBlues4U: calls $0.05
Gould Rush: raises $0.20 to $0.30
Mo8791 joins the table at seat #2
PlayTheBlues4U: calls $0.20
*** FLOP *** [Qc 9h Kd]
PlayTheBlues4U: checks
Gould Rush: bets $0.30
PlayTheBlues4U: calls $0.30
*** TURN *** [Qc 9h Kd] [2s]
PlayTheBlues4U: checks
Gould Rush: checks
*** RIVER *** [Qc 9h Kd 2s] [Jh]
PlayTheBlues4U: bets $1.10
Gould Rush: folds
Uncalled bet ($1.10) returned to PlayTheBlues4U
PlayTheBlues4U collected $1.14 from pot
PlayTheBlues4U: doesn't show hand
*** SUMMARY ***
Total pot $1.20 | Rake $0.06
Board [Qc 9h Kd 2s Jh]
Seat 3: PlayTheBlues4U (small blind) collected ($1.14)
Seat 4: Gould Rush (big blind) folded on the River
Seat 6: Smuggler1991 (button) folded before Flop (didn't bet)


*********** # 190 **************
PokerStars Hand #204206677303:  Hold'em No Limit ($0.02/$0.05 USD) - 2019/10/03 22:37:00 ET
Table 'Phoenix' 6-max Seat #4 is the button
Seat 1: skillzplumber ($4.11 in chips)
Seat 2: Gould Rush ($5.55 in chips)
Seat 3: Smuggler1991 ($3.08 in chips)
Seat 4: Cake_Horn_14 ($5.61 in chips)
Seat 5: DemolishIT ($4.31 in chips)
Seat 6: PlayTheBlues4U ($5.20 in chips)
DemolishIT: posts small blind $0.02
PlayTheBlues4U: posts big blind $0.05
*** HOLE CARDS ***
Dealt to PlayTheBlues4U [4d 8c]
skillzplumber: folds
Gould Rush: folds
Smuggler1991: folds
Cake_Horn_14: raises $0.07 to $0.12
DemolishIT: calls $0.10
PlayTheBlues4U: folds
*** FLOP *** [3s 7d Js]
DemolishIT: checks
Cake_Horn_14: checks
*** TURN *** [3s 7d Js] [Kd]
DemolishIT: checks
Cake_Horn_14: bets $0.19
DemolishIT: folds
Uncalled bet ($0.19) returned to Cake_Horn_14
Cake_Horn_14 collected $0.28 from pot
Cake_Horn_14: doesn't show hand
*** SUMMARY ***
Total pot $0.29 | Rake $0.01
Board [3s 7d Js Kd]
Seat 1: skillzplumber folded before Flop (didn't bet)
Seat 2: Gould Rush folded before Flop (didn't bet)
Seat 3: Smuggler1991 folded before Flop (didn't bet)
Seat 4: Cake_Horn_14 (button) collected ($0.28)
Seat 5: DemolishIT (small blind) folded on the Turn
Seat 6: PlayTheBlues4U (big blind) folded before Flop


*********** # 191 **************
PokerStars Hand #204206677277:  Hold'em No Limit ($0.05/$0.10 USD) - 2019/10/03 22:36:50 ET
Table 'Sculptor' 6-max Seat #4 is the button
Seat 3: PlayTheBlues4U ($7.17 in chips)
Seat 4: Gould Rush ($15.57 in chips)
Seat 6: Smuggler1991 ($6.36 in chips)
Smuggler1991: posts small blind $0.05
PlayTheBlues4U: posts big blind $0.10
*** HOLE CARDS ***
Dealt to PlayTheBlues4U [2s 4d]
Gould Rush: folds
Smuggler1991: folds
Uncalled bet ($0.05) returned to PlayTheBlues4U
PlayTheBlues4U collected $0.10 from pot
PlayTheBlues4U: doesn't show hand
*** SUMMARY ***
Total pot $0.10 | Rake $0
Seat 3: PlayTheBlues4U (big blind) collected ($0.10)
Seat 4: Gould Rush (button) folded before Flop (didn't bet)
Seat 6: Smuggler1991 (small blind) folded before Flop


*********** # 192 **************
PokerStars Hand #204206677115:  Hold'em No Limit ($0.02/$0.05 USD) - 2019/10/03 22:35:54 ET
Table 'Phoenix' 6-max Seat #3 is the button
Seat 1: skillzplumber ($4.71 in chips)
Seat 2: Gould Rush ($4.94 in chips)
Seat 3: Smuggler1991 ($3.08 in chips)
Seat 4: Cake_Horn_14 ($5.63 in chips)
Seat 5: DemolishIT ($4.36 in chips)
Seat 6: PlayTheBlues4U ($5.20 in chips)
Cake_Horn_14: posts small blind $0.02
DemolishIT: posts big blind $0.05
*** HOLE CARDS ***
Dealt to PlayTheBlues4U [4h Jc]
PlayTheBlues4U: folds
skillzplumber: raises $0.15 to $0.20
Gould Rush: raises $0.40 to $0.60
Smuggler1991: folds
Cake_Horn_14: folds
DemolishIT: folds
skillzplumber: calls $0.40
*** FLOP *** [2c 9s 6c]
skillzplumber: checks
Gould Rush: bets $0.75
skillzplumber: folds
Uncalled bet ($0.75) returned to Gould Rush
Gould Rush collected $1.21 from pot
Gould Rush: doesn't show hand
*** SUMMARY ***
Total pot $1.27 | Rake $0.06
Board [2c 9s 6c]
Seat 1: skillzplumber folded on the Flop
Seat 2: Gould Rush collected ($1.21)
Seat 3: Smuggler1991 (button) folded before Flop (didn't bet)
Seat 4: Cake_Horn_14 (small blind) folded before Flop
Seat 5: DemolishIT (big blind) folded before Flop
Seat 6: PlayTheBlues4U folded before Flop (didn't bet)


*********** # 193 **************
PokerStars Hand #204206677071:  Hold'em No Limit ($0.05/$0.10 USD) - 2019/10/03 22:35:40 ET
Table 'Sculptor' 6-max Seat #3 is the button
Seat 3: PlayTheBlues4U ($10.22 in chips)
Seat 4: Gould Rush ($12.73 in chips)
Seat 6: Smuggler1991 ($6.46 in chips)
Gould Rush: posts small blind $0.05
Smuggler1991: posts big blind $0.10
*** HOLE CARDS ***
Dealt to PlayTheBlues4U [9s 6d]
PlayTheBlues4U: raises $0.15 to $0.25
Gould Rush: calls $0.20
Smuggler1991: folds
*** FLOP *** [4c Qs Qh]
Gould Rush: checks
PlayTheBlues4U: checks
*** TURN *** [4c Qs Qh] [7s]
Gould Rush: bets $0.30
PlayTheBlues4U: calls $0.30
*** RIVER *** [4c Qs Qh 7s] [3s]
Gould Rush: bets $1.10
PlayTheBlues4U: raises $1.40 to $2.50
Gould Rush: raises $9.68 to $12.18 and is all-in
PlayTheBlues4U: folds
Uncalled bet ($9.68) returned to Gould Rush
Gould Rush collected $5.89 from pot
Gould Rush: doesn't show hand
*** SUMMARY ***
Total pot $6.20 | Rake $0.31
Board [4c Qs Qh 7s 3s]
Seat 3: PlayTheBlues4U (button) folded on the River
Seat 4: Gould Rush (small blind) collected ($5.89)
Seat 6: Smuggler1991 (big blind) folded before Flop


*********** # 194 **************
PokerStars Hand #204206677012:  Hold'em No Limit ($0.02/$0.05 USD) - 2019/10/03 22:35:25 ET
Table 'Phoenix' 6-max Seat #2 is the button
Seat 1: skillzplumber ($4.71 in chips)
Seat 2: Gould Rush ($4.76 in chips)
Seat 3: Smuggler1991 ($3.23 in chips)
Seat 4: Cake_Horn_14 ($5.68 in chips)
Seat 5: DemolishIT ($4.36 in chips)
Seat 6: PlayTheBlues4U ($5.20 in chips)
Smuggler1991: posts small blind $0.02
Cake_Horn_14: posts big blind $0.05
*** HOLE CARDS ***
Dealt to PlayTheBlues4U [5h 8d]
DemolishIT: folds
PlayTheBlues4U: folds
skillzplumber: folds
Gould Rush: raises $0.10 to $0.15
Smuggler1991: calls $0.13
Cake_Horn_14: folds
*** FLOP *** [6h Qh 4s]
Smuggler1991: checks
Gould Rush: bets $0.20
Smuggler1991: folds
Uncalled bet ($0.20) returned to Gould Rush
Gould Rush collected $0.33 from pot
Gould Rush: doesn't show hand
*** SUMMARY ***
Total pot $0.35 | Rake $0.02
Board [6h Qh 4s]
Seat 1: skillzplumber folded before Flop (didn't bet)
Seat 2: Gould Rush (button) collected ($0.33)
Seat 3: Smuggler1991 (small blind) folded on the Flop
Seat 4: Cake_Horn_14 (big blind) folded before Flop
Seat 5: DemolishIT folded before Flop (didn't bet)
Seat 6: PlayTheBlues4U folded before Flop (didn't bet)


*********** # 195 **************
PokerStars Hand #204206677000:  Hold'em No Limit ($0.05/$0.10 USD) - 2019/10/03 22:35:20 ET
Table 'Sculptor' 6-max Seat #6 is the button
Seat 3: PlayTheBlues4U ($10.27 in chips)
Seat 4: Gould Rush ($13.08 in chips)
Seat 6: Smuggler1991 ($6.10 in chips)
PlayTheBlues4U: posts small blind $0.05
Gould Rush: posts big blind $0.10
*** HOLE CARDS ***
Dealt to PlayTheBlues4U [5d Tc]
Smuggler1991: raises $0.25 to $0.35
PlayTheBlues4U: folds
Gould Rush: calls $0.25
*** FLOP *** [Qs Js 8h]
Gould Rush: checks
Smuggler1991: bets $0.40
Gould Rush: folds
Uncalled bet ($0.40) returned to Smuggler1991
Smuggler1991 collected $0.71 from pot
Smuggler1991: doesn't show hand
*** SUMMARY ***
Total pot $0.75 | Rake $0.04
Board [Qs Js 8h]
Seat 3: PlayTheBlues4U (small blind) folded before Flop
Seat 4: Gould Rush (big blind) folded on the Flop
Seat 6: Smuggler1991 (button) collected ($0.71)


*********** # 196 **************
PokerStars Hand #204206676929:  Hold'em No Limit ($0.05/$0.10 USD) - 2019/10/03 22:34:59 ET
Table 'Sculptor' 6-max Seat #4 is the button
Seat 3: PlayTheBlues4U ($10 in chips)
Seat 4: Gould Rush ($13.08 in chips)
Seat 6: Smuggler1991 ($6.40 in chips)
Smuggler1991: posts small blind $0.05
PlayTheBlues4U: posts big blind $0.10
*** HOLE CARDS ***
Dealt to PlayTheBlues4U [7c Td]
Gould Rush: folds
Smuggler1991: raises $0.20 to $0.30
PlayTheBlues4U: calls $0.20
*** FLOP *** [Ts Ah 3h]
Smuggler1991: checks
PlayTheBlues4U: bets $0.30
Smuggler1991: folds
Uncalled bet ($0.30) returned to PlayTheBlues4U
PlayTheBlues4U collected $0.57 from pot
PlayTheBlues4U: doesn't show hand
*** SUMMARY ***
Total pot $0.60 | Rake $0.03
Board [Ts Ah 3h]
Seat 3: PlayTheBlues4U (big blind) collected ($0.57)
Seat 4: Gould Rush (button) folded before Flop (didn't bet)
Seat 6: Smuggler1991 (small blind) folded on the Flop


*********** # 197 **************
PokerStars Hand #204206676865:  Hold'em No Limit ($0.05/$0.10 USD) - 2019/10/03 22:34:41 ET
Table 'Sculptor' 6-max Seat #3 is the button
Seat 3: PlayTheBlues4U ($8.15 in chips)
Seat 4: Gould Rush ($12.81 in chips)
Seat 6: Smuggler1991 ($6.70 in chips)
Gould Rush: posts small blind $0.05
Smuggler1991: posts big blind $0.10
*** HOLE CARDS ***
Dealt to PlayTheBlues4U [3h Qd]
PlayTheBlues4U: folds
Gould Rush: raises $0.20 to $0.30
Smuggler1991: calls $0.20
*** FLOP *** [Kd 7s 3d]
Gould Rush: bets $0.30
Smuggler1991: folds
Uncalled bet ($0.30) returned to Gould Rush
Gould Rush collected $0.57 from pot
Gould Rush: doesn't show hand
*** SUMMARY ***
Total pot $0.60 | Rake $0.03
Board [Kd 7s 3d]
Seat 3: PlayTheBlues4U (button) folded before Flop (didn't bet)
Seat 4: Gould Rush (small blind) collected ($0.57)
Seat 6: Smuggler1991 (big blind) folded on the Flop


*********** # 198 **************
PokerStars Hand #204206676812:  Hold'em No Limit ($0.02/$0.05 USD) - 2019/10/03 22:34:27 ET
Table 'Phoenix' 6-max Seat #1 is the button
Seat 1: skillzplumber ($4.71 in chips)
Seat 2: Gould Rush ($4.78 in chips)
Seat 3: Smuggler1991 ($3.96 in chips)
Seat 4: Cake_Horn_14 ($5 in chips)
Seat 5: DemolishIT ($4.36 in chips)
Seat 6: PlayTheBlues4U ($5.20 in chips)
Gould Rush: posts small blind $0.02
Smuggler1991: posts big blind $0.05
*** HOLE CARDS ***
Dealt to PlayTheBlues4U [4h 3s]
Cake_Horn_14: raises $0.07 to $0.12
DemolishIT: folds
PlayTheBlues4U: folds
skillzplumber: folds
Gould Rush: folds
Smuggler1991: raises $0.26 to $0.38
Cake_Horn_14: calls $0.26
*** FLOP *** [5c 8c Ts]
Smuggler1991: bets $0.35
Cake_Horn_14: raises $0.95 to $1.30
Smuggler1991: folds
Uncalled bet ($0.95) returned to Cake_Horn_14
Cake_Horn_14 collected $1.41 from pot
Cake_Horn_14: doesn't show hand
*** SUMMARY ***
Total pot $1.48 | Rake $0.07
Board [5c 8c Ts]
Seat 1: skillzplumber (button) folded before Flop (didn't bet)
Seat 2: Gould Rush (small blind) folded before Flop
Seat 3: Smuggler1991 (big blind) folded on the Flop
Seat 4: Cake_Horn_14 collected ($1.41)
Seat 5: DemolishIT folded before Flop (didn't bet)
Seat 6: PlayTheBlues4U folded before Flop (didn't bet)


*********** # 199 **************
PokerStars Hand #204206676769:  Hold'em No Limit ($0.05/$0.10 USD) - 2019/10/03 22:34:11 ET
Table 'Sculptor' 6-max Seat #6 is the button
Seat 3: PlayTheBlues4U ($8.95 in chips)
Seat 4: Gould Rush ($12.09 in chips)
Seat 6: Smuggler1991 ($6.70 in chips)
PlayTheBlues4U: posts small blind $0.05
Gould Rush: posts big blind $0.10
*** HOLE CARDS ***
Dealt to PlayTheBlues4U [4d 4s]
Smuggler1991: folds
PlayTheBlues4U: raises $0.10 to $0.20
Gould Rush: calls $0.10
*** FLOP *** [Jh 8c 7s]
PlayTheBlues4U: bets $0.20
Gould Rush: raises $0.40 to $0.60
PlayTheBlues4U: calls $0.40
*** TURN *** [Jh 8c 7s] [Kc]
PlayTheBlues4U: checks
Gould Rush: bets $1
PlayTheBlues4U: folds
Uncalled bet ($1) returned to Gould Rush
Gould Rush collected $1.52 from pot
Gould Rush: doesn't show hand
*** SUMMARY ***
Total pot $1.60 | Rake $0.08
Board [Jh 8c 7s Kc]
Seat 3: PlayTheBlues4U (small blind) folded on the Turn
Seat 4: Gould Rush (big blind) collected ($1.52)
Seat 6: Smuggler1991 (button) folded before Flop (didn't bet)


*********** # 200 **************
PokerStars Hand #204206676690:  Hold'em No Limit ($0.02/$0.05 USD) - 2019/10/03 22:33:42 ET
Table 'Phoenix' 6-max Seat #6 is the button
Seat 1: skillzplumber ($4.73 in chips)
Seat 2: Gould Rush ($4.93 in chips)
Seat 3: Smuggler1991 ($3.96 in chips)
Seat 4: Cake_Horn_14 ($5 in chips)
Seat 5: DemolishIT ($4.06 in chips)
Seat 6: PlayTheBlues4U ($5.20 in chips)
skillzplumber: posts small blind $0.02
Gould Rush: posts big blind $0.05
Cake_Horn_14: posts big blind $0.05
*** HOLE CARDS ***
Dealt to PlayTheBlues4U [As 4c]
Smuggler1991: folds
Cake_Horn_14: raises $0.10 to $0.15
DemolishIT: calls $0.15
PlayTheBlues4U: folds
skillzplumber: folds
Gould Rush: calls $0.10
*** FLOP *** [Ah Js 3d]
Gould Rush: checks
Cake_Horn_14: checks
DemolishIT: checks
*** TURN *** [Ah Js 3d] [Jh]
Gould Rush: checks
Cake_Horn_14: checks
DemolishIT: checks
*** RIVER *** [Ah Js 3d Jh] [4h]
Gould Rush: checks
Cake_Horn_14: checks
DemolishIT: bets $0.45
Gould Rush: folds
Cake_Horn_14: folds
Uncalled bet ($0.45) returned to DemolishIT
DemolishIT collected $0.45 from pot
*** SUMMARY ***
Total pot $0.47 | Rake $0.02
Board [Ah Js 3d Jh 4h]
Seat 1: skillzplumber (small blind) folded before Flop
Seat 2: Gould Rush (big blind) folded on the River
Seat 3: Smuggler1991 folded before Flop (didn't bet)
Seat 4: Cake_Horn_14 folded on the River
Seat 5: DemolishIT collected ($0.45)
Seat 6: PlayTheBlues4U (button) folded before Flop (didn't bet)

