PokerStars Hand #204909678926: Hold'em No Limit ($0.05/$0.10 USD) - 2019/10/22 22:46:55 ET
Table 'Celuta' 6-max Seat #3 is the button
Seat 2: SeaofLove ($19.88 in chips) 
Seat 3: ng2414 ($13.67 in chips) 
Seat 4: Jahlah1 ($11.34 in chips) 
Seat 5: KeithTurbo48 ($15.66 in chips) 
Seat 6: PlayTheBlues4U ($8.62 in chips) 
Jahlah1: posts small blind $0.05
KeithTurbo48: posts big blind $0.10
*** HOLE CARDS ***
Dealt to PlayTheBlues4U [Th 6h]
PlayTheBlues4U: folds 
SeaofLove: folds 
ng2414: raises $0.20 to $0.30
Jahlah1: calls $0.25
KeithTurbo48: folds 
*** FLOP *** [9c Ac 6c]
Jahlah1: checks 
ng2414: checks 
*** TURN *** [9c Ac 6c] [Tc]
Jahlah1: checks 
ng2414: checks 
*** RIVER *** [9c Ac 6c Tc] [7d]
Jahlah1: checks 
ng2414: checks 
*** SHOW DOWN ***
Jahlah1: shows [4h 4c] (a flush, Ace high)
ng2414: mucks hand 
Jahlah1 collected $0.66 from pot
*** SUMMARY ***
Total pot $0.70 | Rake $0.04 
Board [9c Ac 6c Tc 7d]
Seat 2: SeaofLove folded before Flop (didn't bet)
Seat 3: ng2414 (button) mucked [Ah 8d]
Seat 4: Jahlah1 (small blind) showed [4h 4c] and won ($0.66) with a flush, Ace high
Seat 5: KeithTurbo48 (big blind) folded before Flop
Seat 6: PlayTheBlues4U folded before Flop (didn't bet)


*********** # 2 **************
PokerStars Hand #204909678803: Hold'em No Limit ($0.05/$0.10 USD) - 2019/10/22 22:46:27 ET
Table 'Celuta' 6-max Seat #2 is the button
Seat 2: SeaofLove ($19.88 in chips) 
Seat 3: ng2414 ($13.57 in chips) 
Seat 4: Jahlah1 ($11.44 in chips) 
Seat 5: KeithTurbo48 ($15.66 in chips) 
Seat 6: PlayTheBlues4U ($8.62 in chips) 
ng2414: posts small blind $0.05
Jahlah1: posts big blind $0.10
*** HOLE CARDS ***
Dealt to PlayTheBlues4U [Jd 2c]
KeithTurbo48: folds 
PlayTheBlues4U: folds 
SeaofLove: folds 
ng2414: raises $0.20 to $0.30
Jahlah1: folds 
Uncalled bet ($0.20) returned to ng2414
ng2414 collected $0.20 from pot
*** SUMMARY ***
Total pot $0.20 | Rake $0 
Seat 2: SeaofLove (button) folded before Flop (didn't bet)
Seat 3: ng2414 (small blind) collected ($0.20)
Seat 4: Jahlah1 (big blind) folded before Flop
Seat 5: KeithTurbo48 folded before Flop (didn't bet)
Seat 6: PlayTheBlues4U folded before Flop (didn't bet)


*********** # 3 **************
PokerStars Hand #204909678728: Hold'em No Limit ($0.05/$0.10 USD) - 2019/10/22 22:46:06 ET
Table 'Danae' 6-max Seat #2 is the button
Seat 1: zombiehedgehog ($15.53 in chips) 
Seat 2: SeaofLove ($12.97 in chips) 
Seat 3: KeithTurbo48 ($14.35 in chips) 
Seat 4: ng2414 ($24.28 in chips) 
Seat 5: PlayTheBlues4U ($9.70 in chips) 
Seat 6: Donkey1206 ($6.55 in chips) 
KeithTurbo48: posts small blind $0.05
ng2414: posts big blind $0.10
*** HOLE CARDS ***
Dealt to PlayTheBlues4U [6d 7c]
PlayTheBlues4U: folds 
Donkey1206: calls $0.10
zombiehedgehog: calls $0.10
SeaofLove: folds 
KeithTurbo48: calls $0.05
ng2414: checks 
*** FLOP *** [Ac Kh 3c]
KeithTurbo48: checks 
ng2414: checks 
Donkey1206: bets $0.40
zombiehedgehog: calls $0.40
KeithTurbo48: folds 
ng2414: folds 
*** TURN *** [Ac Kh 3c] [9d]
Donkey1206: bets $1.10
zombiehedgehog: calls $1.10
*** RIVER *** [Ac Kh 3c 9d] [5d]
Donkey1206: bets $1.10
zombiehedgehog: raises $5.43 to $6.53
Donkey1206: calls $3.85 and is all-in
Uncalled bet ($1.58) returned to zombiehedgehog
*** SHOW DOWN ***
zombiehedgehog: shows [9c 5c] (two pair, Nines and Fives)
Donkey1206: shows [Kc Tc] (a pair of Kings)
zombiehedgehog collected $12.64 from pot
*** SUMMARY ***
Total pot $13.30 | Rake $0.66 
Board [Ac Kh 3c 9d 5d]
Seat 1: zombiehedgehog showed [9c 5c] and won ($12.64) with two pair, Nines and Fives
Seat 2: SeaofLove (button) folded before Flop (didn't bet)
Seat 3: KeithTurbo48 (small blind) folded on the Flop
Seat 4: ng2414 (big blind) folded on the Flop
Seat 5: PlayTheBlues4U folded before Flop (didn't bet)
Seat 6: Donkey1206 showed [Kc Tc] and lost with a pair of Kings


*********** # 4 **************
PokerStars Hand #204909678705: Hold'em No Limit ($0.05/$0.10 USD) - 2019/10/22 22:46:01 ET
Table 'Celuta' 6-max Seat #6 is the button
Seat 2: SeaofLove ($19.56 in chips) 
Seat 3: ng2414 ($13.67 in chips) 
Seat 4: Jahlah1 ($11.44 in chips) 
Seat 5: KeithTurbo48 ($15.66 in chips) 
Seat 6: PlayTheBlues4U ($8.87 in chips) 
SeaofLove: posts small blind $0.05
ng2414: posts big blind $0.10
*** HOLE CARDS ***
Dealt to PlayTheBlues4U [9d Ks]
Jahlah1: folds 
KeithTurbo48: folds 
PlayTheBlues4U: raises $0.15 to $0.25
SeaofLove: calls $0.20
ng2414: folds 
*** FLOP *** [Th 6h Jh]
SeaofLove: bets $0.38
PlayTheBlues4U: folds 
Uncalled bet ($0.38) returned to SeaofLove
SeaofLove collected $0.57 from pot
SeaofLove: doesn't show hand 
*** SUMMARY ***
Total pot $0.60 | Rake $0.03 
Board [Th 6h Jh]
Seat 2: SeaofLove (small blind) collected ($0.57)
Seat 3: ng2414 (big blind) folded before Flop
Seat 4: Jahlah1 folded before Flop (didn't bet)
Seat 5: KeithTurbo48 folded before Flop (didn't bet)
Seat 6: PlayTheBlues4U (button) folded on the Flop


*********** # 5 **************
PokerStars Hand #204909678607: Hold'em No Limit ($0.05/$0.10 USD) - 2019/10/22 22:45:39 ET
Table 'Celuta' 6-max Seat #5 is the button
Seat 2: SeaofLove ($19.51 in chips) 
Seat 3: ng2414 ($13.67 in chips) 
Seat 4: Jahlah1 ($11.44 in chips) 
Seat 5: KeithTurbo48 ($15.66 in chips) 
Seat 6: PlayTheBlues4U ($8.92 in chips) 
PlayTheBlues4U: posts small blind $0.05
SeaofLove: posts big blind $0.10
*** HOLE CARDS ***
Dealt to PlayTheBlues4U [Kh 2s]
ng2414: folds 
Jahlah1: folds 
KeithTurbo48: folds 
PlayTheBlues4U: folds 
Uncalled bet ($0.05) returned to SeaofLove
SeaofLove collected $0.10 from pot
SeaofLove: doesn't show hand 
*** SUMMARY ***
Total pot $0.10 | Rake $0 
Seat 2: SeaofLove (big blind) collected ($0.10)
Seat 3: ng2414 folded before Flop (didn't bet)
Seat 4: Jahlah1 folded before Flop (didn't bet)
Seat 5: KeithTurbo48 (button) folded before Flop (didn't bet)
Seat 6: PlayTheBlues4U (small blind) folded before Flop


*********** # 6 **************
PokerStars Hand #204909678538: Hold'em No Limit ($0.05/$0.10 USD) - 2019/10/22 22:45:23 ET
Table 'Danae' 6-max Seat #1 is the button
Seat 1: zombiehedgehog ($15.35 in chips) 
Seat 2: SeaofLove ($13.07 in chips) 
Seat 3: KeithTurbo48 ($14.45 in chips) 
Seat 4: ng2414 ($24.28 in chips) 
Seat 5: PlayTheBlues4U ($9.70 in chips) 
Seat 6: Donkey1206 ($6.55 in chips) 
SeaofLove: posts small blind $0.05
KeithTurbo48: posts big blind $0.10
*** HOLE CARDS ***
Dealt to PlayTheBlues4U [Qd 4d]
ng2414: folds 
PlayTheBlues4U: folds 
Donkey1206: folds 
zombiehedgehog: calls $0.10
SeaofLove: calls $0.05
KeithTurbo48: checks 
*** FLOP *** [2d 9s 2s]
SeaofLove: checks 
KeithTurbo48: checks 
zombiehedgehog: bets $0.10
SeaofLove: folds 
KeithTurbo48: folds 
Uncalled bet ($0.10) returned to zombiehedgehog
zombiehedgehog collected $0.28 from pot
zombiehedgehog: doesn't show hand 
*** SUMMARY ***
Total pot $0.30 | Rake $0.02 
Board [2d 9s 2s]
Seat 1: zombiehedgehog (button) collected ($0.28)
Seat 2: SeaofLove (small blind) folded on the Flop
Seat 3: KeithTurbo48 (big blind) folded on the Flop
Seat 4: ng2414 folded before Flop (didn't bet)
Seat 5: PlayTheBlues4U folded before Flop (didn't bet)
Seat 6: Donkey1206 folded before Flop (didn't bet)


*********** # 7 **************
PokerStars Hand #204909678464: Hold'em No Limit ($0.05/$0.10 USD) - 2019/10/22 22:45:06 ET
Table 'Danae' 6-max Seat #6 is the button
Seat 1: zombiehedgehog ($15.25 in chips) 
Seat 2: SeaofLove ($13.17 in chips) 
Seat 3: KeithTurbo48 ($14.45 in chips) 
Seat 4: ng2414 ($24.28 in chips) 
Seat 5: PlayTheBlues4U ($9.70 in chips) 
Seat 6: Donkey1206 ($6.55 in chips) 
zombiehedgehog: posts small blind $0.05
SeaofLove: posts big blind $0.10
*** HOLE CARDS ***
Dealt to PlayTheBlues4U [3d Kd]
KeithTurbo48: folds 
ng2414: folds 
PlayTheBlues4U: folds 
Donkey1206: folds 
zombiehedgehog: raises $0.20 to $0.30
SeaofLove: folds 
Uncalled bet ($0.20) returned to zombiehedgehog
zombiehedgehog collected $0.20 from pot
zombiehedgehog: doesn't show hand 
*** SUMMARY ***
Total pot $0.20 | Rake $0 
Seat 1: zombiehedgehog (small blind) collected ($0.20)
Seat 2: SeaofLove (big blind) folded before Flop
Seat 3: KeithTurbo48 folded before Flop (didn't bet)
Seat 4: ng2414 folded before Flop (didn't bet)
Seat 5: PlayTheBlues4U folded before Flop (didn't bet)
Seat 6: Donkey1206 (button) folded before Flop (didn't bet)


*********** # 8 **************
PokerStars Hand #204909678456: Hold'em No Limit ($0.05/$0.10 USD) - 2019/10/22 22:45:05 ET
Table 'Celuta' 6-max Seat #4 is the button
Seat 2: SeaofLove ($19.51 in chips) 
Seat 3: ng2414 ($13.67 in chips) 
Seat 4: Jahlah1 ($11.44 in chips) 
Seat 5: KeithTurbo48 ($15.56 in chips) 
Seat 6: PlayTheBlues4U ($9.02 in chips) 
KeithTurbo48: posts small blind $0.05
PlayTheBlues4U: posts big blind $0.10
*** HOLE CARDS ***
Dealt to PlayTheBlues4U [Qs 8c]
SeaofLove: folds 
ng2414: folds 
Jahlah1: folds 
KeithTurbo48: raises $0.20 to $0.30
PlayTheBlues4U: folds 
Uncalled bet ($0.20) returned to KeithTurbo48
KeithTurbo48 collected $0.20 from pot
KeithTurbo48: doesn't show hand 
*** SUMMARY ***
Total pot $0.20 | Rake $0 
Seat 2: SeaofLove folded before Flop (didn't bet)
Seat 3: ng2414 folded before Flop (didn't bet)
Seat 4: Jahlah1 (button) folded before Flop (didn't bet)
Seat 5: KeithTurbo48 (small blind) collected ($0.20)
Seat 6: PlayTheBlues4U (big blind) folded before Flop


*********** # 9 **************
PokerStars Hand #204909678331: Hold'em No Limit ($0.05/$0.10 USD) - 2019/10/22 22:44:29 ET
Table 'Danae' 6-max Seat #5 is the button
Seat 1: zombiehedgehog ($14.98 in chips) 
Seat 2: SeaofLove ($13.17 in chips) 
Seat 3: KeithTurbo48 ($14.45 in chips) 
Seat 4: ng2414 ($24.28 in chips) 
Seat 5: PlayTheBlues4U ($9.95 in chips) 
Seat 6: Donkey1206 ($6.60 in chips) 
Donkey1206: posts small blind $0.05
zombiehedgehog: posts big blind $0.10
*** HOLE CARDS ***
Dealt to PlayTheBlues4U [3s Ad]
SeaofLove: folds 
KeithTurbo48: folds 
ng2414: folds 
PlayTheBlues4U: raises $0.15 to $0.25
Donkey1206: folds 
zombiehedgehog: calls $0.15
*** FLOP *** [Qs Tc Qh]
zombiehedgehog: bets $0.26
PlayTheBlues4U: folds 
Uncalled bet ($0.26) returned to zombiehedgehog
zombiehedgehog collected $0.52 from pot
zombiehedgehog: doesn't show hand 
*** SUMMARY ***
Total pot $0.55 | Rake $0.03 
Board [Qs Tc Qh]
Seat 1: zombiehedgehog (big blind) collected ($0.52)
Seat 2: SeaofLove folded before Flop (didn't bet)
Seat 3: KeithTurbo48 folded before Flop (didn't bet)
Seat 4: ng2414 folded before Flop (didn't bet)
Seat 5: PlayTheBlues4U (button) folded on the Flop
Seat 6: Donkey1206 (small blind) folded before Flop


*********** # 10 **************
PokerStars Hand #204909678230: Hold'em No Limit ($0.05/$0.10 USD) - 2019/10/22 22:44:06 ET
Table 'Celuta' 6-max Seat #3 is the button
Seat 2: SeaofLove ($19.51 in chips) 
Seat 3: ng2414 ($13.97 in chips) 
Seat 4: Jahlah1 ($11.49 in chips) 
Seat 5: KeithTurbo48 ($15.24 in chips) 
Seat 6: PlayTheBlues4U ($9.02 in chips) 
Jahlah1: posts small blind $0.05
KeithTurbo48: posts big blind $0.10
*** HOLE CARDS ***
Dealt to PlayTheBlues4U [7h 2s]
PlayTheBlues4U: folds 
SeaofLove: folds 
ng2414: raises $0.20 to $0.30
Jahlah1: folds 
KeithTurbo48: calls $0.20
*** FLOP *** [6c Qc Kh]
KeithTurbo48: checks 
ng2414: checks 
*** TURN *** [6c Qc Kh] [Qh]
KeithTurbo48: bets $0.30
ng2414: folds 
Uncalled bet ($0.30) returned to KeithTurbo48
KeithTurbo48 collected $0.62 from pot
KeithTurbo48: doesn't show hand 
*** SUMMARY ***
Total pot $0.65 | Rake $0.03 
Board [6c Qc Kh Qh]
Seat 2: SeaofLove folded before Flop (didn't bet)
Seat 3: ng2414 (button) folded on the Turn
Seat 4: Jahlah1 (small blind) folded before Flop
Seat 5: KeithTurbo48 (big blind) collected ($0.62)
Seat 6: PlayTheBlues4U folded before Flop (didn't bet)


*********** # 11 **************
PokerStars Hand #204909678155: Hold'em No Limit ($0.05/$0.10 USD) - 2019/10/22 22:43:49 ET
Table 'Danae' 6-max Seat #4 is the button
Seat 1: zombiehedgehog ($14.98 in chips) 
Seat 2: SeaofLove ($12.80 in chips) 
Seat 3: KeithTurbo48 ($14.45 in chips) 
Seat 4: ng2414 ($24.53 in chips) 
Seat 5: PlayTheBlues4U ($10 in chips) 
Seat 6: Donkey1206 ($6.70 in chips) 
PlayTheBlues4U: posts small blind $0.05
Donkey1206: posts big blind $0.10
*** HOLE CARDS ***
Dealt to PlayTheBlues4U [7s 4d]
zombiehedgehog: folds 
SeaofLove: raises $0.15 to $0.25
KeithTurbo48: folds 
ng2414: calls $0.25
PlayTheBlues4U: folds 
Donkey1206: folds 
*** FLOP *** [2d Qc Jd]
SeaofLove: checks 
ng2414: checks 
*** TURN *** [2d Qc Jd] [9d]
SeaofLove: bets $0.41
ng2414: folds 
Uncalled bet ($0.41) returned to SeaofLove
SeaofLove collected $0.62 from pot
SeaofLove: doesn't show hand 
*** SUMMARY ***
Total pot $0.65 | Rake $0.03 
Board [2d Qc Jd 9d]
Seat 1: zombiehedgehog folded before Flop (didn't bet)
Seat 2: SeaofLove collected ($0.62)
Seat 3: KeithTurbo48 folded before Flop (didn't bet)
Seat 4: ng2414 (button) folded on the Turn
Seat 5: PlayTheBlues4U (small blind) folded before Flop
Seat 6: Donkey1206 (big blind) folded before Flop


*********** # 12 **************
PokerStars Hand #204909677959: Hold'em No Limit ($0.05/$0.10 USD) - 2019/10/22 22:43:01 ET
Table 'Danae' 6-max Seat #3 is the button
Seat 1: zombiehedgehog ($15.08 in chips) 
Seat 2: SeaofLove ($12.80 in chips) 
Seat 3: KeithTurbo48 ($14.22 in chips) 
Seat 4: ng2414 ($24.58 in chips) 
Seat 5: PlayTheBlues4U ($8.01 in chips) 
Seat 6: Donkey1206 ($6.70 in chips) 
ng2414: posts small blind $0.05
PlayTheBlues4U: posts big blind $0.10
*** HOLE CARDS ***
Dealt to PlayTheBlues4U [Qd 4c]
Donkey1206 has timed out
Donkey1206: folds 
zombiehedgehog: calls $0.10
SeaofLove: folds 
KeithTurbo48: calls $0.10
ng2414: folds 
PlayTheBlues4U: checks 
*** FLOP *** [Ks 5c Kc]
PlayTheBlues4U: checks 
zombiehedgehog: checks 
KeithTurbo48: bets $0.15
PlayTheBlues4U: folds 
zombiehedgehog: folds 
Uncalled bet ($0.15) returned to KeithTurbo48
KeithTurbo48 collected $0.33 from pot
KeithTurbo48: doesn't show hand 
*** SUMMARY ***
Total pot $0.35 | Rake $0.02 
Board [Ks 5c Kc]
Seat 1: zombiehedgehog folded on the Flop
Seat 2: SeaofLove folded before Flop (didn't bet)
Seat 3: KeithTurbo48 (button) collected ($0.33)
Seat 4: ng2414 (small blind) folded before Flop
Seat 5: PlayTheBlues4U (big blind) folded on the Flop
Seat 6: Donkey1206 folded before Flop (didn't bet)


*********** # 13 **************
PokerStars Hand #204909677905: Hold'em No Limit ($0.05/$0.10 USD) - 2019/10/22 22:42:46 ET
Table 'Celuta' 6-max Seat #2 is the button
Seat 2: SeaofLove ($15.25 in chips) 
Seat 3: ng2414 ($14.02 in chips) 
Seat 4: Jahlah1 ($11.59 in chips) 
Seat 5: KeithTurbo48 ($19.55 in chips) 
Seat 6: PlayTheBlues4U ($9.27 in chips) 
ng2414: posts small blind $0.05
Jahlah1: posts big blind $0.10
*** HOLE CARDS ***
Dealt to PlayTheBlues4U [Js Ks]
KeithTurbo48: raises $0.15 to $0.25
PlayTheBlues4U: calls $0.25
SeaofLove: calls $0.25
ng2414: folds 
Jahlah1: folds 
*** FLOP *** [4s 9c Tc]
KeithTurbo48: checks 
PlayTheBlues4U: checks 
SeaofLove: bets $0.57
KeithTurbo48: calls $0.57
PlayTheBlues4U: folds 
*** TURN *** [4s 9c Tc] [Qc]
KeithTurbo48: checks 
SeaofLove: bets $1.29
KeithTurbo48: calls $1.29
*** RIVER *** [4s 9c Tc Qc] [Ts]
KeithTurbo48: checks 
SeaofLove: bets $2.20
KeithTurbo48: calls $2.20
*** SHOW DOWN ***
SeaofLove: shows [3c 5c] (a flush, Queen high)
KeithTurbo48: mucks hand 
SeaofLove collected $8.57 from pot
*** SUMMARY ***
Total pot $9.02 | Rake $0.45 
Board [4s 9c Tc Qc Ts]
Seat 2: SeaofLove (button) showed [3c 5c] and won ($8.57) with a flush, Queen high
Seat 3: ng2414 (small blind) folded before Flop
Seat 4: Jahlah1 (big blind) folded before Flop
Seat 5: KeithTurbo48 mucked [Ac Qs]
Seat 6: PlayTheBlues4U folded on the Flop


*********** # 14 **************
PokerStars Hand #204909677808: Hold'em No Limit ($0.05/$0.10 USD) - 2019/10/22 22:42:25 ET
Table 'Danae' 6-max Seat #2 is the button
Seat 1: zombiehedgehog ($14.93 in chips) 
Seat 2: SeaofLove ($12.80 in chips) 
Seat 3: KeithTurbo48 ($14.27 in chips) 
Seat 4: ng2414 ($24.68 in chips) 
Seat 5: PlayTheBlues4U ($8.01 in chips) 
Seat 6: Donkey1206 ($6.70 in chips) 
KeithTurbo48: posts small blind $0.05
ng2414: posts big blind $0.10
*** HOLE CARDS ***
Dealt to PlayTheBlues4U [9s 5s]
PlayTheBlues4U: folds 
Donkey1206: folds 
zombiehedgehog: raises $0.10 to $0.20
SeaofLove: folds 
KeithTurbo48: folds 
ng2414: folds 
Uncalled bet ($0.10) returned to zombiehedgehog
zombiehedgehog collected $0.25 from pot
zombiehedgehog: doesn't show hand 
*** SUMMARY ***
Total pot $0.25 | Rake $0 
Seat 1: zombiehedgehog collected ($0.25)
Seat 2: SeaofLove (button) folded before Flop (didn't bet)
Seat 3: KeithTurbo48 (small blind) folded before Flop
Seat 4: ng2414 (big blind) folded before Flop
Seat 5: PlayTheBlues4U folded before Flop (didn't bet)
Seat 6: Donkey1206 folded before Flop (didn't bet)


*********** # 15 **************
PokerStars Hand #204909677790: Hold'em No Limit ($0.05/$0.10 USD) - 2019/10/22 22:42:20 ET
Table 'Celuta' 6-max Seat #6 is the button
Seat 2: SeaofLove ($15.30 in chips) 
Seat 3: ng2414 ($14.12 in chips) 
Seat 4: Jahlah1 ($11.59 in chips) 
Seat 5: KeithTurbo48 ($19.55 in chips) 
Seat 6: PlayTheBlues4U ($9.12 in chips) 
SeaofLove: posts small blind $0.05
ng2414: posts big blind $0.10
*** HOLE CARDS ***
Dealt to PlayTheBlues4U [8h Qh]
Jahlah1: folds 
KeithTurbo48: folds 
PlayTheBlues4U: raises $0.10 to $0.20
SeaofLove: folds 
ng2414: folds 
Uncalled bet ($0.10) returned to PlayTheBlues4U
PlayTheBlues4U collected $0.25 from pot
PlayTheBlues4U: doesn't show hand 
*** SUMMARY ***
Total pot $0.25 | Rake $0 
Seat 2: SeaofLove (small blind) folded before Flop
Seat 3: ng2414 (big blind) folded before Flop
Seat 4: Jahlah1 folded before Flop (didn't bet)
Seat 5: KeithTurbo48 folded before Flop (didn't bet)
Seat 6: PlayTheBlues4U (button) collected ($0.25)


*********** # 16 **************
PokerStars Hand #204909677724: Hold'em No Limit ($0.05/$0.10 USD) - 2019/10/22 22:42:01 ET
Table 'Celuta' 6-max Seat #5 is the button
Seat 2: SeaofLove ($15.25 in chips) 
Seat 3: ng2414 ($14.12 in chips) 
Seat 4: Jahlah1 ($11.59 in chips) 
Seat 5: KeithTurbo48 ($19.55 in chips) 
Seat 6: PlayTheBlues4U ($9.17 in chips) 
PlayTheBlues4U: posts small blind $0.05
SeaofLove: posts big blind $0.10
*** HOLE CARDS ***
Dealt to PlayTheBlues4U [3c 9d]
ng2414: folds 
Jahlah1: folds 
KeithTurbo48: folds 
PlayTheBlues4U: folds 
Uncalled bet ($0.05) returned to SeaofLove
SeaofLove collected $0.10 from pot
SeaofLove: doesn't show hand 
*** SUMMARY ***
Total pot $0.10 | Rake $0 
Seat 2: SeaofLove (big blind) collected ($0.10)
Seat 3: ng2414 folded before Flop (didn't bet)
Seat 4: Jahlah1 folded before Flop (didn't bet)
Seat 5: KeithTurbo48 (button) folded before Flop (didn't bet)
Seat 6: PlayTheBlues4U (small blind) folded before Flop


*********** # 17 **************
PokerStars Hand #204909677713: Hold'em No Limit ($0.05/$0.10 USD) - 2019/10/22 22:41:58 ET
Table 'Danae' 6-max Seat #1 is the button
Seat 1: zombiehedgehog ($14.70 in chips) 
Seat 2: SeaofLove ($12.85 in chips) 
Seat 3: KeithTurbo48 ($14.47 in chips) 
Seat 4: ng2414 ($24.68 in chips) 
Seat 5: PlayTheBlues4U ($8.01 in chips) 
Seat 6: Donkey1206 ($6.70 in chips) 
SeaofLove: posts small blind $0.05
KeithTurbo48: posts big blind $0.10
*** HOLE CARDS ***
Dealt to PlayTheBlues4U [5c 2d]
ng2414: folds 
PlayTheBlues4U: folds 
Donkey1206: folds 
zombiehedgehog: raises $0.10 to $0.20
SeaofLove: folds 
KeithTurbo48: calls $0.10
*** FLOP *** [6s 7h Td]
KeithTurbo48: checks 
zombiehedgehog: bets $0.22
KeithTurbo48: folds 
Uncalled bet ($0.22) returned to zombiehedgehog
zombiehedgehog collected $0.43 from pot
zombiehedgehog: doesn't show hand 
*** SUMMARY ***
Total pot $0.45 | Rake $0.02 
Board [6s 7h Td]
Seat 1: zombiehedgehog (button) collected ($0.43)
Seat 2: SeaofLove (small blind) folded before Flop
Seat 3: KeithTurbo48 (big blind) folded on the Flop
Seat 4: ng2414 folded before Flop (didn't bet)
Seat 5: PlayTheBlues4U folded before Flop (didn't bet)
Seat 6: Donkey1206 folded before Flop (didn't bet)


*********** # 18 **************
PokerStars Hand #204909677663: Hold'em No Limit ($0.05/$0.10 USD) - 2019/10/22 22:41:47 ET
Table 'Danae' 6-max Seat #6 is the button
Seat 1: zombiehedgehog ($14.60 in chips) 
Seat 2: SeaofLove ($12.95 in chips) 
Seat 3: KeithTurbo48 ($14.47 in chips) 
Seat 4: ng2414 ($24.68 in chips) 
Seat 5: PlayTheBlues4U ($8.01 in chips) 
Seat 6: Donkey1206 ($6.70 in chips) 
zombiehedgehog: posts small blind $0.05
SeaofLove: posts big blind $0.10
*** HOLE CARDS ***
Dealt to PlayTheBlues4U [Qc 2d]
KeithTurbo48: folds 
ng2414: folds 
PlayTheBlues4U: folds 
Donkey1206: folds 
zombiehedgehog: raises $0.10 to $0.20
SeaofLove: folds 
Uncalled bet ($0.10) returned to zombiehedgehog
zombiehedgehog collected $0.20 from pot
zombiehedgehog: doesn't show hand 
*** SUMMARY ***
Total pot $0.20 | Rake $0 
Seat 1: zombiehedgehog (small blind) collected ($0.20)
Seat 2: SeaofLove (big blind) folded before Flop
Seat 3: KeithTurbo48 folded before Flop (didn't bet)
Seat 4: ng2414 folded before Flop (didn't bet)
Seat 5: PlayTheBlues4U folded before Flop (didn't bet)
Seat 6: Donkey1206 (button) folded before Flop (didn't bet)


*********** # 19 **************
PokerStars Hand #204909677533: Hold'em No Limit ($0.05/$0.10 USD) - 2019/10/22 22:41:16 ET
Table 'Celuta' 6-max Seat #4 is the button
Seat 1: trumpcaddy ($9.43 in chips) 
Seat 2: SeaofLove ($15.25 in chips) 
Seat 3: ng2414 ($12.72 in chips) 
Seat 4: Jahlah1 ($11.59 in chips) 
Seat 5: KeithTurbo48 ($19.60 in chips) 
Seat 6: PlayTheBlues4U ($10.67 in chips) 
KeithTurbo48: posts small blind $0.05
PlayTheBlues4U: posts big blind $0.10
*** HOLE CARDS ***
Dealt to PlayTheBlues4U [Ah 9h]
trumpcaddy: folds 
SeaofLove: folds 
ng2414: raises $0.20 to $0.30
Jahlah1: folds 
KeithTurbo48: folds 
PlayTheBlues4U: calls $0.20
*** FLOP *** [2d 6c Ks]
PlayTheBlues4U: checks 
ng2414: checks 
*** TURN *** [2d 6c Ks] [9c]
PlayTheBlues4U: checks 
ng2414: bets $0.40
PlayTheBlues4U: calls $0.40
*** RIVER *** [2d 6c Ks 9c] [Td]
PlayTheBlues4U: checks 
ng2414: bets $0.80
PlayTheBlues4U: calls $0.80
*** SHOW DOWN ***
ng2414: shows [Tc Kh] (two pair, Kings and Tens)
PlayTheBlues4U: mucks hand 
ng2414 collected $2.90 from pot
*** SUMMARY ***
Total pot $3.05 | Rake $0.15 
Board [2d 6c Ks 9c Td]
Seat 1: trumpcaddy folded before Flop (didn't bet)
Seat 2: SeaofLove folded before Flop (didn't bet)
Seat 3: ng2414 showed [Tc Kh] and won ($2.90) with two pair, Kings and Tens
Seat 4: Jahlah1 (button) folded before Flop (didn't bet)
Seat 5: KeithTurbo48 (small blind) folded before Flop
Seat 6: PlayTheBlues4U (big blind) mucked [Ah 9h]


*********** # 20 **************
PokerStars Hand #204909677451: Hold'em No Limit ($0.05/$0.10 USD) - 2019/10/22 22:40:57 ET
Table 'Danae' 6-max Seat #5 is the button
Seat 1: zombiehedgehog ($14.85 in chips) 
Seat 2: SeaofLove ($13.20 in chips) 
Seat 3: KeithTurbo48 ($13.96 in chips) 
Seat 4: ng2414 ($24.68 in chips) 
Seat 5: PlayTheBlues4U ($8.01 in chips) 
Seat 6: Donkey1206 ($6.75 in chips) 
Donkey1206: posts small blind $0.05
zombiehedgehog: posts big blind $0.10
*** HOLE CARDS ***
Dealt to PlayTheBlues4U [4h Qs]
SeaofLove: raises $0.15 to $0.25
KeithTurbo48: calls $0.25
ng2414: folds 
PlayTheBlues4U: folds 
Donkey1206: folds 
zombiehedgehog: calls $0.15
*** FLOP *** [5c 2s Th]
zombiehedgehog: checks 
SeaofLove: checks 
KeithTurbo48: bets $0.50
zombiehedgehog: folds 
SeaofLove: folds 
Uncalled bet ($0.50) returned to KeithTurbo48
KeithTurbo48 collected $0.76 from pot
KeithTurbo48: doesn't show hand 
*** SUMMARY ***
Total pot $0.80 | Rake $0.04 
Board [5c 2s Th]
Seat 1: zombiehedgehog (big blind) folded on the Flop
Seat 2: SeaofLove folded on the Flop
Seat 3: KeithTurbo48 collected ($0.76)
Seat 4: ng2414 folded before Flop (didn't bet)
Seat 5: PlayTheBlues4U (button) folded before Flop (didn't bet)
Seat 6: Donkey1206 (small blind) folded before Flop


*********** # 21 **************
PokerStars Hand #204909677328: Hold'em No Limit ($0.05/$0.10 USD) - 2019/10/22 22:40:29 ET
Table 'Danae' 6-max Seat #4 is the button
Seat 1: zombiehedgehog ($14.67 in chips) 
Seat 2: SeaofLove ($13.20 in chips) 
Seat 3: KeithTurbo48 ($13.96 in chips) 
Seat 4: ng2414 ($24.68 in chips) 
Seat 5: PlayTheBlues4U ($8.11 in chips) 
Seat 6: Donkey1206 ($6.85 in chips) 
PlayTheBlues4U: posts small blind $0.05
Donkey1206: posts big blind $0.10
*** HOLE CARDS ***
Dealt to PlayTheBlues4U [2h Kh]
zombiehedgehog: calls $0.10
SeaofLove: folds 
KeithTurbo48: folds 
ng2414: folds 
PlayTheBlues4U: calls $0.05
Donkey1206: checks 
*** FLOP *** [9d Qs Js]
PlayTheBlues4U: checks 
Donkey1206: checks 
zombiehedgehog: bets $0.10
PlayTheBlues4U: folds 
Donkey1206: folds 
Uncalled bet ($0.10) returned to zombiehedgehog
zombiehedgehog collected $0.28 from pot
zombiehedgehog: doesn't show hand 
*** SUMMARY ***
Total pot $0.30 | Rake $0.02 
Board [9d Qs Js]
Seat 1: zombiehedgehog collected ($0.28)
Seat 2: SeaofLove folded before Flop (didn't bet)
Seat 3: KeithTurbo48 folded before Flop (didn't bet)
Seat 4: ng2414 (button) folded before Flop (didn't bet)
Seat 5: PlayTheBlues4U (small blind) folded on the Flop
Seat 6: Donkey1206 (big blind) folded on the Flop


*********** # 22 **************
PokerStars Hand #204909677220: Hold'em No Limit ($0.05/$0.10 USD) - 2019/10/22 22:40:02 ET
Table 'Celuta' 6-max Seat #3 is the button
Seat 1: trumpcaddy ($10.63 in chips) 
Seat 2: SeaofLove ($17.65 in chips) 
Seat 3: ng2414 ($12.72 in chips) 
Seat 4: Jahlah1 ($8.19 in chips) 
Seat 5: KeithTurbo48 ($19.70 in chips) 
Seat 6: PlayTheBlues4U ($10.67 in chips) 
Jahlah1: posts small blind $0.05
KeithTurbo48: posts big blind $0.10
*** HOLE CARDS ***
Dealt to PlayTheBlues4U [Ah 5c]
PlayTheBlues4U: folds 
trumpcaddy: raises $0.20 to $0.30
SeaofLove: calls $0.30
ng2414: folds 
Jahlah1: raises $0.90 to $1.20
KeithTurbo48: folds 
trumpcaddy: calls $0.90
SeaofLove: calls $0.90
*** FLOP *** [5s 8d As]
Jahlah1: bets $1.20
trumpcaddy: folds 
SeaofLove: calls $1.20
*** TURN *** [5s 8d As] [6h]
Jahlah1: checks 
SeaofLove: checks 
*** RIVER *** [5s 8d As 6h] [Jc]
Jahlah1: checks 
SeaofLove: checks 
*** SHOW DOWN ***
Jahlah1: shows [Ks Kd] (a pair of Kings)
SeaofLove: mucks hand 
Jahlah1 collected $5.80 from pot
*** SUMMARY ***
Total pot $6.10 | Rake $0.30 
Board [5s 8d As 6h Jc]
Seat 1: trumpcaddy folded on the Flop
Seat 2: SeaofLove mucked [5d 4d]
Seat 3: ng2414 (button) folded before Flop (didn't bet)
Seat 4: Jahlah1 (small blind) showed [Ks Kd] and won ($5.80) with a pair of Kings
Seat 5: KeithTurbo48 (big blind) folded before Flop
Seat 6: PlayTheBlues4U folded before Flop (didn't bet)


*********** # 23 **************
PokerStars Hand #204909677125: Hold'em No Limit ($0.05/$0.10 USD) - 2019/10/22 22:39:38 ET
Table 'Celuta' 6-max Seat #2 is the button
Seat 1: trumpcaddy ($10.63 in chips) 
Seat 2: SeaofLove ($17.50 in chips) 
Seat 3: ng2414 ($12.77 in chips) 
Seat 4: Jahlah1 ($8.29 in chips) 
Seat 5: KeithTurbo48 ($19.70 in chips) 
Seat 6: PlayTheBlues4U ($10.67 in chips) 
ng2414: posts small blind $0.05
Jahlah1: posts big blind $0.10
*** HOLE CARDS ***
Dealt to PlayTheBlues4U [6s 5h]
KeithTurbo48: folds 
PlayTheBlues4U: folds 
trumpcaddy: folds 
SeaofLove: raises $0.15 to $0.25
ng2414: folds 
Jahlah1: folds 
Uncalled bet ($0.15) returned to SeaofLove
SeaofLove collected $0.25 from pot
SeaofLove: doesn't show hand 
*** SUMMARY ***
Total pot $0.25 | Rake $0 
Seat 1: trumpcaddy folded before Flop (didn't bet)
Seat 2: SeaofLove (button) collected ($0.25)
Seat 3: ng2414 (small blind) folded before Flop
Seat 4: Jahlah1 (big blind) folded before Flop
Seat 5: KeithTurbo48 folded before Flop (didn't bet)
Seat 6: PlayTheBlues4U folded before Flop (didn't bet)


*********** # 24 **************
PokerStars Hand #204909677092: Hold'em No Limit ($0.05/$0.10 USD) - 2019/10/22 22:39:29 ET
Table 'Celuta' 6-max Seat #1 is the button
Seat 1: trumpcaddy ($10.63 in chips) 
Seat 2: SeaofLove ($17.55 in chips) 
Seat 3: ng2414 ($12.72 in chips) 
Seat 4: Jahlah1 ($8.29 in chips) 
Seat 5: KeithTurbo48 ($19.70 in chips) 
Seat 6: PlayTheBlues4U ($10.67 in chips) 
SeaofLove: posts small blind $0.05
ng2414: posts big blind $0.10
*** HOLE CARDS ***
Dealt to PlayTheBlues4U [9d Qs]
Jahlah1: folds 
KeithTurbo48: folds 
PlayTheBlues4U: folds 
trumpcaddy: folds 
SeaofLove: folds 
Uncalled bet ($0.05) returned to ng2414
ng2414 collected $0.10 from pot
*** SUMMARY ***
Total pot $0.10 | Rake $0 
Seat 1: trumpcaddy (button) folded before Flop (didn't bet)
Seat 2: SeaofLove (small blind) folded before Flop
Seat 3: ng2414 (big blind) collected ($0.10)
Seat 4: Jahlah1 folded before Flop (didn't bet)
Seat 5: KeithTurbo48 folded before Flop (didn't bet)
Seat 6: PlayTheBlues4U folded before Flop (didn't bet)


*********** # 25 **************
PokerStars Hand #204909677074: Hold'em No Limit ($0.05/$0.10 USD) - 2019/10/22 22:39:25 ET
Table 'Danae' 6-max Seat #3 is the button
Seat 1: zombiehedgehog ($14.67 in chips) 
Seat 2: SeaofLove ($13.20 in chips) 
Seat 3: KeithTurbo48 ($11.30 in chips) 
Seat 4: ng2414 ($24.73 in chips) 
Seat 5: PlayTheBlues4U ($8.21 in chips) 
Seat 6: Donkey1206 ($9.65 in chips) 
ng2414: posts small blind $0.05
PlayTheBlues4U: posts big blind $0.10
*** HOLE CARDS ***
Dealt to PlayTheBlues4U [9s 2h]
Donkey1206: raises $0.30 to $0.40
zombiehedgehog: folds 
SeaofLove: folds 
KeithTurbo48: calls $0.40
ng2414: folds 
PlayTheBlues4U: folds 
*** FLOP *** [7s 8s 3c]
Donkey1206: checks 
KeithTurbo48: checks 
*** TURN *** [7s 8s 3c] [9d]
Donkey1206: checks 
KeithTurbo48: bets $0.70
Donkey1206: calls $0.70
*** RIVER *** [7s 8s 3c 9d] [5d]
Donkey1206: checks 
KeithTurbo48: bets $1.70
Donkey1206: calls $1.70
*** SHOW DOWN ***
KeithTurbo48: shows [Ah 6h] (a straight, Five to Nine)
Donkey1206: mucks hand 
KeithTurbo48 collected $5.46 from pot
*** SUMMARY ***
Total pot $5.75 | Rake $0.29 
Board [7s 8s 3c 9d 5d]
Seat 1: zombiehedgehog folded before Flop (didn't bet)
Seat 2: SeaofLove folded before Flop (didn't bet)
Seat 3: KeithTurbo48 (button) showed [Ah 6h] and won ($5.46) with a straight, Five to Nine
Seat 4: ng2414 (small blind) folded before Flop
Seat 5: PlayTheBlues4U (big blind) folded before Flop
Seat 6: Donkey1206 mucked [Ad Kc]


*********** # 26 **************
PokerStars Hand #204909677000: Hold'em No Limit ($0.05/$0.10 USD) - 2019/10/22 22:39:06 ET
Table 'Celuta' 6-max Seat #6 is the button
Seat 1: trumpcaddy ($10.68 in chips) 
Seat 2: SeaofLove ($17.50 in chips) 
Seat 3: ng2414 ($12.72 in chips) 
Seat 4: Jahlah1 ($8.29 in chips) 
Seat 5: KeithTurbo48 ($19.70 in chips) 
Seat 6: PlayTheBlues4U ($10.67 in chips) 
trumpcaddy: posts small blind $0.05
SeaofLove: posts big blind $0.10
*** HOLE CARDS ***
Dealt to PlayTheBlues4U [Jc 6c]
ng2414: folds 
Jahlah1: folds 
KeithTurbo48: folds 
PlayTheBlues4U: folds 
trumpcaddy: folds 
Uncalled bet ($0.05) returned to SeaofLove
SeaofLove collected $0.10 from pot
SeaofLove: doesn't show hand 
*** SUMMARY ***
Total pot $0.10 | Rake $0 
Seat 1: trumpcaddy (small blind) folded before Flop
Seat 2: SeaofLove (big blind) collected ($0.10)
Seat 3: ng2414 folded before Flop (didn't bet)
Seat 4: Jahlah1 folded before Flop (didn't bet)
Seat 5: KeithTurbo48 folded before Flop (didn't bet)
Seat 6: PlayTheBlues4U (button) folded before Flop (didn't bet)


*********** # 27 **************
PokerStars Hand #204909676922: Hold'em No Limit ($0.05/$0.10 USD) - 2019/10/22 22:38:47 ET
Table 'Celuta' 6-max Seat #5 is the button
Seat 1: trumpcaddy ($10.78 in chips) 
Seat 2: SeaofLove ($17.50 in chips) 
Seat 3: ng2414 ($12.72 in chips) 
Seat 4: Jahlah1 ($8.29 in chips) 
Seat 5: KeithTurbo48 ($19.55 in chips) 
Seat 6: PlayTheBlues4U ($10.72 in chips) 
PlayTheBlues4U: posts small blind $0.05
trumpcaddy: posts big blind $0.10
*** HOLE CARDS ***
Dealt to PlayTheBlues4U [9c 6h]
SeaofLove: folds 
ng2414: folds 
Jahlah1: folds 
KeithTurbo48: raises $0.15 to $0.25
PlayTheBlues4U: folds 
trumpcaddy: folds 
Uncalled bet ($0.15) returned to KeithTurbo48
KeithTurbo48 collected $0.25 from pot
KeithTurbo48: doesn't show hand 
*** SUMMARY ***
Total pot $0.25 | Rake $0 
Seat 1: trumpcaddy (big blind) folded before Flop
Seat 2: SeaofLove folded before Flop (didn't bet)
Seat 3: ng2414 folded before Flop (didn't bet)
Seat 4: Jahlah1 folded before Flop (didn't bet)
Seat 5: KeithTurbo48 (button) collected ($0.25)
Seat 6: PlayTheBlues4U (small blind) folded before Flop


*********** # 28 **************
PokerStars Hand #204909676907: Hold'em No Limit ($0.05/$0.10 USD) - 2019/10/22 22:38:43 ET
Table 'Danae' 6-max Seat #2 is the button
Seat 1: zombiehedgehog ($14.67 in chips) 
Seat 2: SeaofLove ($13.20 in chips) 
Seat 3: KeithTurbo48 ($11.35 in chips) 
Seat 4: ng2414 ($24.59 in chips) 
Seat 5: PlayTheBlues4U ($8.21 in chips) 
Seat 6: Donkey1206 ($9.75 in chips) 
KeithTurbo48: posts small blind $0.05
ng2414: posts big blind $0.10
*** HOLE CARDS ***
Dealt to PlayTheBlues4U [Ah 4c]
PlayTheBlues4U: folds 
Donkey1206: calls $0.10
zombiehedgehog: folds 
SeaofLove: folds 
KeithTurbo48: folds 
ng2414: checks 
*** FLOP *** [8s 3h 5s]
ng2414: checks 
Donkey1206: checks 
*** TURN *** [8s 3h 5s] [7d]
ng2414: checks 
Donkey1206: checks 
*** RIVER *** [8s 3h 5s 7d] [Qs]
ng2414: bets $0.10
Donkey1206: folds 
Uncalled bet ($0.10) returned to ng2414
ng2414 collected $0.24 from pot
*** SUMMARY ***
Total pot $0.25 | Rake $0.01 
Board [8s 3h 5s 7d Qs]
Seat 1: zombiehedgehog folded before Flop (didn't bet)
Seat 2: SeaofLove (button) folded before Flop (didn't bet)
Seat 3: KeithTurbo48 (small blind) folded before Flop
Seat 4: ng2414 (big blind) collected ($0.24)
Seat 5: PlayTheBlues4U folded before Flop (didn't bet)
Seat 6: Donkey1206 folded on the River


*********** # 29 **************
PokerStars Hand #204909676859: Hold'em No Limit ($0.05/$0.10 USD) - 2019/10/22 22:38:32 ET
Table 'Celuta' 6-max Seat #4 is the button
Seat 1: trumpcaddy ($10.78 in chips) 
Seat 2: SeaofLove ($17.50 in chips) 
Seat 3: ng2414 ($12.72 in chips) 
Seat 4: Jahlah1 ($8.29 in chips) 
Seat 5: KeithTurbo48 ($19.60 in chips) 
Seat 6: PlayTheBlues4U ($10.67 in chips) 
KeithTurbo48: posts small blind $0.05
PlayTheBlues4U: posts big blind $0.10
*** HOLE CARDS ***
Dealt to PlayTheBlues4U [5h 6c]
trumpcaddy: folds 
SeaofLove: folds 
ng2414: folds 
Jahlah1: folds 
KeithTurbo48: folds 
Uncalled bet ($0.05) returned to PlayTheBlues4U
PlayTheBlues4U collected $0.10 from pot
PlayTheBlues4U: doesn't show hand 
*** SUMMARY ***
Total pot $0.10 | Rake $0 
Seat 1: trumpcaddy folded before Flop (didn't bet)
Seat 2: SeaofLove folded before Flop (didn't bet)
Seat 3: ng2414 folded before Flop (didn't bet)
Seat 4: Jahlah1 (button) folded before Flop (didn't bet)
Seat 5: KeithTurbo48 (small blind) folded before Flop
Seat 6: PlayTheBlues4U (big blind) collected ($0.10)


*********** # 30 **************
PokerStars Hand #204909676805: Hold'em No Limit ($0.05/$0.10 USD) - 2019/10/22 22:38:17 ET
Table 'Celuta' 6-max Seat #3 is the button
Seat 1: trumpcaddy ($10.78 in chips) 
Seat 2: SeaofLove ($17.50 in chips) 
Seat 3: ng2414 ($12.72 in chips) 
Seat 4: Jahlah1 ($8.34 in chips) 
Seat 5: KeithTurbo48 ($19.55 in chips) 
Seat 6: PlayTheBlues4U ($10.67 in chips) 
Jahlah1: posts small blind $0.05
KeithTurbo48: posts big blind $0.10
*** HOLE CARDS ***
Dealt to PlayTheBlues4U [Ks 2d]
PlayTheBlues4U: folds 
trumpcaddy: folds 
SeaofLove: folds 
ng2414: folds 
Jahlah1: folds 
Uncalled bet ($0.05) returned to KeithTurbo48
KeithTurbo48 collected $0.10 from pot
*** SUMMARY ***
Total pot $0.10 | Rake $0 
Seat 1: trumpcaddy folded before Flop (didn't bet)
Seat 2: SeaofLove folded before Flop (didn't bet)
Seat 3: ng2414 (button) folded before Flop (didn't bet)
Seat 4: Jahlah1 (small blind) folded before Flop
Seat 5: KeithTurbo48 (big blind) collected ($0.10)
Seat 6: PlayTheBlues4U folded before Flop (didn't bet)


*********** # 31 **************
PokerStars Hand #204909676734: Hold'em No Limit ($0.05/$0.10 USD) - 2019/10/22 22:38:00 ET
Table 'Danae' 6-max Seat #1 is the button
Seat 1: zombiehedgehog ($14.77 in chips) 
Seat 2: SeaofLove ($12.90 in chips) 
Seat 3: KeithTurbo48 ($11.45 in chips) 
Seat 4: ng2414 ($24.59 in chips) 
Seat 5: PlayTheBlues4U ($8.21 in chips) 
Seat 6: Donkey1206 ($9.85 in chips) 
SeaofLove: posts small blind $0.05
KeithTurbo48: posts big blind $0.10
*** HOLE CARDS ***
Dealt to PlayTheBlues4U [Kd 5c]
ng2414: folds 
PlayTheBlues4U: folds 
Donkey1206: calls $0.10
zombiehedgehog: calls $0.10
SeaofLove: raises $0.50 to $0.60
KeithTurbo48: folds 
Donkey1206: folds 
zombiehedgehog: folds 
Uncalled bet ($0.50) returned to SeaofLove
SeaofLove collected $0.40 from pot
SeaofLove: doesn't show hand 
*** SUMMARY ***
Total pot $0.40 | Rake $0 
Seat 1: zombiehedgehog (button) folded before Flop
Seat 2: SeaofLove (small blind) collected ($0.40)
Seat 3: KeithTurbo48 (big blind) folded before Flop
Seat 4: ng2414 folded before Flop (didn't bet)
Seat 5: PlayTheBlues4U folded before Flop (didn't bet)
Seat 6: Donkey1206 folded before Flop


*********** # 32 **************
PokerStars Hand #204909676725: Hold'em No Limit ($0.05/$0.10 USD) - 2019/10/22 22:37:57 ET
Table 'Celuta' 6-max Seat #2 is the button
Seat 1: trumpcaddy ($10.78 in chips) 
Seat 2: SeaofLove ($17.50 in chips) 
Seat 3: ng2414 ($12.77 in chips) 
Seat 4: Jahlah1 ($8.44 in chips) 
Seat 5: KeithTurbo48 ($19.40 in chips) 
Seat 6: PlayTheBlues4U ($10.67 in chips) 
ng2414: posts small blind $0.05
Jahlah1: posts big blind $0.10
*** HOLE CARDS ***
Dealt to PlayTheBlues4U [7d Ac]
KeithTurbo48: raises $0.15 to $0.25
PlayTheBlues4U: folds 
trumpcaddy: folds 
SeaofLove: folds 
ng2414: folds 
Jahlah1: folds 
Uncalled bet ($0.15) returned to KeithTurbo48
KeithTurbo48 collected $0.25 from pot
KeithTurbo48: doesn't show hand 
*** SUMMARY ***
Total pot $0.25 | Rake $0 
Seat 1: trumpcaddy folded before Flop (didn't bet)
Seat 2: SeaofLove (button) folded before Flop (didn't bet)
Seat 3: ng2414 (small blind) folded before Flop
Seat 4: Jahlah1 (big blind) folded before Flop
Seat 5: KeithTurbo48 collected ($0.25)
Seat 6: PlayTheBlues4U folded before Flop (didn't bet)


*********** # 33 **************
PokerStars Hand #204909676524: Hold'em No Limit ($0.05/$0.10 USD) - 2019/10/22 22:37:07 ET
Table 'Danae' 6-max Seat #6 is the button
Seat 1: zombiehedgehog ($14.68 in chips) 
Seat 2: SeaofLove ($13 in chips) 
Seat 3: KeithTurbo48 ($11.45 in chips) 
Seat 4: ng2414 ($24.59 in chips) 
Seat 5: PlayTheBlues4U ($8.21 in chips) 
Seat 6: Donkey1206 ($9.85 in chips) 
zombiehedgehog: posts small blind $0.05
SeaofLove: posts big blind $0.10
*** HOLE CARDS ***
Dealt to PlayTheBlues4U [5d Ac]
KeithTurbo48: folds 
ng2414: folds 
PlayTheBlues4U: folds 
Donkey1206: folds 
zombiehedgehog: calls $0.05
SeaofLove: checks 
*** FLOP *** [8c 9h 2c]
zombiehedgehog: bets $0.10
SeaofLove: folds 
Uncalled bet ($0.10) returned to zombiehedgehog
zombiehedgehog collected $0.19 from pot
zombiehedgehog: doesn't show hand 
*** SUMMARY ***
Total pot $0.20 | Rake $0.01 
Board [8c 9h 2c]
Seat 1: zombiehedgehog (small blind) collected ($0.19)
Seat 2: SeaofLove (big blind) folded on the Flop
Seat 3: KeithTurbo48 folded before Flop (didn't bet)
Seat 4: ng2414 folded before Flop (didn't bet)
Seat 5: PlayTheBlues4U folded before Flop (didn't bet)
Seat 6: Donkey1206 (button) folded before Flop (didn't bet)


*********** # 34 **************
PokerStars Hand #204909676512: Hold'em No Limit ($0.05/$0.10 USD) - 2019/10/22 22:37:04 ET
Table 'Celuta' 6-max Seat #1 is the button
Seat 1: trumpcaddy ($11.28 in chips) 
Seat 2: SeaofLove ($17.55 in chips) 
Seat 3: ng2414 ($12.87 in chips) 
Seat 4: Jahlah1 ($7.85 in chips) 
Seat 5: KeithTurbo48 ($19.40 in chips) 
Seat 6: PlayTheBlues4U ($10.67 in chips) 
SeaofLove: posts small blind $0.05
ng2414: posts big blind $0.10
*** HOLE CARDS ***
Dealt to PlayTheBlues4U [7h Qd]
Jahlah1: calls $0.10
KeithTurbo48: folds 
PlayTheBlues4U: folds 
trumpcaddy: raises $0.40 to $0.50
SeaofLove: folds 
ng2414: folds 
Jahlah1: calls $0.40
*** FLOP *** [8c Jc Js]
Jahlah1: checks 
trumpcaddy: checks 
*** TURN *** [8c Jc Js] [9s]
Jahlah1: bets $0.40
trumpcaddy: folds 
Uncalled bet ($0.40) returned to Jahlah1
Jahlah1 collected $1.09 from pot
Jahlah1: doesn't show hand 
*** SUMMARY ***
Total pot $1.15 | Rake $0.06 
Board [8c Jc Js 9s]
Seat 1: trumpcaddy (button) folded on the Turn
Seat 2: SeaofLove (small blind) folded before Flop
Seat 3: ng2414 (big blind) folded before Flop
Seat 4: Jahlah1 collected ($1.09)
Seat 5: KeithTurbo48 folded before Flop (didn't bet)
Seat 6: PlayTheBlues4U folded before Flop (didn't bet)


*********** # 35 **************
PokerStars Hand #204909676456: Hold'em No Limit ($0.05/$0.10 USD) - 2019/10/22 22:36:50 ET
Table 'Celuta' 6-max Seat #6 is the button
Seat 1: trumpcaddy ($11.33 in chips) 
Seat 2: SeaofLove ($17.50 in chips) 
Seat 3: ng2414 ($12.87 in chips) 
Seat 4: Jahlah1 ($7.85 in chips) 
Seat 5: KeithTurbo48 ($19.40 in chips) 
Seat 6: PlayTheBlues4U ($10.67 in chips) 
trumpcaddy: posts small blind $0.05
SeaofLove: posts big blind $0.10
*** HOLE CARDS ***
Dealt to PlayTheBlues4U [2d 9h]
ng2414: folds 
Jahlah1: folds 
KeithTurbo48: folds 
PlayTheBlues4U: folds 
trumpcaddy: folds 
Uncalled bet ($0.05) returned to SeaofLove
SeaofLove collected $0.10 from pot
SeaofLove: doesn't show hand 
*** SUMMARY ***
Total pot $0.10 | Rake $0 
Seat 1: trumpcaddy (small blind) folded before Flop
Seat 2: SeaofLove (big blind) collected ($0.10)
Seat 3: ng2414 folded before Flop (didn't bet)
Seat 4: Jahlah1 folded before Flop (didn't bet)
Seat 5: KeithTurbo48 folded before Flop (didn't bet)
Seat 6: PlayTheBlues4U (button) folded before Flop (didn't bet)


*********** # 36 **************
PokerStars Hand #204909676332: Hold'em No Limit ($0.05/$0.10 USD) - 2019/10/22 22:36:19 ET
Table 'Danae' 6-max Seat #5 is the button
Seat 1: zombiehedgehog ($14.78 in chips) 
Seat 2: SeaofLove ($13 in chips) 
Seat 3: KeithTurbo48 ($9.82 in chips) 
Seat 4: ng2414 ($24.59 in chips) 
Seat 5: PlayTheBlues4U ($9.86 in chips) 
Seat 6: Donkey1206 ($9.90 in chips) 
Donkey1206: posts small blind $0.05
zombiehedgehog: posts big blind $0.10
*** HOLE CARDS ***
Dealt to PlayTheBlues4U [Kc Ah]
SeaofLove: folds 
KeithTurbo48: raises $0.15 to $0.25
ng2414: folds 
PlayTheBlues4U: raises $0.50 to $0.75
Donkey1206: folds 
zombiehedgehog: folds 
KeithTurbo48: calls $0.50
*** FLOP *** [Ts 3d 6h]
KeithTurbo48: checks 
PlayTheBlues4U: bets $0.90
KeithTurbo48: calls $0.90
*** TURN *** [Ts 3d 6h] [Qh]
KeithTurbo48: checks 
PlayTheBlues4U: checks 
*** RIVER *** [Ts 3d 6h Qh] [2d]
KeithTurbo48: checks 
PlayTheBlues4U: checks 
*** SHOW DOWN ***
KeithTurbo48: shows [As 6s] (a pair of Sixes)
PlayTheBlues4U: mucks hand 
KeithTurbo48 collected $3.28 from pot
*** SUMMARY ***
Total pot $3.45 | Rake $0.17 
Board [Ts 3d 6h Qh 2d]
Seat 1: zombiehedgehog (big blind) folded before Flop
Seat 2: SeaofLove folded before Flop (didn't bet)
Seat 3: KeithTurbo48 showed [As 6s] and won ($3.28) with a pair of Sixes
Seat 4: ng2414 folded before Flop (didn't bet)
Seat 5: PlayTheBlues4U (button) mucked [Kc Ah]
Seat 6: Donkey1206 (small blind) folded before Flop


*********** # 37 **************
PokerStars Hand #204909676205: Hold'em No Limit ($0.05/$0.10 USD) - 2019/10/22 22:35:48 ET
Table 'Celuta' 6-max Seat #5 is the button
Seat 1: trumpcaddy ($11.43 in chips) 
Seat 2: SeaofLove ($17.50 in chips) 
Seat 3: ng2414 ($12.87 in chips) 
Seat 4: Jahlah1 ($7.85 in chips) 
Seat 5: KeithTurbo48 ($20.15 in chips) 
Seat 6: PlayTheBlues4U ($9.90 in chips) 
PlayTheBlues4U: posts small blind $0.05
trumpcaddy: posts big blind $0.10
*** HOLE CARDS ***
Dealt to PlayTheBlues4U [Ah 5h]
SeaofLove: folds 
ng2414: folds 
Jahlah1: folds 
KeithTurbo48: raises $0.15 to $0.25
PlayTheBlues4U: raises $0.50 to $0.75
trumpcaddy: folds 
KeithTurbo48: calls $0.50
*** FLOP *** [7h Kd Ac]
PlayTheBlues4U: bets $0.90
KeithTurbo48: folds 
Uncalled bet ($0.90) returned to PlayTheBlues4U
PlayTheBlues4U collected $1.52 from pot
PlayTheBlues4U: doesn't show hand 
*** SUMMARY ***
Total pot $1.60 | Rake $0.08 
Board [7h Kd Ac]
Seat 1: trumpcaddy (big blind) folded before Flop
Seat 2: SeaofLove folded before Flop (didn't bet)
Seat 3: ng2414 folded before Flop (didn't bet)
Seat 4: Jahlah1 folded before Flop (didn't bet)
Seat 5: KeithTurbo48 (button) folded on the Flop
Seat 6: PlayTheBlues4U (small blind) collected ($1.52)


*********** # 38 **************
PokerStars Hand #204909676174: Hold'em No Limit ($0.05/$0.10 USD) - 2019/10/22 22:35:41 ET
Table 'Danae' 6-max Seat #4 is the button
Seat 1: zombiehedgehog ($14.88 in chips) 
Seat 2: SeaofLove ($12.36 in chips) 
Seat 3: KeithTurbo48 ($10.27 in chips) 
Seat 4: ng2414 ($24.59 in chips) 
Seat 5: PlayTheBlues4U ($9.91 in chips) 
Seat 6: Donkey1206 ($10 in chips) 
PlayTheBlues4U: posts small blind $0.05
Donkey1206: posts big blind $0.10
*** HOLE CARDS ***
Dealt to PlayTheBlues4U [7s Qd]
zombiehedgehog: calls $0.10
SeaofLove: raises $0.35 to $0.45
KeithTurbo48: calls $0.45
ng2414: folds 
PlayTheBlues4U: folds 
Donkey1206: folds 
zombiehedgehog: folds 
*** FLOP *** [8d Ks 2c]
SeaofLove: checks 
KeithTurbo48: checks 
*** TURN *** [8d Ks 2c] [Qs]
SeaofLove: bets $0.50
KeithTurbo48: folds 
Uncalled bet ($0.50) returned to SeaofLove
SeaofLove collected $1.09 from pot
SeaofLove: doesn't show hand 
*** SUMMARY ***
Total pot $1.15 | Rake $0.06 
Board [8d Ks 2c Qs]
Seat 1: zombiehedgehog folded before Flop
Seat 2: SeaofLove collected ($1.09)
Seat 3: KeithTurbo48 folded on the Turn
Seat 4: ng2414 (button) folded before Flop (didn't bet)
Seat 5: PlayTheBlues4U (small blind) folded before Flop
Seat 6: Donkey1206 (big blind) folded before Flop


*********** # 39 **************
PokerStars Hand #204909676086: Hold'em No Limit ($0.05/$0.10 USD) - 2019/10/22 22:35:22 ET
Table 'Celuta' 6-max Seat #4 is the button
Seat 1: trumpcaddy ($11.53 in chips) 
Seat 2: SeaofLove ($17.50 in chips) 
Seat 3: ng2414 ($12.87 in chips) 
Seat 4: Jahlah1 ($7.85 in chips) 
Seat 5: KeithTurbo48 ($19.97 in chips) 
Seat 6: PlayTheBlues4U ($10 in chips) 
KeithTurbo48: posts small blind $0.05
PlayTheBlues4U: posts big blind $0.10
*** HOLE CARDS ***
Dealt to PlayTheBlues4U [2h Jc]
trumpcaddy: calls $0.10
SeaofLove: folds 
ng2414: folds 
Jahlah1: folds 
KeithTurbo48: calls $0.05
PlayTheBlues4U: checks 
*** FLOP *** [4h As 7h]
KeithTurbo48: bets $0.20
PlayTheBlues4U: folds 
trumpcaddy: folds 
Uncalled bet ($0.20) returned to KeithTurbo48
KeithTurbo48 collected $0.28 from pot
KeithTurbo48: doesn't show hand 
*** SUMMARY ***
Total pot $0.30 | Rake $0.02 
Board [4h As 7h]
Seat 1: trumpcaddy folded on the Flop
Seat 2: SeaofLove folded before Flop (didn't bet)
Seat 3: ng2414 folded before Flop (didn't bet)
Seat 4: Jahlah1 (button) folded before Flop (didn't bet)
Seat 5: KeithTurbo48 (small blind) collected ($0.28)
Seat 6: PlayTheBlues4U (big blind) folded on the Flop


*********** # 40 **************
PokerStars Hand #204909676010: Hold'em No Limit ($0.05/$0.10 USD) - 2019/10/22 22:35:03 ET
Table 'Celuta' 6-max Seat #3 is the button
Seat 1: trumpcaddy ($11.53 in chips) 
Seat 2: SeaofLove ($17.50 in chips) 
Seat 3: ng2414 ($12.87 in chips) 
Seat 4: Jahlah1 ($7.90 in chips) 
Seat 5: KeithTurbo48 ($19.92 in chips) 
Seat 6: PlayTheBlues4U ($10 in chips) 
Jahlah1: posts small blind $0.05
KeithTurbo48: posts big blind $0.10
*** HOLE CARDS ***
Dealt to PlayTheBlues4U [8s 3s]
PlayTheBlues4U: folds 
trumpcaddy: folds 
SeaofLove: folds 
ng2414: folds 
Jahlah1: folds 
Uncalled bet ($0.05) returned to KeithTurbo48
KeithTurbo48 collected $0.10 from pot
KeithTurbo48: doesn't show hand 
*** SUMMARY ***
Total pot $0.10 | Rake $0 
Seat 1: trumpcaddy folded before Flop (didn't bet)
Seat 2: SeaofLove folded before Flop (didn't bet)
Seat 3: ng2414 (button) folded before Flop (didn't bet)
Seat 4: Jahlah1 (small blind) folded before Flop
Seat 5: KeithTurbo48 (big blind) collected ($0.10)
Seat 6: PlayTheBlues4U folded before Flop (didn't bet)


*********** # 41 **************
PokerStars Hand #204909675903: Hold'em No Limit ($0.05/$0.10 USD) - 2019/10/22 22:34:39 ET
Table 'Danae' 6-max Seat #3 is the button
Seat 1: zombiehedgehog ($15.18 in chips) 
Seat 2: SeaofLove ($12.36 in chips) 
Seat 3: KeithTurbo48 ($10.27 in chips) 
Seat 4: ng2414 ($24.69 in chips) 
Seat 5: PlayTheBlues4U ($9.55 in chips) 
Seat 6: Donkey1206 ($6.09 in chips) 
ng2414: posts small blind $0.05
PlayTheBlues4U: posts big blind $0.10
*** HOLE CARDS ***
Dealt to PlayTheBlues4U [Kh Qs]
Donkey1206: folds 
zombiehedgehog: calls $0.10
SeaofLove: folds 
KeithTurbo48: folds 
ng2414: calls $0.05
PlayTheBlues4U: raises $0.20 to $0.30
zombiehedgehog: calls $0.20
ng2414: folds 
*** FLOP *** [3c Js 9c]
PlayTheBlues4U: checks 
zombiehedgehog: checks 
*** TURN *** [3c Js 9c] [Ts]
PlayTheBlues4U: bets $0.50
zombiehedgehog: folds 
Uncalled bet ($0.50) returned to PlayTheBlues4U
PlayTheBlues4U collected $0.66 from pot
PlayTheBlues4U: doesn't show hand 
*** SUMMARY ***
Total pot $0.70 | Rake $0.04 
Board [3c Js 9c Ts]
Seat 1: zombiehedgehog folded on the Turn
Seat 2: SeaofLove folded before Flop (didn't bet)
Seat 3: KeithTurbo48 (button) folded before Flop (didn't bet)
Seat 4: ng2414 (small blind) folded before Flop
Seat 5: PlayTheBlues4U (big blind) collected ($0.66)
Seat 6: Donkey1206 folded before Flop (didn't bet)


*********** # 42 **************
PokerStars Hand #204909675662: Hold'em No Limit ($0.05/$0.10 USD) - 2019/10/22 22:33:43 ET
Table 'Danae' 6-max Seat #2 is the button
Seat 1: zombiehedgehog ($11.52 in chips) 
Seat 2: SeaofLove ($12.36 in chips) 
Seat 3: KeithTurbo48 ($10.32 in chips) 
Seat 4: ng2414 ($24.79 in chips) 
Seat 5: PlayTheBlues4U ($9.55 in chips) 
Seat 6: Donkey1206 ($10 in chips) 
KeithTurbo48: posts small blind $0.05
ng2414: posts big blind $0.10
*** HOLE CARDS ***
Dealt to PlayTheBlues4U [6h 7h]
PlayTheBlues4U: folds 
Donkey1206: raises $0.30 to $0.40
zombiehedgehog: calls $0.40
SeaofLove: folds 
KeithTurbo48: folds 
ng2414: folds 
*** FLOP *** [8h Ad 3s]
Donkey1206: checks 
zombiehedgehog: bets $0.90
Donkey1206: calls $0.90
*** TURN *** [8h Ad 3s] [Td]
Donkey1206: checks 
zombiehedgehog: bets $2.61
Donkey1206: calls $2.61
*** RIVER *** [8h Ad 3s Td] [Js]
Donkey1206: checks 
zombiehedgehog: checks 
*** SHOW DOWN ***
Donkey1206: shows [Qd As] (a pair of Aces)
zombiehedgehog: shows [Kh Ah] (a pair of Aces - King kicker)
zombiehedgehog collected $7.57 from pot
*** SUMMARY ***
Total pot $7.97 | Rake $0.40 
Board [8h Ad 3s Td Js]
Seat 1: zombiehedgehog showed [Kh Ah] and won ($7.57) with a pair of Aces
Seat 2: SeaofLove (button) folded before Flop (didn't bet)
Seat 3: KeithTurbo48 (small blind) folded before Flop
Seat 4: ng2414 (big blind) folded before Flop
Seat 5: PlayTheBlues4U folded before Flop (didn't bet)
Seat 6: Donkey1206 showed [Qd As] and lost with a pair of Aces


*********** # 43 **************
PokerStars Hand #204909675400: Hold'em No Limit ($0.05/$0.10 USD) - 2019/10/22 22:32:40 ET
Table 'Celuta' 6-max Seat #2 is the button
Seat 1: trumpcaddy ($11.53 in chips) 
Seat 2: SeaofLove ($17.50 in chips) 
Seat 3: ng2414 ($9.63 in chips) 
Seat 4: Jahlah1 ($8 in chips) 
Seat 5: KeithTurbo48 ($19.92 in chips) 
Seat 6: PlayTheBlues4U ($9.59 in chips) 
ng2414: posts small blind $0.05
Jahlah1: posts big blind $0.10
*** HOLE CARDS ***
Dealt to PlayTheBlues4U [Js Jc]
KeithTurbo48: folds 
PlayTheBlues4U: raises $0.20 to $0.30
trumpcaddy: folds 
SeaofLove: folds 
ng2414: raises $0.70 to $1
Jahlah1: folds 
PlayTheBlues4U: calls $0.70
*** FLOP *** [4h Th 2s]
ng2414: bets $0.80
PlayTheBlues4U: calls $0.80
*** TURN *** [4h Th 2s] [6d]
ng2414: bets $1.70
PlayTheBlues4U: calls $1.70
*** RIVER *** [4h Th 2s 6d] [9h]
ng2414: bets $3.50
PlayTheBlues4U: folds 
Uncalled bet ($3.50) returned to ng2414
ng2414 collected $6.74 from pot
*** SUMMARY ***
Total pot $7.10 | Rake $0.36 
Board [4h Th 2s 6d 9h]
Seat 1: trumpcaddy folded before Flop (didn't bet)
Seat 2: SeaofLove (button) folded before Flop (didn't bet)
Seat 3: ng2414 (small blind) collected ($6.74)
Seat 4: Jahlah1 (big blind) folded before Flop
Seat 5: KeithTurbo48 folded before Flop (didn't bet)
Seat 6: PlayTheBlues4U folded on the River


*********** # 44 **************
PokerStars Hand #204909675355: Hold'em No Limit ($0.05/$0.10 USD) - 2019/10/22 22:32:29 ET
Table 'Danae' 6-max Seat #1 is the button
Seat 1: zombiehedgehog ($10.12 in chips) 
Seat 2: SeaofLove ($12.41 in chips) 
Seat 3: KeithTurbo48 ($10.42 in chips) 
Seat 4: ng2414 ($24.79 in chips) 
Seat 5: PlayTheBlues4U ($9.55 in chips) 
Seat 6: Donkey1206 ($9.85 in chips) 
SeaofLove: posts small blind $0.05
KeithTurbo48: posts big blind $0.10
*** HOLE CARDS ***
Dealt to PlayTheBlues4U [9c Ad]
ng2414: folds 
PlayTheBlues4U: folds 
Donkey1206: calls $0.10
zombiehedgehog: raises $0.35 to $0.45
SeaofLove: folds 
KeithTurbo48: folds 
Donkey1206: calls $0.35
*** FLOP *** [8d Ks 5h]
Donkey1206: checks 
zombiehedgehog: bets $0.25
Donkey1206: calls $0.25
*** TURN *** [8d Ks 5h] [8c]
Donkey1206: checks 
zombiehedgehog: checks 
*** RIVER *** [8d Ks 5h 8c] [2d]
Donkey1206: bets $0.70
zombiehedgehog: raises $2.87 to $3.57
Donkey1206: folds 
Uncalled bet ($2.87) returned to zombiehedgehog
zombiehedgehog collected $2.80 from pot
zombiehedgehog: doesn't show hand 
*** SUMMARY ***
Total pot $2.95 | Rake $0.15 
Board [8d Ks 5h 8c 2d]
Seat 1: zombiehedgehog (button) collected ($2.80)
Seat 2: SeaofLove (small blind) folded before Flop
Seat 3: KeithTurbo48 (big blind) folded before Flop
Seat 4: ng2414 folded before Flop (didn't bet)
Seat 5: PlayTheBlues4U folded before Flop (didn't bet)
Seat 6: Donkey1206 folded on the River


*********** # 45 **************
PokerStars Hand #204909675281: Hold'em No Limit ($0.05/$0.10 USD) - 2019/10/22 22:32:11 ET
Table 'Danae' 6-max Seat #6 is the button
Seat 1: zombiehedgehog ($10.17 in chips) 
Seat 2: SeaofLove ($12.51 in chips) 
Seat 3: KeithTurbo48 ($10.42 in chips) 
Seat 4: ng2414 ($24.64 in chips) 
Seat 5: PlayTheBlues4U ($9.55 in chips) 
Seat 6: Donkey1206 ($9.85 in chips) 
zombiehedgehog: posts small blind $0.05
SeaofLove: posts big blind $0.10
*** HOLE CARDS ***
Dealt to PlayTheBlues4U [6c 2c]
KeithTurbo48: folds 
ng2414: raises $0.20 to $0.30
PlayTheBlues4U: folds 
Donkey1206: folds 
zombiehedgehog: folds 
SeaofLove: folds 
Uncalled bet ($0.20) returned to ng2414
ng2414 collected $0.25 from pot
*** SUMMARY ***
Total pot $0.25 | Rake $0 
Seat 1: zombiehedgehog (small blind) folded before Flop
Seat 2: SeaofLove (big blind) folded before Flop
Seat 3: KeithTurbo48 folded before Flop (didn't bet)
Seat 4: ng2414 collected ($0.25)
Seat 5: PlayTheBlues4U folded before Flop (didn't bet)
Seat 6: Donkey1206 (button) folded before Flop (didn't bet)


*********** # 46 **************
PokerStars Hand #204909675242: Hold'em No Limit ($0.05/$0.10 USD) - 2019/10/22 22:32:03 ET
Table 'Celuta' 6-max Seat #1 is the button
Seat 1: trumpcaddy ($11.53 in chips) 
Seat 2: SeaofLove ($17.55 in chips) 
Seat 3: ng2414 ($8.53 in chips) 
Seat 5: KeithTurbo48 ($20.17 in chips) 
Seat 6: PlayTheBlues4U ($10.49 in chips) 
SeaofLove: posts small blind $0.05
ng2414: posts big blind $0.10
*** HOLE CARDS ***
Dealt to PlayTheBlues4U [2s 2c]
KeithTurbo48: raises $0.15 to $0.25
PlayTheBlues4U: calls $0.25
trumpcaddy: folds 
SeaofLove: folds 
ng2414: raises $0.65 to $0.90
Jahlah1 joins the table at seat #4 
KeithTurbo48: folds 
PlayTheBlues4U: calls $0.65
*** FLOP *** [Js Qs 4d]
ng2414: bets $0.80
PlayTheBlues4U: folds 
Uncalled bet ($0.80) returned to ng2414
ng2414 collected $2 from pot
*** SUMMARY ***
Total pot $2.10 | Rake $0.10 
Board [Js Qs 4d]
Seat 1: trumpcaddy (button) folded before Flop (didn't bet)
Seat 2: SeaofLove (small blind) folded before Flop
Seat 3: ng2414 (big blind) collected ($2)
Seat 5: KeithTurbo48 folded before Flop
Seat 6: PlayTheBlues4U folded on the Flop


*********** # 47 **************
PokerStars Hand #204909675140: Hold'em No Limit ($0.05/$0.10 USD) - 2019/10/22 22:31:38 ET
Table 'Celuta' 6-max Seat #6 is the button
Seat 1: trumpcaddy ($11.58 in chips) 
Seat 2: SeaofLove ($17.80 in chips) 
Seat 3: ng2414 ($8.53 in chips) 
Seat 4: pancakes1912 ($11.28 in chips) 
Seat 5: KeithTurbo48 ($19.90 in chips) 
Seat 6: PlayTheBlues4U ($10.49 in chips) 
trumpcaddy: posts small blind $0.05
SeaofLove: posts big blind $0.10
*** HOLE CARDS ***
Dealt to PlayTheBlues4U [6s 8d]
ng2414: folds 
pancakes1912: folds 
pancakes1912 leaves the table
KeithTurbo48: raises $0.15 to $0.25
PlayTheBlues4U: folds 
trumpcaddy: folds 
SeaofLove: calls $0.15
*** FLOP *** [2c 8h Ac]
SeaofLove: checks 
KeithTurbo48: bets $0.17
SeaofLove: folds 
Uncalled bet ($0.17) returned to KeithTurbo48
KeithTurbo48 collected $0.52 from pot
KeithTurbo48: doesn't show hand 
*** SUMMARY ***
Total pot $0.55 | Rake $0.03 
Board [2c 8h Ac]
Seat 1: trumpcaddy (small blind) folded before Flop
Seat 2: SeaofLove (big blind) folded on the Flop
Seat 3: ng2414 folded before Flop (didn't bet)
Seat 4: pancakes1912 folded before Flop (didn't bet)
Seat 5: KeithTurbo48 collected ($0.52)
Seat 6: PlayTheBlues4U (button) folded before Flop (didn't bet)


*********** # 48 **************
PokerStars Hand #204909675101: Hold'em No Limit ($0.05/$0.10 USD) - 2019/10/22 22:31:29 ET
Table 'Danae' 6-max Seat #5 is the button
Seat 1: zombiehedgehog ($11.57 in chips) 
Seat 2: SeaofLove ($12.51 in chips) 
Seat 3: KeithTurbo48 ($10.42 in chips) 
Seat 4: ng2414 ($23.33 in chips) 
Seat 5: PlayTheBlues4U ($9.55 in chips) 
Seat 6: Donkey1206 ($9.90 in chips) 
Donkey1206: posts small blind $0.05
zombiehedgehog: posts big blind $0.10
*** HOLE CARDS ***
Dealt to PlayTheBlues4U [Qd 3d]
SeaofLove: folds 
KeithTurbo48: folds 
ng2414: raises $0.20 to $0.30
PlayTheBlues4U: folds 
Donkey1206: folds 
zombiehedgehog: calls $0.20
*** FLOP *** [Js As Jc]
zombiehedgehog: checks 
ng2414: bets $0.40
zombiehedgehog: calls $0.40
*** TURN *** [Js As Jc] [Kd]
zombiehedgehog: checks 
ng2414: bets $0.70
zombiehedgehog: calls $0.70
*** RIVER *** [Js As Jc Kd] [8d]
zombiehedgehog: checks 
ng2414: checks 
*** SHOW DOWN ***
zombiehedgehog: shows [8s Ts] (two pair, Jacks and Eights)
ng2414: shows [Ks 5s] (two pair, Kings and Jacks)
ng2414 collected $2.71 from pot
*** SUMMARY ***
Total pot $2.85 | Rake $0.14 
Board [Js As Jc Kd 8d]
Seat 1: zombiehedgehog (big blind) showed [8s Ts] and lost with two pair, Jacks and Eights
Seat 2: SeaofLove folded before Flop (didn't bet)
Seat 3: KeithTurbo48 folded before Flop (didn't bet)
Seat 4: ng2414 showed [Ks 5s] and won ($2.71) with two pair, Kings and Jacks
Seat 5: PlayTheBlues4U (button) folded before Flop (didn't bet)
Seat 6: Donkey1206 (small blind) folded before Flop


*********** # 49 **************
PokerStars Hand #204909675013: Hold'em No Limit ($0.05/$0.10 USD) - 2019/10/22 22:31:09 ET
Table 'Danae' 6-max Seat #4 is the button
Seat 1: zombiehedgehog ($11.57 in chips) 
Seat 2: SeaofLove ($12.36 in chips) 
Seat 3: KeithTurbo48 ($10.42 in chips) 
Seat 4: ng2414 ($23.33 in chips) 
Seat 5: PlayTheBlues4U ($9.60 in chips) 
Seat 6: Donkey1206 ($10 in chips) 
PlayTheBlues4U: posts small blind $0.05
Donkey1206: posts big blind $0.10
*** HOLE CARDS ***
Dealt to PlayTheBlues4U [5d 8d]
zombiehedgehog: folds 
SeaofLove: raises $0.15 to $0.25
KeithTurbo48: folds 
ng2414: folds 
PlayTheBlues4U: folds 
Donkey1206: folds 
Uncalled bet ($0.15) returned to SeaofLove
SeaofLove collected $0.25 from pot
SeaofLove: doesn't show hand 
*** SUMMARY ***
Total pot $0.25 | Rake $0 
Seat 1: zombiehedgehog folded before Flop (didn't bet)
Seat 2: SeaofLove collected ($0.25)
Seat 3: KeithTurbo48 folded before Flop (didn't bet)
Seat 4: ng2414 (button) folded before Flop (didn't bet)
Seat 5: PlayTheBlues4U (small blind) folded before Flop
Seat 6: Donkey1206 (big blind) folded before Flop


*********** # 50 **************
PokerStars Hand #204909674838: Hold'em No Limit ($0.05/$0.10 USD) - 2019/10/22 22:30:29 ET
Table 'Celuta' 6-max Seat #5 is the button
Seat 1: trumpcaddy ($10.15 in chips) 
Seat 2: SeaofLove ($17.80 in chips) 
Seat 3: ng2414 ($8.53 in chips) 
Seat 4: pancakes1912 ($12.82 in chips) 
Seat 5: KeithTurbo48 ($19.90 in chips) 
Seat 6: PlayTheBlues4U ($10.54 in chips) 
PlayTheBlues4U: posts small blind $0.05
trumpcaddy: posts big blind $0.10
*** HOLE CARDS ***
Dealt to PlayTheBlues4U [7d Jh]
SeaofLove: folds 
ng2414: folds 
pancakes1912: calls $0.10
KeithTurbo48: folds 
PlayTheBlues4U: folds 
trumpcaddy: checks 
*** FLOP *** [Td 9c 3h]
trumpcaddy: checks 
pancakes1912: checks 
*** TURN *** [Td 9c 3h] [Kc]
trumpcaddy: checks 
pancakes1912: bets $0.20
trumpcaddy: calls $0.20
*** RIVER *** [Td 9c 3h Kc] [Jc]
trumpcaddy: bets $0.62
pancakes1912: raises $0.62 to $1.24
trumpcaddy: calls $0.62
*** SHOW DOWN ***
pancakes1912: shows [6c 4c] (a flush, King high)
trumpcaddy: shows [3c Qc] (a flush, King high - Queen higher)
trumpcaddy collected $2.97 from pot
*** SUMMARY ***
Total pot $3.13 | Rake $0.16 
Board [Td 9c 3h Kc Jc]
Seat 1: trumpcaddy (big blind) showed [3c Qc] and won ($2.97) with a flush, King high
Seat 2: SeaofLove folded before Flop (didn't bet)
Seat 3: ng2414 folded before Flop (didn't bet)
Seat 4: pancakes1912 showed [6c 4c] and lost with a flush, King high
Seat 5: KeithTurbo48 (button) folded before Flop (didn't bet)
Seat 6: PlayTheBlues4U (small blind) folded before Flop


*********** # 51 **************
PokerStars Hand #204909674806: Hold'em No Limit ($0.05/$0.10 USD) - 2019/10/22 22:30:19 ET
Table 'Danae' 6-max Seat #3 is the button
Seat 1: zombiehedgehog ($11.57 in chips) 
Seat 2: SeaofLove ($12.36 in chips) 
Seat 3: KeithTurbo48 ($10.84 in chips) 
Seat 4: ng2414 ($23.38 in chips) 
Seat 5: PlayTheBlues4U ($9.17 in chips) 
ng2414: posts small blind $0.05
PlayTheBlues4U: posts big blind $0.10
*** HOLE CARDS ***
Dealt to PlayTheBlues4U [Qd Ts]
zombiehedgehog: folds 
SeaofLove: folds 
KeithTurbo48: raises $0.15 to $0.25
ng2414: folds 
Donkey1206 joins the table at seat #6 
PlayTheBlues4U: calls $0.15
*** FLOP *** [6s Ac 3d]
PlayTheBlues4U: checks 
KeithTurbo48: bets $0.17
PlayTheBlues4U: calls $0.17
*** TURN *** [6s Ac 3d] [4c]
PlayTheBlues4U: checks 
KeithTurbo48: checks 
*** RIVER *** [6s Ac 3d 4c] [2s]
PlayTheBlues4U: bets $0.60
KeithTurbo48: folds 
Uncalled bet ($0.60) returned to PlayTheBlues4U
PlayTheBlues4U collected $0.85 from pot
PlayTheBlues4U: doesn't show hand 
*** SUMMARY ***
Total pot $0.89 | Rake $0.04 
Board [6s Ac 3d 4c 2s]
Seat 1: zombiehedgehog folded before Flop (didn't bet)
Seat 2: SeaofLove folded before Flop (didn't bet)
Seat 3: KeithTurbo48 (button) folded on the River
Seat 4: ng2414 (small blind) folded before Flop
Seat 5: PlayTheBlues4U (big blind) collected ($0.85)


*********** # 52 **************
PokerStars Hand #204909674774: Hold'em No Limit ($0.05/$0.10 USD) - 2019/10/22 22:30:13 ET
Table 'Celuta' 6-max Seat #4 is the button
Seat 1: trumpcaddy ($10 in chips) 
Seat 2: SeaofLove ($17.80 in chips) 
Seat 3: ng2414 ($8.53 in chips) 
Seat 4: pancakes1912 ($12.82 in chips) 
Seat 5: KeithTurbo48 ($19.95 in chips) 
Seat 6: PlayTheBlues4U ($10.64 in chips) 
KeithTurbo48: posts small blind $0.05
PlayTheBlues4U: posts big blind $0.10
*** HOLE CARDS ***
Dealt to PlayTheBlues4U [Qh 5h]
trumpcaddy: raises $0.20 to $0.30
SeaofLove: folds 
ng2414: folds 
pancakes1912: folds 
KeithTurbo48: folds 
PlayTheBlues4U: folds 
Uncalled bet ($0.20) returned to trumpcaddy
trumpcaddy collected $0.25 from pot
trumpcaddy: doesn't show hand 
*** SUMMARY ***
Total pot $0.25 | Rake $0 
Seat 1: trumpcaddy collected ($0.25)
Seat 2: SeaofLove folded before Flop (didn't bet)
Seat 3: ng2414 folded before Flop (didn't bet)
Seat 4: pancakes1912 (button) folded before Flop (didn't bet)
Seat 5: KeithTurbo48 (small blind) folded before Flop
Seat 6: PlayTheBlues4U (big blind) folded before Flop


*********** # 53 **************
PokerStars Hand #204909674732: Hold'em No Limit ($0.05/$0.10 USD) - 2019/10/22 22:30:02 ET
Table 'Danae' 6-max Seat #2 is the button
Seat 1: zombiehedgehog ($11.57 in chips) 
Seat 2: SeaofLove ($12.21 in chips) 
Seat 3: KeithTurbo48 ($10.89 in chips) 
Seat 4: ng2414 ($23.48 in chips) 
Seat 5: PlayTheBlues4U ($9.17 in chips) 
KeithTurbo48: posts small blind $0.05
ng2414: posts big blind $0.10
*** HOLE CARDS ***
Dealt to PlayTheBlues4U [8s Jh]
PlayTheBlues4U: folds 
zombiehedgehog: folds 
SeaofLove: raises $0.15 to $0.25
KeithTurbo48: folds 
ng2414: folds 
Uncalled bet ($0.15) returned to SeaofLove
SeaofLove collected $0.25 from pot
SeaofLove: doesn't show hand 
*** SUMMARY ***
Total pot $0.25 | Rake $0 
Seat 1: zombiehedgehog folded before Flop (didn't bet)
Seat 2: SeaofLove (button) collected ($0.25)
Seat 3: KeithTurbo48 (small blind) folded before Flop
Seat 4: ng2414 (big blind) folded before Flop
Seat 5: PlayTheBlues4U folded before Flop (didn't bet)


*********** # 54 **************
PokerStars Hand #204909674592: Hold'em No Limit ($0.05/$0.10 USD) - 2019/10/22 22:29:25 ET
Table 'Danae' 6-max Seat #1 is the button
Seat 1: zombiehedgehog ($11.57 in chips) 
Seat 2: SeaofLove ($12.26 in chips) 
Seat 3: KeithTurbo48 ($10.84 in chips) 
Seat 4: ng2414 ($23.48 in chips) 
Seat 5: PlayTheBlues4U ($9.17 in chips) 
Seat 6: x Aristokat x ($9.53 in chips) 
SeaofLove: posts small blind $0.05
KeithTurbo48: posts big blind $0.10
*** HOLE CARDS ***
Dealt to PlayTheBlues4U [4s Kh]
ng2414: folds 
PlayTheBlues4U: folds 
x Aristokat x has timed out while disconnected
x Aristokat x: folds 
zombiehedgehog: folds 
x Aristokat x leaves the table
SeaofLove: folds 
Uncalled bet ($0.05) returned to KeithTurbo48
KeithTurbo48 collected $0.10 from pot
KeithTurbo48: doesn't show hand 
*** SUMMARY ***
Total pot $0.10 | Rake $0 
Seat 1: zombiehedgehog (button) folded before Flop (didn't bet)
Seat 2: SeaofLove (small blind) folded before Flop
Seat 3: KeithTurbo48 (big blind) collected ($0.10)
Seat 4: ng2414 folded before Flop (didn't bet)
Seat 5: PlayTheBlues4U folded before Flop (didn't bet)
Seat 6: x Aristokat x folded before Flop (didn't bet)


*********** # 55 **************
PokerStars Hand #204909674535: Hold'em No Limit ($0.05/$0.10 USD) - 2019/10/22 22:29:11 ET
Table 'Celuta' 6-max Seat #3 is the button
Seat 1: trumpcaddy ($10 in chips) 
Seat 2: SeaofLove ($17.80 in chips) 
Seat 3: ng2414 ($8.53 in chips) 
Seat 4: pancakes1912 ($13.12 in chips) 
Seat 5: KeithTurbo48 ($19.68 in chips) 
Seat 6: PlayTheBlues4U ($10.64 in chips) 
pancakes1912: posts small blind $0.05
KeithTurbo48: posts big blind $0.10
*** HOLE CARDS ***
Dealt to PlayTheBlues4U [Tc 6c]
PlayTheBlues4U: folds 
trumpcaddy: folds 
SeaofLove: folds 
ng2414: folds 
pancakes1912: calls $0.05
KeithTurbo48: checks 
*** FLOP *** [6d Ks Qc]
pancakes1912: checks 
KeithTurbo48: checks 
*** TURN *** [6d Ks Qc] [Jc]
pancakes1912: checks 
KeithTurbo48: checks 
*** RIVER *** [6d Ks Qc Jc] [5d]
pancakes1912: bets $0.20
KeithTurbo48: calls $0.20
*** SHOW DOWN ***
pancakes1912: shows [2c 3c] (high card King)
KeithTurbo48: shows [Jd 7c] (a pair of Jacks)
KeithTurbo48 collected $0.57 from pot
*** SUMMARY ***
Total pot $0.60 | Rake $0.03 
Board [6d Ks Qc Jc 5d]
Seat 1: trumpcaddy folded before Flop (didn't bet)
Seat 2: SeaofLove folded before Flop (didn't bet)
Seat 3: ng2414 (button) folded before Flop (didn't bet)
Seat 4: pancakes1912 (small blind) showed [2c 3c] and lost with high card King
Seat 5: KeithTurbo48 (big blind) showed [Jd 7c] and won ($0.57) with a pair of Jacks
Seat 6: PlayTheBlues4U folded before Flop (didn't bet)


*********** # 56 **************
PokerStars Hand #204909674392: Hold'em No Limit ($0.05/$0.10 USD) - 2019/10/22 22:28:40 ET
Table 'Danae' 6-max Seat #6 is the button
Seat 1: zombiehedgehog ($11.62 in chips) 
Seat 2: SeaofLove ($12.36 in chips) 
Seat 3: KeithTurbo48 ($9.10 in chips) 
Seat 4: ng2414 ($23.48 in chips) 
Seat 5: PlayTheBlues4U ($9.17 in chips) 
Seat 6: x Aristokat x ($11.30 in chips) 
zombiehedgehog: posts small blind $0.05
SeaofLove: posts big blind $0.10
*** HOLE CARDS ***
Dealt to PlayTheBlues4U [6c Kd]
KeithTurbo48: raises $0.15 to $0.25
ng2414: folds 
PlayTheBlues4U: folds 
x Aristokat x: calls $0.25
zombiehedgehog: folds 
SeaofLove: folds 
*** FLOP *** [3h 9c 8d]
KeithTurbo48: checks 
x Aristokat x: bets $0.31
KeithTurbo48: calls $0.31
*** TURN *** [3h 9c 8d] [2s]
KeithTurbo48: checks 
x Aristokat x: bets $1.21
KeithTurbo48: raises $2.69 to $3.90
x Aristokat x: folds 
Uncalled bet ($2.69) returned to KeithTurbo48
KeithTurbo48 collected $3.51 from pot
KeithTurbo48: doesn't show hand 
*** SUMMARY ***
Total pot $3.69 | Rake $0.18 
Board [3h 9c 8d 2s]
Seat 1: zombiehedgehog (small blind) folded before Flop
Seat 2: SeaofLove (big blind) folded before Flop
Seat 3: KeithTurbo48 collected ($3.51)
Seat 4: ng2414 folded before Flop (didn't bet)
Seat 5: PlayTheBlues4U folded before Flop (didn't bet)
Seat 6: x Aristokat x (button) folded on the Turn


*********** # 57 **************
PokerStars Hand #204909674302: Hold'em No Limit ($0.05/$0.10 USD) - 2019/10/22 22:28:17 ET
Table 'Celuta' 6-max Seat #2 is the button
Seat 1: trumpcaddy ($10 in chips) 
Seat 2: SeaofLove ($17.80 in chips) 
Seat 3: ng2414 ($8.58 in chips) 
Seat 4: pancakes1912 ($12.80 in chips) 
Seat 5: KeithTurbo48 ($19.68 in chips) 
Seat 6: PlayTheBlues4U ($10.94 in chips) 
ng2414: posts small blind $0.05
pancakes1912: posts big blind $0.10
*** HOLE CARDS ***
Dealt to PlayTheBlues4U [8d 9d]
KeithTurbo48: folds 
PlayTheBlues4U: raises $0.20 to $0.30
trumpcaddy has timed out
trumpcaddy: folds 
SeaofLove: folds 
ng2414: folds 
pancakes1912: calls $0.20
*** FLOP *** [Tc 3h Ac]
pancakes1912: bets $0.50
PlayTheBlues4U: folds 
Uncalled bet ($0.50) returned to pancakes1912
pancakes1912 collected $0.62 from pot
*** SUMMARY ***
Total pot $0.65 | Rake $0.03 
Board [Tc 3h Ac]
Seat 1: trumpcaddy folded before Flop (didn't bet)
Seat 2: SeaofLove (button) folded before Flop (didn't bet)
Seat 3: ng2414 (small blind) folded before Flop
Seat 4: pancakes1912 (big blind) collected ($0.62)
Seat 5: KeithTurbo48 folded before Flop (didn't bet)
Seat 6: PlayTheBlues4U folded on the Flop


*********** # 58 **************
PokerStars Hand #204909674255: Hold'em No Limit ($0.05/$0.10 USD) - 2019/10/22 22:28:03 ET
Table 'Danae' 6-max Seat #5 is the button
Seat 1: zombiehedgehog ($11.72 in chips) 
Seat 2: SeaofLove ($11.16 in chips) 
Seat 3: KeithTurbo48 ($10.27 in chips) 
Seat 4: ng2414 ($23.48 in chips) 
Seat 5: PlayTheBlues4U ($9.17 in chips) 
Seat 6: x Aristokat x ($11.35 in chips) 
x Aristokat x: posts small blind $0.05
zombiehedgehog: posts big blind $0.10
*** HOLE CARDS ***
Dealt to PlayTheBlues4U [3c 9h]
SeaofLove: raises $0.15 to $0.25
KeithTurbo48: calls $0.25
ng2414: folds 
PlayTheBlues4U: folds 
x Aristokat x: folds 
zombiehedgehog: folds 
*** FLOP *** [Ac 3d Js]
SeaofLove: bets $0.31
KeithTurbo48: calls $0.31
*** TURN *** [Ac 3d Js] [9d]
SeaofLove: bets $0.61
KeithTurbo48: calls $0.61
*** RIVER *** [Ac 3d Js 9d] [2d]
SeaofLove: bets $0.80
KeithTurbo48: folds 
Uncalled bet ($0.80) returned to SeaofLove
SeaofLove collected $2.37 from pot
SeaofLove: doesn't show hand 
*** SUMMARY ***
Total pot $2.49 | Rake $0.12 
Board [Ac 3d Js 9d 2d]
Seat 1: zombiehedgehog (big blind) folded before Flop
Seat 2: SeaofLove collected ($2.37)
Seat 3: KeithTurbo48 folded on the River
Seat 4: ng2414 folded before Flop (didn't bet)
Seat 5: PlayTheBlues4U (button) folded before Flop (didn't bet)
Seat 6: x Aristokat x (small blind) folded before Flop


*********** # 59 **************
PokerStars Hand #204909674119: Hold'em No Limit ($0.05/$0.10 USD) - 2019/10/22 22:27:32 ET
Table 'Celuta' 6-max Seat #1 is the button
Seat 1: trumpcaddy ($4.95 in chips) 
Seat 2: SeaofLove ($17.85 in chips) 
Seat 3: ng2414 ($8.68 in chips) 
Seat 4: pancakes1912 ($14.17 in chips) 
Seat 5: KeithTurbo48 ($18.30 in chips) 
Seat 6: PlayTheBlues4U ($10.94 in chips) 
SeaofLove: posts small blind $0.05
ng2414: posts big blind $0.10
*** HOLE CARDS ***
Dealt to PlayTheBlues4U [Tc 2c]
pancakes1912: calls $0.10
KeithTurbo48: raises $0.30 to $0.40
PlayTheBlues4U: folds 
trumpcaddy: folds 
SeaofLove: folds 
ng2414: folds 
pancakes1912: calls $0.30
*** FLOP *** [4h 9d 8s]
pancakes1912: checks 
KeithTurbo48: bets $0.67
pancakes1912: calls $0.67
*** TURN *** [4h 9d 8s] [2s]
pancakes1912: bets $0.30
KeithTurbo48: raises $1.90 to $2.20
pancakes1912: folds 
Uncalled bet ($1.90) returned to KeithTurbo48
KeithTurbo48 collected $2.75 from pot
KeithTurbo48: doesn't show hand 
*** SUMMARY ***
Total pot $2.89 | Rake $0.14 
Board [4h 9d 8s 2s]
Seat 1: trumpcaddy (button) folded before Flop (didn't bet)
Seat 2: SeaofLove (small blind) folded before Flop
Seat 3: ng2414 (big blind) folded before Flop
Seat 4: pancakes1912 folded on the Turn
Seat 5: KeithTurbo48 collected ($2.75)
Seat 6: PlayTheBlues4U folded before Flop (didn't bet)


*********** # 60 **************
PokerStars Hand #204909673993: Hold'em No Limit ($0.05/$0.10 USD) - 2019/10/22 22:27:02 ET
Table 'Danae' 6-max Seat #4 is the button
Seat 1: zombiehedgehog ($12.45 in chips) 
Seat 2: SeaofLove ($11.16 in chips) 
Seat 3: KeithTurbo48 ($10.27 in chips) 
Seat 4: ng2414 ($23.48 in chips) 
Seat 5: PlayTheBlues4U ($9.90 in chips) 
Seat 6: x Aristokat x ($10 in chips) 
PlayTheBlues4U: posts small blind $0.05
x Aristokat x: posts big blind $0.10
*** HOLE CARDS ***
Dealt to PlayTheBlues4U [Ah 5c]
zombiehedgehog: calls $0.10
SeaofLove: folds 
KeithTurbo48: folds 
ng2414: folds 
PlayTheBlues4U: calls $0.05
x Aristokat x: raises $0.20 to $0.30
zombiehedgehog: calls $0.20
PlayTheBlues4U: calls $0.20
*** FLOP *** [Td 7h As]
PlayTheBlues4U: checks 
x Aristokat x: bets $0.43
zombiehedgehog: calls $0.43
PlayTheBlues4U: calls $0.43
*** TURN *** [Td 7h As] [2s]
PlayTheBlues4U: checks 
x Aristokat x: checks 
zombiehedgehog: checks 
*** RIVER *** [Td 7h As 2s] [Js]
PlayTheBlues4U: checks 
x Aristokat x: bets $2.08
zombiehedgehog: folds 
PlayTheBlues4U: folds 
Uncalled bet ($2.08) returned to x Aristokat x
x Aristokat x collected $2.08 from pot
x Aristokat x: doesn't show hand 
*** SUMMARY ***
Total pot $2.19 | Rake $0.11 
Board [Td 7h As 2s Js]
Seat 1: zombiehedgehog folded on the River
Seat 2: SeaofLove folded before Flop (didn't bet)
Seat 3: KeithTurbo48 folded before Flop (didn't bet)
Seat 4: ng2414 (button) folded before Flop (didn't bet)
Seat 5: PlayTheBlues4U (small blind) folded on the River
Seat 6: x Aristokat x (big blind) collected ($2.08)


*********** # 61 **************
PokerStars Hand #204909673944: Hold'em No Limit ($0.05/$0.10 USD) - 2019/10/22 22:26:47 ET
Table 'Celuta' 6-max Seat #6 is the button
Seat 1: trumpcaddy ($11.91 in chips) 
Seat 2: SeaofLove ($18.85 in chips) 
Seat 3: ng2414 ($8.68 in chips) 
Seat 4: pancakes1912 ($6.96 in chips) 
Seat 5: KeithTurbo48 ($18.30 in chips) 
Seat 6: PlayTheBlues4U ($10.94 in chips) 
trumpcaddy: posts small blind $0.05
SeaofLove: posts big blind $0.10
*** HOLE CARDS ***
Dealt to PlayTheBlues4U [4s Ac]
ng2414: folds 
pancakes1912: raises $0.10 to $0.20
KeithTurbo48: folds 
PlayTheBlues4U: folds 
trumpcaddy: raises $0.80 to $1
SeaofLove: calls $0.90
pancakes1912: calls $0.80
*** FLOP *** [Td Qh 5d]
trumpcaddy: bets $2.85
SeaofLove: folds 
pancakes1912: raises $3.11 to $5.96 and is all-in
trumpcaddy: calls $3.11
*** TURN *** [Td Qh 5d] [6h]
*** RIVER *** [Td Qh 5d 6h] [6d]
*** SHOW DOWN ***
trumpcaddy: shows [Ad As] (two pair, Aces and Sixes)
pancakes1912: shows [4d 9d] (a flush, Ten high)
pancakes1912 collected $14.17 from pot
*** SUMMARY ***
Total pot $14.92 | Rake $0.75 
Board [Td Qh 5d 6h 6d]
Seat 1: trumpcaddy (small blind) showed [Ad As] and lost with two pair, Aces and Sixes
Seat 2: SeaofLove (big blind) folded on the Flop
Seat 3: ng2414 folded before Flop (didn't bet)
Seat 4: pancakes1912 showed [4d 9d] and won ($14.17) with a flush, Ten high
Seat 5: KeithTurbo48 folded before Flop (didn't bet)
Seat 6: PlayTheBlues4U (button) folded before Flop (didn't bet)


*********** # 62 **************
PokerStars Hand #204909673876: Hold'em No Limit ($0.05/$0.10 USD) - 2019/10/22 22:26:32 ET
Table 'Danae' 6-max Seat #3 is the button
Seat 1: zombiehedgehog ($13.15 in chips) 
Seat 2: SeaofLove ($11.16 in chips) 
Seat 3: KeithTurbo48 ($9.50 in chips) 
Seat 4: ng2414 ($23.53 in chips) 
Seat 5: PlayTheBlues4U ($10 in chips) 
ng2414: posts small blind $0.05
PlayTheBlues4U: posts big blind $0.10
*** HOLE CARDS ***
Dealt to PlayTheBlues4U [Jc 9d]
zombiehedgehog: raises $0.20 to $0.30
SeaofLove: folds 
KeithTurbo48: raises $0.40 to $0.70
ng2414: folds 
PlayTheBlues4U: folds 
zombiehedgehog: calls $0.40
*** FLOP *** [9h Ad 2h]
x Aristokat x joins the table at seat #6 
zombiehedgehog: checks 
KeithTurbo48: bets $0.50
zombiehedgehog: folds 
Uncalled bet ($0.50) returned to KeithTurbo48
KeithTurbo48 collected $1.47 from pot
KeithTurbo48: doesn't show hand 
*** SUMMARY ***
Total pot $1.55 | Rake $0.08 
Board [9h Ad 2h]
Seat 1: zombiehedgehog folded on the Flop
Seat 2: SeaofLove folded before Flop (didn't bet)
Seat 3: KeithTurbo48 (button) collected ($1.47)
Seat 4: ng2414 (small blind) folded before Flop
Seat 5: PlayTheBlues4U (big blind) folded before Flop


*********** # 63 **************
PokerStars Hand #204909673863: Hold'em No Limit ($0.05/$0.10 USD) - 2019/10/22 22:26:28 ET
Table 'Celuta' 6-max Seat #5 is the button
Seat 1: trumpcaddy ($12.01 in chips) 
Seat 2: SeaofLove ($18.85 in chips) 
Seat 3: ng2414 ($8.53 in chips) 
Seat 4: pancakes1912 ($6.96 in chips) 
Seat 5: KeithTurbo48 ($18.30 in chips) 
Seat 6: PlayTheBlues4U ($10.99 in chips) 
PlayTheBlues4U: posts small blind $0.05
trumpcaddy: posts big blind $0.10
*** HOLE CARDS ***
Dealt to PlayTheBlues4U [Jd 5s]
SeaofLove: folds 
ng2414: raises $0.20 to $0.30
pancakes1912: folds 
KeithTurbo48: folds 
PlayTheBlues4U: folds 
trumpcaddy: folds 
Uncalled bet ($0.20) returned to ng2414
ng2414 collected $0.25 from pot
*** SUMMARY ***
Total pot $0.25 | Rake $0 
Seat 1: trumpcaddy (big blind) folded before Flop
Seat 2: SeaofLove folded before Flop (didn't bet)
Seat 3: ng2414 collected ($0.25)
Seat 4: pancakes1912 folded before Flop (didn't bet)
Seat 5: KeithTurbo48 (button) folded before Flop (didn't bet)
Seat 6: PlayTheBlues4U (small blind) folded before Flop


*********** # 64 **************
PokerStars Hand #204909673705: Hold'em No Limit ($0.05/$0.10 USD) - 2019/10/22 22:25:48 ET
Table 'Danae' 6-max Seat #2 is the button
Seat 1: zombiehedgehog ($13.15 in chips) 
Seat 2: SeaofLove ($11.16 in chips) 
Seat 3: KeithTurbo48 ($9.14 in chips) 
Seat 4: ng2414 ($23.63 in chips) 
Seat 5: PlayTheBlues4U ($8.02 in chips) 
KeithTurbo48: posts small blind $0.05
ng2414: posts big blind $0.10
*** HOLE CARDS ***
Dealt to PlayTheBlues4U [8d Ad]
PlayTheBlues4U: raises $0.20 to $0.30
zombiehedgehog: folds 
SeaofLove: folds 
KeithTurbo48: calls $0.25
ng2414: folds 
*** FLOP *** [Qh 8h Ks]
KeithTurbo48: checks 
PlayTheBlues4U: checks 
*** TURN *** [Qh 8h Ks] [3h]
KeithTurbo48: bets $0.49
PlayTheBlues4U: folds 
Uncalled bet ($0.49) returned to KeithTurbo48
KeithTurbo48 collected $0.66 from pot
KeithTurbo48: doesn't show hand 
*** SUMMARY ***
Total pot $0.70 | Rake $0.04 
Board [Qh 8h Ks 3h]
Seat 1: zombiehedgehog folded before Flop (didn't bet)
Seat 2: SeaofLove (button) folded before Flop (didn't bet)
Seat 3: KeithTurbo48 (small blind) collected ($0.66)
Seat 4: ng2414 (big blind) folded before Flop
Seat 5: PlayTheBlues4U folded on the Turn


*********** # 65 **************
PokerStars Hand #204909673664: Hold'em No Limit ($0.05/$0.10 USD) - 2019/10/22 22:25:36 ET
Table 'Celuta' 6-max Seat #4 is the button
Seat 1: trumpcaddy ($12.01 in chips) 
Seat 2: SeaofLove ($15.85 in chips) 
Seat 3: ng2414 ($8.53 in chips) 
Seat 4: pancakes1912 ($10.13 in chips) 
Seat 5: KeithTurbo48 ($18.35 in chips) 
Seat 6: PlayTheBlues4U ($11.09 in chips) 
KeithTurbo48: posts small blind $0.05
PlayTheBlues4U: posts big blind $0.10
*** HOLE CARDS ***
Dealt to PlayTheBlues4U [3h 6d]
trumpcaddy: folds 
SeaofLove: raises $0.15 to $0.25
ng2414: folds 
pancakes1912: calls $0.25
KeithTurbo48: folds 
PlayTheBlues4U: folds 
*** FLOP *** [2s 7s Kh]
SeaofLove: bets $0.40
pancakes1912: calls $0.40
*** TURN *** [2s 7s Kh] [8c]
SeaofLove: bets $0.92
pancakes1912: calls $0.92
*** RIVER *** [2s 7s Kh 8c] [7h]
SeaofLove: bets $1.60
pancakes1912: calls $1.60
*** SHOW DOWN ***
SeaofLove: shows [Tc Kc] (two pair, Kings and Sevens)
pancakes1912: mucks hand 
SeaofLove collected $6.17 from pot
*** SUMMARY ***
Total pot $6.49 | Rake $0.32 
Board [2s 7s Kh 8c 7h]
Seat 1: trumpcaddy folded before Flop (didn't bet)
Seat 2: SeaofLove showed [Tc Kc] and won ($6.17) with two pair, Kings and Sevens
Seat 3: ng2414 folded before Flop (didn't bet)
Seat 4: pancakes1912 (button) mucked [Jc Ah]
Seat 5: KeithTurbo48 (small blind) folded before Flop
Seat 6: PlayTheBlues4U (big blind) folded before Flop


*********** # 66 **************
PokerStars Hand #204909673487: Hold'em No Limit ($0.05/$0.10 USD) - 2019/10/22 22:24:53 ET
Table 'Danae' 6-max Seat #1 is the button
Seat 1: zombiehedgehog ($13.15 in chips) 
Seat 2: SeaofLove ($11.21 in chips) 
Seat 3: KeithTurbo48 ($8.60 in chips) 
Seat 4: ng2414 ($24.18 in chips) 
Seat 5: PlayTheBlues4U ($8.02 in chips) 
Seat 6: w111r@n ($7.58 in chips) 
SeaofLove: posts small blind $0.05
KeithTurbo48: posts big blind $0.10
*** HOLE CARDS ***
Dealt to PlayTheBlues4U [2h 7c]
ng2414: raises $0.20 to $0.30
PlayTheBlues4U: folds 
w111r@n: folds 
zombiehedgehog: folds 
w111r@n leaves the table
SeaofLove: folds 
KeithTurbo48: calls $0.20
*** FLOP *** [Js Ah 5s]
KeithTurbo48: checks 
ng2414: bets $0.25
KeithTurbo48: calls $0.25
*** TURN *** [Js Ah 5s] [Ts]
KeithTurbo48: checks 
ng2414: checks 
*** RIVER *** [Js Ah 5s Ts] [9h]
KeithTurbo48: checks 
ng2414: checks 
*** SHOW DOWN ***
KeithTurbo48: shows [3d 5d] (a pair of Fives)
ng2414: mucks hand 
KeithTurbo48 collected $1.09 from pot
*** SUMMARY ***
Total pot $1.15 | Rake $0.06 
Board [Js Ah 5s Ts 9h]
Seat 1: zombiehedgehog (button) folded before Flop (didn't bet)
Seat 2: SeaofLove (small blind) folded before Flop
Seat 3: KeithTurbo48 (big blind) showed [3d 5d] and won ($1.09) with a pair of Fives
Seat 4: ng2414 mucked [4c 4d]
Seat 5: PlayTheBlues4U folded before Flop (didn't bet)
Seat 6: w111r@n folded before Flop (didn't bet)


*********** # 67 **************
PokerStars Hand #204909673484: Hold'em No Limit ($0.05/$0.10 USD) - 2019/10/22 22:24:53 ET
Table 'Celuta' 6-max Seat #3 is the button
Seat 1: trumpcaddy ($12.01 in chips) 
Seat 2: SeaofLove ($15.85 in chips) 
Seat 3: ng2414 ($8.53 in chips) 
Seat 4: pancakes1912 ($10.04 in chips) 
Seat 5: KeithTurbo48 ($18.45 in chips) 
Seat 6: PlayTheBlues4U ($11.09 in chips) 
pancakes1912: posts small blind $0.05
KeithTurbo48: posts big blind $0.10
*** HOLE CARDS ***
Dealt to PlayTheBlues4U [4c Kc]
PlayTheBlues4U: folds 
trumpcaddy: folds 
SeaofLove: folds 
ng2414: folds 
pancakes1912: calls $0.05
KeithTurbo48: checks 
*** FLOP *** [9s 8d Jh]
pancakes1912: checks 
KeithTurbo48: checks 
*** TURN *** [9s 8d Jh] [Tc]
pancakes1912: bets $0.40
KeithTurbo48: folds 
Uncalled bet ($0.40) returned to pancakes1912
pancakes1912 collected $0.19 from pot
*** SUMMARY ***
Total pot $0.20 | Rake $0.01 
Board [9s 8d Jh Tc]
Seat 1: trumpcaddy folded before Flop (didn't bet)
Seat 2: SeaofLove folded before Flop (didn't bet)
Seat 3: ng2414 (button) folded before Flop (didn't bet)
Seat 4: pancakes1912 (small blind) collected ($0.19)
Seat 5: KeithTurbo48 (big blind) folded on the Turn
Seat 6: PlayTheBlues4U folded before Flop (didn't bet)


*********** # 68 **************
PokerStars Hand #204909673418: Hold'em No Limit ($0.05/$0.10 USD) - 2019/10/22 22:24:37 ET
Table 'Celuta' 6-max Seat #2 is the button
Seat 1: trumpcaddy ($12.01 in chips) 
Seat 2: SeaofLove ($15.85 in chips) 
Seat 3: ng2414 ($8.58 in chips) 
Seat 4: pancakes1912 ($9.99 in chips) 
Seat 5: KeithTurbo48 ($18.45 in chips) 
Seat 6: PlayTheBlues4U ($11.09 in chips) 
ng2414: posts small blind $0.05
pancakes1912: posts big blind $0.10
*** HOLE CARDS ***
Dealt to PlayTheBlues4U [Qd 8c]
KeithTurbo48: folds 
PlayTheBlues4U: folds 
trumpcaddy: folds 
SeaofLove: folds 
ng2414: folds 
Uncalled bet ($0.05) returned to pancakes1912
pancakes1912 collected $0.10 from pot
*** SUMMARY ***
Total pot $0.10 | Rake $0 
Seat 1: trumpcaddy folded before Flop (didn't bet)
Seat 2: SeaofLove (button) folded before Flop (didn't bet)
Seat 3: ng2414 (small blind) folded before Flop
Seat 4: pancakes1912 (big blind) collected ($0.10)
Seat 5: KeithTurbo48 folded before Flop (didn't bet)
Seat 6: PlayTheBlues4U folded before Flop (didn't bet)


*********** # 69 **************
PokerStars Hand #204909673247: Hold'em No Limit ($0.05/$0.10 USD) - 2019/10/22 22:23:53 ET
Table 'Danae' 6-max Seat #6 is the button
Seat 1: zombiehedgehog ($12.05 in chips) 
Seat 2: SeaofLove ($12.11 in chips) 
Seat 3: KeithTurbo48 ($8.60 in chips) 
Seat 4: ng2414 ($24.18 in chips) 
Seat 5: PlayTheBlues4U ($8.32 in chips) 
Seat 6: w111r@n ($7.58 in chips) 
zombiehedgehog: posts small blind $0.05
SeaofLove: posts big blind $0.10
*** HOLE CARDS ***
Dealt to PlayTheBlues4U [9d Td]
KeithTurbo48: folds 
ng2414: folds 
PlayTheBlues4U: raises $0.20 to $0.30
w111r@n: folds 
zombiehedgehog: calls $0.25
SeaofLove: calls $0.20
*** FLOP *** [3s Qh As]
zombiehedgehog: bets $0.60
SeaofLove: calls $0.60
PlayTheBlues4U: folds 
*** TURN *** [3s Qh As] [Ah]
zombiehedgehog: bets $2
SeaofLove: folds 
Uncalled bet ($2) returned to zombiehedgehog
zombiehedgehog collected $2 from pot
zombiehedgehog: doesn't show hand 
*** SUMMARY ***
Total pot $2.10 | Rake $0.10 
Board [3s Qh As Ah]
Seat 1: zombiehedgehog (small blind) collected ($2)
Seat 2: SeaofLove (big blind) folded on the Turn
Seat 3: KeithTurbo48 folded before Flop (didn't bet)
Seat 4: ng2414 folded before Flop (didn't bet)
Seat 5: PlayTheBlues4U folded on the Flop
Seat 6: w111r@n (button) folded before Flop (didn't bet)


*********** # 70 **************
PokerStars Hand #204909673123: Hold'em No Limit ($0.05/$0.10 USD) - 2019/10/22 22:23:24 ET
Table 'Celuta' 6-max Seat #1 is the button
Seat 1: trumpcaddy ($12.01 in chips) 
Seat 2: SeaofLove ($15.90 in chips) 
Seat 3: ng2414 ($8.68 in chips) 
Seat 4: pancakes1912 ($11.99 in chips) 
Seat 5: KeithTurbo48 ($16.51 in chips) 
Seat 6: PlayTheBlues4U ($11.09 in chips) 
SeaofLove: posts small blind $0.05
ng2414: posts big blind $0.10
*** HOLE CARDS ***
Dealt to PlayTheBlues4U [Jh Ad]
pancakes1912: raises $0.10 to $0.20
KeithTurbo48: raises $0.60 to $0.80
PlayTheBlues4U: folds 
trumpcaddy: folds 
SeaofLove: folds 
ng2414: folds 
pancakes1912: calls $0.60
*** FLOP *** [Th 4s Qd]
pancakes1912: bets $0.40
KeithTurbo48: calls $0.40
*** TURN *** [Th 4s Qd] [5c]
pancakes1912: bets $0.40
KeithTurbo48: calls $0.40
*** RIVER *** [Th 4s Qd 5c] [3h]
pancakes1912: bets $0.40
KeithTurbo48: calls $0.40
*** SHOW DOWN ***
pancakes1912: shows [Kc Jd] (high card King)
KeithTurbo48: shows [Kh As] (high card Ace)
KeithTurbo48 collected $3.94 from pot
*** SUMMARY ***
Total pot $4.15 | Rake $0.21 
Board [Th 4s Qd 5c 3h]
Seat 1: trumpcaddy (button) folded before Flop (didn't bet)
Seat 2: SeaofLove (small blind) folded before Flop
Seat 3: ng2414 (big blind) folded before Flop
Seat 4: pancakes1912 showed [Kc Jd] and lost with high card King
Seat 5: KeithTurbo48 showed [Kh As] and won ($3.94) with high card Ace
Seat 6: PlayTheBlues4U folded before Flop (didn't bet)


*********** # 71 **************
PokerStars Hand #204909672986: Hold'em No Limit ($0.05/$0.10 USD) - 2019/10/22 22:22:55 ET
Table 'Danae' 6-max Seat #5 is the button
Seat 1: zombiehedgehog ($12.30 in chips) 
Seat 2: SeaofLove ($10.84 in chips) 
Seat 3: KeithTurbo48 ($9.48 in chips) 
Seat 4: ng2414 ($24.18 in chips) 
Seat 5: PlayTheBlues4U ($8.32 in chips) 
Seat 6: w111r@n ($7.83 in chips) 
w111r@n: posts small blind $0.05
zombiehedgehog: posts big blind $0.10
*** HOLE CARDS ***
Dealt to PlayTheBlues4U [4d Jh]
SeaofLove: raises $0.15 to $0.25
KeithTurbo48: calls $0.25
ng2414: folds 
PlayTheBlues4U: folds 
w111r@n: calls $0.20
zombiehedgehog: calls $0.15
*** FLOP *** [5h 7c 4h]
w111r@n: checks 
zombiehedgehog: checks 
SeaofLove: bets $0.63
KeithTurbo48: calls $0.63
w111r@n: folds 
zombiehedgehog: folds 
*** TURN *** [5h 7c 4h] [6h]
SeaofLove: bets $1.43
KeithTurbo48: folds 
Uncalled bet ($1.43) returned to SeaofLove
SeaofLove collected $2.15 from pot
SeaofLove: doesn't show hand 
*** SUMMARY ***
Total pot $2.26 | Rake $0.11 
Board [5h 7c 4h 6h]
Seat 1: zombiehedgehog (big blind) folded on the Flop
Seat 2: SeaofLove collected ($2.15)
Seat 3: KeithTurbo48 folded on the Turn
Seat 4: ng2414 folded before Flop (didn't bet)
Seat 5: PlayTheBlues4U (button) folded before Flop (didn't bet)
Seat 6: w111r@n (small blind) folded on the Flop


*********** # 72 **************
PokerStars Hand #204909672882: Hold'em No Limit ($0.05/$0.10 USD) - 2019/10/22 22:22:31 ET
Table 'Danae' 6-max Seat #4 is the button
Seat 1: zombiehedgehog ($12.30 in chips) 
Seat 2: SeaofLove ($10.84 in chips) 
Seat 3: KeithTurbo48 ($9.48 in chips) 
Seat 4: ng2414 ($24.18 in chips) 
Seat 5: PlayTheBlues4U ($8.22 in chips) 
Seat 6: w111r@n ($7.93 in chips) 
PlayTheBlues4U: posts small blind $0.05
w111r@n: posts big blind $0.10
*** HOLE CARDS ***
Dealt to PlayTheBlues4U [Jc Ad]
zombiehedgehog: folds 
SeaofLove: folds 
KeithTurbo48: folds 
ng2414: folds 
PlayTheBlues4U: raises $0.20 to $0.30
w111r@n: folds 
Uncalled bet ($0.20) returned to PlayTheBlues4U
PlayTheBlues4U collected $0.20 from pot
PlayTheBlues4U: doesn't show hand 
*** SUMMARY ***
Total pot $0.20 | Rake $0 
Seat 1: zombiehedgehog folded before Flop (didn't bet)
Seat 2: SeaofLove folded before Flop (didn't bet)
Seat 3: KeithTurbo48 folded before Flop (didn't bet)
Seat 4: ng2414 (button) folded before Flop (didn't bet)
Seat 5: PlayTheBlues4U (small blind) collected ($0.20)
Seat 6: w111r@n (big blind) folded before Flop


*********** # 73 **************
PokerStars Hand #204909672815: Hold'em No Limit ($0.05/$0.10 USD) - 2019/10/22 22:22:15 ET
Table 'Celuta' 6-max Seat #6 is the button
Seat 1: trumpcaddy ($12.06 in chips) 
Seat 2: SeaofLove ($18.06 in chips) 
Seat 3: ng2414 ($8.68 in chips) 
Seat 4: pancakes1912 ($10 in chips) 
Seat 5: KeithTurbo48 ($16.51 in chips) 
Seat 6: PlayTheBlues4U ($11.09 in chips) 
trumpcaddy: posts small blind $0.05
SeaofLove: posts big blind $0.10
*** HOLE CARDS ***
Dealt to PlayTheBlues4U [6d Qs]
ng2414 has timed out
ng2414: folds 
pancakes1912: calls $0.10
KeithTurbo48: folds 
PlayTheBlues4U: folds 
trumpcaddy: folds 
SeaofLove: raises $0.30 to $0.40
pancakes1912: calls $0.30
*** FLOP *** [2h 7h Jd]
SeaofLove: bets $0.54
pancakes1912: calls $0.54
*** TURN *** [2h 7h Jd] [9h]
SeaofLove: bets $1.22
pancakes1912: calls $1.22
*** RIVER *** [2h 7h Jd 9h] [Jh]
SeaofLove: checks 
pancakes1912: bets $2
SeaofLove: folds 
Uncalled bet ($2) returned to pancakes1912
pancakes1912 collected $4.15 from pot
*** SUMMARY ***
Total pot $4.37 | Rake $0.22 
Board [2h 7h Jd 9h Jh]
Seat 1: trumpcaddy (small blind) folded before Flop
Seat 2: SeaofLove (big blind) folded on the River
Seat 3: ng2414 folded before Flop (didn't bet)
Seat 4: pancakes1912 collected ($4.15)
Seat 5: KeithTurbo48 folded before Flop (didn't bet)
Seat 6: PlayTheBlues4U (button) folded before Flop (didn't bet)


*********** # 74 **************
PokerStars Hand #204909672581: Hold'em No Limit ($0.05/$0.10 USD) - 2019/10/22 22:21:17 ET
Table 'Danae' 6-max Seat #3 is the button
Seat 1: zombiehedgehog ($12.02 in chips) 
Seat 2: SeaofLove ($10.84 in chips) 
Seat 3: KeithTurbo48 ($9.58 in chips) 
Seat 4: ng2414 ($24.28 in chips) 
Seat 5: PlayTheBlues4U ($8.32 in chips) 
Seat 6: w111r@n ($7.93 in chips) 
ng2414: posts small blind $0.05
PlayTheBlues4U: posts big blind $0.10
*** HOLE CARDS ***
Dealt to PlayTheBlues4U [4s 6h]
w111r@n: folds 
zombiehedgehog said, "wow what are the odds"
zombiehedgehog: calls $0.10
SeaofLove: folds 
KeithTurbo48: calls $0.10
ng2414 said, "What lol"
zombiehedgehog said, "AJ"
ng2414 said, "me?"
ng2414: calls $0.05
PlayTheBlues4U: checks 
*** FLOP *** [3c 2d Kh]
ng2414: checks 
PlayTheBlues4U: checks 
zombiehedgehog said, "we both had trips. nice little kicker you had"
zombiehedgehog: bets $0.10
KeithTurbo48: folds 
ng2414 said, "Yes"
ng2414: folds 
PlayTheBlues4U: folds 
Uncalled bet ($0.10) returned to zombiehedgehog
zombiehedgehog collected $0.38 from pot
zombiehedgehog: doesn't show hand 
*** SUMMARY ***
Total pot $0.40 | Rake $0.02 
Board [3c 2d Kh]
Seat 1: zombiehedgehog collected ($0.38)
Seat 2: SeaofLove folded before Flop (didn't bet)
Seat 3: KeithTurbo48 (button) folded on the Flop
Seat 4: ng2414 (small blind) folded on the Flop
Seat 5: PlayTheBlues4U (big blind) folded on the Flop
Seat 6: w111r@n folded before Flop (didn't bet)


*********** # 75 **************
PokerStars Hand #204909672449: Hold'em No Limit ($0.05/$0.10 USD) - 2019/10/22 22:20:47 ET
Table 'Celuta' 6-max Seat #5 is the button
Seat 1: trumpcaddy ($12.16 in chips) 
Seat 2: SeaofLove ($18.06 in chips) 
Seat 3: ng2414 ($8.98 in chips) 
Seat 5: KeithTurbo48 ($16.10 in chips) 
Seat 6: PlayTheBlues4U ($11.14 in chips) 
PlayTheBlues4U: posts small blind $0.05
trumpcaddy: posts big blind $0.10
*** HOLE CARDS ***
Dealt to PlayTheBlues4U [6s Tc]
SeaofLove: folds 
ng2414: raises $0.20 to $0.30
KeithTurbo48: calls $0.30
PlayTheBlues4U: folds 
trumpcaddy: folds 
*** FLOP *** [2c Kc Th]
ng2414: checks 
KeithTurbo48: checks 
*** TURN *** [2c Kc Th] [9d]
ng2414: checks 
KeithTurbo48: bets $0.50
ng2414: folds 
Uncalled bet ($0.50) returned to KeithTurbo48
KeithTurbo48 collected $0.71 from pot
KeithTurbo48: doesn't show hand 
*** SUMMARY ***
Total pot $0.75 | Rake $0.04 
Board [2c Kc Th 9d]
Seat 1: trumpcaddy (big blind) folded before Flop
Seat 2: SeaofLove folded before Flop (didn't bet)
Seat 3: ng2414 folded on the Turn
Seat 5: KeithTurbo48 (button) collected ($0.71)
Seat 6: PlayTheBlues4U (small blind) folded before Flop


*********** # 76 **************
PokerStars Hand #204909672241: Hold'em No Limit ($0.05/$0.10 USD) - 2019/10/22 22:20:00 ET
Table 'Celuta' 6-max Seat #3 is the button
Seat 1: trumpcaddy ($12.16 in chips) 
Seat 2: SeaofLove ($14.01 in chips) 
Seat 3: ng2414 ($8.98 in chips) 
Seat 4: pancakes1912 ($4.39 in chips) 
Seat 5: KeithTurbo48 ($16.20 in chips) 
Seat 6: PlayTheBlues4U ($11.14 in chips) 
pancakes1912: posts small blind $0.05
KeithTurbo48: posts big blind $0.10
*** HOLE CARDS ***
Dealt to PlayTheBlues4U [7c 2c]
PlayTheBlues4U: folds 
trumpcaddy: folds 
SeaofLove: raises $0.15 to $0.25
ng2414: folds 
pancakes1912: raises $0.15 to $0.40
KeithTurbo48: folds 
SeaofLove: calls $0.15
*** FLOP *** [9h Ts 6d]
pancakes1912: bets $0.40
SeaofLove: calls $0.40
*** TURN *** [9h Ts 6d] [5s]
pancakes1912: bets $0.40
SeaofLove: raises $4.20 to $4.60
pancakes1912: calls $3.19 and is all-in
Uncalled bet ($1.01) returned to SeaofLove
*** RIVER *** [9h Ts 6d 5s] [Qs]
*** SHOW DOWN ***
pancakes1912: shows [Ac Ks] (high card Ace)
SeaofLove: shows [Jc Tc] (a pair of Tens)
SeaofLove collected $8.44 from pot
*** SUMMARY ***
Total pot $8.88 | Rake $0.44 
Board [9h Ts 6d 5s Qs]
Seat 1: trumpcaddy folded before Flop (didn't bet)
Seat 2: SeaofLove showed [Jc Tc] and won ($8.44) with a pair of Tens
Seat 3: ng2414 (button) folded before Flop (didn't bet)
Seat 4: pancakes1912 (small blind) showed [Ac Ks] and lost with high card Ace
Seat 5: KeithTurbo48 (big blind) folded before Flop
Seat 6: PlayTheBlues4U folded before Flop (didn't bet)


*********** # 77 **************
PokerStars Hand #204909672034: Hold'em No Limit ($0.05/$0.10 USD) - 2019/10/22 22:19:10 ET
Table 'Celuta' 6-max Seat #2 is the button
Seat 1: trumpcaddy ($12.16 in chips) 
Seat 2: SeaofLove ($10.71 in chips) 
Seat 3: ng2414 ($9.03 in chips) 
Seat 4: pancakes1912 ($8 in chips) 
Seat 5: KeithTurbo48 ($16.20 in chips) 
Seat 6: PlayTheBlues4U ($11.14 in chips) 
ng2414: posts small blind $0.05
pancakes1912: posts big blind $0.10
*** HOLE CARDS ***
Dealt to PlayTheBlues4U [4s 7d]
KeithTurbo48: folds 
PlayTheBlues4U: folds 
trumpcaddy: folds 
SeaofLove: raises $0.15 to $0.25
ng2414: folds 
pancakes1912: calls $0.15
*** FLOP *** [Kc Td 8d]
pancakes1912: bets $0.30
SeaofLove: calls $0.30
*** TURN *** [Kc Td 8d] [Qs]
pancakes1912: bets $0.40
SeaofLove: raises $1.26 to $1.66
pancakes1912: calls $1.26
*** RIVER *** [Kc Td 8d Qs] [Ad]
pancakes1912: bets $1.40
SeaofLove: calls $1.40
*** SHOW DOWN ***
pancakes1912: shows [Tc 9c] (a pair of Tens)
SeaofLove: shows [Qh Ks] (two pair, Kings and Queens)
SeaofLove collected $6.91 from pot
*** SUMMARY ***
Total pot $7.27 | Rake $0.36 
Board [Kc Td 8d Qs Ad]
Seat 1: trumpcaddy folded before Flop (didn't bet)
Seat 2: SeaofLove (button) showed [Qh Ks] and won ($6.91) with two pair, Kings and Queens
Seat 3: ng2414 (small blind) folded before Flop
Seat 4: pancakes1912 (big blind) showed [Tc 9c] and lost with a pair of Tens
Seat 5: KeithTurbo48 folded before Flop (didn't bet)
Seat 6: PlayTheBlues4U folded before Flop (didn't bet)


*********** # 78 **************
PokerStars Hand #204909672030: Hold'em No Limit ($0.05/$0.10 USD) - 2019/10/22 22:19:09 ET
Table 'Danae' 6-max Seat #2 is the button
Seat 1: zombiehedgehog ($21.78 in chips) 
Seat 2: SeaofLove ($10.84 in chips) 
Seat 3: KeithTurbo48 ($9.68 in chips) 
Seat 4: ng2414 ($15.40 in chips) 
Seat 5: PlayTheBlues4U ($8.32 in chips) 
Seat 6: w111r@n ($7.93 in chips) 
KeithTurbo48: posts small blind $0.05
ng2414: posts big blind $0.10
*** HOLE CARDS ***
Dealt to PlayTheBlues4U [Kd 9c]
PlayTheBlues4U: folds 
w111r@n: folds 
zombiehedgehog: calls $0.10
SeaofLove: folds 
KeithTurbo48: calls $0.05
ng2414: raises $0.20 to $0.30
zombiehedgehog: calls $0.20
KeithTurbo48: folds 
*** FLOP *** [7h Ts Ac]
ng2414: checks 
zombiehedgehog: bets $0.66
ng2414: calls $0.66
*** TURN *** [7h Ts Ac] [2c]
ng2414: checks 
zombiehedgehog: bets $1.92
ng2414: raises $2.88 to $4.80
zombiehedgehog: calls $2.88
*** RIVER *** [7h Ts Ac 2c] [Ah]
ng2414: bets $4
zombiehedgehog: calls $4
*** SHOW DOWN ***
ng2414: shows [As Kc] (three of a kind, Aces)
zombiehedgehog: mucks hand 
ng2414 collected $18.64 from pot
*** SUMMARY ***
Total pot $19.62 | Rake $0.98 
Board [7h Ts Ac 2c Ah]
Seat 1: zombiehedgehog mucked [Ad 8c]
Seat 2: SeaofLove (button) folded before Flop (didn't bet)
Seat 3: KeithTurbo48 (small blind) folded before Flop
Seat 4: ng2414 (big blind) showed [As Kc] and won ($18.64) with three of a kind, Aces
Seat 5: PlayTheBlues4U folded before Flop (didn't bet)
Seat 6: w111r@n folded before Flop (didn't bet)


*********** # 79 **************
PokerStars Hand #204909671932: Hold'em No Limit ($0.05/$0.10 USD) - 2019/10/22 22:18:48 ET
Table 'Celuta' 6-max Seat #1 is the button
Seat 1: trumpcaddy ($12.16 in chips) 
Seat 2: SeaofLove ($10.76 in chips) 
Seat 3: ng2414 ($9.13 in chips) 
Seat 5: KeithTurbo48 ($16.05 in chips) 
Seat 6: PlayTheBlues4U ($11.14 in chips) 
SeaofLove: posts small blind $0.05
ng2414: posts big blind $0.10
*** HOLE CARDS ***
Dealt to PlayTheBlues4U [9s 7s]
KeithTurbo48: raises $0.15 to $0.25
pancakes1912 joins the table at seat #4 
PlayTheBlues4U: folds 
trumpcaddy: folds 
SeaofLove: folds 
ng2414: folds 
Uncalled bet ($0.15) returned to KeithTurbo48
KeithTurbo48 collected $0.25 from pot
KeithTurbo48: doesn't show hand 
*** SUMMARY ***
Total pot $0.25 | Rake $0 
Seat 1: trumpcaddy (button) folded before Flop (didn't bet)
Seat 2: SeaofLove (small blind) folded before Flop
Seat 3: ng2414 (big blind) folded before Flop
Seat 5: KeithTurbo48 collected ($0.25)
Seat 6: PlayTheBlues4U folded before Flop (didn't bet)


*********** # 80 **************
PokerStars Hand #204909671839: Hold'em No Limit ($0.05/$0.10 USD) - 2019/10/22 22:18:24 ET
Table 'Danae' 6-max Seat #1 is the button
Seat 1: zombiehedgehog ($22.08 in chips) 
Seat 2: SeaofLove ($10 in chips) 
Seat 3: KeithTurbo48 ($9.98 in chips) 
Seat 4: ng2414 ($15.40 in chips) 
Seat 5: PlayTheBlues4U ($8.62 in chips) 
Seat 6: w111r@n ($7.93 in chips) 
SeaofLove: posts small blind $0.05
KeithTurbo48: posts big blind $0.10
*** HOLE CARDS ***
Dealt to PlayTheBlues4U [Kh Ac]
ng2414: folds 
PlayTheBlues4U: raises $0.20 to $0.30
w111r@n: folds 
zombiehedgehog: calls $0.30
SeaofLove: calls $0.25
KeithTurbo48: calls $0.20
*** FLOP *** [4d Th Qh]
SeaofLove: bets $0.76
KeithTurbo48: folds 
PlayTheBlues4U: folds 
zombiehedgehog: folds 
Uncalled bet ($0.76) returned to SeaofLove
SeaofLove collected $1.14 from pot
SeaofLove: doesn't show hand 
*** SUMMARY ***
Total pot $1.20 | Rake $0.06 
Board [4d Th Qh]
Seat 1: zombiehedgehog (button) folded on the Flop
Seat 2: SeaofLove (small blind) collected ($1.14)
Seat 3: KeithTurbo48 (big blind) folded on the Flop
Seat 4: ng2414 folded before Flop (didn't bet)
Seat 5: PlayTheBlues4U folded on the Flop
Seat 6: w111r@n folded before Flop (didn't bet)


*********** # 81 **************
PokerStars Hand #204909671812: Hold'em No Limit ($0.05/$0.10 USD) - 2019/10/22 22:18:18 ET
Table 'Celuta' 6-max Seat #6 is the button
Seat 1: trumpcaddy ($12.21 in chips) 
Seat 2: SeaofLove ($10.22 in chips) 
Seat 3: ng2414 ($9.13 in chips) 
Seat 5: KeithTurbo48 ($16.05 in chips) 
Seat 6: PlayTheBlues4U ($11.69 in chips) 
trumpcaddy: posts small blind $0.05
SeaofLove: posts big blind $0.10
*** HOLE CARDS ***
Dealt to PlayTheBlues4U [Ts Js]
ng2414: folds 
KeithTurbo48: folds 
PlayTheBlues4U: raises $0.15 to $0.25
trumpcaddy: folds 
SeaofLove: calls $0.15
*** FLOP *** [Qd 5c 6c]
SeaofLove: checks 
PlayTheBlues4U: bets $0.30
SeaofLove: raises $0.80 to $1.10
PlayTheBlues4U: folds 
Uncalled bet ($0.80) returned to SeaofLove
SeaofLove collected $1.09 from pot
SeaofLove: doesn't show hand 
*** SUMMARY ***
Total pot $1.15 | Rake $0.06 
Board [Qd 5c 6c]
Seat 1: trumpcaddy (small blind) folded before Flop
Seat 2: SeaofLove (big blind) collected ($1.09)
Seat 3: ng2414 folded before Flop (didn't bet)
Seat 5: KeithTurbo48 folded before Flop (didn't bet)
Seat 6: PlayTheBlues4U (button) folded on the Flop


*********** # 82 **************
PokerStars Hand #204909671612: Hold'em No Limit ($0.05/$0.10 USD) - 2019/10/22 22:17:29 ET
Table 'Celuta' 6-max Seat #5 is the button
Seat 1: trumpcaddy ($12.31 in chips) 
Seat 2: SeaofLove ($10.22 in chips) 
Seat 3: ng2414 ($9.13 in chips) 
Seat 5: KeithTurbo48 ($16.30 in chips) 
Seat 6: PlayTheBlues4U ($11.34 in chips) 
PlayTheBlues4U: posts small blind $0.05
trumpcaddy: posts big blind $0.10
*** HOLE CARDS ***
Dealt to PlayTheBlues4U [Ad Ah]
SeaofLove: folds 
ng2414: folds 
KeithTurbo48: raises $0.15 to $0.25
PlayTheBlues4U: raises $0.45 to $0.70
trumpcaddy: folds 
KeithTurbo48: folds 
Uncalled bet ($0.45) returned to PlayTheBlues4U
PlayTheBlues4U collected $0.60 from pot
PlayTheBlues4U: doesn't show hand 
*** SUMMARY ***
Total pot $0.60 | Rake $0 
Seat 1: trumpcaddy (big blind) folded before Flop
Seat 2: SeaofLove folded before Flop (didn't bet)
Seat 3: ng2414 folded before Flop (didn't bet)
Seat 5: KeithTurbo48 (button) folded before Flop
Seat 6: PlayTheBlues4U (small blind) collected ($0.60)


*********** # 83 **************
PokerStars Hand #204909671547: Hold'em No Limit ($0.05/$0.10 USD) - 2019/10/22 22:17:16 ET
Table 'Danae' 6-max Seat #6 is the button
Seat 1: zombiehedgehog ($18.58 in chips) 
Seat 2: SeaofLove ($10 in chips) 
Seat 3: KeithTurbo48 ($13.50 in chips) 
Seat 4: ng2414 ($15.40 in chips) 
Seat 5: PlayTheBlues4U ($8.87 in chips) 
Seat 6: w111r@n ($7.93 in chips) 
zombiehedgehog: posts small blind $0.05
SeaofLove: posts big blind $0.10
*** HOLE CARDS ***
Dealt to PlayTheBlues4U [6s 7s]
KeithTurbo48: raises $0.15 to $0.25
ng2414: folds 
PlayTheBlues4U: calls $0.25
w111r@n: folds 
zombiehedgehog: raises $0.85 to $1.10
SeaofLove: folds 
KeithTurbo48: calls $0.85
PlayTheBlues4U: folds 
*** FLOP *** [8d 3h 4h]
zombiehedgehog: bets $2.42
KeithTurbo48: calls $2.42
*** TURN *** [8d 3h 4h] [Kd]
zombiehedgehog: checks 
KeithTurbo48: checks 
*** RIVER *** [8d 3h 4h Kd] [Ad]
zombiehedgehog: bets $3.51
KeithTurbo48: folds 
Uncalled bet ($3.51) returned to zombiehedgehog
zombiehedgehog collected $7.02 from pot
zombiehedgehog: doesn't show hand 
*** SUMMARY ***
Total pot $7.39 | Rake $0.37 
Board [8d 3h 4h Kd Ad]
Seat 1: zombiehedgehog (small blind) collected ($7.02)
Seat 2: SeaofLove (big blind) folded before Flop
Seat 3: KeithTurbo48 folded on the River
Seat 4: ng2414 folded before Flop (didn't bet)
Seat 5: PlayTheBlues4U folded before Flop
Seat 6: w111r@n (button) folded before Flop (didn't bet)


*********** # 84 **************
PokerStars Hand #204907679852: Hold'em No Limit ($0.05/$0.10 USD) - 2019/10/22 22:16:27 ET
Table 'Danae' 6-max Seat #5 is the button
Seat 1: zombiehedgehog ($19.28 in chips) 
Seat 2: SeaofLove ($10 in chips) 
Seat 3: KeithTurbo48 ($13.50 in chips) 
Seat 4: ng2414 ($14.72 in chips) 
Seat 5: PlayTheBlues4U ($8.87 in chips) 
Seat 6: w111r@n ($7.98 in chips) 
w111r@n: posts small blind $0.05
zombiehedgehog: posts big blind $0.10
*** HOLE CARDS ***
Dealt to PlayTheBlues4U [4d 6s]
SeaofLove: folds 
KeithTurbo48: folds 
ng2414: raises $0.20 to $0.30
PlayTheBlues4U: folds 
w111r@n: folds 
zombiehedgehog: calls $0.20
*** FLOP *** [2h Kh Qc]
zombiehedgehog: checks 
ng2414: checks 
*** TURN *** [2h Kh Qc] [4s]
zombiehedgehog: checks 
ng2414: bets $0.40
zombiehedgehog: calls $0.40
*** RIVER *** [2h Kh Qc 4s] [Qs]
zombiehedgehog: checks 
ng2414: checks 
*** SHOW DOWN ***
zombiehedgehog: shows [Ah 5s] (a pair of Queens)
ng2414: shows [Ad Th] (a pair of Queens - Ace+King+Ten kicker)
ng2414 collected $1.38 from pot
*** SUMMARY ***
Total pot $1.45 | Rake $0.07 
Board [2h Kh Qc 4s Qs]
Seat 1: zombiehedgehog (big blind) showed [Ah 5s] and lost with a pair of Queens
Seat 2: SeaofLove folded before Flop (didn't bet)
Seat 3: KeithTurbo48 folded before Flop (didn't bet)
Seat 4: ng2414 showed [Ad Th] and won ($1.38) with a pair of Queens
Seat 5: PlayTheBlues4U (button) folded before Flop (didn't bet)
Seat 6: w111r@n (small blind) folded before Flop


*********** # 85 **************
PokerStars Hand #204907679849: Hold'em No Limit ($0.05/$0.10 USD) - 2019/10/22 22:16:26 ET
Table 'Celuta' 6-max Seat #3 is the button
Seat 1: trumpcaddy ($12.31 in chips) 
Seat 2: SeaofLove ($10.22 in chips) 
Seat 3: ng2414 ($9.13 in chips) 
Seat 5: KeithTurbo48 ($8.58 in chips) 
Seat 6: PlayTheBlues4U ($19.92 in chips) 
KeithTurbo48: posts small blind $0.05
PlayTheBlues4U: posts big blind $0.10
*** HOLE CARDS ***
Dealt to PlayTheBlues4U [As Qc]
trumpcaddy: folds 
SeaofLove: folds 
ng2414: folds 
KeithTurbo48: raises $0.20 to $0.30
PlayTheBlues4U: raises $0.50 to $0.80
KeithTurbo48: raises $7.78 to $8.58 and is all-in
PlayTheBlues4U: calls $7.78
*** FLOP *** [6h Kd Kh]
*** TURN *** [6h Kd Kh] [4h]
*** RIVER *** [6h Kd Kh 4h] [2c]
*** SHOW DOWN ***
KeithTurbo48: shows [9c 9s] (two pair, Kings and Nines)
PlayTheBlues4U: shows [As Qc] (a pair of Kings)
KeithTurbo48 collected $16.30 from pot
*** SUMMARY ***
Total pot $17.16 | Rake $0.86 
Board [6h Kd Kh 4h 2c]
Seat 1: trumpcaddy folded before Flop (didn't bet)
Seat 2: SeaofLove folded before Flop (didn't bet)
Seat 3: ng2414 (button) folded before Flop (didn't bet)
Seat 5: KeithTurbo48 (small blind) showed [9c 9s] and won ($16.30) with two pair, Kings and Nines
Seat 6: PlayTheBlues4U (big blind) showed [As Qc] and lost with a pair of Kings


*********** # 86 **************
PokerStars Hand #204907679580: Hold'em No Limit ($0.05/$0.10 USD) - 2019/10/22 22:15:22 ET
Table 'Danae' 6-max Seat #4 is the button
Seat 1: zombiehedgehog ($20.73 in chips) 
Seat 2: SeaofLove ($10 in chips) 
Seat 3: KeithTurbo48 ($12.05 in chips) 
Seat 4: ng2414 ($14.72 in chips) 
Seat 5: PlayTheBlues4U ($8.92 in chips) 
Seat 6: w111r@n ($8.08 in chips) 
PlayTheBlues4U: posts small blind $0.05
w111r@n: posts big blind $0.10
*** HOLE CARDS ***
Dealt to PlayTheBlues4U [8h 2s]
zombiehedgehog: raises $0.10 to $0.20
SeaofLove: folds 
KeithTurbo48: calls $0.20
ng2414: folds 
PlayTheBlues4U: folds 
w111r@n: folds 
*** FLOP *** [Jd 2d 8c]
zombiehedgehog: bets $0.25
KeithTurbo48: calls $0.25
*** TURN *** [Jd 2d 8c] [Th]
zombiehedgehog: bets $0.33
KeithTurbo48: raises $0.67 to $1
zombiehedgehog: calls $0.67
*** RIVER *** [Jd 2d 8c Th] [8s]
zombiehedgehog: checks 
KeithTurbo48: checks 
*** SHOW DOWN ***
zombiehedgehog: shows [5d 3d] (a pair of Eights)
KeithTurbo48: shows [Td Qc] (two pair, Tens and Eights)
KeithTurbo48 collected $2.90 from pot
*** SUMMARY ***
Total pot $3.05 | Rake $0.15 
Board [Jd 2d 8c Th 8s]
Seat 1: zombiehedgehog showed [5d 3d] and lost with a pair of Eights
Seat 2: SeaofLove folded before Flop (didn't bet)
Seat 3: KeithTurbo48 showed [Td Qc] and won ($2.90) with two pair, Tens and Eights
Seat 4: ng2414 (button) folded before Flop (didn't bet)
Seat 5: PlayTheBlues4U (small blind) folded before Flop
Seat 6: w111r@n (big blind) folded before Flop


*********** # 87 **************
PokerStars Hand #204907679543: Hold'em No Limit ($0.05/$0.10 USD) - 2019/10/22 22:15:12 ET
Table 'Celuta' 6-max Seat #2 is the button
Seat 1: trumpcaddy ($12.31 in chips) 
Seat 2: SeaofLove ($10.22 in chips) 
Seat 3: ng2414 ($9.25 in chips) 
Seat 5: KeithTurbo48 ($8.71 in chips) 
Seat 6: PlayTheBlues4U ($19.92 in chips) 
ng2414: posts small blind $0.05
KeithTurbo48: posts big blind $0.10
*** HOLE CARDS ***
Dealt to PlayTheBlues4U [2d 8s]
PlayTheBlues4U: folds 
trumpcaddy: folds 
SeaofLove: folds 
ng2414: raises $0.20 to $0.30
KeithTurbo48: calls $0.20
*** FLOP *** [As 7c 7d]
ng2414: checks 
KeithTurbo48: checks 
*** TURN *** [As 7c 7d] [3s]
ng2414: bets $0.29
KeithTurbo48: calls $0.29
*** RIVER *** [As 7c 7d 3s] [7s]
ng2414: bets $0.56
KeithTurbo48: raises $1.34 to $1.90
ng2414: calls $1.34
*** SHOW DOWN ***
KeithTurbo48: shows [Th Ad] (a full house, Sevens full of Aces)
ng2414: shows [Qs Ac] (a full house, Sevens full of Aces)
ng2414 collected $2.37 from pot
KeithTurbo48 collected $2.36 from pot
*** SUMMARY ***
Total pot $4.98 | Rake $0.25 
Board [As 7c 7d 3s 7s]
Seat 1: trumpcaddy folded before Flop (didn't bet)
Seat 2: SeaofLove (button) folded before Flop (didn't bet)
Seat 3: ng2414 (small blind) showed [Qs Ac] and won ($2.37) with a full house, Sevens full of Aces
Seat 5: KeithTurbo48 (big blind) showed [Th Ad] and won ($2.36) with a full house, Sevens full of Aces
Seat 6: PlayTheBlues4U folded before Flop (didn't bet)


*********** # 88 **************
PokerStars Hand #204907679531: Hold'em No Limit ($0.05/$0.10 USD) - 2019/10/22 22:15:09 ET
Table 'Danae' 6-max Seat #3 is the button
Seat 1: zombiehedgehog ($20.58 in chips) 
Seat 2: SeaofLove ($10 in chips) 
Seat 3: KeithTurbo48 ($12.05 in chips) 
Seat 4: ng2414 ($14.77 in chips) 
Seat 5: PlayTheBlues4U ($9.02 in chips) 
Seat 6: w111r@n ($8.08 in chips) 
ng2414: posts small blind $0.05
PlayTheBlues4U: posts big blind $0.10
*** HOLE CARDS ***
Dealt to PlayTheBlues4U [4h 6s]
w111r@n: folds 
zombiehedgehog: raises $0.10 to $0.20
SeaofLove: folds 
KeithTurbo48: folds 
ng2414: folds 
PlayTheBlues4U: folds 
Uncalled bet ($0.10) returned to zombiehedgehog
zombiehedgehog collected $0.25 from pot
zombiehedgehog: doesn't show hand 
*** SUMMARY ***
Total pot $0.25 | Rake $0 
Seat 1: zombiehedgehog collected ($0.25)
Seat 2: SeaofLove folded before Flop (didn't bet)
Seat 3: KeithTurbo48 (button) folded before Flop (didn't bet)
Seat 4: ng2414 (small blind) folded before Flop
Seat 5: PlayTheBlues4U (big blind) folded before Flop
Seat 6: w111r@n folded before Flop (didn't bet)


*********** # 89 **************
PokerStars Hand #204907679476: Hold'em No Limit ($0.05/$0.10 USD) - 2019/10/22 22:14:53 ET
Table 'Celuta' 6-max Seat #1 is the button
Seat 1: trumpcaddy ($12.31 in chips) 
Seat 2: SeaofLove ($10.27 in chips) 
Seat 3: ng2414 ($9.35 in chips) 
Seat 4: ney1202 ($10.78 in chips) 
Seat 5: KeithTurbo48 ($8.56 in chips) 
Seat 6: PlayTheBlues4U ($19.92 in chips) 
SeaofLove: posts small blind $0.05
ng2414: posts big blind $0.10
*** HOLE CARDS ***
Dealt to PlayTheBlues4U [Kd 7d]
ney1202: folds 
KeithTurbo48: raises $0.15 to $0.25
ney1202 leaves the table
PlayTheBlues4U: folds 
trumpcaddy: folds 
SeaofLove: folds 
ng2414: folds 
Uncalled bet ($0.15) returned to KeithTurbo48
KeithTurbo48 collected $0.25 from pot
KeithTurbo48: doesn't show hand 
*** SUMMARY ***
Total pot $0.25 | Rake $0 
Seat 1: trumpcaddy (button) folded before Flop (didn't bet)
Seat 2: SeaofLove (small blind) folded before Flop
Seat 3: ng2414 (big blind) folded before Flop
Seat 4: ney1202 folded before Flop (didn't bet)
Seat 5: KeithTurbo48 collected ($0.25)
Seat 6: PlayTheBlues4U folded before Flop (didn't bet)


*********** # 90 **************
PokerStars Hand #204907679373: Hold'em No Limit ($0.05/$0.10 USD) - 2019/10/22 22:14:26 ET
Table 'Celuta' 6-max Seat #6 is the button
Seat 1: trumpcaddy ($12.36 in chips) 
Seat 2: SeaofLove ($10 in chips) 
Seat 3: ng2414 ($9.35 in chips) 
Seat 4: ney1202 ($10.78 in chips) 
Seat 5: KeithTurbo48 ($8.56 in chips) 
Seat 6: PlayTheBlues4U ($20.17 in chips) 
trumpcaddy: posts small blind $0.05
SeaofLove: posts big blind $0.10
*** HOLE CARDS ***
Dealt to PlayTheBlues4U [Qd 7d]
ng2414: folds 
ney1202: folds 
KeithTurbo48: folds 
PlayTheBlues4U: raises $0.15 to $0.25
trumpcaddy: folds 
SeaofLove: calls $0.15
*** FLOP *** [Js 6c 3h]
SeaofLove: checks 
PlayTheBlues4U: checks 
*** TURN *** [Js 6c 3h] [2d]
SeaofLove: bets $0.17
PlayTheBlues4U: folds 
Uncalled bet ($0.17) returned to SeaofLove
SeaofLove collected $0.52 from pot
SeaofLove: doesn't show hand 
*** SUMMARY ***
Total pot $0.55 | Rake $0.03 
Board [Js 6c 3h 2d]
Seat 1: trumpcaddy (small blind) folded before Flop
Seat 2: SeaofLove (big blind) collected ($0.52)
Seat 3: ng2414 folded before Flop (didn't bet)
Seat 4: ney1202 folded before Flop (didn't bet)
Seat 5: KeithTurbo48 folded before Flop (didn't bet)
Seat 6: PlayTheBlues4U (button) folded on the Turn


*********** # 91 **************
PokerStars Hand #204907679327: Hold'em No Limit ($0.05/$0.10 USD) - 2019/10/22 22:14:15 ET
Table 'Danae' 6-max Seat #2 is the button
Seat 1: zombiehedgehog ($20.58 in chips) 
Seat 2: SeaofLove ($10 in chips) 
Seat 3: KeithTurbo48 ($12.15 in chips) 
Seat 4: ng2414 ($14.68 in chips) 
Seat 5: PlayTheBlues4U ($9.02 in chips) 
Seat 6: w111r@n ($8.08 in chips) 
KeithTurbo48: posts small blind $0.05
ng2414: posts big blind $0.10
*** HOLE CARDS ***
Dealt to PlayTheBlues4U [7h Th]
PlayTheBlues4U: folds 
w111r@n: folds 
zombiehedgehog: folds 
SeaofLove: folds 
KeithTurbo48: calls $0.05
ng2414: checks 
*** FLOP *** [Qc 8s 8c]
KeithTurbo48: checks 
ng2414: checks 
*** TURN *** [Qc 8s 8c] [Ad]
KeithTurbo48: checks 
ng2414: checks 
*** RIVER *** [Qc 8s 8c Ad] [Kh]
KeithTurbo48: checks 
ng2414: checks 
*** SHOW DOWN ***
KeithTurbo48: shows [4c 5h] (a pair of Eights)
ng2414: shows [Kc 7s] (two pair, Kings and Eights)
ng2414 collected $0.19 from pot
*** SUMMARY ***
Total pot $0.20 | Rake $0.01 
Board [Qc 8s 8c Ad Kh]
Seat 1: zombiehedgehog folded before Flop (didn't bet)
Seat 2: SeaofLove (button) folded before Flop (didn't bet)
Seat 3: KeithTurbo48 (small blind) showed [4c 5h] and lost with a pair of Eights
Seat 4: ng2414 (big blind) showed [Kc 7s] and won ($0.19) with two pair, Kings and Eights
Seat 5: PlayTheBlues4U folded before Flop (didn't bet)
Seat 6: w111r@n folded before Flop (didn't bet)


*********** # 92 **************
PokerStars Hand #204907679232: Hold'em No Limit ($0.05/$0.10 USD) - 2019/10/22 22:13:52 ET
Table 'Danae' 6-max Seat #1 is the button
Seat 1: zombiehedgehog ($20.58 in chips) 
Seat 2: SeaofLove ($10 in chips) 
Seat 3: KeithTurbo48 ($12.35 in chips) 
Seat 4: ng2414 ($14.68 in chips) 
Seat 5: PlayTheBlues4U ($9.02 in chips) 
Seat 6: w111r@n ($7.85 in chips) 
SeaofLove: posts small blind $0.05
KeithTurbo48: posts big blind $0.10
*** HOLE CARDS ***
Dealt to PlayTheBlues4U [Ts Qh]
ng2414: folds 
PlayTheBlues4U: folds 
w111r@n: raises $0.10 to $0.20
zombiehedgehog: folds 
SeaofLove: folds 
KeithTurbo48: calls $0.10
*** FLOP *** [Ac Kh 5s]
KeithTurbo48: checks 
w111r@n: bets $0.20
KeithTurbo48: folds 
Uncalled bet ($0.20) returned to w111r@n
w111r@n collected $0.43 from pot
w111r@n: doesn't show hand 
*** SUMMARY ***
Total pot $0.45 | Rake $0.02 
Board [Ac Kh 5s]
Seat 1: zombiehedgehog (button) folded before Flop (didn't bet)
Seat 2: SeaofLove (small blind) folded before Flop
Seat 3: KeithTurbo48 (big blind) folded on the Flop
Seat 4: ng2414 folded before Flop (didn't bet)
Seat 5: PlayTheBlues4U folded before Flop (didn't bet)
Seat 6: w111r@n collected ($0.43)


*********** # 93 **************
PokerStars Hand #204907679151: Hold'em No Limit ($0.05/$0.10 USD) - 2019/10/22 22:13:32 ET
Table 'Danae' 6-max Seat #6 is the button
Seat 1: zombiehedgehog ($20.63 in chips) 
Seat 2: SeaofLove ($10 in chips) 
Seat 3: KeithTurbo48 ($12.35 in chips) 
Seat 4: ng2414 ($14.53 in chips) 
Seat 5: PlayTheBlues4U ($9.02 in chips) 
Seat 6: w111r@n ($7.85 in chips) 
zombiehedgehog: posts small blind $0.05
SeaofLove: posts big blind $0.10
*** HOLE CARDS ***
Dealt to PlayTheBlues4U [Th 8s]
KeithTurbo48: folds 
ng2414: raises $0.20 to $0.30
PlayTheBlues4U: folds 
w111r@n: folds 
zombiehedgehog: folds 
SeaofLove: folds 
Uncalled bet ($0.20) returned to ng2414
ng2414 collected $0.25 from pot
*** SUMMARY ***
Total pot $0.25 | Rake $0 
Seat 1: zombiehedgehog (small blind) folded before Flop
Seat 2: SeaofLove (big blind) folded before Flop
Seat 3: KeithTurbo48 folded before Flop (didn't bet)
Seat 4: ng2414 collected ($0.25)
Seat 5: PlayTheBlues4U folded before Flop (didn't bet)
Seat 6: w111r@n (button) folded before Flop (didn't bet)


*********** # 94 **************
PokerStars Hand #204907679102: Hold'em No Limit ($0.05/$0.10 USD) - 2019/10/22 22:13:22 ET
Table 'Danae' 6-max Seat #5 is the button
Seat 1: zombiehedgehog ($20.58 in chips) 
Seat 3: KeithTurbo48 ($12.35 in chips) 
Seat 4: ng2414 ($14.53 in chips) 
Seat 5: PlayTheBlues4U ($9.02 in chips) 
Seat 6: w111r@n ($7.90 in chips) 
w111r@n: posts small blind $0.05
zombiehedgehog: posts big blind $0.10
SeaofLove: sits out 
*** HOLE CARDS ***
Dealt to PlayTheBlues4U [6s 4d]
KeithTurbo48: folds 
ng2414: folds 
PlayTheBlues4U: folds 
w111r@n: folds 
Uncalled bet ($0.05) returned to zombiehedgehog
zombiehedgehog collected $0.10 from pot
zombiehedgehog: doesn't show hand 
*** SUMMARY ***
Total pot $0.10 | Rake $0 
Seat 1: zombiehedgehog (big blind) collected ($0.10)
Seat 3: KeithTurbo48 folded before Flop (didn't bet)
Seat 4: ng2414 folded before Flop (didn't bet)
Seat 5: PlayTheBlues4U (button) folded before Flop (didn't bet)
Seat 6: w111r@n (small blind) folded before Flop


*********** # 95 **************
PokerStars Hand #204907679064: Hold'em No Limit ($0.05/$0.10 USD) - 2019/10/22 22:13:14 ET
Table 'Celuta' 6-max Seat #5 is the button
Seat 1: trumpcaddy ($12.46 in chips) 
Seat 3: ng2414 ($9.35 in chips) 
Seat 4: ney1202 ($10.78 in chips) 
Seat 5: KeithTurbo48 ($12.06 in chips) 
Seat 6: PlayTheBlues4U ($16.93 in chips) 
PlayTheBlues4U: posts small blind $0.05
trumpcaddy: posts big blind $0.10
SeaofLove: sits out 
*** HOLE CARDS ***
Dealt to PlayTheBlues4U [Ac Ks]
ng2414: folds 
ney1202: folds 
KeithTurbo48: raises $0.15 to $0.25
PlayTheBlues4U: raises $0.45 to $0.70
trumpcaddy: folds 
KeithTurbo48: calls $0.45
*** FLOP *** [5s 4s Jd]
PlayTheBlues4U: bets $0.90
KeithTurbo48: calls $0.90
*** TURN *** [5s 4s Jd] [3d]
PlayTheBlues4U: checks 
KeithTurbo48: bets $1.90
PlayTheBlues4U: calls $1.90
*** RIVER *** [5s 4s Jd 3d] [Kd]
PlayTheBlues4U: checks 
KeithTurbo48: checks 
*** SHOW DOWN ***
PlayTheBlues4U: shows [Ac Ks] (a pair of Kings)
KeithTurbo48: mucks hand 
PlayTheBlues4U collected $6.74 from pot
*** SUMMARY ***
Total pot $7.10 | Rake $0.36 
Board [5s 4s Jd 3d Kd]
Seat 1: trumpcaddy (big blind) folded before Flop
Seat 3: ng2414 folded before Flop (didn't bet)
Seat 4: ney1202 folded before Flop (didn't bet)
Seat 5: KeithTurbo48 (button) mucked [Jc 9d]
Seat 6: PlayTheBlues4U (small blind) showed [Ac Ks] and won ($6.74) with a pair of Kings


*********** # 96 **************
PokerStars Hand #204907678988: Hold'em No Limit ($0.05/$0.10 USD) - 2019/10/22 22:12:55 ET
Table 'Celuta' 6-max Seat #4 is the button
Seat 1: trumpcaddy ($12.46 in chips) 
Seat 3: ng2414 ($9.20 in chips) 
Seat 4: ney1202 ($10.78 in chips) 
Seat 5: KeithTurbo48 ($12.11 in chips) 
Seat 6: PlayTheBlues4U ($17.03 in chips) 
KeithTurbo48: posts small blind $0.05
PlayTheBlues4U: posts big blind $0.10
SeaofLove: sits out 
*** HOLE CARDS ***
Dealt to PlayTheBlues4U [Th 3d]
trumpcaddy: folds 
ng2414: raises $0.20 to $0.30
ney1202: folds 
KeithTurbo48: folds 
PlayTheBlues4U: folds 
Uncalled bet ($0.20) returned to ng2414
ng2414 collected $0.25 from pot
*** SUMMARY ***
Total pot $0.25 | Rake $0 
Seat 1: trumpcaddy folded before Flop (didn't bet)
Seat 3: ng2414 collected ($0.25)
Seat 4: ney1202 (button) folded before Flop (didn't bet)
Seat 5: KeithTurbo48 (small blind) folded before Flop
Seat 6: PlayTheBlues4U (big blind) folded before Flop


*********** # 97 **************
PokerStars Hand #204907678935: Hold'em No Limit ($0.05/$0.10 USD) - 2019/10/22 22:12:43 ET
Table 'Celuta' 6-max Seat #3 is the button
Seat 1: trumpcaddy ($12.46 in chips) 
Seat 3: ng2414 ($9.20 in chips) 
Seat 4: ney1202 ($10.83 in chips) 
Seat 5: KeithTurbo48 ($12.06 in chips) 
Seat 6: PlayTheBlues4U ($17.03 in chips) 
ney1202: posts small blind $0.05
KeithTurbo48: posts big blind $0.10
SeaofLove: sits out 
*** HOLE CARDS ***
Dealt to PlayTheBlues4U [9d 5h]
PlayTheBlues4U: folds 
trumpcaddy: folds 
ng2414: folds 
ney1202: folds 
Uncalled bet ($0.05) returned to KeithTurbo48
KeithTurbo48 collected $0.10 from pot
KeithTurbo48: doesn't show hand 
*** SUMMARY ***
Total pot $0.10 | Rake $0 
Seat 1: trumpcaddy folded before Flop (didn't bet)
Seat 3: ng2414 (button) folded before Flop (didn't bet)
Seat 4: ney1202 (small blind) folded before Flop
Seat 5: KeithTurbo48 (big blind) collected ($0.10)
Seat 6: PlayTheBlues4U folded before Flop (didn't bet)


*********** # 98 **************
PokerStars Hand #204907678836: Hold'em No Limit ($0.05/$0.10 USD) - 2019/10/22 22:12:20 ET
Table 'Celuta' 6-max Seat #2 is the button
Seat 1: trumpcaddy ($12.31 in chips) 
Seat 2: dcami_nj ($10 in chips) 
Seat 3: ng2414 ($9.25 in chips) 
Seat 4: ney1202 ($10.93 in chips) 
Seat 5: KeithTurbo48 ($12.06 in chips) 
Seat 6: PlayTheBlues4U ($17.03 in chips) 
ng2414: posts small blind $0.05
ney1202: posts big blind $0.10
*** HOLE CARDS ***
Dealt to PlayTheBlues4U [Kd 9s]
KeithTurbo48: folds 
PlayTheBlues4U: folds 
trumpcaddy: raises $0.25 to $0.35
dcami_nj: folds 
dcami_nj leaves the table
SeaofLove joins the table at seat #2 
ng2414: folds 
ney1202: folds 
Uncalled bet ($0.25) returned to trumpcaddy
trumpcaddy collected $0.25 from pot
trumpcaddy: doesn't show hand 
*** SUMMARY ***
Total pot $0.25 | Rake $0 
Seat 1: trumpcaddy collected ($0.25)
Seat 2: dcami_nj (button) folded before Flop (didn't bet)
Seat 3: ng2414 (small blind) folded before Flop
Seat 4: ney1202 (big blind) folded before Flop
Seat 5: KeithTurbo48 folded before Flop (didn't bet)
Seat 6: PlayTheBlues4U folded before Flop (didn't bet)


*********** # 99 **************
PokerStars Hand #204907678819: Hold'em No Limit ($0.05/$0.10 USD) - 2019/10/22 22:12:16 ET
Table 'Danae' 6-max Seat #4 is the button
Seat 1: zombiehedgehog ($20.03 in chips) 
Seat 2: dcami_nj ($7.80 in chips) 
Seat 3: KeithTurbo48 ($12.35 in chips) 
Seat 4: ng2414 ($14.98 in chips) 
Seat 5: PlayTheBlues4U ($9.07 in chips) 
Seat 6: w111r@n ($8 in chips) 
PlayTheBlues4U: posts small blind $0.05
w111r@n: posts big blind $0.10
*** HOLE CARDS ***
Dealt to PlayTheBlues4U [Jd 7d]
zombiehedgehog: calls $0.10
dcami_nj: folds 
KeithTurbo48: folds 
dcami_nj leaves the table
SeaofLove joins the table at seat #2 
ng2414: raises $0.35 to $0.45
PlayTheBlues4U: folds 
w111r@n: folds 
zombiehedgehog: calls $0.35
*** FLOP *** [9c 9s Ts]
zombiehedgehog: checks 
ng2414: checks 
*** TURN *** [9c 9s Ts] [8c]
zombiehedgehog: bets $1
ng2414: folds 
Uncalled bet ($1) returned to zombiehedgehog
zombiehedgehog collected $1 from pot
zombiehedgehog: doesn't show hand 
*** SUMMARY ***
Total pot $1.05 | Rake $0.05 
Board [9c 9s Ts 8c]
Seat 1: zombiehedgehog collected ($1)
Seat 2: dcami_nj folded before Flop (didn't bet)
Seat 3: KeithTurbo48 folded before Flop (didn't bet)
Seat 4: ng2414 (button) folded on the Turn
Seat 5: PlayTheBlues4U (small blind) folded before Flop
Seat 6: w111r@n (big blind) folded before Flop


*********** # 100 **************
PokerStars Hand #204907678749: Hold'em No Limit ($0.05/$0.10 USD) - 2019/10/22 22:12:00 ET
Table 'Celuta' 6-max Seat #1 is the button
Seat 1: trumpcaddy ($12.31 in chips) 
Seat 2: dcami_nj ($7.74 in chips) 
Seat 3: ng2414 ($9.20 in chips) 
Seat 4: ney1202 ($10.93 in chips) 
Seat 5: KeithTurbo48 ($12.06 in chips) 
Seat 6: PlayTheBlues4U ($17.03 in chips) 
dcami_nj: posts small blind $0.05
ng2414: posts big blind $0.10
*** HOLE CARDS ***
Dealt to PlayTheBlues4U [6c Td]
ney1202: folds 
KeithTurbo48: folds 
PlayTheBlues4U: folds 
trumpcaddy: folds 
dcami_nj: folds 
Uncalled bet ($0.05) returned to ng2414
ng2414 collected $0.10 from pot
*** SUMMARY ***
Total pot $0.10 | Rake $0 
Seat 1: trumpcaddy (button) folded before Flop (didn't bet)
Seat 2: dcami_nj (small blind) folded before Flop
Seat 3: ng2414 (big blind) collected ($0.10)
Seat 4: ney1202 folded before Flop (didn't bet)
Seat 5: KeithTurbo48 folded before Flop (didn't bet)
Seat 6: PlayTheBlues4U folded before Flop (didn't bet)


*********** # 101 **************
PokerStars Hand #204907678495: Hold'em No Limit ($0.05/$0.10 USD) - 2019/10/22 22:10:56 ET
Table 'Danae' 6-max Seat #3 is the button
Seat 1: zombiehedgehog ($20.03 in chips) 
Seat 2: dcami_nj ($5.60 in chips) 
Seat 3: KeithTurbo48 ($10.59 in chips) 
Seat 4: ng2414 ($15.03 in chips) 
Seat 5: PlayTheBlues4U ($9.17 in chips) 
ng2414: posts small blind $0.05
PlayTheBlues4U: posts big blind $0.10
w111r@n: sits out 
*** HOLE CARDS ***
Dealt to PlayTheBlues4U [6c Kd]
zombiehedgehog: folds 
dcami_nj: raises $0.30 to $0.40
KeithTurbo48: calls $0.40
ng2414: folds 
PlayTheBlues4U: folds 
*** FLOP *** [8c Js Jc]
dcami_nj: bets $0.50
KeithTurbo48: calls $0.50
*** TURN *** [8c Js Jc] [4d]
dcami_nj: bets $0.90
KeithTurbo48: raises $2.50 to $3.40
dcami_nj: folds 
Uncalled bet ($2.50) returned to KeithTurbo48
KeithTurbo48 collected $3.56 from pot
KeithTurbo48: doesn't show hand 
*** SUMMARY ***
Total pot $3.75 | Rake $0.19 
Board [8c Js Jc 4d]
Seat 1: zombiehedgehog folded before Flop (didn't bet)
Seat 2: dcami_nj folded on the Turn
Seat 3: KeithTurbo48 (button) collected ($3.56)
Seat 4: ng2414 (small blind) folded before Flop
Seat 5: PlayTheBlues4U (big blind) folded before Flop


*********** # 102 **************
PokerStars Hand #204907678335: Hold'em No Limit ($0.05/$0.10 USD) - 2019/10/22 22:10:17 ET
Table 'Celuta' 6-max Seat #6 is the button
Seat 1: trumpcaddy ($12.36 in chips) 
Seat 2: dcami_nj ($16.68 in chips) 
Seat 3: ng2414 ($9.20 in chips) 
Seat 4: ney1202 ($10.93 in chips) 
Seat 5: KeithTurbo48 ($12.06 in chips) 
Seat 6: PlayTheBlues4U ($8.94 in chips) 
trumpcaddy: posts small blind $0.05
dcami_nj: posts big blind $0.10
*** HOLE CARDS ***
Dealt to PlayTheBlues4U [6s 6c]
ng2414 has timed out
ng2414: folds 
ney1202: folds 
KeithTurbo48: folds 
PlayTheBlues4U: raises $0.15 to $0.25
trumpcaddy: folds 
dcami_nj: raises $0.65 to $0.90
PlayTheBlues4U: calls $0.65
*** FLOP *** [6h 6d 8h]
dcami_nj: bets $1
PlayTheBlues4U: calls $1
*** TURN *** [6h 6d 8h] [8c]
dcami_nj: bets $2
PlayTheBlues4U: calls $2
*** RIVER *** [6h 6d 8h 8c] [Tc]
dcami_nj: bets $3.70
PlayTheBlues4U: raises $1.34 to $5.04 and is all-in
dcami_nj: calls $1.34
*** SHOW DOWN ***
PlayTheBlues4U: shows [6s 6c] (four of a kind, Sixes)
dcami_nj: shows [Jd Jh] (two pair, Jacks and Eights)
PlayTheBlues4U collected $17.03 from pot
*** SUMMARY ***
Total pot $17.93 | Rake $0.90 
Board [6h 6d 8h 8c Tc]
Seat 1: trumpcaddy (small blind) folded before Flop
Seat 2: dcami_nj (big blind) showed [Jd Jh] and lost with two pair, Jacks and Eights
Seat 3: ng2414 folded before Flop (didn't bet)
Seat 4: ney1202 folded before Flop (didn't bet)
Seat 5: KeithTurbo48 folded before Flop (didn't bet)
Seat 6: PlayTheBlues4U (button) showed [6s 6c] and won ($17.03) with four of a kind, Sixes


*********** # 103 **************
PokerStars Hand #204907678126: Hold'em No Limit ($0.05/$0.10 USD) - 2019/10/22 22:09:27 ET
Table 'Celuta' 6-max Seat #5 is the button
Seat 1: trumpcaddy ($13.16 in chips) 
Seat 2: dcami_nj ($15.15 in chips) 
Seat 3: ng2414 ($9.20 in chips) 
Seat 4: ney1202 ($10.93 in chips) 
Seat 5: KeithTurbo48 ($12.86 in chips) 
Seat 6: PlayTheBlues4U ($8.99 in chips) 
PlayTheBlues4U: posts small blind $0.05
trumpcaddy: posts big blind $0.10
*** HOLE CARDS ***
Dealt to PlayTheBlues4U [Td 2c]
dcami_nj: raises $0.20 to $0.30
ng2414: folds 
ney1202: folds 
KeithTurbo48: calls $0.30
PlayTheBlues4U: folds 
trumpcaddy: calls $0.20
*** FLOP *** [Tc 3h 5s]
trumpcaddy: checks 
dcami_nj: bets $0.50
KeithTurbo48: calls $0.50
trumpcaddy: calls $0.50
*** TURN *** [Tc 3h 5s] [Jc]
trumpcaddy: checks 
dcami_nj: bets $1.50
KeithTurbo48: folds 
trumpcaddy: folds 
Uncalled bet ($1.50) returned to dcami_nj
dcami_nj collected $2.33 from pot
dcami_nj: doesn't show hand 
*** SUMMARY ***
Total pot $2.45 | Rake $0.12 
Board [Tc 3h 5s Jc]
Seat 1: trumpcaddy (big blind) folded on the Turn
Seat 2: dcami_nj collected ($2.33)
Seat 3: ng2414 folded before Flop (didn't bet)
Seat 4: ney1202 folded before Flop (didn't bet)
Seat 5: KeithTurbo48 (button) folded on the Turn
Seat 6: PlayTheBlues4U (small blind) folded before Flop


*********** # 104 **************
PokerStars Hand #204907678020: Hold'em No Limit ($0.05/$0.10 USD) - 2019/10/22 22:09:03 ET
Table 'Celuta' 6-max Seat #4 is the button
Seat 1: trumpcaddy ($13.16 in chips) 
Seat 2: dcami_nj ($15.15 in chips) 
Seat 4: ney1202 ($10.93 in chips) 
Seat 5: KeithTurbo48 ($12.76 in chips) 
Seat 6: PlayTheBlues4U ($9.09 in chips) 
KeithTurbo48: posts small blind $0.05
PlayTheBlues4U: posts big blind $0.10
*** HOLE CARDS ***
Dealt to PlayTheBlues4U [9h 8s]
trumpcaddy: folds 
dcami_nj: folds 
ney1202: folds 
KeithTurbo48: raises $0.20 to $0.30
PlayTheBlues4U: folds 
Uncalled bet ($0.20) returned to KeithTurbo48
KeithTurbo48 collected $0.20 from pot
KeithTurbo48: doesn't show hand 
*** SUMMARY ***
Total pot $0.20 | Rake $0 
Seat 1: trumpcaddy folded before Flop (didn't bet)
Seat 2: dcami_nj folded before Flop (didn't bet)
Seat 4: ney1202 (button) folded before Flop (didn't bet)
Seat 5: KeithTurbo48 (small blind) collected ($0.20)
Seat 6: PlayTheBlues4U (big blind) folded before Flop


*********** # 105 **************
PokerStars Hand #204907677994: Hold'em No Limit ($0.05/$0.10 USD) - 2019/10/22 22:08:56 ET
Table 'Danae' 6-max Seat #2 is the button
Seat 1: zombiehedgehog ($20.03 in chips) 
Seat 2: dcami_nj ($11.25 in chips) 
Seat 3: KeithTurbo48 ($10.64 in chips) 
Seat 4: ng2414 ($9.90 in chips) 
Seat 5: PlayTheBlues4U ($9.17 in chips) 
KeithTurbo48: posts small blind $0.05
ng2414: posts big blind $0.10
w111r@n: sits out 
*** HOLE CARDS ***
Dealt to PlayTheBlues4U [9d Jd]
PlayTheBlues4U: folds 
zombiehedgehog: folds 
dcami_nj: raises $0.20 to $0.30
KeithTurbo48: folds 
ng2414: raises $0.65 to $0.95
dcami_nj: calls $0.65
*** FLOP *** [5s Ah Jc]
ng2414: checks 
dcami_nj: bets $1
ng2414: calls $1
*** TURN *** [5s Ah Jc] [5d]
ng2414: checks 
dcami_nj: bets $3.70
ng2414: calls $3.70
*** RIVER *** [5s Ah Jc 5d] [Ad]
ng2414: bets $3.10
dcami_nj: folds 
Uncalled bet ($3.10) returned to ng2414
ng2414 collected $10.78 from pot
*** SUMMARY ***
Total pot $11.35 | Rake $0.57 
Board [5s Ah Jc 5d Ad]
Seat 1: zombiehedgehog folded before Flop (didn't bet)
Seat 2: dcami_nj (button) folded on the River
Seat 3: KeithTurbo48 (small blind) folded before Flop
Seat 4: ng2414 (big blind) collected ($10.78)
Seat 5: PlayTheBlues4U folded before Flop (didn't bet)


*********** # 106 **************
PokerStars Hand #204907677890: Hold'em No Limit ($0.05/$0.10 USD) - 2019/10/22 22:08:33 ET
Table 'Celuta' 6-max Seat #3 is the button
Seat 1: trumpcaddy ($13.16 in chips) 
Seat 2: dcami_nj ($15.15 in chips) 
Seat 3: ng2414 ($9.20 in chips) 
Seat 4: ney1202 ($10.98 in chips) 
Seat 5: KeithTurbo48 ($12.71 in chips) 
Seat 6: PlayTheBlues4U ($9.09 in chips) 
ney1202: posts small blind $0.05
KeithTurbo48: posts big blind $0.10
*** HOLE CARDS ***
Dealt to PlayTheBlues4U [Td Js]
PlayTheBlues4U: folds 
trumpcaddy: folds 
dcami_nj: folds 
ng2414 has timed out
ng2414: folds 
ney1202: folds 
Uncalled bet ($0.05) returned to KeithTurbo48
KeithTurbo48 collected $0.10 from pot
KeithTurbo48: doesn't show hand 
*** SUMMARY ***
Total pot $0.10 | Rake $0 
Seat 1: trumpcaddy folded before Flop (didn't bet)
Seat 2: dcami_nj folded before Flop (didn't bet)
Seat 3: ng2414 (button) folded before Flop (didn't bet)
Seat 4: ney1202 (small blind) folded before Flop
Seat 5: KeithTurbo48 (big blind) collected ($0.10)
Seat 6: PlayTheBlues4U folded before Flop (didn't bet)


*********** # 107 **************
PokerStars Hand #204907677767: Hold'em No Limit ($0.05/$0.10 USD) - 2019/10/22 22:08:06 ET
Table 'Danae' 6-max Seat #1 is the button
Seat 1: zombiehedgehog ($20.38 in chips) 
Seat 2: dcami_nj ($12.10 in chips) 
Seat 3: KeithTurbo48 ($9.54 in chips) 
Seat 4: ng2414 ($9.90 in chips) 
Seat 5: PlayTheBlues4U ($9.17 in chips) 
dcami_nj: posts small blind $0.05
KeithTurbo48: posts big blind $0.10
w111r@n: sits out 
*** HOLE CARDS ***
Dealt to PlayTheBlues4U [2s 4s]
ng2414: folds 
PlayTheBlues4U: folds 
zombiehedgehog: raises $0.25 to $0.35
dcami_nj: calls $0.30
KeithTurbo48: calls $0.25
*** FLOP *** [Th Js Qh]
dcami_nj: bets $0.50
KeithTurbo48: calls $0.50
zombiehedgehog: folds 
*** TURN *** [Th Js Qh] [2c]
dcami_nj: checks 
KeithTurbo48: bets $1.90
dcami_nj: folds 
Uncalled bet ($1.90) returned to KeithTurbo48
KeithTurbo48 collected $1.95 from pot
KeithTurbo48: doesn't show hand 
*** SUMMARY ***
Total pot $2.05 | Rake $0.10 
Board [Th Js Qh 2c]
Seat 1: zombiehedgehog (button) folded on the Flop
Seat 2: dcami_nj (small blind) folded on the Turn
Seat 3: KeithTurbo48 (big blind) collected ($1.95)
Seat 4: ng2414 folded before Flop (didn't bet)
Seat 5: PlayTheBlues4U folded before Flop (didn't bet)


*********** # 108 **************
PokerStars Hand #204907677740: Hold'em No Limit ($0.05/$0.10 USD) - 2019/10/22 22:07:59 ET
Table 'Celuta' 6-max Seat #2 is the button
Seat 1: trumpcaddy ($13.16 in chips) 
Seat 2: dcami_nj ($15.15 in chips) 
Seat 3: ng2414 ($9.25 in chips) 
Seat 4: ney1202 ($11.08 in chips) 
Seat 5: KeithTurbo48 ($12.71 in chips) 
Seat 6: PlayTheBlues4U ($8.94 in chips) 
ng2414: posts small blind $0.05
ney1202: posts big blind $0.10
*** HOLE CARDS ***
Dealt to PlayTheBlues4U [Qd Qh]
KeithTurbo48: folds 
PlayTheBlues4U: raises $0.20 to $0.30
trumpcaddy: folds 
dcami_nj: folds 
ng2414: folds 
ney1202: folds 
Uncalled bet ($0.20) returned to PlayTheBlues4U
PlayTheBlues4U collected $0.25 from pot
PlayTheBlues4U: doesn't show hand 
*** SUMMARY ***
Total pot $0.25 | Rake $0 
Seat 1: trumpcaddy folded before Flop (didn't bet)
Seat 2: dcami_nj (button) folded before Flop (didn't bet)
Seat 3: ng2414 (small blind) folded before Flop
Seat 4: ney1202 (big blind) folded before Flop
Seat 5: KeithTurbo48 folded before Flop (didn't bet)
Seat 6: PlayTheBlues4U collected ($0.25)


*********** # 109 **************
PokerStars Hand #204907677646: Hold'em No Limit ($0.05/$0.10 USD) - 2019/10/22 22:07:41 ET
Table 'Danae' 6-max Seat #5 is the button
Seat 1: zombiehedgehog ($20.29 in chips) 
Seat 2: dcami_nj ($12.20 in chips) 
Seat 3: KeithTurbo48 ($9.54 in chips) 
Seat 4: ng2414 ($9.90 in chips) 
Seat 5: PlayTheBlues4U ($9.17 in chips) 
w111r@n will be allowed to play after the button
zombiehedgehog: posts small blind $0.05
dcami_nj: posts big blind $0.10
*** HOLE CARDS ***
Dealt to PlayTheBlues4U [8c 4h]
KeithTurbo48: folds 
ng2414: folds 
PlayTheBlues4U: folds 
zombiehedgehog: calls $0.05
dcami_nj: checks 
*** FLOP *** [3s 8s Qh]
zombiehedgehog: checks 
dcami_nj: checks 
*** TURN *** [3s 8s Qh] [Th]
zombiehedgehog: bets $0.10
dcami_nj: folds 
Uncalled bet ($0.10) returned to zombiehedgehog
zombiehedgehog collected $0.19 from pot
zombiehedgehog: doesn't show hand 
*** SUMMARY ***
Total pot $0.20 | Rake $0.01 
Board [3s 8s Qh Th]
Seat 1: zombiehedgehog (small blind) collected ($0.19)
Seat 2: dcami_nj (big blind) folded on the Turn
Seat 3: KeithTurbo48 folded before Flop (didn't bet)
Seat 4: ng2414 folded before Flop (didn't bet)
Seat 5: PlayTheBlues4U (button) folded before Flop (didn't bet)


*********** # 110 **************
PokerStars Hand #204907677543: Hold'em No Limit ($0.05/$0.10 USD) - 2019/10/22 22:07:16 ET
Table 'Danae' 6-max Seat #4 is the button
Seat 1: zombiehedgehog ($20.39 in chips) 
Seat 2: dcami_nj ($12.20 in chips) 
Seat 3: KeithTurbo48 ($9.39 in chips) 
Seat 4: ng2414 ($9.90 in chips) 
Seat 5: PlayTheBlues4U ($9.22 in chips) 
PlayTheBlues4U: posts small blind $0.05
zombiehedgehog: posts big blind $0.10
*** HOLE CARDS ***
Dealt to PlayTheBlues4U [5s 6c]
dcami_nj: folds 
KeithTurbo48: raises $0.15 to $0.25
ng2414: folds 
w111r@n joins the table at seat #6 
PlayTheBlues4U: folds 
zombiehedgehog: folds 
Uncalled bet ($0.15) returned to KeithTurbo48
KeithTurbo48 collected $0.25 from pot
KeithTurbo48: doesn't show hand 
*** SUMMARY ***
Total pot $0.25 | Rake $0 
Seat 1: zombiehedgehog (big blind) folded before Flop
Seat 2: dcami_nj folded before Flop (didn't bet)
Seat 3: KeithTurbo48 collected ($0.25)
Seat 4: ng2414 (button) folded before Flop (didn't bet)
Seat 5: PlayTheBlues4U (small blind) folded before Flop


*********** # 111 **************
PokerStars Hand #204907677518: Hold'em No Limit ($0.05/$0.10 USD) - 2019/10/22 22:07:11 ET
Table 'Celuta' 6-max Seat #1 is the button
Seat 1: trumpcaddy ($13.16 in chips) 
Seat 2: dcami_nj ($15.20 in chips) 
Seat 3: ng2414 ($9.50 in chips) 
Seat 4: ney1202 ($11.08 in chips) 
Seat 5: KeithTurbo48 ($12.44 in chips) 
Seat 6: PlayTheBlues4U ($8.94 in chips) 
dcami_nj: posts small blind $0.05
ng2414: posts big blind $0.10
*** HOLE CARDS ***
Dealt to PlayTheBlues4U [Jc 4h]
ney1202: folds 
KeithTurbo48: raises $0.15 to $0.25
PlayTheBlues4U: folds 
trumpcaddy: folds 
dcami_nj: folds 
ng2414: calls $0.15
*** FLOP *** [6s Js Td]
ng2414: checks 
KeithTurbo48: checks 
*** TURN *** [6s Js Td] [7d]
ng2414: checks 
KeithTurbo48: bets $0.38
ng2414: folds 
Uncalled bet ($0.38) returned to KeithTurbo48
KeithTurbo48 collected $0.52 from pot
KeithTurbo48: doesn't show hand 
*** SUMMARY ***
Total pot $0.55 | Rake $0.03 
Board [6s Js Td 7d]
Seat 1: trumpcaddy (button) folded before Flop (didn't bet)
Seat 2: dcami_nj (small blind) folded before Flop
Seat 3: ng2414 (big blind) folded on the Turn
Seat 4: ney1202 folded before Flop (didn't bet)
Seat 5: KeithTurbo48 collected ($0.52)
Seat 6: PlayTheBlues4U folded before Flop (didn't bet)


*********** # 112 **************
PokerStars Hand #204907677435: Hold'em No Limit ($0.05/$0.10 USD) - 2019/10/22 22:06:53 ET
Table 'Danae' 6-max Seat #3 is the button
Seat 1: zombiehedgehog ($20.39 in chips) 
Seat 2: dcami_nj ($12.05 in chips) 
Seat 3: KeithTurbo48 ($9.39 in chips) 
Seat 4: ng2414 ($9.95 in chips) 
Seat 5: PlayTheBlues4U ($9.32 in chips) 
ng2414: posts small blind $0.05
PlayTheBlues4U: posts big blind $0.10
*** HOLE CARDS ***
Dealt to PlayTheBlues4U [3d Qs]
zombiehedgehog: folds 
dcami_nj: raises $0.20 to $0.30
KeithTurbo48: folds 
ng2414: folds 
PlayTheBlues4U: folds 
Uncalled bet ($0.20) returned to dcami_nj
dcami_nj collected $0.25 from pot
dcami_nj: doesn't show hand 
*** SUMMARY ***
Total pot $0.25 | Rake $0 
Seat 1: zombiehedgehog folded before Flop (didn't bet)
Seat 2: dcami_nj collected ($0.25)
Seat 3: KeithTurbo48 (button) folded before Flop (didn't bet)
Seat 4: ng2414 (small blind) folded before Flop
Seat 5: PlayTheBlues4U (big blind) folded before Flop


*********** # 113 **************
PokerStars Hand #204907677308: Hold'em No Limit ($0.05/$0.10 USD) - 2019/10/22 22:06:24 ET
Table 'Celuta' 6-max Seat #6 is the button
Seat 1: trumpcaddy ($13.21 in chips) 
Seat 2: dcami_nj ($15.45 in chips) 
Seat 3: ng2414 ($9.50 in chips) 
Seat 4: ney1202 ($11.08 in chips) 
Seat 5: KeithTurbo48 ($11.93 in chips) 
Seat 6: PlayTheBlues4U ($9.19 in chips) 
trumpcaddy: posts small blind $0.05
dcami_nj: posts big blind $0.10
*** HOLE CARDS ***
Dealt to PlayTheBlues4U [Td Jc]
ng2414: folds 
ney1202: folds 
KeithTurbo48: raises $0.15 to $0.25
PlayTheBlues4U: calls $0.25
trumpcaddy: folds 
dcami_nj: calls $0.15
*** FLOP *** [5c 5s 2d]
dcami_nj: checks 
KeithTurbo48: bets $0.25
PlayTheBlues4U: folds 
dcami_nj: folds 
Uncalled bet ($0.25) returned to KeithTurbo48
KeithTurbo48 collected $0.76 from pot
KeithTurbo48: doesn't show hand 
*** SUMMARY ***
Total pot $0.80 | Rake $0.04 
Board [5c 5s 2d]
Seat 1: trumpcaddy (small blind) folded before Flop
Seat 2: dcami_nj (big blind) folded on the Flop
Seat 3: ng2414 folded before Flop (didn't bet)
Seat 4: ney1202 folded before Flop (didn't bet)
Seat 5: KeithTurbo48 collected ($0.76)
Seat 6: PlayTheBlues4U (button) folded on the Flop


*********** # 114 **************
PokerStars Hand #204907677179: Hold'em No Limit ($0.05/$0.10 USD) - 2019/10/22 22:05:52 ET
Table 'Celuta' 6-max Seat #5 is the button
Seat 1: trumpcaddy ($13.51 in chips) 
Seat 2: dcami_nj ($15.45 in chips) 
Seat 3: ng2414 ($9.50 in chips) 
Seat 4: ney1202 ($11.08 in chips) 
Seat 5: KeithTurbo48 ($11.93 in chips) 
Seat 6: PlayTheBlues4U ($8.92 in chips) 
PlayTheBlues4U: posts small blind $0.05
trumpcaddy: posts big blind $0.10
*** HOLE CARDS ***
Dealt to PlayTheBlues4U [Jd Ac]
dcami_nj: folds 
ng2414: folds 
ney1202: folds 
KeithTurbo48: folds 
PlayTheBlues4U: raises $0.20 to $0.30
trumpcaddy: calls $0.20
*** FLOP *** [Ah 5d Qs]
PlayTheBlues4U: checks 
trumpcaddy: checks 
*** TURN *** [Ah 5d Qs] [Kd]
PlayTheBlues4U: bets $0.40
trumpcaddy: folds 
Uncalled bet ($0.40) returned to PlayTheBlues4U
PlayTheBlues4U collected $0.57 from pot
PlayTheBlues4U: doesn't show hand 
*** SUMMARY ***
Total pot $0.60 | Rake $0.03 
Board [Ah 5d Qs Kd]
Seat 1: trumpcaddy (big blind) folded on the Turn
Seat 2: dcami_nj folded before Flop (didn't bet)
Seat 3: ng2414 folded before Flop (didn't bet)
Seat 4: ney1202 folded before Flop (didn't bet)
Seat 5: KeithTurbo48 (button) folded before Flop (didn't bet)
Seat 6: PlayTheBlues4U (small blind) collected ($0.57)


*********** # 115 **************
PokerStars Hand #204907676944: Hold'em No Limit ($0.05/$0.10 USD) - 2019/10/22 22:04:59 ET
Table 'Danae' 6-max Seat #2 is the button
Seat 1: zombiehedgehog ($20.61 in chips) 
Seat 2: dcami_nj ($12.05 in chips) 
Seat 3: KeithTurbo48 ($9.44 in chips) 
Seat 4: ng2414 ($9.70 in chips) 
Seat 5: PlayTheBlues4U ($9.32 in chips) 
KeithTurbo48: posts small blind $0.05
ng2414: posts big blind $0.10
*** HOLE CARDS ***
Dealt to PlayTheBlues4U [7s Js]
PlayTheBlues4U: folds 
zombiehedgehog: calls $0.10
dcami_nj: folds 
KeithTurbo48: folds 
ng2414: checks 
*** FLOP *** [Kd 7d Jh]
ng2414: checks 
zombiehedgehog: checks 
*** TURN *** [Kd 7d Jh] [5d]
ng2414: checks 
zombiehedgehog: checks 
*** RIVER *** [Kd 7d Jh 5d] [Qs]
ng2414: checks 
zombiehedgehog: bets $0.12
ng2414: calls $0.12
*** SHOW DOWN ***
zombiehedgehog: shows [4s 8s] (high card King)
ng2414: shows [7h Th] (a pair of Sevens)
ng2414 collected $0.47 from pot
*** SUMMARY ***
Total pot $0.49 | Rake $0.02 
Board [Kd 7d Jh 5d Qs]
Seat 1: zombiehedgehog showed [4s 8s] and lost with high card King
Seat 2: dcami_nj (button) folded before Flop (didn't bet)
Seat 3: KeithTurbo48 (small blind) folded before Flop
Seat 4: ng2414 (big blind) showed [7h Th] and won ($0.47) with a pair of Sevens
Seat 5: PlayTheBlues4U folded before Flop (didn't bet)


*********** # 116 **************
PokerStars Hand #204907676892: Hold'em No Limit ($0.05/$0.10 USD) - 2019/10/22 22:04:47 ET
Table 'Celuta' 6-max Seat #4 is the button
Seat 1: trumpcaddy ($13.51 in chips) 
Seat 2: dcami_nj ($15.45 in chips) 
Seat 3: ng2414 ($9.50 in chips) 
Seat 4: ney1202 ($10.06 in chips) 
Seat 5: KeithTurbo48 ($11.98 in chips) 
Seat 6: PlayTheBlues4U ($10 in chips) 
KeithTurbo48: posts small blind $0.05
PlayTheBlues4U: posts big blind $0.10
*** HOLE CARDS ***
Dealt to PlayTheBlues4U [Js 7s]
trumpcaddy: folds 
dcami_nj: folds 
PlayTheBlues4U said, "wow"
ng2414: folds 
ney1202: raises $0.13 to $0.23
KeithTurbo48: folds 
PlayTheBlues4U: calls $0.13
*** FLOP *** [8s Kc Ad]
PlayTheBlues4U: checks 
ney1202: checks 
*** TURN *** [8s Kc Ad] [2d]
PlayTheBlues4U: bets $0.25
ney1202: calls $0.25
*** RIVER *** [8s Kc Ad 2d] [4c]
PlayTheBlues4U: bets $0.60
ney1202: calls $0.60
*** SHOW DOWN ***
PlayTheBlues4U: shows [Js 7s] (high card Ace)
ney1202: shows [6d Ah] (a pair of Aces)
ney1202 collected $2.10 from pot
*** SUMMARY ***
Total pot $2.21 | Rake $0.11 
Board [8s Kc Ad 2d 4c]
Seat 1: trumpcaddy folded before Flop (didn't bet)
Seat 2: dcami_nj folded before Flop (didn't bet)
Seat 3: ng2414 folded before Flop (didn't bet)
Seat 4: ney1202 (button) showed [6d Ah] and won ($2.10) with a pair of Aces
Seat 5: KeithTurbo48 (small blind) folded before Flop
Seat 6: PlayTheBlues4U (big blind) showed [Js 7s] and lost with high card Ace


*********** # 117 **************
PokerStars Hand #204907676631: Hold'em No Limit ($0.05/$0.10 USD) - 2019/10/22 22:03:47 ET
Table 'Danae' 6-max Seat #1 is the button
Seat 1: zombiehedgehog ($20.61 in chips) 
Seat 2: dcami_nj ($12.85 in chips) 
Seat 3: KeithTurbo48 ($8.44 in chips) 
Seat 4: ng2414 ($10 in chips) 
Seat 5: PlayTheBlues4U ($9.32 in chips) 
dcami_nj: posts small blind $0.05
KeithTurbo48: posts big blind $0.10
*** HOLE CARDS ***
Dealt to PlayTheBlues4U [4s Ah]
ng2414: raises $0.20 to $0.30
PlayTheBlues4U: folds 
zombiehedgehog: folds 
dcami_nj: calls $0.25
KeithTurbo48: calls $0.20
*** FLOP *** [Js Td 3c]
dcami_nj: checks 
KeithTurbo48: checks 
ng2414: checks 
*** TURN *** [Js Td 3c] [5s]
dcami_nj: bets $0.50
KeithTurbo48: calls $0.50
ng2414: folds 
*** RIVER *** [Js Td 3c 5s] [2s]
dcami_nj: checks 
KeithTurbo48: checks 
*** SHOW DOWN ***
dcami_nj: shows [6c 6d] (a pair of Sixes)
KeithTurbo48: shows [Ts Qd] (a pair of Tens)
KeithTurbo48 collected $1.80 from pot
*** SUMMARY ***
Total pot $1.90 | Rake $0.10 
Board [Js Td 3c 5s 2s]
Seat 1: zombiehedgehog (button) folded before Flop (didn't bet)
Seat 2: dcami_nj (small blind) showed [6c 6d] and lost with a pair of Sixes
Seat 3: KeithTurbo48 (big blind) showed [Ts Qd] and won ($1.80) with a pair of Tens
Seat 4: ng2414 folded on the Turn
Seat 5: PlayTheBlues4U folded before Flop (didn't bet)


*********** # 118 **************
PokerStars Hand #204907676579: Hold'em No Limit ($0.05/$0.10 USD) - 2019/10/22 22:03:38 ET
Table 'Celuta' 6-max Seat #3 is the button
Seat 1: trumpcaddy ($13.51 in chips) 
Seat 2: dcami_nj ($15.45 in chips) 
Seat 3: ng2414 ($9.50 in chips) 
Seat 4: ney1202 ($10.11 in chips) 
Seat 5: KeithTurbo48 ($6.28 in chips) 
Seat 6: PlayTheBlues4U ($10.17 in chips) 
ney1202: posts small blind $0.05
KeithTurbo48: posts big blind $0.10
*** HOLE CARDS ***
Dealt to PlayTheBlues4U [Tc Th]
PlayTheBlues4U: raises $0.20 to $0.30
trumpcaddy: folds 
dcami_nj: folds 
ng2414: folds 
ney1202: folds 
KeithTurbo48: calls $0.20
*** FLOP *** [6s 4c 4s]
KeithTurbo48: checks 
PlayTheBlues4U: bets $0.40
KeithTurbo48: raises $0.90 to $1.30
PlayTheBlues4U: calls $0.90
*** TURN *** [6s 4c 4s] [9c]
KeithTurbo48: bets $1.20
PlayTheBlues4U: raises $2.30 to $3.50
KeithTurbo48: raises $1.18 to $4.68 and is all-in
PlayTheBlues4U: calls $1.18
*** RIVER *** [6s 4c 4s 9c] [3h]
*** SHOW DOWN ***
KeithTurbo48: shows [4h 9h] (a full house, Fours full of Nines)
PlayTheBlues4U: shows [Tc Th] (two pair, Tens and Fours)
KeithTurbo48 collected $11.98 from pot
*** SUMMARY ***
Total pot $12.61 | Rake $0.63 
Board [6s 4c 4s 9c 3h]
Seat 1: trumpcaddy folded before Flop (didn't bet)
Seat 2: dcami_nj folded before Flop (didn't bet)
Seat 3: ng2414 (button) folded before Flop (didn't bet)
Seat 4: ney1202 (small blind) folded before Flop
Seat 5: KeithTurbo48 (big blind) showed [4h 9h] and won ($11.98) with a full house, Fours full of Nines
Seat 6: PlayTheBlues4U showed [Tc Th] and lost with two pair, Tens and Fours


*********** # 119 **************
PokerStars Hand #204907676434: Hold'em No Limit ($0.05/$0.10 USD) - 2019/10/22 22:03:05 ET
Table 'Celuta' 6-max Seat #2 is the button
Seat 1: trumpcaddy ($12.47 in chips) 
Seat 2: dcami_nj ($15.45 in chips) 
Seat 3: ng2414 ($9.55 in chips) 
Seat 4: ney1202 ($10.21 in chips) 
Seat 5: KeithTurbo48 ($7.28 in chips) 
Seat 6: PlayTheBlues4U ($10.17 in chips) 
ng2414: posts small blind $0.05
ney1202: posts big blind $0.10
*** HOLE CARDS ***
Dealt to PlayTheBlues4U [Td 9c]
KeithTurbo48: raises $0.15 to $0.25
PlayTheBlues4U: folds 
trumpcaddy: raises $0.75 to $1
dcami_nj: folds 
ng2414: folds 
ney1202: folds 
KeithTurbo48: calls $0.75
*** FLOP *** [Jd 7h Ts]
KeithTurbo48: checks 
trumpcaddy: bets $2
KeithTurbo48: folds 
Uncalled bet ($2) returned to trumpcaddy
trumpcaddy collected $2.04 from pot
trumpcaddy: doesn't show hand 
*** SUMMARY ***
Total pot $2.15 | Rake $0.11 
Board [Jd 7h Ts]
Seat 1: trumpcaddy collected ($2.04)
Seat 2: dcami_nj (button) folded before Flop (didn't bet)
Seat 3: ng2414 (small blind) folded before Flop
Seat 4: ney1202 (big blind) folded before Flop
Seat 5: KeithTurbo48 folded on the Flop
Seat 6: PlayTheBlues4U folded before Flop (didn't bet)


*********** # 120 **************
PokerStars Hand #204907676363: Hold'em No Limit ($0.05/$0.10 USD) - 2019/10/22 22:02:46 ET
Table 'Danae' 6-max Seat #6 is the button
Seat 1: zombiehedgehog ($22.16 in chips) 
Seat 2: dcami_nj ($10.84 in chips) 
Seat 3: KeithTurbo48 ($8.44 in chips) 
Seat 4: ng2414 ($10 in chips) 
Seat 5: PlayTheBlues4U ($9.32 in chips) 
Seat 6: kptrpt ($12.85 in chips) 
zombiehedgehog: posts small blind $0.05
dcami_nj: posts big blind $0.10
*** HOLE CARDS ***
Dealt to PlayTheBlues4U [Ad 6c]
KeithTurbo48: folds 
ng2414: folds 
PlayTheBlues4U: folds 
kptrpt: raises $0.15 to $0.25
zombiehedgehog: calls $0.20
dcami_nj: calls $0.15
*** FLOP *** [8c 7d Js]
zombiehedgehog: checks 
dcami_nj: bets $0.40
kptrpt: calls $0.40
zombiehedgehog: calls $0.40
*** TURN *** [8c 7d Js] [2s]
zombiehedgehog: checks 
dcami_nj: bets $0.90
kptrpt: folds 
kptrpt leaves the table
zombiehedgehog: calls $0.90
*** RIVER *** [8c 7d Js 2s] [4d]
zombiehedgehog: checks 
dcami_nj: checks 
*** SHOW DOWN ***
zombiehedgehog: shows [Td Kd] (high card King)
dcami_nj: shows [9s 8h] (a pair of Eights)
dcami_nj collected $3.56 from pot
*** SUMMARY ***
Total pot $3.75 | Rake $0.19 
Board [8c 7d Js 2s 4d]
Seat 1: zombiehedgehog (small blind) showed [Td Kd] and lost with high card King
Seat 2: dcami_nj (big blind) showed [9s 8h] and won ($3.56) with a pair of Eights
Seat 3: KeithTurbo48 folded before Flop (didn't bet)
Seat 4: ng2414 folded before Flop (didn't bet)
Seat 5: PlayTheBlues4U folded before Flop (didn't bet)
Seat 6: kptrpt (button) folded on the Turn


*********** # 121 **************
PokerStars Hand #204907676286: Hold'em No Limit ($0.05/$0.10 USD) - 2019/10/22 22:02:29 ET
Table 'Celuta' 6-max Seat #1 is the button
Seat 1: trumpcaddy ($12.47 in chips) 
Seat 2: dcami_nj ($15.18 in chips) 
Seat 3: ng2414 ($9.85 in chips) 
Seat 4: ney1202 ($10.21 in chips) 
Seat 5: KeithTurbo48 ($7.28 in chips) 
Seat 6: PlayTheBlues4U ($10.17 in chips) 
dcami_nj: posts small blind $0.05
ng2414: posts big blind $0.10
*** HOLE CARDS ***
Dealt to PlayTheBlues4U [3s 8d]
ney1202: folds 
KeithTurbo48: folds 
PlayTheBlues4U: folds 
trumpcaddy: folds 
dcami_nj: raises $0.20 to $0.30
ng2414: calls $0.20
*** FLOP *** [Qd Kd Ac]
dcami_nj: bets $0.30
ng2414: folds 
Uncalled bet ($0.30) returned to dcami_nj
dcami_nj collected $0.57 from pot
dcami_nj: doesn't show hand 
*** SUMMARY ***
Total pot $0.60 | Rake $0.03 
Board [Qd Kd Ac]
Seat 1: trumpcaddy (button) folded before Flop (didn't bet)
Seat 2: dcami_nj (small blind) collected ($0.57)
Seat 3: ng2414 (big blind) folded on the Flop
Seat 4: ney1202 folded before Flop (didn't bet)
Seat 5: KeithTurbo48 folded before Flop (didn't bet)
Seat 6: PlayTheBlues4U folded before Flop (didn't bet)


*********** # 122 **************
PokerStars Hand #204907676127: Hold'em No Limit ($0.05/$0.10 USD) - 2019/10/22 22:01:53 ET
Table 'Danae' 6-max Seat #5 is the button
Seat 1: zombiehedgehog ($22.26 in chips) 
Seat 2: dcami_nj ($10.84 in chips) 
Seat 3: KeithTurbo48 ($8.44 in chips) 
Seat 4: ng2414 ($8.55 in chips) 
Seat 5: PlayTheBlues4U ($10.06 in chips) 
Seat 6: kptrpt ($12.09 in chips) 
kptrpt: posts small blind $0.05
zombiehedgehog: posts big blind $0.10
*** HOLE CARDS ***
Dealt to PlayTheBlues4U [Js Jh]
dcami_nj: folds 
KeithTurbo48: folds 
ng2414: folds 
PlayTheBlues4U: raises $0.20 to $0.30
kptrpt: calls $0.25
zombiehedgehog: folds 
*** FLOP *** [9h 5c Kh]
kptrpt: bets $0.44
PlayTheBlues4U: calls $0.44
*** TURN *** [9h 5c Kh] [As]
kptrpt: checks 
PlayTheBlues4U: checks 
*** RIVER *** [9h 5c Kh As] [Th]
kptrpt: bets $1
PlayTheBlues4U: folds 
Uncalled bet ($1) returned to kptrpt
kptrpt collected $1.50 from pot
kptrpt: doesn't show hand 
*** SUMMARY ***
Total pot $1.58 | Rake $0.08 
Board [9h 5c Kh As Th]
Seat 1: zombiehedgehog (big blind) folded before Flop
Seat 2: dcami_nj folded before Flop (didn't bet)
Seat 3: KeithTurbo48 folded before Flop (didn't bet)
Seat 4: ng2414 folded before Flop (didn't bet)
Seat 5: PlayTheBlues4U (button) folded on the River
Seat 6: kptrpt (small blind) collected ($1.50)


*********** # 123 **************
PokerStars Hand #204907676123: Hold'em No Limit ($0.05/$0.10 USD) - 2019/10/22 22:01:53 ET
Table 'Celuta' 6-max Seat #6 is the button
Seat 1: trumpcaddy ($12.57 in chips) 
Seat 2: dcami_nj ($15.09 in chips) 
Seat 3: ng2414 ($9.85 in chips) 
Seat 4: ney1202 ($10.21 in chips) 
Seat 5: KeithTurbo48 ($7.28 in chips) 
Seat 6: PlayTheBlues4U ($10.17 in chips) 
trumpcaddy: posts small blind $0.05
dcami_nj: posts big blind $0.10
*** HOLE CARDS ***
Dealt to PlayTheBlues4U [3d 7d]
ng2414: folds 
ney1202: folds 
KeithTurbo48: folds 
PlayTheBlues4U: folds 
trumpcaddy: calls $0.05
dcami_nj: checks 
*** FLOP *** [3s Qh Ad]
trumpcaddy: checks 
dcami_nj: bets $0.20
trumpcaddy: folds 
Uncalled bet ($0.20) returned to dcami_nj
dcami_nj collected $0.19 from pot
dcami_nj: doesn't show hand 
*** SUMMARY ***
Total pot $0.20 | Rake $0.01 
Board [3s Qh Ad]
Seat 1: trumpcaddy (small blind) folded on the Flop
Seat 2: dcami_nj (big blind) collected ($0.19)
Seat 3: ng2414 folded before Flop (didn't bet)
Seat 4: ney1202 folded before Flop (didn't bet)
Seat 5: KeithTurbo48 folded before Flop (didn't bet)
Seat 6: PlayTheBlues4U (button) folded before Flop (didn't bet)


*********** # 124 **************
PokerStars Hand #204907675960: Hold'em No Limit ($0.05/$0.10 USD) - 2019/10/22 22:01:16 ET
Table 'Celuta' 6-max Seat #5 is the button
Seat 1: trumpcaddy ($12.52 in chips) 
Seat 2: dcami_nj ($15.09 in chips) 
Seat 3: ng2414 ($9.85 in chips) 
Seat 4: ney1202 ($10.21 in chips) 
Seat 5: KeithTurbo48 ($7.28 in chips) 
Seat 6: PlayTheBlues4U ($10.22 in chips) 
PlayTheBlues4U: posts small blind $0.05
trumpcaddy: posts big blind $0.10
*** HOLE CARDS ***
Dealt to PlayTheBlues4U [Ts 3c]
dcami_nj: folds 
ng2414: folds 
ney1202: folds 
KeithTurbo48: folds 
PlayTheBlues4U: folds 
Uncalled bet ($0.05) returned to trumpcaddy
trumpcaddy collected $0.10 from pot
trumpcaddy: doesn't show hand 
*** SUMMARY ***
Total pot $0.10 | Rake $0 
Seat 1: trumpcaddy (big blind) collected ($0.10)
Seat 2: dcami_nj folded before Flop (didn't bet)
Seat 3: ng2414 folded before Flop (didn't bet)
Seat 4: ney1202 folded before Flop (didn't bet)
Seat 5: KeithTurbo48 (button) folded before Flop (didn't bet)
Seat 6: PlayTheBlues4U (small blind) folded before Flop


*********** # 125 **************
PokerStars Hand #204907675793: Hold'em No Limit ($0.05/$0.10 USD) - 2019/10/22 22:00:37 ET
Table 'Danae' 6-max Seat #4 is the button
Seat 1: zombiehedgehog ($22.36 in chips) 
Seat 2: dcami_nj ($10.84 in chips) 
Seat 3: KeithTurbo48 ($8.44 in chips) 
Seat 4: ng2414 ($9.85 in chips) 
Seat 5: PlayTheBlues4U ($8.70 in chips) 
Seat 6: kptrpt ($12.19 in chips) 
PlayTheBlues4U: posts small blind $0.05
kptrpt: posts big blind $0.10
*** HOLE CARDS ***
Dealt to PlayTheBlues4U [Tc Th]
zombiehedgehog: calls $0.10
dcami_nj: folds 
KeithTurbo48: folds 
ng2414: raises $0.35 to $0.45
PlayTheBlues4U: raises $0.85 to $1.30
kptrpt: folds 
zombiehedgehog: folds 
ng2414: calls $0.85
*** FLOP *** [6h Ts Jh]
PlayTheBlues4U: bets $1.40
ng2414: folds 
Uncalled bet ($1.40) returned to PlayTheBlues4U
PlayTheBlues4U collected $2.66 from pot
PlayTheBlues4U: doesn't show hand 
*** SUMMARY ***
Total pot $2.80 | Rake $0.14 
Board [6h Ts Jh]
Seat 1: zombiehedgehog folded before Flop
Seat 2: dcami_nj folded before Flop (didn't bet)
Seat 3: KeithTurbo48 folded before Flop (didn't bet)
Seat 4: ng2414 (button) folded on the Flop
Seat 5: PlayTheBlues4U (small blind) collected ($2.66)
Seat 6: kptrpt (big blind) folded before Flop


*********** # 126 **************
PokerStars Hand #204907675773: Hold'em No Limit ($0.05/$0.10 USD) - 2019/10/22 22:00:33 ET
Table 'Celuta' 6-max Seat #4 is the button
Seat 1: trumpcaddy ($12.52 in chips) 
Seat 2: dcami_nj ($15.09 in chips) 
Seat 3: ng2414 ($9.85 in chips) 
Seat 4: ney1202 ($10.21 in chips) 
Seat 5: KeithTurbo48 ($7.31 in chips) 
Seat 6: PlayTheBlues4U ($10.25 in chips) 
KeithTurbo48: posts small blind $0.05
PlayTheBlues4U: posts big blind $0.10
*** HOLE CARDS ***
Dealt to PlayTheBlues4U [5h 2h]
trumpcaddy: folds 
dcami_nj: folds 
ng2414: folds 
ney1202: folds 
KeithTurbo48: calls $0.05
PlayTheBlues4U: checks 
*** FLOP *** [6d 2c 5c]
KeithTurbo48: bets $0.14
PlayTheBlues4U: calls $0.14
*** TURN *** [6d 2c 5c] [4s]
KeithTurbo48: bets $0.40
PlayTheBlues4U: calls $0.40
*** RIVER *** [6d 2c 5c 4s] [3c]
KeithTurbo48: checks 
PlayTheBlues4U: checks 
*** SHOW DOWN ***
KeithTurbo48: shows [2d 4d] (a straight, Deuce to Six)
PlayTheBlues4U: shows [5h 2h] (a straight, Deuce to Six)
KeithTurbo48 collected $0.61 from pot
PlayTheBlues4U collected $0.61 from pot
*** SUMMARY ***
Total pot $1.28 | Rake $0.06 
Board [6d 2c 5c 4s 3c]
Seat 1: trumpcaddy folded before Flop (didn't bet)
Seat 2: dcami_nj folded before Flop (didn't bet)
Seat 3: ng2414 folded before Flop (didn't bet)
Seat 4: ney1202 (button) folded before Flop (didn't bet)
Seat 5: KeithTurbo48 (small blind) showed [2d 4d] and won ($0.61) with a straight, Deuce to Six
Seat 6: PlayTheBlues4U (big blind) showed [5h 2h] and won ($0.61) with a straight, Deuce to Six


*********** # 127 **************
PokerStars Hand #204907675653: Hold'em No Limit ($0.05/$0.10 USD) - 2019/10/22 21:59:55 ET
Table 'Celuta' 6-max Seat #3 is the button
Seat 1: trumpcaddy ($12.52 in chips) 
Seat 2: dcami_nj ($15.09 in chips) 
Seat 3: ng2414 ($9.85 in chips) 
Seat 4: ney1202 ($9.90 in chips) 
Seat 5: KeithTurbo48 ($7.66 in chips) 
Seat 6: PlayTheBlues4U ($10.25 in chips) 
ney1202: posts small blind $0.05
KeithTurbo48: posts big blind $0.10
*** HOLE CARDS ***
Dealt to PlayTheBlues4U [Qd 4h]
PlayTheBlues4U: folds 
trumpcaddy: folds 
dcami_nj: folds 
ng2414: folds 
ney1202: raises $0.25 to $0.35
KeithTurbo48: calls $0.25
*** FLOP *** [Ac 6d 6s]
ney1202: bets $0.30
KeithTurbo48: folds 
Uncalled bet ($0.30) returned to ney1202
ney1202 collected $0.66 from pot
*** SUMMARY ***
Total pot $0.70 | Rake $0.04 
Board [Ac 6d 6s]
Seat 1: trumpcaddy folded before Flop (didn't bet)
Seat 2: dcami_nj folded before Flop (didn't bet)
Seat 3: ng2414 (button) folded before Flop (didn't bet)
Seat 4: ney1202 (small blind) collected ($0.66)
Seat 5: KeithTurbo48 (big blind) folded on the Flop
Seat 6: PlayTheBlues4U folded before Flop (didn't bet)


*********** # 128 **************
PokerStars Hand #204907675641: Hold'em No Limit ($0.05/$0.10 USD) - 2019/10/22 21:59:52 ET
Table 'Danae' 6-max Seat #3 is the button
Seat 1: zombiehedgehog ($21.95 in chips) 
Seat 2: dcami_nj ($10.84 in chips) 
Seat 3: KeithTurbo48 ($8.54 in chips) 
Seat 4: ng2414 ($9.90 in chips) 
Seat 5: PlayTheBlues4U ($9 in chips) 
Seat 6: kptrpt ($12.19 in chips) 
ng2414: posts small blind $0.05
PlayTheBlues4U: posts big blind $0.10
*** HOLE CARDS ***
Dealt to PlayTheBlues4U [3h 9h]
kptrpt: folds 
zombiehedgehog: calls $0.10
dcami_nj: folds 
KeithTurbo48: calls $0.10
ng2414: folds 
PlayTheBlues4U: checks 
*** FLOP *** [Qd Kc 5h]
PlayTheBlues4U: checks 
zombiehedgehog: checks 
KeithTurbo48: checks 
*** TURN *** [Qd Kc 5h] [6h]
PlayTheBlues4U: bets $0.20
zombiehedgehog: calls $0.20
KeithTurbo48: folds 
*** RIVER *** [Qd Kc 5h 6h] [Kd]
PlayTheBlues4U: checks 
zombiehedgehog: bets $0.71
PlayTheBlues4U: folds 
Uncalled bet ($0.71) returned to zombiehedgehog
zombiehedgehog collected $0.71 from pot
zombiehedgehog: doesn't show hand 
*** SUMMARY ***
Total pot $0.75 | Rake $0.04 
Board [Qd Kc 5h 6h Kd]
Seat 1: zombiehedgehog collected ($0.71)
Seat 2: dcami_nj folded before Flop (didn't bet)
Seat 3: KeithTurbo48 (button) folded on the Turn
Seat 4: ng2414 (small blind) folded before Flop
Seat 5: PlayTheBlues4U (big blind) folded on the River
Seat 6: kptrpt folded before Flop (didn't bet)


*********** # 129 **************
PokerStars Hand #204907675529: Hold'em No Limit ($0.05/$0.10 USD) - 2019/10/22 21:59:18 ET
Table 'Celuta' 6-max Seat #2 is the button
Seat 1: trumpcaddy ($12.52 in chips) 
Seat 2: dcami_nj ($14.54 in chips) 
Seat 3: ng2414 ($9.90 in chips) 
Seat 4: ney1202 ($10 in chips) 
Seat 5: KeithTurbo48 ($8.11 in chips) 
Seat 6: PlayTheBlues4U ($10.25 in chips) 
ng2414: posts small blind $0.05
ney1202: posts big blind $0.10
*** HOLE CARDS ***
Dealt to PlayTheBlues4U [3s Kc]
KeithTurbo48: raises $0.15 to $0.25
PlayTheBlues4U: folds 
trumpcaddy: folds 
dcami_nj: calls $0.25
ng2414: folds 
ney1202: folds 
*** FLOP *** [3d Ks 6s]
KeithTurbo48: bets $0.20
dcami_nj: calls $0.20
*** TURN *** [3d Ks 6s] [4c]
KeithTurbo48: checks 
dcami_nj: bets $1
KeithTurbo48: folds 
Uncalled bet ($1) returned to dcami_nj
dcami_nj collected $1 from pot
dcami_nj: doesn't show hand 
*** SUMMARY ***
Total pot $1.05 | Rake $0.05 
Board [3d Ks 6s 4c]
Seat 1: trumpcaddy folded before Flop (didn't bet)
Seat 2: dcami_nj (button) collected ($1)
Seat 3: ng2414 (small blind) folded before Flop
Seat 4: ney1202 (big blind) folded before Flop
Seat 5: KeithTurbo48 folded on the Turn
Seat 6: PlayTheBlues4U folded before Flop (didn't bet)


*********** # 130 **************
PokerStars Hand #204907675462: Hold'em No Limit ($0.05/$0.10 USD) - 2019/10/22 21:58:57 ET
Table 'Danae' 6-max Seat #2 is the button
Seat 1: zombiehedgehog ($21.22 in chips) 
Seat 2: dcami_nj ($10.84 in chips) 
Seat 3: KeithTurbo48 ($9.25 in chips) 
Seat 4: ng2414 ($10 in chips) 
Seat 5: PlayTheBlues4U ($9 in chips) 
Seat 6: kptrpt ($12.19 in chips) 
KeithTurbo48: posts small blind $0.05
ng2414: posts big blind $0.10
*** HOLE CARDS ***
Dealt to PlayTheBlues4U [6s Th]
PlayTheBlues4U: folds 
kptrpt: folds 
zombiehedgehog: calls $0.10
dcami_nj: folds 
KeithTurbo48: calls $0.05
ng2414: checks 
*** FLOP *** [5c 6c 8h]
KeithTurbo48: checks 
ng2414: checks 
zombiehedgehog: checks 
*** TURN *** [5c 6c 8h] [2h]
KeithTurbo48: bets $0.21
ng2414: folds 
zombiehedgehog: calls $0.21
*** RIVER *** [5c 6c 8h 2h] [6d]
KeithTurbo48: bets $0.40
zombiehedgehog: raises $0.84 to $1.24
KeithTurbo48: folds 
Uncalled bet ($0.84) returned to zombiehedgehog
zombiehedgehog collected $1.44 from pot
zombiehedgehog: doesn't show hand 
*** SUMMARY ***
Total pot $1.52 | Rake $0.08 
Board [5c 6c 8h 2h 6d]
Seat 1: zombiehedgehog collected ($1.44)
Seat 2: dcami_nj (button) folded before Flop (didn't bet)
Seat 3: KeithTurbo48 (small blind) folded on the River
Seat 4: ng2414 (big blind) folded on the Turn
Seat 5: PlayTheBlues4U folded before Flop (didn't bet)
Seat 6: kptrpt folded before Flop (didn't bet)


*********** # 131 **************
PokerStars Hand #204907675325: Hold'em No Limit ($0.05/$0.10 USD) - 2019/10/22 21:58:18 ET
Table 'Celuta' 6-max Seat #1 is the button
Seat 1: trumpcaddy ($9.96 in chips) 
Seat 2: dcami_nj ($14.59 in chips) 
Seat 3: ng2414 ($10 in chips) 
Seat 4: Varginho13 ($19.18 in chips) 
Seat 5: KeithTurbo48 ($10 in chips) 
Seat 6: PlayTheBlues4U ($11 in chips) 
dcami_nj: posts small blind $0.05
ng2414: posts big blind $0.10
*** HOLE CARDS ***
Dealt to PlayTheBlues4U [Jd Jc]
Varginho13: folds 
Varginho13 leaves the table
KeithTurbo48: raises $0.15 to $0.25
PlayTheBlues4U: raises $0.50 to $0.75
trumpcaddy: calls $0.75
dcami_nj: folds 
ng2414: folds 
ney1202 joins the table at seat #4 
KeithTurbo48: calls $0.50
*** FLOP *** [6c 6s Kc]
KeithTurbo48: checks 
PlayTheBlues4U: checks 
trumpcaddy: bets $1.14
KeithTurbo48: calls $1.14
PlayTheBlues4U: folds 
*** TURN *** [6c 6s Kc] [4d]
KeithTurbo48: checks 
trumpcaddy: bets $2.70
KeithTurbo48: folds 
Uncalled bet ($2.70) returned to trumpcaddy
trumpcaddy collected $4.45 from pot
trumpcaddy: doesn't show hand 
*** SUMMARY ***
Total pot $4.68 | Rake $0.23 
Board [6c 6s Kc 4d]
Seat 1: trumpcaddy (button) collected ($4.45)
Seat 2: dcami_nj (small blind) folded before Flop
Seat 3: ng2414 (big blind) folded before Flop
Seat 4: Varginho13 folded before Flop (didn't bet)
Seat 5: KeithTurbo48 folded on the Turn
Seat 6: PlayTheBlues4U folded on the Flop


*********** # 132 **************
PokerStars Hand #204907675309: Hold'em No Limit ($0.05/$0.10 USD) - 2019/10/22 21:58:13 ET
Table 'Danae' 6-max Seat #1 is the button
Seat 1: zombiehedgehog ($21.97 in chips) 
Seat 2: dcami_nj ($10.89 in chips) 
Seat 3: KeithTurbo48 ($10 in chips) 
Seat 5: PlayTheBlues4U ($9 in chips) 
Seat 6: kptrpt ($10.76 in chips) 
dcami_nj: posts small blind $0.05
KeithTurbo48: posts big blind $0.10
ng2414: sits out 
*** HOLE CARDS ***
Dealt to PlayTheBlues4U [Kd 7d]
PlayTheBlues4U: folds 
kptrpt: raises $0.20 to $0.30
zombiehedgehog: calls $0.30
dcami_nj: folds 
KeithTurbo48: calls $0.20
*** FLOP *** [3c 4d Ac]
KeithTurbo48: checks 
kptrpt: checks 
zombiehedgehog: bets $0.45
KeithTurbo48: calls $0.45
kptrpt: raises $0.95 to $1.40
zombiehedgehog: folds 
KeithTurbo48: folds 
Uncalled bet ($0.95) returned to kptrpt
kptrpt collected $2.18 from pot
kptrpt: doesn't show hand 
*** SUMMARY ***
Total pot $2.30 | Rake $0.12 
Board [3c 4d Ac]
Seat 1: zombiehedgehog (button) folded on the Flop
Seat 2: dcami_nj (small blind) folded before Flop
Seat 3: KeithTurbo48 (big blind) folded on the Flop
Seat 5: PlayTheBlues4U folded before Flop (didn't bet)
Seat 6: kptrpt collected ($2.18)


*********** # 133 **************
PokerStars Hand #204907675151: Hold'em No Limit ($0.05/$0.10 USD) - 2019/10/22 21:57:29 ET
Table 'Danae' 6-max Seat #6 is the button
Seat 1: zombiehedgehog ($21.33 in chips) 
Seat 2: dcami_nj ($11.39 in chips) 
Seat 3: KeithTurbo48 ($5.48 in chips) 
Seat 4: jvilla119 ($11.26 in chips) 
Seat 5: PlayTheBlues4U ($9 in chips) 
Seat 6: kptrpt ($10.96 in chips) 
zombiehedgehog: posts small blind $0.05
dcami_nj: posts big blind $0.10
*** HOLE CARDS ***
Dealt to PlayTheBlues4U [9d 4c]
KeithTurbo48: folds 
jvilla119: folds 
PlayTheBlues4U: folds 
kptrpt: raises $0.10 to $0.20
zombiehedgehog: calls $0.15
dcami_nj: calls $0.10
*** FLOP *** [3d Jc Qc]
zombiehedgehog: checks 
jvilla119 leaves the table
dcami_nj: bets $0.30
ng2414 joins the table at seat #4 
kptrpt: folds 
zombiehedgehog: raises $1.17 to $1.47
dcami_nj: folds 
Uncalled bet ($1.17) returned to zombiehedgehog
zombiehedgehog collected $1.14 from pot
zombiehedgehog: doesn't show hand 
*** SUMMARY ***
Total pot $1.20 | Rake $0.06 
Board [3d Jc Qc]
Seat 1: zombiehedgehog (small blind) collected ($1.14)
Seat 2: dcami_nj (big blind) folded on the Flop
Seat 3: KeithTurbo48 folded before Flop (didn't bet)
Seat 4: jvilla119 folded before Flop (didn't bet)
Seat 5: PlayTheBlues4U folded before Flop (didn't bet)
Seat 6: kptrpt (button) folded on the Flop


*********** # 134 **************
PokerStars Hand #204907675134: Hold'em No Limit ($0.05/$0.10 USD) - 2019/10/22 21:57:25 ET
Table 'Celuta' 6-max Seat #6 is the button
Seat 1: trumpcaddy ($9.60 in chips) 
Seat 2: dcami_nj ($14.69 in chips) 
Seat 4: Varginho13 ($19.48 in chips) 
Seat 5: KeithTurbo48 ($8.57 in chips) 
Seat 6: PlayTheBlues4U ($11 in chips) 
trumpcaddy: posts small blind $0.05
dcami_nj: posts big blind $0.10
ng2414: sits out 
*** HOLE CARDS ***
Dealt to PlayTheBlues4U [2d 7c]
Varginho13: raises $0.20 to $0.30
KeithTurbo48: folds 
PlayTheBlues4U: folds 
trumpcaddy: calls $0.25
dcami_nj: folds 
*** FLOP *** [9s Ts Qs]
trumpcaddy: bets $0.66
Varginho13: folds 
Uncalled bet ($0.66) returned to trumpcaddy
trumpcaddy collected $0.66 from pot
trumpcaddy: doesn't show hand 
*** SUMMARY ***
Total pot $0.70 | Rake $0.04 
Board [9s Ts Qs]
Seat 1: trumpcaddy (small blind) collected ($0.66)
Seat 2: dcami_nj (big blind) folded before Flop
Seat 4: Varginho13 folded on the Flop
Seat 5: KeithTurbo48 folded before Flop (didn't bet)
Seat 6: PlayTheBlues4U (button) folded before Flop (didn't bet)


*********** # 135 **************
PokerStars Hand #204907674988: Hold'em No Limit ($0.05/$0.10 USD) - 2019/10/22 21:56:41 ET
Table 'Danae' 6-max Seat #5 is the button
Seat 1: zombiehedgehog ($21.43 in chips) 
Seat 2: dcami_nj ($11.39 in chips) 
Seat 3: KeithTurbo48 ($6.15 in chips) 
Seat 4: jvilla119 ($11.26 in chips) 
Seat 5: PlayTheBlues4U ($9 in chips) 
Seat 6: kptrpt ($10.26 in chips) 
kptrpt: posts small blind $0.05
zombiehedgehog: posts big blind $0.10
*** HOLE CARDS ***
Dealt to PlayTheBlues4U [3d 9d]
dcami_nj: folds 
KeithTurbo48: raises $0.15 to $0.25
jvilla119: folds 
PlayTheBlues4U: folds 
kptrpt: calls $0.20
zombiehedgehog: folds 
*** FLOP *** [9s Th Jd]
kptrpt: checks 
KeithTurbo48: checks 
*** TURN *** [9s Th Jd] [4h]
kptrpt: checks 
KeithTurbo48: bets $0.42
kptrpt: calls $0.42
*** RIVER *** [9s Th Jd 4h] [4d]
kptrpt: checks 
KeithTurbo48: checks 
*** SHOW DOWN ***
kptrpt: shows [Ac 8h] (a pair of Fours)
KeithTurbo48: mucks hand 
kptrpt collected $1.37 from pot
*** SUMMARY ***
Total pot $1.44 | Rake $0.07 
Board [9s Th Jd 4h 4d]
Seat 1: zombiehedgehog (big blind) folded before Flop
Seat 2: dcami_nj folded before Flop (didn't bet)
Seat 3: KeithTurbo48 mucked [5s 7s]
Seat 4: jvilla119 folded before Flop (didn't bet)
Seat 5: PlayTheBlues4U (button) folded before Flop (didn't bet)
Seat 6: kptrpt (small blind) showed [Ac 8h] and won ($1.37) with a pair of Fours


*********** # 136 **************
PokerStars Hand #204907674986: Hold'em No Limit ($0.05/$0.10 USD) - 2019/10/22 21:56:40 ET
Table 'Celuta' 6-max Seat #5 is the button
Seat 1: trumpcaddy ($9.85 in chips) 
Seat 2: dcami_nj ($14.69 in chips) 
Seat 4: Varginho13 ($19.48 in chips) 
Seat 5: KeithTurbo48 ($9.32 in chips) 
Seat 6: PlayTheBlues4U ($10.09 in chips) 
PlayTheBlues4U: posts small blind $0.05
trumpcaddy: posts big blind $0.10
ng2414: sits out 
*** HOLE CARDS ***
Dealt to PlayTheBlues4U [2s 2c]
dcami_nj: folds 
Varginho13: folds 
KeithTurbo48: raises $0.15 to $0.25
PlayTheBlues4U: calls $0.20
trumpcaddy: calls $0.15
*** FLOP *** [3d 8h 6s]
PlayTheBlues4U: checks 
trumpcaddy: checks 
KeithTurbo48: checks 
*** TURN *** [3d 8h 6s] [2d]
PlayTheBlues4U: bets $0.50
trumpcaddy: folds 
KeithTurbo48: calls $0.50
*** RIVER *** [3d 8h 6s 2d] [Qh]
PlayTheBlues4U: bets $1.20
KeithTurbo48: folds 
Uncalled bet ($1.20) returned to PlayTheBlues4U
PlayTheBlues4U collected $1.66 from pot
PlayTheBlues4U: doesn't show hand 
*** SUMMARY ***
Total pot $1.75 | Rake $0.09 
Board [3d 8h 6s 2d Qh]
Seat 1: trumpcaddy (big blind) folded on the Turn
Seat 2: dcami_nj folded before Flop (didn't bet)
Seat 4: Varginho13 folded before Flop (didn't bet)
Seat 5: KeithTurbo48 (button) folded on the River
Seat 6: PlayTheBlues4U (small blind) collected ($1.66)


*********** # 137 **************
PokerStars Hand #204905819998: Hold'em No Limit ($0.05/$0.10 USD) - 2019/10/22 21:56:12 ET
Table 'Celuta' 6-max Seat #4 is the button
Seat 1: trumpcaddy ($9.85 in chips) 
Seat 2: dcami_nj ($14.69 in chips) 
Seat 4: Varginho13 ($19.48 in chips) 
Seat 5: KeithTurbo48 ($9.42 in chips) 
Seat 6: PlayTheBlues4U ($10 in chips) 
KeithTurbo48: posts small blind $0.05
PlayTheBlues4U: posts big blind $0.10
ng2414: sits out 
*** HOLE CARDS ***
Dealt to PlayTheBlues4U [8d 2h]
trumpcaddy: folds 
dcami_nj: folds 
Varginho13: folds 
KeithTurbo48: calls $0.05
PlayTheBlues4U: checks 
*** FLOP *** [Ah 3s Kh]
KeithTurbo48: checks 
PlayTheBlues4U: checks 
*** TURN *** [Ah 3s Kh] [8h]
KeithTurbo48: checks 
PlayTheBlues4U: checks 
*** RIVER *** [Ah 3s Kh 8h] [6d]
KeithTurbo48: checks 
PlayTheBlues4U: checks 
*** SHOW DOWN ***
KeithTurbo48: shows [2s 9s] (high card Ace)
PlayTheBlues4U: shows [8d 2h] (a pair of Eights)
PlayTheBlues4U collected $0.19 from pot
*** SUMMARY ***
Total pot $0.20 | Rake $0.01 
Board [Ah 3s Kh 8h 6d]
Seat 1: trumpcaddy folded before Flop (didn't bet)
Seat 2: dcami_nj folded before Flop (didn't bet)
Seat 4: Varginho13 (button) folded before Flop (didn't bet)
Seat 5: KeithTurbo48 (small blind) showed [2s 9s] and lost with high card Ace
Seat 6: PlayTheBlues4U (big blind) showed [8d 2h] and won ($0.19) with a pair of Eights


*********** # 138 **************
PokerStars Hand #204905819911: Hold'em No Limit ($0.05/$0.10 USD) - 2019/10/22 21:55:48 ET
Table 'Danae' 6-max Seat #4 is the button
Seat 1: zombiehedgehog ($21.43 in chips) 
Seat 2: dcami_nj ($11.39 in chips) 
Seat 3: KeithTurbo48 ($7.65 in chips) 
Seat 4: jvilla119 ($11.26 in chips) 
Seat 5: PlayTheBlues4U ($9.25 in chips) 
Seat 6: kptrpt ($8.67 in chips) 
PlayTheBlues4U: posts small blind $0.05
kptrpt: posts big blind $0.10
*** HOLE CARDS ***
Dealt to PlayTheBlues4U [4d Ah]
zombiehedgehog: folds 
dcami_nj: folds 
KeithTurbo48: raises $0.15 to $0.25
jvilla119: folds 
PlayTheBlues4U: calls $0.20
kptrpt: calls $0.15
*** FLOP *** [8s 2c Ks]
PlayTheBlues4U: checks 
kptrpt: checks 
KeithTurbo48: bets $0.30
PlayTheBlues4U: folds 
kptrpt: calls $0.30
*** TURN *** [8s 2c Ks] [3h]
kptrpt: checks 
KeithTurbo48: bets $0.95
kptrpt: calls $0.95
*** RIVER *** [8s 2c Ks 3h] [Qh]
kptrpt: checks 
KeithTurbo48: checks 
*** SHOW DOWN ***
kptrpt: shows [4s Kh] (a pair of Kings)
KeithTurbo48: mucks hand 
kptrpt collected $3.09 from pot
*** SUMMARY ***
Total pot $3.25 | Rake $0.16 
Board [8s 2c Ks 3h Qh]
Seat 1: zombiehedgehog folded before Flop (didn't bet)
Seat 2: dcami_nj folded before Flop (didn't bet)
Seat 3: KeithTurbo48 mucked [Js Jd]
Seat 4: jvilla119 (button) folded before Flop (didn't bet)
Seat 5: PlayTheBlues4U (small blind) folded on the Flop
Seat 6: kptrpt (big blind) showed [4s Kh] and won ($3.09) with a pair of Kings


*********** # 139 **************
PokerStars Hand #204905819624: Hold'em No Limit ($0.05/$0.10 USD) - 2019/10/22 21:54:38 ET
Table 'Danae' 6-max Seat #3 is the button
Seat 1: zombiehedgehog ($21.43 in chips) 
Seat 2: dcami_nj ($11.39 in chips) 
Seat 3: KeithTurbo48 ($6.65 in chips) 
Seat 4: jvilla119 ($11.51 in chips) 
Seat 5: PlayTheBlues4U ($10 in chips) 
jvilla119: posts small blind $0.05
PlayTheBlues4U: posts big blind $0.10
*** HOLE CARDS ***
Dealt to PlayTheBlues4U [As Jh]
zombiehedgehog: folds 
dcami_nj: folds 
KeithTurbo48: raises $0.15 to $0.25
jvilla119: calls $0.20
PlayTheBlues4U: raises $0.50 to $0.75
KeithTurbo48: raises $2.25 to $3
jvilla119: folds 
PlayTheBlues4U: folds 
Uncalled bet ($2.25) returned to KeithTurbo48
KeithTurbo48 collected $1.75 from pot
KeithTurbo48: doesn't show hand 
*** SUMMARY ***
Total pot $1.75 | Rake $0 
Seat 1: zombiehedgehog folded before Flop (didn't bet)
Seat 2: dcami_nj folded before Flop (didn't bet)
Seat 3: KeithTurbo48 (button) collected ($1.75)
Seat 4: jvilla119 (small blind) folded before Flop
Seat 5: PlayTheBlues4U (big blind) folded before Flop


*********** # 140 **************
PokerStars Hand #204851189215: Hold'em No Limit ($0.05/$0.10 USD) - 2019/10/21 22:03:27 ET
Table 'Draco' 6-max Seat #6 is the button
Seat 1: BigBlue ($7.45 in chips) 
Seat 2: LanskyBanksy ($15.66 in chips) 
Seat 3: PlayTheBlues4U ($18.51 in chips) 
Seat 5: Klytu ($10 in chips) 
Seat 6: EddieMoney9 ($16.34 in chips) 
BigBlue: posts small blind $0.05
LanskyBanksy: posts big blind $0.10
*** HOLE CARDS ***
Dealt to PlayTheBlues4U [Qc Qs]
PlayTheBlues4U: raises $0.20 to $0.30
Klytu: folds 
EddieMoney9: calls $0.30
BigBlue: calls $0.25
LanskyBanksy: calls $0.20
*** FLOP *** [4c 5c 7d]
BigBlue: checks 
LanskyBanksy: checks 
PlayTheBlues4U: bets $0.80
EddieMoney9: folds 
BigBlue: raises $1.40 to $2.20
LanskyBanksy: folds 
x Aristokat x joins the table at seat #4 
PlayTheBlues4U: calls $1.40
*** TURN *** [4c 5c 7d] [7h]
BigBlue: bets $2.70
PlayTheBlues4U: calls $2.70
*** RIVER *** [4c 5c 7d 7h] [5s]
BigBlue: bets $2.25 and is all-in
PlayTheBlues4U: calls $2.25
*** SHOW DOWN ***
BigBlue: shows [4h 5h] (a full house, Fives full of Sevens)
PlayTheBlues4U: shows [Qc Qs] (two pair, Queens and Sevens)
BigBlue collected $14.72 from pot
*** SUMMARY ***
Total pot $15.50 | Rake $0.78 
Board [4c 5c 7d 7h 5s]
Seat 1: BigBlue (small blind) showed [4h 5h] and won ($14.72) with a full house, Fives full of Sevens
Seat 2: LanskyBanksy (big blind) folded on the Flop
Seat 3: PlayTheBlues4U showed [Qc Qs] and lost with two pair, Queens and Sevens
Seat 5: Klytu folded before Flop (didn't bet)
Seat 6: EddieMoney9 (button) folded on the Flop


*********** # 141 **************
PokerStars Hand #204851189105: Hold'em No Limit ($0.05/$0.10 USD) - 2019/10/21 22:03:00 ET
Table 'Draco' 6-max Seat #5 is the button
Seat 1: BigBlue ($7.55 in chips) 
Seat 2: LanskyBanksy ($15.66 in chips) 
Seat 3: PlayTheBlues4U ($18.36 in chips) 
Seat 5: Klytu ($10 in chips) 
Seat 6: EddieMoney9 ($16.39 in chips) 
EddieMoney9: posts small blind $0.05
BigBlue: posts big blind $0.10
*** HOLE CARDS ***
Dealt to PlayTheBlues4U [Kh Tc]
LanskyBanksy: folds 
PlayTheBlues4U: raises $0.20 to $0.30
Klytu: folds 
EddieMoney9: folds 
BigBlue: folds 
Uncalled bet ($0.20) returned to PlayTheBlues4U
PlayTheBlues4U collected $0.25 from pot
PlayTheBlues4U: doesn't show hand 
*** SUMMARY ***
Total pot $0.25 | Rake $0 
Seat 1: BigBlue (big blind) folded before Flop
Seat 2: LanskyBanksy folded before Flop (didn't bet)
Seat 3: PlayTheBlues4U collected ($0.25)
Seat 5: Klytu (button) folded before Flop (didn't bet)
Seat 6: EddieMoney9 (small blind) folded before Flop


*********** # 142 **************
PokerStars Hand #204851188897: Hold'em No Limit ($0.05/$0.10 USD) - 2019/10/21 22:02:10 ET
Table 'Draco' 6-max Seat #3 is the button
Seat 1: BigBlue ($7.85 in chips) 
Seat 2: LanskyBanksy ($15.66 in chips) 
Seat 3: PlayTheBlues4U ($17.76 in chips) 
Seat 5: Klytu ($10.05 in chips) 
Seat 6: EddieMoney9 ($16.69 in chips) 
Klytu: posts small blind $0.05
EddieMoney9: posts big blind $0.10
*** HOLE CARDS ***
Dealt to PlayTheBlues4U [Ah 8s]
BigBlue: calls $0.10
LanskyBanksy: folds 
PlayTheBlues4U: raises $0.20 to $0.30
Klytu: folds 
EddieMoney9: calls $0.20
BigBlue: calls $0.20
*** FLOP *** [As Ts 8d]
EddieMoney9: checks 
BigBlue: checks 
PlayTheBlues4U: bets $0.70
EddieMoney9: folds 
BigBlue: folds 
Uncalled bet ($0.70) returned to PlayTheBlues4U
PlayTheBlues4U collected $0.90 from pot
PlayTheBlues4U: doesn't show hand 
*** SUMMARY ***
Total pot $0.95 | Rake $0.05 
Board [As Ts 8d]
Seat 1: BigBlue folded on the Flop
Seat 2: LanskyBanksy folded before Flop (didn't bet)
Seat 3: PlayTheBlues4U (button) collected ($0.90)
Seat 5: Klytu (small blind) folded before Flop
Seat 6: EddieMoney9 (big blind) folded on the Flop


*********** # 143 **************
PokerStars Hand #204851188699: Hold'em No Limit ($0.05/$0.10 USD) - 2019/10/21 22:01:24 ET
Table 'Draco' 6-max Seat #2 is the button
Seat 1: BigBlue ($7.85 in chips) 
Seat 2: LanskyBanksy ($15.52 in chips) 
Seat 3: PlayTheBlues4U ($17.81 in chips) 
Seat 5: Klytu ($10.15 in chips) 
Seat 6: EddieMoney9 ($16.69 in chips) 
PlayTheBlues4U: posts small blind $0.05
Klytu: posts big blind $0.10
*** HOLE CARDS ***
Dealt to PlayTheBlues4U [5d 7c]
EddieMoney9: folds 
BigBlue: folds 
LanskyBanksy: calls $0.10
PlayTheBlues4U: folds 
Klytu: checks 
*** FLOP *** [Qc 8h Ac]
Klytu: checks 
LanskyBanksy: checks 
*** TURN *** [Qc 8h Ac] [3c]
Klytu: checks 
LanskyBanksy: checks 
*** RIVER *** [Qc 8h Ac 3c] [5h]
Klytu: checks 
LanskyBanksy: bets $0.50
Klytu: folds 
Uncalled bet ($0.50) returned to LanskyBanksy
LanskyBanksy collected $0.24 from pot
LanskyBanksy: doesn't show hand 
*** SUMMARY ***
Total pot $0.25 | Rake $0.01 
Board [Qc 8h Ac 3c 5h]
Seat 1: BigBlue folded before Flop (didn't bet)
Seat 2: LanskyBanksy (button) collected ($0.24)
Seat 3: PlayTheBlues4U (small blind) folded before Flop
Seat 5: Klytu (big blind) folded on the River
Seat 6: EddieMoney9 folded before Flop (didn't bet)


*********** # 144 **************
PokerStars Hand #204851188654: Hold'em No Limit ($0.05/$0.10 USD) - 2019/10/21 22:01:14 ET
Table 'Hesperia' 6-max Seat #5 is the button
Seat 1: BigBlue ($9.79 in chips) 
Seat 2: LanskyBanksy ($16.16 in chips) 
Seat 4: PlayTheBlues4U ($9.05 in chips) 
Seat 5: Klytu ($10 in chips) 
BigBlue: posts small blind $0.05
LanskyBanksy: posts big blind $0.10
*** HOLE CARDS ***
Dealt to PlayTheBlues4U [6d Td]
PlayTheBlues4U: folds 
Klytu: raises $0.15 to $0.25
BigBlue: folds 
LanskyBanksy: calls $0.15
*** FLOP *** [6s Qs 3c]
LanskyBanksy: checks 
Klytu: bets $0.30
LanskyBanksy: calls $0.30
*** TURN *** [6s Qs 3c] [5h]
LanskyBanksy: checks 
Klytu: bets $0.45
LanskyBanksy: raises $0.55 to $1
Klytu: calls $0.55
*** RIVER *** [6s Qs 3c 5h] [Ks]
LanskyBanksy: bets $2.40
Klytu: folds 
Uncalled bet ($2.40) returned to LanskyBanksy
LanskyBanksy collected $2.99 from pot
LanskyBanksy: doesn't show hand 
*** SUMMARY ***
Total pot $3.15 | Rake $0.16 
Board [6s Qs 3c 5h Ks]
Seat 1: BigBlue (small blind) folded before Flop
Seat 2: LanskyBanksy (big blind) collected ($2.99)
Seat 4: PlayTheBlues4U folded before Flop (didn't bet)
Seat 5: Klytu (button) folded on the River


*********** # 145 **************
PokerStars Hand #204851188595: Hold'em No Limit ($0.05/$0.10 USD) - 2019/10/21 22:01:00 ET
Table 'Hesperia' 6-max Seat #4 is the button
Seat 1: BigBlue ($9.89 in chips) 
Seat 2: LanskyBanksy ($16.16 in chips) 
Seat 4: PlayTheBlues4U ($8.90 in chips) 
Seat 5: Klytu ($9.95 in chips) 
Klytu: posts small blind $0.05
BigBlue: posts big blind $0.10
*** HOLE CARDS ***
Dealt to PlayTheBlues4U [2d Ac]
LanskyBanksy: folds 
PlayTheBlues4U: raises $0.20 to $0.30
Klytu: folds 
BigBlue: folds 
Uncalled bet ($0.20) returned to PlayTheBlues4U
PlayTheBlues4U collected $0.25 from pot
PlayTheBlues4U: doesn't show hand 
*** SUMMARY ***
Total pot $0.25 | Rake $0 
Seat 1: BigBlue (big blind) folded before Flop
Seat 2: LanskyBanksy folded before Flop (didn't bet)
Seat 4: PlayTheBlues4U (button) collected ($0.25)
Seat 5: Klytu (small blind) folded before Flop


*********** # 146 **************
PokerStars Hand #204851188549: Hold'em No Limit ($0.05/$0.10 USD) - 2019/10/21 22:00:50 ET
Table 'Draco' 6-max Seat #1 is the button
Seat 1: BigBlue ($7.85 in chips) 
Seat 2: LanskyBanksy ($15.72 in chips) 
Seat 3: PlayTheBlues4U ($17.63 in chips) 
Seat 5: Klytu ($10.15 in chips) 
Seat 6: EddieMoney9 ($16.69 in chips) 
LanskyBanksy: posts small blind $0.05
PlayTheBlues4U: posts big blind $0.10
*** HOLE CARDS ***
Dealt to PlayTheBlues4U [7s Ad]
Klytu: folds 
EddieMoney9: folds 
BigBlue: folds 
LanskyBanksy: calls $0.05
PlayTheBlues4U: raises $0.10 to $0.20
LanskyBanksy: calls $0.10
*** FLOP *** [Ts 9h Js]
LanskyBanksy: checks 
PlayTheBlues4U: checks 
*** TURN *** [Ts 9h Js] [7d]
LanskyBanksy: checks 
PlayTheBlues4U: checks 
*** RIVER *** [Ts 9h Js 7d] [Kh]
LanskyBanksy: checks 
PlayTheBlues4U: checks 
*** SHOW DOWN ***
LanskyBanksy: shows [4h 6d] (high card King)
PlayTheBlues4U: shows [7s Ad] (a pair of Sevens)
PlayTheBlues4U collected $0.38 from pot
*** SUMMARY ***
Total pot $0.40 | Rake $0.02 
Board [Ts 9h Js 7d Kh]
Seat 1: BigBlue (button) folded before Flop (didn't bet)
Seat 2: LanskyBanksy (small blind) showed [4h 6d] and lost with high card King
Seat 3: PlayTheBlues4U (big blind) showed [7s Ad] and won ($0.38) with a pair of Sevens
Seat 5: Klytu folded before Flop (didn't bet)
Seat 6: EddieMoney9 folded before Flop (didn't bet)


*********** # 147 **************
PokerStars Hand #204851188507: Hold'em No Limit ($0.05/$0.10 USD) - 2019/10/21 22:00:41 ET
Table 'Hesperia' 6-max Seat #2 is the button
Seat 1: BigBlue ($9.89 in chips) 
Seat 2: LanskyBanksy ($16.16 in chips) 
Seat 4: PlayTheBlues4U ($8.72 in chips) 
Seat 5: Klytu ($10.15 in chips) 
PlayTheBlues4U: posts small blind $0.05
Klytu: posts big blind $0.10
*** HOLE CARDS ***
Dealt to PlayTheBlues4U [5s 7d]
BigBlue: folds 
LanskyBanksy: folds 
PlayTheBlues4U: raises $0.10 to $0.20
Klytu: calls $0.10
*** FLOP *** [4h Jd 3h]
PlayTheBlues4U: bets $0.20
Klytu: folds 
Uncalled bet ($0.20) returned to PlayTheBlues4U
PlayTheBlues4U collected $0.38 from pot
PlayTheBlues4U: doesn't show hand 
*** SUMMARY ***
Total pot $0.40 | Rake $0.02 
Board [4h Jd 3h]
Seat 1: BigBlue folded before Flop (didn't bet)
Seat 2: LanskyBanksy (button) folded before Flop (didn't bet)
Seat 4: PlayTheBlues4U (small blind) collected ($0.38)
Seat 5: Klytu (big blind) folded on the Flop


*********** # 148 **************
PokerStars Hand #204851188466: Hold'em No Limit ($0.05/$0.10 USD) - 2019/10/21 22:00:30 ET
Table 'Hesperia' 6-max Seat #1 is the button
Seat 1: BigBlue ($9.74 in chips) 
Seat 2: LanskyBanksy ($16.21 in chips) 
Seat 4: PlayTheBlues4U ($8.82 in chips) 
Seat 5: Klytu ($10.15 in chips) 
LanskyBanksy: posts small blind $0.05
PlayTheBlues4U: posts big blind $0.10
*** HOLE CARDS ***
Dealt to PlayTheBlues4U [Qh 3c]
Klytu: folds 
BigBlue: raises $0.15 to $0.25
LanskyBanksy: folds 
PlayTheBlues4U: folds 
Uncalled bet ($0.15) returned to BigBlue
BigBlue collected $0.25 from pot
BigBlue: doesn't show hand 
*** SUMMARY ***
Total pot $0.25 | Rake $0 
Seat 1: BigBlue (button) collected ($0.25)
Seat 2: LanskyBanksy (small blind) folded before Flop
Seat 4: PlayTheBlues4U (big blind) folded before Flop
Seat 5: Klytu folded before Flop (didn't bet)


*********** # 149 **************
PokerStars Hand #204851188389: Hold'em No Limit ($0.05/$0.10 USD) - 2019/10/21 22:00:11 ET
Table 'Hesperia' 6-max Seat #5 is the button
Seat 1: BigBlue ($9.79 in chips) 
Seat 2: LanskyBanksy ($16.16 in chips) 
Seat 4: PlayTheBlues4U ($8.82 in chips) 
Seat 5: Klytu ($10.15 in chips) 
BigBlue: posts small blind $0.05
LanskyBanksy: posts big blind $0.10
*** HOLE CARDS ***
Dealt to PlayTheBlues4U [2c Qd]
PlayTheBlues4U: folds 
Klytu: folds 
BigBlue: folds 
Uncalled bet ($0.05) returned to LanskyBanksy
LanskyBanksy collected $0.10 from pot
LanskyBanksy: doesn't show hand 
*** SUMMARY ***
Total pot $0.10 | Rake $0 
Seat 1: BigBlue (small blind) folded before Flop
Seat 2: LanskyBanksy (big blind) collected ($0.10)
Seat 4: PlayTheBlues4U folded before Flop (didn't bet)
Seat 5: Klytu (button) folded before Flop (didn't bet)


*********** # 150 **************
PokerStars Hand #204851188344: Hold'em No Limit ($0.05/$0.10 USD) - 2019/10/21 21:59:56 ET
Table 'Hesperia' 6-max Seat #4 is the button
Seat 1: BigBlue ($9.89 in chips) 
Seat 2: LanskyBanksy ($16.16 in chips) 
Seat 4: PlayTheBlues4U ($8.82 in chips) 
Seat 5: Klytu ($10.05 in chips) 
Klytu: posts small blind $0.05
BigBlue: posts big blind $0.10
*** HOLE CARDS ***
Dealt to PlayTheBlues4U [8d 3c]
LanskyBanksy: folds 
PlayTheBlues4U: folds 
Klytu: raises $0.20 to $0.30
BigBlue: folds 
Uncalled bet ($0.20) returned to Klytu
Klytu collected $0.20 from pot
Klytu: doesn't show hand 
*** SUMMARY ***
Total pot $0.20 | Rake $0 
Seat 1: BigBlue (big blind) folded before Flop
Seat 2: LanskyBanksy folded before Flop (didn't bet)
Seat 4: PlayTheBlues4U (button) folded before Flop (didn't bet)
Seat 5: Klytu (small blind) collected ($0.20)


*********** # 151 **************
PokerStars Hand #204851188290: Hold'em No Limit ($0.05/$0.10 USD) - 2019/10/21 21:59:43 ET
Table 'Draco' 6-max Seat #6 is the button
Seat 1: BigBlue ($7.90 in chips) 
Seat 2: LanskyBanksy ($15.82 in chips) 
Seat 3: PlayTheBlues4U ($17.93 in chips) 
Seat 5: Klytu ($10.90 in chips) 
Seat 6: EddieMoney9 ($15.59 in chips) 
BigBlue: posts small blind $0.05
LanskyBanksy: posts big blind $0.10
*** HOLE CARDS ***
Dealt to PlayTheBlues4U [Tc 7c]
PlayTheBlues4U: raises $0.20 to $0.30
Klytu: calls $0.30
EddieMoney9: calls $0.30
BigBlue: folds 
LanskyBanksy: folds 
*** FLOP *** [Kc Qh 3h]
PlayTheBlues4U: checks 
Klytu: checks 
EddieMoney9: checks 
*** TURN *** [Kc Qh 3h] [4d]
PlayTheBlues4U: checks 
Klytu: bets $0.45
EddieMoney9: calls $0.45
PlayTheBlues4U: folds 
*** RIVER *** [Kc Qh 3h 4d] [Qc]
Klytu: checks 
EddieMoney9: bets $0.60
Klytu: folds 
Uncalled bet ($0.60) returned to EddieMoney9
EddieMoney9 collected $1.85 from pot
EddieMoney9: doesn't show hand 
*** SUMMARY ***
Total pot $1.95 | Rake $0.10 
Board [Kc Qh 3h 4d Qc]
Seat 1: BigBlue (small blind) folded before Flop
Seat 2: LanskyBanksy (big blind) folded before Flop
Seat 3: PlayTheBlues4U folded on the Turn
Seat 5: Klytu folded on the River
Seat 6: EddieMoney9 (button) collected ($1.85)


*********** # 152 **************
PokerStars Hand #204851188230: Hold'em No Limit ($0.05/$0.10 USD) - 2019/10/21 21:59:27 ET
Table 'Draco' 6-max Seat #5 is the button
Seat 1: BigBlue ($8 in chips) 
Seat 2: LanskyBanksy ($15.82 in chips) 
Seat 3: PlayTheBlues4U ($17.93 in chips) 
Seat 5: Klytu ($10.75 in chips) 
Seat 6: EddieMoney9 ($15.64 in chips) 
EddieMoney9: posts small blind $0.05
BigBlue: posts big blind $0.10
*** HOLE CARDS ***
Dealt to PlayTheBlues4U [2s Jc]
LanskyBanksy: folds 
PlayTheBlues4U: folds 
Klytu: raises $0.15 to $0.25
EddieMoney9: folds 
BigBlue: folds 
Uncalled bet ($0.15) returned to Klytu
Klytu collected $0.25 from pot
Klytu: doesn't show hand 
*** SUMMARY ***
Total pot $0.25 | Rake $0 
Seat 1: BigBlue (big blind) folded before Flop
Seat 2: LanskyBanksy folded before Flop (didn't bet)
Seat 3: PlayTheBlues4U folded before Flop (didn't bet)
Seat 5: Klytu (button) collected ($0.25)
Seat 6: EddieMoney9 (small blind) folded before Flop


*********** # 153 **************
PokerStars Hand #204851188200: Hold'em No Limit ($0.05/$0.10 USD) - 2019/10/21 21:59:18 ET
Table 'Hesperia' 6-max Seat #2 is the button
Seat 1: BigBlue ($9.12 in chips) 
Seat 2: LanskyBanksy ($16.16 in chips) 
Seat 4: PlayTheBlues4U ($9.57 in chips) 
Seat 5: Klytu ($10.15 in chips) 
PlayTheBlues4U: posts small blind $0.05
Klytu: posts big blind $0.10
*** HOLE CARDS ***
Dealt to PlayTheBlues4U [Jd As]
BigBlue: raises $0.25 to $0.35
LanskyBanksy: folds 
PlayTheBlues4U: calls $0.30
Klytu: folds 
*** FLOP *** [8d Ac 6s]
PlayTheBlues4U: checks 
BigBlue: bets $0.40
PlayTheBlues4U: calls $0.40
*** TURN *** [8d Ac 6s] [7c]
PlayTheBlues4U: checks 
BigBlue: checks 
*** RIVER *** [8d Ac 6s 7c] [5d]
PlayTheBlues4U: checks 
BigBlue: bets $2
PlayTheBlues4U: folds 
Uncalled bet ($2) returned to BigBlue
BigBlue collected $1.52 from pot
BigBlue: doesn't show hand 
*** SUMMARY ***
Total pot $1.60 | Rake $0.08 
Board [8d Ac 6s 7c 5d]
Seat 1: BigBlue collected ($1.52)
Seat 2: LanskyBanksy (button) folded before Flop (didn't bet)
Seat 4: PlayTheBlues4U (small blind) folded on the River
Seat 5: Klytu (big blind) folded before Flop


*********** # 154 **************
PokerStars Hand #204851188165: Hold'em No Limit ($0.05/$0.10 USD) - 2019/10/21 21:59:11 ET
Table 'Draco' 6-max Seat #3 is the button
Seat 2: LanskyBanksy ($15.82 in chips) 
Seat 3: PlayTheBlues4U ($17.93 in chips) 
Seat 5: Klytu ($11.05 in chips) 
Seat 6: EddieMoney9 ($15.37 in chips) 
Klytu: posts small blind $0.05
EddieMoney9: posts big blind $0.10
BigBlue: sits out 
*** HOLE CARDS ***
Dealt to PlayTheBlues4U [2s 9d]
LanskyBanksy: folds 
PlayTheBlues4U: folds 
Klytu: raises $0.20 to $0.30
EddieMoney9: calls $0.20
*** FLOP *** [Jh 7d 6h]
Klytu: checks 
EddieMoney9: bets $0.40
Klytu: folds 
Uncalled bet ($0.40) returned to EddieMoney9
EddieMoney9 collected $0.57 from pot
EddieMoney9: doesn't show hand 
*** SUMMARY ***
Total pot $0.60 | Rake $0.03 
Board [Jh 7d 6h]
Seat 2: LanskyBanksy folded before Flop (didn't bet)
Seat 3: PlayTheBlues4U (button) folded before Flop (didn't bet)
Seat 5: Klytu (small blind) folded on the Flop
Seat 6: EddieMoney9 (big blind) collected ($0.57)


*********** # 155 **************
PokerStars Hand #204851188106: Hold'em No Limit ($0.05/$0.10 USD) - 2019/10/21 21:58:55 ET
Table 'Draco' 6-max Seat #2 is the button
Seat 2: LanskyBanksy ($15.82 in chips) 
Seat 3: PlayTheBlues4U ($17.98 in chips) 
Seat 5: Klytu ($11 in chips) 
Seat 6: EddieMoney9 ($15.37 in chips) 
PlayTheBlues4U: posts small blind $0.05
Klytu: posts big blind $0.10
BigBlue: sits out 
*** HOLE CARDS ***
Dealt to PlayTheBlues4U [6d 4s]
EddieMoney9: folds 
LanskyBanksy: folds 
PlayTheBlues4U: folds 
Uncalled bet ($0.05) returned to Klytu
Klytu collected $0.10 from pot
Klytu: doesn't show hand 
*** SUMMARY ***
Total pot $0.10 | Rake $0 
Seat 2: LanskyBanksy (button) folded before Flop (didn't bet)
Seat 3: PlayTheBlues4U (small blind) folded before Flop
Seat 5: Klytu (big blind) collected ($0.10)
Seat 6: EddieMoney9 folded before Flop (didn't bet)


*********** # 156 **************
PokerStars Hand #204851188077: Hold'em No Limit ($0.05/$0.10 USD) - 2019/10/21 21:58:46 ET
Table 'Hesperia' 6-max Seat #1 is the button
Seat 1: BigBlue ($9.12 in chips) 
Seat 2: LanskyBanksy ($16.07 in chips) 
Seat 4: PlayTheBlues4U ($9.67 in chips) 
Seat 5: Klytu ($10.15 in chips) 
LanskyBanksy: posts small blind $0.05
PlayTheBlues4U: posts big blind $0.10
*** HOLE CARDS ***
Dealt to PlayTheBlues4U [2d 6h]
Klytu: folds 
BigBlue: folds 
LanskyBanksy: calls $0.05
PlayTheBlues4U: checks 
*** FLOP *** [3c Ks Kc]
LanskyBanksy: checks 
PlayTheBlues4U: checks 
*** TURN *** [3c Ks Kc] [9s]
LanskyBanksy: checks 
PlayTheBlues4U: checks 
*** RIVER *** [3c Ks Kc 9s] [5c]
LanskyBanksy: bets $0.20
PlayTheBlues4U: folds 
Uncalled bet ($0.20) returned to LanskyBanksy
LanskyBanksy collected $0.19 from pot
LanskyBanksy: doesn't show hand 
*** SUMMARY ***
Total pot $0.20 | Rake $0.01 
Board [3c Ks Kc 9s 5c]
Seat 1: BigBlue (button) folded before Flop (didn't bet)
Seat 2: LanskyBanksy (small blind) collected ($0.19)
Seat 4: PlayTheBlues4U (big blind) folded on the River
Seat 5: Klytu folded before Flop (didn't bet)


*********** # 157 **************
PokerStars Hand #204851188049: Hold'em No Limit ($0.05/$0.10 USD) - 2019/10/21 21:58:39 ET
Table 'Draco' 6-max Seat #6 is the button
Seat 2: LanskyBanksy ($15.87 in chips) 
Seat 3: PlayTheBlues4U ($18.08 in chips) 
Seat 5: Klytu ($10.85 in chips) 
Seat 6: EddieMoney9 ($15.37 in chips) 
LanskyBanksy: posts small blind $0.05
PlayTheBlues4U: posts big blind $0.10
*** HOLE CARDS ***
Dealt to PlayTheBlues4U [3c Qc]
BigBlue joins the table at seat #1 
Klytu: raises $0.20 to $0.30
EddieMoney9: folds 
LanskyBanksy: folds 
PlayTheBlues4U: folds 
Uncalled bet ($0.20) returned to Klytu
Klytu collected $0.25 from pot
Klytu: doesn't show hand 
*** SUMMARY ***
Total pot $0.25 | Rake $0 
Seat 2: LanskyBanksy (small blind) folded before Flop
Seat 3: PlayTheBlues4U (big blind) folded before Flop
Seat 5: Klytu collected ($0.25)
Seat 6: EddieMoney9 (button) folded before Flop (didn't bet)


*********** # 158 **************
PokerStars Hand #204851188039: Hold'em No Limit ($0.05/$0.10 USD) - 2019/10/21 21:58:37 ET
Table 'Hesperia' 6-max Seat #5 is the button
Seat 1: BigBlue ($9.17 in chips) 
Seat 2: LanskyBanksy ($16.17 in chips) 
Seat 4: PlayTheBlues4U ($9.67 in chips) 
Seat 5: Klytu ($10 in chips) 
BigBlue: posts small blind $0.05
LanskyBanksy: posts big blind $0.10
*** HOLE CARDS ***
Dealt to PlayTheBlues4U [6d Qh]
PlayTheBlues4U: folds 
Klytu: raises $0.15 to $0.25
BigBlue: folds 
LanskyBanksy: folds 
Uncalled bet ($0.15) returned to Klytu
Klytu collected $0.25 from pot
Klytu: doesn't show hand 
*** SUMMARY ***
Total pot $0.25 | Rake $0 
Seat 1: BigBlue (small blind) folded before Flop
Seat 2: LanskyBanksy (big blind) folded before Flop
Seat 4: PlayTheBlues4U folded before Flop (didn't bet)
Seat 5: Klytu (button) collected ($0.25)


*********** # 159 **************
PokerStars Hand #204851188008: Hold'em No Limit ($0.05/$0.10 USD) - 2019/10/21 21:58:28 ET
Table 'Draco' 6-max Seat #5 is the button
Seat 2: LanskyBanksy ($15.97 in chips) 
Seat 3: PlayTheBlues4U ($18.08 in chips) 
Seat 5: Klytu ($10.70 in chips) 
Seat 6: EddieMoney9 ($15.42 in chips) 
EddieMoney9: posts small blind $0.05
LanskyBanksy: posts big blind $0.10
*** HOLE CARDS ***
Dealt to PlayTheBlues4U [5s Jd]
PlayTheBlues4U: folds 
bsdnj leaves the table
Klytu: raises $0.15 to $0.25
EddieMoney9: folds 
LanskyBanksy: folds 
Uncalled bet ($0.15) returned to Klytu
Klytu collected $0.25 from pot
Klytu: doesn't show hand 
*** SUMMARY ***
Total pot $0.25 | Rake $0 
Seat 2: LanskyBanksy (big blind) folded before Flop
Seat 3: PlayTheBlues4U folded before Flop (didn't bet)
Seat 5: Klytu (button) collected ($0.25)
Seat 6: EddieMoney9 (small blind) folded before Flop


*********** # 160 **************
PokerStars Hand #204851187977: Hold'em No Limit ($0.05/$0.10 USD) - 2019/10/21 21:58:18 ET
Table 'Hesperia' 6-max Seat #4 is the button
Seat 1: BigBlue ($9.12 in chips) 
Seat 2: LanskyBanksy ($16.17 in chips) 
Seat 4: PlayTheBlues4U ($9.67 in chips) 
Seat 5: Klytu ($10.05 in chips) 
Klytu: posts small blind $0.05
BigBlue: posts big blind $0.10
*** HOLE CARDS ***
Dealt to PlayTheBlues4U [3d 9s]
LanskyBanksy: folds 
PlayTheBlues4U: folds 
Klytu: folds 
Uncalled bet ($0.05) returned to BigBlue
BigBlue collected $0.10 from pot
BigBlue: doesn't show hand 
*** SUMMARY ***
Total pot $0.10 | Rake $0 
Seat 1: BigBlue (big blind) collected ($0.10)
Seat 2: LanskyBanksy folded before Flop (didn't bet)
Seat 4: PlayTheBlues4U (button) folded before Flop (didn't bet)
Seat 5: Klytu (small blind) folded before Flop


*********** # 161 **************
PokerStars Hand #204851187929: Hold'em No Limit ($0.05/$0.10 USD) - 2019/10/21 21:58:04 ET
Table 'Hesperia' 6-max Seat #2 is the button
Seat 1: BigBlue ($9.12 in chips) 
Seat 2: LanskyBanksy ($16.02 in chips) 
Seat 4: PlayTheBlues4U ($9.72 in chips) 
Seat 5: Klytu ($10.15 in chips) 
PlayTheBlues4U: posts small blind $0.05
Klytu: posts big blind $0.10
*** HOLE CARDS ***
Dealt to PlayTheBlues4U [3s Kc]
BigBlue: folds 
LanskyBanksy: raises $0.20 to $0.30
PlayTheBlues4U: folds 
Klytu: folds 
Uncalled bet ($0.20) returned to LanskyBanksy
LanskyBanksy collected $0.25 from pot
LanskyBanksy: doesn't show hand 
*** SUMMARY ***
Total pot $0.25 | Rake $0 
Seat 1: BigBlue folded before Flop (didn't bet)
Seat 2: LanskyBanksy (button) collected ($0.25)
Seat 4: PlayTheBlues4U (small blind) folded before Flop
Seat 5: Klytu (big blind) folded before Flop


*********** # 162 **************
PokerStars Hand #204851187892: Hold'em No Limit ($0.05/$0.10 USD) - 2019/10/21 21:57:54 ET
Table 'Draco' 6-max Seat #4 is the button
Seat 1: 123tiger711a ($10.14 in chips) 
Seat 2: LanskyBanksy ($15.97 in chips) 
Seat 3: PlayTheBlues4U ($16.04 in chips) 
Seat 4: bsdnj ($2.11 in chips) 
Seat 5: Klytu ($10.75 in chips) 
Seat 6: EddieMoney9 ($15.52 in chips) 
Klytu: posts small blind $0.05
EddieMoney9: posts big blind $0.10
*** HOLE CARDS ***
Dealt to PlayTheBlues4U [Td Kd]
123tiger711a: folds 
LanskyBanksy: folds 
PlayTheBlues4U: raises $0.20 to $0.30
123tiger711a leaves the table
bsdnj: calls $0.30
Klytu: folds 
EddieMoney9: folds 
*** FLOP *** [5s Jd Ad]
PlayTheBlues4U: bets $0.40
bsdnj: raises $1.41 to $1.81 and is all-in
PlayTheBlues4U: calls $1.41
*** TURN *** [5s Jd Ad] [3h]
*** RIVER *** [5s Jd Ad 3h] [Qh]
*** SHOW DOWN ***
PlayTheBlues4U: shows [Td Kd] (a straight, Ten to Ace)
bsdnj: shows [Ah Qc] (two pair, Aces and Queens)
PlayTheBlues4U collected $4.15 from pot
*** SUMMARY ***
Total pot $4.37 | Rake $0.22 
Board [5s Jd Ad 3h Qh]
Seat 1: 123tiger711a folded before Flop (didn't bet)
Seat 2: LanskyBanksy folded before Flop (didn't bet)
Seat 3: PlayTheBlues4U showed [Td Kd] and won ($4.15) with a straight, Ten to Ace
Seat 4: bsdnj (button) showed [Ah Qc] and lost with two pair, Aces and Queens
Seat 5: Klytu (small blind) folded before Flop
Seat 6: EddieMoney9 (big blind) folded before Flop


*********** # 163 **************
PokerStars Hand #204851187889: Hold'em No Limit ($0.05/$0.10 USD) - 2019/10/21 21:57:53 ET
Table 'Hesperia' 6-max Seat #1 is the button
Seat 1: BigBlue ($9.12 in chips) 
Seat 2: LanskyBanksy ($16.07 in chips) 
Seat 4: PlayTheBlues4U ($9.82 in chips) 
Seat 5: Klytu ($10 in chips) 
LanskyBanksy: posts small blind $0.05
PlayTheBlues4U: posts big blind $0.10
*** HOLE CARDS ***
Dealt to PlayTheBlues4U [Tc 2c]
Klytu: raises $0.20 to $0.30
BigBlue: folds 
LanskyBanksy: folds 
PlayTheBlues4U: folds 
Uncalled bet ($0.20) returned to Klytu
Klytu collected $0.25 from pot
Klytu: doesn't show hand 
*** SUMMARY ***
Total pot $0.25 | Rake $0 
Seat 1: BigBlue (button) folded before Flop (didn't bet)
Seat 2: LanskyBanksy (small blind) folded before Flop
Seat 4: PlayTheBlues4U (big blind) folded before Flop
Seat 5: Klytu collected ($0.25)


*********** # 164 **************
PokerStars Hand #204851187853: Hold'em No Limit ($0.05/$0.10 USD) - 2019/10/21 21:57:44 ET
Table 'Hesperia' 6-max Seat #5 is the button
Seat 1: BigBlue ($9.17 in chips) 
Seat 2: LanskyBanksy ($16.02 in chips) 
Seat 4: PlayTheBlues4U ($9.82 in chips) 
Seat 5: Klytu ($10 in chips) 
BigBlue: posts small blind $0.05
LanskyBanksy: posts big blind $0.10
*** HOLE CARDS ***
Dealt to PlayTheBlues4U [4h Ac]
PlayTheBlues4U: folds 
Klytu: folds 
BigBlue: folds 
Uncalled bet ($0.05) returned to LanskyBanksy
LanskyBanksy collected $0.10 from pot
LanskyBanksy: doesn't show hand 
*** SUMMARY ***
Total pot $0.10 | Rake $0 
Seat 1: BigBlue (small blind) folded before Flop
Seat 2: LanskyBanksy (big blind) collected ($0.10)
Seat 4: PlayTheBlues4U folded before Flop (didn't bet)
Seat 5: Klytu (button) folded before Flop (didn't bet)


*********** # 165 **************
PokerStars Hand #204851187825: Hold'em No Limit ($0.05/$0.10 USD) - 2019/10/21 21:57:37 ET
Table 'Hesperia' 6-max Seat #4 is the button
Seat 1: BigBlue ($9.12 in chips) 
Seat 2: LanskyBanksy ($16.02 in chips) 
Seat 4: PlayTheBlues4U ($9.82 in chips) 
Seat 5: Klytu ($6.75 in chips) 
Klytu: posts small blind $0.05
BigBlue: posts big blind $0.10
*** HOLE CARDS ***
Dealt to PlayTheBlues4U [5s 2h]
LanskyBanksy: folds 
PlayTheBlues4U: folds 
Klytu: folds 
Uncalled bet ($0.05) returned to BigBlue
BigBlue collected $0.10 from pot
BigBlue: doesn't show hand 
*** SUMMARY ***
Total pot $0.10 | Rake $0 
Seat 1: BigBlue (big blind) collected ($0.10)
Seat 2: LanskyBanksy folded before Flop (didn't bet)
Seat 4: PlayTheBlues4U (button) folded before Flop (didn't bet)
Seat 5: Klytu (small blind) folded before Flop


*********** # 166 **************
PokerStars Hand #204851187786: Hold'em No Limit ($0.05/$0.10 USD) - 2019/10/21 21:57:24 ET
Table 'Draco' 6-max Seat #3 is the button
Seat 1: 123tiger711a ($10.14 in chips) 
Seat 2: LanskyBanksy ($15.97 in chips) 
Seat 3: PlayTheBlues4U ($16.34 in chips) 
Seat 4: bsdnj ($2.16 in chips) 
Seat 5: Klytu ($10.43 in chips) 
Seat 6: EddieMoney9 ($15.52 in chips) 
bsdnj: posts small blind $0.05
Klytu: posts big blind $0.10
*** HOLE CARDS ***
Dealt to PlayTheBlues4U [Qh Kc]
EddieMoney9: folds 
123tiger711a: folds 
LanskyBanksy: folds 
PlayTheBlues4U: raises $0.20 to $0.30
bsdnj: folds 
Klytu: calls $0.20
*** FLOP *** [Th 3c 8d]
Klytu: checks 
PlayTheBlues4U: checks 
*** TURN *** [Th 3c 8d] [5d]
Klytu: checks 
PlayTheBlues4U: checks 
*** RIVER *** [Th 3c 8d 5d] [8h]
Klytu: checks 
PlayTheBlues4U: checks 
*** SHOW DOWN ***
Klytu: shows [Ac 4s] (a pair of Eights)
PlayTheBlues4U: mucks hand 
Klytu collected $0.62 from pot
*** SUMMARY ***
Total pot $0.65 | Rake $0.03 
Board [Th 3c 8d 5d 8h]
Seat 1: 123tiger711a folded before Flop (didn't bet)
Seat 2: LanskyBanksy folded before Flop (didn't bet)
Seat 3: PlayTheBlues4U (button) mucked [Qh Kc]
Seat 4: bsdnj (small blind) folded before Flop
Seat 5: Klytu (big blind) showed [Ac 4s] and won ($0.62) with a pair of Eights
Seat 6: EddieMoney9 folded before Flop (didn't bet)


*********** # 167 **************
PokerStars Hand #204851187676: Hold'em No Limit ($0.05/$0.10 USD) - 2019/10/21 21:56:51 ET
Table 'Draco' 6-max Seat #2 is the button
Seat 1: 123tiger711a ($10.14 in chips) 
Seat 2: LanskyBanksy ($15.65 in chips) 
Seat 3: PlayTheBlues4U ($16.39 in chips) 
Seat 4: bsdnj ($2.46 in chips) 
Seat 5: Klytu ($10.43 in chips) 
Seat 6: EddieMoney9 ($15.52 in chips) 
PlayTheBlues4U: posts small blind $0.05
bsdnj: posts big blind $0.10
*** HOLE CARDS ***
Dealt to PlayTheBlues4U [7s 6d]
Klytu: folds 
EddieMoney9: folds 
123tiger711a: folds 
LanskyBanksy: calls $0.10
PlayTheBlues4U: folds 
bsdnj: checks 
*** FLOP *** [Ah Ks Ad]
bsdnj: checks 
LanskyBanksy: bets $0.20
bsdnj: calls $0.20
*** TURN *** [Ah Ks Ad] [8h]
bsdnj: checks 
LanskyBanksy: bets $0.40
bsdnj: folds 
Uncalled bet ($0.40) returned to LanskyBanksy
LanskyBanksy collected $0.62 from pot
LanskyBanksy: doesn't show hand 
*** SUMMARY ***
Total pot $0.65 | Rake $0.03 
Board [Ah Ks Ad 8h]
Seat 1: 123tiger711a folded before Flop (didn't bet)
Seat 2: LanskyBanksy (button) collected ($0.62)
Seat 3: PlayTheBlues4U (small blind) folded before Flop
Seat 4: bsdnj (big blind) folded on the Turn
Seat 5: Klytu folded before Flop (didn't bet)
Seat 6: EddieMoney9 folded before Flop (didn't bet)


*********** # 168 **************
PokerStars Hand #204851187640: Hold'em No Limit ($0.05/$0.10 USD) - 2019/10/21 21:56:41 ET
Table 'Hesperia' 6-max Seat #2 is the button
Seat 1: BigBlue ($6.15 in chips) 
Seat 2: LanskyBanksy ($16.02 in chips) 
Seat 4: PlayTheBlues4U ($9.87 in chips) 
Seat 5: Klytu ($10 in chips) 
Seat 6: 123tiger711a ($22.64 in chips) 
PlayTheBlues4U: posts small blind $0.05
Klytu: posts big blind $0.10
*** HOLE CARDS ***
Dealt to PlayTheBlues4U [Jh 5c]
123tiger711a: folds 
BigBlue: calls $0.10
LanskyBanksy: folds 
123tiger711a leaves the table
PlayTheBlues4U: folds 
Klytu: raises $0.30 to $0.40
BigBlue: calls $0.30
*** FLOP *** [Kh 3s As]
Klytu: bets $0.45
BigBlue: calls $0.45
*** TURN *** [Kh 3s As] [Kc]
Klytu: checks 
Varginho13 leaves the table
BigBlue: bets $0.80
Klytu: calls $0.80
*** RIVER *** [Kh 3s As Kc] [4h]
Klytu: checks 
BigBlue: bets $1.60
Klytu: calls $1.60
*** SHOW DOWN ***
BigBlue: shows [5s Ks] (three of a kind, Kings)
Klytu: mucks hand 
BigBlue collected $6.22 from pot
*** SUMMARY ***
Total pot $6.55 | Rake $0.33 
Board [Kh 3s As Kc 4h]
Seat 1: BigBlue showed [5s Ks] and won ($6.22) with three of a kind, Kings
Seat 2: LanskyBanksy (button) folded before Flop (didn't bet)
Seat 4: PlayTheBlues4U (small blind) folded before Flop
Seat 5: Klytu (big blind) mucked [Jc Js]
Seat 6: 123tiger711a folded before Flop (didn't bet)


*********** # 169 **************
PokerStars Hand #204851187620: Hold'em No Limit ($0.05/$0.10 USD) - 2019/10/21 21:56:35 ET
Table 'Draco' 6-max Seat #1 is the button
Seat 1: 123tiger711a ($10.14 in chips) 
Seat 2: LanskyBanksy ($15.75 in chips) 
Seat 3: PlayTheBlues4U ($16.29 in chips) 
Seat 4: bsdnj ($2.46 in chips) 
Seat 5: Klytu ($10.43 in chips) 
Seat 6: EddieMoney9 ($15.52 in chips) 
LanskyBanksy: posts small blind $0.05
PlayTheBlues4U: posts big blind $0.10
*** HOLE CARDS ***
Dealt to PlayTheBlues4U [Th As]
bsdnj: folds 
Klytu: folds 
EddieMoney9: folds 
123tiger711a: folds 
LanskyBanksy: calls $0.05
PlayTheBlues4U: raises $0.20 to $0.30
LanskyBanksy: folds 
Uncalled bet ($0.20) returned to PlayTheBlues4U
PlayTheBlues4U collected $0.20 from pot
PlayTheBlues4U: doesn't show hand 
*** SUMMARY ***
Total pot $0.20 | Rake $0 
Seat 1: 123tiger711a (button) folded before Flop (didn't bet)
Seat 2: LanskyBanksy (small blind) folded before Flop
Seat 3: PlayTheBlues4U (big blind) collected ($0.20)
Seat 4: bsdnj folded before Flop (didn't bet)
Seat 5: Klytu folded before Flop (didn't bet)
Seat 6: EddieMoney9 folded before Flop (didn't bet)


*********** # 170 **************
PokerStars Hand #204851187550: Hold'em No Limit ($0.05/$0.10 USD) - 2019/10/21 21:56:13 ET
Table 'Draco' 6-max Seat #6 is the button
Seat 1: 123tiger711a ($10.44 in chips) 
Seat 2: LanskyBanksy ($15.85 in chips) 
Seat 3: PlayTheBlues4U ($15.93 in chips) 
Seat 4: bsdnj ($2.46 in chips) 
Seat 5: Klytu ($10.43 in chips) 
Seat 6: EddieMoney9 ($15.52 in chips) 
123tiger711a: posts small blind $0.05
LanskyBanksy: posts big blind $0.10
*** HOLE CARDS ***
Dealt to PlayTheBlues4U [Qc Kd]
PlayTheBlues4U: raises $0.20 to $0.30
bsdnj: folds 
Klytu: folds 
EddieMoney9: folds 
123tiger711a: calls $0.25
LanskyBanksy: folds 
*** FLOP *** [2h 4s 2d]
123tiger711a: checks 
PlayTheBlues4U: checks 
*** TURN *** [2h 4s 2d] [As]
123tiger711a: checks 
PlayTheBlues4U: bets $0.40
123tiger711a: folds 
Uncalled bet ($0.40) returned to PlayTheBlues4U
PlayTheBlues4U collected $0.66 from pot
PlayTheBlues4U: doesn't show hand 
*** SUMMARY ***
Total pot $0.70 | Rake $0.04 
Board [2h 4s 2d As]
Seat 1: 123tiger711a (small blind) folded on the Turn
Seat 2: LanskyBanksy (big blind) folded before Flop
Seat 3: PlayTheBlues4U collected ($0.66)
Seat 4: bsdnj folded before Flop (didn't bet)
Seat 5: Klytu folded before Flop (didn't bet)
Seat 6: EddieMoney9 (button) folded before Flop (didn't bet)


*********** # 171 **************
PokerStars Hand #204851187529: Hold'em No Limit ($0.05/$0.10 USD) - 2019/10/21 21:56:06 ET
Table 'Hesperia' 6-max Seat #1 is the button
Seat 1: BigBlue ($6.15 in chips) 
Seat 2: LanskyBanksy ($16.12 in chips) 
Seat 4: PlayTheBlues4U ($9.78 in chips) 
Seat 5: Klytu ($10 in chips) 
Seat 6: 123tiger711a ($22.64 in chips) 
LanskyBanksy: posts small blind $0.05
PlayTheBlues4U: posts big blind $0.10
*** HOLE CARDS ***
Dealt to PlayTheBlues4U [8s 9c]
Klytu: folds 
123tiger711a: folds 
BigBlue: folds 
LanskyBanksy: calls $0.05
PlayTheBlues4U: checks 
*** FLOP *** [Ks Kc Ac]
LanskyBanksy: checks 
PlayTheBlues4U: checks 
*** TURN *** [Ks Kc Ac] [Kd]
LanskyBanksy: checks 
PlayTheBlues4U: checks 
*** RIVER *** [Ks Kc Ac Kd] [4d]
LanskyBanksy: checks 
PlayTheBlues4U: checks 
*** SHOW DOWN ***
LanskyBanksy: shows [5d 3c] (three of a kind, Kings)
PlayTheBlues4U: shows [8s 9c] (three of a kind, Kings - Ace+Nine kicker)
PlayTheBlues4U collected $0.19 from pot
*** SUMMARY ***
Total pot $0.20 | Rake $0.01 
Board [Ks Kc Ac Kd 4d]
Seat 1: BigBlue (button) folded before Flop (didn't bet)
Seat 2: LanskyBanksy (small blind) showed [5d 3c] and lost with three of a kind, Kings
Seat 4: PlayTheBlues4U (big blind) showed [8s 9c] and won ($0.19) with three of a kind, Kings
Seat 5: Klytu folded before Flop (didn't bet)
Seat 6: 123tiger711a folded before Flop (didn't bet)


*********** # 172 **************
PokerStars Hand #204851187486: Hold'em No Limit ($0.05/$0.10 USD) - 2019/10/21 21:55:55 ET
Table 'Hesperia' 6-max Seat #6 is the button
Seat 1: BigBlue ($6.05 in chips) 
Seat 2: LanskyBanksy ($16.22 in chips) 
Seat 4: PlayTheBlues4U ($9.78 in chips) 
Seat 5: Klytu ($10 in chips) 
Seat 6: 123tiger711a ($22.64 in chips) 
BigBlue: posts small blind $0.05
LanskyBanksy: posts big blind $0.10
*** HOLE CARDS ***
Dealt to PlayTheBlues4U [Ad 6d]
PlayTheBlues4U: folds 
Klytu: folds 
123tiger711a: folds 
BigBlue: raises $0.10 to $0.20
LanskyBanksy: folds 
Uncalled bet ($0.10) returned to BigBlue
BigBlue collected $0.20 from pot
BigBlue: doesn't show hand 
*** SUMMARY ***
Total pot $0.20 | Rake $0 
Seat 1: BigBlue (small blind) collected ($0.20)
Seat 2: LanskyBanksy (big blind) folded before Flop
Seat 4: PlayTheBlues4U folded before Flop (didn't bet)
Seat 5: Klytu folded before Flop (didn't bet)
Seat 6: 123tiger711a (button) folded before Flop (didn't bet)


*********** # 173 **************
PokerStars Hand #204851187453: Hold'em No Limit ($0.05/$0.10 USD) - 2019/10/21 21:55:47 ET
Table 'Draco' 6-max Seat #5 is the button
Seat 1: 123tiger711a ($10.54 in chips) 
Seat 2: LanskyBanksy ($15.85 in chips) 
Seat 3: PlayTheBlues4U ($15.93 in chips) 
Seat 4: bsdnj ($2.46 in chips) 
Seat 5: Klytu ($10.28 in chips) 
Seat 6: EddieMoney9 ($15.57 in chips) 
EddieMoney9: posts small blind $0.05
123tiger711a: posts big blind $0.10
*** HOLE CARDS ***
Dealt to PlayTheBlues4U [8d As]
LanskyBanksy: folds 
PlayTheBlues4U: folds 
bsdnj: folds 
Klytu: raises $0.15 to $0.25
EddieMoney9: folds 
123tiger711a: folds 
Uncalled bet ($0.15) returned to Klytu
Klytu collected $0.25 from pot
Klytu: doesn't show hand 
*** SUMMARY ***
Total pot $0.25 | Rake $0 
Seat 1: 123tiger711a (big blind) folded before Flop
Seat 2: LanskyBanksy folded before Flop (didn't bet)
Seat 3: PlayTheBlues4U folded before Flop (didn't bet)
Seat 4: bsdnj folded before Flop (didn't bet)
Seat 5: Klytu (button) collected ($0.25)
Seat 6: EddieMoney9 (small blind) folded before Flop


*********** # 174 **************
PokerStars Hand #204851187151: Hold'em No Limit ($0.05/$0.10 USD) - 2019/10/21 21:54:35 ET
Table 'Hesperia' 6-max Seat #5 is the button
Seat 1: BigBlue ($6.85 in chips) 
Seat 2: LanskyBanksy ($15.22 in chips) 
Seat 4: PlayTheBlues4U ($9.78 in chips) 
Seat 5: Klytu ($10 in chips) 
Seat 6: 123tiger711a ($22.94 in chips) 
123tiger711a: posts small blind $0.05
BigBlue: posts big blind $0.10
*** HOLE CARDS ***
Dealt to PlayTheBlues4U [4c Qc]
LanskyBanksy: raises $0.20 to $0.30
PlayTheBlues4U: folds 
Klytu: folds 
123tiger711a: calls $0.25
BigBlue: calls $0.20
*** FLOP *** [6c 5c 9d]
123tiger711a: checks 
BigBlue: checks 
LanskyBanksy: checks 
*** TURN *** [6c 5c 9d] [Kd]
123tiger711a: checks 
BigBlue: checks 
LanskyBanksy: bets $0.50
123tiger711a: folds 
BigBlue: calls $0.50
*** RIVER *** [6c 5c 9d Kd] [2s]
BigBlue: checks 
LanskyBanksy: bets $0.90
BigBlue: folds 
Uncalled bet ($0.90) returned to LanskyBanksy
LanskyBanksy collected $1.80 from pot
LanskyBanksy: doesn't show hand 
*** SUMMARY ***
Total pot $1.90 | Rake $0.10 
Board [6c 5c 9d Kd 2s]
Seat 1: BigBlue (big blind) folded on the River
Seat 2: LanskyBanksy collected ($1.80)
Seat 4: PlayTheBlues4U folded before Flop (didn't bet)
Seat 5: Klytu (button) folded before Flop (didn't bet)
Seat 6: 123tiger711a (small blind) folded on the Turn


*********** # 175 **************
PokerStars Hand #204851187133: Hold'em No Limit ($0.05/$0.10 USD) - 2019/10/21 21:54:31 ET
Table 'Draco' 6-max Seat #4 is the button
Seat 1: 123tiger711a ($10.54 in chips) 
Seat 2: LanskyBanksy ($15.85 in chips) 
Seat 3: PlayTheBlues4U ($12.28 in chips) 
Seat 4: bsdnj ($6.36 in chips) 
Seat 5: Klytu ($10.33 in chips) 
Seat 6: EddieMoney9 ($15.67 in chips) 
Klytu: posts small blind $0.05
EddieMoney9: posts big blind $0.10
*** HOLE CARDS ***
Dealt to PlayTheBlues4U [6h 7s]
123tiger711a: folds 
LanskyBanksy: folds 
PlayTheBlues4U: raises $0.20 to $0.30
bsdnj: calls $0.30
Klytu: folds 
EddieMoney9: folds 
*** FLOP *** [5c 4c 3s]
PlayTheBlues4U: bets $0.50
bsdnj: calls $0.50
*** TURN *** [5c 4c 3s] [Qs]
PlayTheBlues4U: bets $1.20
bsdnj: calls $1.20
*** RIVER *** [5c 4c 3s Qs] [Td]
PlayTheBlues4U: bets $1.90
bsdnj: calls $1.90
*** SHOW DOWN ***
PlayTheBlues4U: shows [6h 7s] (a straight, Three to Seven)
bsdnj: mucks hand 
PlayTheBlues4U collected $7.55 from pot
*** SUMMARY ***
Total pot $7.95 | Rake $0.40 
Board [5c 4c 3s Qs Td]
Seat 1: 123tiger711a folded before Flop (didn't bet)
Seat 2: LanskyBanksy folded before Flop (didn't bet)
Seat 3: PlayTheBlues4U showed [6h 7s] and won ($7.55) with a straight, Three to Seven
Seat 4: bsdnj (button) mucked [Qc Ac]
Seat 5: Klytu (small blind) folded before Flop
Seat 6: EddieMoney9 (big blind) folded before Flop


*********** # 176 **************
PokerStars Hand #204851187077: Hold'em No Limit ($0.05/$0.10 USD) - 2019/10/21 21:54:18 ET
Table 'Hesperia' 6-max Seat #4 is the button
Seat 1: BigBlue ($6.85 in chips) 
Seat 2: LanskyBanksy ($15.22 in chips) 
Seat 4: PlayTheBlues4U ($9.78 in chips) 
Seat 5: Klytu ($8.98 in chips) 
Seat 6: 123tiger711a ($22.89 in chips) 
Klytu: posts small blind $0.05
123tiger711a: posts big blind $0.10
*** HOLE CARDS ***
Dealt to PlayTheBlues4U [Js 2s]
BigBlue: folds 
LanskyBanksy: folds 
PlayTheBlues4U: folds 
Klytu: folds 
Uncalled bet ($0.05) returned to 123tiger711a
123tiger711a collected $0.10 from pot
*** SUMMARY ***
Total pot $0.10 | Rake $0 
Seat 1: BigBlue folded before Flop (didn't bet)
Seat 2: LanskyBanksy folded before Flop (didn't bet)
Seat 4: PlayTheBlues4U (button) folded before Flop (didn't bet)
Seat 5: Klytu (small blind) folded before Flop
Seat 6: 123tiger711a (big blind) collected ($0.10)


*********** # 177 **************
PokerStars Hand #204851187044: Hold'em No Limit ($0.05/$0.10 USD) - 2019/10/21 21:54:10 ET
Table 'Draco' 6-max Seat #3 is the button
Seat 1: 123tiger711a ($10.54 in chips) 
Seat 2: LanskyBanksy ($15.85 in chips) 
Seat 3: PlayTheBlues4U ($12.28 in chips) 
Seat 4: bsdnj ($6.41 in chips) 
Seat 5: Klytu ($10.28 in chips) 
Seat 6: EddieMoney9 ($15.67 in chips) 
bsdnj: posts small blind $0.05
Klytu: posts big blind $0.10
*** HOLE CARDS ***
Dealt to PlayTheBlues4U [7s 2h]
EddieMoney9: folds 
123tiger711a: folds 
LanskyBanksy: folds 
PlayTheBlues4U: folds 
bsdnj: folds 
Uncalled bet ($0.05) returned to Klytu
Klytu collected $0.10 from pot
Klytu: doesn't show hand 
*** SUMMARY ***
Total pot $0.10 | Rake $0 
Seat 1: 123tiger711a folded before Flop (didn't bet)
Seat 2: LanskyBanksy folded before Flop (didn't bet)
Seat 3: PlayTheBlues4U (button) folded before Flop (didn't bet)
Seat 4: bsdnj (small blind) folded before Flop
Seat 5: Klytu (big blind) collected ($0.10)
Seat 6: EddieMoney9 folded before Flop (didn't bet)


*********** # 178 **************
PokerStars Hand #204851187007: Hold'em No Limit ($0.05/$0.10 USD) - 2019/10/21 21:54:01 ET
Table 'Draco' 6-max Seat #2 is the button
Seat 1: 123tiger711a ($10.54 in chips) 
Seat 2: LanskyBanksy ($15.85 in chips) 
Seat 3: PlayTheBlues4U ($12.33 in chips) 
Seat 4: bsdnj ($6.36 in chips) 
Seat 5: Klytu ($10.28 in chips) 
Seat 6: EddieMoney9 ($15.67 in chips) 
PlayTheBlues4U: posts small blind $0.05
bsdnj: posts big blind $0.10
*** HOLE CARDS ***
Dealt to PlayTheBlues4U [7c Kd]
Klytu: folds 
EddieMoney9: folds 
123tiger711a: folds 
LanskyBanksy: folds 
PlayTheBlues4U: folds 
Uncalled bet ($0.05) returned to bsdnj
bsdnj collected $0.10 from pot
bsdnj: doesn't show hand 
*** SUMMARY ***
Total pot $0.10 | Rake $0 
Seat 1: 123tiger711a folded before Flop (didn't bet)
Seat 2: LanskyBanksy (button) folded before Flop (didn't bet)
Seat 3: PlayTheBlues4U (small blind) folded before Flop
Seat 4: bsdnj (big blind) collected ($0.10)
Seat 5: Klytu folded before Flop (didn't bet)
Seat 6: EddieMoney9 folded before Flop (didn't bet)


*********** # 179 **************
PokerStars Hand #204851186891: Hold'em No Limit ($0.05/$0.10 USD) - 2019/10/21 21:53:35 ET
Table 'Draco' 6-max Seat #1 is the button
Seat 1: 123tiger711a ($10.54 in chips) 
Seat 2: LanskyBanksy ($15.95 in chips) 
Seat 3: PlayTheBlues4U ($12.43 in chips) 
Seat 4: bsdnj ($6.18 in chips) 
Seat 5: Klytu ($10.28 in chips) 
Seat 6: EddieMoney9 ($15.67 in chips) 
LanskyBanksy: posts small blind $0.05
PlayTheBlues4U: posts big blind $0.10
*** HOLE CARDS ***
Dealt to PlayTheBlues4U [2c 8d]
bsdnj: calls $0.10
Klytu: folds 
EddieMoney9: folds 
123tiger711a: folds 
LanskyBanksy: calls $0.05
PlayTheBlues4U: checks 
*** FLOP *** [7d 5s Jd]
LanskyBanksy: checks 
PlayTheBlues4U: checks 
bsdnj: bets $0.30
LanskyBanksy: folds 
PlayTheBlues4U: folds 
Uncalled bet ($0.30) returned to bsdnj
bsdnj collected $0.28 from pot
bsdnj: doesn't show hand 
*** SUMMARY ***
Total pot $0.30 | Rake $0.02 
Board [7d 5s Jd]
Seat 1: 123tiger711a (button) folded before Flop (didn't bet)
Seat 2: LanskyBanksy (small blind) folded on the Flop
Seat 3: PlayTheBlues4U (big blind) folded on the Flop
Seat 4: bsdnj collected ($0.28)
Seat 5: Klytu folded before Flop (didn't bet)
Seat 6: EddieMoney9 folded before Flop (didn't bet)


*********** # 180 **************
PokerStars Hand #204851186880: Hold'em No Limit ($0.05/$0.10 USD) - 2019/10/21 21:53:34 ET
Table 'Hesperia' 6-max Seat #2 is the button
Seat 1: BigBlue ($6.85 in chips) 
Seat 2: LanskyBanksy ($14.12 in chips) 
Seat 4: PlayTheBlues4U ($9.88 in chips) 
Seat 5: Klytu ($8.61 in chips) 
Seat 6: 123tiger711a ($22.89 in chips) 
PlayTheBlues4U: posts small blind $0.05
Klytu: posts big blind $0.10
*** HOLE CARDS ***
Dealt to PlayTheBlues4U [Kd 2d]
123tiger711a: folds 
BigBlue: folds 
LanskyBanksy: calls $0.10
PlayTheBlues4U: calls $0.05
Klytu: checks 
*** FLOP *** [4s Jc 9h]
PlayTheBlues4U: checks 
Klytu: bets $0.15
LanskyBanksy: calls $0.15
PlayTheBlues4U: folds 
*** TURN *** [4s Jc 9h] [6s]
Klytu: bets $0.30
LanskyBanksy: calls $0.30
*** RIVER *** [4s Jc 9h 6s] [9c]
Klytu: checks 
LanskyBanksy: bets $0.57
Klytu: calls $0.57
*** SHOW DOWN ***
LanskyBanksy: shows [Qh Jd] (two pair, Jacks and Nines)
Klytu: mucks hand 
LanskyBanksy collected $2.22 from pot
*** SUMMARY ***
Total pot $2.34 | Rake $0.12 
Board [4s Jc 9h 6s 9c]
Seat 1: BigBlue folded before Flop (didn't bet)
Seat 2: LanskyBanksy (button) showed [Qh Jd] and won ($2.22) with two pair, Jacks and Nines
Seat 4: PlayTheBlues4U (small blind) folded on the Flop
Seat 5: Klytu (big blind) mucked [5c Js]
Seat 6: 123tiger711a folded before Flop (didn't bet)


*********** # 181 **************
PokerStars Hand #204851186699: Hold'em No Limit ($0.05/$0.10 USD) - 2019/10/21 21:52:53 ET
Table 'Draco' 6-max Seat #6 is the button
Seat 1: 123tiger711a ($10.18 in chips) 
Seat 2: LanskyBanksy ($16.05 in chips) 
Seat 3: PlayTheBlues4U ($12.43 in chips) 
Seat 4: bsdnj ($6.18 in chips) 
Seat 5: Klytu ($10.28 in chips) 
Seat 6: EddieMoney9 ($15.97 in chips) 
123tiger711a: posts small blind $0.05
LanskyBanksy: posts big blind $0.10
*** HOLE CARDS ***
Dealt to PlayTheBlues4U [3d 9d]
PlayTheBlues4U: folds 
bsdnj: folds 
Klytu: folds 
EddieMoney9: raises $0.20 to $0.30
123tiger711a: calls $0.25
LanskyBanksy: folds 
*** FLOP *** [6c 5c 8h]
123tiger711a: checks 
EddieMoney9: checks 
*** TURN *** [6c 5c 8h] [2d]
123tiger711a: checks 
EddieMoney9: checks 
*** RIVER *** [6c 5c 8h 2d] [5h]
123tiger711a: checks 
EddieMoney9: checks 
*** SHOW DOWN ***
123tiger711a: shows [Jh As] (a pair of Fives)
EddieMoney9: mucks hand 
123tiger711a collected $0.66 from pot
*** SUMMARY ***
Total pot $0.70 | Rake $0.04 
Board [6c 5c 8h 2d 5h]
Seat 1: 123tiger711a (small blind) showed [Jh As] and won ($0.66) with a pair of Fives
Seat 2: LanskyBanksy (big blind) folded before Flop
Seat 3: PlayTheBlues4U folded before Flop (didn't bet)
Seat 4: bsdnj folded before Flop (didn't bet)
Seat 5: Klytu folded before Flop (didn't bet)
Seat 6: EddieMoney9 (button) mucked [Kh Qh]


*********** # 182 **************
PokerStars Hand #204851186671: Hold'em No Limit ($0.05/$0.10 USD) - 2019/10/21 21:52:46 ET
Table 'Hesperia' 6-max Seat #1 is the button
Seat 1: BigBlue ($6.85 in chips) 
Seat 2: LanskyBanksy ($12.64 in chips) 
Seat 4: PlayTheBlues4U ($9.98 in chips) 
Seat 5: Klytu ($10.15 in chips) 
Seat 6: 123tiger711a ($22.89 in chips) 
LanskyBanksy: posts small blind $0.05
PlayTheBlues4U: posts big blind $0.10
*** HOLE CARDS ***
Dealt to PlayTheBlues4U [6s Ks]
Klytu: raises $0.20 to $0.30
123tiger711a: folds 
BigBlue: folds 
LanskyBanksy: calls $0.25
PlayTheBlues4U: folds 
*** FLOP *** [4s Kh 7d]
LanskyBanksy: bets $0.20
Klytu: calls $0.20
*** TURN *** [4s Kh 7d] [6c]
LanskyBanksy: checks 
Klytu: checks 
*** RIVER *** [4s Kh 7d 6c] [5s]
LanskyBanksy: bets $1.04
Klytu: calls $1.04
*** SHOW DOWN ***
LanskyBanksy: shows [Ah Ad] (a pair of Aces)
Klytu: mucks hand 
LanskyBanksy collected $3.02 from pot
*** SUMMARY ***
Total pot $3.18 | Rake $0.16 
Board [4s Kh 7d 6c 5s]
Seat 1: BigBlue (button) folded before Flop (didn't bet)
Seat 2: LanskyBanksy (small blind) showed [Ah Ad] and won ($3.02) with a pair of Aces
Seat 4: PlayTheBlues4U (big blind) folded before Flop
Seat 5: Klytu mucked [Jc Kd]
Seat 6: 123tiger711a folded before Flop (didn't bet)


*********** # 183 **************
PokerStars Hand #204851186615: Hold'em No Limit ($0.05/$0.10 USD) - 2019/10/21 21:52:31 ET
Table 'Hesperia' 6-max Seat #6 is the button
Seat 1: BigBlue ($6.90 in chips) 
Seat 2: LanskyBanksy ($12.74 in chips) 
Seat 4: PlayTheBlues4U ($9.98 in chips) 
Seat 5: Klytu ($10 in chips) 
Seat 6: 123tiger711a ($22.89 in chips) 
BigBlue: posts small blind $0.05
LanskyBanksy: posts big blind $0.10
*** HOLE CARDS ***
Dealt to PlayTheBlues4U [5c 4c]
PlayTheBlues4U: folds 
Klytu: raises $0.15 to $0.25
123tiger711a: folds 
BigBlue: folds 
LanskyBanksy: folds 
Uncalled bet ($0.15) returned to Klytu
Klytu collected $0.25 from pot
Klytu: doesn't show hand 
*** SUMMARY ***
Total pot $0.25 | Rake $0 
Seat 1: BigBlue (small blind) folded before Flop
Seat 2: LanskyBanksy (big blind) folded before Flop
Seat 4: PlayTheBlues4U folded before Flop (didn't bet)
Seat 5: Klytu collected ($0.25)
Seat 6: 123tiger711a (button) folded before Flop (didn't bet)


*********** # 184 **************
PokerStars Hand #204851186534: Hold'em No Limit ($0.05/$0.10 USD) - 2019/10/21 21:52:14 ET
Table 'Draco' 6-max Seat #5 is the button
Seat 1: 123tiger711a ($10 in chips) 
Seat 2: LanskyBanksy ($16.05 in chips) 
Seat 3: PlayTheBlues4U ($12.43 in chips) 
Seat 4: bsdnj ($6.28 in chips) 
Seat 5: Klytu ($10.28 in chips) 
Seat 6: EddieMoney9 ($16.07 in chips) 
EddieMoney9: posts small blind $0.05
123tiger711a: posts big blind $0.10
*** HOLE CARDS ***
Dealt to PlayTheBlues4U [Tc Qh]
LanskyBanksy: folds 
PlayTheBlues4U said, "pure skill"
PlayTheBlues4U: folds 
bsdnj: calls $0.10
Klytu: folds 
EddieMoney9: calls $0.05
123tiger711a: checks 
*** FLOP *** [Ad 4c As]
EddieMoney9: checks 
123tiger711a: checks 
bsdnj: checks 
*** TURN *** [Ad 4c As] [4h]
EddieMoney9: checks 
123tiger711a: checks 
bsdnj: checks 
*** RIVER *** [Ad 4c As 4h] [7s]
EddieMoney9: checks 
123tiger711a: checks 
bsdnj: checks 
*** SHOW DOWN ***
EddieMoney9: shows [3d Qs] (two pair, Aces and Fours)
123tiger711a: shows [8d Kc] (two pair, Aces and Fours - King kicker)
bsdnj: mucks hand 
123tiger711a collected $0.28 from pot
*** SUMMARY ***
Total pot $0.30 | Rake $0.02 
Board [Ad 4c As 4h 7s]
Seat 1: 123tiger711a (big blind) showed [8d Kc] and won ($0.28) with two pair, Aces and Fours
Seat 2: LanskyBanksy folded before Flop (didn't bet)
Seat 3: PlayTheBlues4U folded before Flop (didn't bet)
Seat 4: bsdnj mucked [Td 9h]
Seat 5: Klytu (button) folded before Flop (didn't bet)
Seat 6: EddieMoney9 (small blind) showed [3d Qs] and lost with two pair, Aces and Fours


*********** # 185 **************
PokerStars Hand #204851186358: Hold'em No Limit ($0.05/$0.10 USD) - 2019/10/21 21:51:37 ET
Table 'Hesperia' 6-max Seat #5 is the button
Seat 1: BigBlue ($7.20 in chips) 
Seat 2: LanskyBanksy ($12.18 in chips) 
Seat 4: PlayTheBlues4U ($9.98 in chips) 
Seat 5: Klytu ($6.54 in chips) 
Seat 6: 123tiger711a ($23.19 in chips) 
123tiger711a: posts small blind $0.05
BigBlue: posts big blind $0.10
*** HOLE CARDS ***
Dealt to PlayTheBlues4U [7c 8h]
LanskyBanksy: raises $0.20 to $0.30
PlayTheBlues4U: folds 
Klytu: folds 
123tiger711a: calls $0.25
BigBlue: calls $0.20
*** FLOP *** [Qc Qd 2h]
123tiger711a: checks 
BigBlue: checks 
LanskyBanksy: checks 
*** TURN *** [Qc Qd 2h] [7d]
123tiger711a: checks 
BigBlue: checks 
LanskyBanksy: bets $0.50
123tiger711a: folds 
BigBlue: folds 
Uncalled bet ($0.50) returned to LanskyBanksy
LanskyBanksy collected $0.86 from pot
LanskyBanksy: doesn't show hand 
*** SUMMARY ***
Total pot $0.90 | Rake $0.04 
Board [Qc Qd 2h 7d]
Seat 1: BigBlue (big blind) folded on the Turn
Seat 2: LanskyBanksy collected ($0.86)
Seat 4: PlayTheBlues4U folded before Flop (didn't bet)
Seat 5: Klytu (button) folded before Flop (didn't bet)
Seat 6: 123tiger711a (small blind) folded on the Turn


*********** # 186 **************
PokerStars Hand #204851186222: Hold'em No Limit ($0.05/$0.10 USD) - 2019/10/21 21:51:04 ET
Table 'Draco' 6-max Seat #4 is the button
Seat 1: 123tiger711a ($10.06 in chips) 
Seat 2: LanskyBanksy ($16.05 in chips) 
Seat 3: PlayTheBlues4U ($11.59 in chips) 
Seat 4: bsdnj ($6.28 in chips) 
Seat 5: Klytu ($10.58 in chips) 
Seat 6: EddieMoney9 ($16.37 in chips) 
Klytu: posts small blind $0.05
EddieMoney9: posts big blind $0.10
*** HOLE CARDS ***
Dealt to PlayTheBlues4U [2h 2d]
123tiger711a: calls $0.10
LanskyBanksy: folds 
PlayTheBlues4U: raises $0.20 to $0.30
bsdnj: folds 
Klytu: calls $0.25
EddieMoney9: calls $0.20
123tiger711a: calls $0.20
*** FLOP *** [Th 6h 5h]
Klytu: checks 
EddieMoney9: checks 
123tiger711a: checks 
PlayTheBlues4U: checks 
*** TURN *** [Th 6h 5h] [6s]
Klytu: checks 
EddieMoney9: checks 
123tiger711a: checks 
PlayTheBlues4U: checks 
*** RIVER *** [Th 6h 5h 6s] [9h]
Klytu: checks 
EddieMoney9: checks 
123tiger711a: checks 
PlayTheBlues4U: checks 
*** SHOW DOWN ***
Klytu: shows [Kd Qs] (a pair of Sixes)
EddieMoney9: shows [Ac 4s] (a pair of Sixes - Ace kicker)
123tiger711a: mucks hand 
PlayTheBlues4U: shows [2h 2d] (a flush, Ten high)
PlayTheBlues4U collected $1.14 from pot
*** SUMMARY ***
Total pot $1.20 | Rake $0.06 
Board [Th 6h 5h 6s 9h]
Seat 1: 123tiger711a mucked [Js 8s]
Seat 2: LanskyBanksy folded before Flop (didn't bet)
Seat 3: PlayTheBlues4U showed [2h 2d] and won ($1.14) with a flush, Ten high
Seat 4: bsdnj (button) folded before Flop (didn't bet)
Seat 5: Klytu (small blind) showed [Kd Qs] and lost with a pair of Sixes
Seat 6: EddieMoney9 (big blind) showed [Ac 4s] and lost with a pair of Sixes


*********** # 187 **************
PokerStars Hand #204851186201: Hold'em No Limit ($0.05/$0.10 USD) - 2019/10/21 21:51:01 ET
Table 'Hesperia' 6-max Seat #4 is the button
Seat 1: BigBlue ($7.20 in chips) 
Seat 2: LanskyBanksy ($12.18 in chips) 
Seat 4: PlayTheBlues4U ($9.98 in chips) 
Seat 5: Klytu ($16.77 in chips) 
Seat 6: 123tiger711a ($13.98 in chips) 
Klytu: posts small blind $0.05
123tiger711a: posts big blind $0.10
*** HOLE CARDS ***
Dealt to PlayTheBlues4U [6d Tc]
BigBlue: folds 
LanskyBanksy: folds 
PlayTheBlues4U: folds 
Klytu: raises $0.20 to $0.30
123tiger711a: calls $0.20
*** FLOP *** [Qc 2h Qh]
Klytu: checks 
123tiger711a: checks 
*** TURN *** [Qc 2h Qh] [9c]
Klytu: bets $0.30
123tiger711a: raises $1.17 to $1.47
Klytu: calls $1.17
*** RIVER *** [Qc 2h Qh 9c] [3d]
Klytu: bets $1.70
123tiger711a: raises $6.76 to $8.46
Klytu: calls $6.76
*** SHOW DOWN ***
123tiger711a: shows [Qs Ks] (three of a kind, Queens)
Klytu: mucks hand 
123tiger711a collected $19.44 from pot
*** SUMMARY ***
Total pot $20.46 | Rake $1.02 
Board [Qc 2h Qh 9c 3d]
Seat 1: BigBlue folded before Flop (didn't bet)
Seat 2: LanskyBanksy folded before Flop (didn't bet)
Seat 4: PlayTheBlues4U (button) folded before Flop (didn't bet)
Seat 5: Klytu (small blind) mucked [Ah 7s]
Seat 6: 123tiger711a (big blind) showed [Qs Ks] and won ($19.44) with three of a kind, Queens


*********** # 188 **************
PokerStars Hand #204851186145: Hold'em No Limit ($0.05/$0.10 USD) - 2019/10/21 21:50:48 ET
Table 'Hesperia' 6-max Seat #2 is the button
Seat 1: BigBlue ($7.05 in chips) 
Seat 2: LanskyBanksy ($12.18 in chips) 
Seat 4: PlayTheBlues4U ($10.03 in chips) 
Seat 5: Klytu ($16.87 in chips) 
Seat 6: 123tiger711a ($13.98 in chips) 
PlayTheBlues4U: posts small blind $0.05
Klytu: posts big blind $0.10
*** HOLE CARDS ***
Dealt to PlayTheBlues4U [Ks 7c]
123tiger711a: folds 
BigBlue: raises $0.15 to $0.25
LanskyBanksy: folds 
PlayTheBlues4U: folds 
Klytu: folds 
Uncalled bet ($0.15) returned to BigBlue
BigBlue collected $0.25 from pot
BigBlue: doesn't show hand 
*** SUMMARY ***
Total pot $0.25 | Rake $0 
Seat 1: BigBlue collected ($0.25)
Seat 2: LanskyBanksy (button) folded before Flop (didn't bet)
Seat 4: PlayTheBlues4U (small blind) folded before Flop
Seat 5: Klytu (big blind) folded before Flop
Seat 6: 123tiger711a folded before Flop (didn't bet)


*********** # 189 **************
PokerStars Hand #204851186110: Hold'em No Limit ($0.05/$0.10 USD) - 2019/10/21 21:50:40 ET
Table 'Draco' 6-max Seat #3 is the button
Seat 1: 123tiger711a ($10.46 in chips) 
Seat 2: LanskyBanksy ($16.05 in chips) 
Seat 3: PlayTheBlues4U ($11.09 in chips) 
Seat 4: bsdnj ($6.33 in chips) 
Seat 5: Klytu ($10.68 in chips) 
Seat 6: EddieMoney9 ($16.37 in chips) 
bsdnj: posts small blind $0.05
Klytu: posts big blind $0.10
*** HOLE CARDS ***
Dealt to PlayTheBlues4U [Ks 9s]
EddieMoney9: folds 
123tiger711a: calls $0.10
LanskyBanksy: folds 
PlayTheBlues4U: raises $0.30 to $0.40
bsdnj: folds 
Klytu: folds 
123tiger711a: calls $0.30
*** FLOP *** [Tc Ah 9d]
123tiger711a: checks 
PlayTheBlues4U: bets $0.60
123tiger711a: folds 
Uncalled bet ($0.60) returned to PlayTheBlues4U
PlayTheBlues4U collected $0.90 from pot
PlayTheBlues4U: doesn't show hand 
*** SUMMARY ***
Total pot $0.95 | Rake $0.05 
Board [Tc Ah 9d]
Seat 1: 123tiger711a folded on the Flop
Seat 2: LanskyBanksy folded before Flop (didn't bet)
Seat 3: PlayTheBlues4U (button) collected ($0.90)
Seat 4: bsdnj (small blind) folded before Flop
Seat 5: Klytu (big blind) folded before Flop
Seat 6: EddieMoney9 folded before Flop (didn't bet)


*********** # 190 **************
PokerStars Hand #204851186067: Hold'em No Limit ($0.05/$0.10 USD) - 2019/10/21 21:50:32 ET
Table 'Hesperia' 6-max Seat #1 is the button
Seat 1: BigBlue ($6.80 in chips) 
Seat 2: LanskyBanksy ($12.23 in chips) 
Seat 4: PlayTheBlues4U ($10.13 in chips) 
Seat 5: Klytu ($16.87 in chips) 
Seat 6: 123tiger711a ($14.08 in chips) 
LanskyBanksy: posts small blind $0.05
PlayTheBlues4U: posts big blind $0.10
*** HOLE CARDS ***
Dealt to PlayTheBlues4U [Td 6s]
Klytu: folds 
123tiger711a: calls $0.10
BigBlue: raises $0.35 to $0.45
LanskyBanksy: folds 
PlayTheBlues4U: folds 
123tiger711a: folds 
Uncalled bet ($0.35) returned to BigBlue
BigBlue collected $0.35 from pot
BigBlue: doesn't show hand 
*** SUMMARY ***
Total pot $0.35 | Rake $0 
Seat 1: BigBlue (button) collected ($0.35)
Seat 2: LanskyBanksy (small blind) folded before Flop
Seat 4: PlayTheBlues4U (big blind) folded before Flop
Seat 5: Klytu folded before Flop (didn't bet)
Seat 6: 123tiger711a folded before Flop


*********** # 191 **************
PokerStars Hand #204851185990: Hold'em No Limit ($0.05/$0.10 USD) - 2019/10/21 21:50:15 ET
Table 'Hesperia' 6-max Seat #6 is the button
Seat 1: BigBlue ($6.85 in chips) 
Seat 2: LanskyBanksy ($12.18 in chips) 
Seat 4: PlayTheBlues4U ($10.13 in chips) 
Seat 5: Klytu ($16.87 in chips) 
Seat 6: 123tiger711a ($14.08 in chips) 
BigBlue: posts small blind $0.05
LanskyBanksy: posts big blind $0.10
*** HOLE CARDS ***
Dealt to PlayTheBlues4U [4d Kc]
PlayTheBlues4U: folds 
Klytu: folds 
123tiger711a: folds 
BigBlue: folds 
Uncalled bet ($0.05) returned to LanskyBanksy
LanskyBanksy collected $0.10 from pot
LanskyBanksy: doesn't show hand 
*** SUMMARY ***
Total pot $0.10 | Rake $0 
Seat 1: BigBlue (small blind) folded before Flop
Seat 2: LanskyBanksy (big blind) collected ($0.10)
Seat 4: PlayTheBlues4U folded before Flop (didn't bet)
Seat 5: Klytu folded before Flop (didn't bet)
Seat 6: 123tiger711a (button) folded before Flop (didn't bet)


*********** # 192 **************
PokerStars Hand #204850619977: Hold'em No Limit ($0.05/$0.10 USD) - 2019/10/21 21:49:49 ET
Table 'Draco' 6-max Seat #2 is the button
Seat 1: 123tiger711a ($10.46 in chips) 
Seat 2: LanskyBanksy ($15.68 in chips) 
Seat 3: PlayTheBlues4U ($11.29 in chips) 
Seat 4: bsdnj ($6.53 in chips) 
Seat 5: Klytu ($10.68 in chips) 
Seat 6: EddieMoney9 ($16.37 in chips) 
PlayTheBlues4U: posts small blind $0.05
bsdnj: posts big blind $0.10
*** HOLE CARDS ***
Dealt to PlayTheBlues4U [9s 5s]
Klytu: folds 
EddieMoney9: folds 
123tiger711a: folds 
LanskyBanksy: raises $0.10 to $0.20
PlayTheBlues4U: calls $0.15
bsdnj: calls $0.10
*** FLOP *** [Td Kd Jc]
PlayTheBlues4U: checks 
bsdnj: checks 
LanskyBanksy: bets $0.29
PlayTheBlues4U: folds 
bsdnj: folds 
Uncalled bet ($0.29) returned to LanskyBanksy
LanskyBanksy collected $0.57 from pot
LanskyBanksy: doesn't show hand 
*** SUMMARY ***
Total pot $0.60 | Rake $0.03 
Board [Td Kd Jc]
Seat 1: 123tiger711a folded before Flop (didn't bet)
Seat 2: LanskyBanksy (button) collected ($0.57)
Seat 3: PlayTheBlues4U (small blind) folded on the Flop
Seat 4: bsdnj (big blind) folded on the Flop
Seat 5: Klytu folded before Flop (didn't bet)
Seat 6: EddieMoney9 folded before Flop (didn't bet)


*********** # 193 **************
PokerStars Hand #204850619827: Hold'em No Limit ($0.05/$0.10 USD) - 2019/10/21 21:49:12 ET
Table 'Hesperia' 6-max Seat #5 is the button
Seat 1: BigBlue ($6.95 in chips) 
Seat 2: LanskyBanksy ($12.18 in chips) 
Seat 4: PlayTheBlues4U ($10.43 in chips) 
Seat 5: Klytu ($19.12 in chips) 
Seat 6: 123tiger711a ($11.67 in chips) 
123tiger711a: posts small blind $0.05
BigBlue: posts big blind $0.10
*** HOLE CARDS ***
Dealt to PlayTheBlues4U [Ac 8d]
LanskyBanksy: folds 
PlayTheBlues4U: raises $0.20 to $0.30
Klytu: raises $0.75 to $1.05
123tiger711a: calls $1
BigBlue: folds 
PlayTheBlues4U: folds 
*** FLOP *** [6d Th 5d]
123tiger711a: checks 
Klytu: bets $1.20
123tiger711a: raises $4.78 to $5.98
Klytu: folds 
Uncalled bet ($4.78) returned to 123tiger711a
123tiger711a collected $4.66 from pot
*** SUMMARY ***
Total pot $4.90 | Rake $0.24 
Board [6d Th 5d]
Seat 1: BigBlue (big blind) folded before Flop
Seat 2: LanskyBanksy folded before Flop (didn't bet)
Seat 4: PlayTheBlues4U folded before Flop
Seat 5: Klytu (button) folded on the Flop
Seat 6: 123tiger711a (small blind) collected ($4.66)


*********** # 194 **************
PokerStars Hand #204850619711: Hold'em No Limit ($0.05/$0.10 USD) - 2019/10/21 21:48:42 ET
Table 'Draco' 6-max Seat #1 is the button
Seat 1: 123tiger711a ($10.70 in chips) 
Seat 2: LanskyBanksy ($15.78 in chips) 
Seat 3: PlayTheBlues4U ($10.98 in chips) 
Seat 4: bsdnj ($6.53 in chips) 
Seat 5: Klytu ($10.68 in chips) 
Seat 6: EddieMoney9 ($16.37 in chips) 
LanskyBanksy: posts small blind $0.05
PlayTheBlues4U: posts big blind $0.10
*** HOLE CARDS ***
Dealt to PlayTheBlues4U [Tc 8c]
bsdnj: folds 
Klytu: folds 
EddieMoney9: folds 
123tiger711a: calls $0.10
LanskyBanksy: calls $0.05
PlayTheBlues4U: checks 
*** FLOP *** [7c 8d Jh]
LanskyBanksy: checks 
PlayTheBlues4U: checks 
123tiger711a: bets $0.14
LanskyBanksy: folds 
PlayTheBlues4U: calls $0.14
*** TURN *** [7c 8d Jh] [9s]
PlayTheBlues4U: checks 
123tiger711a: checks 
*** RIVER *** [7c 8d Jh 9s] [6s]
PlayTheBlues4U: bets $0.90
123tiger711a: folds 
Uncalled bet ($0.90) returned to PlayTheBlues4U
PlayTheBlues4U collected $0.55 from pot
PlayTheBlues4U: doesn't show hand 
*** SUMMARY ***
Total pot $0.58 | Rake $0.03 
Board [7c 8d Jh 9s 6s]
Seat 1: 123tiger711a (button) folded on the River
Seat 2: LanskyBanksy (small blind) folded on the Flop
Seat 3: PlayTheBlues4U (big blind) collected ($0.55)
Seat 4: bsdnj folded before Flop (didn't bet)
Seat 5: Klytu folded before Flop (didn't bet)
Seat 6: EddieMoney9 folded before Flop (didn't bet)


*********** # 195 **************
PokerStars Hand #204850619694: Hold'em No Limit ($0.05/$0.10 USD) - 2019/10/21 21:48:39 ET
Table 'Hesperia' 6-max Seat #4 is the button
Seat 1: BigBlue ($6.95 in chips) 
Seat 2: LanskyBanksy ($12.18 in chips) 
Seat 4: PlayTheBlues4U ($11.08 in chips) 
Seat 5: Klytu ($19.17 in chips) 
Seat 6: 123tiger711a ($11.04 in chips) 
Klytu: posts small blind $0.05
123tiger711a: posts big blind $0.10
*** HOLE CARDS ***
Dealt to PlayTheBlues4U [9d 6d]
BigBlue: folds 
LanskyBanksy: folds 
PlayTheBlues4U: raises $0.20 to $0.30
Klytu: folds 
123tiger711a: calls $0.20
*** FLOP *** [5h 6c Jd]
123tiger711a: checks 
PlayTheBlues4U: bets $0.35
123tiger711a: raises $1.32 to $1.67
PlayTheBlues4U: folds 
Uncalled bet ($1.32) returned to 123tiger711a
123tiger711a collected $1.28 from pot
*** SUMMARY ***
Total pot $1.35 | Rake $0.07 
Board [5h 6c Jd]
Seat 1: BigBlue folded before Flop (didn't bet)
Seat 2: LanskyBanksy folded before Flop (didn't bet)
Seat 4: PlayTheBlues4U (button) folded on the Flop
Seat 5: Klytu (small blind) folded before Flop
Seat 6: 123tiger711a (big blind) collected ($1.28)


*********** # 196 **************
PokerStars Hand #204850619612: Hold'em No Limit ($0.05/$0.10 USD) - 2019/10/21 21:48:21 ET
Table 'Hesperia' 6-max Seat #2 is the button
Seat 1: BigBlue ($6.80 in chips) 
Seat 2: LanskyBanksy ($12.18 in chips) 
Seat 4: PlayTheBlues4U ($11.13 in chips) 
Seat 5: Klytu ($19.27 in chips) 
Seat 6: 123tiger711a ($11.04 in chips) 
PlayTheBlues4U: posts small blind $0.05
Klytu: posts big blind $0.10
*** HOLE CARDS ***
Dealt to PlayTheBlues4U [Qs 5h]
123tiger711a: folds 
BigBlue: raises $0.25 to $0.35
LanskyBanksy: folds 
PlayTheBlues4U: folds 
Klytu: folds 
Uncalled bet ($0.25) returned to BigBlue
BigBlue collected $0.25 from pot
BigBlue: doesn't show hand 
*** SUMMARY ***
Total pot $0.25 | Rake $0 
Seat 1: BigBlue collected ($0.25)
Seat 2: LanskyBanksy (button) folded before Flop (didn't bet)
Seat 4: PlayTheBlues4U (small blind) folded before Flop
Seat 5: Klytu (big blind) folded before Flop
Seat 6: 123tiger711a folded before Flop (didn't bet)


*********** # 197 **************
PokerStars Hand #204850619580: Hold'em No Limit ($0.05/$0.10 USD) - 2019/10/21 21:48:12 ET
Table 'Draco' 6-max Seat #6 is the button
Seat 1: 123tiger711a ($10.80 in chips) 
Seat 2: LanskyBanksy ($15.69 in chips) 
Seat 3: PlayTheBlues4U ($10.98 in chips) 
Seat 4: bsdnj ($6.53 in chips) 
Seat 5: Klytu ($10.68 in chips) 
Seat 6: EddieMoney9 ($16.37 in chips) 
123tiger711a: posts small blind $0.05
LanskyBanksy: posts big blind $0.10
*** HOLE CARDS ***
Dealt to PlayTheBlues4U [Js 8s]
PlayTheBlues4U: folds 
bsdnj: folds 
Klytu: folds 
EddieMoney9: folds 
123tiger711a: calls $0.05
LanskyBanksy: checks 
*** FLOP *** [3c 9s 4c]
123tiger711a: checks 
LanskyBanksy: checks 
*** TURN *** [3c 9s 4c] [Qs]
123tiger711a: checks 
LanskyBanksy: checks 
*** RIVER *** [3c 9s 4c Qs] [5d]
123tiger711a: checks 
LanskyBanksy: bets $0.50
123tiger711a: folds 
Uncalled bet ($0.50) returned to LanskyBanksy
LanskyBanksy collected $0.19 from pot
LanskyBanksy: doesn't show hand 
*** SUMMARY ***
Total pot $0.20 | Rake $0.01 
Board [3c 9s 4c Qs 5d]
Seat 1: 123tiger711a (small blind) folded on the River
Seat 2: LanskyBanksy (big blind) collected ($0.19)
Seat 3: PlayTheBlues4U folded before Flop (didn't bet)
Seat 4: bsdnj folded before Flop (didn't bet)
Seat 5: Klytu folded before Flop (didn't bet)
Seat 6: EddieMoney9 (button) folded before Flop (didn't bet)


*********** # 198 **************
PokerStars Hand #204850619520: Hold'em No Limit ($0.05/$0.10 USD) - 2019/10/21 21:47:56 ET
Table 'Draco' 6-max Seat #5 is the button
Seat 1: 123tiger711a ($10.90 in chips) 
Seat 2: LanskyBanksy ($15.54 in chips) 
Seat 3: PlayTheBlues4U ($10.98 in chips) 
Seat 4: bsdnj ($6.53 in chips) 
Seat 5: Klytu ($10.68 in chips) 
Seat 6: EddieMoney9 ($16.42 in chips) 
EddieMoney9: posts small blind $0.05
123tiger711a: posts big blind $0.10
*** HOLE CARDS ***
Dealt to PlayTheBlues4U [6h 8d]
LanskyBanksy: raises $0.30 to $0.40
PlayTheBlues4U: folds 
bsdnj: folds 
Klytu: folds 
EddieMoney9: folds 
123tiger711a: folds 
Uncalled bet ($0.30) returned to LanskyBanksy
LanskyBanksy collected $0.25 from pot
LanskyBanksy: doesn't show hand 
*** SUMMARY ***
Total pot $0.25 | Rake $0 
Seat 1: 123tiger711a (big blind) folded before Flop
Seat 2: LanskyBanksy collected ($0.25)
Seat 3: PlayTheBlues4U folded before Flop (didn't bet)
Seat 4: bsdnj folded before Flop (didn't bet)
Seat 5: Klytu (button) folded before Flop (didn't bet)
Seat 6: EddieMoney9 (small blind) folded before Flop


*********** # 199 **************
PokerStars Hand #204850619465: Hold'em No Limit ($0.05/$0.10 USD) - 2019/10/21 21:47:42 ET
Table 'Hesperia' 6-max Seat #1 is the button
Seat 1: BigBlue ($6.80 in chips) 
Seat 2: LanskyBanksy ($12.28 in chips) 
Seat 4: PlayTheBlues4U ($11.04 in chips) 
Seat 5: Klytu ($19.27 in chips) 
Seat 6: 123tiger711a ($11.04 in chips) 
LanskyBanksy: posts small blind $0.05
PlayTheBlues4U: posts big blind $0.10
*** HOLE CARDS ***
Dealt to PlayTheBlues4U [7h 4c]
Klytu: folds 
123tiger711a: folds 
BigBlue: folds 
LanskyBanksy: calls $0.05
PlayTheBlues4U: checks 
*** FLOP *** [2c 5d Js]
LanskyBanksy: checks 
PlayTheBlues4U: checks 
*** TURN *** [2c 5d Js] [Kh]
LanskyBanksy: checks 
PlayTheBlues4U: bets $0.10
LanskyBanksy: folds 
Uncalled bet ($0.10) returned to PlayTheBlues4U
PlayTheBlues4U collected $0.19 from pot
PlayTheBlues4U: doesn't show hand 
*** SUMMARY ***
Total pot $0.20 | Rake $0.01 
Board [2c 5d Js Kh]
Seat 1: BigBlue (button) folded before Flop (didn't bet)
Seat 2: LanskyBanksy (small blind) folded on the Turn
Seat 4: PlayTheBlues4U (big blind) collected ($0.19)
Seat 5: Klytu folded before Flop (didn't bet)
Seat 6: 123tiger711a folded before Flop (didn't bet)


*********** # 200 **************
PokerStars Hand #204850619409: Hold'em No Limit ($0.05/$0.10 USD) - 2019/10/21 21:47:29 ET
Table 'Hesperia' 6-max Seat #6 is the button
Seat 1: BigBlue ($6.85 in chips) 
Seat 2: LanskyBanksy ($12.38 in chips) 
Seat 4: PlayTheBlues4U ($11.04 in chips) 
Seat 5: Klytu ($19.12 in chips) 
Seat 6: 123tiger711a ($11.04 in chips) 
BigBlue: posts small blind $0.05
LanskyBanksy: posts big blind $0.10
*** HOLE CARDS ***
Dealt to PlayTheBlues4U [6c Kd]
PlayTheBlues4U: folds 
Klytu: raises $0.20 to $0.30
123tiger711a: folds 
BigBlue: folds 
LanskyBanksy: folds 
Uncalled bet ($0.20) returned to Klytu
Klytu collected $0.25 from pot
Klytu: doesn't show hand 
*** SUMMARY ***
Total pot $0.25 | Rake $0 
Seat 1: BigBlue (small blind) folded before Flop
Seat 2: LanskyBanksy (big blind) folded before Flop
Seat 4: PlayTheBlues4U folded before Flop (didn't bet)
Seat 5: Klytu collected ($0.25)
Seat 6: 123tiger711a (button) folded before Flop (didn't bet)