*********** # 1 **************
PokerStars Hand #205379006821:  Hold'em No Limit ($0.05/$0.10 USD) - 2019/11/02 22:52:32 ET
Table 'Hekate' 6-max Seat #3 is the button
Seat 3: PlayTheBlues4U ($44.07 in chips)
Seat 4: SeaofLove ($13.10 in chips)
Seat 6: Ty1erDurrden ($17.10 in chips)
SeaofLove: posts small blind $0.05
Ty1erDurrden: posts big blind $0.10
*** HOLE CARDS ***
Dealt to PlayTheBlues4U [Ts 8s]
PlayTheBlues4U: raises $0.20 to $0.30
SeaofLove: folds
Ty1erDurrden: calls $0.20
*** FLOP *** [8d Qh 2s]
Ty1erDurrden: checks
PlayTheBlues4U: bets $0.40
Ty1erDurrden: calls $0.40
*** TURN *** [8d Qh 2s] [9d]
Ty1erDurrden: checks
PlayTheBlues4U: checks
*** RIVER *** [8d Qh 2s 9d] [4c]
Ty1erDurrden: checks
PlayTheBlues4U: checks
*** SHOW DOWN ***
Ty1erDurrden: shows [8c Jh] (a pair of Eights)
PlayTheBlues4U: mucks hand
Ty1erDurrden collected $1.38 from pot
*** SUMMARY ***
Total pot $1.45 | Rake $0.07
Board [8d Qh 2s 9d 4c]
Seat 3: PlayTheBlues4U (button) mucked [Ts 8s]
Seat 4: SeaofLove (small blind) folded before Flop
Seat 6: Ty1erDurrden (big blind) showed [8c Jh] and won ($1.38) with a pair of Eights


*********** # 2 **************
PokerStars Hand #205379006773:  Hold'em No Limit ($0.05/$0.10 USD) - 2019/11/02 22:52:19 ET
Table 'Hekate' 6-max Seat #6 is the button
Seat 3: PlayTheBlues4U ($44.12 in chips)
Seat 4: SeaofLove ($13.05 in chips)
Seat 6: Ty1erDurrden ($17.10 in chips)
PlayTheBlues4U: posts small blind $0.05
SeaofLove: posts big blind $0.10
*** HOLE CARDS ***
Dealt to PlayTheBlues4U [Td 8c]
SourShoes9 leaves the table
Ty1erDurrden: folds
PlayTheBlues4U: folds
Uncalled bet ($0.05) returned to SeaofLove
SeaofLove collected $0.10 from pot
SeaofLove: doesn't show hand
*** SUMMARY ***
Total pot $0.10 | Rake $0
Seat 3: PlayTheBlues4U (small blind) folded before Flop
Seat 4: SeaofLove (big blind) collected ($0.10)
Seat 6: Ty1erDurrden (button) folded before Flop (didn't bet)


*********** # 3 **************
PokerStars Hand #205379006712:  Hold'em No Limit ($0.05/$0.10 USD) - 2019/11/02 22:52:06 ET
Table 'Hekate' 6-max Seat #4 is the button
Seat 1: SourShoes9 ($14.18 in chips)
Seat 3: PlayTheBlues4U ($44.12 in chips)
Seat 4: SeaofLove ($12.90 in chips)
Seat 6: Ty1erDurrden ($17.15 in chips)
Ty1erDurrden: posts small blind $0.05
SourShoes9: posts big blind $0.10
*** HOLE CARDS ***
Dealt to PlayTheBlues4U [9d 4d]
PlayTheBlues4U: folds
SeaofLove: raises $0.15 to $0.25
Ty1erDurrden: folds
SourShoes9: folds
Uncalled bet ($0.15) returned to SeaofLove
SeaofLove collected $0.25 from pot
SeaofLove: doesn't show hand
*** SUMMARY ***
Total pot $0.25 | Rake $0
Seat 1: SourShoes9 (big blind) folded before Flop
Seat 3: PlayTheBlues4U folded before Flop (didn't bet)
Seat 4: SeaofLove (button) collected ($0.25)
Seat 6: Ty1erDurrden (small blind) folded before Flop


*********** # 4 **************
PokerStars Hand #205379006507:  Hold'em No Limit ($0.05/$0.10 USD) - 2019/11/02 22:51:08 ET
Table 'Hekate' 6-max Seat #3 is the button
Seat 1: SourShoes9 ($9.32 in chips)
Seat 3: PlayTheBlues4U ($46.72 in chips)
Seat 4: SeaofLove ($12.95 in chips)
Seat 6: Ty1erDurrden ($19.75 in chips)
SeaofLove: posts small blind $0.05
Ty1erDurrden: posts big blind $0.10
*** HOLE CARDS ***
Dealt to PlayTheBlues4U [9c Tc]
SourShoes9: calls $0.10
PlayTheBlues4U: raises $0.20 to $0.30
SeaofLove: folds
Ty1erDurrden: calls $0.20
SourShoes9: calls $0.20
*** FLOP *** [Jc 7h 7c]
Ty1erDurrden: checks
SourShoes9: checks
PlayTheBlues4U: bets $0.50
Ty1erDurrden: calls $0.50
SourShoes9: calls $0.50
*** TURN *** [Jc 7h 7c] [5c]
Ty1erDurrden: checks
SourShoes9: checks
PlayTheBlues4U: bets $1.80
Ty1erDurrden: calls $1.80
SourShoes9: calls $1.80
*** RIVER *** [Jc 7h 7c 5c] [4c]
Ty1erDurrden: checks
SourShoes9: checks
PlayTheBlues4U: checks
*** SHOW DOWN ***
Ty1erDurrden: shows [7s As] (three of a kind, Sevens)
SourShoes9: shows [Ts Kc] (a flush, King high)
PlayTheBlues4U: mucks hand
SourShoes9 collected $7.46 from pot
*** SUMMARY ***
Total pot $7.85 | Rake $0.39
Board [Jc 7h 7c 5c 4c]
Seat 1: SourShoes9 showed [Ts Kc] and won ($7.46) with a flush, King high
Seat 3: PlayTheBlues4U (button) mucked [9c Tc]
Seat 4: SeaofLove (small blind) folded before Flop
Seat 6: Ty1erDurrden (big blind) showed [7s As] and lost with three of a kind, Sevens


*********** # 5 **************
PokerStars Hand #205379006436:  Hold'em No Limit ($0.05/$0.10 USD) - 2019/11/02 22:50:52 ET
Table 'Hekate' 6-max Seat #1 is the button
Seat 1: SourShoes9 ($9.32 in chips)
Seat 3: PlayTheBlues4U ($46.82 in chips)
Seat 4: SeaofLove ($12.85 in chips)
Seat 6: Ty1erDurrden ($19.75 in chips)
PlayTheBlues4U: posts small blind $0.05
SeaofLove: posts big blind $0.10
*** HOLE CARDS ***
Dealt to PlayTheBlues4U [Ks 9s]
Ty1erDurrden: folds
SourShoes9: folds
PlayTheBlues4U: calls $0.05
SeaofLove: raises $0.20 to $0.30
PlayTheBlues4U: folds
Uncalled bet ($0.20) returned to SeaofLove
SeaofLove collected $0.20 from pot
SeaofLove: doesn't show hand
*** SUMMARY ***
Total pot $0.20 | Rake $0
Seat 1: SourShoes9 (button) folded before Flop (didn't bet)
Seat 3: PlayTheBlues4U (small blind) folded before Flop
Seat 4: SeaofLove (big blind) collected ($0.20)
Seat 6: Ty1erDurrden folded before Flop (didn't bet)


*********** # 6 **************
PokerStars Hand #205379006362:  Hold'em No Limit ($0.05/$0.10 USD) - 2019/11/02 22:50:31 ET
Table 'Antares' 6-max Seat #5 is the button
Seat 1: SeaofLove ($10.57 in chips)
Seat 2: PlayTheBlues4U ($15.34 in chips)
Seat 3: StickyChipss ($16.51 in chips)
Seat 4: tempusfugit3737 ($10.97 in chips)
Seat 5: skoalguy33 ($13.28 in chips)
Seat 6: hanklocic ($7.90 in chips)
hanklocic: posts small blind $0.05
SeaofLove: posts big blind $0.10
*** HOLE CARDS ***
Dealt to PlayTheBlues4U [2d Tc]
PlayTheBlues4U: folds
StickyChipss: folds
tempusfugit3737: raises $0.20 to $0.30
skoalguy33: calls $0.30
hanklocic: calls $0.25
SeaofLove: folds
*** FLOP *** [Ks Ad Kh]
hanklocic: checks
tempusfugit3737: checks
skoalguy33: bets $0.48
hanklocic: folds
tempusfugit3737: calls $0.48
*** TURN *** [Ks Ad Kh] [9d]
tempusfugit3737: checks
skoalguy33: bets $0.93
tempusfugit3737: folds
Uncalled bet ($0.93) returned to skoalguy33
skoalguy33 collected $1.86 from pot
skoalguy33: doesn't show hand
*** SUMMARY ***
Total pot $1.96 | Rake $0.10
Board [Ks Ad Kh 9d]
Seat 1: SeaofLove (big blind) folded before Flop
Seat 2: PlayTheBlues4U folded before Flop (didn't bet)
Seat 3: StickyChipss folded before Flop (didn't bet)
Seat 4: tempusfugit3737 folded on the Turn
Seat 5: skoalguy33 (button) collected ($1.86)
Seat 6: hanklocic (small blind) folded on the Flop


*********** # 7 **************
PokerStars Hand #205379006337:  Hold'em No Limit ($0.05/$0.10 USD) - 2019/11/02 22:50:27 ET
Table 'Hekate' 6-max Seat #6 is the button
Seat 1: SourShoes9 ($8.50 in chips)
Seat 3: PlayTheBlues4U ($46.92 in chips)
Seat 4: SeaofLove ($12.85 in chips)
Seat 6: Ty1erDurrden ($20.55 in chips)
SourShoes9: posts small blind $0.05
PlayTheBlues4U: posts big blind $0.10
*** HOLE CARDS ***
Dealt to PlayTheBlues4U [4d 7c]
SeaofLove: folds
Ty1erDurrden: raises $0.15 to $0.25
SourShoes9: raises $0.15 to $0.40
PlayTheBlues4U: folds
Ty1erDurrden: calls $0.15
*** FLOP *** [Qc Kh Ac]
SourShoes9: bets $0.40
Ty1erDurrden: calls $0.40
*** TURN *** [Qc Kh Ac] [5d]
SourShoes9: bets $0.80
Ty1erDurrden: folds
Uncalled bet ($0.80) returned to SourShoes9
SourShoes9 collected $1.62 from pot
SourShoes9: doesn't show hand
*** SUMMARY ***
Total pot $1.70 | Rake $0.08
Board [Qc Kh Ac 5d]
Seat 1: SourShoes9 (small blind) collected ($1.62)
Seat 3: PlayTheBlues4U (big blind) folded before Flop
Seat 4: SeaofLove folded before Flop (didn't bet)
Seat 6: Ty1erDurrden (button) folded on the Turn


*********** # 8 **************
PokerStars Hand #205379006276:  Hold'em No Limit ($0.05/$0.10 USD) - 2019/11/02 22:50:11 ET
Table 'Antares' 6-max Seat #4 is the button
Seat 1: SeaofLove ($10.57 in chips)
Seat 2: PlayTheBlues4U ($15.34 in chips)
Seat 3: StickyChipss ($16.51 in chips)
Seat 4: tempusfugit3737 ($10.82 in chips)
Seat 5: skoalguy33 ($13.33 in chips)
Seat 6: hanklocic ($8 in chips)
skoalguy33: posts small blind $0.05
hanklocic: posts big blind $0.10
*** HOLE CARDS ***
Dealt to PlayTheBlues4U [6s 8c]
SeaofLove: folds
PlayTheBlues4U: folds
StickyChipss: folds
tempusfugit3737: raises $0.20 to $0.30
skoalguy33: folds
hanklocic: folds
Uncalled bet ($0.20) returned to tempusfugit3737
tempusfugit3737 collected $0.25 from pot
tempusfugit3737: doesn't show hand
*** SUMMARY ***
Total pot $0.25 | Rake $0
Seat 1: SeaofLove folded before Flop (didn't bet)
Seat 2: PlayTheBlues4U folded before Flop (didn't bet)
Seat 3: StickyChipss folded before Flop (didn't bet)
Seat 4: tempusfugit3737 (button) collected ($0.25)
Seat 5: skoalguy33 (small blind) folded before Flop
Seat 6: hanklocic (big blind) folded before Flop


*********** # 9 **************
PokerStars Hand #205379006106:  Hold'em No Limit ($0.05/$0.10 USD) - 2019/11/02 22:49:28 ET
Table 'Antares' 6-max Seat #3 is the button
Seat 1: SeaofLove ($10.57 in chips)
Seat 2: PlayTheBlues4U ($15.34 in chips)
Seat 3: StickyChipss ($16.51 in chips)
Seat 4: tempusfugit3737 ($11.92 in chips)
Seat 5: skoalguy33 ($12.34 in chips)
tempusfugit3737: posts small blind $0.05
skoalguy33: posts big blind $0.10
hanklocic: sits out
*** HOLE CARDS ***
Dealt to PlayTheBlues4U [Ts Jc]
SeaofLove: folds
PlayTheBlues4U: folds
StickyChipss: folds
tempusfugit3737: raises $0.20 to $0.30
skoalguy33: raises $0.80 to $1.10
tempusfugit3737: calls $0.80
*** FLOP *** [2d 5h Th]
tempusfugit3737: checks
skoalguy33: bets $1.05
tempusfugit3737: folds
Uncalled bet ($1.05) returned to skoalguy33
skoalguy33 collected $2.09 from pot
skoalguy33: doesn't show hand
*** SUMMARY ***
Total pot $2.20 | Rake $0.11
Board [2d 5h Th]
Seat 1: SeaofLove folded before Flop (didn't bet)
Seat 2: PlayTheBlues4U folded before Flop (didn't bet)
Seat 3: StickyChipss (button) folded before Flop (didn't bet)
Seat 4: tempusfugit3737 (small blind) folded on the Flop
Seat 5: skoalguy33 (big blind) collected ($2.09)


*********** # 10 **************
PokerStars Hand #205379006104:  Hold'em No Limit ($0.05/$0.10 USD) - 2019/11/02 22:49:28 ET
Table 'Hekate' 6-max Seat #4 is the button
Seat 1: SourShoes9 ($9.70 in chips)
Seat 3: PlayTheBlues4U ($48.12 in chips)
Seat 4: SeaofLove ($12.85 in chips)
Seat 6: Ty1erDurrden ($18.33 in chips)
Ty1erDurrden: posts small blind $0.05
SourShoes9: posts big blind $0.10
*** HOLE CARDS ***
Dealt to PlayTheBlues4U [3c Ac]
PlayTheBlues4U: raises $0.20 to $0.30
SeaofLove: folds
Ty1erDurrden: raises $0.90 to $1.20
SourShoes9: calls $1.10
PlayTheBlues4U: calls $0.90
*** FLOP *** [6s 4h Js]
Ty1erDurrden: bets $1.50
SourShoes9: folds
PlayTheBlues4U: folds
Uncalled bet ($1.50) returned to Ty1erDurrden
Ty1erDurrden collected $3.42 from pot
Ty1erDurrden: doesn't show hand
*** SUMMARY ***
Total pot $3.60 | Rake $0.18
Board [6s 4h Js]
Seat 1: SourShoes9 (big blind) folded on the Flop
Seat 3: PlayTheBlues4U folded on the Flop
Seat 4: SeaofLove (button) folded before Flop (didn't bet)
Seat 6: Ty1erDurrden (small blind) collected ($3.42)


*********** # 11 **************
PokerStars Hand #205379006079:  Hold'em No Limit ($0.05/$0.10 USD) - 2019/11/02 22:49:21 ET
Table 'Hekate' 6-max Seat #3 is the button
Seat 1: SourShoes9 ($9.70 in chips)
Seat 3: PlayTheBlues4U ($48.12 in chips)
Seat 4: SeaofLove ($12.90 in chips)
Seat 6: Ty1erDurrden ($18.28 in chips)
SeaofLove: posts small blind $0.05
Ty1erDurrden: posts big blind $0.10
*** HOLE CARDS ***
Dealt to PlayTheBlues4U [Kh 6c]
SourShoes9: folds
PlayTheBlues4U: folds
SeaofLove: folds
Uncalled bet ($0.05) returned to Ty1erDurrden
Ty1erDurrden collected $0.10 from pot
Ty1erDurrden: doesn't show hand
*** SUMMARY ***
Total pot $0.10 | Rake $0
Seat 1: SourShoes9 folded before Flop (didn't bet)
Seat 3: PlayTheBlues4U (button) folded before Flop (didn't bet)
Seat 4: SeaofLove (small blind) folded before Flop
Seat 6: Ty1erDurrden (big blind) collected ($0.10)


*********** # 12 **************
PokerStars Hand #205379006038:  Hold'em No Limit ($0.05/$0.10 USD) - 2019/11/02 22:49:11 ET
Table 'Antares' 6-max Seat #2 is the button
Seat 1: SeaofLove ($10.42 in chips)
Seat 2: PlayTheBlues4U ($15.34 in chips)
Seat 3: StickyChipss ($16.56 in chips)
Seat 4: tempusfugit3737 ($12.02 in chips)
Seat 5: skoalguy33 ($12.34 in chips)
StickyChipss: posts small blind $0.05
tempusfugit3737: posts big blind $0.10
hanklocic: sits out
*** HOLE CARDS ***
Dealt to PlayTheBlues4U [6c 2c]
skoalguy33: folds
SeaofLove: raises $0.20 to $0.30
PlayTheBlues4U: folds
StickyChipss: folds
tempusfugit3737: folds
Uncalled bet ($0.20) returned to SeaofLove
SeaofLove collected $0.25 from pot
SeaofLove: doesn't show hand
*** SUMMARY ***
Total pot $0.25 | Rake $0
Seat 1: SeaofLove collected ($0.25)
Seat 2: PlayTheBlues4U (button) folded before Flop (didn't bet)
Seat 3: StickyChipss (small blind) folded before Flop
Seat 4: tempusfugit3737 (big blind) folded before Flop
Seat 5: skoalguy33 folded before Flop (didn't bet)


*********** # 13 **************
PokerStars Hand #205379005978:  Hold'em No Limit ($0.05/$0.10 USD) - 2019/11/02 22:48:55 ET
Table 'Antares' 6-max Seat #1 is the button
Seat 1: SeaofLove ($10.42 in chips)
Seat 2: PlayTheBlues4U ($15.39 in chips)
Seat 3: StickyChipss ($16.51 in chips)
Seat 4: tempusfugit3737 ($12.02 in chips)
Seat 5: skoalguy33 ($12.34 in chips)
PlayTheBlues4U: posts small blind $0.05
StickyChipss: posts big blind $0.10
*** HOLE CARDS ***
Dealt to PlayTheBlues4U [Kh 6c]
hanklocic joins the table at seat #6
tempusfugit3737: folds
skoalguy33: folds
SeaofLove: folds
PlayTheBlues4U: folds
Uncalled bet ($0.05) returned to StickyChipss
StickyChipss collected $0.10 from pot
*** SUMMARY ***
Total pot $0.10 | Rake $0
Seat 1: SeaofLove (button) folded before Flop (didn't bet)
Seat 2: PlayTheBlues4U (small blind) folded before Flop
Seat 3: StickyChipss (big blind) collected ($0.10)
Seat 4: tempusfugit3737 folded before Flop (didn't bet)
Seat 5: skoalguy33 folded before Flop (didn't bet)


*********** # 14 **************
PokerStars Hand #205379005940:  Hold'em No Limit ($0.05/$0.10 USD) - 2019/11/02 22:48:45 ET
Table 'Antares' 6-max Seat #5 is the button
Seat 1: SeaofLove ($10.32 in chips)
Seat 2: PlayTheBlues4U ($15.49 in chips)
Seat 3: StickyChipss ($16.51 in chips)
Seat 4: tempusfugit3737 ($12.02 in chips)
Seat 5: skoalguy33 ($12.34 in chips)
SeaofLove: posts small blind $0.05
PlayTheBlues4U: posts big blind $0.10
*** HOLE CARDS ***
Dealt to PlayTheBlues4U [3h 8h]
StickyChipss: folds
tempusfugit3737: folds
skoalguy33: folds
SeaofLove: raises $0.20 to $0.30
PlayTheBlues4U: folds
Uncalled bet ($0.20) returned to SeaofLove
SeaofLove collected $0.20 from pot
SeaofLove: doesn't show hand
*** SUMMARY ***
Total pot $0.20 | Rake $0
Seat 1: SeaofLove (small blind) collected ($0.20)
Seat 2: PlayTheBlues4U (big blind) folded before Flop
Seat 3: StickyChipss folded before Flop (didn't bet)
Seat 4: tempusfugit3737 folded before Flop (didn't bet)
Seat 5: skoalguy33 (button) folded before Flop (didn't bet)


*********** # 15 **************
PokerStars Hand #205379005914:  Hold'em No Limit ($0.05/$0.10 USD) - 2019/11/02 22:48:40 ET
Table 'Hekate' 6-max Seat #1 is the button
Seat 1: SourShoes9 ($10.95 in chips)
Seat 3: PlayTheBlues4U ($48.37 in chips)
Seat 4: SeaofLove ($11.30 in chips)
Seat 6: Ty1erDurrden ($18.53 in chips)
PlayTheBlues4U: posts small blind $0.05
SeaofLove: posts big blind $0.10
*** HOLE CARDS ***
Dealt to PlayTheBlues4U [Js Ac]
Ty1erDurrden: raises $0.15 to $0.25
SourShoes9: calls $0.25
PlayTheBlues4U: calls $0.20
SeaofLove: raises $1 to $1.25
Ty1erDurrden: folds
SourShoes9: calls $1
PlayTheBlues4U: folds
*** FLOP *** [9d Qd 2h]
SeaofLove: bets $1.50
SourShoes9: folds
Uncalled bet ($1.50) returned to SeaofLove
SeaofLove collected $2.85 from pot
SeaofLove: doesn't show hand
*** SUMMARY ***
Total pot $3 | Rake $0.15
Board [9d Qd 2h]
Seat 1: SourShoes9 (button) folded on the Flop
Seat 3: PlayTheBlues4U (small blind) folded before Flop
Seat 4: SeaofLove (big blind) collected ($2.85)
Seat 6: Ty1erDurrden folded before Flop


*********** # 16 **************
PokerStars Hand #205379005899:  Hold'em No Limit ($0.05/$0.10 USD) - 2019/11/02 22:48:36 ET
Table 'Antares' 6-max Seat #4 is the button
Seat 1: SeaofLove ($10.27 in chips)
Seat 2: PlayTheBlues4U ($15.49 in chips)
Seat 3: StickyChipss ($16.51 in chips)
Seat 4: tempusfugit3737 ($12.02 in chips)
Seat 5: skoalguy33 ($12.39 in chips)
skoalguy33: posts small blind $0.05
SeaofLove: posts big blind $0.10
*** HOLE CARDS ***
Dealt to PlayTheBlues4U [6d 4c]
PlayTheBlues4U: folds
StickyChipss: folds
tempusfugit3737: folds
skoalguy33: folds
Uncalled bet ($0.05) returned to SeaofLove
SeaofLove collected $0.10 from pot
SeaofLove: doesn't show hand
*** SUMMARY ***
Total pot $0.10 | Rake $0
Seat 1: SeaofLove (big blind) collected ($0.10)
Seat 2: PlayTheBlues4U folded before Flop (didn't bet)
Seat 3: StickyChipss folded before Flop (didn't bet)
Seat 4: tempusfugit3737 (button) folded before Flop (didn't bet)
Seat 5: skoalguy33 (small blind) folded before Flop


*********** # 17 **************
PokerStars Hand #205379005864:  Hold'em No Limit ($0.05/$0.10 USD) - 2019/11/02 22:48:25 ET
Table 'Antares' 6-max Seat #3 is the button
Seat 1: SeaofLove ($10.27 in chips)
Seat 2: PlayTheBlues4U ($15.49 in chips)
Seat 3: StickyChipss ($16.51 in chips)
Seat 4: tempusfugit3737 ($12.07 in chips)
Seat 5: skoalguy33 ($12.34 in chips)
tempusfugit3737: posts small blind $0.05
skoalguy33: posts big blind $0.10
*** HOLE CARDS ***
Dealt to PlayTheBlues4U [Ad 3s]
SeaofLove: folds
PlayTheBlues4U: folds
StickyChipss: folds
tempusfugit3737: folds
Uncalled bet ($0.05) returned to skoalguy33
skoalguy33 collected $0.10 from pot
skoalguy33: doesn't show hand
*** SUMMARY ***
Total pot $0.10 | Rake $0
Seat 1: SeaofLove folded before Flop (didn't bet)
Seat 2: PlayTheBlues4U folded before Flop (didn't bet)
Seat 3: StickyChipss (button) folded before Flop (didn't bet)
Seat 4: tempusfugit3737 (small blind) folded before Flop
Seat 5: skoalguy33 (big blind) collected ($0.10)


*********** # 18 **************
PokerStars Hand #205379005830:  Hold'em No Limit ($0.05/$0.10 USD) - 2019/11/02 22:48:16 ET
Table 'Antares' 6-max Seat #2 is the button
Seat 1: SeaofLove ($10.27 in chips)
Seat 2: PlayTheBlues4U ($15.49 in chips)
Seat 3: StickyChipss ($16.56 in chips)
Seat 4: tempusfugit3737 ($12.02 in chips)
Seat 5: skoalguy33 ($12.34 in chips)
StickyChipss: posts small blind $0.05
tempusfugit3737: posts big blind $0.10
*** HOLE CARDS ***
Dealt to PlayTheBlues4U [Jh 6d]
skoalguy33: folds
SeaofLove: folds
PlayTheBlues4U: folds
StickyChipss: folds
Uncalled bet ($0.05) returned to tempusfugit3737
tempusfugit3737 collected $0.10 from pot
tempusfugit3737: doesn't show hand
*** SUMMARY ***
Total pot $0.10 | Rake $0
Seat 1: SeaofLove folded before Flop (didn't bet)
Seat 2: PlayTheBlues4U (button) folded before Flop (didn't bet)
Seat 3: StickyChipss (small blind) folded before Flop
Seat 4: tempusfugit3737 (big blind) collected ($0.10)
Seat 5: skoalguy33 folded before Flop (didn't bet)


*********** # 19 **************
PokerStars Hand #205379005736:  Hold'em No Limit ($0.05/$0.10 USD) - 2019/11/02 22:47:53 ET
Table 'Hekate' 6-max Seat #6 is the button
Seat 1: SourShoes9 ($11 in chips)
Seat 3: PlayTheBlues4U ($48.47 in chips)
Seat 4: SeaofLove ($10.08 in chips)
Seat 6: Ty1erDurrden ($19.73 in chips)
SourShoes9: posts small blind $0.05
PlayTheBlues4U: posts big blind $0.10
*** HOLE CARDS ***
Dealt to PlayTheBlues4U [5s 9s]
SeaofLove: raises $0.15 to $0.25
Ty1erDurrden: raises $0.95 to $1.20
SourShoes9: folds
PlayTheBlues4U: folds
SeaofLove: calls $0.95
*** FLOP *** [2s Ts 4d]
SeaofLove: checks
Ty1erDurrden: checks
*** TURN *** [2s Ts 4d] [Js]
SeaofLove: bets $1.61
Ty1erDurrden: folds
Uncalled bet ($1.61) returned to SeaofLove
SeaofLove collected $2.42 from pot
SeaofLove: doesn't show hand
*** SUMMARY ***
Total pot $2.55 | Rake $0.13
Board [2s Ts 4d Js]
Seat 1: SourShoes9 (small blind) folded before Flop
Seat 3: PlayTheBlues4U (big blind) folded before Flop
Seat 4: SeaofLove collected ($2.42)
Seat 6: Ty1erDurrden (button) folded on the Turn


*********** # 20 **************
PokerStars Hand #205379005723:  Hold'em No Limit ($0.05/$0.10 USD) - 2019/11/02 22:47:50 ET
Table 'Antares' 6-max Seat #1 is the button
Seat 1: SeaofLove ($10.27 in chips)
Seat 2: PlayTheBlues4U ($15.54 in chips)
Seat 3: StickyChipss ($16.66 in chips)
Seat 4: tempusfugit3737 ($11.61 in chips)
Seat 5: skoalguy33 ($12.64 in chips)
PlayTheBlues4U: posts small blind $0.05
StickyChipss: posts big blind $0.10
*** HOLE CARDS ***
Dealt to PlayTheBlues4U [9c Qc]
tempusfugit3737: raises $0.20 to $0.30
skoalguy33: calls $0.30
SeaofLove: folds
PlayTheBlues4U: folds
StickyChipss: folds
*** FLOP *** [Th 6d 6c]
tempusfugit3737: checks
skoalguy33: checks
*** TURN *** [Th 6d 6c] [Jh]
tempusfugit3737: bets $0.40
skoalguy33: folds
Uncalled bet ($0.40) returned to tempusfugit3737
tempusfugit3737 collected $0.71 from pot
tempusfugit3737: doesn't show hand
*** SUMMARY ***
Total pot $0.75 | Rake $0.04
Board [Th 6d 6c Jh]
Seat 1: SeaofLove (button) folded before Flop (didn't bet)
Seat 2: PlayTheBlues4U (small blind) folded before Flop
Seat 3: StickyChipss (big blind) folded before Flop
Seat 4: tempusfugit3737 collected ($0.71)
Seat 5: skoalguy33 folded on the Turn


*********** # 21 **************
PokerStars Hand #205379005648:  Hold'em No Limit ($0.05/$0.10 USD) - 2019/11/02 22:47:29 ET
Table 'Hekate' 6-max Seat #4 is the button
Seat 1: SourShoes9 ($11.30 in chips)
Seat 3: PlayTheBlues4U ($48.47 in chips)
Seat 4: SeaofLove ($10.08 in chips)
Seat 6: Ty1erDurrden ($19.46 in chips)
Ty1erDurrden: posts small blind $0.05
SourShoes9: posts big blind $0.10
*** HOLE CARDS ***
Dealt to PlayTheBlues4U [8c 9h]
PlayTheBlues4U: folds
SeaofLove: folds
Ty1erDurrden: raises $0.20 to $0.30
SourShoes9: calls $0.20
*** FLOP *** [Qd 8d Ac]
Ty1erDurrden: bets $0.30
SourShoes9: folds
Uncalled bet ($0.30) returned to Ty1erDurrden
Ty1erDurrden collected $0.57 from pot
Ty1erDurrden: doesn't show hand
*** SUMMARY ***
Total pot $0.60 | Rake $0.03
Board [Qd 8d Ac]
Seat 1: SourShoes9 (big blind) folded on the Flop
Seat 3: PlayTheBlues4U folded before Flop (didn't bet)
Seat 4: SeaofLove (button) folded before Flop (didn't bet)
Seat 6: Ty1erDurrden (small blind) collected ($0.57)


*********** # 22 **************
PokerStars Hand #205379005593:  Hold'em No Limit ($0.05/$0.10 USD) - 2019/11/02 22:47:15 ET
Table 'Antares' 6-max Seat #5 is the button
Seat 1: SeaofLove ($10 in chips)
Seat 2: PlayTheBlues4U ($15.84 in chips)
Seat 3: StickyChipss ($16.66 in chips)
Seat 4: tempusfugit3737 ($11.61 in chips)
Seat 5: skoalguy33 ($12.64 in chips)
SeaofLove: posts small blind $0.05
PlayTheBlues4U: posts big blind $0.10
*** HOLE CARDS ***
Dealt to PlayTheBlues4U [Qc Td]
StickyChipss: folds
tempusfugit3737: folds
skoalguy33: folds
SeaofLove: raises $0.20 to $0.30
PlayTheBlues4U: calls $0.20
*** FLOP *** [6s 5h Ah]
SeaofLove: bets $0.38
PlayTheBlues4U: folds
Uncalled bet ($0.38) returned to SeaofLove
SeaofLove collected $0.57 from pot
SeaofLove: doesn't show hand
*** SUMMARY ***
Total pot $0.60 | Rake $0.03
Board [6s 5h Ah]
Seat 1: SeaofLove (small blind) collected ($0.57)
Seat 2: PlayTheBlues4U (big blind) folded on the Flop
Seat 3: StickyChipss folded before Flop (didn't bet)
Seat 4: tempusfugit3737 folded before Flop (didn't bet)
Seat 5: skoalguy33 (button) folded before Flop (didn't bet)


*********** # 23 **************
PokerStars Hand #205379005569:  Hold'em No Limit ($0.05/$0.10 USD) - 2019/11/02 22:47:09 ET
Table 'Hekate' 6-max Seat #3 is the button
Seat 1: SourShoes9 ($11.16 in chips)
Seat 3: PlayTheBlues4U ($48.47 in chips)
Seat 4: SeaofLove ($10.13 in chips)
Seat 6: Ty1erDurrden ($19.56 in chips)
SeaofLove: posts small blind $0.05
Ty1erDurrden: posts big blind $0.10
*** HOLE CARDS ***
Dealt to PlayTheBlues4U [8d Kc]
SourShoes9: calls $0.10
PlayTheBlues4U: folds
SeaofLove: folds
mankar.am leaves the table
Ty1erDurrden: checks
*** FLOP *** [Jc Ts 2h]
Ty1erDurrden: checks
SourShoes9: bets $0.10
Ty1erDurrden: folds
Uncalled bet ($0.10) returned to SourShoes9
SourShoes9 collected $0.24 from pot
SourShoes9: doesn't show hand
*** SUMMARY ***
Total pot $0.25 | Rake $0.01
Board [Jc Ts 2h]
Seat 1: SourShoes9 collected ($0.24)
Seat 3: PlayTheBlues4U (button) folded before Flop (didn't bet)
Seat 4: SeaofLove (small blind) folded before Flop
Seat 6: Ty1erDurrden (big blind) folded on the Flop


*********** # 24 **************
PokerStars Hand #205379005462:  Hold'em No Limit ($0.05/$0.10 USD) - 2019/11/02 22:46:39 ET
Table 'Antares' 6-max Seat #4 is the button
Seat 1: SeaofLove ($10 in chips)
Seat 2: PlayTheBlues4U ($15.84 in chips)
Seat 3: StickyChipss ($13.81 in chips)
Seat 4: tempusfugit3737 ($11.61 in chips)
Seat 5: skoalguy33 ($13.44 in chips)
skoalguy33: posts small blind $0.05
SeaofLove: posts big blind $0.10
*** HOLE CARDS ***
Dealt to PlayTheBlues4U [3s 4c]
PlayTheBlues4U: folds
StickyChipss: raises $0.20 to $0.30
tempusfugit3737: folds
skoalguy33: calls $0.25
SeaofLove: calls $0.20
*** FLOP *** [Th 6h 7c]
skoalguy33: checks
SeaofLove: bets $0.50
StickyChipss: calls $0.50
skoalguy33: calls $0.50
*** TURN *** [Th 6h 7c] [Qd]
skoalguy33: checks
SeaofLove: bets $1.52
StickyChipss: calls $1.52
skoalguy33: folds
*** RIVER *** [Th 6h 7c Qd] [4d]
SeaofLove: checks
StickyChipss: bets $5.17
SeaofLove: folds
Uncalled bet ($5.17) returned to StickyChipss
StickyChipss collected $5.17 from pot
*** SUMMARY ***
Total pot $5.44 | Rake $0.27
Board [Th 6h 7c Qd 4d]
Seat 1: SeaofLove (big blind) folded on the River
Seat 2: PlayTheBlues4U folded before Flop (didn't bet)
Seat 3: StickyChipss collected ($5.17)
Seat 4: tempusfugit3737 (button) folded before Flop (didn't bet)
Seat 5: skoalguy33 (small blind) folded on the Turn


*********** # 25 **************
PokerStars Hand #205379005429:  Hold'em No Limit ($0.05/$0.10 USD) - 2019/11/02 22:46:31 ET
Table 'Antares' 6-max Seat #3 is the button
Seat 1: SeaofLove ($10 in chips)
Seat 2: PlayTheBlues4U ($15.69 in chips)
Seat 3: StickyChipss ($13.81 in chips)
Seat 4: tempusfugit3737 ($11.66 in chips)
Seat 5: skoalguy33 ($13.54 in chips)
tempusfugit3737: posts small blind $0.05
skoalguy33: posts big blind $0.10
*** HOLE CARDS ***
Dealt to PlayTheBlues4U [As Qc]
SeaofLove: folds
PlayTheBlues4U: raises $0.20 to $0.30
StickyChipss: folds
tempusfugit3737: folds
skoalguy33: folds
Uncalled bet ($0.20) returned to PlayTheBlues4U
PlayTheBlues4U collected $0.25 from pot
PlayTheBlues4U: doesn't show hand
*** SUMMARY ***
Total pot $0.25 | Rake $0
Seat 1: SeaofLove folded before Flop (didn't bet)
Seat 2: PlayTheBlues4U collected ($0.25)
Seat 3: StickyChipss (button) folded before Flop (didn't bet)
Seat 4: tempusfugit3737 (small blind) folded before Flop
Seat 5: skoalguy33 (big blind) folded before Flop


*********** # 26 **************
PokerStars Hand #205379005384:  Hold'em No Limit ($0.05/$0.10 USD) - 2019/11/02 22:46:20 ET
Table 'Hekate' 6-max Seat #1 is the button
Seat 1: SourShoes9 ($6.79 in chips)
Seat 2: mankar.am ($4.75 in chips)
Seat 3: PlayTheBlues4U ($48.57 in chips)
Seat 4: SeaofLove ($10.13 in chips)
Seat 6: Ty1erDurrden ($19.56 in chips)
mankar.am: posts small blind $0.05
PlayTheBlues4U: posts big blind $0.10
*** HOLE CARDS ***
Dealt to PlayTheBlues4U [4s Kd]
SeaofLove: folds
Ty1erDurrden: folds
SourShoes9: raises $0.20 to $0.30
mankar.am: calls $0.25
PlayTheBlues4U: folds
*** FLOP *** [Jc 2s 3h]
mankar.am: checks
SourShoes9: bets $0.70
mankar.am: calls $0.70
*** TURN *** [Jc 2s 3h] [Qs]
mankar.am: checks
SourShoes9: bets $2.70
mankar.am: calls $2.70
*** RIVER *** [Jc 2s 3h Qs] [6c]
mankar.am: bets $1.05 and is all-in
SourShoes9: calls $1.05
*** SHOW DOWN ***
mankar.am: shows [Kc Th] (high card King)
SourShoes9: shows [Js 9c] (a pair of Jacks)
SourShoes9 collected $9.12 from pot
*** SUMMARY ***
Total pot $9.60 | Rake $0.48
Board [Jc 2s 3h Qs 6c]
Seat 1: SourShoes9 (button) showed [Js 9c] and won ($9.12) with a pair of Jacks
Seat 2: mankar.am (small blind) showed [Kc Th] and lost with high card King
Seat 3: PlayTheBlues4U (big blind) folded before Flop
Seat 4: SeaofLove folded before Flop (didn't bet)
Seat 6: Ty1erDurrden folded before Flop (didn't bet)


*********** # 27 **************
PokerStars Hand #205379005272:  Hold'em No Limit ($0.05/$0.10 USD) - 2019/11/02 22:45:51 ET
Table 'Antares' 6-max Seat #2 is the button
Seat 1: SeaofLove ($10 in chips)
Seat 2: PlayTheBlues4U ($15.18 in chips)
Seat 3: StickyChipss ($13.86 in chips)
Seat 4: tempusfugit3737 ($11.91 in chips)
Seat 5: skoalguy33 ($13.54 in chips)
StickyChipss: posts small blind $0.05
tempusfugit3737: posts big blind $0.10
*** HOLE CARDS ***
Dealt to PlayTheBlues4U [7c 7s]
skoalguy33: folds
SeaofLove: raises $0.15 to $0.25
PlayTheBlues4U: calls $0.25
StickyChipss: folds
tempusfugit3737: calls $0.15
*** FLOP *** [7h 8c 8h]
tempusfugit3737: checks
SeaofLove: checks
PlayTheBlues4U: bets $0.60
tempusfugit3737: folds
SeaofLove: folds
Uncalled bet ($0.60) returned to PlayTheBlues4U
PlayTheBlues4U collected $0.76 from pot
PlayTheBlues4U: doesn't show hand
*** SUMMARY ***
Total pot $0.80 | Rake $0.04
Board [7h 8c 8h]
Seat 1: SeaofLove folded on the Flop
Seat 2: PlayTheBlues4U (button) collected ($0.76)
Seat 3: StickyChipss (small blind) folded before Flop
Seat 4: tempusfugit3737 (big blind) folded on the Flop
Seat 5: skoalguy33 folded before Flop (didn't bet)


*********** # 28 **************
PokerStars Hand #205379005243:  Hold'em No Limit ($0.05/$0.10 USD) - 2019/11/02 22:45:45 ET
Table 'Hekate' 6-max Seat #6 is the button
Seat 1: SourShoes9 ($6.84 in chips)
Seat 2: mankar.am ($4.85 in chips)
Seat 3: PlayTheBlues4U ($48.57 in chips)
Seat 4: SeaofLove ($16.09 in chips)
Seat 6: Ty1erDurrden ($14.05 in chips)
SourShoes9: posts small blind $0.05
mankar.am: posts big blind $0.10
*** HOLE CARDS ***
Dealt to PlayTheBlues4U [8d Jd]
PlayTheBlues4U: folds
SeaofLove: raises $0.15 to $0.25
Ty1erDurrden: raises $0.95 to $1.20
SourShoes9: folds
mankar.am: folds
SeaofLove: calls $0.95
*** FLOP *** [2c Ts 7c]
SeaofLove: checks
Ty1erDurrden: bets $1.82
SeaofLove: calls $1.82
*** TURN *** [2c Ts 7c] [8s]
SeaofLove: checks
Ty1erDurrden: checks
*** RIVER *** [2c Ts 7c 8s] [Th]
SeaofLove: bets $2.94
Ty1erDurrden: calls $2.94
*** SHOW DOWN ***
SeaofLove: shows [9c 9s] (two pair, Tens and Nines)
Ty1erDurrden: shows [Ks Kd] (two pair, Kings and Tens)
Ty1erDurrden collected $11.47 from pot
*** SUMMARY ***
Total pot $12.07 | Rake $0.60
Board [2c Ts 7c 8s Th]
Seat 1: SourShoes9 (small blind) folded before Flop
Seat 2: mankar.am (big blind) folded before Flop
Seat 3: PlayTheBlues4U folded before Flop (didn't bet)
Seat 4: SeaofLove showed [9c 9s] and lost with two pair, Tens and Nines
Seat 6: Ty1erDurrden (button) showed [Ks Kd] and won ($11.47) with two pair, Kings and Tens


*********** # 29 **************
PokerStars Hand #205379005070:  Hold'em No Limit ($0.05/$0.10 USD) - 2019/11/02 22:45:03 ET
Table 'Antares' 6-max Seat #1 is the button
Seat 1: SeaofLove ($10 in chips)
Seat 2: PlayTheBlues4U ($15.95 in chips)
Seat 3: StickyChipss ($13.17 in chips)
Seat 4: tempusfugit3737 ($11.91 in chips)
Seat 5: skoalguy33 ($13.54 in chips)
PlayTheBlues4U: posts small blind $0.05
StickyChipss: posts big blind $0.10
*** HOLE CARDS ***
Dealt to PlayTheBlues4U [6h 6s]
tempusfugit3737: folds
skoalguy33: folds
SeaofLove: folds
PlayTheBlues4U: calls $0.05
StickyChipss: raises $0.67 to $0.77
PlayTheBlues4U: calls $0.67
*** FLOP *** [2c 7d Ac]
PlayTheBlues4U: checks
StickyChipss: bets $1
PlayTheBlues4U: folds
Uncalled bet ($1) returned to StickyChipss
StickyChipss collected $1.46 from pot
*** SUMMARY ***
Total pot $1.54 | Rake $0.08
Board [2c 7d Ac]
Seat 1: SeaofLove (button) folded before Flop (didn't bet)
Seat 2: PlayTheBlues4U (small blind) folded on the Flop
Seat 3: StickyChipss (big blind) collected ($1.46)
Seat 4: tempusfugit3737 folded before Flop (didn't bet)
Seat 5: skoalguy33 folded before Flop (didn't bet)


*********** # 30 **************
PokerStars Hand #205379005006:  Hold'em No Limit ($0.05/$0.10 USD) - 2019/11/02 22:44:47 ET
Table 'Hekate' 6-max Seat #4 is the button
Seat 1: SourShoes9 ($10.49 in chips)
Seat 2: mankar.am ($5.30 in chips)
Seat 3: PlayTheBlues4U ($48.57 in chips)
Seat 4: SeaofLove ($12.33 in chips)
Seat 6: Ty1erDurrden ($14.10 in chips)
Ty1erDurrden: posts small blind $0.05
SourShoes9: posts big blind $0.10
*** HOLE CARDS ***
Dealt to PlayTheBlues4U [Ah 7s]
mankar.am: calls $0.10
PlayTheBlues4U: folds
SeaofLove: raises $0.35 to $0.45
Ty1erDurrden: folds
SourShoes9: calls $0.35
mankar.am: calls $0.35
*** FLOP *** [Jd Kh 5h]
SourShoes9: checks
mankar.am: checks
SeaofLove: checks
*** TURN *** [Jd Kh 5h] [4d]
SourShoes9: bets $1.30
mankar.am: folds
SeaofLove: calls $1.30
*** RIVER *** [Jd Kh 5h 4d] [Ad]
SourShoes9: bets $1.90
SeaofLove: raises $7.60 to $9.50
SourShoes9: folds
Uncalled bet ($7.60) returned to SeaofLove
SeaofLove collected $7.41 from pot
SeaofLove: doesn't show hand
*** SUMMARY ***
Total pot $7.80 | Rake $0.39
Board [Jd Kh 5h 4d Ad]
Seat 1: SourShoes9 (big blind) folded on the River
Seat 2: mankar.am folded on the Turn
Seat 3: PlayTheBlues4U folded before Flop (didn't bet)
Seat 4: SeaofLove (button) collected ($7.41)
Seat 6: Ty1erDurrden (small blind) folded before Flop


*********** # 31 **************
PokerStars Hand #205379004990:  Hold'em No Limit ($0.05/$0.10 USD) - 2019/11/02 22:44:45 ET
Table 'Antares' 6-max Seat #5 is the button
Seat 1: SeaofLove ($10 in chips)
Seat 2: PlayTheBlues4U ($16.05 in chips)
Seat 3: StickyChipss ($13.17 in chips)
Seat 4: tempusfugit3737 ($11.91 in chips)
Seat 5: skoalguy33 ($13.39 in chips)
SeaofLove: posts small blind $0.05
PlayTheBlues4U: posts big blind $0.10
*** HOLE CARDS ***
Dealt to PlayTheBlues4U [Th Jd]
StickyChipss: folds
tempusfugit3737: folds
skoalguy33: raises $0.20 to $0.30
SeaofLove: folds
PlayTheBlues4U: folds
Uncalled bet ($0.20) returned to skoalguy33
skoalguy33 collected $0.25 from pot
skoalguy33: doesn't show hand
*** SUMMARY ***
Total pot $0.25 | Rake $0
Seat 1: SeaofLove (small blind) folded before Flop
Seat 2: PlayTheBlues4U (big blind) folded before Flop
Seat 3: StickyChipss folded before Flop (didn't bet)
Seat 4: tempusfugit3737 folded before Flop (didn't bet)
Seat 5: skoalguy33 (button) collected ($0.25)


*********** # 32 **************
PokerStars Hand #205379004868:  Hold'em No Limit ($0.05/$0.10 USD) - 2019/11/02 22:44:11 ET
Table 'Antares' 6-max Seat #4 is the button
Seat 1: SeaofLove ($10 in chips)
Seat 2: PlayTheBlues4U ($14.35 in chips)
Seat 3: StickyChipss ($13.17 in chips)
Seat 4: tempusfugit3737 ($12.21 in chips)
Seat 5: skoalguy33 ($14.69 in chips)
skoalguy33: posts small blind $0.05
SeaofLove: posts big blind $0.10
*** HOLE CARDS ***
Dealt to PlayTheBlues4U [Kc Ks]
PlayTheBlues4U: raises $0.20 to $0.30
StickyChipss: folds
tempusfugit3737: calls $0.30
skoalguy33: raises $1 to $1.30
SeaofLove: folds
PlayTheBlues4U: raises $2.20 to $3.50
tempusfugit3737: folds
skoalguy33: folds
Uncalled bet ($2.20) returned to PlayTheBlues4U
PlayTheBlues4U collected $3 from pot
PlayTheBlues4U: doesn't show hand
*** SUMMARY ***
Total pot $3 | Rake $0
Seat 1: SeaofLove (big blind) folded before Flop
Seat 2: PlayTheBlues4U collected ($3)
Seat 3: StickyChipss folded before Flop (didn't bet)
Seat 4: tempusfugit3737 (button) folded before Flop
Seat 5: skoalguy33 (small blind) folded before Flop


*********** # 33 **************
PokerStars Hand #205379004821:  Hold'em No Limit ($0.05/$0.10 USD) - 2019/11/02 22:44:00 ET
Table 'Hekate' 6-max Seat #3 is the button
Seat 1: SourShoes9 ($10.49 in chips)
Seat 2: mankar.am ($7.04 in chips)
Seat 3: PlayTheBlues4U ($48.57 in chips)
Seat 4: SeaofLove ($12.38 in chips)
Seat 6: Ty1erDurrden ($12.49 in chips)
SeaofLove: posts small blind $0.05
Ty1erDurrden: posts big blind $0.10
*** HOLE CARDS ***
Dealt to PlayTheBlues4U [As 4c]
SourShoes9: folds
mankar.am: calls $0.10
PlayTheBlues4U: folds
SeaofLove: folds
Ty1erDurrden: raises $0.60 to $0.70
mankar.am: calls $0.60
*** FLOP *** [Qh 5s 8s]
Ty1erDurrden: bets $1.04
mankar.am: calls $1.04
*** TURN *** [Qh 5s 8s] [Jh]
Ty1erDurrden: bets $6.78
mankar.am: folds
Uncalled bet ($6.78) returned to Ty1erDurrden
Ty1erDurrden collected $3.35 from pot
Ty1erDurrden: doesn't show hand
*** SUMMARY ***
Total pot $3.53 | Rake $0.18
Board [Qh 5s 8s Jh]
Seat 1: SourShoes9 folded before Flop (didn't bet)
Seat 2: mankar.am folded on the Turn
Seat 3: PlayTheBlues4U (button) folded before Flop (didn't bet)
Seat 4: SeaofLove (small blind) folded before Flop
Seat 6: Ty1erDurrden (big blind) collected ($3.35)


*********** # 34 **************
PokerStars Hand #205379004804:  Hold'em No Limit ($0.05/$0.10 USD) - 2019/11/02 22:43:56 ET
Table 'Antares' 6-max Seat #3 is the button
Seat 1: SeaofLove ($10 in chips)
Seat 2: PlayTheBlues4U ($14.20 in chips)
Seat 3: StickyChipss ($13.17 in chips)
Seat 4: tempusfugit3737 ($12.26 in chips)
Seat 5: skoalguy33 ($14.79 in chips)
tempusfugit3737: posts small blind $0.05
skoalguy33: posts big blind $0.10
*** HOLE CARDS ***
Dealt to PlayTheBlues4U [6h Ah]
SeaofLove: folds
PlayTheBlues4U: raises $0.20 to $0.30
StickyChipss: folds
tempusfugit3737: folds
skoalguy33: folds
Uncalled bet ($0.20) returned to PlayTheBlues4U
PlayTheBlues4U collected $0.25 from pot
PlayTheBlues4U: doesn't show hand
*** SUMMARY ***
Total pot $0.25 | Rake $0
Seat 1: SeaofLove folded before Flop (didn't bet)
Seat 2: PlayTheBlues4U collected ($0.25)
Seat 3: StickyChipss (button) folded before Flop (didn't bet)
Seat 4: tempusfugit3737 (small blind) folded before Flop
Seat 5: skoalguy33 (big blind) folded before Flop


*********** # 35 **************
PokerStars Hand #205379004767:  Hold'em No Limit ($0.05/$0.10 USD) - 2019/11/02 22:43:47 ET
Table 'Antares' 6-max Seat #2 is the button
Seat 1: SeaofLove ($10 in chips)
Seat 2: PlayTheBlues4U ($14.20 in chips)
Seat 3: StickyChipss ($13.22 in chips)
Seat 4: tempusfugit3737 ($12.21 in chips)
Seat 5: skoalguy33 ($14.79 in chips)
StickyChipss: posts small blind $0.05
tempusfugit3737: posts big blind $0.10
*** HOLE CARDS ***
Dealt to PlayTheBlues4U [9h Kc]
skoalguy33: folds
SeaofLove: folds
PlayTheBlues4U: folds
StickyChipss: folds
Uncalled bet ($0.05) returned to tempusfugit3737
tempusfugit3737 collected $0.10 from pot
tempusfugit3737: doesn't show hand
*** SUMMARY ***
Total pot $0.10 | Rake $0
Seat 1: SeaofLove folded before Flop (didn't bet)
Seat 2: PlayTheBlues4U (button) folded before Flop (didn't bet)
Seat 3: StickyChipss (small blind) folded before Flop
Seat 4: tempusfugit3737 (big blind) collected ($0.10)
Seat 5: skoalguy33 folded before Flop (didn't bet)


*********** # 36 **************
PokerStars Hand #205379004672:  Hold'em No Limit ($0.05/$0.10 USD) - 2019/11/02 22:43:23 ET
Table 'Hekate' 6-max Seat #2 is the button
Seat 1: SourShoes9 ($11.64 in chips)
Seat 2: mankar.am ($5.86 in chips)
Seat 3: PlayTheBlues4U ($48.62 in chips)
Seat 4: SeaofLove ($12.48 in chips)
Seat 6: Ty1erDurrden ($12.49 in chips)
PlayTheBlues4U: posts small blind $0.05
SeaofLove: posts big blind $0.10
*** HOLE CARDS ***
Dealt to PlayTheBlues4U [Ks 9h]
Ty1erDurrden: folds
SourShoes9: raises $0.25 to $0.35
mankar.am: calls $0.35
PlayTheBlues4U: folds
SeaofLove: folds
*** FLOP *** [Js Ac Qc]
SourShoes9: bets $0.40
mankar.am: raises $0.40 to $0.80
SourShoes9: calls $0.40
*** TURN *** [Js Ac Qc] [4d]
SourShoes9: checks
mankar.am: bets $1.20
SourShoes9: folds
Uncalled bet ($1.20) returned to mankar.am
mankar.am collected $2.33 from pot
mankar.am: doesn't show hand
*** SUMMARY ***
Total pot $2.45 | Rake $0.12
Board [Js Ac Qc 4d]
Seat 1: SourShoes9 folded on the Turn
Seat 2: mankar.am (button) collected ($2.33)
Seat 3: PlayTheBlues4U (small blind) folded before Flop
Seat 4: SeaofLove (big blind) folded before Flop
Seat 6: Ty1erDurrden folded before Flop (didn't bet)


*********** # 37 **************
PokerStars Hand #205379004632:  Hold'em No Limit ($0.05/$0.10 USD) - 2019/11/02 22:43:14 ET
Table 'Antares' 6-max Seat #1 is the button
Seat 1: SeaofLove ($10.66 in chips)
Seat 2: PlayTheBlues4U ($14.25 in chips)
Seat 3: StickyChipss ($13.32 in chips)
Seat 4: tempusfugit3737 ($11.12 in chips)
Seat 5: skoalguy33 ($14.79 in chips)
PlayTheBlues4U: posts small blind $0.05
StickyChipss: posts big blind $0.10
*** HOLE CARDS ***
Dealt to PlayTheBlues4U [8h Ks]
tempusfugit3737: raises $0.20 to $0.30
skoalguy33: folds
SeaofLove: raises $0.75 to $1.05
PlayTheBlues4U: folds
StickyChipss: folds
tempusfugit3737: calls $0.75
*** FLOP *** [7s 2s 3s]
tempusfugit3737: bets $1.20
SeaofLove: folds
Uncalled bet ($1.20) returned to tempusfugit3737
tempusfugit3737 collected $2.14 from pot
tempusfugit3737: doesn't show hand
*** SUMMARY ***
Total pot $2.25 | Rake $0.11
Board [7s 2s 3s]
Seat 1: SeaofLove (button) folded on the Flop
Seat 2: PlayTheBlues4U (small blind) folded before Flop
Seat 3: StickyChipss (big blind) folded before Flop
Seat 4: tempusfugit3737 collected ($2.14)
Seat 5: skoalguy33 folded before Flop (didn't bet)


*********** # 38 **************
PokerStars Hand #205379004582:  Hold'em No Limit ($0.05/$0.10 USD) - 2019/11/02 22:43:02 ET
Table 'Antares' 6-max Seat #5 is the button
Seat 1: SeaofLove ($10.56 in chips)
Seat 2: PlayTheBlues4U ($14.35 in chips)
Seat 3: StickyChipss ($13.32 in chips)
Seat 4: tempusfugit3737 ($11.12 in chips)
Seat 5: skoalguy33 ($14.79 in chips)
SeaofLove: posts small blind $0.05
PlayTheBlues4U: posts big blind $0.10
*** HOLE CARDS ***
Dealt to PlayTheBlues4U [9d 3d]
StickyChipss: folds
tempusfugit3737: folds
skoalguy33: folds
SeaofLove: raises $0.20 to $0.30
PlayTheBlues4U: folds
Uncalled bet ($0.20) returned to SeaofLove
SeaofLove collected $0.20 from pot
SeaofLove: doesn't show hand
*** SUMMARY ***
Total pot $0.20 | Rake $0
Seat 1: SeaofLove (small blind) collected ($0.20)
Seat 2: PlayTheBlues4U (big blind) folded before Flop
Seat 3: StickyChipss folded before Flop (didn't bet)
Seat 4: tempusfugit3737 folded before Flop (didn't bet)
Seat 5: skoalguy33 (button) folded before Flop (didn't bet)


*********** # 39 **************
PokerStars Hand #205379004557:  Hold'em No Limit ($0.05/$0.10 USD) - 2019/11/02 22:42:56 ET
Table 'Hekate' 6-max Seat #1 is the button
Seat 1: SourShoes9 ($11.64 in chips)
Seat 2: mankar.am ($5.91 in chips)
Seat 3: PlayTheBlues4U ($48.72 in chips)
Seat 4: SeaofLove ($13.68 in chips)
Seat 6: Ty1erDurrden ($11.27 in chips)
mankar.am: posts small blind $0.05
PlayTheBlues4U: posts big blind $0.10
*** HOLE CARDS ***
Dealt to PlayTheBlues4U [7d Qc]
SeaofLove: raises $0.15 to $0.25
Ty1erDurrden: raises $0.95 to $1.20
SourShoes9: folds
mankar.am: folds
PlayTheBlues4U: folds
SeaofLove: calls $0.95
*** FLOP *** [Jc Tc As]
SeaofLove: checks
Ty1erDurrden: bets $1.82
SeaofLove: folds
Uncalled bet ($1.82) returned to Ty1erDurrden
Ty1erDurrden collected $2.42 from pot
Ty1erDurrden: doesn't show hand
*** SUMMARY ***
Total pot $2.55 | Rake $0.13
Board [Jc Tc As]
Seat 1: SourShoes9 (button) folded before Flop (didn't bet)
Seat 2: mankar.am (small blind) folded before Flop
Seat 3: PlayTheBlues4U (big blind) folded before Flop
Seat 4: SeaofLove folded on the Flop
Seat 6: Ty1erDurrden collected ($2.42)


*********** # 40 **************
PokerStars Hand #205379004510:  Hold'em No Limit ($0.05/$0.10 USD) - 2019/11/02 22:42:44 ET
Table 'Antares' 6-max Seat #4 is the button
Seat 1: SeaofLove ($10.66 in chips)
Seat 2: PlayTheBlues4U ($14.35 in chips)
Seat 3: StickyChipss ($13.32 in chips)
Seat 4: tempusfugit3737 ($10.97 in chips)
Seat 5: skoalguy33 ($14.84 in chips)
skoalguy33: posts small blind $0.05
SeaofLove: posts big blind $0.10
*** HOLE CARDS ***
Dealt to PlayTheBlues4U [4s 2h]
PlayTheBlues4U: folds
StickyChipss: folds
tempusfugit3737: raises $0.20 to $0.30
skoalguy33: folds
SeaofLove: folds
Uncalled bet ($0.20) returned to tempusfugit3737
tempusfugit3737 collected $0.25 from pot
tempusfugit3737: doesn't show hand
*** SUMMARY ***
Total pot $0.25 | Rake $0
Seat 1: SeaofLove (big blind) folded before Flop
Seat 2: PlayTheBlues4U folded before Flop (didn't bet)
Seat 3: StickyChipss folded before Flop (didn't bet)
Seat 4: tempusfugit3737 (button) collected ($0.25)
Seat 5: skoalguy33 (small blind) folded before Flop


*********** # 41 **************
PokerStars Hand #205379004393:  Hold'em No Limit ($0.05/$0.10 USD) - 2019/11/02 22:42:13 ET
Table 'Antares' 6-max Seat #3 is the button
Seat 1: SeaofLove ($10.66 in chips)
Seat 2: PlayTheBlues4U ($14.35 in chips)
Seat 3: StickyChipss ($13.32 in chips)
Seat 4: tempusfugit3737 ($10.88 in chips)
Seat 5: skoalguy33 ($14.94 in chips)
Seat 6: StarManNJ ($8.05 in chips)
tempusfugit3737: posts small blind $0.05
skoalguy33: posts big blind $0.10
*** HOLE CARDS ***
Dealt to PlayTheBlues4U [4s 9d]
StarManNJ: folds
SeaofLove: folds
StarManNJ leaves the table
PlayTheBlues4U: folds
StickyChipss: folds
tempusfugit3737: calls $0.05
skoalguy33: checks
*** FLOP *** [4h Qs 7d]
tempusfugit3737: checks
skoalguy33: checks
*** TURN *** [4h Qs 7d] [Td]
tempusfugit3737: bets $0.20
skoalguy33: folds
Uncalled bet ($0.20) returned to tempusfugit3737
tempusfugit3737 collected $0.19 from pot
tempusfugit3737: doesn't show hand
*** SUMMARY ***
Total pot $0.20 | Rake $0.01
Board [4h Qs 7d Td]
Seat 1: SeaofLove folded before Flop (didn't bet)
Seat 2: PlayTheBlues4U folded before Flop (didn't bet)
Seat 3: StickyChipss (button) folded before Flop (didn't bet)
Seat 4: tempusfugit3737 (small blind) collected ($0.19)
Seat 5: skoalguy33 (big blind) folded on the Turn
Seat 6: StarManNJ folded before Flop (didn't bet)


*********** # 42 **************
PokerStars Hand #205379004321:  Hold'em No Limit ($0.05/$0.10 USD) - 2019/11/02 22:41:55 ET
Table 'Antares' 6-max Seat #2 is the button
Seat 1: SeaofLove ($10.66 in chips)
Seat 2: PlayTheBlues4U ($14.35 in chips)
Seat 3: StickyChipss ($13.37 in chips)
Seat 4: tempusfugit3737 ($10.98 in chips)
Seat 5: skoalguy33 ($14.94 in chips)
Seat 6: StarManNJ ($7.90 in chips)
StickyChipss: posts small blind $0.05
tempusfugit3737: posts big blind $0.10
*** HOLE CARDS ***
Dealt to PlayTheBlues4U [4c 2h]
skoalguy33: folds
StarManNJ: raises $0.20 to $0.30
SeaofLove: folds
PlayTheBlues4U: folds
StickyChipss: folds
tempusfugit3737: folds
Uncalled bet ($0.20) returned to StarManNJ
StarManNJ collected $0.25 from pot
StarManNJ: doesn't show hand
*** SUMMARY ***
Total pot $0.25 | Rake $0
Seat 1: SeaofLove folded before Flop (didn't bet)
Seat 2: PlayTheBlues4U (button) folded before Flop (didn't bet)
Seat 3: StickyChipss (small blind) folded before Flop
Seat 4: tempusfugit3737 (big blind) folded before Flop
Seat 5: skoalguy33 folded before Flop (didn't bet)
Seat 6: StarManNJ collected ($0.25)


*********** # 43 **************
PokerStars Hand #205379004293:  Hold'em No Limit ($0.05/$0.10 USD) - 2019/11/02 22:41:48 ET
Table 'Hekate' 6-max Seat #6 is the button
Seat 1: SourShoes9 ($11.69 in chips)
Seat 2: mankar.am ($3.65 in chips)
Seat 3: PlayTheBlues4U ($48.72 in chips)
Seat 4: SeaofLove ($13.68 in chips)
Seat 5: StarManNJ ($7.60 in chips)
Seat 6: Ty1erDurrden ($12.84 in chips)
SourShoes9: posts small blind $0.05
mankar.am: posts big blind $0.10
*** HOLE CARDS ***
Dealt to PlayTheBlues4U [4d Tc]
PlayTheBlues4U: folds
SeaofLove: folds
StarManNJ: raises $0.10 to $0.20
Ty1erDurrden: raises $0.64 to $0.84
SourShoes9: folds
mankar.am: calls $0.74
StarManNJ: calls $0.64
*** FLOP *** [As Js 4s]
mankar.am: checks
StarManNJ: checks
Ty1erDurrden: bets $0.73
mankar.am: calls $0.73
StarManNJ: folds
*** TURN *** [As Js 4s] [4c]
StarManNJ leaves the table
mankar.am: checks
Ty1erDurrden: checks
*** RIVER *** [As Js 4s 4c] [3h]
mankar.am: checks
Ty1erDurrden: checks
*** SHOW DOWN ***
mankar.am: shows [Qs Jc] (two pair, Jacks and Fours)
Ty1erDurrden: mucks hand
mankar.am collected $3.83 from pot
*** SUMMARY ***
Total pot $4.03 | Rake $0.20
Board [As Js 4s 4c 3h]
Seat 1: SourShoes9 (small blind) folded before Flop
Seat 2: mankar.am (big blind) showed [Qs Jc] and won ($3.83) with two pair, Jacks and Fours
Seat 3: PlayTheBlues4U folded before Flop (didn't bet)
Seat 4: SeaofLove folded before Flop (didn't bet)
Seat 5: StarManNJ folded on the Flop
Seat 6: Ty1erDurrden (button) mucked [8d 7d]


*********** # 44 **************
PokerStars Hand #205379004275:  Hold'em No Limit ($0.05/$0.10 USD) - 2019/11/02 22:41:42 ET
Table 'Antares' 6-max Seat #1 is the button
Seat 1: SeaofLove ($10.66 in chips)
Seat 2: PlayTheBlues4U ($14.40 in chips)
Seat 3: StickyChipss ($13.47 in chips)
Seat 4: tempusfugit3737 ($10.73 in chips)
Seat 5: skoalguy33 ($14.94 in chips)
Seat 6: StarManNJ ($8 in chips)
PlayTheBlues4U: posts small blind $0.05
StickyChipss: posts big blind $0.10
StarManNJ: posts big blind $0.10
*** HOLE CARDS ***
Dealt to PlayTheBlues4U [8s Jd]
tempusfugit3737: raises $0.20 to $0.30
skoalguy33: folds
StarManNJ: folds
SeaofLove: folds
PlayTheBlues4U: folds
StickyChipss: folds
Uncalled bet ($0.20) returned to tempusfugit3737
tempusfugit3737 collected $0.35 from pot
tempusfugit3737: doesn't show hand
*** SUMMARY ***
Total pot $0.35 | Rake $0
Seat 1: SeaofLove (button) folded before Flop (didn't bet)
Seat 2: PlayTheBlues4U (small blind) folded before Flop
Seat 3: StickyChipss (big blind) folded before Flop
Seat 4: tempusfugit3737 collected ($0.35)
Seat 5: skoalguy33 folded before Flop (didn't bet)
Seat 6: StarManNJ folded before Flop (didn't bet)


*********** # 45 **************
PokerStars Hand #205379004179:  Hold'em No Limit ($0.05/$0.10 USD) - 2019/11/02 22:41:17 ET
Table 'Antares' 6-max Seat #5 is the button
Seat 1: SeaofLove ($10.71 in chips)
Seat 2: PlayTheBlues4U ($14.50 in chips)
Seat 3: StickyChipss ($13.77 in chips)
Seat 4: tempusfugit3737 ($10.28 in chips)
Seat 5: skoalguy33 ($14.94 in chips)
StarManNJ will be allowed to play after the button
SeaofLove: posts small blind $0.05
PlayTheBlues4U: posts big blind $0.10
*** HOLE CARDS ***
Dealt to PlayTheBlues4U [Ah Kd]
StickyChipss: raises $0.20 to $0.30
tempusfugit3737: raises $0.70 to $1
skoalguy33: folds
SeaofLove: folds
PlayTheBlues4U: folds
StickyChipss: folds
Uncalled bet ($0.70) returned to tempusfugit3737
tempusfugit3737 collected $0.75 from pot
tempusfugit3737: doesn't show hand
*** SUMMARY ***
Total pot $0.75 | Rake $0
Seat 1: SeaofLove (small blind) folded before Flop
Seat 2: PlayTheBlues4U (big blind) folded before Flop
Seat 3: StickyChipss folded before Flop
Seat 4: tempusfugit3737 collected ($0.75)
Seat 5: skoalguy33 (button) folded before Flop (didn't bet)


*********** # 46 **************
PokerStars Hand #205379004167:  Hold'em No Limit ($0.05/$0.10 USD) - 2019/11/02 22:41:14 ET
Table 'Hekate' 6-max Seat #5 is the button
Seat 1: SourShoes9 ($11.10 in chips)
Seat 2: mankar.am ($3.65 in chips)
Seat 3: PlayTheBlues4U ($48.72 in chips)
Seat 4: SeaofLove ($14.28 in chips)
Seat 5: StarManNJ ($7.60 in chips)
Seat 6: Ty1erDurrden ($12.89 in chips)
Ty1erDurrden: posts small blind $0.05
SourShoes9: posts big blind $0.10
*** HOLE CARDS ***
Dealt to PlayTheBlues4U [Kh 4c]
mankar.am: folds
PlayTheBlues4U: folds
SeaofLove: raises $0.15 to $0.25
StarManNJ: folds
Ty1erDurrden: folds
SourShoes9: calls $0.15
*** FLOP *** [5h Th 4s]
SourShoes9: checks
SeaofLove: checks
*** TURN *** [5h Th 4s] [8d]
SourShoes9: checks
SeaofLove: bets $0.35
SourShoes9: calls $0.35
*** RIVER *** [5h Th 4s 8d] [Qd]
SourShoes9: checks
SeaofLove: checks
*** SHOW DOWN ***
SourShoes9: shows [9h Qs] (a pair of Queens)
SeaofLove: mucks hand
SourShoes9 collected $1.19 from pot
*** SUMMARY ***
Total pot $1.25 | Rake $0.06
Board [5h Th 4s 8d Qd]
Seat 1: SourShoes9 (big blind) showed [9h Qs] and won ($1.19) with a pair of Queens
Seat 2: mankar.am folded before Flop (didn't bet)
Seat 3: PlayTheBlues4U folded before Flop (didn't bet)
Seat 4: SeaofLove mucked [Tc 9s]
Seat 5: StarManNJ (button) folded before Flop (didn't bet)
Seat 6: Ty1erDurrden (small blind) folded before Flop


*********** # 47 **************
PokerStars Hand #205379004001:  Hold'em No Limit ($0.05/$0.10 USD) - 2019/11/02 22:40:29 ET
Table 'Antares' 6-max Seat #4 is the button
Seat 1: SeaofLove ($10.15 in chips)
Seat 2: PlayTheBlues4U ($14.50 in chips)
Seat 3: StickyChipss ($13.77 in chips)
Seat 4: tempusfugit3737 ($10.58 in chips)
Seat 5: skoalguy33 ($15.24 in chips)
skoalguy33: posts small blind $0.05
SeaofLove: posts big blind $0.10
*** HOLE CARDS ***
Dealt to PlayTheBlues4U [2h Jd]
PlayTheBlues4U: folds
StickyChipss: folds
tempusfugit3737: raises $0.20 to $0.30
skoalguy33: calls $0.25
SeaofLove: calls $0.20
*** FLOP *** [6s Jc 4d]
StarManNJ joins the table at seat #6
skoalguy33: checks
SeaofLove: checks
tempusfugit3737: checks
*** TURN *** [6s Jc 4d] [Ts]
skoalguy33: checks
SeaofLove: bets $0.57
tempusfugit3737: folds
skoalguy33: folds
Uncalled bet ($0.57) returned to SeaofLove
SeaofLove collected $0.86 from pot
SeaofLove: doesn't show hand
*** SUMMARY ***
Total pot $0.90 | Rake $0.04
Board [6s Jc 4d Ts]
Seat 1: SeaofLove (big blind) collected ($0.86)
Seat 2: PlayTheBlues4U folded before Flop (didn't bet)
Seat 3: StickyChipss folded before Flop (didn't bet)
Seat 4: tempusfugit3737 (button) folded on the Turn
Seat 5: skoalguy33 (small blind) folded on the Turn


*********** # 48 **************
PokerStars Hand #205379003938:  Hold'em No Limit ($0.05/$0.10 USD) - 2019/11/02 22:40:16 ET
Table 'Hekate' 6-max Seat #4 is the button
Seat 1: SourShoes9 ($10 in chips)
Seat 2: mankar.am ($4.45 in chips)
Seat 3: PlayTheBlues4U ($48.72 in chips)
Seat 4: SeaofLove ($14.28 in chips)
Seat 5: StarManNJ ($7.70 in chips)
Seat 6: Ty1erDurrden ($13.19 in chips)
StarManNJ: posts small blind $0.05
Ty1erDurrden: posts big blind $0.10
*** HOLE CARDS ***
Dealt to PlayTheBlues4U [Td Kh]
SourShoes9: calls $0.10
mankar.am: calls $0.10
PlayTheBlues4U: folds
SeaofLove: folds
StarManNJ: calls $0.05
Ty1erDurrden: checks
*** FLOP *** [Ac 3d 2c]
StarManNJ: checks
Ty1erDurrden: checks
SourShoes9: bets $0.20
mankar.am: calls $0.20
StarManNJ: folds
Ty1erDurrden: calls $0.20
*** TURN *** [Ac 3d 2c] [Ts]
Ty1erDurrden: checks
SourShoes9: bets $0.50
mankar.am: calls $0.50
Ty1erDurrden: folds
*** RIVER *** [Ac 3d 2c Ts] [9d]
SourShoes9: bets $1.80
mankar.am: folds
Uncalled bet ($1.80) returned to SourShoes9
SourShoes9 collected $1.90 from pot
SourShoes9: doesn't show hand
*** SUMMARY ***
Total pot $2 | Rake $0.10
Board [Ac 3d 2c Ts 9d]
Seat 1: SourShoes9 collected ($1.90)
Seat 2: mankar.am folded on the River
Seat 3: PlayTheBlues4U folded before Flop (didn't bet)
Seat 4: SeaofLove (button) folded before Flop (didn't bet)
Seat 5: StarManNJ (small blind) folded on the Flop
Seat 6: Ty1erDurrden (big blind) folded on the Turn


*********** # 49 **************
PokerStars Hand #205379003935:  Hold'em No Limit ($0.05/$0.10 USD) - 2019/11/02 22:40:15 ET
Table 'Antares' 6-max Seat #3 is the button
Seat 1: SeaofLove ($10.15 in chips)
Seat 2: PlayTheBlues4U ($14.50 in chips)
Seat 3: StickyChipss ($13.77 in chips)
Seat 4: tempusfugit3737 ($10.63 in chips)
Seat 5: skoalguy33 ($15.19 in chips)
tempusfugit3737: posts small blind $0.05
skoalguy33: posts big blind $0.10
*** HOLE CARDS ***
Dealt to PlayTheBlues4U [8d 6s]
SeaofLove: folds
PlayTheBlues4U: folds
StickyChipss: folds
tempusfugit3737: folds
Uncalled bet ($0.05) returned to skoalguy33
skoalguy33 collected $0.10 from pot
skoalguy33: doesn't show hand
*** SUMMARY ***
Total pot $0.10 | Rake $0
Seat 1: SeaofLove folded before Flop (didn't bet)
Seat 2: PlayTheBlues4U folded before Flop (didn't bet)
Seat 3: StickyChipss (button) folded before Flop (didn't bet)
Seat 4: tempusfugit3737 (small blind) folded before Flop
Seat 5: skoalguy33 (big blind) collected ($0.10)


*********** # 50 **************
PokerStars Hand #205379003855:  Hold'em No Limit ($0.05/$0.10 USD) - 2019/11/02 22:39:54 ET
Table 'Antares' 6-max Seat #2 is the button
Seat 1: SeaofLove ($10 in chips)
Seat 2: PlayTheBlues4U ($14.50 in chips)
Seat 3: StickyChipss ($13.82 in chips)
Seat 4: tempusfugit3737 ($10.73 in chips)
Seat 5: skoalguy33 ($15.19 in chips)
StickyChipss: posts small blind $0.05
tempusfugit3737: posts big blind $0.10
*** HOLE CARDS ***
Dealt to PlayTheBlues4U [9s Qd]
skoalguy33: folds
SeaofLove: raises $0.15 to $0.25
PlayTheBlues4U: folds
StickyChipss: folds
tempusfugit3737: folds
Uncalled bet ($0.15) returned to SeaofLove
SeaofLove collected $0.25 from pot
SeaofLove: doesn't show hand
*** SUMMARY ***
Total pot $0.25 | Rake $0
Seat 1: SeaofLove collected ($0.25)
Seat 2: PlayTheBlues4U (button) folded before Flop (didn't bet)
Seat 3: StickyChipss (small blind) folded before Flop
Seat 4: tempusfugit3737 (big blind) folded before Flop
Seat 5: skoalguy33 folded before Flop (didn't bet)


*********** # 51 **************
PokerStars Hand #205379003821:  Hold'em No Limit ($0.05/$0.10 USD) - 2019/11/02 22:39:49 ET
Table 'Hekate' 6-max Seat #3 is the button
Seat 1: SourShoes9 ($10 in chips)
Seat 2: mankar.am ($4.80 in chips)
Seat 3: PlayTheBlues4U ($48.72 in chips)
Seat 4: SeaofLove ($14.33 in chips)
Seat 5: StarManNJ ($7.80 in chips)
Seat 6: Ty1erDurrden ($12.73 in chips)
SeaofLove: posts small blind $0.05
StarManNJ: posts big blind $0.10
*** HOLE CARDS ***
Dealt to PlayTheBlues4U [Jh 6h]
Ty1erDurrden: raises $0.15 to $0.25
SourShoes9: folds
mankar.am: calls $0.25
PlayTheBlues4U: folds
SeaofLove: folds
StarManNJ: folds
*** FLOP *** [Ks 4d 5h]
Ty1erDurrden: bets $0.10
mankar.am: calls $0.10
*** TURN *** [Ks 4d 5h] [As]
Ty1erDurrden: bets $0.53
mankar.am: folds
Uncalled bet ($0.53) returned to Ty1erDurrden
Ty1erDurrden collected $0.81 from pot
Ty1erDurrden: doesn't show hand
*** SUMMARY ***
Total pot $0.85 | Rake $0.04
Board [Ks 4d 5h As]
Seat 1: SourShoes9 folded before Flop (didn't bet)
Seat 2: mankar.am folded on the Turn
Seat 3: PlayTheBlues4U (button) folded before Flop (didn't bet)
Seat 4: SeaofLove (small blind) folded before Flop
Seat 5: StarManNJ (big blind) folded before Flop
Seat 6: Ty1erDurrden collected ($0.81)


*********** # 52 **************
PokerStars Hand #205379003765:  Hold'em No Limit ($0.05/$0.10 USD) - 2019/11/02 22:39:36 ET
Table 'Hekate' 6-max Seat #2 is the button
Seat 2: mankar.am ($4.80 in chips)
Seat 3: PlayTheBlues4U ($48.77 in chips)
Seat 4: SeaofLove ($14.43 in chips)
Seat 5: StarManNJ ($8 in chips)
Seat 6: Ty1erDurrden ($12.38 in chips)
PlayTheBlues4U: posts small blind $0.05
SeaofLove: posts big blind $0.10
StarManNJ: posts big blind $0.10
*** HOLE CARDS ***
Dealt to PlayTheBlues4U [2h 3c]
StarManNJ: raises $0.10 to $0.20
Ty1erDurrden: raises $0.64 to $0.84
mankar.am: folds
PlayTheBlues4U: folds
SeaofLove: folds
StarManNJ: folds
Uncalled bet ($0.64) returned to Ty1erDurrden
Ty1erDurrden collected $0.55 from pot
Ty1erDurrden: doesn't show hand
*** SUMMARY ***
Total pot $0.55 | Rake $0
Seat 2: mankar.am (button) folded before Flop (didn't bet)
Seat 3: PlayTheBlues4U (small blind) folded before Flop
Seat 4: SeaofLove (big blind) folded before Flop
Seat 5: StarManNJ folded before Flop
Seat 6: Ty1erDurrden collected ($0.55)


*********** # 53 **************
PokerStars Hand #205379003732:  Hold'em No Limit ($0.05/$0.10 USD) - 2019/11/02 22:39:28 ET
Table 'Antares' 6-max Seat #1 is the button
Seat 1: SeaofLove ($10 in chips)
Seat 2: PlayTheBlues4U ($14.55 in chips)
Seat 3: StickyChipss ($13.92 in chips)
Seat 4: tempusfugit3737 ($10.32 in chips)
Seat 5: skoalguy33 ($15.49 in chips)
PlayTheBlues4U: posts small blind $0.05
StickyChipss: posts big blind $0.10
*** HOLE CARDS ***
Dealt to PlayTheBlues4U [Ad 5s]
tempusfugit3737: raises $0.20 to $0.30
skoalguy33: calls $0.30
SeaofLove: folds
PlayTheBlues4U: folds
StickyChipss: folds
*** FLOP *** [6d 5h 6s]
tempusfugit3737: checks
skoalguy33: checks
*** TURN *** [6d 5h 6s] [9s]
tempusfugit3737: bets $0.30
skoalguy33: folds
Uncalled bet ($0.30) returned to tempusfugit3737
tempusfugit3737 collected $0.71 from pot
tempusfugit3737: doesn't show hand
*** SUMMARY ***
Total pot $0.75 | Rake $0.04
Board [6d 5h 6s 9s]
Seat 1: SeaofLove (button) folded before Flop (didn't bet)
Seat 2: PlayTheBlues4U (small blind) folded before Flop
Seat 3: StickyChipss (big blind) folded before Flop
Seat 4: tempusfugit3737 collected ($0.71)
Seat 5: skoalguy33 folded on the Turn


*********** # 54 **************
PokerStars Hand #205379003670:  Hold'em No Limit ($0.05/$0.10 USD) - 2019/11/02 22:39:15 ET
Table 'Antares' 6-max Seat #5 is the button
Seat 1: SeaofLove ($10 in chips)
Seat 2: PlayTheBlues4U ($14.50 in chips)
Seat 3: StickyChipss ($13.92 in chips)
Seat 4: tempusfugit3737 ($10.32 in chips)
Seat 5: skoalguy33 ($15.49 in chips)
SeaofLove: posts small blind $0.05
PlayTheBlues4U: posts big blind $0.10
*** HOLE CARDS ***
Dealt to PlayTheBlues4U [4c Qh]
StickyChipss: folds
StickyChipss said, "get out of here with dat"
tempusfugit3737: folds
skoalguy33: folds
SeaofLove: folds
Uncalled bet ($0.05) returned to PlayTheBlues4U
PlayTheBlues4U collected $0.10 from pot
PlayTheBlues4U: doesn't show hand
*** SUMMARY ***
Total pot $0.10 | Rake $0
Seat 1: SeaofLove (small blind) folded before Flop
Seat 2: PlayTheBlues4U (big blind) collected ($0.10)
Seat 3: StickyChipss folded before Flop (didn't bet)
Seat 4: tempusfugit3737 folded before Flop (didn't bet)
Seat 5: skoalguy33 (button) folded before Flop (didn't bet)


*********** # 55 **************
PokerStars Hand #205379003625:  Hold'em No Limit ($0.05/$0.10 USD) - 2019/11/02 22:39:06 ET
Table 'Hekate' 6-max Seat #1 is the button
Seat 1: SourShoes9 ($6.60 in chips)
Seat 2: mankar.am ($4.85 in chips)
Seat 3: PlayTheBlues4U ($42.78 in chips)
Seat 4: SeaofLove ($14.43 in chips)
Seat 6: Ty1erDurrden ($12.38 in chips)
mankar.am: posts small blind $0.05
PlayTheBlues4U: posts big blind $0.10
*** HOLE CARDS ***
Dealt to PlayTheBlues4U [Ts Tc]
SeaofLove: folds
Ty1erDurrden: folds
SourShoes9: calls $0.10
mankar.am: folds
PlayTheBlues4U: raises $0.20 to $0.30
SourShoes9: raises $6.30 to $6.60 and is all-in
StarManNJ joins the table at seat #5
PlayTheBlues4U: calls $6.30
*** FLOP *** [5d 9c 2d]
*** TURN *** [5d 9c 2d] [5h]
*** RIVER *** [5d 9c 2d 5h] [4h]
*** SHOW DOWN ***
PlayTheBlues4U: shows [Ts Tc] (two pair, Tens and Fives)
SourShoes9: shows [7h 7d] (two pair, Sevens and Fives)
PlayTheBlues4U collected $12.59 from pot
*** SUMMARY ***
Total pot $13.25 | Rake $0.66
Board [5d 9c 2d 5h 4h]
Seat 1: SourShoes9 (button) showed [7h 7d] and lost with two pair, Sevens and Fives
Seat 2: mankar.am (small blind) folded before Flop
Seat 3: PlayTheBlues4U (big blind) showed [Ts Tc] and won ($12.59) with two pair, Tens and Fives
Seat 4: SeaofLove folded before Flop (didn't bet)
Seat 6: Ty1erDurrden folded before Flop (didn't bet)


*********** # 56 **************
PokerStars Hand #205379003542:  Hold'em No Limit ($0.05/$0.10 USD) - 2019/11/02 22:38:44 ET
Table 'Antares' 6-max Seat #4 is the button
Seat 1: SeaofLove ($10 in chips)
Seat 2: PlayTheBlues4U ($14.50 in chips)
Seat 3: StickyChipss ($13.92 in chips)
Seat 4: tempusfugit3737 ($10 in chips)
Seat 5: skoalguy33 ($15.54 in chips)
skoalguy33: posts small blind $0.05
SeaofLove: posts big blind $0.10
*** HOLE CARDS ***
Dealt to PlayTheBlues4U [3s 4s]
PlayTheBlues4U: folds
StickyChipss: folds
tempusfugit3737: raises $0.20 to $0.30
skoalguy33: folds
SeaofLove: calls $0.20
*** FLOP *** [3h 4h 9d]
StickyChipss said, "Whats that little blocker bet for? lol"
SeaofLove: checks
tempusfugit3737: bets $0.40
SeaofLove: folds
Uncalled bet ($0.40) returned to tempusfugit3737
tempusfugit3737 collected $0.62 from pot
boxerpupp727 was removed from the table for failing to post
boxerpupp727 leaves the table
tempusfugit3737: doesn't show hand
*** SUMMARY ***
Total pot $0.65 | Rake $0.03
Board [3h 4h 9d]
Seat 1: SeaofLove (big blind) folded on the Flop
Seat 2: PlayTheBlues4U folded before Flop (didn't bet)
Seat 3: StickyChipss folded before Flop (didn't bet)
Seat 4: tempusfugit3737 (button) collected ($0.62)
Seat 5: skoalguy33 (small blind) folded before Flop


*********** # 57 **************
PokerStars Hand #205379003487:  Hold'em No Limit ($0.05/$0.10 USD) - 2019/11/02 22:38:29 ET
Table 'Hekate' 6-max Seat #6 is the button
Seat 1: SourShoes9 ($6.65 in chips)
Seat 2: mankar.am ($5.90 in chips)
Seat 3: PlayTheBlues4U ($42.78 in chips)
Seat 4: SeaofLove ($14.43 in chips)
Seat 6: Ty1erDurrden ($11.39 in chips)
SourShoes9: posts small blind $0.05
mankar.am: posts big blind $0.10
*** HOLE CARDS ***
Dealt to PlayTheBlues4U [Jh 5h]
PlayTheBlues4U: folds
SeaofLove: folds
Ty1erDurrden: raises $0.15 to $0.25
SourShoes9: folds
mankar.am: calls $0.15
*** FLOP *** [Js Ad 5c]
mankar.am: checks
Ty1erDurrden: checks
*** TURN *** [Js Ad 5c] [3s]
mankar.am: bets $0.30
Ty1erDurrden: calls $0.30
*** RIVER *** [Js Ad 5c 3s] [Ks]
mankar.am: bets $0.50
Ty1erDurrden: calls $0.50
*** SHOW DOWN ***
mankar.am: shows [7c Ts] (high card Ace)
Ty1erDurrden: shows [Kd Kh] (three of a kind, Kings)
Ty1erDurrden collected $2.04 from pot
*** SUMMARY ***
Total pot $2.15 | Rake $0.11
Board [Js Ad 5c 3s Ks]
Seat 1: SourShoes9 (small blind) folded before Flop
Seat 2: mankar.am (big blind) showed [7c Ts] and lost with high card Ace
Seat 3: PlayTheBlues4U folded before Flop (didn't bet)
Seat 4: SeaofLove folded before Flop (didn't bet)
Seat 6: Ty1erDurrden (button) showed [Kd Kh] and won ($2.04) with three of a kind, Kings


*********** # 58 **************
PokerStars Hand #205379003406:  Hold'em No Limit ($0.05/$0.10 USD) - 2019/11/02 22:38:07 ET
Table 'Hekate' 6-max Seat #4 is the button
Seat 1: SourShoes9 ($7.10 in chips)
Seat 2: mankar.am ($6.35 in chips)
Seat 3: PlayTheBlues4U ($42.78 in chips)
Seat 4: SeaofLove ($14.43 in chips)
Seat 6: Ty1erDurrden ($10.56 in chips)
Ty1erDurrden: posts small blind $0.05
SourShoes9: posts big blind $0.10
*** HOLE CARDS ***
Dealt to PlayTheBlues4U [3h 4d]
mankar.am: calls $0.10
PlayTheBlues4U: folds
SeaofLove: folds
Ty1erDurrden: raises $0.35 to $0.45
SourShoes9: calls $0.35
mankar.am: calls $0.35
*** FLOP *** [5s 3s Kd]
Ty1erDurrden: checks
SourShoes9: checks
mankar.am: checks
*** TURN *** [5s 3s Kd] [8h]
Ty1erDurrden: bets $0.90
SourShoes9: folds
mankar.am: folds
Uncalled bet ($0.90) returned to Ty1erDurrden
Ty1erDurrden collected $1.28 from pot
Ty1erDurrden: doesn't show hand
*** SUMMARY ***
Total pot $1.35 | Rake $0.07
Board [5s 3s Kd 8h]
Seat 1: SourShoes9 (big blind) folded on the Turn
Seat 2: mankar.am folded on the Turn
Seat 3: PlayTheBlues4U folded before Flop (didn't bet)
Seat 4: SeaofLove (button) folded before Flop (didn't bet)
Seat 6: Ty1erDurrden (small blind) collected ($1.28)


*********** # 59 **************
PokerStars Hand #205379003283:  Hold'em No Limit ($0.05/$0.10 USD) - 2019/11/02 22:37:37 ET
Table 'Hekate' 6-max Seat #3 is the button
Seat 1: SourShoes9 ($7.10 in chips)
Seat 2: mankar.am ($10.85 in chips)
Seat 3: PlayTheBlues4U ($42.78 in chips)
Seat 4: SeaofLove ($10.29 in chips)
Seat 5: doodooeater ($10.64 in chips)
Seat 6: Ty1erDurrden ($10.56 in chips)
SeaofLove: posts small blind $0.05
doodooeater: posts big blind $0.10
*** HOLE CARDS ***
Dealt to PlayTheBlues4U [Kh 5s]
Ty1erDurrden: folds
SourShoes9: folds
mankar.am: raises $0.10 to $0.20
PlayTheBlues4U: folds
SeaofLove: raises $0.50 to $0.70
doodooeater: folds
mankar.am: calls $0.50
*** FLOP *** [As 3c 4c]
SeaofLove: bets $0.80
mankar.am: raises $0.80 to $1.60
SeaofLove: calls $0.80
*** TURN *** [As 3c 4c] [2s]
doodooeater leaves the table
SeaofLove: checks
mankar.am: bets $2.20
SeaofLove: calls $2.20
*** RIVER *** [As 3c 4c 2s] [9c]
SeaofLove: checks
mankar.am: checks
*** SHOW DOWN ***
SeaofLove: shows [Ah Qh] (a pair of Aces)
mankar.am: mucks hand
SeaofLove collected $8.64 from pot
*** SUMMARY ***
Total pot $9.10 | Rake $0.46
Board [As 3c 4c 2s 9c]
Seat 1: SourShoes9 folded before Flop (didn't bet)
Seat 2: mankar.am mucked [Qs Jd]
Seat 3: PlayTheBlues4U (button) folded before Flop (didn't bet)
Seat 4: SeaofLove (small blind) showed [Ah Qh] and won ($8.64) with a pair of Aces
Seat 5: doodooeater (big blind) folded before Flop
Seat 6: Ty1erDurrden folded before Flop (didn't bet)


*********** # 60 **************
PokerStars Hand #205379003221:  Hold'em No Limit ($0.05/$0.10 USD) - 2019/11/02 22:37:22 ET
Table 'Antares' 6-max Seat #3 is the button
Seat 1: SeaofLove ($10 in chips)
Seat 2: PlayTheBlues4U ($14.50 in chips)
Seat 3: StickyChipss ($11.32 in chips)
Seat 4: tempusfugit3737 ($10.35 in chips)
Seat 5: skoalguy33 ($15.64 in chips)
tempusfugit3737: posts small blind $0.05
skoalguy33: posts big blind $0.10
*** HOLE CARDS ***
Dealt to PlayTheBlues4U [6h 5d]
SeaofLove: folds
PlayTheBlues4U: folds
StickyChipss: raises $0.20 to $0.30
tempusfugit3737: calls $0.25
skoalguy33: folds
*** FLOP *** [4s Js 7c]
tempusfugit3737: checks
StickyChipss: bets $0.44
tempusfugit3737: raises $0.54 to $0.98
StickyChipss: calls $0.54
*** TURN *** [4s Js 7c] [Tc]
tempusfugit3737: bets $1.50
StickyChipss: raises $8.54 to $10.04 and is all-in
tempusfugit3737: folds
Uncalled bet ($8.54) returned to StickyChipss
StickyChipss collected $5.38 from pot
*** SUMMARY ***
Total pot $5.66 | Rake $0.28
Board [4s Js 7c Tc]
Seat 1: SeaofLove folded before Flop (didn't bet)
Seat 2: PlayTheBlues4U folded before Flop (didn't bet)
Seat 3: StickyChipss (button) collected ($5.38)
Seat 4: tempusfugit3737 (small blind) folded on the Turn
Seat 5: skoalguy33 (big blind) folded before Flop


*********** # 61 **************
PokerStars Hand #205379003143:  Hold'em No Limit ($0.05/$0.10 USD) - 2019/11/02 22:37:04 ET
Table 'Antares' 6-max Seat #2 is the button
Seat 1: SeaofLove ($10 in chips)
Seat 2: PlayTheBlues4U ($14.50 in chips)
Seat 3: StickyChipss ($11.37 in chips)
Seat 4: tempusfugit3737 ($10.30 in chips)
Seat 5: skoalguy33 ($15.64 in chips)
StickyChipss: posts small blind $0.05
tempusfugit3737: posts big blind $0.10
*** HOLE CARDS ***
Dealt to PlayTheBlues4U [Jd 4c]
skoalguy33: folds
SeaofLove: folds
PlayTheBlues4U: folds
StickyChipss: folds
Uncalled bet ($0.05) returned to tempusfugit3737
tempusfugit3737 collected $0.10 from pot
tempusfugit3737: doesn't show hand
*** SUMMARY ***
Total pot $0.10 | Rake $0
Seat 1: SeaofLove folded before Flop (didn't bet)
Seat 2: PlayTheBlues4U (button) folded before Flop (didn't bet)
Seat 3: StickyChipss (small blind) folded before Flop
Seat 4: tempusfugit3737 (big blind) collected ($0.10)
Seat 5: skoalguy33 folded before Flop (didn't bet)


*********** # 62 **************
PokerStars Hand #205379003135:  Hold'em No Limit ($0.05/$0.10 USD) - 2019/11/02 22:37:02 ET
Table 'Hekate' 6-max Seat #2 is the button
Seat 1: SourShoes9 ($7.35 in chips)
Seat 2: mankar.am ($10.79 in chips)
Seat 3: PlayTheBlues4U ($42.83 in chips)
Seat 4: SeaofLove ($10.39 in chips)
Seat 5: doodooeater ($10.64 in chips)
Seat 6: Ty1erDurrden ($10.50 in chips)
PlayTheBlues4U: posts small blind $0.05
SeaofLove: posts big blind $0.10
*** HOLE CARDS ***
Dealt to PlayTheBlues4U [9h 3c]
doodooeater: folds
Ty1erDurrden: raises $0.15 to $0.25
SourShoes9: calls $0.25
mankar.am: calls $0.25
PlayTheBlues4U: folds
SeaofLove: folds
*** FLOP *** [2h As 7c]
Ty1erDurrden: checks
SourShoes9: checks
mankar.am: checks
*** TURN *** [2h As 7c] [Kc]
Ty1erDurrden: bets $0.50
SourShoes9: folds
mankar.am: raises $0.50 to $1
Ty1erDurrden: calls $0.50
*** RIVER *** [2h As 7c Kc] [7s]
Ty1erDurrden: checks
mankar.am: bets $1.40
Ty1erDurrden: calls $1.40
*** SHOW DOWN ***
mankar.am: shows [2c Ad] (two pair, Aces and Sevens)
Ty1erDurrden: shows [Ah Ts] (two pair, Aces and Sevens)
Ty1erDurrden collected $2.71 from pot
mankar.am collected $2.71 from pot
*** SUMMARY ***
Total pot $5.70 | Rake $0.28
Board [2h As 7c Kc 7s]
Seat 1: SourShoes9 folded on the Turn
Seat 2: mankar.am (button) showed [2c Ad] and won ($2.71) with two pair, Aces and Sevens
Seat 3: PlayTheBlues4U (small blind) folded before Flop
Seat 4: SeaofLove (big blind) folded before Flop
Seat 5: doodooeater folded before Flop (didn't bet)
Seat 6: Ty1erDurrden showed [Ah Ts] and won ($2.71) with two pair, Aces and Sevens


*********** # 63 **************
PokerStars Hand #205379003096:  Hold'em No Limit ($0.05/$0.10 USD) - 2019/11/02 22:36:52 ET
Table 'Antares' 6-max Seat #1 is the button
Seat 1: SeaofLove ($10 in chips)
Seat 2: PlayTheBlues4U ($14.55 in chips)
Seat 3: StickyChipss ($11.47 in chips)
Seat 4: tempusfugit3737 ($10.15 in chips)
Seat 5: skoalguy33 ($15.64 in chips)
PlayTheBlues4U: posts small blind $0.05
StickyChipss: posts big blind $0.10
*** HOLE CARDS ***
Dealt to PlayTheBlues4U [4c Ad]
tempusfugit3737: raises $0.20 to $0.30
skoalguy33: folds
SeaofLove: folds
PlayTheBlues4U: folds
StickyChipss: folds
Uncalled bet ($0.20) returned to tempusfugit3737
tempusfugit3737 collected $0.25 from pot
tempusfugit3737: doesn't show hand
*** SUMMARY ***
Total pot $0.25 | Rake $0
Seat 1: SeaofLove (button) folded before Flop (didn't bet)
Seat 2: PlayTheBlues4U (small blind) folded before Flop
Seat 3: StickyChipss (big blind) folded before Flop
Seat 4: tempusfugit3737 collected ($0.25)
Seat 5: skoalguy33 folded before Flop (didn't bet)


*********** # 64 **************
PokerStars Hand #205379003029:  Hold'em No Limit ($0.05/$0.10 USD) - 2019/11/02 22:36:34 ET
Table 'Antares' 6-max Seat #5 is the button
Seat 1: SeaofLove ($10.05 in chips)
Seat 2: PlayTheBlues4U ($14.65 in chips)
Seat 3: StickyChipss ($11.77 in chips)
Seat 4: tempusfugit3737 ($10.15 in chips)
Seat 5: skoalguy33 ($15.19 in chips)
SeaofLove: posts small blind $0.05
PlayTheBlues4U: posts big blind $0.10
*** HOLE CARDS ***
Dealt to PlayTheBlues4U [Qs 8h]
StickyChipss: raises $0.20 to $0.30
tempusfugit3737: folds
skoalguy33: raises $0.75 to $1.05
SeaofLove: folds
PlayTheBlues4U: folds
StickyChipss: folds
Uncalled bet ($0.75) returned to skoalguy33
skoalguy33 collected $0.75 from pot
skoalguy33: doesn't show hand
*** SUMMARY ***
Total pot $0.75 | Rake $0
Seat 1: SeaofLove (small blind) folded before Flop
Seat 2: PlayTheBlues4U (big blind) folded before Flop
Seat 3: StickyChipss folded before Flop
Seat 4: tempusfugit3737 folded before Flop (didn't bet)
Seat 5: skoalguy33 (button) collected ($0.75)


*********** # 65 **************
PokerStars Hand #205379003025:  Hold'em No Limit ($0.05/$0.10 USD) - 2019/11/02 22:36:33 ET
Table 'Hekate' 6-max Seat #1 is the button
Seat 1: SourShoes9 ($7.35 in chips)
Seat 2: mankar.am ($11.39 in chips)
Seat 3: PlayTheBlues4U ($42.93 in chips)
Seat 4: SeaofLove ($10.39 in chips)
Seat 5: doodooeater ($10 in chips)
Seat 6: Ty1erDurrden ($10.50 in chips)
mankar.am: posts small blind $0.05
PlayTheBlues4U: posts big blind $0.10
*** HOLE CARDS ***
Dealt to PlayTheBlues4U [Kc 3h]
SeaofLove: folds
doodooeater: raises $0.20 to $0.30
Ty1erDurrden: folds
SourShoes9: folds
mankar.am: calls $0.25
PlayTheBlues4U: folds
*** FLOP *** [3d Ad 4h]
mankar.am: checks
doodooeater: checks
*** TURN *** [3d Ad 4h] [Qh]
mankar.am: bets $0.30
doodooeater: raises $0.95 to $1.25
mankar.am: folds
Uncalled bet ($0.95) returned to doodooeater
doodooeater collected $1.24 from pot
*** SUMMARY ***
Total pot $1.30 | Rake $0.06
Board [3d Ad 4h Qh]
Seat 1: SourShoes9 (button) folded before Flop (didn't bet)
Seat 2: mankar.am (small blind) folded on the Turn
Seat 3: PlayTheBlues4U (big blind) folded before Flop
Seat 4: SeaofLove folded before Flop (didn't bet)
Seat 5: doodooeater collected ($1.24)
Seat 6: Ty1erDurrden folded before Flop (didn't bet)


*********** # 66 **************
PokerStars Hand #205379002947:  Hold'em No Limit ($0.05/$0.10 USD) - 2019/11/02 22:36:16 ET
Table 'Antares' 6-max Seat #4 is the button
Seat 1: SeaofLove ($10.15 in chips)
Seat 2: PlayTheBlues4U ($14.65 in chips)
Seat 3: StickyChipss ($11.77 in chips)
Seat 4: tempusfugit3737 ($10 in chips)
Seat 5: skoalguy33 ($15.24 in chips)
skoalguy33: posts small blind $0.05
SeaofLove: posts big blind $0.10
*** HOLE CARDS ***
Dealt to PlayTheBlues4U [5d Ac]
PlayTheBlues4U: folds
StickyChipss: folds
tempusfugit3737: raises $0.20 to $0.30
skoalguy33: folds
SeaofLove: folds
Uncalled bet ($0.20) returned to tempusfugit3737
tempusfugit3737 collected $0.25 from pot
tempusfugit3737: doesn't show hand
*** SUMMARY ***
Total pot $0.25 | Rake $0
Seat 1: SeaofLove (big blind) folded before Flop
Seat 2: PlayTheBlues4U folded before Flop (didn't bet)
Seat 3: StickyChipss folded before Flop (didn't bet)
Seat 4: tempusfugit3737 (button) collected ($0.25)
Seat 5: skoalguy33 (small blind) folded before Flop


*********** # 67 **************
PokerStars Hand #205379002911:  Hold'em No Limit ($0.05/$0.10 USD) - 2019/11/02 22:36:05 ET
Table 'Hekate' 6-max Seat #6 is the button
Seat 1: SourShoes9 ($7.55 in chips)
Seat 2: mankar.am ($11.21 in chips)
Seat 3: PlayTheBlues4U ($42.93 in chips)
Seat 4: SeaofLove ($10.39 in chips)
Seat 5: doodooeater ($10 in chips)
Seat 6: Ty1erDurrden ($10.50 in chips)
SourShoes9: posts small blind $0.05
mankar.am: posts big blind $0.10
*** HOLE CARDS ***
Dealt to PlayTheBlues4U [9d 3c]
PlayTheBlues4U: folds
SeaofLove: folds
doodooeater: folds
Ty1erDurrden: folds
SourShoes9: calls $0.05
mankar.am: raises $0.10 to $0.20
SourShoes9: calls $0.10
*** FLOP *** [8s Js 2h]
SourShoes9: checks
mankar.am: bets $0.20
SourShoes9: folds
Uncalled bet ($0.20) returned to mankar.am
mankar.am collected $0.38 from pot
*** SUMMARY ***
Total pot $0.40 | Rake $0.02
Board [8s Js 2h]
Seat 1: SourShoes9 (small blind) folded on the Flop
Seat 2: mankar.am (big blind) collected ($0.38)
Seat 3: PlayTheBlues4U folded before Flop (didn't bet)
Seat 4: SeaofLove folded before Flop (didn't bet)
Seat 5: doodooeater folded before Flop (didn't bet)
Seat 6: Ty1erDurrden (button) folded before Flop (didn't bet)


*********** # 68 **************
PokerStars Hand #205379002893:  Hold'em No Limit ($0.05/$0.10 USD) - 2019/11/02 22:36:00 ET
Table 'Antares' 6-max Seat #3 is the button
Seat 1: SeaofLove ($10 in chips)
Seat 2: PlayTheBlues4U ($14.65 in chips)
Seat 3: StickyChipss ($11.77 in chips)
Seat 4: tempusfugit3737 ($10.05 in chips)
Seat 5: skoalguy33 ($15.34 in chips)
tempusfugit3737: posts small blind $0.05
skoalguy33: posts big blind $0.10
*** HOLE CARDS ***
Dealt to PlayTheBlues4U [4c 9c]
SeaofLove: raises $0.15 to $0.25
PlayTheBlues4U: folds
StickyChipss: folds
tempusfugit3737: folds
skoalguy33: folds
Uncalled bet ($0.15) returned to SeaofLove
SeaofLove collected $0.25 from pot
SeaofLove: doesn't show hand
*** SUMMARY ***
Total pot $0.25 | Rake $0
Seat 1: SeaofLove collected ($0.25)
Seat 2: PlayTheBlues4U folded before Flop (didn't bet)
Seat 3: StickyChipss (button) folded before Flop (didn't bet)
Seat 4: tempusfugit3737 (small blind) folded before Flop
Seat 5: skoalguy33 (big blind) folded before Flop


*********** # 69 **************
PokerStars Hand #205379002852:  Hold'em No Limit ($0.05/$0.10 USD) - 2019/11/02 22:35:50 ET
Table 'Antares' 6-max Seat #2 is the button
Seat 1: SeaofLove ($10 in chips)
Seat 2: PlayTheBlues4U ($14.65 in chips)
Seat 3: StickyChipss ($11.82 in chips)
Seat 4: tempusfugit3737 ($10 in chips)
Seat 5: skoalguy33 ($15.34 in chips)
StickyChipss: posts small blind $0.05
tempusfugit3737: posts big blind $0.10
*** HOLE CARDS ***
Dealt to PlayTheBlues4U [4s Ah]
skoalguy33: folds
SeaofLove: folds
PlayTheBlues4U: folds
StickyChipss: folds
Uncalled bet ($0.05) returned to tempusfugit3737
tempusfugit3737 collected $0.10 from pot
tempusfugit3737: doesn't show hand
*** SUMMARY ***
Total pot $0.10 | Rake $0
Seat 1: SeaofLove folded before Flop (didn't bet)
Seat 2: PlayTheBlues4U (button) folded before Flop (didn't bet)
Seat 3: StickyChipss (small blind) folded before Flop
Seat 4: tempusfugit3737 (big blind) collected ($0.10)
Seat 5: skoalguy33 folded before Flop (didn't bet)


*********** # 70 **************
PokerStars Hand #205379002762:  Hold'em No Limit ($0.05/$0.10 USD) - 2019/11/02 22:35:26 ET
Table 'Hekate' 6-max Seat #5 is the button
Seat 1: SourShoes9 ($7.85 in chips)
Seat 2: mankar.am ($11.21 in chips)
Seat 3: PlayTheBlues4U ($42.61 in chips)
Seat 4: SeaofLove ($10.39 in chips)
Seat 5: doodooeater ($10 in chips)
Seat 6: Ty1erDurrden ($10.55 in chips)
Ty1erDurrden: posts small blind $0.05
SourShoes9: posts big blind $0.10
*** HOLE CARDS ***
Dealt to PlayTheBlues4U [As Jc]
mankar.am: folds
PlayTheBlues4U: raises $0.20 to $0.30
SeaofLove: folds
doodooeater: folds
Ty1erDurrden: folds
SourShoes9: calls $0.20
*** FLOP *** [3d 7s Ks]
SourShoes9: checks
PlayTheBlues4U: checks
*** TURN *** [3d 7s Ks] [Kc]
SourShoes9: checks
PlayTheBlues4U: checks
*** RIVER *** [3d 7s Ks Kc] [9h]
SourShoes9: checks
PlayTheBlues4U: checks
*** SHOW DOWN ***
SourShoes9: shows [4d 6c] (a pair of Kings)
PlayTheBlues4U: shows [As Jc] (a pair of Kings - Ace kicker)
PlayTheBlues4U collected $0.62 from pot
*** SUMMARY ***
Total pot $0.65 | Rake $0.03
Board [3d 7s Ks Kc 9h]
Seat 1: SourShoes9 (big blind) showed [4d 6c] and lost with a pair of Kings
Seat 2: mankar.am folded before Flop (didn't bet)
Seat 3: PlayTheBlues4U showed [As Jc] and won ($0.62) with a pair of Kings
Seat 4: SeaofLove folded before Flop (didn't bet)
Seat 5: doodooeater (button) folded before Flop (didn't bet)
Seat 6: Ty1erDurrden (small blind) folded before Flop


*********** # 71 **************
PokerStars Hand #205379002689:  Hold'em No Limit ($0.05/$0.10 USD) - 2019/11/02 22:35:06 ET
Table 'Hekate' 6-max Seat #4 is the button
Seat 1: SourShoes9 ($8.05 in chips)
Seat 2: mankar.am ($10.89 in chips)
Seat 3: PlayTheBlues4U ($42.61 in chips)
Seat 4: SeaofLove ($10.39 in chips)
Seat 5: doodooeater ($10 in chips)
Seat 6: Ty1erDurrden ($10.65 in chips)
doodooeater: posts small blind $0.05
Ty1erDurrden: posts big blind $0.10
*** HOLE CARDS ***
Dealt to PlayTheBlues4U [6d 9c]
SourShoes9: calls $0.10
mankar.am: raises $0.10 to $0.20
PlayTheBlues4U: folds
SeaofLove: folds
doodooeater: folds
Ty1erDurrden: folds
SourShoes9: calls $0.10
*** FLOP *** [7s 6s Td]
SourShoes9: checks
mankar.am: bets $0.30
SourShoes9: folds
Uncalled bet ($0.30) returned to mankar.am
mankar.am collected $0.52 from pot
*** SUMMARY ***
Total pot $0.55 | Rake $0.03
Board [7s 6s Td]
Seat 1: SourShoes9 folded on the Flop
Seat 2: mankar.am collected ($0.52)
Seat 3: PlayTheBlues4U folded before Flop (didn't bet)
Seat 4: SeaofLove (button) folded before Flop (didn't bet)
Seat 5: doodooeater (small blind) folded before Flop
Seat 6: Ty1erDurrden (big blind) folded before Flop


*********** # 72 **************
PokerStars Hand #205379002619:  Hold'em No Limit ($0.05/$0.10 USD) - 2019/11/02 22:34:47 ET
Table 'Antares' 6-max Seat #1 is the button
Seat 1: SeaofLove ($12.53 in chips)
Seat 2: PlayTheBlues4U ($14.70 in chips)
Seat 3: StickyChipss ($11.92 in chips)
Seat 4: tempusfugit3737 ($10 in chips)
Seat 5: skoalguy33 ($8 in chips)
PlayTheBlues4U: posts small blind $0.05
StickyChipss: posts big blind $0.10
*** HOLE CARDS ***
Dealt to PlayTheBlues4U [Ts Tc]
tempusfugit3737 has timed out
tempusfugit3737: folds
skoalguy33: raises $0.20 to $0.30
SeaofLove: raises $0.75 to $1.05
PlayTheBlues4U: folds
StickyChipss: folds
skoalguy33: calls $0.75
*** FLOP *** [Th 9h 6c]
skoalguy33: checks
SeaofLove: bets $1.43
skoalguy33: calls $1.43
*** TURN *** [Th 9h 6c] [4h]
skoalguy33: checks
SeaofLove: bets $3.23
skoalguy33: raises $2.29 to $5.52 and is all-in
SeaofLove: calls $2.29
*** RIVER *** [Th 9h 6c 4h] [As]
*** SHOW DOWN ***
skoalguy33: shows [Qh Kh] (a flush, King high)
SeaofLove: shows [9d 9c] (three of a kind, Nines)
skoalguy33 collected $15.34 from pot
*** SUMMARY ***
Total pot $16.15 | Rake $0.81
Board [Th 9h 6c 4h As]
Seat 1: SeaofLove (button) showed [9d 9c] and lost with three of a kind, Nines
Seat 2: PlayTheBlues4U (small blind) folded before Flop
Seat 3: StickyChipss (big blind) folded before Flop
Seat 4: tempusfugit3737 folded before Flop (didn't bet)
Seat 5: skoalguy33 showed [Qh Kh] and won ($15.34) with a flush, King high


*********** # 73 **************
PokerStars Hand #205379002570:  Hold'em No Limit ($0.05/$0.10 USD) - 2019/11/02 22:34:33 ET
Table 'Hekate' 6-max Seat #3 is the button
Seat 1: SourShoes9 ($9.90 in chips)
Seat 2: mankar.am ($8.28 in chips)
Seat 3: PlayTheBlues4U ($42.61 in chips)
Seat 4: SeaofLove ($11.29 in chips)
Seat 5: doodooeater ($10 in chips)
Seat 6: Ty1erDurrden ($10.65 in chips)
SeaofLove: posts small blind $0.05
doodooeater: posts big blind $0.10
*** HOLE CARDS ***
Dealt to PlayTheBlues4U [7s Js]
Ty1erDurrden: folds
SourShoes9: raises $0.25 to $0.35
mankar.am: calls $0.35
PlayTheBlues4U: folds
SeaofLove: calls $0.30
doodooeater: folds
*** FLOP *** [7d 2d 2c]
SeaofLove: bets $0.55
SourShoes9: raises $0.95 to $1.50
mankar.am: raises $0.95 to $2.45
SeaofLove: folds
SourShoes9: folds
Uncalled bet ($0.95) returned to mankar.am
mankar.am collected $4.46 from pot
*** SUMMARY ***
Total pot $4.70 | Rake $0.24
Board [7d 2d 2c]
Seat 1: SourShoes9 folded on the Flop
Seat 2: mankar.am collected ($4.46)
Seat 3: PlayTheBlues4U (button) folded before Flop (didn't bet)
Seat 4: SeaofLove (small blind) folded on the Flop
Seat 5: doodooeater (big blind) folded before Flop
Seat 6: Ty1erDurrden folded before Flop (didn't bet)


*********** # 74 **************
PokerStars Hand #205379002548:  Hold'em No Limit ($0.05/$0.10 USD) - 2019/11/02 22:34:28 ET
Table 'Antares' 6-max Seat #5 is the button
Seat 1: SeaofLove ($12.58 in chips)
Seat 2: PlayTheBlues4U ($14.80 in chips)
Seat 3: StickyChipss ($11.92 in chips)
Seat 4: tempusfugit3737 ($9 in chips)
Seat 5: skoalguy33 ($7.85 in chips)
SeaofLove: posts small blind $0.05
PlayTheBlues4U: posts big blind $0.10
*** HOLE CARDS ***
Dealt to PlayTheBlues4U [6c Ad]
StickyChipss: folds
tempusfugit3737: folds
skoalguy33: raises $0.20 to $0.30
SeaofLove: folds
PlayTheBlues4U: folds
Uncalled bet ($0.20) returned to skoalguy33
skoalguy33 collected $0.25 from pot
skoalguy33: doesn't show hand
*** SUMMARY ***
Total pot $0.25 | Rake $0
Seat 1: SeaofLove (small blind) folded before Flop
Seat 2: PlayTheBlues4U (big blind) folded before Flop
Seat 3: StickyChipss folded before Flop (didn't bet)
Seat 4: tempusfugit3737 folded before Flop (didn't bet)
Seat 5: skoalguy33 (button) collected ($0.25)


*********** # 75 **************
PokerStars Hand #205379002466:  Hold'em No Limit ($0.05/$0.10 USD) - 2019/11/02 22:34:07 ET
Table 'Hekate' 6-max Seat #2 is the button
Seat 1: SourShoes9 ($10 in chips)
Seat 2: mankar.am ($8.05 in chips)
Seat 3: PlayTheBlues4U ($42.66 in chips)
Seat 4: SeaofLove ($11.39 in chips)
Seat 5: doodooeater ($10 in chips)
Seat 6: Ty1erDurrden ($10.65 in chips)
PlayTheBlues4U: posts small blind $0.05
SeaofLove: posts big blind $0.10
SourShoes9: posts big blind $0.10
*** HOLE CARDS ***
Dealt to PlayTheBlues4U [6s Qh]
doodooeater: folds
Ty1erDurrden: folds
SourShoes9: checks
mankar.am: calls $0.10
PlayTheBlues4U: folds
SeaofLove: checks
*** FLOP *** [9d 5c 8d]
SeaofLove: checks
SourShoes9: checks
mankar.am: bets $0.20
SeaofLove: folds
SourShoes9: folds
Uncalled bet ($0.20) returned to mankar.am
mankar.am collected $0.33 from pot
mankar.am: doesn't show hand
*** SUMMARY ***
Total pot $0.35 | Rake $0.02
Board [9d 5c 8d]
Seat 1: SourShoes9 folded on the Flop (didn't bet)
Seat 2: mankar.am (button) collected ($0.33)
Seat 3: PlayTheBlues4U (small blind) folded before Flop
Seat 4: SeaofLove (big blind) folded on the Flop
Seat 5: doodooeater folded before Flop (didn't bet)
Seat 6: Ty1erDurrden folded before Flop (didn't bet)


*********** # 76 **************
PokerStars Hand #205379002413:  Hold'em No Limit ($0.05/$0.10 USD) - 2019/11/02 22:33:51 ET
Table 'Hekate' 6-max Seat #6 is the button
Seat 2: mankar.am ($8.10 in chips)
Seat 3: PlayTheBlues4U ($42.76 in chips)
Seat 4: SeaofLove ($11.39 in chips)
Seat 5: doodooeater ($10 in chips)
Seat 6: Ty1erDurrden ($10.40 in chips)
mankar.am: posts small blind $0.05
PlayTheBlues4U: posts big blind $0.10
doodooeater: posts big blind $0.10
*** HOLE CARDS ***
Dealt to PlayTheBlues4U [9h 2c]
SeaofLove: folds
doodooeater: checks
SourShoes9 joins the table at seat #1
Ty1erDurrden: raises $0.35 to $0.45
mankar.am: folds
PlayTheBlues4U: folds
doodooeater: folds
Uncalled bet ($0.35) returned to Ty1erDurrden
Ty1erDurrden collected $0.35 from pot
Ty1erDurrden: doesn't show hand
*** SUMMARY ***
Total pot $0.35 | Rake $0
Seat 2: mankar.am (small blind) folded before Flop
Seat 3: PlayTheBlues4U (big blind) folded before Flop
Seat 4: SeaofLove folded before Flop (didn't bet)
Seat 5: doodooeater folded before Flop (didn't bet)
Seat 6: Ty1erDurrden (button) collected ($0.35)


*********** # 77 **************
PokerStars Hand #205379002352:  Hold'em No Limit ($0.05/$0.10 USD) - 2019/11/02 22:33:33 ET
Table 'Antares' 6-max Seat #4 is the button
Seat 1: SeaofLove ($12.68 in chips)
Seat 2: PlayTheBlues4U ($14.80 in chips)
Seat 3: StickyChipss ($11.01 in chips)
Seat 4: tempusfugit3737 ($9.85 in chips)
Seat 5: skoalguy33 ($7.90 in chips)
skoalguy33: posts small blind $0.05
SeaofLove: posts big blind $0.10
*** HOLE CARDS ***
Dealt to PlayTheBlues4U [3s 4c]
PlayTheBlues4U: folds
StickyChipss: raises $0.20 to $0.30
tempusfugit3737: calls $0.30
skoalguy33: folds
SeaofLove: folds
*** FLOP *** [Td 7d 2c]
StickyChipss: bets $0.55
tempusfugit3737: calls $0.55
*** TURN *** [Td 7d 2c] [8s]
StickyChipss: bets $1.36
tempusfugit3737: folds
Uncalled bet ($1.36) returned to StickyChipss
StickyChipss collected $1.76 from pot
*** SUMMARY ***
Total pot $1.85 | Rake $0.09
Board [Td 7d 2c 8s]
Seat 1: SeaofLove (big blind) folded before Flop
Seat 2: PlayTheBlues4U folded before Flop (didn't bet)
Seat 3: StickyChipss collected ($1.76)
Seat 4: tempusfugit3737 (button) folded on the Turn
Seat 5: skoalguy33 (small blind) folded before Flop


*********** # 78 **************
PokerStars Hand #205379002323:  Hold'em No Limit ($0.05/$0.10 USD) - 2019/11/02 22:33:27 ET
Table 'Hekate' 6-max Seat #4 is the button
Seat 2: mankar.am ($8.20 in chips)
Seat 3: PlayTheBlues4U ($43.06 in chips)
Seat 4: SeaofLove ($11.39 in chips)
Seat 6: Ty1erDurrden ($10 in chips)
doodooeater will be allowed to play after the button
Ty1erDurrden: posts small blind $0.05
mankar.am: posts big blind $0.10
*** HOLE CARDS ***
Dealt to PlayTheBlues4U [Ac Td]
PlayTheBlues4U: raises $0.20 to $0.30
SeaofLove: folds
Ty1erDurrden: raises $0.90 to $1.20
mankar.am: folds
PlayTheBlues4U: folds
Uncalled bet ($0.90) returned to Ty1erDurrden
Ty1erDurrden collected $0.70 from pot
Ty1erDurrden: doesn't show hand
*** SUMMARY ***
Total pot $0.70 | Rake $0
Seat 2: mankar.am (big blind) folded before Flop
Seat 3: PlayTheBlues4U folded before Flop
Seat 4: SeaofLove (button) folded before Flop (didn't bet)
Seat 6: Ty1erDurrden (small blind) collected ($0.70)


*********** # 79 **************
PokerStars Hand #205379002300:  Hold'em No Limit ($0.05/$0.10 USD) - 2019/11/02 22:33:21 ET
Table 'Antares' 6-max Seat #3 is the button
Seat 1: SeaofLove ($12.68 in chips)
Seat 2: PlayTheBlues4U ($14.80 in chips)
Seat 3: StickyChipss ($11.01 in chips)
Seat 4: tempusfugit3737 ($9.75 in chips)
Seat 5: skoalguy33 ($8 in chips)
tempusfugit3737: posts small blind $0.05
skoalguy33: posts big blind $0.10
*** HOLE CARDS ***
Dealt to PlayTheBlues4U [8s Qh]
SeaofLove: folds
PlayTheBlues4U: folds
StickyChipss: folds
tempusfugit3737: raises $0.20 to $0.30
skoalguy33: folds
Uncalled bet ($0.20) returned to tempusfugit3737
tempusfugit3737 collected $0.20 from pot
tempusfugit3737: doesn't show hand
*** SUMMARY ***
Total pot $0.20 | Rake $0
Seat 1: SeaofLove folded before Flop (didn't bet)
Seat 2: PlayTheBlues4U folded before Flop (didn't bet)
Seat 3: StickyChipss (button) folded before Flop (didn't bet)
Seat 4: tempusfugit3737 (small blind) collected ($0.20)
Seat 5: skoalguy33 (big blind) folded before Flop


*********** # 80 **************
PokerStars Hand #205379002200:  Hold'em No Limit ($0.05/$0.10 USD) - 2019/11/02 22:32:53 ET
Table 'Antares' 6-max Seat #2 is the button
Seat 1: SeaofLove ($12.17 in chips)
Seat 2: PlayTheBlues4U ($15.05 in chips)
Seat 3: StickyChipss ($11.06 in chips)
Seat 4: tempusfugit3737 ($10 in chips)
StickyChipss: posts small blind $0.05
tempusfugit3737: posts big blind $0.10
skoalguy33: sits out
*** HOLE CARDS ***
Dealt to PlayTheBlues4U [9d Ah]
SeaofLove: raises $0.15 to $0.25
PlayTheBlues4U: calls $0.25
StickyChipss: folds
tempusfugit3737: calls $0.15
*** FLOP *** [2s Qs Qc]
tempusfugit3737: checks
SeaofLove: bets $0.51
PlayTheBlues4U: folds
tempusfugit3737: folds
Uncalled bet ($0.51) returned to SeaofLove
SeaofLove collected $0.76 from pot
SeaofLove: doesn't show hand
*** SUMMARY ***
Total pot $0.80 | Rake $0.04
Board [2s Qs Qc]
Seat 1: SeaofLove collected ($0.76)
Seat 2: PlayTheBlues4U (button) folded on the Flop
Seat 3: StickyChipss (small blind) folded before Flop
Seat 4: tempusfugit3737 (big blind) folded on the Flop


*********** # 81 **************
PokerStars Hand #205379002194:  Hold'em No Limit ($0.05/$0.10 USD) - 2019/11/02 22:32:51 ET
Table 'Hekate' 6-max Seat #3 is the button
Seat 2: mankar.am ($7.79 in chips)
Seat 3: PlayTheBlues4U ($43.36 in chips)
Seat 4: SeaofLove ($11.44 in chips)
Seat 6: Ty1erDurrden ($9.95 in chips)
SeaofLove: posts small blind $0.05
Ty1erDurrden: posts big blind $0.10
*** HOLE CARDS ***
Dealt to PlayTheBlues4U [Th Ah]
mankar.am: raises $0.10 to $0.20
PlayTheBlues4U: calls $0.20
SeaofLove: folds
Ty1erDurrden: folds
*** FLOP *** [9h 5c 3d]
mankar.am: checks
PlayTheBlues4U: checks
*** TURN *** [9h 5c 3d] [Jh]
mankar.am: bets $0.10
PlayTheBlues4U: calls $0.10
*** RIVER *** [9h 5c 3d Jh] [9d]
doodooeater joins the table at seat #5
mankar.am: bets $0.70
PlayTheBlues4U: folds
Uncalled bet ($0.70) returned to mankar.am
mankar.am collected $0.71 from pot
mankar.am: doesn't show hand
*** SUMMARY ***
Total pot $0.75 | Rake $0.04
Board [9h 5c 3d Jh 9d]
Seat 2: mankar.am collected ($0.71)
Seat 3: PlayTheBlues4U (button) folded on the River
Seat 4: SeaofLove (small blind) folded before Flop
Seat 6: Ty1erDurrden (big blind) folded before Flop


*********** # 82 **************
PokerStars Hand #205379002035:  Hold'em No Limit ($0.05/$0.10 USD) - 2019/11/02 22:32:08 ET
Table 'Hekate' 6-max Seat #2 is the button
Seat 2: mankar.am ($6.71 in chips)
Seat 3: PlayTheBlues4U ($44.46 in chips)
Seat 4: SeaofLove ($11.54 in chips)
Seat 6: Ty1erDurrden ($9.95 in chips)
PlayTheBlues4U: posts small blind $0.05
SeaofLove: posts big blind $0.10
*** HOLE CARDS ***
Dealt to PlayTheBlues4U [Td 9h]
Ty1erDurrden: folds
mankar.am: raises $0.10 to $0.20
PlayTheBlues4U: calls $0.15
SeaofLove: folds
*** FLOP *** [7d Qs Jd]
PlayTheBlues4U: checks
mankar.am: checks
*** TURN *** [7d Qs Jd] [4s]
PlayTheBlues4U: bets $0.30
mankar.am: calls $0.30
*** RIVER *** [7d Qs Jd 4s] [Qc]
PlayTheBlues4U: bets $0.60
mankar.am: calls $0.60
*** SHOW DOWN ***
PlayTheBlues4U: shows [Td 9h] (a pair of Queens)
mankar.am: shows [Ac Th] (a pair of Queens - Ace kicker)
mankar.am collected $2.18 from pot
*** SUMMARY ***
Total pot $2.30 | Rake $0.12
Board [7d Qs Jd 4s Qc]
Seat 2: mankar.am (button) showed [Ac Th] and won ($2.18) with a pair of Queens
Seat 3: PlayTheBlues4U (small blind) showed [Td 9h] and lost with a pair of Queens
Seat 4: SeaofLove (big blind) folded before Flop
Seat 6: Ty1erDurrden folded before Flop (didn't bet)


*********** # 83 **************
PokerStars Hand #205379001966:  Hold'em No Limit ($0.05/$0.10 USD) - 2019/11/02 22:31:50 ET
Table 'Hekate' 6-max Seat #6 is the button
Seat 2: mankar.am ($6.96 in chips)
Seat 3: PlayTheBlues4U ($44.56 in chips)
Seat 4: SeaofLove ($11.22 in chips)
Seat 6: Ty1erDurrden ($9.95 in chips)
mankar.am: posts small blind $0.05
PlayTheBlues4U: posts big blind $0.10
*** HOLE CARDS ***
Dealt to PlayTheBlues4U [2h Td]
SeaofLove: raises $0.15 to $0.25
Ty1erDurrden: folds
mankar.am: calls $0.20
PlayTheBlues4U: folds
*** FLOP *** [6s Kc 8h]
mankar.am: checks
SeaofLove: bets $0.38
mankar.am: folds
Uncalled bet ($0.38) returned to SeaofLove
SeaofLove collected $0.57 from pot
SeaofLove: doesn't show hand
*** SUMMARY ***
Total pot $0.60 | Rake $0.03
Board [6s Kc 8h]
Seat 2: mankar.am (small blind) folded on the Flop
Seat 3: PlayTheBlues4U (big blind) folded before Flop
Seat 4: SeaofLove collected ($0.57)
Seat 6: Ty1erDurrden (button) folded before Flop (didn't bet)


*********** # 84 **************
PokerStars Hand #205379001868:  Hold'em No Limit ($0.05/$0.10 USD) - 2019/11/02 22:31:23 ET
Table 'Hekate' 6-max Seat #4 is the button
Seat 2: mankar.am ($8.26 in chips)
Seat 3: PlayTheBlues4U ($44.56 in chips)
Seat 4: SeaofLove ($10 in chips)
Seat 6: Ty1erDurrden ($10 in chips)
Ty1erDurrden: posts small blind $0.05
mankar.am: posts big blind $0.10
*** HOLE CARDS ***
Dealt to PlayTheBlues4U [4c 8d]
PlayTheBlues4U: folds
SeaofLove: raises $0.15 to $0.25
Ty1erDurrden: folds
mankar.am: calls $0.15
*** FLOP *** [5d 4d Th]
mankar.am: bets $0.30
SeaofLove: raises $0.75 to $1.05
mankar.am: calls $0.75
*** TURN *** [5d 4d Th] [5s]
mankar.am: checks
SeaofLove: bets $1.30
mankar.am: folds
Uncalled bet ($1.30) returned to SeaofLove
SeaofLove collected $2.52 from pot
SeaofLove: doesn't show hand
*** SUMMARY ***
Total pot $2.65 | Rake $0.13
Board [5d 4d Th 5s]
Seat 2: mankar.am (big blind) folded on the Turn
Seat 3: PlayTheBlues4U folded before Flop (didn't bet)
Seat 4: SeaofLove (button) collected ($2.52)
Seat 6: Ty1erDurrden (small blind) folded before Flop


*********** # 85 **************
PokerStars Hand #205379001854:  Hold'em No Limit ($0.05/$0.10 USD) - 2019/11/02 22:31:19 ET
Table 'Antares' 6-max Seat #1 is the button
Seat 1: SeaofLove ($11.85 in chips)
Seat 2: PlayTheBlues4U ($15.30 in chips)
Seat 3: StickyChipss ($11.16 in chips)
PlayTheBlues4U: posts small blind $0.05
StickyChipss: posts big blind $0.10
*** HOLE CARDS ***
Dealt to PlayTheBlues4U [Tc 7c]
SeaofLove: raises $0.15 to $0.25
PlayTheBlues4U: calls $0.20
skoalguy33 joins the table at seat #5
tempusfugit3737 joins the table at seat #4
StickyChipss: folds
*** FLOP *** [Jd Qd 2h]
PlayTheBlues4U: checks
SeaofLove: checks
*** TURN *** [Jd Qd 2h] [2c]
PlayTheBlues4U: checks
SeaofLove: checks
*** RIVER *** [Jd Qd 2h 2c] [4c]
PlayTheBlues4U: checks
SeaofLove: checks
*** SHOW DOWN ***
PlayTheBlues4U: shows [Tc 7c] (a pair of Deuces)
SeaofLove: shows [Ac 6c] (a pair of Deuces - Ace kicker)
SeaofLove collected $0.57 from pot
*** SUMMARY ***
Total pot $0.60 | Rake $0.03
Board [Jd Qd 2h 2c 4c]
Seat 1: SeaofLove (button) showed [Ac 6c] and won ($0.57) with a pair of Deuces
Seat 2: PlayTheBlues4U (small blind) showed [Tc 7c] and lost with a pair of Deuces
Seat 3: StickyChipss (big blind) folded before Flop


*********** # 86 **************
PokerStars Hand #205379001833:  Hold'em No Limit ($0.05/$0.10 USD) - 2019/11/02 22:31:13 ET
Table 'Antares' 6-max Seat #3 is the button
Seat 1: SeaofLove ($11.90 in chips)
Seat 2: PlayTheBlues4U ($15.25 in chips)
Seat 3: StickyChipss ($11.16 in chips)
SeaofLove: posts small blind $0.05
PlayTheBlues4U: posts big blind $0.10
*** HOLE CARDS ***
Dealt to PlayTheBlues4U [9h 7s]
StickyChipss: folds
SeaofLove: folds
Uncalled bet ($0.05) returned to PlayTheBlues4U
PlayTheBlues4U collected $0.10 from pot
PlayTheBlues4U: doesn't show hand
*** SUMMARY ***
Total pot $0.10 | Rake $0
Seat 1: SeaofLove (small blind) folded before Flop
Seat 2: PlayTheBlues4U (big blind) collected ($0.10)
Seat 3: StickyChipss (button) folded before Flop (didn't bet)


*********** # 87 **************
PokerStars Hand #205379001803:  Hold'em No Limit ($0.05/$0.10 USD) - 2019/11/02 22:31:05 ET
Table 'Antares' 6-max Seat #2 is the button
Seat 1: SeaofLove ($11.85 in chips)
Seat 2: PlayTheBlues4U ($15.25 in chips)
Seat 3: StickyChipss ($11.21 in chips)
StickyChipss: posts small blind $0.05
SeaofLove: posts big blind $0.10
*** HOLE CARDS ***
Dealt to PlayTheBlues4U [4h Js]
PlayTheBlues4U: folds
StickyChipss: folds
Uncalled bet ($0.05) returned to SeaofLove
SeaofLove collected $0.10 from pot
SeaofLove: doesn't show hand
*** SUMMARY ***
Total pot $0.10 | Rake $0
Seat 1: SeaofLove (big blind) collected ($0.10)
Seat 2: PlayTheBlues4U (button) folded before Flop (didn't bet)
Seat 3: StickyChipss (small blind) folded before Flop


*********** # 88 **************
PokerStars Hand #205379001755:  Hold'em No Limit ($0.05/$0.10 USD) - 2019/11/02 22:30:53 ET
Table 'Antares' 6-max Seat #1 is the button
Seat 1: SeaofLove ($11.85 in chips)
Seat 2: PlayTheBlues4U ($15.15 in chips)
Seat 3: StickyChipss ($11.31 in chips)
PlayTheBlues4U: posts small blind $0.05
StickyChipss: posts big blind $0.10
*** HOLE CARDS ***
Dealt to PlayTheBlues4U [As 4s]
SeaofLove: folds
PlayTheBlues4U: raises $0.20 to $0.30
StickyChipss: folds
Uncalled bet ($0.20) returned to PlayTheBlues4U
PlayTheBlues4U collected $0.20 from pot
PlayTheBlues4U: doesn't show hand
*** SUMMARY ***
Total pot $0.20 | Rake $0
Seat 1: SeaofLove (button) folded before Flop (didn't bet)
Seat 2: PlayTheBlues4U (small blind) collected ($0.20)
Seat 3: StickyChipss (big blind) folded before Flop


*********** # 89 **************
PokerStars Hand #205379001744:  Hold'em No Limit ($0.05/$0.10 USD) - 2019/11/02 22:30:51 ET
Table 'Hekate' 6-max Seat #3 is the button
Seat 2: mankar.am ($6.84 in chips)
Seat 3: PlayTheBlues4U ($44.56 in chips)
Seat 4: SeaofLove ($10.95 in chips)
Seat 6: Ty1erDurrden ($9.95 in chips)
SeaofLove: posts small blind $0.05
Ty1erDurrden: posts big blind $0.10
*** HOLE CARDS ***
Dealt to PlayTheBlues4U [Qh Jc]
mankar.am: raises $0.10 to $0.20
PlayTheBlues4U: folds
SeaofLove: calls $0.15
Ty1erDurrden: calls $0.10
*** FLOP *** [5h Td 3c]
SeaofLove: bets $0.38
Ty1erDurrden: calls $0.38
mankar.am: raises $0.38 to $0.76
SeaofLove: calls $0.38
Ty1erDurrden: folds
*** TURN *** [5h Td 3c] [3d]
SeaofLove: checks
mankar.am: bets $1.20
SeaofLove: folds
Uncalled bet ($1.20) returned to mankar.am
mankar.am collected $2.38 from pot
mankar.am: doesn't show hand
*** SUMMARY ***
Total pot $2.50 | Rake $0.12
Board [5h Td 3c 3d]
Seat 2: mankar.am collected ($2.38)
Seat 3: PlayTheBlues4U (button) folded before Flop (didn't bet)
Seat 4: SeaofLove (small blind) folded on the Turn
Seat 6: Ty1erDurrden (big blind) folded on the Flop


*********** # 90 **************
PokerStars Hand #205379001730:  Hold'em No Limit ($0.05/$0.10 USD) - 2019/11/02 22:30:46 ET
Table 'Antares' 6-max Seat #3 is the button
Seat 1: SeaofLove ($11.90 in chips)
Seat 2: PlayTheBlues4U ($15.10 in chips)
Seat 3: StickyChipss ($11.31 in chips)
SeaofLove: posts small blind $0.05
PlayTheBlues4U: posts big blind $0.10
*** HOLE CARDS ***
Dealt to PlayTheBlues4U [Jc 3s]
StickyChipss: folds
SeaofLove: folds
Uncalled bet ($0.05) returned to PlayTheBlues4U
PlayTheBlues4U collected $0.10 from pot
PlayTheBlues4U: doesn't show hand
*** SUMMARY ***
Total pot $0.10 | Rake $0
Seat 1: SeaofLove (small blind) folded before Flop
Seat 2: PlayTheBlues4U (big blind) collected ($0.10)
Seat 3: StickyChipss (button) folded before Flop (didn't bet)


*********** # 91 **************
PokerStars Hand #205379001704:  Hold'em No Limit ($0.05/$0.10 USD) - 2019/11/02 22:30:39 ET
Table 'Hekate' 6-max Seat #2 is the button
Seat 2: mankar.am ($6.69 in chips)
Seat 3: PlayTheBlues4U ($44.61 in chips)
Seat 4: SeaofLove ($11.05 in chips)
Seat 6: Ty1erDurrden ($9.95 in chips)
PlayTheBlues4U: posts small blind $0.05
SeaofLove: posts big blind $0.10
*** HOLE CARDS ***
Dealt to PlayTheBlues4U [Th 7h]
Ty1erDurrden: folds
mankar.am: raises $0.10 to $0.20
linghuchong2 leaves the table
PlayTheBlues4U: folds
SeaofLove: folds
Uncalled bet ($0.10) returned to mankar.am
mankar.am collected $0.25 from pot
*** SUMMARY ***
Total pot $0.25 | Rake $0
Seat 2: mankar.am (button) collected ($0.25)
Seat 3: PlayTheBlues4U (small blind) folded before Flop
Seat 4: SeaofLove (big blind) folded before Flop
Seat 6: Ty1erDurrden folded before Flop (didn't bet)


*********** # 92 **************
PokerStars Hand #205379001662:  Hold'em No Limit ($0.05/$0.10 USD) - 2019/11/02 22:30:28 ET
Table 'Antares' 6-max Seat #2 is the button
Seat 1: SeaofLove ($12 in chips)
Seat 2: PlayTheBlues4U ($15.10 in chips)
Seat 3: StickyChipss ($11.21 in chips)
StickyChipss: posts small blind $0.05
SeaofLove: posts big blind $0.10
*** HOLE CARDS ***
Dealt to PlayTheBlues4U [Th 2c]
PlayTheBlues4U: folds
StickyChipss: raises $0.90 to $1
SeaofLove: folds
Uncalled bet ($0.90) returned to StickyChipss
StickyChipss collected $0.20 from pot
*** SUMMARY ***
Total pot $0.20 | Rake $0
Seat 1: SeaofLove (big blind) folded before Flop
Seat 2: PlayTheBlues4U (button) folded before Flop (didn't bet)
Seat 3: StickyChipss (small blind) collected ($0.20)


*********** # 93 **************
PokerStars Hand #205379001625:  Hold'em No Limit ($0.05/$0.10 USD) - 2019/11/02 22:30:19 ET
Table 'Antares' 6-max Seat #1 is the button
Seat 1: SeaofLove ($12 in chips)
Seat 2: PlayTheBlues4U ($15.15 in chips)
Seat 3: StickyChipss ($11.16 in chips)
PlayTheBlues4U: posts small blind $0.05
StickyChipss: posts big blind $0.10
*** HOLE CARDS ***
Dealt to PlayTheBlues4U [7d 2c]
SeaofLove: folds
PlayTheBlues4U: folds
Uncalled bet ($0.05) returned to StickyChipss
StickyChipss collected $0.10 from pot
*** SUMMARY ***
Total pot $0.10 | Rake $0
Seat 1: SeaofLove (button) folded before Flop (didn't bet)
Seat 2: PlayTheBlues4U (small blind) folded before Flop
Seat 3: StickyChipss (big blind) collected ($0.10)


*********** # 94 **************
PokerStars Hand #205379001594:  Hold'em No Limit ($0.05/$0.10 USD) - 2019/11/02 22:30:12 ET
Table 'Hekate' 6-max Seat #6 is the button
Seat 1: linghuchong2 ($0.44 in chips)
Seat 2: mankar.am ($6.29 in chips)
Seat 3: PlayTheBlues4U ($44.61 in chips)
Seat 4: SeaofLove ($11.05 in chips)
Seat 6: Ty1erDurrden ($9.95 in chips)
linghuchong2: posts small blind $0.05
mankar.am: posts big blind $0.10
*** HOLE CARDS ***
Dealt to PlayTheBlues4U [Js Tc]
PlayTheBlues4U: folds
SeaofLove: folds
Ty1erDurrden: folds
linghuchong2: raises $0.34 to $0.44 and is all-in
mankar.am: calls $0.34
*** FLOP *** [5h 9d 7d]
*** TURN *** [5h 9d 7d] [4c]
*** RIVER *** [5h 9d 7d 4c] [3s]
*** SHOW DOWN ***
linghuchong2: shows [Ad 3c] (a pair of Threes)
mankar.am: shows [4h Qd] (a pair of Fours)
mankar.am collected $0.84 from pot
*** SUMMARY ***
Total pot $0.88 | Rake $0.04
Board [5h 9d 7d 4c 3s]
Seat 1: linghuchong2 (small blind) showed [Ad 3c] and lost with a pair of Threes
Seat 2: mankar.am (big blind) showed [4h Qd] and won ($0.84) with a pair of Fours
Seat 3: PlayTheBlues4U folded before Flop (didn't bet)
Seat 4: SeaofLove folded before Flop (didn't bet)
Seat 6: Ty1erDurrden (button) folded before Flop (didn't bet)


*********** # 95 **************
PokerStars Hand #205379001556:  Hold'em No Limit ($0.05/$0.10 USD) - 2019/11/02 22:30:00 ET
Table 'Antares' 6-max Seat #5 is the button
Seat 1: SeaofLove ($12.05 in chips)
Seat 2: PlayTheBlues4U ($15.10 in chips)
Seat 3: StickyChipss ($11.16 in chips)
Seat 5: colinsdad16 ($6.85 in chips)
SeaofLove: posts small blind $0.05
PlayTheBlues4U: posts big blind $0.10
*** HOLE CARDS ***
Dealt to PlayTheBlues4U [Ts 9h]
StickyChipss: folds
boxerpupp727 is disconnected
colinsdad16: folds
SeaofLove: folds
Uncalled bet ($0.05) returned to PlayTheBlues4U
PlayTheBlues4U collected $0.10 from pot
colinsdad16 leaves the table
PlayTheBlues4U: doesn't show hand
*** SUMMARY ***
Total pot $0.10 | Rake $0
Seat 1: SeaofLove (small blind) folded before Flop
Seat 2: PlayTheBlues4U (big blind) collected ($0.10)
Seat 3: StickyChipss folded before Flop (didn't bet)
Seat 5: colinsdad16 (button) folded before Flop (didn't bet)


*********** # 96 **************
PokerStars Hand #205379001481:  Hold'em No Limit ($0.05/$0.10 USD) - 2019/11/02 22:29:38 ET
Table 'Hekate' 6-max Seat #4 is the button
Seat 1: linghuchong2 ($2.24 in chips)
Seat 2: mankar.am ($4.62 in chips)
Seat 3: PlayTheBlues4U ($44.61 in chips)
Seat 4: SeaofLove ($11.05 in chips)
Seat 6: Ty1erDurrden ($10 in chips)
Ty1erDurrden: posts small blind $0.05
linghuchong2: posts big blind $0.10
*** HOLE CARDS ***
Dealt to PlayTheBlues4U [5d 9s]
mankar.am: raises $0.10 to $0.20
PlayTheBlues4U: folds
SeaofLove: folds
Ty1erDurrden: folds
linghuchong2: calls $0.10
*** FLOP *** [4s Ac 3c]
linghuchong2: bets $0.40
mankar.am: calls $0.40
*** TURN *** [4s Ac 3c] [Ks]
linghuchong2: checks
mankar.am: checks
*** RIVER *** [4s Ac 3c Ks] [7d]
linghuchong2: checks
mankar.am: bets $1.20
linghuchong2: calls $1.20
*** SHOW DOWN ***
mankar.am: shows [5c 6c] (a straight, Three to Seven)
linghuchong2: mucks hand
mankar.am collected $3.47 from pot
*** SUMMARY ***
Total pot $3.65 | Rake $0.18
Board [4s Ac 3c Ks 7d]
Seat 1: linghuchong2 (big blind) mucked [Jc Ah]
Seat 2: mankar.am showed [5c 6c] and won ($3.47) with a straight, Three to Seven
Seat 3: PlayTheBlues4U folded before Flop (didn't bet)
Seat 4: SeaofLove (button) folded before Flop (didn't bet)
Seat 6: Ty1erDurrden (small blind) folded before Flop


*********** # 97 **************
PokerStars Hand #205379001346:  Hold'em No Limit ($0.05/$0.10 USD) - 2019/11/02 22:29:02 ET
Table 'Antares' 6-max Seat #3 is the button
Seat 1: SeaofLove ($12.30 in chips)
Seat 2: PlayTheBlues4U ($12.06 in chips)
Seat 3: StickyChipss ($11.16 in chips)
Seat 5: colinsdad16 ($9.70 in chips)
Seat 6: boxerpupp727 ($12.24 in chips)
colinsdad16: posts small blind $0.05
boxerpupp727: posts big blind $0.10
*** HOLE CARDS ***
Dealt to PlayTheBlues4U [5d 5h]
SeaofLove: raises $0.15 to $0.25
boxerpupp727 said, "75 other day. now 30s"
PlayTheBlues4U: calls $0.25
StickyChipss: folds
colinsdad16: calls $0.20
boxerpupp727: calls $0.15
*** FLOP *** [2h 5s 6s]
colinsdad16: checks
boxerpupp727: checks
SeaofLove: checks
PlayTheBlues4U: bets $0.70
colinsdad16: calls $0.70
boxerpupp727: folds
SeaofLove: folds
*** TURN *** [2h 5s 6s] [2c]
colinsdad16: checks
PlayTheBlues4U: bets $1.90
colinsdad16: calls $1.90
*** RIVER *** [2h 5s 6s 2c] [Kh]
colinsdad16: checks
PlayTheBlues4U: bets $4.80
colinsdad16: folds
Uncalled bet ($4.80) returned to PlayTheBlues4U
PlayTheBlues4U collected $5.89 from pot
PlayTheBlues4U: doesn't show hand
*** SUMMARY ***
Total pot $6.20 | Rake $0.31
Board [2h 5s 6s 2c Kh]
Seat 1: SeaofLove folded on the Flop
Seat 2: PlayTheBlues4U collected ($5.89)
Seat 3: StickyChipss (button) folded before Flop (didn't bet)
Seat 5: colinsdad16 (small blind) folded on the River
Seat 6: boxerpupp727 (big blind) folded on the Flop


*********** # 98 **************
PokerStars Hand #205379001252:  Hold'em No Limit ($0.05/$0.10 USD) - 2019/11/02 22:28:36 ET
Table 'Antares' 6-max Seat #2 is the button
Seat 1: SeaofLove ($12.15 in chips)
Seat 2: PlayTheBlues4U ($12.06 in chips)
Seat 3: StickyChipss ($11.21 in chips)
Seat 5: colinsdad16 ($9.80 in chips)
Seat 6: boxerpupp727 ($12.24 in chips)
StickyChipss: posts small blind $0.05
colinsdad16: posts big blind $0.10
*** HOLE CARDS ***
Dealt to PlayTheBlues4U [5d Kc]
boxerpupp727: folds
SeaofLove: raises $0.15 to $0.25
boxerpupp727 said, "damn. winter is here"
PlayTheBlues4U: folds
StickyChipss: folds
colinsdad16: folds
Uncalled bet ($0.15) returned to SeaofLove
SeaofLove collected $0.25 from pot
SeaofLove: doesn't show hand
*** SUMMARY ***
Total pot $0.25 | Rake $0
Seat 1: SeaofLove collected ($0.25)
Seat 2: PlayTheBlues4U (button) folded before Flop (didn't bet)
Seat 3: StickyChipss (small blind) folded before Flop
Seat 5: colinsdad16 (big blind) folded before Flop
Seat 6: boxerpupp727 folded before Flop (didn't bet)


*********** # 99 **************
PokerStars Hand #205379001237:  Hold'em No Limit ($0.05/$0.10 USD) - 2019/11/02 22:28:32 ET
Table 'Hekate' 6-max Seat #3 is the button
Seat 1: linghuchong2 ($2.24 in chips)
Seat 2: mankar.am ($5.42 in chips)
Seat 3: PlayTheBlues4U ($42.99 in chips)
Seat 4: SeaofLove ($11.10 in chips)
Seat 5: papabear127 ($15.91 in chips)
Seat 6: Ty1erDurrden ($10 in chips)
SeaofLove: posts small blind $0.05
papabear127: posts big blind $0.10
*** HOLE CARDS ***
Dealt to PlayTheBlues4U [As 2s]
Ty1erDurrden: raises $0.15 to $0.25
linghuchong2: folds
mankar.am: calls $0.25
PlayTheBlues4U: raises $0.55 to $0.80
SeaofLove: folds
papabear127: folds
Ty1erDurrden: calls $0.55
mankar.am: calls $0.55
*** FLOP *** [9d Kc 3d]
Ty1erDurrden: checks
mankar.am: checks
PlayTheBlues4U: bets $1.70
Ty1erDurrden: folds
papabear127 leaves the table
mankar.am: folds
Uncalled bet ($1.70) returned to PlayTheBlues4U
PlayTheBlues4U collected $2.42 from pot
*** SUMMARY ***
Total pot $2.55 | Rake $0.13
Board [9d Kc 3d]
Seat 1: linghuchong2 folded before Flop (didn't bet)
Seat 2: mankar.am folded on the Flop
Seat 3: PlayTheBlues4U (button) collected ($2.42)
Seat 4: SeaofLove (small blind) folded before Flop
Seat 5: papabear127 (big blind) folded before Flop
Seat 6: Ty1erDurrden folded on the Flop


*********** # 100 **************
PokerStars Hand #205379001224:  Hold'em No Limit ($0.05/$0.10 USD) - 2019/11/02 22:28:29 ET
Table 'Antares' 6-max Seat #1 is the button
Seat 1: SeaofLove ($12.15 in chips)
Seat 2: PlayTheBlues4U ($12.11 in chips)
Seat 3: StickyChipss ($11.16 in chips)
Seat 5: colinsdad16 ($9.80 in chips)
Seat 6: boxerpupp727 ($12.24 in chips)
PlayTheBlues4U: posts small blind $0.05
StickyChipss: posts big blind $0.10
*** HOLE CARDS ***
Dealt to PlayTheBlues4U [7c Tc]
colinsdad16: folds
boxerpupp727: folds
SeaofLove: folds
PlayTheBlues4U: folds
Uncalled bet ($0.05) returned to StickyChipss
StickyChipss collected $0.10 from pot
*** SUMMARY ***
Total pot $0.10 | Rake $0
Seat 1: SeaofLove (button) folded before Flop (didn't bet)
Seat 2: PlayTheBlues4U (small blind) folded before Flop
Seat 3: StickyChipss (big blind) collected ($0.10)
Seat 5: colinsdad16 folded before Flop (didn't bet)
Seat 6: boxerpupp727 folded before Flop (didn't bet)


*********** # 101 **************
PokerStars Hand #205379001177:  Hold'em No Limit ($0.05/$0.10 USD) - 2019/11/02 22:28:15 ET
Table 'Antares' 6-max Seat #6 is the button
Seat 1: SeaofLove ($12.20 in chips)
Seat 2: PlayTheBlues4U ($12.06 in chips)
Seat 3: StickyChipss ($11.16 in chips)
Seat 5: colinsdad16 ($9.80 in chips)
Seat 6: boxerpupp727 ($12.24 in chips)
SeaofLove: posts small blind $0.05
PlayTheBlues4U: posts big blind $0.10
*** HOLE CARDS ***
Dealt to PlayTheBlues4U [5h Kh]
StickyChipss: folds
colinsdad16: folds
boxerpupp727: folds
SeaofLove: folds
Uncalled bet ($0.05) returned to PlayTheBlues4U
PlayTheBlues4U collected $0.10 from pot
PlayTheBlues4U: doesn't show hand
*** SUMMARY ***
Total pot $0.10 | Rake $0
Seat 1: SeaofLove (small blind) folded before Flop
Seat 2: PlayTheBlues4U (big blind) collected ($0.10)
Seat 3: StickyChipss folded before Flop (didn't bet)
Seat 5: colinsdad16 folded before Flop (didn't bet)
Seat 6: boxerpupp727 (button) folded before Flop (didn't bet)


*********** # 102 **************
PokerStars Hand #205379001147:  Hold'em No Limit ($0.05/$0.10 USD) - 2019/11/02 22:28:07 ET
Table 'Antares' 6-max Seat #5 is the button
Seat 1: SeaofLove ($12.15 in chips)
Seat 2: PlayTheBlues4U ($12.06 in chips)
Seat 3: StickyChipss ($11.16 in chips)
Seat 5: colinsdad16 ($9.80 in chips)
Seat 6: boxerpupp727 ($12.29 in chips)
boxerpupp727: posts small blind $0.05
SeaofLove: posts big blind $0.10
*** HOLE CARDS ***
Dealt to PlayTheBlues4U [Qd 4d]
PlayTheBlues4U: folds
StickyChipss: folds
colinsdad16: folds
boxerpupp727: folds
Uncalled bet ($0.05) returned to SeaofLove
SeaofLove collected $0.10 from pot
SeaofLove: doesn't show hand
*** SUMMARY ***
Total pot $0.10 | Rake $0
Seat 1: SeaofLove (big blind) collected ($0.10)
Seat 2: PlayTheBlues4U folded before Flop (didn't bet)
Seat 3: StickyChipss folded before Flop (didn't bet)
Seat 5: colinsdad16 (button) folded before Flop (didn't bet)
Seat 6: boxerpupp727 (small blind) folded before Flop


*********** # 103 **************
PokerStars Hand #205379001026:  Hold'em No Limit ($0.05/$0.10 USD) - 2019/11/02 22:27:34 ET
Table 'Antares' 6-max Seat #3 is the button
Seat 1: SeaofLove ($12.90 in chips)
Seat 2: PlayTheBlues4U ($12.06 in chips)
Seat 3: StickyChipss ($11.16 in chips)
Seat 5: colinsdad16 ($10.05 in chips)
Seat 6: boxerpupp727 ($11.38 in chips)
colinsdad16: posts small blind $0.05
boxerpupp727: posts big blind $0.10
*** HOLE CARDS ***
Dealt to PlayTheBlues4U [4c 5h]
SeaofLove: raises $0.15 to $0.25
PlayTheBlues4U: folds
StickyChipss: folds
colinsdad16: calls $0.20
boxerpupp727: calls $0.15
*** FLOP *** [7h 6h 9s]
colinsdad16: checks
boxerpupp727: checks
SeaofLove: checks
*** TURN *** [7h 6h 9s] [3c]
colinsdad16: checks
boxerpupp727: bets $0.50
SeaofLove: calls $0.50
colinsdad16: folds
*** RIVER *** [7h 6h 9s 3c] [4s]
boxerpupp727: checks
SeaofLove: checks
*** SHOW DOWN ***
boxerpupp727: shows [Qs Qc] (a pair of Queens)
SeaofLove: mucks hand
boxerpupp727 collected $1.66 from pot
*** SUMMARY ***
Total pot $1.75 | Rake $0.09
Board [7h 6h 9s 3c 4s]
Seat 1: SeaofLove mucked [Qd 9d]
Seat 2: PlayTheBlues4U folded before Flop (didn't bet)
Seat 3: StickyChipss (button) folded before Flop (didn't bet)
Seat 5: colinsdad16 (small blind) folded on the Turn
Seat 6: boxerpupp727 (big blind) showed [Qs Qc] and won ($1.66) with a pair of Queens


*********** # 104 **************
PokerStars Hand #205379001002:  Hold'em No Limit ($0.05/$0.10 USD) - 2019/11/02 22:27:28 ET
Table 'Hekate' 6-max Seat #2 is the button
Seat 1: linghuchong2 ($2.24 in chips)
Seat 2: mankar.am ($6.22 in chips)
Seat 3: PlayTheBlues4U ($43.04 in chips)
Seat 4: SeaofLove ($11.20 in chips)
Seat 5: papabear127 ($7.90 in chips)
Seat 6: Ty1erDurrden ($10 in chips)
PlayTheBlues4U: posts small blind $0.05
SeaofLove: posts big blind $0.10
*** HOLE CARDS ***
Dealt to PlayTheBlues4U [4h 4s]
papabear127: calls $0.10
Ty1erDurrden: raises $0.35 to $0.45
linghuchong2: folds
mankar.am: raises $0.35 to $0.80
PlayTheBlues4U: folds
SeaofLove: folds
papabear127: calls $0.70
Ty1erDurrden: calls $0.35
*** FLOP *** [Jc 5d 9h]
papabear127: bets $1.21
Ty1erDurrden: raises $1.45 to $2.66
mankar.am: folds
papabear127: calls $1.45
*** TURN *** [Jc 5d 9h] [Qc]
papabear127: checks
Ty1erDurrden: bets $6.54 and is all-in
papabear127: calls $4.44 and is all-in
Uncalled bet ($2.10) returned to Ty1erDurrden
*** RIVER *** [Jc 5d 9h Qc] [Ks]
*** SHOW DOWN ***
papabear127: shows [Jh Qd] (two pair, Queens and Jacks)
Ty1erDurrden: shows [9s Js] (two pair, Jacks and Nines)
papabear127 collected $15.91 from pot
*** SUMMARY ***
Total pot $16.75 | Rake $0.84
Board [Jc 5d 9h Qc Ks]
Seat 1: linghuchong2 folded before Flop (didn't bet)
Seat 2: mankar.am (button) folded on the Flop
Seat 3: PlayTheBlues4U (small blind) folded before Flop
Seat 4: SeaofLove (big blind) folded before Flop
Seat 5: papabear127 showed [Jh Qd] and won ($15.91) with two pair, Queens and Jacks
Seat 6: Ty1erDurrden showed [9s Js] and lost with two pair, Jacks and Nines


*********** # 105 **************
PokerStars Hand #205379000996:  Hold'em No Limit ($0.05/$0.10 USD) - 2019/11/02 22:27:26 ET
Table 'Antares' 6-max Seat #2 is the button
Seat 1: SeaofLove ($12.90 in chips)
Seat 2: PlayTheBlues4U ($12.06 in chips)
Seat 3: StickyChipss ($11.21 in chips)
Seat 5: colinsdad16 ($10 in chips)
Seat 6: boxerpupp727 ($11.38 in chips)
StickyChipss: posts small blind $0.05
colinsdad16: posts big blind $0.10
*** HOLE CARDS ***
Dealt to PlayTheBlues4U [4c Tc]
boxerpupp727: folds
SeaofLove: folds
PlayTheBlues4U: folds
StickyChipss: folds
Uncalled bet ($0.05) returned to colinsdad16
colinsdad16 collected $0.10 from pot
colinsdad16: doesn't show hand
*** SUMMARY ***
Total pot $0.10 | Rake $0
Seat 1: SeaofLove folded before Flop (didn't bet)
Seat 2: PlayTheBlues4U (button) folded before Flop (didn't bet)
Seat 3: StickyChipss (small blind) folded before Flop
Seat 5: colinsdad16 (big blind) collected ($0.10)
Seat 6: boxerpupp727 folded before Flop (didn't bet)


*********** # 106 **************
PokerStars Hand #205379000872:  Hold'em No Limit ($0.05/$0.10 USD) - 2019/11/02 22:26:55 ET
Table 'Hekate' 6-max Seat #1 is the button
Seat 1: linghuchong2 ($2.24 in chips)
Seat 2: mankar.am ($5.17 in chips)
Seat 3: PlayTheBlues4U ($43.14 in chips)
Seat 4: SeaofLove ($11.20 in chips)
Seat 5: papabear127 ($8 in chips)
Seat 6: Ty1erDurrden ($10.25 in chips)
mankar.am: posts small blind $0.05
PlayTheBlues4U: posts big blind $0.10
papabear127: posts big blind $0.10
*** HOLE CARDS ***
Dealt to PlayTheBlues4U [Qs 3d]
SeaofLove: folds
papabear127: checks
Ty1erDurrden: raises $0.35 to $0.45
linghuchong2: folds
mankar.am: calls $0.40
PlayTheBlues4U: folds
papabear127: folds
*** FLOP *** [Qh 9c Th]
mankar.am: bets $0.50
Ty1erDurrden: calls $0.50
*** TURN *** [Qh 9c Th] [8h]
mankar.am: bets $1
Ty1erDurrden: folds
Uncalled bet ($1) returned to mankar.am
mankar.am collected $2 from pot
*** SUMMARY ***
Total pot $2.10 | Rake $0.10
Board [Qh 9c Th 8h]
Seat 1: linghuchong2 (button) folded before Flop (didn't bet)
Seat 2: mankar.am (small blind) collected ($2)
Seat 3: PlayTheBlues4U (big blind) folded before Flop
Seat 4: SeaofLove folded before Flop (didn't bet)
Seat 5: papabear127 folded before Flop (didn't bet)
Seat 6: Ty1erDurrden folded on the Turn


*********** # 107 **************
PokerStars Hand #205379000853:  Hold'em No Limit ($0.05/$0.10 USD) - 2019/11/02 22:26:51 ET
Table 'Antares' 6-max Seat #1 is the button
Seat 1: SeaofLove ($13.25 in chips)
Seat 2: PlayTheBlues4U ($13.01 in chips)
Seat 3: StickyChipss ($11.31 in chips)
Seat 6: boxerpupp727 ($10.10 in chips)
PlayTheBlues4U: posts small blind $0.05
StickyChipss: posts big blind $0.10
*** HOLE CARDS ***
Dealt to PlayTheBlues4U [Qc Kc]
boxerpupp727: raises $0.25 to $0.35
SeaofLove: calls $0.35
PlayTheBlues4U: calls $0.30
StickyChipss: folds
*** FLOP *** [Ah 7c Ts]
PlayTheBlues4U: checks
boxerpupp727: checks
SeaofLove: checks
*** TURN *** [Ah 7c Ts] [4c]
PlayTheBlues4U: bets $0.60
boxerpupp727: calls $0.60
SeaofLove: folds
*** RIVER *** [Ah 7c Ts 4c] [8d]
PlayTheBlues4U: checks
colinsdad16 joins the table at seat #5
boxerpupp727: checks
*** SHOW DOWN ***
PlayTheBlues4U: shows [Qc Kc] (high card Ace)
boxerpupp727: shows [7d Jd] (a pair of Sevens)
boxerpupp727 collected $2.23 from pot
*** SUMMARY ***
Total pot $2.35 | Rake $0.12
Board [Ah 7c Ts 4c 8d]
Seat 1: SeaofLove (button) folded on the Turn
Seat 2: PlayTheBlues4U (small blind) showed [Qc Kc] and lost with high card Ace
Seat 3: StickyChipss (big blind) folded before Flop
Seat 6: boxerpupp727 showed [7d Jd] and won ($2.23) with a pair of Sevens


*********** # 108 **************
PokerStars Hand #205379000813:  Hold'em No Limit ($0.05/$0.10 USD) - 2019/11/02 22:26:39 ET
Table 'Antares' 6-max Seat #6 is the button
Seat 1: SeaofLove ($13.30 in chips)
Seat 2: PlayTheBlues4U ($13.11 in chips)
Seat 3: StickyChipss ($11.31 in chips)
Seat 6: boxerpupp727 ($9.95 in chips)
SeaofLove: posts small blind $0.05
PlayTheBlues4U: posts big blind $0.10
*** HOLE CARDS ***
Dealt to PlayTheBlues4U [2d 6h]
StickyChipss: folds
boxerpupp727: raises $0.25 to $0.35
SeaofLove: folds
PlayTheBlues4U: folds
Uncalled bet ($0.25) returned to boxerpupp727
boxerpupp727 collected $0.25 from pot
*** SUMMARY ***
Total pot $0.25 | Rake $0
Seat 1: SeaofLove (small blind) folded before Flop
Seat 2: PlayTheBlues4U (big blind) folded before Flop
Seat 3: StickyChipss folded before Flop (didn't bet)
Seat 6: boxerpupp727 (button) collected ($0.25)


*********** # 109 **************
PokerStars Hand #205379000773:  Hold'em No Limit ($0.05/$0.10 USD) - 2019/11/02 22:26:29 ET
Table 'Antares' 6-max Seat #3 is the button
Seat 1: SeaofLove ($13.25 in chips)
Seat 2: PlayTheBlues4U ($13.11 in chips)
Seat 3: StickyChipss ($11.31 in chips)
Seat 6: boxerpupp727 ($10 in chips)
boxerpupp727: posts small blind $0.05
SeaofLove: posts big blind $0.10
*** HOLE CARDS ***
Dealt to PlayTheBlues4U [2d Ah]
PlayTheBlues4U: folds
StickyChipss: folds
boxerpupp727: folds
Uncalled bet ($0.05) returned to SeaofLove
SeaofLove collected $0.10 from pot
SeaofLove: doesn't show hand
*** SUMMARY ***
Total pot $0.10 | Rake $0
Seat 1: SeaofLove (big blind) collected ($0.10)
Seat 2: PlayTheBlues4U folded before Flop (didn't bet)
Seat 3: StickyChipss (button) folded before Flop (didn't bet)
Seat 6: boxerpupp727 (small blind) folded before Flop


*********** # 110 **************
PokerStars Hand #205379000719:  Hold'em No Limit ($0.05/$0.10 USD) - 2019/11/02 22:26:16 ET
Table 'Hekate' 6-max Seat #6 is the button
Seat 1: linghuchong2 ($2.29 in chips)
Seat 2: mankar.am ($4.86 in chips)
Seat 3: PlayTheBlues4U ($44.24 in chips)
Seat 4: SeaofLove ($11.20 in chips)
Seat 6: Ty1erDurrden ($9.95 in chips)
linghuchong2: posts small blind $0.05
mankar.am: posts big blind $0.10
*** HOLE CARDS ***
Dealt to PlayTheBlues4U [Jc Jd]
PlayTheBlues4U: raises $0.20 to $0.30
SeaofLove: folds
Ty1erDurrden: raises $0.80 to $1.10
linghuchong2: folds
mankar.am: calls $1
PlayTheBlues4U: calls $0.80
*** FLOP *** [7d Ad 3h]
mankar.am: bets $3.76 and is all-in
papabear127 joins the table at seat #5
PlayTheBlues4U: folds
Ty1erDurrden: calls $3.76
*** TURN *** [7d Ad 3h] [7c]
*** RIVER *** [7d Ad 3h 7c] [7s]
*** SHOW DOWN ***
mankar.am: shows [9s As] (a full house, Sevens full of Aces)
Ty1erDurrden: shows [Ac Qc] (a full house, Sevens full of Aces)
mankar.am collected $5.17 from pot
Ty1erDurrden collected $5.16 from pot
*** SUMMARY ***
Total pot $10.87 | Rake $0.54
Board [7d Ad 3h 7c 7s]
Seat 1: linghuchong2 (small blind) folded before Flop
Seat 2: mankar.am (big blind) showed [9s As] and won ($5.17) with a full house, Sevens full of Aces
Seat 3: PlayTheBlues4U folded on the Flop
Seat 4: SeaofLove folded before Flop (didn't bet)
Seat 6: Ty1erDurrden (button) showed [Ac Qc] and won ($5.16) with a full house, Sevens full of Aces


*********** # 111 **************
PokerStars Hand #205379000714:  Hold'em No Limit ($0.05/$0.10 USD) - 2019/11/02 22:26:15 ET
Table 'Antares' 6-max Seat #2 is the button
Seat 1: SeaofLove ($13.25 in chips)
Seat 2: PlayTheBlues4U ($12.96 in chips)
Seat 3: StickyChipss ($11.36 in chips)
Seat 6: boxerpupp727 ($10.10 in chips)
StickyChipss: posts small blind $0.05
boxerpupp727: posts big blind $0.10
*** HOLE CARDS ***
Dealt to PlayTheBlues4U [9d Th]
SeaofLove: folds
PlayTheBlues4U: raises $0.20 to $0.30
StickyChipss: folds
boxerpupp727: folds
Uncalled bet ($0.20) returned to PlayTheBlues4U
PlayTheBlues4U collected $0.25 from pot
PlayTheBlues4U: doesn't show hand
*** SUMMARY ***
Total pot $0.25 | Rake $0
Seat 1: SeaofLove folded before Flop (didn't bet)
Seat 2: PlayTheBlues4U (button) collected ($0.25)
Seat 3: StickyChipss (small blind) folded before Flop
Seat 6: boxerpupp727 (big blind) folded before Flop


*********** # 112 **************
PokerStars Hand #205379000682:  Hold'em No Limit ($0.05/$0.10 USD) - 2019/11/02 22:26:04 ET
Table 'Hekate' 6-max Seat #4 is the button
Seat 1: linghuchong2 ($2.39 in chips)
Seat 2: mankar.am ($4.71 in chips)
Seat 3: PlayTheBlues4U ($44.24 in chips)
Seat 4: SeaofLove ($11.20 in chips)
Seat 6: Ty1erDurrden ($10 in chips)
Ty1erDurrden: posts small blind $0.05
linghuchong2: posts big blind $0.10
*** HOLE CARDS ***
Dealt to PlayTheBlues4U [9s 7d]
mankar.am: raises $0.10 to $0.20
PlayTheBlues4U: folds
SeaofLove: folds
Ty1erDurrden: folds
linghuchong2: folds
Uncalled bet ($0.10) returned to mankar.am
mankar.am collected $0.25 from pot
mankar.am: doesn't show hand
*** SUMMARY ***
Total pot $0.25 | Rake $0
Seat 1: linghuchong2 (big blind) folded before Flop
Seat 2: mankar.am collected ($0.25)
Seat 3: PlayTheBlues4U folded before Flop (didn't bet)
Seat 4: SeaofLove (button) folded before Flop (didn't bet)
Seat 6: Ty1erDurrden (small blind) folded before Flop


*********** # 113 **************
PokerStars Hand #205379000650:  Hold'em No Limit ($0.05/$0.10 USD) - 2019/11/02 22:25:56 ET
Table 'Antares' 6-max Seat #1 is the button
Seat 1: SeaofLove ($13.25 in chips)
Seat 2: PlayTheBlues4U ($13.01 in chips)
Seat 3: StickyChipss ($11.46 in chips)
Seat 6: boxerpupp727 ($9.95 in chips)
PlayTheBlues4U: posts small blind $0.05
StickyChipss: posts big blind $0.10
*** HOLE CARDS ***
Dealt to PlayTheBlues4U [7s 4s]
boxerpupp727: raises $0.25 to $0.35
SeaofLove: folds
PlayTheBlues4U: folds
StickyChipss: folds
Uncalled bet ($0.25) returned to boxerpupp727
boxerpupp727 collected $0.25 from pot
boxerpupp727: doesn't show hand
*** SUMMARY ***
Total pot $0.25 | Rake $0
Seat 1: SeaofLove (button) folded before Flop (didn't bet)
Seat 2: PlayTheBlues4U (small blind) folded before Flop
Seat 3: StickyChipss (big blind) folded before Flop
Seat 6: boxerpupp727 collected ($0.25)


*********** # 114 **************
PokerStars Hand #205379000619:  Hold'em No Limit ($0.05/$0.10 USD) - 2019/11/02 22:25:46 ET
Table 'Antares' 6-max Seat #6 is the button
Seat 1: SeaofLove ($13.30 in chips)
Seat 2: PlayTheBlues4U ($13.11 in chips)
Seat 3: StickyChipss ($11.46 in chips)
Seat 6: boxerpupp727 ($9.80 in chips)
SeaofLove: posts small blind $0.05
PlayTheBlues4U: posts big blind $0.10
*** HOLE CARDS ***
Dealt to PlayTheBlues4U [3h 4c]
StickyChipss: folds
boxerpupp727: raises $0.25 to $0.35
SeaofLove: folds
PlayTheBlues4U: folds
Uncalled bet ($0.25) returned to boxerpupp727
boxerpupp727 collected $0.25 from pot
boxerpupp727: doesn't show hand
*** SUMMARY ***
Total pot $0.25 | Rake $0
Seat 1: SeaofLove (small blind) folded before Flop
Seat 2: PlayTheBlues4U (big blind) folded before Flop
Seat 3: StickyChipss folded before Flop (didn't bet)
Seat 6: boxerpupp727 (button) collected ($0.25)


*********** # 115 **************
PokerStars Hand #205379000557:  Hold'em No Limit ($0.05/$0.10 USD) - 2019/11/02 22:25:31 ET
Table 'Hekate' 6-max Seat #3 is the button
Seat 1: linghuchong2 ($2.07 in chips)
Seat 2: mankar.am ($4.71 in chips)
Seat 3: PlayTheBlues4U ($44.24 in chips)
Seat 4: SeaofLove ($11.25 in chips)
Seat 6: Ty1erDurrden ($10 in chips)
SeaofLove: posts small blind $0.05
Ty1erDurrden: posts big blind $0.10
*** HOLE CARDS ***
Dealt to PlayTheBlues4U [Qs 5d]
linghuchong2: calls $0.10
mankar.am: folds
PlayTheBlues4U: folds
SeaofLove: folds
Ty1erDurrden: checks
*** FLOP *** [8h Kh Jd]
Ty1erDurrden: checks
linghuchong2: checks
*** TURN *** [8h Kh Jd] [Js]
Ty1erDurrden: checks
linghuchong2: bets $0.20
Ty1erDurrden: calls $0.20
*** RIVER *** [8h Kh Jd Js] [8c]
Ty1erDurrden: checks
linghuchong2: bets $0.60
Ty1erDurrden: folds
Uncalled bet ($0.60) returned to linghuchong2
linghuchong2 collected $0.62 from pot
linghuchong2: doesn't show hand
*** SUMMARY ***
Total pot $0.65 | Rake $0.03
Board [8h Kh Jd Js 8c]
Seat 1: linghuchong2 collected ($0.62)
Seat 2: mankar.am folded before Flop (didn't bet)
Seat 3: PlayTheBlues4U (button) folded before Flop (didn't bet)
Seat 4: SeaofLove (small blind) folded before Flop
Seat 6: Ty1erDurrden (big blind) folded on the River


*********** # 116 **************
PokerStars Hand #205379000508:  Hold'em No Limit ($0.05/$0.10 USD) - 2019/11/02 22:25:16 ET
Table 'Antares' 6-max Seat #3 is the button
Seat 1: SeaofLove ($13.40 in chips)
Seat 2: PlayTheBlues4U ($12.96 in chips)
Seat 3: StickyChipss ($11.46 in chips)
Seat 6: boxerpupp727 ($9.85 in chips)
boxerpupp727: posts small blind $0.05
SeaofLove: posts big blind $0.10
*** HOLE CARDS ***
Dealt to PlayTheBlues4U [Jc 9c]
PlayTheBlues4U: raises $0.20 to $0.30
boxerpupp727 said, "sorry"
boxerpupp727 said, " busy"
StickyChipss: folds
boxerpupp727: folds
SeaofLove: folds
Uncalled bet ($0.20) returned to PlayTheBlues4U
PlayTheBlues4U collected $0.25 from pot
PlayTheBlues4U: doesn't show hand
*** SUMMARY ***
Total pot $0.25 | Rake $0
Seat 1: SeaofLove (big blind) folded before Flop
Seat 2: PlayTheBlues4U collected ($0.25)
Seat 3: StickyChipss (button) folded before Flop (didn't bet)
Seat 6: boxerpupp727 (small blind) folded before Flop


*********** # 117 **************
PokerStars Hand #205379000466:  Hold'em No Limit ($0.05/$0.10 USD) - 2019/11/02 22:25:07 ET
Table 'Hekate' 6-max Seat #2 is the button
Seat 1: linghuchong2 ($1.66 in chips)
Seat 2: mankar.am ($5.01 in chips)
Seat 3: PlayTheBlues4U ($44.29 in chips)
Seat 4: SeaofLove ($11.35 in chips)
Seat 6: Ty1erDurrden ($10 in chips)
PlayTheBlues4U: posts small blind $0.05
SeaofLove: posts big blind $0.10
*** HOLE CARDS ***
Dealt to PlayTheBlues4U [4h 9d]
Ty1erDurrden: folds
linghuchong2: raises $0.20 to $0.30
mankar.am: calls $0.30
PlayTheBlues4U: folds
SeaofLove: folds
*** FLOP *** [Kd 5d Tc]
linghuchong2: bets $0.70
mankar.am: folds
Uncalled bet ($0.70) returned to linghuchong2
linghuchong2 collected $0.71 from pot
linghuchong2: doesn't show hand
*** SUMMARY ***
Total pot $0.75 | Rake $0.04
Board [Kd 5d Tc]
Seat 1: linghuchong2 collected ($0.71)
Seat 2: mankar.am (button) folded on the Flop
Seat 3: PlayTheBlues4U (small blind) folded before Flop
Seat 4: SeaofLove (big blind) folded before Flop
Seat 6: Ty1erDurrden folded before Flop (didn't bet)


*********** # 118 **************
PokerStars Hand #205379000420:  Hold'em No Limit ($0.05/$0.10 USD) - 2019/11/02 22:24:52 ET
Table 'Hekate' 6-max Seat #1 is the button
Seat 1: linghuchong2 ($1.66 in chips)
Seat 2: mankar.am ($4.91 in chips)
Seat 3: PlayTheBlues4U ($44.39 in chips)
Seat 4: SeaofLove ($11.35 in chips)
Seat 6: Ty1erDurrden ($10 in chips)
mankar.am: posts small blind $0.05
PlayTheBlues4U: posts big blind $0.10
*** HOLE CARDS ***
Dealt to PlayTheBlues4U [8h 3c]
SeaofLove: folds
Ty1erDurrden: folds
linghuchong2: folds
mankar.am: raises $0.10 to $0.20
PlayTheBlues4U: folds
Uncalled bet ($0.10) returned to mankar.am
mankar.am collected $0.20 from pot
*** SUMMARY ***
Total pot $0.20 | Rake $0
Seat 1: linghuchong2 (button) folded before Flop (didn't bet)
Seat 2: mankar.am (small blind) collected ($0.20)
Seat 3: PlayTheBlues4U (big blind) folded before Flop
Seat 4: SeaofLove folded before Flop (didn't bet)
Seat 6: Ty1erDurrden folded before Flop (didn't bet)


*********** # 119 **************
PokerStars Hand #205379000307:  Hold'em No Limit ($0.05/$0.10 USD) - 2019/11/02 22:24:23 ET
Table 'Antares' 6-max Seat #2 is the button
Seat 1: SeaofLove ($13.40 in chips)
Seat 2: PlayTheBlues4U ($12.96 in chips)
Seat 3: StickyChipss ($11.36 in chips)
Seat 6: boxerpupp727 ($9.95 in chips)
StickyChipss: posts small blind $0.05
boxerpupp727: posts big blind $0.10
*** HOLE CARDS ***
Dealt to PlayTheBlues4U [7d 3d]
SeaofLove: folds
boxerpupp727 said, "at work"
PlayTheBlues4U: folds
StickyChipss: raises $0.20 to $0.30
boxerpupp727: folds
Uncalled bet ($0.20) returned to StickyChipss
StickyChipss collected $0.20 from pot
*** SUMMARY ***
Total pot $0.20 | Rake $0
Seat 1: SeaofLove folded before Flop (didn't bet)
Seat 2: PlayTheBlues4U (button) folded before Flop (didn't bet)
Seat 3: StickyChipss (small blind) collected ($0.20)
Seat 6: boxerpupp727 (big blind) folded before Flop


*********** # 120 **************
PokerStars Hand #205379000278:  Hold'em No Limit ($0.05/$0.10 USD) - 2019/11/02 22:24:15 ET
Table 'Antares' 6-max Seat #1 is the button
Seat 1: SeaofLove ($13.25 in chips)
Seat 2: PlayTheBlues4U ($13.01 in chips)
Seat 3: StickyChipss ($11.46 in chips)
PlayTheBlues4U: posts small blind $0.05
StickyChipss: posts big blind $0.10
boxerpupp727: sits out
*** HOLE CARDS ***
Dealt to PlayTheBlues4U [4s 5c]
SeaofLove: raises $0.15 to $0.25
PlayTheBlues4U: folds
StickyChipss: folds
Uncalled bet ($0.15) returned to SeaofLove
SeaofLove collected $0.25 from pot
SeaofLove: doesn't show hand
*** SUMMARY ***
Total pot $0.25 | Rake $0
Seat 1: SeaofLove (button) collected ($0.25)
Seat 2: PlayTheBlues4U (small blind) folded before Flop
Seat 3: StickyChipss (big blind) folded before Flop


*********** # 121 **************
PokerStars Hand #205379000245:  Hold'em No Limit ($0.05/$0.10 USD) - 2019/11/02 22:24:06 ET
Table 'Hekate' 6-max Seat #6 is the button
Seat 1: linghuchong2 ($1.71 in chips)
Seat 2: mankar.am ($4.32 in chips)
Seat 3: PlayTheBlues4U ($44.99 in chips)
Seat 4: SeaofLove ($11.35 in chips)
Seat 6: Ty1erDurrden ($10 in chips)
linghuchong2: posts small blind $0.05
mankar.am: posts big blind $0.10
*** HOLE CARDS ***
Dealt to PlayTheBlues4U [Kc Ks]
PlayTheBlues4U: raises $0.20 to $0.30
SeaofLove: folds
Ty1erDurrden: folds
linghuchong2: folds
mankar.am: calls $0.20
*** FLOP *** [2d Ad 7h]
mankar.am: checks
PlayTheBlues4U: checks
*** TURN *** [2d Ad 7h] [8s]
mankar.am: bets $0.30
PlayTheBlues4U: calls $0.30
*** RIVER *** [2d Ad 7h 8s] [3c]
mankar.am: bets $1.20
PlayTheBlues4U: folds
Uncalled bet ($1.20) returned to mankar.am
mankar.am collected $1.19 from pot
*** SUMMARY ***
Total pot $1.25 | Rake $0.06
Board [2d Ad 7h 8s 3c]
Seat 1: linghuchong2 (small blind) folded before Flop
Seat 2: mankar.am (big blind) collected ($1.19)
Seat 3: PlayTheBlues4U folded on the River
Seat 4: SeaofLove folded before Flop (didn't bet)
Seat 6: Ty1erDurrden (button) folded before Flop (didn't bet)


*********** # 122 **************
PokerStars Hand #205379000241:  Hold'em No Limit ($0.05/$0.10 USD) - 2019/11/02 22:24:05 ET
Table 'Antares' 6-max Seat #3 is the button
Seat 1: SeaofLove ($13.30 in chips)
Seat 2: PlayTheBlues4U ($12.96 in chips)
Seat 3: StickyChipss ($11.46 in chips)
SeaofLove: posts small blind $0.05
PlayTheBlues4U: posts big blind $0.10
*** HOLE CARDS ***
Dealt to PlayTheBlues4U [Qs 7h]
StickyChipss: folds
SeaofLove: folds
Uncalled bet ($0.05) returned to PlayTheBlues4U
PlayTheBlues4U collected $0.10 from pot
PlayTheBlues4U: doesn't show hand
*** SUMMARY ***
Total pot $0.10 | Rake $0
Seat 1: SeaofLove (small blind) folded before Flop
Seat 2: PlayTheBlues4U (big blind) collected ($0.10)
Seat 3: StickyChipss (button) folded before Flop (didn't bet)


*********** # 123 **************
PokerStars Hand #205379000207:  Hold'em No Limit ($0.05/$0.10 USD) - 2019/11/02 22:23:53 ET
Table 'Antares' 6-max Seat #2 is the button
Seat 1: SeaofLove ($13.25 in chips)
Seat 2: PlayTheBlues4U ($12.96 in chips)
Seat 3: StickyChipss ($11.51 in chips)
StickyChipss: posts small blind $0.05
SeaofLove: posts big blind $0.10
*** HOLE CARDS ***
Dealt to PlayTheBlues4U [4c Td]
PlayTheBlues4U: folds
StickyChipss: folds
Uncalled bet ($0.05) returned to SeaofLove
SeaofLove collected $0.10 from pot
SeaofLove: doesn't show hand
*** SUMMARY ***
Total pot $0.10 | Rake $0
Seat 1: SeaofLove (big blind) collected ($0.10)
Seat 2: PlayTheBlues4U (button) folded before Flop (didn't bet)
Seat 3: StickyChipss (small blind) folded before Flop


*********** # 124 **************
PokerStars Hand #205379000181:  Hold'em No Limit ($0.05/$0.10 USD) - 2019/11/02 22:23:45 ET
Table 'Hekate' 6-max Seat #4 is the button
Seat 1: linghuchong2 ($1.91 in chips)
Seat 2: mankar.am ($4.09 in chips)
Seat 3: PlayTheBlues4U ($44.99 in chips)
Seat 4: SeaofLove ($11.35 in chips)
Seat 6: Ty1erDurrden ($9.90 in chips)
Ty1erDurrden: posts small blind $0.05
linghuchong2: posts big blind $0.10
*** HOLE CARDS ***
Dealt to PlayTheBlues4U [Th 5d]
mankar.am: raises $0.10 to $0.20
PlayTheBlues4U: folds
SeaofLove: folds
Ty1erDurrden: folds
linghuchong2: calls $0.10
*** FLOP *** [Kd Ah 9h]
linghuchong2: checks
mankar.am: bets $0.20
linghuchong2: folds
Uncalled bet ($0.20) returned to mankar.am
mankar.am collected $0.43 from pot
*** SUMMARY ***
Total pot $0.45 | Rake $0.02
Board [Kd Ah 9h]
Seat 1: linghuchong2 (big blind) folded on the Flop
Seat 2: mankar.am collected ($0.43)
Seat 3: PlayTheBlues4U folded before Flop (didn't bet)
Seat 4: SeaofLove (button) folded before Flop (didn't bet)
Seat 6: Ty1erDurrden (small blind) folded before Flop


*********** # 125 **************
PokerStars Hand #205379000159:  Hold'em No Limit ($0.05/$0.10 USD) - 2019/11/02 22:23:39 ET
Table 'Antares' 6-max Seat #1 is the button
Seat 1: SeaofLove ($13.25 in chips)
Seat 2: PlayTheBlues4U ($13.01 in chips)
Seat 3: StickyChipss ($11.46 in chips)
PlayTheBlues4U: posts small blind $0.05
StickyChipss: posts big blind $0.10
*** HOLE CARDS ***
Dealt to PlayTheBlues4U [5s Jd]
SeaofLove: folds
PlayTheBlues4U: folds
Uncalled bet ($0.05) returned to StickyChipss
StickyChipss collected $0.10 from pot
*** SUMMARY ***
Total pot $0.10 | Rake $0
Seat 1: SeaofLove (button) folded before Flop (didn't bet)
Seat 2: PlayTheBlues4U (small blind) folded before Flop
Seat 3: StickyChipss (big blind) collected ($0.10)


*********** # 126 **************
PokerStars Hand #205377949968:  Hold'em No Limit ($0.05/$0.10 USD) - 2019/11/02 22:23:13 ET
Table 'Antares' 6-max Seat #3 is the button
Seat 1: SeaofLove ($13.35 in chips)
Seat 2: PlayTheBlues4U ($13.01 in chips)
Seat 3: StickyChipss ($11.31 in chips)
Seat 6: boxerpupp727 ($10 in chips)
boxerpupp727: posts small blind $0.05
SeaofLove: posts big blind $0.10
*** HOLE CARDS ***
Dealt to PlayTheBlues4U [4c 3h]
boxerpupp727 said, " nh sticky"
StickyChipss said, "TY"
boxerpupp727 said, "brb"
PlayTheBlues4U: folds
StickyChipss: raises $0.20 to $0.30
boxerpupp727: folds
SeaofLove: folds
Uncalled bet ($0.20) returned to StickyChipss
StickyChipss collected $0.25 from pot
*** SUMMARY ***
Total pot $0.25 | Rake $0
Seat 1: SeaofLove (big blind) folded before Flop
Seat 2: PlayTheBlues4U folded before Flop (didn't bet)
Seat 3: StickyChipss (button) collected ($0.25)
Seat 6: boxerpupp727 (small blind) folded before Flop


*********** # 127 **************
PokerStars Hand #205377949864:  Hold'em No Limit ($0.05/$0.10 USD) - 2019/11/02 22:22:50 ET
Table 'Antares' 6-max Seat #2 is the button
Seat 1: SeaofLove ($13.35 in chips)
Seat 2: PlayTheBlues4U ($13.01 in chips)
Seat 3: StickyChipss ($10.64 in chips)
Seat 6: boxerpupp727 ($10 in chips)
StickyChipss: posts small blind $0.05
boxerpupp727: posts big blind $0.10
*** HOLE CARDS ***
Dealt to PlayTheBlues4U [3c 2c]
SeaofLove: folds
PlayTheBlues4U: folds
boxerpupp727 said, "lol ps"
StickyChipss: raises $0.20 to $0.30
boxerpupp727: calls $0.20
*** FLOP *** [4h Js 5h]
StickyChipss: bets $0.44
boxerpupp727: calls $0.44
*** TURN *** [4h Js 5h] [9h]
StickyChipss: checks
boxerpupp727: checks
*** RIVER *** [4h Js 5h 9h] [6h]
StickyChipss: checks
boxerpupp727: checks
*** SHOW DOWN ***
StickyChipss: shows [Jc Jd] (three of a kind, Jacks)
boxerpupp727: mucks hand
StickyChipss collected $1.41 from pot
*** SUMMARY ***
Total pot $1.48 | Rake $0.07
Board [4h Js 5h 9h 6h]
Seat 1: SeaofLove folded before Flop (didn't bet)
Seat 2: PlayTheBlues4U (button) folded before Flop (didn't bet)
Seat 3: StickyChipss (small blind) showed [Jc Jd] and won ($1.41) with three of a kind, Jacks
Seat 6: boxerpupp727 (big blind) mucked [Ad Tc]


*********** # 128 **************
PokerStars Hand #205377949841:  Hold'em No Limit ($0.05/$0.10 USD) - 2019/11/02 22:22:42 ET
Table 'Hekate' 6-max Seat #3 is the button
Seat 1: linghuchong2 ($9.21 in chips)
Seat 2: mankar.am ($4.49 in chips)
Seat 3: PlayTheBlues4U ($37.90 in chips)
Seat 4: SeaofLove ($11.40 in chips)
Seat 6: Ty1erDurrden ($10 in chips)
SeaofLove: posts small blind $0.05
Ty1erDurrden: posts big blind $0.10
*** HOLE CARDS ***
Dealt to PlayTheBlues4U [Js Jd]
linghuchong2: calls $0.10
mankar.am: calls $0.10
PlayTheBlues4U: raises $0.30 to $0.40
SeaofLove: folds
Ty1erDurrden: folds
linghuchong2: calls $0.30
mankar.am: calls $0.30
*** FLOP *** [2d 2h 3h]
linghuchong2: checks
mankar.am: checks
PlayTheBlues4U: bets $0.90
linghuchong2: calls $0.90
mankar.am: folds
*** TURN *** [2d 2h 3h] [6d]
linghuchong2: checks
PlayTheBlues4U: bets $2.30
linghuchong2: calls $2.30
*** RIVER *** [2d 2h 3h 6d] [7s]
linghuchong2: bets $3.70
PlayTheBlues4U: calls $3.70
*** SHOW DOWN ***
linghuchong2: shows [3d As] (two pair, Threes and Deuces)
PlayTheBlues4U: shows [Js Jd] (two pair, Jacks and Deuces)
PlayTheBlues4U collected $14.39 from pot
*** SUMMARY ***
Total pot $15.15 | Rake $0.76
Board [2d 2h 3h 6d 7s]
Seat 1: linghuchong2 showed [3d As] and lost with two pair, Threes and Deuces
Seat 2: mankar.am folded on the Flop
Seat 3: PlayTheBlues4U (button) showed [Js Jd] and won ($14.39) with two pair, Jacks and Deuces
Seat 4: SeaofLove (small blind) folded before Flop
Seat 6: Ty1erDurrden (big blind) folded before Flop


*********** # 129 **************
PokerStars Hand #205377949838:  Hold'em No Limit ($0.05/$0.10 USD) - 2019/11/02 22:22:41 ET
Table 'Antares' 6-max Seat #1 is the button
Seat 1: SeaofLove ($13.35 in chips)
Seat 2: PlayTheBlues4U ($13.06 in chips)
Seat 3: StickyChipss ($10.59 in chips)
Seat 6: boxerpupp727 ($10 in chips)
PlayTheBlues4U: posts small blind $0.05
StickyChipss: posts big blind $0.10
*** HOLE CARDS ***
Dealt to PlayTheBlues4U [5c Tc]
boxerpupp727: folds
SeaofLove: folds
PlayTheBlues4U: folds
Uncalled bet ($0.05) returned to StickyChipss
boxerpupp727 said, "sick"
StickyChipss collected $0.10 from pot
*** SUMMARY ***
Total pot $0.10 | Rake $0
Seat 1: SeaofLove (button) folded before Flop (didn't bet)
Seat 2: PlayTheBlues4U (small blind) folded before Flop
Seat 3: StickyChipss (big blind) collected ($0.10)
Seat 6: boxerpupp727 folded before Flop (didn't bet)


*********** # 130 **************
PokerStars Hand #205377949789:  Hold'em No Limit ($0.05/$0.10 USD) - 2019/11/02 22:22:26 ET
Table 'Hekate' 6-max Seat #2 is the button
Seat 1: linghuchong2 ($9.21 in chips)
Seat 2: mankar.am ($4.49 in chips)
Seat 3: PlayTheBlues4U ($37.95 in chips)
Seat 4: SeaofLove ($11.35 in chips)
Seat 6: Ty1erDurrden ($10 in chips)
PlayTheBlues4U: posts small blind $0.05
SeaofLove: posts big blind $0.10
*** HOLE CARDS ***
Dealt to PlayTheBlues4U [Kc 6c]
Ty1erDurrden: folds
linghuchong2: folds
mankar.am: folds
PlayTheBlues4U: folds
Uncalled bet ($0.05) returned to SeaofLove
SeaofLove collected $0.10 from pot
SeaofLove: doesn't show hand
*** SUMMARY ***
Total pot $0.10 | Rake $0
Seat 1: linghuchong2 folded before Flop (didn't bet)
Seat 2: mankar.am (button) folded before Flop (didn't bet)
Seat 3: PlayTheBlues4U (small blind) folded before Flop
Seat 4: SeaofLove (big blind) collected ($0.10)
Seat 6: Ty1erDurrden folded before Flop (didn't bet)


*********** # 131 **************
PokerStars Hand #205377949716:  Hold'em No Limit ($0.05/$0.10 USD) - 2019/11/02 22:22:06 ET
Table 'Antares' 6-max Seat #6 is the button
Seat 1: SeaofLove ($13.40 in chips)
Seat 2: PlayTheBlues4U ($13.16 in chips)
Seat 3: StickyChipss ($10.65 in chips)
Seat 6: boxerpupp727 ($10 in chips)
SeaofLove: posts small blind $0.05
PlayTheBlues4U: posts big blind $0.10
*** HOLE CARDS ***
Dealt to PlayTheBlues4U [Jh 6d]
StickyChipss: raises $0.20 to $0.30
boxerpupp727: folds
SeaofLove: calls $0.25
PlayTheBlues4U: folds
*** FLOP *** [Qd Ad Jd]
SeaofLove: checks
StickyChipss: bets $0.51
SeaofLove: calls $0.51
*** TURN *** [Qd Ad Jd] [Td]
SeaofLove: checks
StickyChipss: bets $1.26
SeaofLove: calls $1.26
*** RIVER *** [Qd Ad Jd Td] [Kd]
SeaofLove: checks
StickyChipss: checks
*** SHOW DOWN ***
SeaofLove: shows [Ac Qh] (a Royal Flush)
StickyChipss: shows [Ks Qs] (a Royal Flush)
SeaofLove collected $2.02 from pot
StickyChipss collected $2.01 from pot
boxerpupp727 said, "wow"
*** SUMMARY ***
Total pot $4.24 | Rake $0.21
Board [Qd Ad Jd Td Kd]
Seat 1: SeaofLove (small blind) showed [Ac Qh] and won ($2.02) with a Royal Flush
Seat 2: PlayTheBlues4U (big blind) folded before Flop
Seat 3: StickyChipss showed [Ks Qs] and won ($2.01) with a Royal Flush
Seat 6: boxerpupp727 (button) folded before Flop (didn't bet)


*********** # 132 **************
PokerStars Hand #205377949710:  Hold'em No Limit ($0.05/$0.10 USD) - 2019/11/02 22:22:06 ET
Table 'Hekate' 6-max Seat #1 is the button
Seat 1: linghuchong2 ($9.21 in chips)
Seat 2: mankar.am ($4.74 in chips)
Seat 3: PlayTheBlues4U ($38.05 in chips)
Seat 4: SeaofLove ($11.03 in chips)
Seat 6: Ty1erDurrden ($10 in chips)
mankar.am: posts small blind $0.05
PlayTheBlues4U: posts big blind $0.10
*** HOLE CARDS ***
Dealt to PlayTheBlues4U [5c Jc]
SeaofLove: raises $0.15 to $0.25
Ty1erDurrden: folds
linghuchong2: folds
mankar.am: calls $0.20
PlayTheBlues4U: folds
*** FLOP *** [6d Ac 3d]
mankar.am: checks
SeaofLove: bets $0.38
mankar.am: folds
Uncalled bet ($0.38) returned to SeaofLove
SeaofLove collected $0.57 from pot
SeaofLove: doesn't show hand
*** SUMMARY ***
Total pot $0.60 | Rake $0.03
Board [6d Ac 3d]
Seat 1: linghuchong2 (button) folded before Flop (didn't bet)
Seat 2: mankar.am (small blind) folded on the Flop
Seat 3: PlayTheBlues4U (big blind) folded before Flop
Seat 4: SeaofLove collected ($0.57)
Seat 6: Ty1erDurrden folded before Flop (didn't bet)


*********** # 133 **************
PokerStars Hand #205377949674:  Hold'em No Limit ($0.05/$0.10 USD) - 2019/11/02 22:21:57 ET
Table 'Antares' 6-max Seat #3 is the button
Seat 1: SeaofLove ($13.50 in chips)
Seat 2: PlayTheBlues4U ($13.16 in chips)
Seat 3: StickyChipss ($10.50 in chips)
Seat 6: boxerpupp727 ($9.20 in chips)
boxerpupp727: posts small blind $0.05
SeaofLove: posts big blind $0.10
*** HOLE CARDS ***
Dealt to PlayTheBlues4U [3d 8c]
PlayTheBlues4U: folds
StickyChipss: raises $0.20 to $0.30
boxerpupp727: folds
SeaofLove: folds
Uncalled bet ($0.20) returned to StickyChipss
StickyChipss collected $0.25 from pot
*** SUMMARY ***
Total pot $0.25 | Rake $0
Seat 1: SeaofLove (big blind) folded before Flop
Seat 2: PlayTheBlues4U folded before Flop (didn't bet)
Seat 3: StickyChipss (button) collected ($0.25)
Seat 6: boxerpupp727 (small blind) folded before Flop


*********** # 134 **************
PokerStars Hand #205377949638:  Hold'em No Limit ($0.05/$0.10 USD) - 2019/11/02 22:21:47 ET
Table 'Hekate' 6-max Seat #6 is the button
Seat 1: linghuchong2 ($9.26 in chips)
Seat 2: mankar.am ($4.84 in chips)
Seat 3: PlayTheBlues4U ($37.90 in chips)
Seat 4: SeaofLove ($11.03 in chips)
Seat 6: Ty1erDurrden ($10 in chips)
linghuchong2: posts small blind $0.05
mankar.am: posts big blind $0.10
*** HOLE CARDS ***
Dealt to PlayTheBlues4U [Kc Ks]
PlayTheBlues4U: raises $0.20 to $0.30
SeaofLove: folds
Ty1erDurrden: folds
linghuchong2: folds
mankar.am: folds
Uncalled bet ($0.20) returned to PlayTheBlues4U
PlayTheBlues4U collected $0.25 from pot
PlayTheBlues4U: doesn't show hand
*** SUMMARY ***
Total pot $0.25 | Rake $0
Seat 1: linghuchong2 (small blind) folded before Flop
Seat 2: mankar.am (big blind) folded before Flop
Seat 3: PlayTheBlues4U collected ($0.25)
Seat 4: SeaofLove folded before Flop (didn't bet)
Seat 6: Ty1erDurrden (button) folded before Flop (didn't bet)


*********** # 135 **************
PokerStars Hand #205377949599:  Hold'em No Limit ($0.05/$0.10 USD) - 2019/11/02 22:21:38 ET
Table 'Hekate' 6-max Seat #4 is the button
Seat 1: linghuchong2 ($9.21 in chips)
Seat 2: mankar.am ($4.84 in chips)
Seat 3: PlayTheBlues4U ($37.90 in chips)
Seat 4: SeaofLove ($11.03 in chips)
Seat 6: Ty1erDurrden ($9.90 in chips)
Ty1erDurrden: posts small blind $0.05
linghuchong2: posts big blind $0.10
*** HOLE CARDS ***
Dealt to PlayTheBlues4U [9h Ts]
mankar.am: folds
PlayTheBlues4U: folds
SeaofLove: folds
Ty1erDurrden: folds
Uncalled bet ($0.05) returned to linghuchong2
linghuchong2 collected $0.10 from pot
linghuchong2: doesn't show hand
*** SUMMARY ***
Total pot $0.10 | Rake $0
Seat 1: linghuchong2 (big blind) collected ($0.10)
Seat 2: mankar.am folded before Flop (didn't bet)
Seat 3: PlayTheBlues4U folded before Flop (didn't bet)
Seat 4: SeaofLove (button) folded before Flop (didn't bet)
Seat 6: Ty1erDurrden (small blind) folded before Flop


*********** # 136 **************
PokerStars Hand #205377949556:  Hold'em No Limit ($0.05/$0.10 USD) - 2019/11/02 22:21:27 ET
Table 'Antares' 6-max Seat #2 is the button
Seat 1: SeaofLove ($12.41 in chips)
Seat 2: PlayTheBlues4U ($13.16 in chips)
Seat 3: StickyChipss ($10.75 in chips)
Seat 6: boxerpupp727 ($10.15 in chips)
StickyChipss: posts small blind $0.05
rope-a-dope8: is sitting out
Jariso13: is sitting out
boxerpupp727: posts big blind $0.10
*** HOLE CARDS ***
Dealt to PlayTheBlues4U [Kd Ts]
rope-a-dope8 leaves the table
SeaofLove: raises $0.15 to $0.25
PlayTheBlues4U: folds
StickyChipss: calls $0.20
boxerpupp727: calls $0.15
*** FLOP *** [Ah 4d 5h]
Jariso13 leaves the table
StickyChipss: checks
boxerpupp727: bets $0.70
SeaofLove: calls $0.70
StickyChipss: folds
*** TURN *** [Ah 4d 5h] [2d]
boxerpupp727: checks
SeaofLove: checks
*** RIVER *** [Ah 4d 5h 2d] [Kc]
boxerpupp727: checks
SeaofLove: checks
*** SHOW DOWN ***
boxerpupp727: shows [8h Qh] (high card Ace)
SeaofLove: shows [As Qc] (a pair of Aces)
SeaofLove collected $2.04 from pot
*** SUMMARY ***
Total pot $2.15 | Rake $0.11
Board [Ah 4d 5h 2d Kc]
Seat 1: SeaofLove showed [As Qc] and won ($2.04) with a pair of Aces
Seat 2: PlayTheBlues4U (button) folded before Flop (didn't bet)
Seat 3: StickyChipss (small blind) folded on the Flop
Seat 6: boxerpupp727 (big blind) showed [8h Qh] and lost with high card Ace


*********** # 137 **************
PokerStars Hand #205377949481:  Hold'em No Limit ($0.05/$0.10 USD) - 2019/11/02 22:21:10 ET
Table 'Antares' 6-max Seat #1 is the button
Seat 1: SeaofLove ($12.41 in chips)
Seat 2: PlayTheBlues4U ($13.21 in chips)
Seat 3: StickyChipss ($10.85 in chips)
Seat 4: rope-a-dope8 ($18.08 in chips)
Seat 5: Jariso13 ($13.23 in chips)
Seat 6: boxerpupp727 ($10 in chips)
PlayTheBlues4U: posts small blind $0.05
StickyChipss: posts big blind $0.10
*** HOLE CARDS ***
Dealt to PlayTheBlues4U [3c Ts]
boxerpupp727 said, "gh"
rope-a-dope8: folds
Jariso13: folds
boxerpupp727: raises $0.25 to $0.35
SeaofLove: folds
PlayTheBlues4U: folds
StickyChipss: folds
Uncalled bet ($0.25) returned to boxerpupp727
boxerpupp727 collected $0.25 from pot
boxerpupp727: doesn't show hand
*** SUMMARY ***
Total pot $0.25 | Rake $0
Seat 1: SeaofLove (button) folded before Flop (didn't bet)
Seat 2: PlayTheBlues4U (small blind) folded before Flop
Seat 3: StickyChipss (big blind) folded before Flop
Seat 4: rope-a-dope8 folded before Flop (didn't bet)
Seat 5: Jariso13 folded before Flop (didn't bet)
Seat 6: boxerpupp727 collected ($0.25)


*********** # 138 **************
PokerStars Hand #205377949463:  Hold'em No Limit ($0.05/$0.10 USD) - 2019/11/02 22:21:05 ET
Table 'Hekate' 6-max Seat #3 is the button
Seat 1: linghuchong2 ($9.21 in chips)
Seat 2: mankar.am ($5.34 in chips)
Seat 3: PlayTheBlues4U ($37.90 in chips)
Seat 4: SeaofLove ($10.49 in chips)
Seat 6: Ty1erDurrden ($10 in chips)
SeaofLove: posts small blind $0.05
Ty1erDurrden: posts big blind $0.10
*** HOLE CARDS ***
Dealt to PlayTheBlues4U [4h Qc]
linghuchong2: folds
mankar.am: raises $0.10 to $0.20
PlayTheBlues4U: folds
SeaofLove: calls $0.15
Ty1erDurrden: folds
*** FLOP *** [Ah 2h 4d]
SeaofLove: checks
mankar.am: checks
*** TURN *** [Ah 2h 4d] [7h]
SeaofLove: bets $0.30
mankar.am: calls $0.30
*** RIVER *** [Ah 2h 4d 7h] [3d]
SeaofLove: checks
mankar.am: checks
*** SHOW DOWN ***
SeaofLove: shows [Qd Kh] (high card Ace)
mankar.am: mucks hand
SeaofLove collected $1.04 from pot
*** SUMMARY ***
Total pot $1.10 | Rake $0.06
Board [Ah 2h 4d 7h 3d]
Seat 1: linghuchong2 folded before Flop (didn't bet)
Seat 2: mankar.am mucked [9s Kd]
Seat 3: PlayTheBlues4U (button) folded before Flop (didn't bet)
Seat 4: SeaofLove (small blind) showed [Qd Kh] and won ($1.04) with high card Ace
Seat 6: Ty1erDurrden (big blind) folded before Flop


*********** # 139 **************
PokerStars Hand #205377949342:  Hold'em No Limit ($0.05/$0.10 USD) - 2019/11/02 22:20:34 ET
Table 'Hekate' 6-max Seat #2 is the button
Seat 1: linghuchong2 ($9.21 in chips)
Seat 2: mankar.am ($5.20 in chips)
Seat 3: PlayTheBlues4U ($37.95 in chips)
Seat 4: SeaofLove ($10.59 in chips)
Seat 5: rope-a-dope8 ($11 in chips)
Seat 6: Ty1erDurrden ($10 in chips)
PlayTheBlues4U: posts small blind $0.05
SeaofLove: posts big blind $0.10
*** HOLE CARDS ***
Dealt to PlayTheBlues4U [2d Jd]
rope-a-dope8: folds
rope-a-dope8 leaves the table
Ty1erDurrden: folds
linghuchong2: folds
mankar.am: calls $0.10
PlayTheBlues4U: folds
SeaofLove: checks
*** FLOP *** [Jh 5c 4c]
SeaofLove: checks
mankar.am: checks
*** TURN *** [Jh 5c 4c] [9d]
SeaofLove: checks
mankar.am: bets $0.10
SeaofLove: folds
Uncalled bet ($0.10) returned to mankar.am
mankar.am collected $0.24 from pot
*** SUMMARY ***
Total pot $0.25 | Rake $0.01
Board [Jh 5c 4c 9d]
Seat 1: linghuchong2 folded before Flop (didn't bet)
Seat 2: mankar.am (button) collected ($0.24)
Seat 3: PlayTheBlues4U (small blind) folded before Flop
Seat 4: SeaofLove (big blind) folded on the Turn
Seat 5: rope-a-dope8 folded before Flop (didn't bet)
Seat 6: Ty1erDurrden folded before Flop (didn't bet)


*********** # 140 **************
PokerStars Hand #205377949269:  Hold'em No Limit ($0.05/$0.10 USD) - 2019/11/02 22:20:14 ET
Table 'Antares' 6-max Seat #6 is the button
Seat 1: SeaofLove ($10 in chips)
Seat 2: PlayTheBlues4U ($13.31 in chips)
Seat 3: StickyChipss ($10.85 in chips)
Seat 4: rope-a-dope8 ($18.08 in chips)
Seat 5: Jariso13 ($13.33 in chips)
Seat 6: boxerpupp727 ($9.85 in chips)
SeaofLove: posts small blind $0.05
PlayTheBlues4U: posts big blind $0.10
*** HOLE CARDS ***
Dealt to PlayTheBlues4U [7s 8s]
StickyChipss: folds
rope-a-dope8: folds
Jariso13: calls $0.10
boxerpupp727: raises $0.45 to $0.55
SeaofLove: calls $0.50
PlayTheBlues4U: folds
Jariso13: folds
*** FLOP *** [Js Td 9s]
SeaofLove: bets $0.62
boxerpupp727: calls $0.62
*** TURN *** [Js Td 9s] [2c]
SeaofLove: bets $1.30
boxerpupp727: calls $1.30
*** RIVER *** [Js Td 9s 2c] [3d]
SeaofLove: bets $2.44
boxerpupp727: folds
Uncalled bet ($2.44) returned to SeaofLove
SeaofLove collected $4.88 from pot
SeaofLove: doesn't show hand
*** SUMMARY ***
Total pot $5.14 | Rake $0.26
Board [Js Td 9s 2c 3d]
Seat 1: SeaofLove (small blind) collected ($4.88)
Seat 2: PlayTheBlues4U (big blind) folded before Flop
Seat 3: StickyChipss folded before Flop (didn't bet)
Seat 4: rope-a-dope8 folded before Flop (didn't bet)
Seat 5: Jariso13 folded before Flop
Seat 6: boxerpupp727 (button) folded on the River


*********** # 141 **************
PokerStars Hand #205377949202:  Hold'em No Limit ($0.05/$0.10 USD) - 2019/11/02 22:19:57 ET
Table 'Hekate' 6-max Seat #1 is the button
Seat 1: linghuchong2 ($8.01 in chips)
Seat 2: mankar.am ($5.75 in chips)
Seat 3: PlayTheBlues4U ($38.05 in chips)
Seat 4: SeaofLove ($10.59 in chips)
Seat 5: rope-a-dope8 ($11 in chips)
Seat 6: Ty1erDurrden ($10 in chips)
mankar.am: posts small blind $0.05
PlayTheBlues4U: posts big blind $0.10
*** HOLE CARDS ***
Dealt to PlayTheBlues4U [3h Kc]
SeaofLove: folds
rope-a-dope8: folds
Ty1erDurrden: raises $0.15 to $0.25
linghuchong2: raises $0.15 to $0.40
mankar.am: raises $0.15 to $0.55
PlayTheBlues4U: folds
Ty1erDurrden: calls $0.30
linghuchong2: raises $7.46 to $8.01 and is all-in
mankar.am: folds
Ty1erDurrden: folds
Uncalled bet ($7.46) returned to linghuchong2
linghuchong2 collected $1.75 from pot
linghuchong2: doesn't show hand
*** SUMMARY ***
Total pot $1.75 | Rake $0
Seat 1: linghuchong2 (button) collected ($1.75)
Seat 2: mankar.am (small blind) folded before Flop
Seat 3: PlayTheBlues4U (big blind) folded before Flop
Seat 4: SeaofLove folded before Flop (didn't bet)
Seat 5: rope-a-dope8 folded before Flop (didn't bet)
Seat 6: Ty1erDurrden folded before Flop


*********** # 142 **************
PokerStars Hand #205377949175:  Hold'em No Limit ($0.05/$0.10 USD) - 2019/11/02 22:19:49 ET
Table 'Antares' 6-max Seat #5 is the button
Seat 1: SeaofLove ($10 in chips)
Seat 2: PlayTheBlues4U ($13.31 in chips)
Seat 3: StickyChipss ($10.85 in chips)
Seat 4: rope-a-dope8 ($17.93 in chips)
Seat 5: Jariso13 ($13.33 in chips)
Seat 6: boxerpupp727 ($9.90 in chips)
boxerpupp727: posts small blind $0.05
SeaofLove: posts big blind $0.10
*** HOLE CARDS ***
Dealt to PlayTheBlues4U [2d 8d]
PlayTheBlues4U: folds
StickyChipss: folds
rope-a-dope8: raises $0.25 to $0.35
Jariso13: folds
boxerpupp727: folds
SeaofLove: folds
Uncalled bet ($0.25) returned to rope-a-dope8
rope-a-dope8 collected $0.25 from pot
rope-a-dope8: doesn't show hand
*** SUMMARY ***
Total pot $0.25 | Rake $0
Seat 1: SeaofLove (big blind) folded before Flop
Seat 2: PlayTheBlues4U folded before Flop (didn't bet)
Seat 3: StickyChipss folded before Flop (didn't bet)
Seat 4: rope-a-dope8 collected ($0.25)
Seat 5: Jariso13 (button) folded before Flop (didn't bet)
Seat 6: boxerpupp727 (small blind) folded before Flop


*********** # 143 **************
PokerStars Hand #205377949079:  Hold'em No Limit ($0.05/$0.10 USD) - 2019/11/02 22:19:25 ET
Table 'Antares' 6-max Seat #4 is the button
Seat 1: TonyA747 ($20.20 in chips)
Seat 2: PlayTheBlues4U ($13.31 in chips)
Seat 3: StickyChipss ($10.85 in chips)
Seat 4: rope-a-dope8 ($17.78 in chips)
Seat 5: Jariso13 ($13.38 in chips)
Seat 6: boxerpupp727 ($10 in chips)
Jariso13: posts small blind $0.05
boxerpupp727: posts big blind $0.10
*** HOLE CARDS ***
Dealt to PlayTheBlues4U [5h 4s]
TonyA747: folds
PlayTheBlues4U: folds
StickyChipss: folds
rope-a-dope8: raises $0.30 to $0.40
TonyA747 leaves the table
Jariso13: folds
SeaofLove joins the table at seat #1
boxerpupp727: folds
Uncalled bet ($0.30) returned to rope-a-dope8
rope-a-dope8 collected $0.25 from pot
rope-a-dope8: doesn't show hand
*** SUMMARY ***
Total pot $0.25 | Rake $0
Seat 1: TonyA747 folded before Flop (didn't bet)
Seat 2: PlayTheBlues4U folded before Flop (didn't bet)
Seat 3: StickyChipss folded before Flop (didn't bet)
Seat 4: rope-a-dope8 (button) collected ($0.25)
Seat 5: Jariso13 (small blind) folded before Flop
Seat 6: boxerpupp727 (big blind) folded before Flop


*********** # 144 **************
PokerStars Hand #205377949050:  Hold'em No Limit ($0.05/$0.10 USD) - 2019/11/02 22:19:18 ET
Table 'Hekate' 6-max Seat #6 is the button
Seat 1: linghuchong2 ($8.06 in chips)
Seat 2: mankar.am ($6.95 in chips)
Seat 3: PlayTheBlues4U ($36.92 in chips)
Seat 4: SeaofLove ($10.59 in chips)
Seat 5: rope-a-dope8 ($11 in chips)
Seat 6: Ty1erDurrden ($10 in chips)
linghuchong2: posts small blind $0.05
mankar.am: posts big blind $0.10
*** HOLE CARDS ***
Dealt to PlayTheBlues4U [Tc Ts]
PlayTheBlues4U: raises $0.20 to $0.30
SeaofLove: folds
rope-a-dope8: folds
Ty1erDurrden: folds
linghuchong2: folds
mankar.am: raises $0.20 to $0.50
PlayTheBlues4U: calls $0.20
*** FLOP *** [5d 2d 8h]
mankar.am: checks
PlayTheBlues4U: bets $0.70
mankar.am: calls $0.70
*** TURN *** [5d 2d 8h] [6h]
mankar.am: checks
PlayTheBlues4U: bets $1.60
mankar.am: folds
Uncalled bet ($1.60) returned to PlayTheBlues4U
PlayTheBlues4U collected $2.33 from pot
PlayTheBlues4U: doesn't show hand
*** SUMMARY ***
Total pot $2.45 | Rake $0.12
Board [5d 2d 8h 6h]
Seat 1: linghuchong2 (small blind) folded before Flop
Seat 2: mankar.am (big blind) folded on the Turn
Seat 3: PlayTheBlues4U collected ($2.33)
Seat 4: SeaofLove folded before Flop (didn't bet)
Seat 5: rope-a-dope8 folded before Flop (didn't bet)
Seat 6: Ty1erDurrden (button) folded before Flop (didn't bet)


*********** # 145 **************
PokerStars Hand #205377948907:  Hold'em No Limit ($0.05/$0.10 USD) - 2019/11/02 22:18:40 ET
Table 'Antares' 6-max Seat #3 is the button
Seat 1: TonyA747 ($20.55 in chips)
Seat 2: PlayTheBlues4U ($13.31 in chips)
Seat 3: StickyChipss ($10 in chips)
Seat 4: rope-a-dope8 ($17.83 in chips)
Seat 5: Jariso13 ($13.48 in chips)
Seat 6: boxerpupp727 ($10 in chips)
rope-a-dope8: posts small blind $0.05
Jariso13: posts big blind $0.10
*** HOLE CARDS ***
Dealt to PlayTheBlues4U [2d 5s]
boxerpupp727: raises $0.25 to $0.35
TonyA747: calls $0.35
PlayTheBlues4U: folds
StickyChipss: raises $9.65 to $10 and is all-in
rope-a-dope8: folds
Jariso13: folds
boxerpupp727: folds
TonyA747: folds
Uncalled bet ($9.65) returned to StickyChipss
StickyChipss collected $1.20 from pot
*** SUMMARY ***
Total pot $1.20 | Rake $0
Seat 1: TonyA747 folded before Flop
Seat 2: PlayTheBlues4U folded before Flop (didn't bet)
Seat 3: StickyChipss (button) collected ($1.20)
Seat 4: rope-a-dope8 (small blind) folded before Flop
Seat 5: Jariso13 (big blind) folded before Flop
Seat 6: boxerpupp727 folded before Flop


*********** # 146 **************
PokerStars Hand #205377948885:  Hold'em No Limit ($0.05/$0.10 USD) - 2019/11/02 22:18:35 ET
Table 'Hekate' 6-max Seat #5 is the button
Seat 1: linghuchong2 ($6.57 in chips)
Seat 2: mankar.am ($8.55 in chips)
Seat 3: PlayTheBlues4U ($36.92 in chips)
Seat 4: SeaofLove ($10.59 in chips)
Seat 5: rope-a-dope8 ($11 in chips)
Seat 6: Ty1erDurrden ($9.90 in chips)
Ty1erDurrden: posts small blind $0.05
linghuchong2: posts big blind $0.10
*** HOLE CARDS ***
Dealt to PlayTheBlues4U [Kc 9c]
mankar.am: raises $0.10 to $0.20
PlayTheBlues4U: folds
SeaofLove: folds
rope-a-dope8: folds
Ty1erDurrden: folds
linghuchong2: calls $0.10
*** FLOP *** [7h 7c 8h]
linghuchong2: checks
mankar.am: bets $0.20
linghuchong2: calls $0.20
*** TURN *** [7h 7c 8h] [Th]
linghuchong2: checks
mankar.am: bets $0.40
linghuchong2: calls $0.40
*** RIVER *** [7h 7c 8h Th] [Td]
linghuchong2: checks
mankar.am: bets $0.80
linghuchong2: calls $0.80
*** SHOW DOWN ***
mankar.am: shows [Kd 5c] (two pair, Tens and Sevens)
linghuchong2: shows [8c 6c] (two pair, Tens and Eights)
linghuchong2 collected $3.09 from pot
*** SUMMARY ***
Total pot $3.25 | Rake $0.16
Board [7h 7c 8h Th Td]
Seat 1: linghuchong2 (big blind) showed [8c 6c] and won ($3.09) with two pair, Tens and Eights
Seat 2: mankar.am showed [Kd 5c] and lost with two pair, Tens and Sevens
Seat 3: PlayTheBlues4U folded before Flop (didn't bet)
Seat 4: SeaofLove folded before Flop (didn't bet)
Seat 5: rope-a-dope8 (button) folded before Flop (didn't bet)
Seat 6: Ty1erDurrden (small blind) folded before Flop


*********** # 147 **************
PokerStars Hand #205377948756:  Hold'em No Limit ($0.05/$0.10 USD) - 2019/11/02 22:18:00 ET
Table 'Hekate' 6-max Seat #4 is the button
Seat 1: linghuchong2 ($7.07 in chips)
Seat 2: mankar.am ($8.65 in chips)
Seat 3: PlayTheBlues4U ($36.92 in chips)
Seat 4: SeaofLove ($10.59 in chips)
Seat 5: rope-a-dope8 ($10.36 in chips)
Seat 6: Ty1erDurrden ($10 in chips)
rope-a-dope8: posts small blind $0.05
Ty1erDurrden: posts big blind $0.10
mankar.am: posts big blind $0.10
*** HOLE CARDS ***
Dealt to PlayTheBlues4U [6h 3c]
linghuchong2: calls $0.10
mankar.am: checks
PlayTheBlues4U: folds
SeaofLove: folds
rope-a-dope8: raises $0.40 to $0.50
Ty1erDurrden: folds
linghuchong2: calls $0.40
mankar.am: folds
*** FLOP *** [2c 7h 3s]
rope-a-dope8: bets $0.86
linghuchong2: folds
Uncalled bet ($0.86) returned to rope-a-dope8
rope-a-dope8 collected $1.14 from pot
rope-a-dope8: doesn't show hand
*** SUMMARY ***
Total pot $1.20 | Rake $0.06
Board [2c 7h 3s]
Seat 1: linghuchong2 folded on the Flop
Seat 2: mankar.am folded before Flop (didn't bet)
Seat 3: PlayTheBlues4U folded before Flop (didn't bet)
Seat 4: SeaofLove (button) folded before Flop (didn't bet)
Seat 5: rope-a-dope8 (small blind) collected ($1.14)
Seat 6: Ty1erDurrden (big blind) folded before Flop


*********** # 148 **************
PokerStars Hand #205377948726:  Hold'em No Limit ($0.05/$0.10 USD) - 2019/11/02 22:17:52 ET
Table 'Hekate' 6-max Seat #3 is the button
Seat 1: linghuchong2 ($7.07 in chips)
Seat 3: PlayTheBlues4U ($36.77 in chips)
Seat 4: SeaofLove ($10.64 in chips)
Seat 5: rope-a-dope8 ($10.46 in chips)
SeaofLove: posts small blind $0.05
rope-a-dope8: posts big blind $0.10
Ty1erDurrden: sits out
*** HOLE CARDS ***
Dealt to PlayTheBlues4U [Ah 7h]
linghuchong2: folds
mankar.am joins the table at seat #2
PlayTheBlues4U: raises $0.20 to $0.30
SeaofLove: folds
rope-a-dope8: folds
Uncalled bet ($0.20) returned to PlayTheBlues4U
PlayTheBlues4U collected $0.25 from pot
PlayTheBlues4U: doesn't show hand
*** SUMMARY ***
Total pot $0.25 | Rake $0
Seat 1: linghuchong2 folded before Flop (didn't bet)
Seat 3: PlayTheBlues4U (button) collected ($0.25)
Seat 4: SeaofLove (small blind) folded before Flop
Seat 5: rope-a-dope8 (big blind) folded before Flop


*********** # 149 **************
PokerStars Hand #205377948681:  Hold'em No Limit ($0.05/$0.10 USD) - 2019/11/02 22:17:39 ET
Table 'Hekate' 6-max Seat #1 is the button
Seat 1: linghuchong2 ($7.07 in chips)
Seat 3: PlayTheBlues4U ($36.82 in chips)
Seat 4: SeaofLove ($10.59 in chips)
Seat 5: rope-a-dope8 ($10.46 in chips)
PlayTheBlues4U: posts small blind $0.05
SeaofLove: posts big blind $0.10
Ty1erDurrden: sits out
*** HOLE CARDS ***
Dealt to PlayTheBlues4U [2h 5s]
rope-a-dope8: folds
linghuchong2: folds
PlayTheBlues4U: folds
Uncalled bet ($0.05) returned to SeaofLove
SeaofLove collected $0.10 from pot
SeaofLove: doesn't show hand
*** SUMMARY ***
Total pot $0.10 | Rake $0
Seat 1: linghuchong2 (button) folded before Flop (didn't bet)
Seat 3: PlayTheBlues4U (small blind) folded before Flop
Seat 4: SeaofLove (big blind) collected ($0.10)
Seat 5: rope-a-dope8 folded before Flop (didn't bet)


*********** # 150 **************
PokerStars Hand #205377948671:  Hold'em No Limit ($0.05/$0.10 USD) - 2019/11/02 22:17:35 ET
Table 'Antares' 6-max Seat #2 is the button
Seat 1: TonyA747 ($10.31 in chips)
Seat 2: PlayTheBlues4U ($13.31 in chips)
Seat 3: StickyChipss ($10 in chips)
Seat 4: rope-a-dope8 ($17.93 in chips)
Seat 5: Jariso13 ($13.48 in chips)
Seat 6: boxerpupp727 ($10 in chips)
StickyChipss: posts small blind $0.05
rope-a-dope8: posts big blind $0.10
*** HOLE CARDS ***
Dealt to PlayTheBlues4U [Td 2h]
Jariso13: folds
boxerpupp727: raises $0.25 to $0.35
TonyA747: raises $0.85 to $1.20
PlayTheBlues4U: folds
StickyChipss: calls $1.15
rope-a-dope8: folds
boxerpupp727: calls $0.85
*** FLOP *** [Qc 8c Ad]
StickyChipss: checks
boxerpupp727: checks
TonyA747: bets $3.50
StickyChipss: calls $3.50
boxerpupp727: folds
*** TURN *** [Qc 8c Ad] [9s]
StickyChipss: checks
TonyA747: bets $5.61 and is all-in
StickyChipss: calls $5.30 and is all-in
Uncalled bet ($0.31) returned to TonyA747
*** RIVER *** [Qc 8c Ad 9s] [2d]
*** SHOW DOWN ***
StickyChipss: shows [Qh Kd] (a pair of Queens)
TonyA747: shows [8d Qd] (two pair, Queens and Eights)
TonyA747 collected $20.24 from pot
*** SUMMARY ***
Total pot $21.30 | Rake $1.06
Board [Qc 8c Ad 9s 2d]
Seat 1: TonyA747 showed [8d Qd] and won ($20.24) with two pair, Queens and Eights
Seat 2: PlayTheBlues4U (button) folded before Flop (didn't bet)
Seat 3: StickyChipss (small blind) showed [Qh Kd] and lost with a pair of Queens
Seat 4: rope-a-dope8 (big blind) folded before Flop
Seat 5: Jariso13 folded before Flop (didn't bet)
Seat 6: boxerpupp727 folded on the Flop


*********** # 151 **************
PokerStars Hand #205377948572:  Hold'em No Limit ($0.05/$0.10 USD) - 2019/11/02 22:17:07 ET
Table 'Antares' 6-max Seat #1 is the button
Seat 1: TonyA747 ($10.66 in chips)
Seat 2: PlayTheBlues4U ($13.36 in chips)
Seat 3: StickyChipss ($10 in chips)
Seat 4: rope-a-dope8 ($17.47 in chips)
Seat 5: Jariso13 ($13.48 in chips)
Seat 6: boxerpupp727 ($9.60 in chips)
PlayTheBlues4U: posts small blind $0.05
StickyChipss: posts big blind $0.10
*** HOLE CARDS ***
Dealt to PlayTheBlues4U [Kd 4d]
rope-a-dope8: raises $0.25 to $0.35
Jariso13: folds
boxerpupp727: folds
TonyA747: calls $0.35
PlayTheBlues4U: folds
StickyChipss: folds
*** FLOP *** [As 9s 6h]
rope-a-dope8: bets $0.81
TonyA747: folds
Uncalled bet ($0.81) returned to rope-a-dope8
rope-a-dope8 collected $0.81 from pot
rope-a-dope8: doesn't show hand
*** SUMMARY ***
Total pot $0.85 | Rake $0.04
Board [As 9s 6h]
Seat 1: TonyA747 (button) folded on the Flop
Seat 2: PlayTheBlues4U (small blind) folded before Flop
Seat 3: StickyChipss (big blind) folded before Flop
Seat 4: rope-a-dope8 collected ($0.81)
Seat 5: Jariso13 folded before Flop (didn't bet)
Seat 6: boxerpupp727 folded before Flop (didn't bet)


*********** # 152 **************
PokerStars Hand #205377948507:  Hold'em No Limit ($0.05/$0.10 USD) - 2019/11/02 22:16:51 ET
Table 'Hekate' 6-max Seat #5 is the button
Seat 1: linghuchong2 ($7.47 in chips)
Seat 3: PlayTheBlues4U ($36.92 in chips)
Seat 4: SeaofLove ($10.59 in chips)
Seat 5: rope-a-dope8 ($10 in chips)
linghuchong2: posts small blind $0.05
PlayTheBlues4U: posts big blind $0.10
*** HOLE CARDS ***
Dealt to PlayTheBlues4U [3s 7s]
SeaofLove: folds
rope-a-dope8: raises $0.30 to $0.40
linghuchong2: calls $0.35
PlayTheBlues4U: folds
*** FLOP *** [2d 2s Ks]
linghuchong2: checks
rope-a-dope8: bets $0.86
Ty1erDurrden joins the table at seat #6
linghuchong2: folds
Uncalled bet ($0.86) returned to rope-a-dope8
rope-a-dope8 collected $0.86 from pot
rope-a-dope8: doesn't show hand
*** SUMMARY ***
Total pot $0.90 | Rake $0.04
Board [2d 2s Ks]
Seat 1: linghuchong2 (small blind) folded on the Flop
Seat 3: PlayTheBlues4U (big blind) folded before Flop
Seat 4: SeaofLove folded before Flop (didn't bet)
Seat 5: rope-a-dope8 (button) collected ($0.86)


*********** # 153 **************
PokerStars Hand #205377948425:  Hold'em No Limit ($0.05/$0.10 USD) - 2019/11/02 22:16:29 ET
Table 'Antares' 6-max Seat #6 is the button
Seat 1: TonyA747 ($10.71 in chips)
Seat 2: PlayTheBlues4U ($12.95 in chips)
Seat 3: StickyChipss ($10 in chips)
Seat 4: rope-a-dope8 ($17.47 in chips)
Seat 5: Jariso13 ($13.48 in chips)
Seat 6: boxerpupp727 ($7.50 in chips)
TonyA747: posts small blind $0.05
PlayTheBlues4U: posts big blind $0.10
*** HOLE CARDS ***
Dealt to PlayTheBlues4U [3h 3s]
StickyChipss: folds
rope-a-dope8: folds
Jariso13: folds
boxerpupp727: raises $0.30 to $0.40
TonyA747: folds
PlayTheBlues4U: calls $0.30
*** FLOP *** [9s 7d 5s]
PlayTheBlues4U: checks
boxerpupp727: checks
*** TURN *** [9s 7d 5s] [9d]
PlayTheBlues4U: checks
boxerpupp727: checks
*** RIVER *** [9s 7d 5s 9d] [4c]
PlayTheBlues4U: checks
boxerpupp727: checks
*** SHOW DOWN ***
PlayTheBlues4U: shows [3h 3s] (two pair, Nines and Threes)
boxerpupp727: mucks hand
PlayTheBlues4U collected $0.81 from pot
*** SUMMARY ***
Total pot $0.85 | Rake $0.04
Board [9s 7d 5s 9d 4c]
Seat 1: TonyA747 (small blind) folded before Flop
Seat 2: PlayTheBlues4U (big blind) showed [3h 3s] and won ($0.81) with two pair, Nines and Threes
Seat 3: StickyChipss folded before Flop (didn't bet)
Seat 4: rope-a-dope8 folded before Flop (didn't bet)
Seat 5: Jariso13 folded before Flop (didn't bet)
Seat 6: boxerpupp727 (button) mucked [Ac Th]


*********** # 154 **************
PokerStars Hand #205377948366:  Hold'em No Limit ($0.05/$0.10 USD) - 2019/11/02 22:16:12 ET
Table 'Hekate' 6-max Seat #4 is the button
Seat 1: linghuchong2 ($7.57 in chips)
Seat 3: PlayTheBlues4U ($36.92 in chips)
Seat 4: SeaofLove ($10 in chips)
Seat 5: rope-a-dope8 ($10.39 in chips)
rope-a-dope8: posts small blind $0.05
linghuchong2: posts big blind $0.10
*** HOLE CARDS ***
Dealt to PlayTheBlues4U [6d Qh]
PlayTheBlues4U said, "big hand. "
PlayTheBlues4U: folds
SeaofLove: raises $0.15 to $0.25
rope-a-dope8: calls $0.20
linghuchong2: folds
*** FLOP *** [2d 7h Tc]
rope-a-dope8: bets $0.30
SeaofLove: raises $0.78 to $1.08
rope-a-dope8: folds
Uncalled bet ($0.78) returned to SeaofLove
SeaofLove collected $1.14 from pot
SeaofLove: doesn't show hand
*** SUMMARY ***
Total pot $1.20 | Rake $0.06
Board [2d 7h Tc]
Seat 1: linghuchong2 (big blind) folded before Flop
Seat 3: PlayTheBlues4U folded before Flop (didn't bet)
Seat 4: SeaofLove (button) collected ($1.14)
Seat 5: rope-a-dope8 (small blind) folded on the Flop


*********** # 155 **************
PokerStars Hand #205377948324:  Hold'em No Limit ($0.05/$0.10 USD) - 2019/11/02 22:16:04 ET
Table 'Antares' 6-max Seat #5 is the button
Seat 1: TonyA747 ($10.31 in chips)
Seat 2: PlayTheBlues4U ($12.95 in chips)
Seat 3: StickyChipss ($10 in chips)
Seat 4: rope-a-dope8 ($17.47 in chips)
Seat 5: Jariso13 ($13.48 in chips)
Seat 6: boxerpupp727 ($7.90 in chips)
boxerpupp727: posts small blind $0.05
TonyA747: posts big blind $0.10
*** HOLE CARDS ***
Dealt to PlayTheBlues4U [5c 7h]
PlayTheBlues4U: folds
StickyChipss said, "nice"
StickyChipss: folds
rope-a-dope8: folds
Jariso13: folds
boxerpupp727: raises $0.30 to $0.40
TonyA747: raises $0.80 to $1.20
boxerpupp727: folds
Uncalled bet ($0.80) returned to TonyA747
TonyA747 collected $0.80 from pot
boxerpupp727 said, "thx"
TonyA747: doesn't show hand
*** SUMMARY ***
Total pot $0.80 | Rake $0
Seat 1: TonyA747 (big blind) collected ($0.80)
Seat 2: PlayTheBlues4U folded before Flop (didn't bet)
Seat 3: StickyChipss folded before Flop (didn't bet)
Seat 4: rope-a-dope8 folded before Flop (didn't bet)
Seat 5: Jariso13 (button) folded before Flop (didn't bet)
Seat 6: boxerpupp727 (small blind) folded before Flop


*********** # 156 **************
PokerStars Hand #205377948255:  Hold'em No Limit ($0.05/$0.10 USD) - 2019/11/02 22:15:45 ET
Table 'Hekate' 6-max Seat #3 is the button
Seat 1: linghuchong2 ($7.67 in chips)
Seat 3: PlayTheBlues4U ($36.92 in chips)
Seat 4: SeaofLove ($10 in chips)
Seat 5: rope-a-dope8 ($10.25 in chips)
SeaofLove: posts small blind $0.05
rope-a-dope8: posts big blind $0.10
*** HOLE CARDS ***
Dealt to PlayTheBlues4U [Ks 8s]
linghuchong2: calls $0.10
PlayTheBlues4U: folds
SeaofLove: folds
rope-a-dope8: checks
*** FLOP *** [Kd 2d 5s]
rope-a-dope8: bets $0.18
linghuchong2: folds
Uncalled bet ($0.18) returned to rope-a-dope8
rope-a-dope8 collected $0.24 from pot
rope-a-dope8: doesn't show hand
*** SUMMARY ***
Total pot $0.25 | Rake $0.01
Board [Kd 2d 5s]
Seat 1: linghuchong2 folded on the Flop
Seat 3: PlayTheBlues4U (button) folded before Flop (didn't bet)
Seat 4: SeaofLove (small blind) folded before Flop
Seat 5: rope-a-dope8 (big blind) collected ($0.24)


*********** # 157 **************
PokerStars Hand #205377948203:  Hold'em No Limit ($0.05/$0.10 USD) - 2019/11/02 22:15:33 ET
Table 'Hekate' 6-max Seat #1 is the button
Seat 1: linghuchong2 ($7.67 in chips)
Seat 3: PlayTheBlues4U ($36.97 in chips)
Seat 4: SeaofLove ($10 in chips)
Seat 5: rope-a-dope8 ($10.10 in chips)
PlayTheBlues4U: posts small blind $0.05
SeaofLove: posts big blind $0.10
*** HOLE CARDS ***
Dealt to PlayTheBlues4U [3c 9s]
rope-a-dope8: raises $0.25 to $0.35
linghuchong2: folds
PlayTheBlues4U: folds
SeaofLove: folds
Uncalled bet ($0.25) returned to rope-a-dope8
rope-a-dope8 collected $0.25 from pot
rope-a-dope8: doesn't show hand
*** SUMMARY ***
Total pot $0.25 | Rake $0
Seat 1: linghuchong2 (button) folded before Flop (didn't bet)
Seat 3: PlayTheBlues4U (small blind) folded before Flop
Seat 4: SeaofLove (big blind) folded before Flop
Seat 5: rope-a-dope8 collected ($0.25)


*********** # 158 **************
PokerStars Hand #205377948167:  Hold'em No Limit ($0.05/$0.10 USD) - 2019/11/02 22:15:26 ET
Table 'Hekate' 6-max Seat #5 is the button
Seat 1: linghuchong2 ($7.72 in chips)
Seat 3: PlayTheBlues4U ($36.92 in chips)
Seat 5: rope-a-dope8 ($10.10 in chips)
linghuchong2: posts small blind $0.05
PlayTheBlues4U: posts big blind $0.10
SeaofLove: sits out
*** HOLE CARDS ***
Dealt to PlayTheBlues4U [6h Kh]
rope-a-dope8: folds
linghuchong2: folds
Uncalled bet ($0.05) returned to PlayTheBlues4U
PlayTheBlues4U collected $0.10 from pot
PlayTheBlues4U: doesn't show hand
*** SUMMARY ***
Total pot $0.10 | Rake $0
Seat 1: linghuchong2 (small blind) folded before Flop
Seat 3: PlayTheBlues4U (big blind) collected ($0.10)
Seat 5: rope-a-dope8 (button) folded before Flop (didn't bet)


*********** # 159 **************
PokerStars Hand #205377948146:  Hold'em No Limit ($0.05/$0.10 USD) - 2019/11/02 22:15:22 ET
Table 'Antares' 6-max Seat #4 is the button
Seat 1: TonyA747 ($10.13 in chips)
Seat 2: PlayTheBlues4U ($12.95 in chips)
Seat 3: StickyChipss ($10 in chips)
Seat 4: rope-a-dope8 ($17.47 in chips)
Seat 5: Jariso13 ($13.58 in chips)
Seat 6: boxerpupp727 ($8 in chips)
Jariso13: posts small blind $0.05
boxerpupp727: posts big blind $0.10
*** HOLE CARDS ***
Dealt to PlayTheBlues4U [2d Kd]
TonyA747: calls $0.10
PlayTheBlues4U: folds
StickyChipss: folds
rope-a-dope8: folds
Jariso13: calls $0.05
boxerpupp727: checks
*** FLOP *** [9c 6s 5h]
boxerpupp727 said, "pupp is 85 pounds now lol"
Jariso13: checks
boxerpupp727: checks
TonyA747: checks
*** TURN *** [9c 6s 5h] [6h]
Jariso13: checks
boxerpupp727: checks
TonyA747: checks
*** RIVER *** [9c 6s 5h 6h] [2h]
Jariso13: checks
boxerpupp727: checks
TonyA747: checks
*** SHOW DOWN ***
Jariso13: shows [Jd Qh] (a pair of Sixes)
boxerpupp727: mucks hand
TonyA747: shows [Kh Ts] (a pair of Sixes - King kicker)
TonyA747 collected $0.28 from pot
*** SUMMARY ***
Total pot $0.30 | Rake $0.02
Board [9c 6s 5h 6h 2h]
Seat 1: TonyA747 showed [Kh Ts] and won ($0.28) with a pair of Sixes
Seat 2: PlayTheBlues4U folded before Flop (didn't bet)
Seat 3: StickyChipss folded before Flop (didn't bet)
Seat 4: rope-a-dope8 (button) folded before Flop (didn't bet)
Seat 5: Jariso13 (small blind) showed [Jd Qh] and lost with a pair of Sixes
Seat 6: boxerpupp727 (big blind) mucked [4c 7d]


*********** # 160 **************
PokerStars Hand #205377948096:  Hold'em No Limit ($0.05/$0.10 USD) - 2019/11/02 22:15:11 ET
Table 'Hekate' 6-max Seat #3 is the button
Seat 1: linghuchong2 ($7.82 in chips)
Seat 3: PlayTheBlues4U ($36.92 in chips)
Seat 5: rope-a-dope8 ($10 in chips)
SeaofLove will be allowed to play after the button
rope-a-dope8: posts small blind $0.05
BATHMEDIC: is sitting out
linghuchong2: posts big blind $0.10
*** HOLE CARDS ***
Dealt to PlayTheBlues4U [4s Ks]
asanxz22 leaves the table
PlayTheBlues4U: folds
BATHMEDIC leaves the table
rope-a-dope8: raises $0.30 to $0.40
linghuchong2: folds
Uncalled bet ($0.30) returned to rope-a-dope8
rope-a-dope8 collected $0.20 from pot
rope-a-dope8: doesn't show hand
*** SUMMARY ***
Total pot $0.20 | Rake $0
Seat 1: linghuchong2 (big blind) folded before Flop
Seat 3: PlayTheBlues4U (button) folded before Flop (didn't bet)
Seat 5: rope-a-dope8 (small blind) collected ($0.20)


*********** # 161 **************
PokerStars Hand #205377948052:  Hold'em No Limit ($0.05/$0.10 USD) - 2019/11/02 22:14:59 ET
Table 'Antares' 6-max Seat #3 is the button
Seat 1: TonyA747 ($10.13 in chips)
Seat 2: PlayTheBlues4U ($12.95 in chips)
Seat 3: StickyChipss ($10 in chips)
Seat 4: rope-a-dope8 ($17.37 in chips)
Seat 5: Jariso13 ($13.68 in chips)
rope-a-dope8: posts small blind $0.05
Jariso13: posts big blind $0.10
boxerpupp727: sits out
*** HOLE CARDS ***
Dealt to PlayTheBlues4U [4s Ad]
TonyA747: folds
PlayTheBlues4U: folds
StickyChipss: folds
StickyChipss said, "sup lil puppy"
rope-a-dope8: raises $0.30 to $0.40
Jariso13: folds
Uncalled bet ($0.30) returned to rope-a-dope8
rope-a-dope8 collected $0.20 from pot
rope-a-dope8: doesn't show hand
*** SUMMARY ***
Total pot $0.20 | Rake $0
Seat 1: TonyA747 folded before Flop (didn't bet)
Seat 2: PlayTheBlues4U folded before Flop (didn't bet)
Seat 3: StickyChipss (button) folded before Flop (didn't bet)
Seat 4: rope-a-dope8 (small blind) collected ($0.20)
Seat 5: Jariso13 (big blind) folded before Flop


*********** # 162 **************
PokerStars Hand #205377948008:  Hold'em No Limit ($0.05/$0.10 USD) - 2019/11/02 22:14:47 ET
Table 'Antares' 6-max Seat #2 is the button
Seat 1: TonyA747 ($10.13 in chips)
Seat 2: PlayTheBlues4U ($12.95 in chips)
Seat 3: StickyChipss ($10 in chips)
Seat 4: rope-a-dope8 ($17.32 in chips)
Seat 5: Jariso13 ($13.68 in chips)
StickyChipss: posts small blind $0.05
rope-a-dope8: posts big blind $0.10
boxerpupp727: sits out
*** HOLE CARDS ***
Dealt to PlayTheBlues4U [Th 4h]
Jariso13: folds
TonyA747: folds
PlayTheBlues4U: folds
StickyChipss: folds
Uncalled bet ($0.05) returned to rope-a-dope8
rope-a-dope8 collected $0.10 from pot
rope-a-dope8: doesn't show hand
*** SUMMARY ***
Total pot $0.10 | Rake $0
Seat 1: TonyA747 folded before Flop (didn't bet)
Seat 2: PlayTheBlues4U (button) folded before Flop (didn't bet)
Seat 3: StickyChipss (small blind) folded before Flop
Seat 4: rope-a-dope8 (big blind) collected ($0.10)
Seat 5: Jariso13 folded before Flop (didn't bet)


*********** # 163 **************
PokerStars Hand #205377947794:  Hold'em No Limit ($0.05/$0.10 USD) - 2019/11/02 22:13:54 ET
Table 'Hekate' 6-max Seat #2 is the button
Seat 1: linghuchong2 ($7.82 in chips)
Seat 2: asanxz22 ($9.80 in chips)
Seat 3: PlayTheBlues4U ($18.29 in chips)
Seat 5: rope-a-dope8 ($10.13 in chips)
Seat 6: BATHMEDIC ($5.77 in chips)
PlayTheBlues4U: posts small blind $0.05
rope-a-dope8: posts big blind $0.10
*** HOLE CARDS ***
Dealt to PlayTheBlues4U [Kc Ac]
BATHMEDIC: raises $0.10 to $0.20
linghuchong2: folds
asanxz22: raises $0.10 to $0.30
PlayTheBlues4U: raises $0.60 to $0.90
rope-a-dope8: raises $2.30 to $3.20
BATHMEDIC: folds
asanxz22: calls $2.90
PlayTheBlues4U: raises $3.50 to $6.70
rope-a-dope8: raises $3.43 to $10.13 and is all-in
SeaofLove joins the table at seat #4
asanxz22: calls $6.60 and is all-in
PlayTheBlues4U: calls $3.43
*** FLOP *** [Td 2s 9c]
*** TURN *** [Td 2s 9c] [4h]
*** RIVER *** [Td 2s 9c 4h] [3c]
*** SHOW DOWN ***
PlayTheBlues4U: shows [Kc Ac] (high card Ace)
rope-a-dope8: shows [Qs Ad] (high card Ace - lower kicker)
PlayTheBlues4U collected $0.64 from side pot
asanxz22: shows [Kh Jh] (high card King)
PlayTheBlues4U collected $28.12 from main pot
*** SUMMARY ***
Total pot $30.26 Main pot $28.12. Side pot $0.64. | Rake $1.50
Board [Td 2s 9c 4h 3c]
Seat 1: linghuchong2 folded before Flop (didn't bet)
Seat 2: asanxz22 (button) showed [Kh Jh] and lost with high card King
Seat 3: PlayTheBlues4U (small blind) showed [Kc Ac] and won ($28.76) with high card Ace
Seat 5: rope-a-dope8 (big blind) showed [Qs Ad] and lost with high card Ace
Seat 6: BATHMEDIC folded before Flop


*********** # 164 **************
PokerStars Hand #205377947731:  Hold'em No Limit ($0.05/$0.10 USD) - 2019/11/02 22:13:35 ET
Table 'Antares' 6-max Seat #1 is the button
Seat 1: TonyA747 ($9.76 in chips)
Seat 2: PlayTheBlues4U ($13.15 in chips)
Seat 3: StickyChipss ($10 in chips)
Seat 4: rope-a-dope8 ($17.32 in chips)
Seat 5: Jariso13 ($13.68 in chips)
PlayTheBlues4U: posts small blind $0.05
StickyChipss: posts big blind $0.10
*** HOLE CARDS ***
Dealt to PlayTheBlues4U [9s Ah]
rope-a-dope8: folds
Jariso13: folds
boxerpupp727 joins the table at seat #6
TonyA747: raises $0.10 to $0.20
PlayTheBlues4U: calls $0.15
StickyChipss: calls $0.10
*** FLOP *** [5d 8d 4h]
PlayTheBlues4U: checks
StickyChipss: checks
TonyA747: bets $1.80
boxerpupp727 said, "sup sticky icky"
PlayTheBlues4U: folds
StickyChipss: folds
Uncalled bet ($1.80) returned to TonyA747
TonyA747 collected $0.57 from pot
TonyA747: doesn't show hand
*** SUMMARY ***
Total pot $0.60 | Rake $0.03
Board [5d 8d 4h]
Seat 1: TonyA747 (button) collected ($0.57)
Seat 2: PlayTheBlues4U (small blind) folded on the Flop
Seat 3: StickyChipss (big blind) folded on the Flop
Seat 4: rope-a-dope8 folded before Flop (didn't bet)
Seat 5: Jariso13 folded before Flop (didn't bet)


*********** # 165 **************
PokerStars Hand #205377947668:  Hold'em No Limit ($0.05/$0.10 USD) - 2019/11/02 22:13:21 ET
Table 'Antares' 6-max Seat #5 is the button
Seat 1: TonyA747 ($9.36 in chips)
Seat 2: PlayTheBlues4U ($13.25 in chips)
Seat 4: rope-a-dope8 ($17.32 in chips)
Seat 5: Jariso13 ($13.98 in chips)
TonyA747: posts small blind $0.05
PlayTheBlues4U: posts big blind $0.10
StickyChipss: sits out
*** HOLE CARDS ***
Dealt to PlayTheBlues4U [Ts 9d]
rope-a-dope8: folds
Jariso13: raises $0.20 to $0.30
TonyA747: raises $0.70 to $1
PlayTheBlues4U: folds
Jariso13: folds
Uncalled bet ($0.70) returned to TonyA747
TonyA747 collected $0.70 from pot
TonyA747: doesn't show hand
*** SUMMARY ***
Total pot $0.70 | Rake $0
Seat 1: TonyA747 (small blind) collected ($0.70)
Seat 2: PlayTheBlues4U (big blind) folded before Flop
Seat 4: rope-a-dope8 folded before Flop (didn't bet)
Seat 5: Jariso13 (button) folded before Flop


*********** # 166 **************
PokerStars Hand #205377947583:  Hold'em No Limit ($0.05/$0.10 USD) - 2019/11/02 22:13:00 ET
Table 'Hekate' 6-max Seat #1 is the button
Seat 1: linghuchong2 ($7.82 in chips)
Seat 2: asanxz22 ($11.90 in chips)
Seat 3: PlayTheBlues4U ($16.31 in chips)
Seat 5: rope-a-dope8 ($10.13 in chips)
Seat 6: BATHMEDIC ($5.87 in chips)
asanxz22: posts small blind $0.05
PlayTheBlues4U: posts big blind $0.10
*** HOLE CARDS ***
Dealt to PlayTheBlues4U [3c Ad]
rope-a-dope8: folds
BATHMEDIC: calls $0.10
linghuchong2: folds
asanxz22: calls $0.05
PlayTheBlues4U: checks
*** FLOP *** [6h 4d 5d]
asanxz22: bets $0.10
PlayTheBlues4U: calls $0.10
BATHMEDIC: folds
*** TURN *** [6h 4d 5d] [2d]
asanxz22: bets $0.50
PlayTheBlues4U: calls $0.50
*** RIVER *** [6h 4d 5d 2d] [4c]
asanxz22: bets $1.40
PlayTheBlues4U: calls $1.40
*** SHOW DOWN ***
asanxz22: shows [9h 4h] (three of a kind, Fours)
PlayTheBlues4U: shows [3c Ad] (a straight, Deuce to Six)
PlayTheBlues4U collected $4.08 from pot
*** SUMMARY ***
Total pot $4.30 | Rake $0.22
Board [6h 4d 5d 2d 4c]
Seat 1: linghuchong2 (button) folded before Flop (didn't bet)
Seat 2: asanxz22 (small blind) showed [9h 4h] and lost with three of a kind, Fours
Seat 3: PlayTheBlues4U (big blind) showed [3c Ad] and won ($4.08) with a straight, Deuce to Six
Seat 5: rope-a-dope8 folded before Flop (didn't bet)
Seat 6: BATHMEDIC folded on the Flop


*********** # 167 **************
PokerStars Hand #205377947390:  Hold'em No Limit ($0.05/$0.10 USD) - 2019/11/02 22:12:12 ET
Table 'Antares' 6-max Seat #4 is the button
Seat 1: TonyA747 ($11.14 in chips)
Seat 2: PlayTheBlues4U ($13.70 in chips)
Seat 4: rope-a-dope8 ($15.24 in chips)
Seat 5: Jariso13 ($14.03 in chips)
Jariso13: posts small blind $0.05
TonyA747: posts big blind $0.10
StickyChipss: sits out
*** HOLE CARDS ***
Dealt to PlayTheBlues4U [2h 2c]
PlayTheBlues4U: calls $0.10
rope-a-dope8: raises $0.35 to $0.45
Jariso13: folds
TonyA747: calls $0.35
PlayTheBlues4U: calls $0.35
*** FLOP *** [Jc 3d 7d]
TonyA747: checks
PlayTheBlues4U: checks
rope-a-dope8: bets $1.33
TonyA747: calls $1.33
PlayTheBlues4U: folds
*** TURN *** [Jc 3d 7d] [Ks]
TonyA747: checks
rope-a-dope8: bets $1.93
TonyA747: folds
Uncalled bet ($1.93) returned to rope-a-dope8
rope-a-dope8 collected $3.86 from pot
rope-a-dope8: doesn't show hand
*** SUMMARY ***
Total pot $4.06 | Rake $0.20
Board [Jc 3d 7d Ks]
Seat 1: TonyA747 (big blind) folded on the Turn
Seat 2: PlayTheBlues4U folded on the Flop
Seat 4: rope-a-dope8 (button) collected ($3.86)
Seat 5: Jariso13 (small blind) folded before Flop


*********** # 168 **************
PokerStars Hand #205377947371:  Hold'em No Limit ($0.05/$0.10 USD) - 2019/11/02 22:12:08 ET
Table 'Hekate' 6-max Seat #6 is the button
Seat 1: linghuchong2 ($6.89 in chips)
Seat 2: asanxz22 ($12 in chips)
Seat 3: PlayTheBlues4U ($16.76 in chips)
Seat 5: rope-a-dope8 ($10.58 in chips)
Seat 6: BATHMEDIC ($5.87 in chips)
linghuchong2: posts small blind $0.05
asanxz22: posts big blind $0.10
*** HOLE CARDS ***
Dealt to PlayTheBlues4U [3h 3s]
PlayTheBlues4U: calls $0.10
boxerpupp727 was removed from the table for failing to post
boxerpupp727 leaves the table
rope-a-dope8: raises $0.35 to $0.45
BATHMEDIC: folds
linghuchong2: calls $0.40
asanxz22: folds
PlayTheBlues4U: calls $0.35
*** FLOP *** [Js 8c Qh]
linghuchong2: bets $0.70
PlayTheBlues4U: folds
rope-a-dope8: folds
Uncalled bet ($0.70) returned to linghuchong2
linghuchong2 collected $1.38 from pot
linghuchong2: doesn't show hand
*** SUMMARY ***
Total pot $1.45 | Rake $0.07
Board [Js 8c Qh]
Seat 1: linghuchong2 (small blind) collected ($1.38)
Seat 2: asanxz22 (big blind) folded before Flop
Seat 3: PlayTheBlues4U folded on the Flop
Seat 5: rope-a-dope8 folded on the Flop
Seat 6: BATHMEDIC (button) folded before Flop (didn't bet)


*********** # 169 **************
PokerStars Hand #205377947309:  Hold'em No Limit ($0.05/$0.10 USD) - 2019/11/02 22:11:54 ET
Table 'Hekate' 6-max Seat #5 is the button
Seat 1: linghuchong2 ($6.99 in chips)
Seat 2: asanxz22 ($12 in chips)
Seat 3: PlayTheBlues4U ($16.76 in chips)
Seat 5: rope-a-dope8 ($10.58 in chips)
Seat 6: BATHMEDIC ($5.77 in chips)
BATHMEDIC: posts small blind $0.05
linghuchong2: posts big blind $0.10
*** HOLE CARDS ***
Dealt to PlayTheBlues4U [6d 4h]
asanxz22: folds
PlayTheBlues4U: folds
rope-a-dope8: folds
BATHMEDIC: raises $0.10 to $0.20
linghuchong2: folds
Uncalled bet ($0.10) returned to BATHMEDIC
BATHMEDIC collected $0.20 from pot
*** SUMMARY ***
Total pot $0.20 | Rake $0
Seat 1: linghuchong2 (big blind) folded before Flop
Seat 2: asanxz22 folded before Flop (didn't bet)
Seat 3: PlayTheBlues4U folded before Flop (didn't bet)
Seat 5: rope-a-dope8 (button) folded before Flop (didn't bet)
Seat 6: BATHMEDIC (small blind) collected ($0.20)


*********** # 170 **************
PokerStars Hand #205377947173:  Hold'em No Limit ($0.05/$0.10 USD) - 2019/11/02 22:11:23 ET
Table 'Antares' 6-max Seat #2 is the button
Seat 1: TonyA747 ($12.74 in chips)
Seat 2: PlayTheBlues4U ($13.70 in chips)
Seat 4: rope-a-dope8 ($15.29 in chips)
Seat 5: Jariso13 ($12.54 in chips)
rope-a-dope8: posts small blind $0.05
Jariso13: posts big blind $0.10
*** HOLE CARDS ***
Dealt to PlayTheBlues4U [9c Qh]
TonyA747: calls $0.10
PlayTheBlues4U: folds
rope-a-dope8: folds
Jariso13: checks
*** FLOP *** [3d 5d Js]
Jariso13: bets $0.20
TonyA747: calls $0.20
*** TURN *** [3d 5d Js] [Th]
Jariso13: bets $0.50
TonyA747: calls $0.50
*** RIVER *** [3d 5d Js Th] [6s]
Jariso13: checks
TonyA747: bets $0.80
Jariso13: calls $0.80
*** SHOW DOWN ***
TonyA747: shows [Qs 8s] (high card Queen)
Jariso13: shows [Ah Jd] (a pair of Jacks)
Jariso13 collected $3.09 from pot
*** SUMMARY ***
Total pot $3.25 | Rake $0.16
Board [3d 5d Js Th 6s]
Seat 1: TonyA747 showed [Qs 8s] and lost with high card Queen
Seat 2: PlayTheBlues4U (button) folded before Flop (didn't bet)
Seat 4: rope-a-dope8 (small blind) folded before Flop
Seat 5: Jariso13 (big blind) showed [Ah Jd] and won ($3.09) with a pair of Jacks


*********** # 171 **************
PokerStars Hand #205377947087:  Hold'em No Limit ($0.05/$0.10 USD) - 2019/11/02 22:11:03 ET
Table 'Hekate' 6-max Seat #3 is the button
Seat 1: linghuchong2 ($7.09 in chips)
Seat 2: asanxz22 ($12 in chips)
Seat 3: PlayTheBlues4U ($17.66 in chips)
Seat 5: rope-a-dope8 ($10.63 in chips)
Seat 6: BATHMEDIC ($4.82 in chips)
rope-a-dope8: posts small blind $0.05
BATHMEDIC: posts big blind $0.10
*** HOLE CARDS ***
Dealt to PlayTheBlues4U [Ks Ac]
linghuchong2: calls $0.10
asanxz22: folds
PlayTheBlues4U: raises $0.30 to $0.40
rope-a-dope8: folds
BATHMEDIC: calls $0.30
linghuchong2: folds
*** FLOP *** [Th 4c 7s]
BATHMEDIC: checks
PlayTheBlues4U: bets $0.50
BATHMEDIC: raises $0.80 to $1.30
PlayTheBlues4U: folds
Uncalled bet ($0.80) returned to BATHMEDIC
BATHMEDIC collected $1.85 from pot
*** SUMMARY ***
Total pot $1.95 | Rake $0.10
Board [Th 4c 7s]
Seat 1: linghuchong2 folded before Flop
Seat 2: asanxz22 folded before Flop (didn't bet)
Seat 3: PlayTheBlues4U (button) folded on the Flop
Seat 5: rope-a-dope8 (small blind) folded before Flop
Seat 6: BATHMEDIC (big blind) collected ($1.85)


*********** # 172 **************
PokerStars Hand #205377947044:  Hold'em No Limit ($0.05/$0.10 USD) - 2019/11/02 22:10:52 ET
Table 'Antares' 6-max Seat #1 is the button
Seat 1: TonyA747 ($12.33 in chips)
Seat 2: PlayTheBlues4U ($13.75 in chips)
Seat 4: rope-a-dope8 ($15.39 in chips)
Seat 5: Jariso13 ($12.84 in chips)
PlayTheBlues4U: posts small blind $0.05
rope-a-dope8: posts big blind $0.10
*** HOLE CARDS ***
Dealt to PlayTheBlues4U [Kc 5s]
Jariso13: raises $0.20 to $0.30
TonyA747: calls $0.30
PlayTheBlues4U: folds
rope-a-dope8: folds
*** FLOP *** [4d Qd 6d]
Jariso13: checks
TonyA747: bets $0.70
Jariso13: folds
Uncalled bet ($0.70) returned to TonyA747
TonyA747 collected $0.71 from pot
TonyA747: doesn't show hand
*** SUMMARY ***
Total pot $0.75 | Rake $0.04
Board [4d Qd 6d]
Seat 1: TonyA747 (button) collected ($0.71)
Seat 2: PlayTheBlues4U (small blind) folded before Flop
Seat 4: rope-a-dope8 (big blind) folded before Flop
Seat 5: Jariso13 folded on the Flop


*********** # 173 **************
PokerStars Hand #205377946929:  Hold'em No Limit ($0.05/$0.10 USD) - 2019/11/02 22:10:24 ET
Table 'Antares' 6-max Seat #5 is the button
Seat 1: TonyA747 ($12.24 in chips)
Seat 2: PlayTheBlues4U ($13.85 in chips)
Seat 4: rope-a-dope8 ($15.39 in chips)
Seat 5: Jariso13 ($12.84 in chips)
TonyA747: posts small blind $0.05
PlayTheBlues4U: posts big blind $0.10
*** HOLE CARDS ***
Dealt to PlayTheBlues4U [2c 4c]
rope-a-dope8: folds
Jariso13: folds
TonyA747: calls $0.05
PlayTheBlues4U: checks
*** FLOP *** [5c Qs 6h]
TonyA747: checks
PlayTheBlues4U: checks
*** TURN *** [5c Qs 6h] [4d]
TonyA747: bets $0.10
PlayTheBlues4U: folds
Uncalled bet ($0.10) returned to TonyA747
TonyA747 collected $0.19 from pot
TonyA747: doesn't show hand
*** SUMMARY ***
Total pot $0.20 | Rake $0.01
Board [5c Qs 6h 4d]
Seat 1: TonyA747 (small blind) collected ($0.19)
Seat 2: PlayTheBlues4U (big blind) folded on the Turn
Seat 4: rope-a-dope8 folded before Flop (didn't bet)
Seat 5: Jariso13 (button) folded before Flop (didn't bet)


*********** # 174 **************
PokerStars Hand #205377946770:  Hold'em No Limit ($0.05/$0.10 USD) - 2019/11/02 22:09:45 ET
Table 'Hekate' 6-max Seat #2 is the button
Seat 1: linghuchong2 ($7.09 in chips)
Seat 2: asanxz22 ($12 in chips)
Seat 3: PlayTheBlues4U ($18.36 in chips)
Seat 5: rope-a-dope8 ($10 in chips)
Seat 6: BATHMEDIC ($4.82 in chips)
PlayTheBlues4U: posts small blind $0.05
rope-a-dope8: posts big blind $0.10
*** HOLE CARDS ***
Dealt to PlayTheBlues4U [9h 9d]
BATHMEDIC: folds
linghuchong2: folds
asanxz22: folds
PlayTheBlues4U: raises $0.20 to $0.30
rope-a-dope8: raises $0.40 to $0.70
PlayTheBlues4U: calls $0.40
*** FLOP *** [3h 6h Ad]
PlayTheBlues4U: checks
rope-a-dope8: checks
*** TURN *** [3h 6h Ad] [Qc]
PlayTheBlues4U: checks
rope-a-dope8: checks
*** RIVER *** [3h 6h Ad Qc] [Jd]
PlayTheBlues4U: checks
rope-a-dope8: bets $1.33
PlayTheBlues4U: folds
Uncalled bet ($1.33) returned to rope-a-dope8
rope-a-dope8 collected $1.33 from pot
rope-a-dope8: doesn't show hand
*** SUMMARY ***
Total pot $1.40 | Rake $0.07
Board [3h 6h Ad Qc Jd]
Seat 1: linghuchong2 folded before Flop (didn't bet)
Seat 2: asanxz22 (button) folded before Flop (didn't bet)
Seat 3: PlayTheBlues4U (small blind) folded on the River
Seat 5: rope-a-dope8 (big blind) collected ($1.33)
Seat 6: BATHMEDIC folded before Flop (didn't bet)


*********** # 175 **************
PokerStars Hand #205377946590:  Hold'em No Limit ($0.05/$0.10 USD) - 2019/11/02 22:09:03 ET
Table 'Antares' 6-max Seat #4 is the button
Seat 1: TonyA747 ($12.24 in chips)
Seat 2: PlayTheBlues4U ($13.85 in chips)
Seat 4: rope-a-dope8 ($16.12 in chips)
Seat 5: Jariso13 ($12.09 in chips)
Seat 6: sins07 ($12.39 in chips)
Jariso13: posts small blind $0.05
sins07: posts big blind $0.10
*** HOLE CARDS ***
Dealt to PlayTheBlues4U [6h 5d]
TonyA747: folds
PlayTheBlues4U: folds
rope-a-dope8: raises $0.25 to $0.35
Jariso13: calls $0.30
sins07: folds
*** FLOP *** [4s 2h 8c]
Jariso13: checks
sins07 leaves the table
rope-a-dope8: bets $0.38
Jariso13: calls $0.38
*** TURN *** [4s 2h 8c] [Jd]
Jariso13: bets $0.70
rope-a-dope8: folds
Uncalled bet ($0.70) returned to Jariso13
Jariso13 collected $1.48 from pot
Jariso13: doesn't show hand
*** SUMMARY ***
Total pot $1.56 | Rake $0.08
Board [4s 2h 8c Jd]
Seat 1: TonyA747 folded before Flop (didn't bet)
Seat 2: PlayTheBlues4U folded before Flop (didn't bet)
Seat 4: rope-a-dope8 (button) folded on the Turn
Seat 5: Jariso13 (small blind) collected ($1.48)
Seat 6: sins07 (big blind) folded before Flop


*********** # 176 **************
PokerStars Hand #205377946448:  Hold'em No Limit ($0.05/$0.10 USD) - 2019/11/02 22:08:28 ET
Table 'Antares' 6-max Seat #2 is the button
Seat 1: TonyA747 ($12.54 in chips)
Seat 2: PlayTheBlues4U ($13.85 in chips)
Seat 4: rope-a-dope8 ($16.17 in chips)
Seat 5: Jariso13 ($12.19 in chips)
Seat 6: sins07 ($11.98 in chips)
rope-a-dope8: posts small blind $0.05
Jariso13: posts big blind $0.10
*** HOLE CARDS ***
Dealt to PlayTheBlues4U [7c Qh]
sins07: raises $0.20 to $0.30
TonyA747: calls $0.30
PlayTheBlues4U: folds
rope-a-dope8: folds
Jariso13: folds
*** FLOP *** [As 3c Kd]
sins07: bets $0.50
TonyA747: folds
Uncalled bet ($0.50) returned to sins07
sins07 collected $0.71 from pot
sins07: doesn't show hand
*** SUMMARY ***
Total pot $0.75 | Rake $0.04
Board [As 3c Kd]
Seat 1: TonyA747 folded on the Flop
Seat 2: PlayTheBlues4U (button) folded before Flop (didn't bet)
Seat 4: rope-a-dope8 (small blind) folded before Flop
Seat 5: Jariso13 (big blind) folded before Flop
Seat 6: sins07 collected ($0.71)


*********** # 177 **************
PokerStars Hand #205377946389:  Hold'em No Limit ($0.05/$0.10 USD) - 2019/11/02 22:08:15 ET
Table 'Hekate' 6-max Seat #1 is the button
Seat 1: linghuchong2 ($7.09 in chips)
Seat 2: asanxz22 ($12.05 in chips)
Seat 3: PlayTheBlues4U ($9.64 in chips)
Seat 5: rope-a-dope8 ($10 in chips)
Seat 6: BATHMEDIC ($4.82 in chips)
asanxz22: posts small blind $0.05
PlayTheBlues4U: posts big blind $0.10
*** HOLE CARDS ***
Dealt to PlayTheBlues4U [Qh Qc]
rope-a-dope8: raises $0.25 to $0.35
BATHMEDIC: folds
linghuchong2: folds
asanxz22: folds
PlayTheBlues4U: raises $0.55 to $0.90
rope-a-dope8: raises $1.85 to $2.75
PlayTheBlues4U: raises $2.75 to $5.50
rope-a-dope8: calls $2.75
*** FLOP *** [4s 6c 7c]
PlayTheBlues4U: bets $4.14 and is all-in
rope-a-dope8: calls $4.14
*** TURN *** [4s 6c 7c] [Kd]
*** RIVER *** [4s 6c 7c Kd] [2s]
*** SHOW DOWN ***
PlayTheBlues4U: shows [Qh Qc] (a pair of Queens)
rope-a-dope8: shows [Ac Js] (high card Ace)
PlayTheBlues4U collected $18.36 from pot
*** SUMMARY ***
Total pot $19.33 | Rake $0.97
Board [4s 6c 7c Kd 2s]
Seat 1: linghuchong2 (button) folded before Flop (didn't bet)
Seat 2: asanxz22 (small blind) folded before Flop
Seat 3: PlayTheBlues4U (big blind) showed [Qh Qc] and won ($18.36) with a pair of Queens
Seat 5: rope-a-dope8 showed [Ac Js] and lost with high card Ace
Seat 6: BATHMEDIC folded before Flop (didn't bet)


*********** # 178 **************
PokerStars Hand #205377946251:  Hold'em No Limit ($0.05/$0.10 USD) - 2019/11/02 22:07:41 ET
Table 'Antares' 6-max Seat #1 is the button
Seat 1: TonyA747 ($12.26 in chips)
Seat 2: PlayTheBlues4U ($13.95 in chips)
Seat 4: rope-a-dope8 ($16.27 in chips)
Seat 5: Jariso13 ($12.19 in chips)
Seat 6: sins07 ($12.08 in chips)
PlayTheBlues4U: posts small blind $0.05
rope-a-dope8: posts big blind $0.10
*** HOLE CARDS ***
Dealt to PlayTheBlues4U [8d 3d]
Jariso13: folds
sins07: calls $0.10
TonyA747: calls $0.10
PlayTheBlues4U: calls $0.05
rope-a-dope8: checks
*** FLOP *** [Ah Js 9s]
PlayTheBlues4U: checks
rope-a-dope8: checks
sins07: checks
TonyA747: bets $0.40
PlayTheBlues4U: folds
rope-a-dope8: folds
sins07: folds
Uncalled bet ($0.40) returned to TonyA747
TonyA747 collected $0.38 from pot
TonyA747: doesn't show hand
*** SUMMARY ***
Total pot $0.40 | Rake $0.02
Board [Ah Js 9s]
Seat 1: TonyA747 (button) collected ($0.38)
Seat 2: PlayTheBlues4U (small blind) folded on the Flop
Seat 4: rope-a-dope8 (big blind) folded on the Flop
Seat 5: Jariso13 folded before Flop (didn't bet)
Seat 6: sins07 folded on the Flop


*********** # 179 **************
PokerStars Hand #205377946231:  Hold'em No Limit ($0.05/$0.10 USD) - 2019/11/02 22:07:35 ET
Table 'Hekate' 6-max Seat #6 is the button
Seat 1: linghuchong2 ($7.19 in chips)
Seat 2: asanxz22 ($11.96 in chips)
Seat 3: PlayTheBlues4U ($9.64 in chips)
Seat 5: rope-a-dope8 ($10 in chips)
Seat 6: BATHMEDIC ($4.82 in chips)
linghuchong2: posts small blind $0.05
asanxz22: posts big blind $0.10
*** HOLE CARDS ***
Dealt to PlayTheBlues4U [Tc Jc]
PlayTheBlues4U: folds
rope-a-dope8: folds
BATHMEDIC: folds
linghuchong2: calls $0.05
asanxz22: checks
*** FLOP *** [2s Td 4s]
linghuchong2: checks
asanxz22: checks
*** TURN *** [2s Td 4s] [Ad]
linghuchong2: checks
asanxz22: checks
*** RIVER *** [2s Td 4s Ad] [4c]
linghuchong2: checks
asanxz22: checks
*** SHOW DOWN ***
linghuchong2: shows [9c Qc] (a pair of Fours)
asanxz22: shows [2d 8h] (two pair, Fours and Deuces)
asanxz22 collected $0.19 from pot
*** SUMMARY ***
Total pot $0.20 | Rake $0.01
Board [2s Td 4s Ad 4c]
Seat 1: linghuchong2 (small blind) showed [9c Qc] and lost with a pair of Fours
Seat 2: asanxz22 (big blind) showed [2d 8h] and won ($0.19) with two pair, Fours and Deuces
Seat 3: PlayTheBlues4U folded before Flop (didn't bet)
Seat 5: rope-a-dope8 folded before Flop (didn't bet)
Seat 6: BATHMEDIC (button) folded before Flop (didn't bet)


*********** # 180 **************
PokerStars Hand #205377946120:  Hold'em No Limit ($0.05/$0.10 USD) - 2019/11/02 22:07:07 ET
Table 'Antares' 6-max Seat #6 is the button
Seat 1: TonyA747 ($12.61 in chips)
Seat 2: PlayTheBlues4U ($14.05 in chips)
Seat 3: StickyChipss ($10 in chips)
Seat 4: rope-a-dope8 ($15.86 in chips)
Seat 5: Jariso13 ($12.19 in chips)
Seat 6: sins07 ($12.08 in chips)
TonyA747: posts small blind $0.05
PlayTheBlues4U: posts big blind $0.10
*** HOLE CARDS ***
Dealt to PlayTheBlues4U [3c 9d]
StickyChipss: folds
rope-a-dope8: raises $0.25 to $0.35
Jariso13: folds
sins07: folds
TonyA747: calls $0.30
PlayTheBlues4U: folds
*** FLOP *** [Qs 5c 3d]
TonyA747: checks
rope-a-dope8: bets $0.38
TonyA747: folds
Uncalled bet ($0.38) returned to rope-a-dope8
rope-a-dope8 collected $0.76 from pot
rope-a-dope8: doesn't show hand
*** SUMMARY ***
Total pot $0.80 | Rake $0.04
Board [Qs 5c 3d]
Seat 1: TonyA747 (small blind) folded on the Flop
Seat 2: PlayTheBlues4U (big blind) folded before Flop
Seat 3: StickyChipss folded before Flop (didn't bet)
Seat 4: rope-a-dope8 collected ($0.76)
Seat 5: Jariso13 folded before Flop (didn't bet)
Seat 6: sins07 (button) folded before Flop (didn't bet)


*********** # 181 **************
PokerStars Hand #205377946072:  Hold'em No Limit ($0.05/$0.10 USD) - 2019/11/02 22:06:57 ET
Table 'Hekate' 6-max Seat #5 is the button
Seat 1: linghuchong2 ($7.59 in chips)
Seat 2: asanxz22 ($11.50 in chips)
Seat 3: PlayTheBlues4U ($9.64 in chips)
Seat 5: rope-a-dope8 ($10 in chips)
Seat 6: BATHMEDIC ($4.92 in chips)
BATHMEDIC: posts small blind $0.05
linghuchong2: posts big blind $0.10
*** HOLE CARDS ***
Dealt to PlayTheBlues4U [Td 4h]
asanxz22: calls $0.10
PlayTheBlues4U: folds
rope-a-dope8: folds
BATHMEDIC: calls $0.05
linghuchong2: checks
*** FLOP *** [6d As 9c]
BATHMEDIC: checks
linghuchong2: checks
asanxz22: bets $0.10
BATHMEDIC: folds
linghuchong2: calls $0.10
*** TURN *** [6d As 9c] [2d]
linghuchong2: checks
asanxz22: bets $0.20
linghuchong2: calls $0.20
*** RIVER *** [6d As 9c 2d] [7h]
linghuchong2: checks
asanxz22: bets $0.90
linghuchong2: folds
Uncalled bet ($0.90) returned to asanxz22
asanxz22 collected $0.86 from pot
asanxz22: doesn't show hand
*** SUMMARY ***
Total pot $0.90 | Rake $0.04
Board [6d As 9c 2d 7h]
Seat 1: linghuchong2 (big blind) folded on the River
Seat 2: asanxz22 collected ($0.86)
Seat 3: PlayTheBlues4U folded before Flop (didn't bet)
Seat 5: rope-a-dope8 (button) folded before Flop (didn't bet)
Seat 6: BATHMEDIC (small blind) folded on the Flop


*********** # 182 **************
PokerStars Hand #205377945923:  Hold'em No Limit ($0.05/$0.10 USD) - 2019/11/02 22:06:15 ET
Table 'Antares' 6-max Seat #5 is the button
Seat 1: TonyA747 ($12.05 in chips)
Seat 2: PlayTheBlues4U ($14.05 in chips)
Seat 3: StickyChipss ($10.17 in chips)
Seat 4: rope-a-dope8 ($15.86 in chips)
Seat 5: Jariso13 ($12.19 in chips)
Seat 6: sins07 ($12.38 in chips)
sins07: posts small blind $0.05
TonyA747: posts big blind $0.10
*** HOLE CARDS ***
Dealt to PlayTheBlues4U [Jh Qs]
PlayTheBlues4U: folds
StickyChipss: raises $0.20 to $0.30
rope-a-dope8: folds
Jariso13: folds
sins07: calls $0.25
TonyA747: calls $0.20
*** FLOP *** [Tc 9s 2s]
sins07: checks
TonyA747: checks
StickyChipss: checks
*** TURN *** [Tc 9s 2s] [2c]
sins07: checks
TonyA747: checks
StickyChipss: checks
*** RIVER *** [Tc 9s 2s 2c] [Qd]
sins07: checks
TonyA747: bets $0.90
StickyChipss: folds
sins07: folds
Uncalled bet ($0.90) returned to TonyA747
TonyA747 collected $0.86 from pot
TonyA747: doesn't show hand
*** SUMMARY ***
Total pot $0.90 | Rake $0.04
Board [Tc 9s 2s 2c Qd]
Seat 1: TonyA747 (big blind) collected ($0.86)
Seat 2: PlayTheBlues4U folded before Flop (didn't bet)
Seat 3: StickyChipss folded on the River
Seat 4: rope-a-dope8 folded before Flop (didn't bet)
Seat 5: Jariso13 (button) folded before Flop (didn't bet)
Seat 6: sins07 (small blind) folded on the River


*********** # 183 **************
PokerStars Hand #205377945813:  Hold'em No Limit ($0.05/$0.10 USD) - 2019/11/02 22:05:50 ET
Table 'Antares' 6-max Seat #4 is the button
Seat 1: TonyA747 ($12.05 in chips)
Seat 2: PlayTheBlues4U ($14.05 in chips)
Seat 3: StickyChipss ($10.17 in chips)
Seat 4: rope-a-dope8 ($15.86 in chips)
Seat 5: Jariso13 ($12.24 in chips)
Seat 6: sins07 ($12.33 in chips)
Jariso13: posts small blind $0.05
sins07: posts big blind $0.10
*** HOLE CARDS ***
Dealt to PlayTheBlues4U [2c 6d]
TonyA747: folds
PlayTheBlues4U: folds
StickyChipss: folds
rope-a-dope8: folds
Jariso13: folds
Uncalled bet ($0.05) returned to sins07
sins07 collected $0.10 from pot
sins07: doesn't show hand
*** SUMMARY ***
Total pot $0.10 | Rake $0
Seat 1: TonyA747 folded before Flop (didn't bet)
Seat 2: PlayTheBlues4U folded before Flop (didn't bet)
Seat 3: StickyChipss folded before Flop (didn't bet)
Seat 4: rope-a-dope8 (button) folded before Flop (didn't bet)
Seat 5: Jariso13 (small blind) folded before Flop
Seat 6: sins07 (big blind) collected ($0.10)


*********** # 184 **************
PokerStars Hand #205377945775:  Hold'em No Limit ($0.05/$0.10 USD) - 2019/11/02 22:05:41 ET
Table 'Hekate' 6-max Seat #3 is the button
Seat 1: linghuchong2 ($7.69 in chips)
Seat 2: asanxz22 ($10 in chips)
Seat 3: PlayTheBlues4U ($9.64 in chips)
Seat 5: rope-a-dope8 ($10.14 in chips)
Seat 6: BATHMEDIC ($5.02 in chips)
rope-a-dope8: posts small blind $0.05
BATHMEDIC: posts big blind $0.10
asanxz22: posts big blind $0.10
*** HOLE CARDS ***
Dealt to PlayTheBlues4U [4h 3d]
linghuchong2: calls $0.10
asanxz22: checks
PlayTheBlues4U: folds
rope-a-dope8: raises $0.60 to $0.70
BATHMEDIC: folds
linghuchong2: folds
asanxz22: calls $0.60
*** FLOP *** [3c 7h 5c]
rope-a-dope8: bets $0.76
asanxz22: calls $0.76
*** TURN *** [3c 7h 5c] [Jc]
rope-a-dope8: checks
asanxz22: checks
*** RIVER *** [3c 7h 5c Jc] [3h]
rope-a-dope8: checks
asanxz22: checks
*** SHOW DOWN ***
rope-a-dope8: shows [Ah Ks] (a pair of Threes)
asanxz22: shows [2c 2s] (two pair, Threes and Deuces)
asanxz22 collected $2.96 from pot
*** SUMMARY ***
Total pot $3.12 | Rake $0.16
Board [3c 7h 5c Jc 3h]
Seat 1: linghuchong2 folded before Flop
Seat 2: asanxz22 showed [2c 2s] and won ($2.96) with two pair, Threes and Deuces
Seat 3: PlayTheBlues4U (button) folded before Flop (didn't bet)
Seat 5: rope-a-dope8 (small blind) showed [Ah Ks] and lost with a pair of Threes
Seat 6: BATHMEDIC (big blind) folded before Flop


*********** # 185 **************
PokerStars Hand #205377945749:  Hold'em No Limit ($0.05/$0.10 USD) - 2019/11/02 22:05:35 ET
Table 'Antares' 6-max Seat #3 is the button
Seat 1: TonyA747 ($12.05 in chips)
Seat 2: PlayTheBlues4U ($14.05 in chips)
Seat 3: StickyChipss ($10.17 in chips)
Seat 4: rope-a-dope8 ($15.76 in chips)
Seat 5: Jariso13 ($12.34 in chips)
Seat 6: sins07 ($12.33 in chips)
rope-a-dope8: posts small blind $0.05
Jariso13: posts big blind $0.10
*** HOLE CARDS ***
Dealt to PlayTheBlues4U [Qh Tc]
sins07: folds
TonyA747: folds
PlayTheBlues4U: folds
StickyChipss: folds
rope-a-dope8: raises $0.20 to $0.30
Jariso13: folds
Uncalled bet ($0.20) returned to rope-a-dope8
rope-a-dope8 collected $0.20 from pot
rope-a-dope8: doesn't show hand
*** SUMMARY ***
Total pot $0.20 | Rake $0
Seat 1: TonyA747 folded before Flop (didn't bet)
Seat 2: PlayTheBlues4U folded before Flop (didn't bet)
Seat 3: StickyChipss (button) folded before Flop (didn't bet)
Seat 4: rope-a-dope8 (small blind) collected ($0.20)
Seat 5: Jariso13 (big blind) folded before Flop
Seat 6: sins07 folded before Flop (didn't bet)


*********** # 186 **************
PokerStars Hand #205377945584:  Hold'em No Limit ($0.05/$0.10 USD) - 2019/11/02 22:04:54 ET
Table 'Hekate' 6-max Seat #1 is the button
Seat 1: linghuchong2 ($7.69 in chips)
Seat 3: PlayTheBlues4U ($9.69 in chips)
Seat 5: rope-a-dope8 ($10 in chips)
Seat 6: BATHMEDIC ($5.12 in chips)
PlayTheBlues4U: posts small blind $0.05
rope-a-dope8: posts big blind $0.10
*** HOLE CARDS ***
Dealt to PlayTheBlues4U [3c Qs]
BATHMEDIC: calls $0.10
linghuchong2: folds
PlayTheBlues4U: folds
rope-a-dope8: checks
*** FLOP *** [2d 8h Jh]
rope-a-dope8: bets $0.12
asanxz22 joins the table at seat #2
BATHMEDIC: folds
Uncalled bet ($0.12) returned to rope-a-dope8
rope-a-dope8 collected $0.24 from pot
rope-a-dope8: doesn't show hand
*** SUMMARY ***
Total pot $0.25 | Rake $0.01
Board [2d 8h Jh]
Seat 1: linghuchong2 (button) folded before Flop (didn't bet)
Seat 3: PlayTheBlues4U (small blind) folded before Flop
Seat 5: rope-a-dope8 (big blind) collected ($0.24)
Seat 6: BATHMEDIC folded on the Flop


*********** # 187 **************
PokerStars Hand #205377945562:  Hold'em No Limit ($0.05/$0.10 USD) - 2019/11/02 22:04:49 ET
Table 'Antares' 6-max Seat #2 is the button
Seat 1: TonyA747 ($10 in chips)
Seat 2: PlayTheBlues4U ($14.05 in chips)
Seat 3: StickyChipss ($10.22 in chips)
Seat 4: rope-a-dope8 ($17.51 in chips)
Seat 5: Jariso13 ($12.34 in chips)
Seat 6: sins07 ($12.78 in chips)
StickyChipss: posts small blind $0.05
rope-a-dope8: posts big blind $0.10
TonyA747: posts big blind $0.10
*** HOLE CARDS ***
Dealt to PlayTheBlues4U [As 7h]
Jariso13: folds
sins07: calls $0.10
TonyA747: raises $0.35 to $0.45
PlayTheBlues4U: folds
StickyChipss: folds
rope-a-dope8: calls $0.35
sins07: calls $0.35
*** FLOP *** [3h 2s Kd]
rope-a-dope8: checks
sins07: checks
TonyA747: bets $1.30
rope-a-dope8: calls $1.30
sins07: folds
*** TURN *** [3h 2s Kd] [2c]
rope-a-dope8: checks
TonyA747: bets $8.25 and is all-in
rope-a-dope8: folds
Uncalled bet ($8.25) returned to TonyA747
TonyA747 collected $3.80 from pot
TonyA747: doesn't show hand
*** SUMMARY ***
Total pot $4 | Rake $0.20
Board [3h 2s Kd 2c]
Seat 1: TonyA747 collected ($3.80)
Seat 2: PlayTheBlues4U (button) folded before Flop (didn't bet)
Seat 3: StickyChipss (small blind) folded before Flop
Seat 4: rope-a-dope8 (big blind) folded on the Turn
Seat 5: Jariso13 folded before Flop (didn't bet)
Seat 6: sins07 folded on the Flop


*********** # 188 **************
PokerStars Hand #205377945475:  Hold'em No Limit ($0.05/$0.10 USD) - 2019/11/02 22:04:27 ET
Table 'Hekate' 6-max Seat #6 is the button
Seat 1: linghuchong2 ($7.74 in chips)
Seat 3: PlayTheBlues4U ($9.79 in chips)
Seat 5: rope-a-dope8 ($10 in chips)
Seat 6: BATHMEDIC ($4.98 in chips)
linghuchong2: posts small blind $0.05
PlayTheBlues4U: posts big blind $0.10
*** HOLE CARDS ***
Dealt to PlayTheBlues4U [Jc 3s]
rope-a-dope8: folds
BATHMEDIC: calls $0.10
linghuchong2: folds
PlayTheBlues4U: checks
*** FLOP *** [Ks 9d 5s]
PlayTheBlues4U: checks
BATHMEDIC: checks
*** TURN *** [Ks 9d 5s] [2d]
PlayTheBlues4U: checks
BATHMEDIC: checks
*** RIVER *** [Ks 9d 5s 2d] [Qh]
PlayTheBlues4U: checks
BATHMEDIC: bets $0.24
PlayTheBlues4U: folds
Uncalled bet ($0.24) returned to BATHMEDIC
BATHMEDIC collected $0.24 from pot
*** SUMMARY ***
Total pot $0.25 | Rake $0.01
Board [Ks 9d 5s 2d Qh]
Seat 1: linghuchong2 (small blind) folded before Flop
Seat 3: PlayTheBlues4U (big blind) folded on the River
Seat 5: rope-a-dope8 folded before Flop (didn't bet)
Seat 6: BATHMEDIC (button) collected ($0.24)


*********** # 189 **************
PokerStars Hand #205377945467:  Hold'em No Limit ($0.05/$0.10 USD) - 2019/11/02 22:04:24 ET
Table 'Antares' 6-max Seat #6 is the button
Seat 2: PlayTheBlues4U ($13.85 in chips)
Seat 3: StickyChipss ($10.32 in chips)
Seat 4: rope-a-dope8 ($17.51 in chips)
Seat 5: Jariso13 ($12.34 in chips)
Seat 6: sins07 ($12.88 in chips)
PlayTheBlues4U: posts small blind $0.05
StickyChipss: posts big blind $0.10
*** HOLE CARDS ***
Dealt to PlayTheBlues4U [Kc Qd]
rope-a-dope8: folds
TonyA747 joins the table at seat #1
Jariso13: folds
sins07: calls $0.10
PlayTheBlues4U: raises $0.20 to $0.30
StickyChipss: folds
sins07: folds
Uncalled bet ($0.20) returned to PlayTheBlues4U
PlayTheBlues4U collected $0.30 from pot
PlayTheBlues4U: doesn't show hand
*** SUMMARY ***
Total pot $0.30 | Rake $0
Seat 2: PlayTheBlues4U (small blind) collected ($0.30)
Seat 3: StickyChipss (big blind) folded before Flop
Seat 4: rope-a-dope8 folded before Flop (didn't bet)
Seat 5: Jariso13 folded before Flop (didn't bet)
Seat 6: sins07 (button) folded before Flop


*********** # 190 **************
PokerStars Hand #205377945427:  Hold'em No Limit ($0.05/$0.10 USD) - 2019/11/02 22:04:15 ET
Table 'Hekate' 6-max Seat #5 is the button
Seat 1: linghuchong2 ($7.84 in chips)
Seat 3: PlayTheBlues4U ($9.79 in chips)
Seat 5: rope-a-dope8 ($10 in chips)
Seat 6: BATHMEDIC ($4.88 in chips)
BATHMEDIC: posts small blind $0.05
linghuchong2: posts big blind $0.10
*** HOLE CARDS ***
Dealt to PlayTheBlues4U [3s Th]
PlayTheBlues4U: folds
rope-a-dope8: folds
BATHMEDIC: raises $0.10 to $0.20
linghuchong2: folds
Uncalled bet ($0.10) returned to BATHMEDIC
BATHMEDIC collected $0.20 from pot
*** SUMMARY ***
Total pot $0.20 | Rake $0
Seat 1: linghuchong2 (big blind) folded before Flop
Seat 3: PlayTheBlues4U folded before Flop (didn't bet)
Seat 5: rope-a-dope8 (button) folded before Flop (didn't bet)
Seat 6: BATHMEDIC (small blind) collected ($0.20)


*********** # 191 **************
PokerStars Hand #205377945357:  Hold'em No Limit ($0.05/$0.10 USD) - 2019/11/02 22:03:55 ET
Table 'Antares' 6-max Seat #5 is the button
Seat 2: PlayTheBlues4U ($13.95 in chips)
Seat 3: StickyChipss ($10.32 in chips)
Seat 4: rope-a-dope8 ($17.51 in chips)
Seat 5: Jariso13 ($11.88 in chips)
Seat 6: sins07 ($13.28 in chips)
sins07: posts small blind $0.05
PlayTheBlues4U: posts big blind $0.10
*** HOLE CARDS ***
Dealt to PlayTheBlues4U [3s 4d]
StickyChipss: folds
rope-a-dope8: folds
Jariso13: calls $0.10
sins07: calls $0.05
PlayTheBlues4U: checks
*** FLOP *** [7c 6d 3d]
sins07: bets $0.10
PlayTheBlues4U: folds
Jariso13: calls $0.10
*** TURN *** [7c 6d 3d] [Tc]
sins07: bets $0.20
Jariso13: raises $0.50 to $0.70
sins07: folds
Uncalled bet ($0.50) returned to Jariso13
Jariso13 collected $0.86 from pot
Jariso13: doesn't show hand
*** SUMMARY ***
Total pot $0.90 | Rake $0.04
Board [7c 6d 3d Tc]
Seat 2: PlayTheBlues4U (big blind) folded on the Flop
Seat 3: StickyChipss folded before Flop (didn't bet)
Seat 4: rope-a-dope8 folded before Flop (didn't bet)
Seat 5: Jariso13 (button) collected ($0.86)
Seat 6: sins07 (small blind) folded on the Turn


*********** # 192 **************
PokerStars Hand #205377945266:  Hold'em No Limit ($0.05/$0.10 USD) - 2019/11/02 22:03:34 ET
Table 'Antares' 6-max Seat #4 is the button
Seat 2: PlayTheBlues4U ($13.95 in chips)
Seat 3: StickyChipss ($10.32 in chips)
Seat 4: rope-a-dope8 ($17.51 in chips)
Seat 5: Jariso13 ($12.18 in chips)
Seat 6: sins07 ($13.01 in chips)
Jariso13: posts small blind $0.05
sins07: posts big blind $0.10
*** HOLE CARDS ***
Dealt to PlayTheBlues4U [8c 2h]
PlayTheBlues4U: folds
StickyChipss: folds
rope-a-dope8: folds
Jariso13: calls $0.05
sins07: checks
*** FLOP *** [Th 5d 3d]
Jariso13: bets $0.20
sins07: calls $0.20
*** TURN *** [Th 5d 3d] [2c]
Jariso13: checks
sins07: checks
*** RIVER *** [Th 5d 3d 2c] [3s]
Jariso13: checks
sins07: checks
*** SHOW DOWN ***
Jariso13: shows [7c 6h] (a pair of Threes)
sins07: shows [5c 4d] (two pair, Fives and Threes)
sins07 collected $0.57 from pot
*** SUMMARY ***
Total pot $0.60 | Rake $0.03
Board [Th 5d 3d 2c 3s]
Seat 2: PlayTheBlues4U folded before Flop (didn't bet)
Seat 3: StickyChipss folded before Flop (didn't bet)
Seat 4: rope-a-dope8 (button) folded before Flop (didn't bet)
Seat 5: Jariso13 (small blind) showed [7c 6h] and lost with a pair of Threes
Seat 6: sins07 (big blind) showed [5c 4d] and won ($0.57) with two pair, Fives and Threes


*********** # 193 **************
PokerStars Hand #205377945225:  Hold'em No Limit ($0.05/$0.10 USD) - 2019/11/02 22:03:25 ET
Table 'Hekate' 6-max Seat #3 is the button
Seat 1: linghuchong2 ($8.84 in chips)
Seat 3: PlayTheBlues4U ($8.75 in chips)
Seat 5: rope-a-dope8 ($10 in chips)
Seat 6: BATHMEDIC ($4.98 in chips)
rope-a-dope8: posts small blind $0.05
BATHMEDIC: posts big blind $0.10
*** HOLE CARDS ***
Dealt to PlayTheBlues4U [5c 4c]
linghuchong2: raises $0.20 to $0.30
PlayTheBlues4U: calls $0.30
rope-a-dope8: folds
BATHMEDIC: folds
*** FLOP *** [Th 5d 5s]
linghuchong2: bets $0.70
PlayTheBlues4U: calls $0.70
*** TURN *** [Th 5d 5s] [8d]
linghuchong2: checks
PlayTheBlues4U: bets $1.40
asanxz22 was removed from the table for failing to post
asanxz22 leaves the table
linghuchong2: folds
Uncalled bet ($1.40) returned to PlayTheBlues4U
PlayTheBlues4U collected $2.04 from pot
PlayTheBlues4U: doesn't show hand
*** SUMMARY ***
Total pot $2.15 | Rake $0.11
Board [Th 5d 5s 8d]
Seat 1: linghuchong2 folded on the Turn
Seat 3: PlayTheBlues4U (button) collected ($2.04)
Seat 5: rope-a-dope8 (small blind) folded before Flop
Seat 6: BATHMEDIC (big blind) folded before Flop


*********** # 194 **************
PokerStars Hand #205377945171:  Hold'em No Limit ($0.05/$0.10 USD) - 2019/11/02 22:03:13 ET
Table 'Antares' 6-max Seat #3 is the button
Seat 2: PlayTheBlues4U ($13.95 in chips)
Seat 3: StickyChipss ($10.32 in chips)
Seat 4: rope-a-dope8 ($17.56 in chips)
Seat 5: Jariso13 ($12.58 in chips)
Seat 6: sins07 ($12.60 in chips)
rope-a-dope8: posts small blind $0.05
Jariso13: posts big blind $0.10
*** HOLE CARDS ***
Dealt to PlayTheBlues4U [6c Qc]
sins07: raises $0.30 to $0.40
PlayTheBlues4U: folds
StickyChipss: folds
rope-a-dope8: folds
Jariso13: calls $0.30
*** FLOP *** [4c 7c 9h]
Jariso13: checks
sins07: bets $0.50
Jariso13: folds
Uncalled bet ($0.50) returned to sins07
sins07 collected $0.81 from pot
sins07: doesn't show hand
*** SUMMARY ***
Total pot $0.85 | Rake $0.04
Board [4c 7c 9h]
Seat 2: PlayTheBlues4U folded before Flop (didn't bet)
Seat 3: StickyChipss (button) folded before Flop (didn't bet)
Seat 4: rope-a-dope8 (small blind) folded before Flop
Seat 5: Jariso13 (big blind) folded on the Flop
Seat 6: sins07 collected ($0.81)


*********** # 195 **************
PokerStars Hand #205377945056:  Hold'em No Limit ($0.05/$0.10 USD) - 2019/11/02 22:02:49 ET
Table 'Hekate' 6-max Seat #1 is the button
Seat 1: linghuchong2 ($8.84 in chips)
Seat 3: PlayTheBlues4U ($8.80 in chips)
Seat 5: rope-a-dope8 ($10 in chips)
Seat 6: BATHMEDIC ($4.75 in chips)
PlayTheBlues4U: posts small blind $0.05
rope-a-dope8: posts big blind $0.10
*** HOLE CARDS ***
Dealt to PlayTheBlues4U [7h 2c]
BATHMEDIC: calls $0.10
linghuchong2: folds
PlayTheBlues4U: folds
rope-a-dope8: checks
*** FLOP *** [6s 9c 4h]
rope-a-dope8: bets $0.10
BATHMEDIC: raises $0.30 to $0.40
rope-a-dope8: folds
Uncalled bet ($0.30) returned to BATHMEDIC
BATHMEDIC collected $0.43 from pot
*** SUMMARY ***
Total pot $0.45 | Rake $0.02
Board [6s 9c 4h]
Seat 1: linghuchong2 (button) folded before Flop (didn't bet)
Seat 3: PlayTheBlues4U (small blind) folded before Flop
Seat 5: rope-a-dope8 (big blind) folded on the Flop
Seat 6: BATHMEDIC collected ($0.43)


*********** # 196 **************
PokerStars Hand #205377945011:  Hold'em No Limit ($0.05/$0.10 USD) - 2019/11/02 22:02:39 ET
Table 'Antares' 6-max Seat #2 is the button
Seat 2: PlayTheBlues4U ($13.95 in chips)
Seat 3: StickyChipss ($10.37 in chips)
Seat 4: rope-a-dope8 ($17.58 in chips)
Seat 5: Jariso13 ($12.58 in chips)
Seat 6: sins07 ($12.62 in chips)
StickyChipss: posts small blind $0.05
rope-a-dope8: posts big blind $0.10
*** HOLE CARDS ***
Dealt to PlayTheBlues4U [3c 4h]
Jariso13: folds
sins07: calls $0.10
PlayTheBlues4U: folds
StickyChipss: folds
rope-a-dope8: checks
*** FLOP *** [Th Kh Ad]
rope-a-dope8: bets $0.10
sins07: raises $0.20 to $0.30
rope-a-dope8: calls $0.20
*** TURN *** [Th Kh Ad] [5s]
rope-a-dope8: checks
sins07: bets $0.20
rope-a-dope8: calls $0.20
*** RIVER *** [Th Kh Ad 5s] [Kc]
rope-a-dope8: bets $0.30
sins07: calls $0.30
*** SHOW DOWN ***
rope-a-dope8: shows [Ac 4s] (two pair, Aces and Kings)
sins07: shows [As 3d] (two pair, Aces and Kings)
rope-a-dope8 collected $0.88 from pot
sins07 collected $0.88 from pot
*** SUMMARY ***
Total pot $1.85 | Rake $0.09
Board [Th Kh Ad 5s Kc]
Seat 2: PlayTheBlues4U (button) folded before Flop (didn't bet)
Seat 3: StickyChipss (small blind) folded before Flop
Seat 4: rope-a-dope8 (big blind) showed [Ac 4s] and won ($0.88) with two pair, Aces and Kings
Seat 5: Jariso13 folded before Flop (didn't bet)
Seat 6: sins07 showed [As 3d] and won ($0.88) with two pair, Aces and Kings


*********** # 197 **************
PokerStars Hand #205377944902:  Hold'em No Limit ($0.05/$0.10 USD) - 2019/11/02 22:02:13 ET
Table 'Antares' 6-max Seat #6 is the button
Seat 2: PlayTheBlues4U ($14 in chips)
Seat 3: StickyChipss ($10.47 in chips)
Seat 4: rope-a-dope8 ($17.43 in chips)
Seat 5: Jariso13 ($12.58 in chips)
Seat 6: sins07 ($12.62 in chips)
PlayTheBlues4U: posts small blind $0.05
StickyChipss: posts big blind $0.10
*** HOLE CARDS ***
Dealt to PlayTheBlues4U [4h Jc]
rope-a-dope8: raises $0.20 to $0.30
Jariso13: folds
sins07: folds
PlayTheBlues4U: folds
StickyChipss: folds
Uncalled bet ($0.20) returned to rope-a-dope8
rope-a-dope8 collected $0.25 from pot
rope-a-dope8: doesn't show hand
*** SUMMARY ***
Total pot $0.25 | Rake $0
Seat 2: PlayTheBlues4U (small blind) folded before Flop
Seat 3: StickyChipss (big blind) folded before Flop
Seat 4: rope-a-dope8 collected ($0.25)
Seat 5: Jariso13 folded before Flop (didn't bet)
Seat 6: sins07 (button) folded before Flop (didn't bet)


*********** # 198 **************
PokerStars Hand #205377944889:  Hold'em No Limit ($0.02/$0.05 USD) - 2019/11/02 22:02:10 ET
Table 'Pisces' 6-max Seat #5 is the button
Seat 1: CMc172 ($4.70 in chips)
Seat 2: BaldEagleStar ($4.69 in chips)
Seat 3: PlayTheBlues4U ($6.04 in chips)
Seat 4: crazy turfer ($2.31 in chips)
Seat 5: peenpump240 ($5.84 in chips)
Seat 6: GTMuldoon ($4.56 in chips)
GTMuldoon: posts small blind $0.02
CMc172: posts big blind $0.05
*** HOLE CARDS ***
Dealt to PlayTheBlues4U [Qc Jh]
BaldEagleStar: calls $0.05
PlayTheBlues4U: folds
crazy turfer: folds
peenpump240: raises $0.05 to $0.10
GTMuldoon: folds
CMc172: folds
BaldEagleStar: calls $0.05
*** FLOP *** [Kd Ad Ah]
GTMuldoon leaves the table
Jariso13 joins the table at seat #6
BaldEagleStar: checks
peenpump240: bets $0.05
BaldEagleStar: folds
Uncalled bet ($0.05) returned to peenpump240
peenpump240 collected $0.26 from pot
peenpump240: doesn't show hand
*** SUMMARY ***
Total pot $0.27 | Rake $0.01
Board [Kd Ad Ah]
Seat 1: CMc172 (big blind) folded before Flop
Seat 2: BaldEagleStar folded on the Flop
Seat 3: PlayTheBlues4U folded before Flop (didn't bet)
Seat 4: crazy turfer folded before Flop (didn't bet)
Seat 5: peenpump240 (button) collected ($0.26)
Seat 6: GTMuldoon (small blind) folded before Flop


*********** # 199 **************
PokerStars Hand #205377944827:  Hold'em No Limit ($0.05/$0.10 USD) - 2019/11/02 22:01:55 ET
Table 'Antares' 6-max Seat #5 is the button
Seat 2: PlayTheBlues4U ($14.10 in chips)
Seat 3: StickyChipss ($10.32 in chips)
Seat 4: rope-a-dope8 ($17.43 in chips)
Seat 5: Jariso13 ($12.58 in chips)
Seat 6: sins07 ($12.67 in chips)
sins07: posts small blind $0.05
PlayTheBlues4U: posts big blind $0.10
*** HOLE CARDS ***
Dealt to PlayTheBlues4U [9c 4d]
StickyChipss: raises $0.20 to $0.30
rope-a-dope8: folds
Jariso13: folds
sins07: folds
PlayTheBlues4U: folds
Uncalled bet ($0.20) returned to StickyChipss
StickyChipss collected $0.25 from pot
*** SUMMARY ***
Total pot $0.25 | Rake $0
Seat 2: PlayTheBlues4U (big blind) folded before Flop
Seat 3: StickyChipss collected ($0.25)
Seat 4: rope-a-dope8 folded before Flop (didn't bet)
Seat 5: Jariso13 (button) folded before Flop (didn't bet)
Seat 6: sins07 (small blind) folded before Flop


*********** # 200 **************
PokerStars Hand #205377944808:  Hold'em No Limit ($0.05/$0.10 USD) - 2019/11/02 22:01:50 ET
Table 'Hekate' 6-max Seat #6 is the button
Seat 1: linghuchong2 ($8.89 in chips)
Seat 3: PlayTheBlues4U ($10 in chips)
Seat 4: boxerpupp727 ($8.70 in chips)
Seat 5: rope-a-dope8 ($10 in chips)
Seat 6: BATHMEDIC ($3.62 in chips)
linghuchong2: posts small blind $0.05
PlayTheBlues4U: posts big blind $0.10
*** HOLE CARDS ***
Dealt to PlayTheBlues4U [Kh Ah]
boxerpupp727: folds
rope-a-dope8: folds
BATHMEDIC: calls $0.10
linghuchong2: folds
PlayTheBlues4U: raises $0.30 to $0.40
BATHMEDIC: calls $0.30
*** FLOP *** [4c Jd Qh]
boxerpupp727 is disconnected
PlayTheBlues4U: bets $0.40
BATHMEDIC: raises $0.40 to $0.80
PlayTheBlues4U: calls $0.40
*** TURN *** [4c Jd Qh] [6d]
PlayTheBlues4U: checks
BATHMEDIC: checks
*** RIVER *** [4c Jd Qh 6d] [6s]
PlayTheBlues4U: checks
BATHMEDIC: bets $2.33
PlayTheBlues4U: folds
Uncalled bet ($2.33) returned to BATHMEDIC
BATHMEDIC collected $2.33 from pot
*** SUMMARY ***
Total pot $2.45 | Rake $0.12
Board [4c Jd Qh 6d 6s]
Seat 1: linghuchong2 (small blind) folded before Flop
Seat 3: PlayTheBlues4U (big blind) folded on the River
Seat 4: boxerpupp727 folded before Flop (didn't bet)
Seat 5: rope-a-dope8 folded before Flop (didn't bet)
Seat 6: BATHMEDIC (button) collected ($2.33)